created_date,pick_city_name,pick_district_name,timeslot,gross_order,net_order,cancel_order,cnd
2021-12-27,Binh Duong,Ben Cat,11,1,1,0,0
2021-12-27,Binh Duong,Ben Cat,19,3,1,2,2
2021-12-27,Binh Duong,Di An,7,7,2,5,5
2021-12-27,Binh Duong,Di An,8,15,4,11,8
2021-12-27,Binh Duong,Di An,9,10,2,8,8
2021-12-27,Binh Duong,Di An,10,14,5,9,7
2021-12-27,Binh Duong,Di An,11,17,11,6,4
2021-12-27,Binh Duong,Di An,12,25,12,13,9
2021-12-27,Binh Duong,Di An,13,23,7,16,15
2021-12-27,Binh Duong,Di An,14,13,9,4,3
2021-12-27,Binh Duong,Di An,15,15,9,6,5
2021-12-27,Binh Duong,Di An,16,13,2,11,9
2021-12-27,Binh Duong,Di An,17,14,2,12,8
2021-12-27,Binh Duong,Di An,18,9,4,5,4
2021-12-27,Binh Duong,Di An,19,36,5,31,29
2021-12-27,Binh Duong,Di An,20,10,4,6,4
2021-12-27,Binh Duong,Di An,21,3,0,3,1
2021-12-27,Binh Duong,Tan Uyen,10,4,1,3,3
2021-12-27,Binh Duong,Tan Uyen,11,3,1,2,2
2021-12-27,Binh Duong,Tan Uyen,13,1,1,0,0
2021-12-27,Binh Duong,Tan Uyen,14,4,2,2,2
2021-12-27,Binh Duong,Tan Uyen,15,2,1,1,0
2021-12-27,Binh Duong,Tan Uyen,16,1,0,1,1
2021-12-27,Binh Duong,Tan Uyen,19,2,1,1,1
2021-12-27,Binh Duong,Thu Dau Mot Town,5,1,1,0,0
2021-12-27,Binh Duong,Thu Dau Mot Town,6,30,21,9,2
2021-12-27,Binh Duong,Thu Dau Mot Town,7,99,94,5,1
2021-12-27,Binh Duong,Thu Dau Mot Town,8,196,183,13,2
2021-12-27,Binh Duong,Thu Dau Mot Town,9,213,204,9,1
2021-12-27,Binh Duong,Thu Dau Mot Town,10,323,300,23,1
2021-12-27,Binh Duong,Thu Dau Mot Town,11,597,543,54,5
2021-12-27,Binh Duong,Thu Dau Mot Town,12,386,369,17,4
2021-12-27,Binh Duong,Thu Dau Mot Town,13,351,332,19,6
2021-12-27,Binh Duong,Thu Dau Mot Town,14,269,255,14,4
2021-12-27,Binh Duong,Thu Dau Mot Town,15,259,246,13,6
2021-12-27,Binh Duong,Thu Dau Mot Town,16,245,230,15,2
2021-12-27,Binh Duong,Thu Dau Mot Town,17,340,279,61,36
2021-12-27,Binh Duong,Thu Dau Mot Town,18,391,244,147,110
2021-12-27,Binh Duong,Thu Dau Mot Town,19,438,292,146,115
2021-12-27,Binh Duong,Thu Dau Mot Town,20,264,224,40,19
2021-12-27,Binh Duong,Thu Dau Mot Town,21,90,79,11,4
2021-12-27,Binh Duong,Thu Dau Mot Town,22,5,2,3,0
2021-12-27,Binh Duong,Thu Dau Mot Town,23,2,0,2,0
2021-12-27,Binh Duong,Thuan An,7,8,3,5,5
2021-12-27,Binh Duong,Thuan An,8,15,7,8,6
2021-12-27,Binh Duong,Thuan An,9,30,15,15,12
2021-12-27,Binh Duong,Thuan An,10,48,26,22,17
2021-12-27,Binh Duong,Thuan An,11,104,50,54,44
2021-12-27,Binh Duong,Thuan An,12,81,38,43,35
2021-12-27,Binh Duong,Thuan An,13,57,30,27,20
2021-12-27,Binh Duong,Thuan An,14,44,23,21,17
2021-12-27,Binh Duong,Thuan An,15,33,21,12,8
2021-12-27,Binh Duong,Thuan An,16,41,24,17,14
2021-12-27,Binh Duong,Thuan An,17,32,19,13,11
2021-12-27,Binh Duong,Thuan An,18,22,10,12,10
2021-12-27,Binh Duong,Thuan An,19,32,14,18,17
2021-12-27,Binh Duong,Thuan An,20,19,7,12,8
2021-12-27,Binh Duong,Thuan An,21,11,2,9,3
2021-12-27,Binh Duong,Thuan An,23,1,0,1,1
2021-12-27,Can Tho City,Binh Thuy District,8,2,2,0,0
2021-12-27,Can Tho City,Binh Thuy District,9,4,3,1,0
2021-12-27,Can Tho City,Binh Thuy District,10,5,5,0,0
2021-12-27,Can Tho City,Binh Thuy District,11,9,8,1,0
2021-12-27,Can Tho City,Binh Thuy District,12,6,6,0,0
2021-12-27,Can Tho City,Binh Thuy District,13,14,13,1,0
2021-12-27,Can Tho City,Binh Thuy District,14,6,6,0,0
2021-12-27,Can Tho City,Binh Thuy District,15,11,10,1,0
2021-12-27,Can Tho City,Binh Thuy District,16,12,10,2,0
2021-12-27,Can Tho City,Binh Thuy District,17,3,3,0,0
2021-12-27,Can Tho City,Binh Thuy District,18,7,6,1,0
2021-12-27,Can Tho City,Binh Thuy District,19,13,13,0,0
2021-12-27,Can Tho City,Binh Thuy District,20,9,6,3,1
2021-12-27,Can Tho City,Binh Thuy District,21,5,3,2,0
2021-12-27,Can Tho City,Cai Rang District,6,1,1,0,0
2021-12-27,Can Tho City,Cai Rang District,7,6,5,1,0
2021-12-27,Can Tho City,Cai Rang District,8,6,4,2,0
2021-12-27,Can Tho City,Cai Rang District,9,5,5,0,0
2021-12-27,Can Tho City,Cai Rang District,10,6,5,1,0
2021-12-27,Can Tho City,Cai Rang District,11,11,10,1,0
2021-12-27,Can Tho City,Cai Rang District,12,10,9,1,0
2021-12-27,Can Tho City,Cai Rang District,13,7,7,0,0
2021-12-27,Can Tho City,Cai Rang District,14,7,7,0,0
2021-12-27,Can Tho City,Cai Rang District,15,6,5,1,0
2021-12-27,Can Tho City,Cai Rang District,16,11,11,0,0
2021-12-27,Can Tho City,Cai Rang District,17,10,10,0,0
2021-12-27,Can Tho City,Cai Rang District,18,7,5,2,0
2021-12-27,Can Tho City,Cai Rang District,19,8,8,0,0
2021-12-27,Can Tho City,Cai Rang District,20,7,5,2,0
2021-12-27,Can Tho City,Cai Rang District,21,1,1,0,0
2021-12-27,Can Tho City,Cai Rang District,23,1,1,0,0
2021-12-27,Can Tho City,Ninh Kieu District,0,2,1,1,0
2021-12-27,Can Tho City,Ninh Kieu District,1,7,5,2,0
2021-12-27,Can Tho City,Ninh Kieu District,3,1,1,0,0
2021-12-27,Can Tho City,Ninh Kieu District,4,2,2,0,0
2021-12-27,Can Tho City,Ninh Kieu District,5,1,1,0,0
2021-12-27,Can Tho City,Ninh Kieu District,6,55,50,5,0
2021-12-27,Can Tho City,Ninh Kieu District,7,152,139,13,0
2021-12-27,Can Tho City,Ninh Kieu District,8,241,234,7,0
2021-12-27,Can Tho City,Ninh Kieu District,9,264,250,14,0
2021-12-27,Can Tho City,Ninh Kieu District,10,425,408,17,0
2021-12-27,Can Tho City,Ninh Kieu District,11,750,722,28,0
2021-12-27,Can Tho City,Ninh Kieu District,12,528,506,22,0
2021-12-27,Can Tho City,Ninh Kieu District,13,399,380,19,0
2021-12-27,Can Tho City,Ninh Kieu District,14,316,300,16,0
2021-12-27,Can Tho City,Ninh Kieu District,15,280,266,14,0
2021-12-27,Can Tho City,Ninh Kieu District,16,352,336,16,0
2021-12-27,Can Tho City,Ninh Kieu District,17,453,429,24,0
2021-12-27,Can Tho City,Ninh Kieu District,18,489,464,25,0
2021-12-27,Can Tho City,Ninh Kieu District,19,427,396,31,0
2021-12-27,Can Tho City,Ninh Kieu District,20,278,254,24,1
2021-12-27,Can Tho City,Ninh Kieu District,21,180,151,29,0
2021-12-27,Can Tho City,Ninh Kieu District,22,7,5,2,0
2021-12-27,Can Tho City,Ninh Kieu District,23,3,3,0,0
2021-12-27,Dong Nai,Bien Hoa City,5,2,2,0,0
2021-12-27,Dong Nai,Bien Hoa City,6,40,27,13,8
2021-12-27,Dong Nai,Bien Hoa City,7,139,111,28,15
2021-12-27,Dong Nai,Bien Hoa City,8,254,224,30,8
2021-12-27,Dong Nai,Bien Hoa City,9,345,303,42,8
2021-12-27,Dong Nai,Bien Hoa City,10,606,565,41,10
2021-12-27,Dong Nai,Bien Hoa City,11,979,855,124,40
2021-12-27,Dong Nai,Bien Hoa City,12,768,698,70,8
2021-12-27,Dong Nai,Bien Hoa City,13,670,630,40,7
2021-12-27,Dong Nai,Bien Hoa City,14,607,554,53,11
2021-12-27,Dong Nai,Bien Hoa City,15,470,437,33,8
2021-12-27,Dong Nai,Bien Hoa City,16,454,422,32,5
2021-12-27,Dong Nai,Bien Hoa City,17,532,491,41,2
2021-12-27,Dong Nai,Bien Hoa City,18,598,539,59,4
2021-12-27,Dong Nai,Bien Hoa City,19,542,493,49,11
2021-12-27,Dong Nai,Bien Hoa City,20,437,348,89,37
2021-12-27,Dong Nai,Bien Hoa City,21,226,141,85,51
2021-12-27,Dong Nai,Bien Hoa City,22,3,1,2,0
2021-12-27,Dong Nai,Bien Hoa City,23,4,2,2,1
2021-12-27,Dong Nai,Long Thanh,8,4,0,4,3
2021-12-27,Dong Nai,Long Thanh,9,4,0,4,3
2021-12-27,Dong Nai,Long Thanh,10,5,0,5,4
2021-12-27,Dong Nai,Long Thanh,11,1,0,1,1
2021-12-27,Dong Nai,Long Thanh,13,1,0,1,1
2021-12-27,Dong Nai,Long Thanh,15,2,0,2,2
2021-12-27,Dong Nai,Long Thanh,19,1,0,1,1
2021-12-27,Dong Nai,Long Thanh,21,1,0,1,0
2021-12-27,Dong Nai,Thong Nhat,10,1,1,0,0
2021-12-27,Dong Nai,Thong Nhat,12,1,1,0,0
2021-12-27,Dong Nai,Thong Nhat,13,3,3,0,0
2021-12-27,Dong Nai,Thong Nhat,16,1,1,0,0
2021-12-27,Dong Nai,Thong Nhat,19,1,1,0,0
2021-12-27,Dong Nai,Trang Bom,13,3,0,3,3
2021-12-27,Dong Nai,Trang Bom,15,2,0,2,2
2021-12-27,Dong Nai,Trang Bom,17,1,0,1,1
2021-12-27,Hai Phong City,An Duong,7,2,0,2,2
2021-12-27,Hai Phong City,An Duong,8,1,0,1,1
2021-12-27,Hai Phong City,An Duong,9,3,2,1,0
2021-12-27,Hai Phong City,An Duong,10,3,3,0,0
2021-12-27,Hai Phong City,An Duong,11,1,1,0,0
2021-12-27,Hai Phong City,An Duong,13,2,1,1,1
2021-12-27,Hai Phong City,An Duong,15,3,2,1,1
2021-12-27,Hai Phong City,An Duong,17,1,1,0,0
2021-12-27,Hai Phong City,An Duong,20,1,1,0,0
2021-12-27,Hai Phong City,An Lao,15,2,0,2,1
2021-12-27,Hai Phong City,Do Son District,9,1,0,1,1
2021-12-27,Hai Phong City,Do Son District,10,1,0,1,1
2021-12-27,Hai Phong City,Hai An District,7,11,6,5,3
2021-12-27,Hai Phong City,Hai An District,8,12,10,2,0
2021-12-27,Hai Phong City,Hai An District,9,11,9,2,0
2021-12-27,Hai Phong City,Hai An District,10,26,23,3,0
2021-12-27,Hai Phong City,Hai An District,11,58,54,4,1
2021-12-27,Hai Phong City,Hai An District,12,23,22,1,0
2021-12-27,Hai Phong City,Hai An District,13,15,14,1,0
2021-12-27,Hai Phong City,Hai An District,14,13,12,1,0
2021-12-27,Hai Phong City,Hai An District,15,28,21,7,2
2021-12-27,Hai Phong City,Hai An District,16,42,32,10,0
2021-12-27,Hai Phong City,Hai An District,17,24,19,5,1
2021-12-27,Hai Phong City,Hai An District,18,30,23,7,3
2021-12-27,Hai Phong City,Hai An District,19,32,24,8,2
2021-12-27,Hai Phong City,Hai An District,20,17,12,5,0
2021-12-27,Hai Phong City,Hai An District,21,17,11,6,1
2021-12-27,Hai Phong City,Hong Bang District,3,1,1,0,0
2021-12-27,Hai Phong City,Hong Bang District,7,22,13,9,8
2021-12-27,Hai Phong City,Hong Bang District,8,42,29,13,6
2021-12-27,Hai Phong City,Hong Bang District,9,41,36,5,1
2021-12-27,Hai Phong City,Hong Bang District,10,58,50,8,0
2021-12-27,Hai Phong City,Hong Bang District,11,124,102,22,8
2021-12-27,Hai Phong City,Hong Bang District,12,68,58,10,3
2021-12-27,Hai Phong City,Hong Bang District,13,36,35,1,1
2021-12-27,Hai Phong City,Hong Bang District,14,54,51,3,0
2021-12-27,Hai Phong City,Hong Bang District,15,47,44,3,2
2021-12-27,Hai Phong City,Hong Bang District,16,56,47,9,3
2021-12-27,Hai Phong City,Hong Bang District,17,54,42,12,2
2021-12-27,Hai Phong City,Hong Bang District,18,63,59,4,1
2021-12-27,Hai Phong City,Hong Bang District,19,80,64,16,6
2021-12-27,Hai Phong City,Hong Bang District,20,46,37,9,7
2021-12-27,Hai Phong City,Hong Bang District,21,19,13,6,3
2021-12-27,Hai Phong City,Kien An District,8,4,0,4,3
2021-12-27,Hai Phong City,Kien An District,9,9,4,5,4
2021-12-27,Hai Phong City,Kien An District,10,4,2,2,1
2021-12-27,Hai Phong City,Kien An District,11,14,10,4,3
2021-12-27,Hai Phong City,Kien An District,12,7,5,2,0
2021-12-27,Hai Phong City,Kien An District,13,6,4,2,0
2021-12-27,Hai Phong City,Kien An District,14,2,2,0,0
2021-12-27,Hai Phong City,Kien An District,15,10,10,0,0
2021-12-27,Hai Phong City,Kien An District,16,9,2,7,6
2021-12-27,Hai Phong City,Kien An District,17,8,5,3,2
2021-12-27,Hai Phong City,Kien An District,18,9,4,5,4
2021-12-27,Hai Phong City,Kien An District,19,6,4,2,2
2021-12-27,Hai Phong City,Kien An District,20,5,3,2,2
2021-12-27,Hai Phong City,Kien An District,21,3,2,1,1
2021-12-27,Hai Phong City,Le Chan District,0,3,1,2,1
2021-12-27,Hai Phong City,Le Chan District,2,1,0,1,0
2021-12-27,Hai Phong City,Le Chan District,4,1,0,1,0
2021-12-27,Hai Phong City,Le Chan District,5,1,1,0,0
2021-12-27,Hai Phong City,Le Chan District,6,7,1,6,3
2021-12-27,Hai Phong City,Le Chan District,7,54,23,31,17
2021-12-27,Hai Phong City,Le Chan District,8,113,83,30,16
2021-12-27,Hai Phong City,Le Chan District,9,83,75,8,0
2021-12-27,Hai Phong City,Le Chan District,10,172,149,23,2
2021-12-27,Hai Phong City,Le Chan District,11,320,283,37,20
2021-12-27,Hai Phong City,Le Chan District,12,227,206,21,4
2021-12-27,Hai Phong City,Le Chan District,13,116,113,3,0
2021-12-27,Hai Phong City,Le Chan District,14,146,133,13,0
2021-12-27,Hai Phong City,Le Chan District,15,205,177,28,4
2021-12-27,Hai Phong City,Le Chan District,16,206,177,29,6
2021-12-27,Hai Phong City,Le Chan District,17,244,213,31,3
2021-12-27,Hai Phong City,Le Chan District,18,250,224,26,9
2021-12-27,Hai Phong City,Le Chan District,19,218,187,31,3
2021-12-27,Hai Phong City,Le Chan District,20,151,130,21,11
2021-12-27,Hai Phong City,Le Chan District,21,98,62,36,13
2021-12-27,Hai Phong City,Le Chan District,22,1,1,0,0
2021-12-27,Hai Phong City,Ngo Quyen District,0,2,0,2,2
2021-12-27,Hai Phong City,Ngo Quyen District,1,1,1,0,0
2021-12-27,Hai Phong City,Ngo Quyen District,3,1,0,1,0
2021-12-27,Hai Phong City,Ngo Quyen District,7,29,14,15,9
2021-12-27,Hai Phong City,Ngo Quyen District,8,96,63,33,23
2021-12-27,Hai Phong City,Ngo Quyen District,9,89,81,8,1
2021-12-27,Hai Phong City,Ngo Quyen District,10,90,77,13,1
2021-12-27,Hai Phong City,Ngo Quyen District,11,258,226,32,11
2021-12-27,Hai Phong City,Ngo Quyen District,12,198,179,19,1
2021-12-27,Hai Phong City,Ngo Quyen District,13,120,114,6,2
2021-12-27,Hai Phong City,Ngo Quyen District,14,121,100,21,2
2021-12-27,Hai Phong City,Ngo Quyen District,15,175,153,22,9
2021-12-27,Hai Phong City,Ngo Quyen District,16,170,144,26,5
2021-12-27,Hai Phong City,Ngo Quyen District,17,167,141,26,6
2021-12-27,Hai Phong City,Ngo Quyen District,18,190,162,28,7
2021-12-27,Hai Phong City,Ngo Quyen District,19,169,148,21,1
2021-12-27,Hai Phong City,Ngo Quyen District,20,146,119,27,11
2021-12-27,Hai Phong City,Ngo Quyen District,21,91,52,39,18
2021-12-27,Hai Phong City,Ngo Quyen District,22,1,1,0,0
2021-12-27,Hai Phong City,Ngo Quyen District,23,1,0,1,1
2021-12-27,Hai Phong City,Thuy Nguyen,5,1,0,1,0
2021-12-27,Hai Phong City,Thuy Nguyen,8,1,0,1,1
2021-12-27,Hai Phong City,Thuy Nguyen,10,1,0,1,1
2021-12-27,Hai Phong City,Thuy Nguyen,12,1,0,1,1
2021-12-27,Hai Phong City,Thuy Nguyen,13,1,0,1,1
2021-12-27,Hai Phong City,Thuy Nguyen,15,2,0,2,2
2021-12-27,Hai Phong City,Thuy Nguyen,16,2,1,1,1
2021-12-27,Hai Phong City,Thuy Nguyen,19,2,0,2,2
2021-12-27,Hai Phong City,Thuy Nguyen,20,2,0,2,2
2021-12-27,Hue City,Hue City,0,10,7,3,0
2021-12-27,Hue City,Hue City,1,6,3,3,0
2021-12-27,Hue City,Hue City,2,2,1,1,0
2021-12-27,Hue City,Hue City,3,1,0,1,0
2021-12-27,Hue City,Hue City,4,2,1,1,0
2021-12-27,Hue City,Hue City,6,61,51,10,2
2021-12-27,Hue City,Hue City,7,254,227,27,0
2021-12-27,Hue City,Hue City,8,407,375,32,3
2021-12-27,Hue City,Hue City,9,337,308,29,1
2021-12-27,Hue City,Hue City,10,382,362,20,1
2021-12-27,Hue City,Hue City,11,733,695,38,0
2021-12-27,Hue City,Hue City,12,462,431,31,0
2021-12-27,Hue City,Hue City,13,397,368,29,3
2021-12-27,Hue City,Hue City,14,406,378,28,3
2021-12-27,Hue City,Hue City,15,531,495,36,3
2021-12-27,Hue City,Hue City,16,583,535,48,10
2021-12-27,Hue City,Hue City,17,687,629,58,11
2021-12-27,Hue City,Hue City,18,741,683,58,13
2021-12-27,Hue City,Hue City,19,684,599,85,16
2021-12-27,Hue City,Hue City,20,542,457,85,20
2021-12-27,Hue City,Hue City,21,238,217,21,4
2021-12-27,Hue City,Hue City,22,6,0,6,3
2021-12-27,Hue City,Hue City,23,5,2,3,2
2021-12-27,Hue City,Huong Thuy,8,1,1,0,0
2021-12-27,Hue City,Huong Thuy,9,1,0,1,0
2021-12-27,Hue City,Huong Thuy,14,1,1,0,0
2021-12-27,Hue City,Huong Thuy,17,3,1,2,1
2021-12-27,Hue City,Huong Thuy,18,2,2,0,0
2021-12-27,Hue City,Huong Thuy,19,2,2,0,0
2021-12-27,Hue City,Huong Thuy,20,1,1,0,0
2021-12-27,Hue City,Huong Thuy,21,1,0,1,0
2021-12-27,Hue City,Phu Vang,7,1,1,0,0
2021-12-27,Hue City,Phu Vang,8,1,1,0,0
2021-12-27,Hue City,Phu Vang,9,3,2,1,0
2021-12-27,Hue City,Phu Vang,13,1,1,0,0
2021-12-27,Hue City,Phu Vang,16,3,3,0,0
2021-12-27,Hue City,Phu Vang,18,1,1,0,0
2021-12-27,Hue City,Phu Vang,19,1,1,0,0
2021-12-27,Hue City,Phu Vang,20,2,1,1,1
2021-12-27,Hue City,Phu Vang,21,1,1,0,0
2021-12-27,Vung Tau,Ba Ria City,7,1,1,0,0
2021-12-27,Vung Tau,Ba Ria City,8,4,1,3,2
2021-12-27,Vung Tau,Ba Ria City,9,2,2,0,0
2021-12-27,Vung Tau,Ba Ria City,10,10,5,5,5
2021-12-27,Vung Tau,Ba Ria City,11,9,4,5,5
2021-12-27,Vung Tau,Ba Ria City,12,4,1,3,3
2021-12-27,Vung Tau,Ba Ria City,13,12,4,8,8
2021-12-27,Vung Tau,Ba Ria City,14,10,6,4,3
2021-12-27,Vung Tau,Ba Ria City,15,9,7,2,2
2021-12-27,Vung Tau,Ba Ria City,16,4,3,1,0
2021-12-27,Vung Tau,Ba Ria City,17,5,4,1,1
2021-12-27,Vung Tau,Ba Ria City,18,5,4,1,0
2021-12-27,Vung Tau,Ba Ria City,19,2,1,1,1
2021-12-27,Vung Tau,Ba Ria City,20,2,0,2,2
2021-12-27,Vung Tau,Tan Thanh,9,1,0,1,1
2021-12-27,Vung Tau,Tan Thanh,11,1,0,1,1
2021-12-27,Vung Tau,Vung Tau City,0,3,3,0,0
2021-12-27,Vung Tau,Vung Tau City,1,1,1,0,0
2021-12-27,Vung Tau,Vung Tau City,2,2,2,0,0
2021-12-27,Vung Tau,Vung Tau City,6,53,42,11,3
2021-12-27,Vung Tau,Vung Tau City,7,119,108,11,2
2021-12-27,Vung Tau,Vung Tau City,8,172,159,13,0
2021-12-27,Vung Tau,Vung Tau City,9,177,169,8,0
2021-12-27,Vung Tau,Vung Tau City,10,234,214,20,0
2021-12-27,Vung Tau,Vung Tau City,11,367,348,19,1
2021-12-27,Vung Tau,Vung Tau City,12,297,281,16,3
2021-12-27,Vung Tau,Vung Tau City,13,219,188,31,5
2021-12-27,Vung Tau,Vung Tau City,14,241,221,20,1
2021-12-27,Vung Tau,Vung Tau City,15,235,220,15,0
2021-12-27,Vung Tau,Vung Tau City,16,209,199,10,0
2021-12-27,Vung Tau,Vung Tau City,17,262,240,22,2
2021-12-27,Vung Tau,Vung Tau City,18,313,286,27,4
2021-12-27,Vung Tau,Vung Tau City,19,215,204,11,0
2021-12-27,Vung Tau,Vung Tau City,20,157,143,14,2
2021-12-27,Vung Tau,Vung Tau City,21,94,77,17,5
2021-12-27,Vung Tau,Vung Tau City,22,3,3,0,0
2021-12-27,Vung Tau,Vung Tau City,23,4,1,3,0
2021-12-28,Binh Duong,Ben Cat,17,1,1,0,0
2021-12-28,Binh Duong,Di An,4,1,0,1,0
2021-12-28,Binh Duong,Di An,7,1,0,1,1
2021-12-28,Binh Duong,Di An,8,6,3,3,3
2021-12-28,Binh Duong,Di An,9,6,2,4,1
2021-12-28,Binh Duong,Di An,10,15,10,5,1
2021-12-28,Binh Duong,Di An,11,16,13,3,0
2021-12-28,Binh Duong,Di An,12,13,5,8,6
2021-12-28,Binh Duong,Di An,13,17,8,9,8
2021-12-28,Binh Duong,Di An,14,20,15,5,3
2021-12-28,Binh Duong,Di An,15,11,7,4,3
2021-12-28,Binh Duong,Di An,16,16,9,7,5
2021-12-28,Binh Duong,Di An,17,6,2,4,3
2021-12-28,Binh Duong,Di An,18,19,0,19,18
2021-12-28,Binh Duong,Di An,19,20,3,17,17
2021-12-28,Binh Duong,Di An,20,15,3,12,10
2021-12-28,Binh Duong,Di An,21,2,0,2,2
2021-12-28,Binh Duong,Di An,22,1,0,1,0
2021-12-28,Binh Duong,Tan Uyen,10,1,0,1,1
2021-12-28,Binh Duong,Tan Uyen,11,3,2,1,0
2021-12-28,Binh Duong,Tan Uyen,12,1,1,0,0
2021-12-28,Binh Duong,Tan Uyen,13,1,0,1,1
2021-12-28,Binh Duong,Tan Uyen,14,1,0,1,1
2021-12-28,Binh Duong,Tan Uyen,16,1,1,0,0
2021-12-28,Binh Duong,Tan Uyen,17,2,0,2,1
2021-12-28,Binh Duong,Tan Uyen,20,1,0,1,1
2021-12-28,Binh Duong,Thu Dau Mot Town,1,1,1,0,0
2021-12-28,Binh Duong,Thu Dau Mot Town,2,1,0,1,0
2021-12-28,Binh Duong,Thu Dau Mot Town,3,1,1,0,0
2021-12-28,Binh Duong,Thu Dau Mot Town,5,3,1,2,1
2021-12-28,Binh Duong,Thu Dau Mot Town,6,43,35,8,6
2021-12-28,Binh Duong,Thu Dau Mot Town,7,135,121,14,5
2021-12-28,Binh Duong,Thu Dau Mot Town,8,209,200,9,1
2021-12-28,Binh Duong,Thu Dau Mot Town,9,215,197,18,6
2021-12-28,Binh Duong,Thu Dau Mot Town,10,324,304,20,2
2021-12-28,Binh Duong,Thu Dau Mot Town,11,581,536,45,5
2021-12-28,Binh Duong,Thu Dau Mot Town,12,419,396,23,1
2021-12-28,Binh Duong,Thu Dau Mot Town,13,353,341,12,5
2021-12-28,Binh Duong,Thu Dau Mot Town,14,308,284,24,5
2021-12-28,Binh Duong,Thu Dau Mot Town,15,296,274,22,2
2021-12-28,Binh Duong,Thu Dau Mot Town,16,290,264,26,5
2021-12-28,Binh Duong,Thu Dau Mot Town,17,334,312,22,4
2021-12-28,Binh Duong,Thu Dau Mot Town,18,350,327,23,9
2021-12-28,Binh Duong,Thu Dau Mot Town,19,317,289,28,5
2021-12-28,Binh Duong,Thu Dau Mot Town,20,209,198,11,2
2021-12-28,Binh Duong,Thu Dau Mot Town,21,92,75,17,2
2021-12-28,Binh Duong,Thu Dau Mot Town,22,2,2,0,0
2021-12-28,Binh Duong,Thu Dau Mot Town,23,1,0,1,0
2021-12-28,Binh Duong,Thuan An,6,3,1,2,2
2021-12-28,Binh Duong,Thuan An,7,2,1,1,1
2021-12-28,Binh Duong,Thuan An,8,14,5,9,7
2021-12-28,Binh Duong,Thuan An,9,30,9,21,19
2021-12-28,Binh Duong,Thuan An,10,74,39,35,31
2021-12-28,Binh Duong,Thuan An,11,83,50,33,28
2021-12-28,Binh Duong,Thuan An,12,51,42,9,6
2021-12-28,Binh Duong,Thuan An,13,41,30,11,9
2021-12-28,Binh Duong,Thuan An,14,41,27,14,11
2021-12-28,Binh Duong,Thuan An,15,56,32,24,18
2021-12-28,Binh Duong,Thuan An,16,29,18,11,8
2021-12-28,Binh Duong,Thuan An,17,34,23,11,7
2021-12-28,Binh Duong,Thuan An,18,44,21,23,18
2021-12-28,Binh Duong,Thuan An,19,31,26,5,3
2021-12-28,Binh Duong,Thuan An,20,21,8,13,12
2021-12-28,Binh Duong,Thuan An,21,12,3,9,6
2021-12-28,Binh Duong,Thuan An,22,1,0,1,0
2021-12-28,Binh Duong,Thuan An,23,1,1,0,0
2021-12-28,Can Tho City,Binh Thuy District,7,5,4,1,0
2021-12-28,Can Tho City,Binh Thuy District,8,2,2,0,0
2021-12-28,Can Tho City,Binh Thuy District,9,7,7,0,0
2021-12-28,Can Tho City,Binh Thuy District,10,8,8,0,0
2021-12-28,Can Tho City,Binh Thuy District,11,10,9,1,0
2021-12-28,Can Tho City,Binh Thuy District,12,12,12,0,0
2021-12-28,Can Tho City,Binh Thuy District,13,13,13,0,0
2021-12-28,Can Tho City,Binh Thuy District,14,9,9,0,0
2021-12-28,Can Tho City,Binh Thuy District,15,6,5,1,0
2021-12-28,Can Tho City,Binh Thuy District,16,14,14,0,0
2021-12-28,Can Tho City,Binh Thuy District,17,10,10,0,0
2021-12-28,Can Tho City,Binh Thuy District,18,7,7,0,0
2021-12-28,Can Tho City,Binh Thuy District,19,4,4,0,0
2021-12-28,Can Tho City,Binh Thuy District,20,6,5,1,0
2021-12-28,Can Tho City,Binh Thuy District,21,2,1,1,1
2021-12-28,Can Tho City,Cai Rang District,7,4,4,0,0
2021-12-28,Can Tho City,Cai Rang District,8,3,2,1,1
2021-12-28,Can Tho City,Cai Rang District,9,10,10,0,0
2021-12-28,Can Tho City,Cai Rang District,10,8,7,1,1
2021-12-28,Can Tho City,Cai Rang District,11,13,13,0,0
2021-12-28,Can Tho City,Cai Rang District,12,10,9,1,0
2021-12-28,Can Tho City,Cai Rang District,13,10,9,1,0
2021-12-28,Can Tho City,Cai Rang District,14,7,6,1,0
2021-12-28,Can Tho City,Cai Rang District,15,11,9,2,1
2021-12-28,Can Tho City,Cai Rang District,16,5,5,0,0
2021-12-28,Can Tho City,Cai Rang District,17,7,7,0,0
2021-12-28,Can Tho City,Cai Rang District,18,7,6,1,0
2021-12-28,Can Tho City,Cai Rang District,19,13,11,2,0
2021-12-28,Can Tho City,Cai Rang District,20,8,7,1,0
2021-12-28,Can Tho City,Cai Rang District,21,5,3,2,1
2021-12-28,Can Tho City,Ninh Kieu District,0,2,1,1,0
2021-12-28,Can Tho City,Ninh Kieu District,1,7,5,2,0
2021-12-28,Can Tho City,Ninh Kieu District,2,3,3,0,0
2021-12-28,Can Tho City,Ninh Kieu District,4,2,2,0,0
2021-12-28,Can Tho City,Ninh Kieu District,5,1,1,0,0
2021-12-28,Can Tho City,Ninh Kieu District,6,46,44,2,0
2021-12-28,Can Tho City,Ninh Kieu District,7,146,137,9,0
2021-12-28,Can Tho City,Ninh Kieu District,8,242,228,14,0
2021-12-28,Can Tho City,Ninh Kieu District,9,270,256,14,0
2021-12-28,Can Tho City,Ninh Kieu District,10,426,408,18,0
2021-12-28,Can Tho City,Ninh Kieu District,11,694,672,22,0
2021-12-28,Can Tho City,Ninh Kieu District,12,536,508,28,0
2021-12-28,Can Tho City,Ninh Kieu District,13,418,399,19,0
2021-12-28,Can Tho City,Ninh Kieu District,14,322,302,20,0
2021-12-28,Can Tho City,Ninh Kieu District,15,329,305,24,0
2021-12-28,Can Tho City,Ninh Kieu District,16,396,375,21,0
2021-12-28,Can Tho City,Ninh Kieu District,17,431,397,34,0
2021-12-28,Can Tho City,Ninh Kieu District,18,446,430,16,0
2021-12-28,Can Tho City,Ninh Kieu District,19,386,354,32,0
2021-12-28,Can Tho City,Ninh Kieu District,20,264,239,25,0
2021-12-28,Can Tho City,Ninh Kieu District,21,140,117,23,1
2021-12-28,Can Tho City,Ninh Kieu District,22,1,0,1,0
2021-12-28,Can Tho City,Ninh Kieu District,23,3,2,1,0
2021-12-28,Dong Nai,Bien Hoa City,0,5,4,1,0
2021-12-28,Dong Nai,Bien Hoa City,1,1,1,0,0
2021-12-28,Dong Nai,Bien Hoa City,2,2,1,1,0
2021-12-28,Dong Nai,Bien Hoa City,3,2,1,1,0
2021-12-28,Dong Nai,Bien Hoa City,4,2,1,1,0
2021-12-28,Dong Nai,Bien Hoa City,5,1,0,1,1
2021-12-28,Dong Nai,Bien Hoa City,6,52,35,17,13
2021-12-28,Dong Nai,Bien Hoa City,7,157,131,26,11
2021-12-28,Dong Nai,Bien Hoa City,8,291,258,33,11
2021-12-28,Dong Nai,Bien Hoa City,9,382,351,31,7
2021-12-28,Dong Nai,Bien Hoa City,10,661,615,46,8
2021-12-28,Dong Nai,Bien Hoa City,11,933,861,72,16
2021-12-28,Dong Nai,Bien Hoa City,12,749,696,53,3
2021-12-28,Dong Nai,Bien Hoa City,13,631,589,42,8
2021-12-28,Dong Nai,Bien Hoa City,14,555,515,40,9
2021-12-28,Dong Nai,Bien Hoa City,15,451,412,39,2
2021-12-28,Dong Nai,Bien Hoa City,16,498,460,38,5
2021-12-28,Dong Nai,Bien Hoa City,17,525,488,37,9
2021-12-28,Dong Nai,Bien Hoa City,18,618,569,49,5
2021-12-28,Dong Nai,Bien Hoa City,19,560,523,37,11
2021-12-28,Dong Nai,Bien Hoa City,20,425,380,45,14
2021-12-28,Dong Nai,Bien Hoa City,21,223,168,55,33
2021-12-28,Dong Nai,Bien Hoa City,22,2,2,0,0
2021-12-28,Dong Nai,Long Thanh,8,2,0,2,2
2021-12-28,Dong Nai,Long Thanh,9,2,0,2,2
2021-12-28,Dong Nai,Long Thanh,10,1,0,1,1
2021-12-28,Dong Nai,Long Thanh,14,2,0,2,1
2021-12-28,Dong Nai,Long Thanh,19,1,0,1,1
2021-12-28,Dong Nai,Long Thanh,21,1,0,1,1
2021-12-28,Dong Nai,Thong Nhat,7,1,1,0,0
2021-12-28,Dong Nai,Thong Nhat,10,1,1,0,0
2021-12-28,Dong Nai,Thong Nhat,11,1,1,0,0
2021-12-28,Dong Nai,Thong Nhat,12,1,1,0,0
2021-12-28,Dong Nai,Thong Nhat,13,1,1,0,0
2021-12-28,Dong Nai,Thong Nhat,14,2,2,0,0
2021-12-28,Dong Nai,Thong Nhat,15,1,1,0,0
2021-12-28,Dong Nai,Thong Nhat,17,1,1,0,0
2021-12-28,Dong Nai,Thong Nhat,19,2,2,0,0
2021-12-28,Dong Nai,Thong Nhat,20,1,1,0,0
2021-12-28,Dong Nai,Thong Nhat,21,1,1,0,0
2021-12-28,Dong Nai,Trang Bom,9,1,0,1,1
2021-12-28,Dong Nai,Trang Bom,11,1,0,1,1
2021-12-28,Dong Nai,Trang Bom,13,1,0,1,1
2021-12-28,Dong Nai,Trang Bom,16,1,0,1,1
2021-12-28,Dong Nai,Trang Bom,19,1,0,1,1
2021-12-28,Hai Phong City,An Duong,8,5,3,2,0
2021-12-28,Hai Phong City,An Duong,9,6,4,2,0
2021-12-28,Hai Phong City,An Duong,10,1,1,0,0
2021-12-28,Hai Phong City,An Duong,11,3,0,3,2
2021-12-28,Hai Phong City,An Duong,13,2,1,1,0
2021-12-28,Hai Phong City,An Duong,14,2,2,0,0
2021-12-28,Hai Phong City,An Duong,15,3,2,1,1
2021-12-28,Hai Phong City,An Duong,17,3,1,2,1
2021-12-28,Hai Phong City,An Duong,18,2,2,0,0
2021-12-28,Hai Phong City,An Duong,20,1,1,0,0
2021-12-28,Hai Phong City,Do Son District,18,1,0,1,1
2021-12-28,Hai Phong City,Duong Kinh District,20,1,0,1,1
2021-12-28,Hai Phong City,Hai An District,0,1,0,1,0
2021-12-28,Hai Phong City,Hai An District,7,8,5,3,2
2021-12-28,Hai Phong City,Hai An District,8,10,8,2,2
2021-12-28,Hai Phong City,Hai An District,9,6,5,1,0
2021-12-28,Hai Phong City,Hai An District,10,12,9,3,0
2021-12-28,Hai Phong City,Hai An District,11,49,41,8,5
2021-12-28,Hai Phong City,Hai An District,12,21,18,3,0
2021-12-28,Hai Phong City,Hai An District,13,20,17,3,0
2021-12-28,Hai Phong City,Hai An District,14,13,10,3,0
2021-12-28,Hai Phong City,Hai An District,15,23,16,7,4
2021-12-28,Hai Phong City,Hai An District,16,23,18,5,2
2021-12-28,Hai Phong City,Hai An District,17,22,21,1,1
2021-12-28,Hai Phong City,Hai An District,18,39,37,2,0
2021-12-28,Hai Phong City,Hai An District,19,16,14,2,0
2021-12-28,Hai Phong City,Hai An District,20,14,12,2,1
2021-12-28,Hai Phong City,Hai An District,21,10,4,6,3
2021-12-28,Hai Phong City,Hong Bang District,0,1,0,1,1
2021-12-28,Hai Phong City,Hong Bang District,1,1,1,0,0
2021-12-28,Hai Phong City,Hong Bang District,3,1,0,1,1
2021-12-28,Hai Phong City,Hong Bang District,6,1,0,1,1
2021-12-28,Hai Phong City,Hong Bang District,7,13,10,3,3
2021-12-28,Hai Phong City,Hong Bang District,8,60,37,23,11
2021-12-28,Hai Phong City,Hong Bang District,9,46,40,6,5
2021-12-28,Hai Phong City,Hong Bang District,10,51,49,2,0
2021-12-28,Hai Phong City,Hong Bang District,11,125,107,18,8
2021-12-28,Hai Phong City,Hong Bang District,12,73,64,9,2
2021-12-28,Hai Phong City,Hong Bang District,13,51,51,0,0
2021-12-28,Hai Phong City,Hong Bang District,14,63,58,5,0
2021-12-28,Hai Phong City,Hong Bang District,15,74,64,10,5
2021-12-28,Hai Phong City,Hong Bang District,16,50,40,10,0
2021-12-28,Hai Phong City,Hong Bang District,17,63,54,9,3
2021-12-28,Hai Phong City,Hong Bang District,18,75,63,12,3
2021-12-28,Hai Phong City,Hong Bang District,19,79,71,8,1
2021-12-28,Hai Phong City,Hong Bang District,20,49,39,10,3
2021-12-28,Hai Phong City,Hong Bang District,21,18,14,4,0
2021-12-28,Hai Phong City,Kien An District,8,5,2,3,3
2021-12-28,Hai Phong City,Kien An District,9,3,1,2,2
2021-12-28,Hai Phong City,Kien An District,10,10,5,5,2
2021-12-28,Hai Phong City,Kien An District,11,10,9,1,1
2021-12-28,Hai Phong City,Kien An District,12,9,7,2,0
2021-12-28,Hai Phong City,Kien An District,13,21,5,16,12
2021-12-28,Hai Phong City,Kien An District,14,14,7,7,6
2021-12-28,Hai Phong City,Kien An District,15,11,5,6,4
2021-12-28,Hai Phong City,Kien An District,16,7,5,2,1
2021-12-28,Hai Phong City,Kien An District,17,7,3,4,2
2021-12-28,Hai Phong City,Kien An District,18,8,6,2,2
2021-12-28,Hai Phong City,Kien An District,19,5,5,0,0
2021-12-28,Hai Phong City,Kien An District,20,4,2,2,2
2021-12-28,Hai Phong City,Kien An District,21,4,2,2,2
2021-12-28,Hai Phong City,Le Chan District,0,1,1,0,0
2021-12-28,Hai Phong City,Le Chan District,2,1,1,0,0
2021-12-28,Hai Phong City,Le Chan District,7,55,40,15,4
2021-12-28,Hai Phong City,Le Chan District,8,118,101,17,12
2021-12-28,Hai Phong City,Le Chan District,9,114,93,21,6
2021-12-28,Hai Phong City,Le Chan District,10,185,169,16,0
2021-12-28,Hai Phong City,Le Chan District,11,363,318,45,18
2021-12-28,Hai Phong City,Le Chan District,12,243,222,21,2
2021-12-28,Hai Phong City,Le Chan District,13,108,94,14,0
2021-12-28,Hai Phong City,Le Chan District,14,172,149,23,1
2021-12-28,Hai Phong City,Le Chan District,15,212,176,36,10
2021-12-28,Hai Phong City,Le Chan District,16,208,175,33,2
2021-12-28,Hai Phong City,Le Chan District,17,218,204,14,2
2021-12-28,Hai Phong City,Le Chan District,18,250,231,19,4
2021-12-28,Hai Phong City,Le Chan District,19,212,192,20,1
2021-12-28,Hai Phong City,Le Chan District,20,154,129,25,3
2021-12-28,Hai Phong City,Le Chan District,21,69,54,15,3
2021-12-28,Hai Phong City,Le Chan District,22,2,1,1,1
2021-12-28,Hai Phong City,Le Chan District,23,1,0,1,0
2021-12-28,Hai Phong City,Ngo Quyen District,0,2,1,1,0
2021-12-28,Hai Phong City,Ngo Quyen District,2,1,0,1,0
2021-12-28,Hai Phong City,Ngo Quyen District,6,2,0,2,1
2021-12-28,Hai Phong City,Ngo Quyen District,7,29,17,12,8
2021-12-28,Hai Phong City,Ngo Quyen District,8,106,71,35,18
2021-12-28,Hai Phong City,Ngo Quyen District,9,101,92,9,2
2021-12-28,Hai Phong City,Ngo Quyen District,10,120,105,15,3
2021-12-28,Hai Phong City,Ngo Quyen District,11,271,237,34,12
2021-12-28,Hai Phong City,Ngo Quyen District,12,187,169,18,1
2021-12-28,Hai Phong City,Ngo Quyen District,13,156,140,16,0
2021-12-28,Hai Phong City,Ngo Quyen District,14,156,136,20,0
2021-12-28,Hai Phong City,Ngo Quyen District,15,184,159,25,10
2021-12-28,Hai Phong City,Ngo Quyen District,16,200,172,28,4
2021-12-28,Hai Phong City,Ngo Quyen District,17,166,142,24,6
2021-12-28,Hai Phong City,Ngo Quyen District,18,176,155,21,7
2021-12-28,Hai Phong City,Ngo Quyen District,19,167,147,20,3
2021-12-28,Hai Phong City,Ngo Quyen District,20,146,125,21,2
2021-12-28,Hai Phong City,Ngo Quyen District,21,76,61,15,3
2021-12-28,Hai Phong City,Ngo Quyen District,22,5,1,4,2
2021-12-28,Hai Phong City,Thuy Nguyen,8,1,0,1,1
2021-12-28,Hai Phong City,Thuy Nguyen,11,1,0,1,1
2021-12-28,Hai Phong City,Thuy Nguyen,12,4,1,3,1
2021-12-28,Hai Phong City,Thuy Nguyen,15,1,0,1,1
2021-12-28,Hai Phong City,Thuy Nguyen,20,1,0,1,0
2021-12-28,Hai Phong City,Thuy Nguyen,21,1,0,1,0
2021-12-28,Hue City,Hue City,0,14,9,5,0
2021-12-28,Hue City,Hue City,1,1,0,1,1
2021-12-28,Hue City,Hue City,3,2,1,1,0
2021-12-28,Hue City,Hue City,4,1,0,1,1
2021-12-28,Hue City,Hue City,5,6,4,2,2
2021-12-28,Hue City,Hue City,6,103,64,39,24
2021-12-28,Hue City,Hue City,7,280,246,34,9
2021-12-28,Hue City,Hue City,8,412,387,25,0
2021-12-28,Hue City,Hue City,9,298,283,15,0
2021-12-28,Hue City,Hue City,10,366,340,26,1
2021-12-28,Hue City,Hue City,11,732,694,38,3
2021-12-28,Hue City,Hue City,12,478,454,24,0
2021-12-28,Hue City,Hue City,13,347,317,30,2
2021-12-28,Hue City,Hue City,14,354,331,23,1
2021-12-28,Hue City,Hue City,15,498,461,37,7
2021-12-28,Hue City,Hue City,16,531,488,43,5
2021-12-28,Hue City,Hue City,17,638,596,42,0
2021-12-28,Hue City,Hue City,18,713,676,37,2
2021-12-28,Hue City,Hue City,19,540,515,25,2
2021-12-28,Hue City,Hue City,20,481,424,57,17
2021-12-28,Hue City,Hue City,21,272,228,44,10
2021-12-28,Hue City,Hue City,22,9,1,8,0
2021-12-28,Hue City,Hue City,23,3,3,0,0
2021-12-28,Hue City,Huong Thuy,8,1,0,1,1
2021-12-28,Hue City,Huong Thuy,10,1,0,1,1
2021-12-28,Hue City,Huong Thuy,17,3,2,1,0
2021-12-28,Hue City,Huong Thuy,18,1,0,1,0
2021-12-28,Hue City,Huong Thuy,20,1,0,1,1
2021-12-28,Hue City,Huong Thuy,21,2,1,1,1
2021-12-28,Hue City,Huong Tra,16,2,0,2,1
2021-12-28,Hue City,Phu Vang,5,1,1,0,0
2021-12-28,Hue City,Phu Vang,6,2,1,1,1
2021-12-28,Hue City,Phu Vang,7,1,1,0,0
2021-12-28,Hue City,Phu Vang,8,1,0,1,0
2021-12-28,Hue City,Phu Vang,9,2,0,2,0
2021-12-28,Hue City,Phu Vang,10,2,1,1,0
2021-12-28,Hue City,Phu Vang,11,2,2,0,0
2021-12-28,Hue City,Phu Vang,13,2,2,0,0
2021-12-28,Hue City,Phu Vang,14,1,1,0,0
2021-12-28,Hue City,Phu Vang,15,2,2,0,0
2021-12-28,Hue City,Phu Vang,16,1,0,1,1
2021-12-28,Hue City,Phu Vang,17,7,6,1,0
2021-12-28,Hue City,Phu Vang,18,2,0,2,0
2021-12-28,Hue City,Phu Vang,20,2,0,2,0
2021-12-28,Vung Tau,Ba Ria City,6,5,0,5,4
2021-12-28,Vung Tau,Ba Ria City,7,2,1,1,1
2021-12-28,Vung Tau,Ba Ria City,8,4,3,1,0
2021-12-28,Vung Tau,Ba Ria City,9,6,5,1,1
2021-12-28,Vung Tau,Ba Ria City,10,10,5,5,3
2021-12-28,Vung Tau,Ba Ria City,11,3,2,1,1
2021-12-28,Vung Tau,Ba Ria City,12,4,3,1,0
2021-12-28,Vung Tau,Ba Ria City,13,5,2,3,0
2021-12-28,Vung Tau,Ba Ria City,14,5,3,2,0
2021-12-28,Vung Tau,Ba Ria City,15,9,4,5,3
2021-12-28,Vung Tau,Ba Ria City,16,4,1,3,0
2021-12-28,Vung Tau,Ba Ria City,17,20,6,14,10
2021-12-28,Vung Tau,Ba Ria City,18,8,5,3,1
2021-12-28,Vung Tau,Ba Ria City,19,3,3,0,0
2021-12-28,Vung Tau,Ba Ria City,20,6,2,4,4
2021-12-28,Vung Tau,Ba Ria City,21,6,1,5,5
2021-12-28,Vung Tau,Vung Tau City,0,2,2,0,0
2021-12-28,Vung Tau,Vung Tau City,2,2,2,0,0
2021-12-28,Vung Tau,Vung Tau City,5,1,0,1,0
2021-12-28,Vung Tau,Vung Tau City,6,46,43,3,2
2021-12-28,Vung Tau,Vung Tau City,7,130,119,11,0
2021-12-28,Vung Tau,Vung Tau City,8,184,174,10,0
2021-12-28,Vung Tau,Vung Tau City,9,164,150,14,0
2021-12-28,Vung Tau,Vung Tau City,10,162,150,12,0
2021-12-28,Vung Tau,Vung Tau City,11,297,281,16,0
2021-12-28,Vung Tau,Vung Tau City,12,223,213,10,0
2021-12-28,Vung Tau,Vung Tau City,13,225,207,18,2
2021-12-28,Vung Tau,Vung Tau City,14,214,194,20,1
2021-12-28,Vung Tau,Vung Tau City,15,226,203,23,1
2021-12-28,Vung Tau,Vung Tau City,16,188,176,12,0
2021-12-28,Vung Tau,Vung Tau City,17,268,252,16,0
2021-12-28,Vung Tau,Vung Tau City,18,304,268,36,5
2021-12-28,Vung Tau,Vung Tau City,19,219,196,23,3
2021-12-28,Vung Tau,Vung Tau City,20,209,181,28,2
2021-12-28,Vung Tau,Vung Tau City,21,79,66,13,3
2021-12-28,Vung Tau,Vung Tau City,22,2,1,1,0
2021-12-28,Vung Tau,Vung Tau City,23,5,4,1,0
2021-12-29,Binh Duong,Ben Cat,17,1,0,1,1
2021-12-29,Binh Duong,Ben Cat,18,1,1,0,0
2021-12-29,Binh Duong,Di An,7,2,1,1,1
2021-12-29,Binh Duong,Di An,8,10,2,8,8
2021-12-29,Binh Duong,Di An,9,7,0,7,3
2021-12-29,Binh Duong,Di An,10,8,4,4,4
2021-12-29,Binh Duong,Di An,11,9,6,3,2
2021-12-29,Binh Duong,Di An,12,12,7,5,3
2021-12-29,Binh Duong,Di An,13,11,7,4,3
2021-12-29,Binh Duong,Di An,14,17,5,12,8
2021-12-29,Binh Duong,Di An,15,12,4,8,4
2021-12-29,Binh Duong,Di An,16,14,4,10,9
2021-12-29,Binh Duong,Di An,17,15,11,4,4
2021-12-29,Binh Duong,Di An,18,8,4,4,2
2021-12-29,Binh Duong,Di An,19,12,6,6,6
2021-12-29,Binh Duong,Di An,20,9,3,6,5
2021-12-29,Binh Duong,Di An,21,1,0,1,1
2021-12-29,Binh Duong,Tan Uyen,8,1,0,1,0
2021-12-29,Binh Duong,Tan Uyen,11,1,0,1,1
2021-12-29,Binh Duong,Tan Uyen,12,2,2,0,0
2021-12-29,Binh Duong,Tan Uyen,13,1,0,1,1
2021-12-29,Binh Duong,Tan Uyen,15,2,0,2,2
2021-12-29,Binh Duong,Tan Uyen,16,2,1,1,1
2021-12-29,Binh Duong,Tan Uyen,17,1,1,0,0
2021-12-29,Binh Duong,Tan Uyen,19,1,0,1,1
2021-12-29,Binh Duong,Thu Dau Mot Town,0,4,2,2,0
2021-12-29,Binh Duong,Thu Dau Mot Town,2,2,1,1,0
2021-12-29,Binh Duong,Thu Dau Mot Town,5,1,1,0,0
2021-12-29,Binh Duong,Thu Dau Mot Town,6,22,20,2,2
2021-12-29,Binh Duong,Thu Dau Mot Town,7,103,97,6,3
2021-12-29,Binh Duong,Thu Dau Mot Town,8,224,209,15,3
2021-12-29,Binh Duong,Thu Dau Mot Town,9,194,183,11,1
2021-12-29,Binh Duong,Thu Dau Mot Town,10,338,318,20,4
2021-12-29,Binh Duong,Thu Dau Mot Town,11,591,547,44,11
2021-12-29,Binh Duong,Thu Dau Mot Town,12,422,399,23,3
2021-12-29,Binh Duong,Thu Dau Mot Town,13,302,291,11,5
2021-12-29,Binh Duong,Thu Dau Mot Town,14,263,250,13,1
2021-12-29,Binh Duong,Thu Dau Mot Town,15,228,219,9,1
2021-12-29,Binh Duong,Thu Dau Mot Town,16,242,228,14,4
2021-12-29,Binh Duong,Thu Dau Mot Town,17,326,311,15,2
2021-12-29,Binh Duong,Thu Dau Mot Town,18,333,310,23,2
2021-12-29,Binh Duong,Thu Dau Mot Town,19,254,242,12,4
2021-12-29,Binh Duong,Thu Dau Mot Town,20,172,155,17,6
2021-12-29,Binh Duong,Thu Dau Mot Town,21,89,75,14,0
2021-12-29,Binh Duong,Thu Dau Mot Town,22,3,2,1,0
2021-12-29,Binh Duong,Thu Dau Mot Town,23,1,1,0,0
2021-12-29,Binh Duong,Thuan An,1,1,0,1,1
2021-12-29,Binh Duong,Thuan An,7,10,0,10,9
2021-12-29,Binh Duong,Thuan An,8,21,4,17,14
2021-12-29,Binh Duong,Thuan An,9,36,19,17,14
2021-12-29,Binh Duong,Thuan An,10,66,39,27,24
2021-12-29,Binh Duong,Thuan An,11,70,38,32,25
2021-12-29,Binh Duong,Thuan An,12,51,37,14,10
2021-12-29,Binh Duong,Thuan An,13,51,34,17,11
2021-12-29,Binh Duong,Thuan An,14,57,39,18,14
2021-12-29,Binh Duong,Thuan An,15,38,25,13,8
2021-12-29,Binh Duong,Thuan An,16,28,23,5,3
2021-12-29,Binh Duong,Thuan An,17,33,19,14,11
2021-12-29,Binh Duong,Thuan An,18,31,23,8,2
2021-12-29,Binh Duong,Thuan An,19,17,9,8,6
2021-12-29,Binh Duong,Thuan An,20,21,11,10,8
2021-12-29,Binh Duong,Thuan An,21,13,4,9,7
2021-12-29,Binh Duong,Thuan An,22,1,0,1,0
2021-12-29,Can Tho City,Binh Thuy District,0,1,1,0,0
2021-12-29,Can Tho City,Binh Thuy District,6,2,1,1,1
2021-12-29,Can Tho City,Binh Thuy District,7,7,3,4,0
2021-12-29,Can Tho City,Binh Thuy District,8,6,5,1,0
2021-12-29,Can Tho City,Binh Thuy District,9,5,5,0,0
2021-12-29,Can Tho City,Binh Thuy District,10,6,6,0,0
2021-12-29,Can Tho City,Binh Thuy District,11,10,10,0,0
2021-12-29,Can Tho City,Binh Thuy District,12,7,7,0,0
2021-12-29,Can Tho City,Binh Thuy District,13,11,11,0,0
2021-12-29,Can Tho City,Binh Thuy District,14,16,16,0,0
2021-12-29,Can Tho City,Binh Thuy District,15,9,9,0,0
2021-12-29,Can Tho City,Binh Thuy District,16,7,7,0,0
2021-12-29,Can Tho City,Binh Thuy District,17,7,7,0,0
2021-12-29,Can Tho City,Binh Thuy District,18,16,13,3,0
2021-12-29,Can Tho City,Binh Thuy District,19,10,10,0,0
2021-12-29,Can Tho City,Binh Thuy District,20,9,7,2,0
2021-12-29,Can Tho City,Cai Rang District,6,4,4,0,0
2021-12-29,Can Tho City,Cai Rang District,8,6,5,1,0
2021-12-29,Can Tho City,Cai Rang District,9,6,6,0,0
2021-12-29,Can Tho City,Cai Rang District,10,11,10,1,0
2021-12-29,Can Tho City,Cai Rang District,11,11,9,2,0
2021-12-29,Can Tho City,Cai Rang District,12,9,5,4,2
2021-12-29,Can Tho City,Cai Rang District,13,9,9,0,0
2021-12-29,Can Tho City,Cai Rang District,14,12,11,1,0
2021-12-29,Can Tho City,Cai Rang District,15,5,4,1,0
2021-12-29,Can Tho City,Cai Rang District,16,12,9,3,3
2021-12-29,Can Tho City,Cai Rang District,17,6,6,0,0
2021-12-29,Can Tho City,Cai Rang District,18,8,8,0,0
2021-12-29,Can Tho City,Cai Rang District,19,7,7,0,0
2021-12-29,Can Tho City,Cai Rang District,20,6,4,2,0
2021-12-29,Can Tho City,Cai Rang District,21,2,2,0,0
2021-12-29,Can Tho City,Ninh Kieu District,0,11,6,5,0
2021-12-29,Can Tho City,Ninh Kieu District,1,3,3,0,0
2021-12-29,Can Tho City,Ninh Kieu District,2,1,1,0,0
2021-12-29,Can Tho City,Ninh Kieu District,3,1,1,0,0
2021-12-29,Can Tho City,Ninh Kieu District,5,2,2,0,0
2021-12-29,Can Tho City,Ninh Kieu District,6,49,47,2,0
2021-12-29,Can Tho City,Ninh Kieu District,7,168,157,11,0
2021-12-29,Can Tho City,Ninh Kieu District,8,255,234,21,0
2021-12-29,Can Tho City,Ninh Kieu District,9,282,261,21,0
2021-12-29,Can Tho City,Ninh Kieu District,10,473,450,23,0
2021-12-29,Can Tho City,Ninh Kieu District,11,712,686,26,0
2021-12-29,Can Tho City,Ninh Kieu District,12,468,456,12,0
2021-12-29,Can Tho City,Ninh Kieu District,13,377,354,23,0
2021-12-29,Can Tho City,Ninh Kieu District,14,342,330,12,0
2021-12-29,Can Tho City,Ninh Kieu District,15,322,308,14,0
2021-12-29,Can Tho City,Ninh Kieu District,16,409,380,29,0
2021-12-29,Can Tho City,Ninh Kieu District,17,514,493,21,0
2021-12-29,Can Tho City,Ninh Kieu District,18,482,459,23,0
2021-12-29,Can Tho City,Ninh Kieu District,19,400,383,17,1
2021-12-29,Can Tho City,Ninh Kieu District,20,295,258,37,0
2021-12-29,Can Tho City,Ninh Kieu District,21,152,137,15,0
2021-12-29,Can Tho City,Ninh Kieu District,22,5,5,0,0
2021-12-29,Can Tho City,Ninh Kieu District,23,3,3,0,0
2021-12-29,Dong Nai,Bien Hoa City,0,6,3,3,0
2021-12-29,Dong Nai,Bien Hoa City,1,2,1,1,0
2021-12-29,Dong Nai,Bien Hoa City,3,2,0,2,1
2021-12-29,Dong Nai,Bien Hoa City,5,1,0,1,0
2021-12-29,Dong Nai,Bien Hoa City,6,49,33,16,11
2021-12-29,Dong Nai,Bien Hoa City,7,148,120,28,12
2021-12-29,Dong Nai,Bien Hoa City,8,281,249,32,10
2021-12-29,Dong Nai,Bien Hoa City,9,350,309,41,4
2021-12-29,Dong Nai,Bien Hoa City,10,626,575,51,5
2021-12-29,Dong Nai,Bien Hoa City,11,945,862,83,14
2021-12-29,Dong Nai,Bien Hoa City,12,735,708,27,7
2021-12-29,Dong Nai,Bien Hoa City,13,733,677,56,13
2021-12-29,Dong Nai,Bien Hoa City,14,574,518,56,10
2021-12-29,Dong Nai,Bien Hoa City,15,477,425,52,16
2021-12-29,Dong Nai,Bien Hoa City,16,509,468,41,10
2021-12-29,Dong Nai,Bien Hoa City,17,531,489,42,9
2021-12-29,Dong Nai,Bien Hoa City,18,553,528,25,1
2021-12-29,Dong Nai,Bien Hoa City,19,544,503,41,11
2021-12-29,Dong Nai,Bien Hoa City,20,443,377,66,19
2021-12-29,Dong Nai,Bien Hoa City,21,184,136,48,20
2021-12-29,Dong Nai,Bien Hoa City,22,2,2,0,0
2021-12-29,Dong Nai,Bien Hoa City,23,1,1,0,0
2021-12-29,Dong Nai,Long Khanh,18,1,0,1,1
2021-12-29,Dong Nai,Long Thanh,9,1,0,1,1
2021-12-29,Dong Nai,Long Thanh,10,1,0,1,1
2021-12-29,Dong Nai,Long Thanh,11,2,0,2,2
2021-12-29,Dong Nai,Long Thanh,12,1,0,1,1
2021-12-29,Dong Nai,Long Thanh,15,1,0,1,1
2021-12-29,Dong Nai,Long Thanh,19,3,0,3,2
2021-12-29,Dong Nai,Thong Nhat,8,1,1,0,0
2021-12-29,Dong Nai,Thong Nhat,9,3,3,0,0
2021-12-29,Dong Nai,Thong Nhat,10,1,1,0,0
2021-12-29,Dong Nai,Thong Nhat,13,2,2,0,0
2021-12-29,Dong Nai,Thong Nhat,14,1,1,0,0
2021-12-29,Dong Nai,Thong Nhat,15,4,3,1,0
2021-12-29,Dong Nai,Thong Nhat,16,2,2,0,0
2021-12-29,Dong Nai,Thong Nhat,18,1,1,0,0
2021-12-29,Dong Nai,Thong Nhat,19,2,2,0,0
2021-12-29,Dong Nai,Trang Bom,10,1,0,1,1
2021-12-29,Dong Nai,Trang Bom,11,1,0,1,1
2021-12-29,Dong Nai,Trang Bom,12,1,0,1,1
2021-12-29,Hai Phong City,An Duong,5,1,0,1,1
2021-12-29,Hai Phong City,An Duong,8,1,1,0,0
2021-12-29,Hai Phong City,An Duong,12,1,1,0,0
2021-12-29,Hai Phong City,An Duong,13,3,1,2,1
2021-12-29,Hai Phong City,An Duong,14,3,1,2,1
2021-12-29,Hai Phong City,An Duong,15,2,1,1,0
2021-12-29,Hai Phong City,An Duong,16,4,2,2,2
2021-12-29,Hai Phong City,An Duong,17,2,1,1,1
2021-12-29,Hai Phong City,An Duong,18,4,1,3,1
2021-12-29,Hai Phong City,Duong Kinh District,9,2,1,1,0
2021-12-29,Hai Phong City,Hai An District,1,1,1,0,0
2021-12-29,Hai Phong City,Hai An District,6,1,1,0,0
2021-12-29,Hai Phong City,Hai An District,7,11,7,4,4
2021-12-29,Hai Phong City,Hai An District,8,12,9,3,1
2021-12-29,Hai Phong City,Hai An District,9,12,11,1,0
2021-12-29,Hai Phong City,Hai An District,10,23,19,4,0
2021-12-29,Hai Phong City,Hai An District,11,45,40,5,2
2021-12-29,Hai Phong City,Hai An District,12,31,27,4,0
2021-12-29,Hai Phong City,Hai An District,13,12,10,2,1
2021-12-29,Hai Phong City,Hai An District,14,21,17,4,0
2021-12-29,Hai Phong City,Hai An District,15,15,14,1,0
2021-12-29,Hai Phong City,Hai An District,16,23,19,4,0
2021-12-29,Hai Phong City,Hai An District,17,13,12,1,0
2021-12-29,Hai Phong City,Hai An District,18,31,27,4,1
2021-12-29,Hai Phong City,Hai An District,19,24,22,2,0
2021-12-29,Hai Phong City,Hai An District,20,18,17,1,0
2021-12-29,Hai Phong City,Hai An District,21,10,6,4,2
2021-12-29,Hai Phong City,Hai An District,23,1,1,0,0
2021-12-29,Hai Phong City,Hong Bang District,0,1,0,1,0
2021-12-29,Hai Phong City,Hong Bang District,6,1,0,1,0
2021-12-29,Hai Phong City,Hong Bang District,7,18,9,9,7
2021-12-29,Hai Phong City,Hong Bang District,8,52,38,14,10
2021-12-29,Hai Phong City,Hong Bang District,9,34,32,2,1
2021-12-29,Hai Phong City,Hong Bang District,10,58,55,3,0
2021-12-29,Hai Phong City,Hong Bang District,11,125,110,15,7
2021-12-29,Hai Phong City,Hong Bang District,12,76,70,6,0
2021-12-29,Hai Phong City,Hong Bang District,13,40,38,2,1
2021-12-29,Hai Phong City,Hong Bang District,14,32,31,1,0
2021-12-29,Hai Phong City,Hong Bang District,15,49,43,6,5
2021-12-29,Hai Phong City,Hong Bang District,16,58,41,17,2
2021-12-29,Hai Phong City,Hong Bang District,17,55,48,7,0
2021-12-29,Hai Phong City,Hong Bang District,18,65,59,6,2
2021-12-29,Hai Phong City,Hong Bang District,19,65,61,4,1
2021-12-29,Hai Phong City,Hong Bang District,20,49,39,10,1
2021-12-29,Hai Phong City,Hong Bang District,21,16,13,3,1
2021-12-29,Hai Phong City,Kien An District,7,3,1,2,1
2021-12-29,Hai Phong City,Kien An District,8,6,4,2,1
2021-12-29,Hai Phong City,Kien An District,9,9,6,3,2
2021-12-29,Hai Phong City,Kien An District,10,4,4,0,0
2021-12-29,Hai Phong City,Kien An District,11,8,5,3,1
2021-12-29,Hai Phong City,Kien An District,12,5,4,1,0
2021-12-29,Hai Phong City,Kien An District,13,11,6,5,3
2021-12-29,Hai Phong City,Kien An District,14,10,6,4,2
2021-12-29,Hai Phong City,Kien An District,15,8,4,4,3
2021-12-29,Hai Phong City,Kien An District,16,2,2,0,0
2021-12-29,Hai Phong City,Kien An District,17,6,5,1,1
2021-12-29,Hai Phong City,Kien An District,18,8,3,5,4
2021-12-29,Hai Phong City,Kien An District,19,8,4,4,3
2021-12-29,Hai Phong City,Kien An District,20,15,8,7,5
2021-12-29,Hai Phong City,Le Chan District,0,10,8,2,1
2021-12-29,Hai Phong City,Le Chan District,1,9,7,2,1
2021-12-29,Hai Phong City,Le Chan District,6,2,1,1,1
2021-12-29,Hai Phong City,Le Chan District,7,52,33,19,13
2021-12-29,Hai Phong City,Le Chan District,8,116,93,23,15
2021-12-29,Hai Phong City,Le Chan District,9,98,83,15,3
2021-12-29,Hai Phong City,Le Chan District,10,162,144,18,0
2021-12-29,Hai Phong City,Le Chan District,11,316,292,24,1
2021-12-29,Hai Phong City,Le Chan District,12,200,192,8,0
2021-12-29,Hai Phong City,Le Chan District,13,110,106,4,0
2021-12-29,Hai Phong City,Le Chan District,14,125,112,13,0
2021-12-29,Hai Phong City,Le Chan District,15,182,159,23,2
2021-12-29,Hai Phong City,Le Chan District,16,159,137,22,0
2021-12-29,Hai Phong City,Le Chan District,17,178,153,25,3
2021-12-29,Hai Phong City,Le Chan District,18,262,233,29,1
2021-12-29,Hai Phong City,Le Chan District,19,211,176,35,1
2021-12-29,Hai Phong City,Le Chan District,20,165,143,22,5
2021-12-29,Hai Phong City,Le Chan District,21,89,71,18,3
2021-12-29,Hai Phong City,Le Chan District,22,3,2,1,0
2021-12-29,Hai Phong City,Ngo Quyen District,0,2,1,1,1
2021-12-29,Hai Phong City,Ngo Quyen District,1,1,1,0,0
2021-12-29,Hai Phong City,Ngo Quyen District,4,1,0,1,0
2021-12-29,Hai Phong City,Ngo Quyen District,7,40,15,25,22
2021-12-29,Hai Phong City,Ngo Quyen District,8,106,78,28,14
2021-12-29,Hai Phong City,Ngo Quyen District,9,102,97,5,1
2021-12-29,Hai Phong City,Ngo Quyen District,10,130,120,10,1
2021-12-29,Hai Phong City,Ngo Quyen District,11,232,214,18,6
2021-12-29,Hai Phong City,Ngo Quyen District,12,177,159,18,0
2021-12-29,Hai Phong City,Ngo Quyen District,13,125,115,10,0
2021-12-29,Hai Phong City,Ngo Quyen District,14,128,116,12,0
2021-12-29,Hai Phong City,Ngo Quyen District,15,147,134,13,6
2021-12-29,Hai Phong City,Ngo Quyen District,16,135,129,6,0
2021-12-29,Hai Phong City,Ngo Quyen District,17,140,132,8,0
2021-12-29,Hai Phong City,Ngo Quyen District,18,187,172,15,1
2021-12-29,Hai Phong City,Ngo Quyen District,19,192,171,21,3
2021-12-29,Hai Phong City,Ngo Quyen District,20,130,115,15,2
2021-12-29,Hai Phong City,Ngo Quyen District,21,62,51,11,3
2021-12-29,Hai Phong City,Ngo Quyen District,22,1,0,1,1
2021-12-29,Hai Phong City,Thuy Nguyen,6,1,0,1,1
2021-12-29,Hai Phong City,Thuy Nguyen,8,1,0,1,1
2021-12-29,Hai Phong City,Thuy Nguyen,9,1,0,1,1
2021-12-29,Hai Phong City,Thuy Nguyen,12,2,0,2,2
2021-12-29,Hai Phong City,Thuy Nguyen,15,1,1,0,0
2021-12-29,Hai Phong City,Thuy Nguyen,17,1,0,1,1
2021-12-29,Hai Phong City,Thuy Nguyen,18,1,0,1,1
2021-12-29,Hai Phong City,Thuy Nguyen,19,1,0,1,1
2021-12-29,Hai Phong City,Thuy Nguyen,20,2,0,2,2
2021-12-29,Hai Phong City,Thuy Nguyen,21,1,0,1,1
2021-12-29,Hue City,Hue City,0,12,11,1,0
2021-12-29,Hue City,Hue City,1,12,10,2,0
2021-12-29,Hue City,Hue City,2,4,4,0,0
2021-12-29,Hue City,Hue City,4,1,1,0,0
2021-12-29,Hue City,Hue City,5,3,3,0,0
2021-12-29,Hue City,Hue City,6,73,62,11,1
2021-12-29,Hue City,Hue City,7,239,222,17,1
2021-12-29,Hue City,Hue City,8,402,377,25,3
2021-12-29,Hue City,Hue City,9,294,275,19,1
2021-12-29,Hue City,Hue City,10,400,384,16,1
2021-12-29,Hue City,Hue City,11,715,681,34,0
2021-12-29,Hue City,Hue City,12,514,480,34,0
2021-12-29,Hue City,Hue City,13,287,272,15,0
2021-12-29,Hue City,Hue City,14,367,344,23,1
2021-12-29,Hue City,Hue City,15,488,460,28,6
2021-12-29,Hue City,Hue City,16,526,491,35,4
2021-12-29,Hue City,Hue City,17,629,588,41,4
2021-12-29,Hue City,Hue City,18,668,619,49,7
2021-12-29,Hue City,Hue City,19,533,501,32,4
2021-12-29,Hue City,Hue City,20,440,402,38,4
2021-12-29,Hue City,Hue City,21,254,202,52,16
2021-12-29,Hue City,Hue City,22,6,4,2,0
2021-12-29,Hue City,Hue City,23,3,0,3,0
2021-12-29,Hue City,Huong Thuy,9,2,2,0,0
2021-12-29,Hue City,Huong Thuy,10,2,0,2,1
2021-12-29,Hue City,Huong Thuy,15,2,1,1,0
2021-12-29,Hue City,Huong Thuy,16,1,1,0,0
2021-12-29,Hue City,Huong Thuy,17,4,2,2,1
2021-12-29,Hue City,Huong Thuy,18,2,1,1,1
2021-12-29,Hue City,Huong Thuy,21,1,1,0,0
2021-12-29,Hue City,Huong Tra,21,1,1,0,0
2021-12-29,Hue City,Phu Vang,7,1,1,0,0
2021-12-29,Hue City,Phu Vang,8,3,2,1,0
2021-12-29,Hue City,Phu Vang,11,3,3,0,0
2021-12-29,Hue City,Phu Vang,12,1,1,0,0
2021-12-29,Hue City,Phu Vang,17,2,1,1,0
2021-12-29,Hue City,Phu Vang,18,3,3,0,0
2021-12-29,Vung Tau,Ba Ria City,8,2,2,0,0
2021-12-29,Vung Tau,Ba Ria City,9,8,6,2,1
2021-12-29,Vung Tau,Ba Ria City,10,14,6,8,7
2021-12-29,Vung Tau,Ba Ria City,11,8,5,3,3
2021-12-29,Vung Tau,Ba Ria City,12,4,3,1,0
2021-12-29,Vung Tau,Ba Ria City,13,7,4,3,2
2021-12-29,Vung Tau,Ba Ria City,14,5,2,3,3
2021-12-29,Vung Tau,Ba Ria City,15,11,5,6,6
2021-12-29,Vung Tau,Ba Ria City,16,9,5,4,2
2021-12-29,Vung Tau,Ba Ria City,17,6,4,2,1
2021-12-29,Vung Tau,Ba Ria City,18,14,3,11,7
2021-12-29,Vung Tau,Ba Ria City,19,9,4,5,4
2021-12-29,Vung Tau,Ba Ria City,21,1,1,0,0
2021-12-29,Vung Tau,Vung Tau City,0,8,5,3,1
2021-12-29,Vung Tau,Vung Tau City,1,5,5,0,0
2021-12-29,Vung Tau,Vung Tau City,5,4,2,2,0
2021-12-29,Vung Tau,Vung Tau City,6,47,39,8,3
2021-12-29,Vung Tau,Vung Tau City,7,122,109,13,1
2021-12-29,Vung Tau,Vung Tau City,8,152,141,11,0
2021-12-29,Vung Tau,Vung Tau City,9,172,151,21,2
2021-12-29,Vung Tau,Vung Tau City,10,176,152,24,2
2021-12-29,Vung Tau,Vung Tau City,11,334,315,19,2
2021-12-29,Vung Tau,Vung Tau City,12,247,232,15,0
2021-12-29,Vung Tau,Vung Tau City,13,214,204,10,1
2021-12-29,Vung Tau,Vung Tau City,14,227,211,16,1
2021-12-29,Vung Tau,Vung Tau City,15,195,186,9,1
2021-12-29,Vung Tau,Vung Tau City,16,189,177,12,0
2021-12-29,Vung Tau,Vung Tau City,17,259,244,15,4
2021-12-29,Vung Tau,Vung Tau City,18,301,272,29,4
2021-12-29,Vung Tau,Vung Tau City,19,239,216,23,3
2021-12-29,Vung Tau,Vung Tau City,20,154,141,13,0
2021-12-29,Vung Tau,Vung Tau City,21,73,61,12,0
2021-12-29,Vung Tau,Vung Tau City,22,4,1,3,0
2021-12-29,Vung Tau,Vung Tau City,23,2,1,1,0
2021-12-30,Binh Duong,Ben Cat,8,1,0,1,0
2021-12-30,Binh Duong,Ben Cat,10,1,0,1,1
2021-12-30,Binh Duong,Ben Cat,11,1,0,1,1
2021-12-30,Binh Duong,Ben Cat,14,1,1,0,0
2021-12-30,Binh Duong,Ben Cat,16,1,1,0,0
2021-12-30,Binh Duong,Ben Cat,17,1,1,0,0
2021-12-30,Binh Duong,Ben Cat,18,1,0,1,1
2021-12-30,Binh Duong,Ben Cat,19,1,0,1,1
2021-12-30,Binh Duong,Di An,7,2,0,2,1
2021-12-30,Binh Duong,Di An,8,9,1,8,8
2021-12-30,Binh Duong,Di An,9,12,6,6,5
2021-12-30,Binh Duong,Di An,10,7,6,1,1
2021-12-30,Binh Duong,Di An,11,21,15,6,5
2021-12-30,Binh Duong,Di An,12,15,10,5,2
2021-12-30,Binh Duong,Di An,13,16,10,6,5
2021-12-30,Binh Duong,Di An,14,18,13,5,4
2021-12-30,Binh Duong,Di An,15,16,9,7,5
2021-12-30,Binh Duong,Di An,16,11,6,5,5
2021-12-30,Binh Duong,Di An,17,7,5,2,2
2021-12-30,Binh Duong,Di An,18,7,5,2,2
2021-12-30,Binh Duong,Di An,19,13,3,10,9
2021-12-30,Binh Duong,Di An,20,7,1,6,5
2021-12-30,Binh Duong,Di An,21,3,0,3,3
2021-12-30,Binh Duong,Tan Uyen,10,1,0,1,1
2021-12-30,Binh Duong,Tan Uyen,11,5,3,2,2
2021-12-30,Binh Duong,Tan Uyen,13,2,0,2,2
2021-12-30,Binh Duong,Tan Uyen,14,1,1,0,0
2021-12-30,Binh Duong,Tan Uyen,16,1,1,0,0
2021-12-30,Binh Duong,Tan Uyen,18,1,1,0,0
2021-12-30,Binh Duong,Tan Uyen,19,3,1,2,2
2021-12-30,Binh Duong,Tan Uyen,20,1,0,1,1
2021-12-30,Binh Duong,Thu Dau Mot Town,0,2,1,1,0
2021-12-30,Binh Duong,Thu Dau Mot Town,2,1,1,0,0
2021-12-30,Binh Duong,Thu Dau Mot Town,5,1,0,1,0
2021-12-30,Binh Duong,Thu Dau Mot Town,6,29,26,3,1
2021-12-30,Binh Duong,Thu Dau Mot Town,7,92,85,7,0
2021-12-30,Binh Duong,Thu Dau Mot Town,8,190,181,9,1
2021-12-30,Binh Duong,Thu Dau Mot Town,9,196,184,12,3
2021-12-30,Binh Duong,Thu Dau Mot Town,10,321,299,22,3
2021-12-30,Binh Duong,Thu Dau Mot Town,11,523,489,34,7
2021-12-30,Binh Duong,Thu Dau Mot Town,12,414,390,24,1
2021-12-30,Binh Duong,Thu Dau Mot Town,13,346,323,23,2
2021-12-30,Binh Duong,Thu Dau Mot Town,14,274,257,17,3
2021-12-30,Binh Duong,Thu Dau Mot Town,15,187,180,7,0
2021-12-30,Binh Duong,Thu Dau Mot Town,16,253,233,20,6
2021-12-30,Binh Duong,Thu Dau Mot Town,17,300,283,17,1
2021-12-30,Binh Duong,Thu Dau Mot Town,18,357,333,24,4
2021-12-30,Binh Duong,Thu Dau Mot Town,19,235,223,12,3
2021-12-30,Binh Duong,Thu Dau Mot Town,20,166,143,23,5
2021-12-30,Binh Duong,Thu Dau Mot Town,21,79,61,18,5
2021-12-30,Binh Duong,Thu Dau Mot Town,23,1,1,0,0
2021-12-30,Binh Duong,Thuan An,0,1,0,1,1
2021-12-30,Binh Duong,Thuan An,6,2,0,2,1
2021-12-30,Binh Duong,Thuan An,7,6,1,5,3
2021-12-30,Binh Duong,Thuan An,8,17,8,9,7
2021-12-30,Binh Duong,Thuan An,9,41,20,21,17
2021-12-30,Binh Duong,Thuan An,10,56,35,21,15
2021-12-30,Binh Duong,Thuan An,11,71,53,18,10
2021-12-30,Binh Duong,Thuan An,12,35,25,10,5
2021-12-30,Binh Duong,Thuan An,13,37,27,10,6
2021-12-30,Binh Duong,Thuan An,14,42,23,19,14
2021-12-30,Binh Duong,Thuan An,15,27,18,9,7
2021-12-30,Binh Duong,Thuan An,16,30,20,10,6
2021-12-30,Binh Duong,Thuan An,17,39,26,13,11
2021-12-30,Binh Duong,Thuan An,18,22,13,9,5
2021-12-30,Binh Duong,Thuan An,19,28,21,7,2
2021-12-30,Binh Duong,Thuan An,20,21,13,8,3
2021-12-30,Binh Duong,Thuan An,21,10,7,3,3
2021-12-30,Binh Duong,Thuan An,22,1,0,1,1
2021-12-30,Can Tho City,Binh Thuy District,6,1,1,0,0
2021-12-30,Can Tho City,Binh Thuy District,7,2,1,1,0
2021-12-30,Can Tho City,Binh Thuy District,8,5,5,0,0
2021-12-30,Can Tho City,Binh Thuy District,9,6,5,1,0
2021-12-30,Can Tho City,Binh Thuy District,10,12,10,2,0
2021-12-30,Can Tho City,Binh Thuy District,11,3,3,0,0
2021-12-30,Can Tho City,Binh Thuy District,12,2,2,0,0
2021-12-30,Can Tho City,Binh Thuy District,13,5,5,0,0
2021-12-30,Can Tho City,Binh Thuy District,14,9,8,1,0
2021-12-30,Can Tho City,Binh Thuy District,15,10,9,1,0
2021-12-30,Can Tho City,Binh Thuy District,16,9,8,1,0
2021-12-30,Can Tho City,Binh Thuy District,17,10,9,1,0
2021-12-30,Can Tho City,Binh Thuy District,18,11,11,0,0
2021-12-30,Can Tho City,Binh Thuy District,19,13,13,0,0
2021-12-30,Can Tho City,Binh Thuy District,20,12,11,1,0
2021-12-30,Can Tho City,Binh Thuy District,21,3,3,0,0
2021-12-30,Can Tho City,Cai Rang District,7,3,2,1,0
2021-12-30,Can Tho City,Cai Rang District,8,6,6,0,0
2021-12-30,Can Tho City,Cai Rang District,10,10,10,0,0
2021-12-30,Can Tho City,Cai Rang District,11,11,11,0,0
2021-12-30,Can Tho City,Cai Rang District,12,5,4,1,1
2021-12-30,Can Tho City,Cai Rang District,13,12,10,2,1
2021-12-30,Can Tho City,Cai Rang District,14,5,5,0,0
2021-12-30,Can Tho City,Cai Rang District,15,13,12,1,0
2021-12-30,Can Tho City,Cai Rang District,16,11,7,4,0
2021-12-30,Can Tho City,Cai Rang District,17,8,6,2,1
2021-12-30,Can Tho City,Cai Rang District,18,9,7,2,0
2021-12-30,Can Tho City,Cai Rang District,19,11,10,1,0
2021-12-30,Can Tho City,Cai Rang District,20,6,5,1,0
2021-12-30,Can Tho City,Cai Rang District,21,1,1,0,0
2021-12-30,Can Tho City,Ninh Kieu District,0,20,15,5,0
2021-12-30,Can Tho City,Ninh Kieu District,1,2,1,1,0
2021-12-30,Can Tho City,Ninh Kieu District,2,1,1,0,0
2021-12-30,Can Tho City,Ninh Kieu District,3,3,3,0,0
2021-12-30,Can Tho City,Ninh Kieu District,5,1,1,0,0
2021-12-30,Can Tho City,Ninh Kieu District,6,58,55,3,1
2021-12-30,Can Tho City,Ninh Kieu District,7,176,170,6,0
2021-12-30,Can Tho City,Ninh Kieu District,8,238,222,16,0
2021-12-30,Can Tho City,Ninh Kieu District,9,270,258,12,0
2021-12-30,Can Tho City,Ninh Kieu District,10,449,437,12,1
2021-12-30,Can Tho City,Ninh Kieu District,11,663,638,25,0
2021-12-30,Can Tho City,Ninh Kieu District,12,489,472,17,0
2021-12-30,Can Tho City,Ninh Kieu District,13,372,356,16,0
2021-12-30,Can Tho City,Ninh Kieu District,14,311,297,14,0
2021-12-30,Can Tho City,Ninh Kieu District,15,271,256,15,0
2021-12-30,Can Tho City,Ninh Kieu District,16,324,313,11,0
2021-12-30,Can Tho City,Ninh Kieu District,17,412,395,17,0
2021-12-30,Can Tho City,Ninh Kieu District,18,408,387,21,0
2021-12-30,Can Tho City,Ninh Kieu District,19,327,309,18,0
2021-12-30,Can Tho City,Ninh Kieu District,20,237,218,19,0
2021-12-30,Can Tho City,Ninh Kieu District,21,129,103,26,0
2021-12-30,Can Tho City,Ninh Kieu District,22,5,4,1,0
2021-12-30,Can Tho City,Ninh Kieu District,23,3,3,0,0
2021-12-30,Dong Nai,Bien Hoa City,0,5,2,3,1
2021-12-30,Dong Nai,Bien Hoa City,1,1,1,0,0
2021-12-30,Dong Nai,Bien Hoa City,4,2,2,0,0
2021-12-30,Dong Nai,Bien Hoa City,5,1,0,1,1
2021-12-30,Dong Nai,Bien Hoa City,6,49,36,13,10
2021-12-30,Dong Nai,Bien Hoa City,7,148,122,26,9
2021-12-30,Dong Nai,Bien Hoa City,8,289,252,37,8
2021-12-30,Dong Nai,Bien Hoa City,9,360,326,34,2
2021-12-30,Dong Nai,Bien Hoa City,10,611,572,39,8
2021-12-30,Dong Nai,Bien Hoa City,11,942,866,76,10
2021-12-30,Dong Nai,Bien Hoa City,12,697,675,22,1
2021-12-30,Dong Nai,Bien Hoa City,13,669,637,32,5
2021-12-30,Dong Nai,Bien Hoa City,14,557,521,36,4
2021-12-30,Dong Nai,Bien Hoa City,15,440,407,33,2
2021-12-30,Dong Nai,Bien Hoa City,16,451,414,37,8
2021-12-30,Dong Nai,Bien Hoa City,17,515,471,44,6
2021-12-30,Dong Nai,Bien Hoa City,18,602,570,32,5
2021-12-30,Dong Nai,Bien Hoa City,19,556,510,46,8
2021-12-30,Dong Nai,Bien Hoa City,20,428,354,74,32
2021-12-30,Dong Nai,Bien Hoa City,21,171,121,50,15
2021-12-30,Dong Nai,Bien Hoa City,22,2,2,0,0
2021-12-30,Dong Nai,Bien Hoa City,23,4,2,2,0
2021-12-30,Dong Nai,Long Khanh,13,2,0,2,2
2021-12-30,Dong Nai,Long Khanh,18,1,0,1,1
2021-12-30,Dong Nai,Long Thanh,11,1,0,1,0
2021-12-30,Dong Nai,Long Thanh,15,2,0,2,2
2021-12-30,Dong Nai,Thong Nhat,8,2,2,0,0
2021-12-30,Dong Nai,Thong Nhat,9,1,1,0,0
2021-12-30,Dong Nai,Thong Nhat,12,1,1,0,0
2021-12-30,Dong Nai,Thong Nhat,13,2,2,0,0
2021-12-30,Dong Nai,Thong Nhat,14,3,3,0,0
2021-12-30,Dong Nai,Thong Nhat,16,1,1,0,0
2021-12-30,Dong Nai,Thong Nhat,17,3,3,0,0
2021-12-30,Dong Nai,Thong Nhat,18,1,1,0,0
2021-12-30,Dong Nai,Thong Nhat,19,1,1,0,0
2021-12-30,Dong Nai,Thong Nhat,21,1,0,1,0
2021-12-30,Dong Nai,Trang Bom,10,1,0,1,1
2021-12-30,Dong Nai,Trang Bom,12,1,0,1,1
2021-12-30,Dong Nai,Trang Bom,15,2,0,2,2
2021-12-30,Dong Nai,Trang Bom,16,1,0,1,1
2021-12-30,Hai Phong City,An Duong,5,1,0,1,0
2021-12-30,Hai Phong City,An Duong,7,1,0,1,0
2021-12-30,Hai Phong City,An Duong,8,5,2,3,2
2021-12-30,Hai Phong City,An Duong,9,5,2,3,1
2021-12-30,Hai Phong City,An Duong,10,5,4,1,1
2021-12-30,Hai Phong City,An Duong,11,4,2,2,2
2021-12-30,Hai Phong City,An Duong,13,3,1,2,2
2021-12-30,Hai Phong City,An Duong,14,5,4,1,0
2021-12-30,Hai Phong City,An Duong,15,1,0,1,0
2021-12-30,Hai Phong City,An Duong,16,1,1,0,0
2021-12-30,Hai Phong City,An Duong,17,4,2,2,0
2021-12-30,Hai Phong City,An Duong,19,1,1,0,0
2021-12-30,Hai Phong City,An Duong,21,1,0,1,1
2021-12-30,Hai Phong City,Do Son District,19,1,0,1,1
2021-12-30,Hai Phong City,Duong Kinh District,9,1,0,1,1
2021-12-30,Hai Phong City,Duong Kinh District,15,2,0,2,1
2021-12-30,Hai Phong City,Hai An District,7,6,3,3,1
2021-12-30,Hai Phong City,Hai An District,8,17,17,0,0
2021-12-30,Hai Phong City,Hai An District,9,11,11,0,0
2021-12-30,Hai Phong City,Hai An District,10,23,19,4,2
2021-12-30,Hai Phong City,Hai An District,11,56,47,9,2
2021-12-30,Hai Phong City,Hai An District,12,29,19,10,2
2021-12-30,Hai Phong City,Hai An District,13,6,4,2,0
2021-12-30,Hai Phong City,Hai An District,14,19,16,3,2
2021-12-30,Hai Phong City,Hai An District,15,19,15,4,3
2021-12-30,Hai Phong City,Hai An District,16,18,17,1,0
2021-12-30,Hai Phong City,Hai An District,17,13,10,3,2
2021-12-30,Hai Phong City,Hai An District,18,30,28,2,1
2021-12-30,Hai Phong City,Hai An District,19,20,17,3,0
2021-12-30,Hai Phong City,Hai An District,20,17,14,3,0
2021-12-30,Hai Phong City,Hai An District,21,3,1,2,1
2021-12-30,Hai Phong City,Hong Bang District,0,1,1,0,0
2021-12-30,Hai Phong City,Hong Bang District,2,1,0,1,1
2021-12-30,Hai Phong City,Hong Bang District,3,1,0,1,0
2021-12-30,Hai Phong City,Hong Bang District,6,1,0,1,0
2021-12-30,Hai Phong City,Hong Bang District,7,16,11,5,2
2021-12-30,Hai Phong City,Hong Bang District,8,46,35,11,4
2021-12-30,Hai Phong City,Hong Bang District,9,38,32,6,1
2021-12-30,Hai Phong City,Hong Bang District,10,62,56,6,0
2021-12-30,Hai Phong City,Hong Bang District,11,130,104,26,11
2021-12-30,Hai Phong City,Hong Bang District,12,73,64,9,2
2021-12-30,Hai Phong City,Hong Bang District,13,31,27,4,1
2021-12-30,Hai Phong City,Hong Bang District,14,46,39,7,2
2021-12-30,Hai Phong City,Hong Bang District,15,55,48,7,0
2021-12-30,Hai Phong City,Hong Bang District,16,54,46,8,0
2021-12-30,Hai Phong City,Hong Bang District,17,48,40,8,1
2021-12-30,Hai Phong City,Hong Bang District,18,62,53,9,1
2021-12-30,Hai Phong City,Hong Bang District,19,78,63,15,2
2021-12-30,Hai Phong City,Hong Bang District,20,36,29,7,0
2021-12-30,Hai Phong City,Hong Bang District,21,10,8,2,0
2021-12-30,Hai Phong City,Kien An District,7,1,0,1,1
2021-12-30,Hai Phong City,Kien An District,8,5,1,4,4
2021-12-30,Hai Phong City,Kien An District,9,5,3,2,1
2021-12-30,Hai Phong City,Kien An District,10,2,2,0,0
2021-12-30,Hai Phong City,Kien An District,11,16,8,8,7
2021-12-30,Hai Phong City,Kien An District,12,12,10,2,0
2021-12-30,Hai Phong City,Kien An District,13,5,4,1,1
2021-12-30,Hai Phong City,Kien An District,14,4,1,3,1
2021-12-30,Hai Phong City,Kien An District,15,6,4,2,1
2021-12-30,Hai Phong City,Kien An District,16,1,1,0,0
2021-12-30,Hai Phong City,Kien An District,17,10,6,4,2
2021-12-30,Hai Phong City,Kien An District,18,5,4,1,1
2021-12-30,Hai Phong City,Kien An District,19,8,6,2,0
2021-12-30,Hai Phong City,Kien An District,20,8,4,4,1
2021-12-30,Hai Phong City,Kien An District,21,2,1,1,1
2021-12-30,Hai Phong City,Le Chan District,0,21,19,2,2
2021-12-30,Hai Phong City,Le Chan District,1,1,0,1,1
2021-12-30,Hai Phong City,Le Chan District,3,2,0,2,0
2021-12-30,Hai Phong City,Le Chan District,5,1,1,0,0
2021-12-30,Hai Phong City,Le Chan District,6,4,2,2,1
2021-12-30,Hai Phong City,Le Chan District,7,40,29,11,7
2021-12-30,Hai Phong City,Le Chan District,8,92,76,16,12
2021-12-30,Hai Phong City,Le Chan District,9,91,77,14,2
2021-12-30,Hai Phong City,Le Chan District,10,149,135,14,1
2021-12-30,Hai Phong City,Le Chan District,11,364,299,65,33
2021-12-30,Hai Phong City,Le Chan District,12,198,179,19,4
2021-12-30,Hai Phong City,Le Chan District,13,121,111,10,0
2021-12-30,Hai Phong City,Le Chan District,14,112,101,11,1
2021-12-30,Hai Phong City,Le Chan District,15,194,176,18,3
2021-12-30,Hai Phong City,Le Chan District,16,172,165,7,3
2021-12-30,Hai Phong City,Le Chan District,17,212,189,23,3
2021-12-30,Hai Phong City,Le Chan District,18,236,216,20,2
2021-12-30,Hai Phong City,Le Chan District,19,206,185,21,2
2021-12-30,Hai Phong City,Le Chan District,20,163,141,22,0
2021-12-30,Hai Phong City,Le Chan District,21,93,73,20,1
2021-12-30,Hai Phong City,Le Chan District,23,1,0,1,0
2021-12-30,Hai Phong City,Ngo Quyen District,0,3,2,1,1
2021-12-30,Hai Phong City,Ngo Quyen District,4,1,0,1,1
2021-12-30,Hai Phong City,Ngo Quyen District,5,1,0,1,0
2021-12-30,Hai Phong City,Ngo Quyen District,7,51,28,23,15
2021-12-30,Hai Phong City,Ngo Quyen District,8,90,66,24,15
2021-12-30,Hai Phong City,Ngo Quyen District,9,84,72,12,1
2021-12-30,Hai Phong City,Ngo Quyen District,10,146,137,9,2
2021-12-30,Hai Phong City,Ngo Quyen District,11,281,242,39,10
2021-12-30,Hai Phong City,Ngo Quyen District,12,189,177,12,1
2021-12-30,Hai Phong City,Ngo Quyen District,13,105,93,12,0
2021-12-30,Hai Phong City,Ngo Quyen District,14,121,109,12,0
2021-12-30,Hai Phong City,Ngo Quyen District,15,161,140,21,6
2021-12-30,Hai Phong City,Ngo Quyen District,16,147,134,13,0
2021-12-30,Hai Phong City,Ngo Quyen District,17,185,162,23,2
2021-12-30,Hai Phong City,Ngo Quyen District,18,202,169,33,2
2021-12-30,Hai Phong City,Ngo Quyen District,19,221,187,34,8
2021-12-30,Hai Phong City,Ngo Quyen District,20,153,142,11,2
2021-12-30,Hai Phong City,Ngo Quyen District,21,65,54,11,5
2021-12-30,Hai Phong City,Thuy Nguyen,9,1,0,1,1
2021-12-30,Hai Phong City,Thuy Nguyen,11,3,0,3,3
2021-12-30,Hai Phong City,Thuy Nguyen,18,1,0,1,1
2021-12-30,Hai Phong City,Thuy Nguyen,19,2,0,2,2
2021-12-30,Hai Phong City,Thuy Nguyen,20,2,0,2,1
2021-12-30,Hai Phong City,Thuy Nguyen,21,1,0,1,1
2021-12-30,Hue City,Hue City,0,26,19,7,1
2021-12-30,Hue City,Hue City,1,3,2,1,0
2021-12-30,Hue City,Hue City,2,1,1,0,0
2021-12-30,Hue City,Hue City,4,1,1,0,0
2021-12-30,Hue City,Hue City,5,3,3,0,0
2021-12-30,Hue City,Hue City,6,70,55,15,5
2021-12-30,Hue City,Hue City,7,238,222,16,0
2021-12-30,Hue City,Hue City,8,374,346,28,0
2021-12-30,Hue City,Hue City,9,272,244,28,0
2021-12-30,Hue City,Hue City,10,303,279,24,2
2021-12-30,Hue City,Hue City,11,670,640,30,3
2021-12-30,Hue City,Hue City,12,463,427,36,2
2021-12-30,Hue City,Hue City,13,264,239,25,2
2021-12-30,Hue City,Hue City,14,326,295,31,3
2021-12-30,Hue City,Hue City,15,369,350,19,1
2021-12-30,Hue City,Hue City,16,412,382,30,3
2021-12-30,Hue City,Hue City,17,504,481,23,1
2021-12-30,Hue City,Hue City,18,562,517,45,0
2021-12-30,Hue City,Hue City,19,488,447,41,3
2021-12-30,Hue City,Hue City,20,407,352,55,5
2021-12-30,Hue City,Hue City,21,217,174,43,11
2021-12-30,Hue City,Hue City,22,9,4,5,1
2021-12-30,Hue City,Hue City,23,1,1,0,0
2021-12-30,Hue City,Huong Thuy,17,1,0,1,1
2021-12-30,Hue City,Huong Thuy,18,1,1,0,0
2021-12-30,Hue City,Huong Thuy,20,1,0,1,1
2021-12-30,Hue City,Huong Tra,18,1,0,1,0
2021-12-30,Hue City,Huong Tra,19,1,1,0,0
2021-12-30,Hue City,Phu Vang,7,1,1,0,0
2021-12-30,Hue City,Phu Vang,8,3,3,0,0
2021-12-30,Hue City,Phu Vang,10,1,0,1,1
2021-12-30,Hue City,Phu Vang,11,4,3,1,1
2021-12-30,Hue City,Phu Vang,13,5,4,1,1
2021-12-30,Hue City,Phu Vang,14,2,2,0,0
2021-12-30,Hue City,Phu Vang,15,2,2,0,0
2021-12-30,Hue City,Phu Vang,18,3,1,2,1
2021-12-30,Vung Tau,Ba Ria City,8,8,3,5,3
2021-12-30,Vung Tau,Ba Ria City,9,3,2,1,1
2021-12-30,Vung Tau,Ba Ria City,10,9,2,7,5
2021-12-30,Vung Tau,Ba Ria City,11,12,6,6,5
2021-12-30,Vung Tau,Ba Ria City,12,6,4,2,0
2021-12-30,Vung Tau,Ba Ria City,13,3,3,0,0
2021-12-30,Vung Tau,Ba Ria City,14,7,7,0,0
2021-12-30,Vung Tau,Ba Ria City,15,1,1,0,0
2021-12-30,Vung Tau,Ba Ria City,16,3,3,0,0
2021-12-30,Vung Tau,Ba Ria City,17,3,3,0,0
2021-12-30,Vung Tau,Ba Ria City,18,6,4,2,1
2021-12-30,Vung Tau,Ba Ria City,19,8,3,5,4
2021-12-30,Vung Tau,Ba Ria City,20,8,0,8,8
2021-12-30,Vung Tau,Ba Ria City,21,2,0,2,2
2021-12-30,Vung Tau,Vung Tau City,0,5,2,3,0
2021-12-30,Vung Tau,Vung Tau City,2,3,1,2,0
2021-12-30,Vung Tau,Vung Tau City,3,1,1,0,0
2021-12-30,Vung Tau,Vung Tau City,6,35,31,4,0
2021-12-30,Vung Tau,Vung Tau City,7,121,105,16,4
2021-12-30,Vung Tau,Vung Tau City,8,162,149,13,1
2021-12-30,Vung Tau,Vung Tau City,9,155,139,16,1
2021-12-30,Vung Tau,Vung Tau City,10,182,168,14,0
2021-12-30,Vung Tau,Vung Tau City,11,338,321,17,1
2021-12-30,Vung Tau,Vung Tau City,12,227,216,11,0
2021-12-30,Vung Tau,Vung Tau City,13,191,177,14,7
2021-12-30,Vung Tau,Vung Tau City,14,206,191,15,3
2021-12-30,Vung Tau,Vung Tau City,15,228,215,13,2
2021-12-30,Vung Tau,Vung Tau City,16,210,190,20,0
2021-12-30,Vung Tau,Vung Tau City,17,266,247,19,0
2021-12-30,Vung Tau,Vung Tau City,18,314,292,22,0
2021-12-30,Vung Tau,Vung Tau City,19,224,201,23,1
2021-12-30,Vung Tau,Vung Tau City,20,165,134,31,2
2021-12-30,Vung Tau,Vung Tau City,21,109,81,28,1
2021-12-30,Vung Tau,Vung Tau City,22,4,3,1,0
2021-12-30,Vung Tau,Vung Tau City,23,4,2,2,0
2021-12-31,Binh Duong,Di An,6,1,0,1,1
2021-12-31,Binh Duong,Di An,8,5,3,2,2
2021-12-31,Binh Duong,Di An,9,10,6,4,4
2021-12-31,Binh Duong,Di An,10,15,3,12,10
2021-12-31,Binh Duong,Di An,11,31,12,19,15
2021-12-31,Binh Duong,Di An,12,34,11,23,19
2021-12-31,Binh Duong,Di An,13,20,11,9,7
2021-12-31,Binh Duong,Di An,14,16,9,7,6
2021-12-31,Binh Duong,Di An,15,10,8,2,2
2021-12-31,Binh Duong,Di An,16,8,6,2,2
2021-12-31,Binh Duong,Di An,17,9,3,6,4
2021-12-31,Binh Duong,Di An,18,20,7,13,11
2021-12-31,Binh Duong,Di An,19,21,7,14,11
2021-12-31,Binh Duong,Di An,20,14,3,11,5
2021-12-31,Binh Duong,Di An,21,6,2,4,3
2021-12-31,Binh Duong,Tan Uyen,10,1,1,0,0
2021-12-31,Binh Duong,Tan Uyen,11,1,1,0,0
2021-12-31,Binh Duong,Tan Uyen,12,1,1,0,0
2021-12-31,Binh Duong,Tan Uyen,13,6,3,3,2
2021-12-31,Binh Duong,Tan Uyen,14,1,1,0,0
2021-12-31,Binh Duong,Tan Uyen,16,1,1,0,0
2021-12-31,Binh Duong,Tan Uyen,19,1,0,1,1
2021-12-31,Binh Duong,Thu Dau Mot Town,0,3,2,1,1
2021-12-31,Binh Duong,Thu Dau Mot Town,2,3,1,2,0
2021-12-31,Binh Duong,Thu Dau Mot Town,5,2,1,1,1
2021-12-31,Binh Duong,Thu Dau Mot Town,6,37,30,7,4
2021-12-31,Binh Duong,Thu Dau Mot Town,7,98,92,6,1
2021-12-31,Binh Duong,Thu Dau Mot Town,8,197,179,18,3
2021-12-31,Binh Duong,Thu Dau Mot Town,9,217,205,12,3
2021-12-31,Binh Duong,Thu Dau Mot Town,10,358,331,27,3
2021-12-31,Binh Duong,Thu Dau Mot Town,11,623,551,72,33
2021-12-31,Binh Duong,Thu Dau Mot Town,12,455,420,35,3
2021-12-31,Binh Duong,Thu Dau Mot Town,13,382,358,24,3
2021-12-31,Binh Duong,Thu Dau Mot Town,14,274,257,17,1
2021-12-31,Binh Duong,Thu Dau Mot Town,15,246,228,18,3
2021-12-31,Binh Duong,Thu Dau Mot Town,16,247,230,17,3
2021-12-31,Binh Duong,Thu Dau Mot Town,17,324,294,30,8
2021-12-31,Binh Duong,Thu Dau Mot Town,18,356,320,36,9
2021-12-31,Binh Duong,Thu Dau Mot Town,19,309,278,31,8
2021-12-31,Binh Duong,Thu Dau Mot Town,20,211,185,26,8
2021-12-31,Binh Duong,Thu Dau Mot Town,21,94,79,15,2
2021-12-31,Binh Duong,Thu Dau Mot Town,22,1,0,1,0
2021-12-31,Binh Duong,Thuan An,0,3,2,1,1
2021-12-31,Binh Duong,Thuan An,7,4,0,4,2
2021-12-31,Binh Duong,Thuan An,8,18,7,11,8
2021-12-31,Binh Duong,Thuan An,9,40,14,26,21
2021-12-31,Binh Duong,Thuan An,10,74,27,47,43
2021-12-31,Binh Duong,Thuan An,11,78,39,39,34
2021-12-31,Binh Duong,Thuan An,12,71,35,36,33
2021-12-31,Binh Duong,Thuan An,13,58,23,35,29
2021-12-31,Binh Duong,Thuan An,14,64,26,38,31
2021-12-31,Binh Duong,Thuan An,15,31,15,16,14
2021-12-31,Binh Duong,Thuan An,16,42,19,23,13
2021-12-31,Binh Duong,Thuan An,17,34,16,18,11
2021-12-31,Binh Duong,Thuan An,18,37,25,12,8
2021-12-31,Binh Duong,Thuan An,19,49,23,26,19
2021-12-31,Binh Duong,Thuan An,20,25,9,16,12
2021-12-31,Binh Duong,Thuan An,21,17,5,12,9
2021-12-31,Binh Duong,Thuan An,22,1,0,1,0
2021-12-31,Can Tho City,Binh Thuy District,7,1,1,0,0
2021-12-31,Can Tho City,Binh Thuy District,8,6,5,1,0
2021-12-31,Can Tho City,Binh Thuy District,9,5,5,0,0
2021-12-31,Can Tho City,Binh Thuy District,10,11,10,1,0
2021-12-31,Can Tho City,Binh Thuy District,11,13,11,2,0
2021-12-31,Can Tho City,Binh Thuy District,12,11,11,0,0
2021-12-31,Can Tho City,Binh Thuy District,13,8,7,1,0
2021-12-31,Can Tho City,Binh Thuy District,14,14,9,5,0
2021-12-31,Can Tho City,Binh Thuy District,15,9,8,1,0
2021-12-31,Can Tho City,Binh Thuy District,16,6,6,0,0
2021-12-31,Can Tho City,Binh Thuy District,17,8,7,1,0
2021-12-31,Can Tho City,Binh Thuy District,18,10,10,0,0
2021-12-31,Can Tho City,Binh Thuy District,19,7,7,0,0
2021-12-31,Can Tho City,Binh Thuy District,20,13,13,0,0
2021-12-31,Can Tho City,Binh Thuy District,21,2,0,2,0
2021-12-31,Can Tho City,Cai Rang District,6,2,2,0,0
2021-12-31,Can Tho City,Cai Rang District,7,1,1,0,0
2021-12-31,Can Tho City,Cai Rang District,8,6,5,1,0
2021-12-31,Can Tho City,Cai Rang District,9,6,6,0,0
2021-12-31,Can Tho City,Cai Rang District,10,6,6,0,0
2021-12-31,Can Tho City,Cai Rang District,11,12,11,1,1
2021-12-31,Can Tho City,Cai Rang District,12,2,2,0,0
2021-12-31,Can Tho City,Cai Rang District,13,6,5,1,0
2021-12-31,Can Tho City,Cai Rang District,14,8,5,3,1
2021-12-31,Can Tho City,Cai Rang District,15,12,9,3,0
2021-12-31,Can Tho City,Cai Rang District,16,11,10,1,0
2021-12-31,Can Tho City,Cai Rang District,17,7,6,1,0
2021-12-31,Can Tho City,Cai Rang District,18,9,9,0,0
2021-12-31,Can Tho City,Cai Rang District,19,9,6,3,1
2021-12-31,Can Tho City,Cai Rang District,20,6,4,2,1
2021-12-31,Can Tho City,Cai Rang District,21,2,2,0,0
2021-12-31,Can Tho City,Ninh Kieu District,0,21,20,1,0
2021-12-31,Can Tho City,Ninh Kieu District,1,4,4,0,0
2021-12-31,Can Tho City,Ninh Kieu District,3,1,0,1,0
2021-12-31,Can Tho City,Ninh Kieu District,4,1,1,0,0
2021-12-31,Can Tho City,Ninh Kieu District,5,6,5,1,0
2021-12-31,Can Tho City,Ninh Kieu District,6,63,58,5,1
2021-12-31,Can Tho City,Ninh Kieu District,7,152,148,4,0
2021-12-31,Can Tho City,Ninh Kieu District,8,250,240,10,0
2021-12-31,Can Tho City,Ninh Kieu District,9,288,268,20,0
2021-12-31,Can Tho City,Ninh Kieu District,10,429,413,16,0
2021-12-31,Can Tho City,Ninh Kieu District,11,723,699,24,0
2021-12-31,Can Tho City,Ninh Kieu District,12,483,467,16,0
2021-12-31,Can Tho City,Ninh Kieu District,13,386,375,11,0
2021-12-31,Can Tho City,Ninh Kieu District,14,344,326,18,0
2021-12-31,Can Tho City,Ninh Kieu District,15,300,290,10,0
2021-12-31,Can Tho City,Ninh Kieu District,16,344,331,13,0
2021-12-31,Can Tho City,Ninh Kieu District,17,438,416,22,0
2021-12-31,Can Tho City,Ninh Kieu District,18,437,421,16,0
2021-12-31,Can Tho City,Ninh Kieu District,19,380,367,13,0
2021-12-31,Can Tho City,Ninh Kieu District,20,313,283,30,0
2021-12-31,Can Tho City,Ninh Kieu District,21,160,143,17,0
2021-12-31,Can Tho City,Ninh Kieu District,22,2,1,1,0
2021-12-31,Can Tho City,Ninh Kieu District,23,4,3,1,0
2021-12-31,Dong Nai,Bien Hoa City,0,4,2,2,1
2021-12-31,Dong Nai,Bien Hoa City,1,2,1,1,1
2021-12-31,Dong Nai,Bien Hoa City,4,1,1,0,0
2021-12-31,Dong Nai,Bien Hoa City,5,4,3,1,1
2021-12-31,Dong Nai,Bien Hoa City,6,44,34,10,4
2021-12-31,Dong Nai,Bien Hoa City,7,158,134,24,11
2021-12-31,Dong Nai,Bien Hoa City,8,295,275,20,4
2021-12-31,Dong Nai,Bien Hoa City,9,408,375,33,2
2021-12-31,Dong Nai,Bien Hoa City,10,711,641,70,24
2021-12-31,Dong Nai,Bien Hoa City,11,1017,927,90,30
2021-12-31,Dong Nai,Bien Hoa City,12,807,737,70,22
2021-12-31,Dong Nai,Bien Hoa City,13,740,682,58,10
2021-12-31,Dong Nai,Bien Hoa City,14,589,546,43,6
2021-12-31,Dong Nai,Bien Hoa City,15,524,482,42,12
2021-12-31,Dong Nai,Bien Hoa City,16,430,392,38,4
2021-12-31,Dong Nai,Bien Hoa City,17,612,538,74,24
2021-12-31,Dong Nai,Bien Hoa City,18,724,614,110,55
2021-12-31,Dong Nai,Bien Hoa City,19,648,525,123,47
2021-12-31,Dong Nai,Bien Hoa City,20,590,424,166,101
2021-12-31,Dong Nai,Bien Hoa City,21,339,172,167,112
2021-12-31,Dong Nai,Bien Hoa City,22,2,1,1,0
2021-12-31,Dong Nai,Long Khanh,16,2,0,2,2
2021-12-31,Dong Nai,Long Thanh,8,1,0,1,1
2021-12-31,Dong Nai,Long Thanh,9,2,0,2,2
2021-12-31,Dong Nai,Long Thanh,10,1,0,1,1
2021-12-31,Dong Nai,Long Thanh,20,1,0,1,1
2021-12-31,Dong Nai,Thong Nhat,7,1,1,0,0
2021-12-31,Dong Nai,Thong Nhat,13,3,3,0,0
2021-12-31,Dong Nai,Thong Nhat,18,2,1,1,0
2021-12-31,Dong Nai,Thong Nhat,21,1,1,0,0
2021-12-31,Dong Nai,Trang Bom,9,2,0,2,1
2021-12-31,Dong Nai,Trang Bom,10,2,0,2,2
2021-12-31,Dong Nai,Trang Bom,12,2,0,2,2
2021-12-31,Dong Nai,Trang Bom,15,3,0,3,3
2021-12-31,Dong Nai,Trang Bom,16,3,0,3,3
2021-12-31,Dong Nai,Trang Bom,17,5,2,3,1
2021-12-31,Dong Nai,Trang Bom,18,3,0,3,3
2021-12-31,Dong Nai,Trang Bom,19,1,0,1,1
2021-12-31,Hai Phong City,An Duong,9,1,1,0,0
2021-12-31,Hai Phong City,An Duong,10,3,2,1,1
2021-12-31,Hai Phong City,An Duong,11,2,1,1,1
2021-12-31,Hai Phong City,An Duong,12,2,0,2,0
2021-12-31,Hai Phong City,An Duong,13,2,0,2,1
2021-12-31,Hai Phong City,An Duong,14,3,1,2,2
2021-12-31,Hai Phong City,An Duong,15,1,0,1,1
2021-12-31,Hai Phong City,An Duong,16,1,0,1,0
2021-12-31,Hai Phong City,An Duong,18,1,0,1,1
2021-12-31,Hai Phong City,An Duong,19,4,2,2,1
2021-12-31,Hai Phong City,An Duong,20,1,0,1,1
2021-12-31,Hai Phong City,Do Son District,16,1,0,1,1
2021-12-31,Hai Phong City,Duong Kinh District,14,1,0,1,1
2021-12-31,Hai Phong City,Duong Kinh District,20,1,0,1,1
2021-12-31,Hai Phong City,Hai An District,7,6,5,1,1
2021-12-31,Hai Phong City,Hai An District,8,13,9,4,2
2021-12-31,Hai Phong City,Hai An District,9,12,10,2,0
2021-12-31,Hai Phong City,Hai An District,10,20,19,1,0
2021-12-31,Hai Phong City,Hai An District,11,52,42,10,6
2021-12-31,Hai Phong City,Hai An District,12,25,22,3,0
2021-12-31,Hai Phong City,Hai An District,13,11,10,1,0
2021-12-31,Hai Phong City,Hai An District,14,13,13,0,0
2021-12-31,Hai Phong City,Hai An District,15,18,14,4,3
2021-12-31,Hai Phong City,Hai An District,16,23,17,6,0
2021-12-31,Hai Phong City,Hai An District,17,27,24,3,0
2021-12-31,Hai Phong City,Hai An District,18,44,29,15,9
2021-12-31,Hai Phong City,Hai An District,19,23,15,8,1
2021-12-31,Hai Phong City,Hai An District,20,24,18,6,2
2021-12-31,Hai Phong City,Hai An District,21,20,11,9,6
2021-12-31,Hai Phong City,Hong Bang District,0,2,1,1,0
2021-12-31,Hai Phong City,Hong Bang District,7,15,12,3,2
2021-12-31,Hai Phong City,Hong Bang District,8,36,29,7,0
2021-12-31,Hai Phong City,Hong Bang District,9,48,45,3,0
2021-12-31,Hai Phong City,Hong Bang District,10,56,50,6,0
2021-12-31,Hai Phong City,Hong Bang District,11,143,121,22,14
2021-12-31,Hai Phong City,Hong Bang District,12,74,67,7,3
2021-12-31,Hai Phong City,Hong Bang District,13,58,47,11,3
2021-12-31,Hai Phong City,Hong Bang District,14,42,38,4,1
2021-12-31,Hai Phong City,Hong Bang District,15,50,45,5,1
2021-12-31,Hai Phong City,Hong Bang District,16,52,42,10,0
2021-12-31,Hai Phong City,Hong Bang District,17,56,46,10,3
2021-12-31,Hai Phong City,Hong Bang District,18,83,61,22,14
2021-12-31,Hai Phong City,Hong Bang District,19,89,70,19,13
2021-12-31,Hai Phong City,Hong Bang District,20,52,41,11,5
2021-12-31,Hai Phong City,Hong Bang District,21,27,16,11,6
2021-12-31,Hai Phong City,Hong Bang District,22,1,1,0,0
2021-12-31,Hai Phong City,Kien An District,7,1,0,1,1
2021-12-31,Hai Phong City,Kien An District,8,4,3,1,1
2021-12-31,Hai Phong City,Kien An District,9,4,3,1,1
2021-12-31,Hai Phong City,Kien An District,10,7,5,2,2
2021-12-31,Hai Phong City,Kien An District,11,12,7,5,5
2021-12-31,Hai Phong City,Kien An District,12,5,3,2,2
2021-12-31,Hai Phong City,Kien An District,13,9,8,1,0
2021-12-31,Hai Phong City,Kien An District,14,6,5,1,1
2021-12-31,Hai Phong City,Kien An District,15,10,6,4,2
2021-12-31,Hai Phong City,Kien An District,16,9,5,4,2
2021-12-31,Hai Phong City,Kien An District,17,15,11,4,3
2021-12-31,Hai Phong City,Kien An District,18,7,4,3,3
2021-12-31,Hai Phong City,Kien An District,19,9,4,5,3
2021-12-31,Hai Phong City,Kien An District,20,7,4,3,2
2021-12-31,Hai Phong City,Kien An District,21,2,1,1,0
2021-12-31,Hai Phong City,Le Chan District,0,22,20,2,0
2021-12-31,Hai Phong City,Le Chan District,1,3,1,2,0
2021-12-31,Hai Phong City,Le Chan District,5,1,1,0,0
2021-12-31,Hai Phong City,Le Chan District,6,1,1,0,0
2021-12-31,Hai Phong City,Le Chan District,7,42,34,8,2
2021-12-31,Hai Phong City,Le Chan District,8,108,94,14,1
2021-12-31,Hai Phong City,Le Chan District,9,89,72,17,1
2021-12-31,Hai Phong City,Le Chan District,10,181,164,17,2
2021-12-31,Hai Phong City,Le Chan District,11,377,320,57,29
2021-12-31,Hai Phong City,Le Chan District,12,211,195,16,2
2021-12-31,Hai Phong City,Le Chan District,13,126,115,11,1
2021-12-31,Hai Phong City,Le Chan District,14,107,100,7,0
2021-12-31,Hai Phong City,Le Chan District,15,181,169,12,1
2021-12-31,Hai Phong City,Le Chan District,16,214,183,31,6
2021-12-31,Hai Phong City,Le Chan District,17,219,194,25,6
2021-12-31,Hai Phong City,Le Chan District,18,294,225,69,37
2021-12-31,Hai Phong City,Le Chan District,19,275,217,58,23
2021-12-31,Hai Phong City,Le Chan District,20,180,143,37,14
2021-12-31,Hai Phong City,Le Chan District,21,119,75,44,15
2021-12-31,Hai Phong City,Ngo Quyen District,0,11,9,2,1
2021-12-31,Hai Phong City,Ngo Quyen District,6,2,1,1,1
2021-12-31,Hai Phong City,Ngo Quyen District,7,42,23,19,11
2021-12-31,Hai Phong City,Ngo Quyen District,8,105,92,13,4
2021-12-31,Hai Phong City,Ngo Quyen District,9,107,87,20,3
2021-12-31,Hai Phong City,Ngo Quyen District,10,135,124,11,0
2021-12-31,Hai Phong City,Ngo Quyen District,11,287,253,34,10
2021-12-31,Hai Phong City,Ngo Quyen District,12,193,176,17,2
2021-12-31,Hai Phong City,Ngo Quyen District,13,118,110,8,0
2021-12-31,Hai Phong City,Ngo Quyen District,14,147,139,8,1
2021-12-31,Hai Phong City,Ngo Quyen District,15,154,137,17,5
2021-12-31,Hai Phong City,Ngo Quyen District,16,163,153,10,1
2021-12-31,Hai Phong City,Ngo Quyen District,17,132,126,6,0
2021-12-31,Hai Phong City,Ngo Quyen District,18,231,183,48,30
2021-12-31,Hai Phong City,Ngo Quyen District,19,212,166,46,22
2021-12-31,Hai Phong City,Ngo Quyen District,20,208,168,40,17
2021-12-31,Hai Phong City,Ngo Quyen District,21,88,56,32,10
2021-12-31,Hai Phong City,Ngo Quyen District,22,2,0,2,0
2021-12-31,Hai Phong City,Thuy Nguyen,11,1,0,1,1
2021-12-31,Hai Phong City,Thuy Nguyen,12,2,0,2,2
2021-12-31,Hai Phong City,Thuy Nguyen,13,1,0,1,1
2021-12-31,Hai Phong City,Thuy Nguyen,14,2,1,1,1
2021-12-31,Hai Phong City,Thuy Nguyen,19,1,0,1,0
2021-12-31,Hue City,Hue City,0,39,33,6,3
2021-12-31,Hue City,Hue City,1,2,2,0,0
2021-12-31,Hue City,Hue City,2,1,1,0,0
2021-12-31,Hue City,Hue City,3,3,2,1,0
2021-12-31,Hue City,Hue City,4,3,3,0,0
2021-12-31,Hue City,Hue City,5,4,3,1,1
2021-12-31,Hue City,Hue City,6,81,74,7,2
2021-12-31,Hue City,Hue City,7,203,187,16,4
2021-12-31,Hue City,Hue City,8,381,346,35,2
2021-12-31,Hue City,Hue City,9,294,268,26,2
2021-12-31,Hue City,Hue City,10,377,358,19,1
2021-12-31,Hue City,Hue City,11,667,639,28,2
2021-12-31,Hue City,Hue City,12,451,436,15,0
2021-12-31,Hue City,Hue City,13,326,313,13,1
2021-12-31,Hue City,Hue City,14,361,331,30,8
2021-12-31,Hue City,Hue City,15,430,398,32,3
2021-12-31,Hue City,Hue City,16,433,396,37,3
2021-12-31,Hue City,Hue City,17,580,529,51,3
2021-12-31,Hue City,Hue City,18,742,641,101,47
2021-12-31,Hue City,Hue City,19,589,509,80,22
2021-12-31,Hue City,Hue City,20,482,384,98,39
2021-12-31,Hue City,Hue City,21,301,230,71,22
2021-12-31,Hue City,Hue City,22,3,2,1,0
2021-12-31,Hue City,Hue City,23,2,2,0,0
2021-12-31,Hue City,Huong Thuy,7,3,1,2,1
2021-12-31,Hue City,Huong Thuy,9,1,0,1,1
2021-12-31,Hue City,Huong Thuy,12,1,1,0,0
2021-12-31,Hue City,Huong Thuy,15,1,0,1,0
2021-12-31,Hue City,Huong Thuy,17,1,1,0,0
2021-12-31,Hue City,Huong Thuy,20,3,2,1,0
2021-12-31,Hue City,Phu Vang,8,4,4,0,0
2021-12-31,Hue City,Phu Vang,9,1,1,0,0
2021-12-31,Hue City,Phu Vang,10,2,2,0,0
2021-12-31,Hue City,Phu Vang,11,2,2,0,0
2021-12-31,Hue City,Phu Vang,14,1,1,0,0
2021-12-31,Hue City,Phu Vang,17,1,1,0,0
2021-12-31,Hue City,Phu Vang,18,2,2,0,0
2021-12-31,Hue City,Phu Vang,19,2,2,0,0
2021-12-31,Hue City,Phu Vang,20,2,0,2,0
2021-12-31,Vung Tau,Ba Ria City,7,2,1,1,1
2021-12-31,Vung Tau,Ba Ria City,8,5,3,2,0
2021-12-31,Vung Tau,Ba Ria City,9,4,4,0,0
2021-12-31,Vung Tau,Ba Ria City,10,3,2,1,0
2021-12-31,Vung Tau,Ba Ria City,11,13,5,8,7
2021-12-31,Vung Tau,Ba Ria City,12,12,4,8,4
2021-12-31,Vung Tau,Ba Ria City,13,5,4,1,1
2021-12-31,Vung Tau,Ba Ria City,14,3,1,2,1
2021-12-31,Vung Tau,Ba Ria City,15,7,5,2,0
2021-12-31,Vung Tau,Ba Ria City,16,12,6,6,4
2021-12-31,Vung Tau,Ba Ria City,17,7,4,3,1
2021-12-31,Vung Tau,Ba Ria City,18,14,3,11,9
2021-12-31,Vung Tau,Ba Ria City,19,7,3,4,4
2021-12-31,Vung Tau,Ba Ria City,20,6,0,6,5
2021-12-31,Vung Tau,Ba Ria City,21,2,0,2,2
2021-12-31,Vung Tau,Vung Tau City,0,4,4,0,0
2021-12-31,Vung Tau,Vung Tau City,1,2,2,0,0
2021-12-31,Vung Tau,Vung Tau City,2,2,0,2,0
2021-12-31,Vung Tau,Vung Tau City,3,1,1,0,0
2021-12-31,Vung Tau,Vung Tau City,5,1,0,1,0
2021-12-31,Vung Tau,Vung Tau City,6,52,45,7,1
2021-12-31,Vung Tau,Vung Tau City,7,136,123,13,3
2021-12-31,Vung Tau,Vung Tau City,8,162,149,13,1
2021-12-31,Vung Tau,Vung Tau City,9,171,161,10,0
2021-12-31,Vung Tau,Vung Tau City,10,190,180,10,2
2021-12-31,Vung Tau,Vung Tau City,11,341,316,25,3
2021-12-31,Vung Tau,Vung Tau City,12,241,232,9,0
2021-12-31,Vung Tau,Vung Tau City,13,211,192,19,3
2021-12-31,Vung Tau,Vung Tau City,14,236,213,23,4
2021-12-31,Vung Tau,Vung Tau City,15,238,221,17,0
2021-12-31,Vung Tau,Vung Tau City,16,209,187,22,0
2021-12-31,Vung Tau,Vung Tau City,17,281,254,27,3
2021-12-31,Vung Tau,Vung Tau City,18,349,313,36,3
2021-12-31,Vung Tau,Vung Tau City,19,295,244,51,13
2021-12-31,Vung Tau,Vung Tau City,20,197,168,29,2
2021-12-31,Vung Tau,Vung Tau City,21,98,86,12,1
2021-12-31,Vung Tau,Vung Tau City,22,1,1,0,0
2022-01-01,Binh Duong,Ben Cat,11,1,0,1,1
2022-01-01,Binh Duong,Ben Cat,15,1,0,1,1
2022-01-01,Binh Duong,Ben Cat,16,1,0,1,1
2022-01-01,Binh Duong,Di An,6,2,1,1,1
2022-01-01,Binh Duong,Di An,7,4,0,4,3
2022-01-01,Binh Duong,Di An,8,6,4,2,1
2022-01-01,Binh Duong,Di An,9,11,5,6,2
2022-01-01,Binh Duong,Di An,10,27,5,22,14
2022-01-01,Binh Duong,Di An,11,30,7,23,17
2022-01-01,Binh Duong,Di An,12,35,12,23,20
2022-01-01,Binh Duong,Di An,13,30,10,20,17
2022-01-01,Binh Duong,Di An,14,25,11,14,13
2022-01-01,Binh Duong,Di An,15,22,10,12,10
2022-01-01,Binh Duong,Di An,16,21,9,12,8
2022-01-01,Binh Duong,Di An,17,15,9,6,6
2022-01-01,Binh Duong,Di An,18,13,6,7,3
2022-01-01,Binh Duong,Di An,19,18,11,7,7
2022-01-01,Binh Duong,Di An,20,10,3,7,5
2022-01-01,Binh Duong,Di An,21,8,2,6,6
2022-01-01,Binh Duong,Tan Uyen,8,1,0,1,1
2022-01-01,Binh Duong,Tan Uyen,10,2,0,2,1
2022-01-01,Binh Duong,Tan Uyen,11,3,0,3,1
2022-01-01,Binh Duong,Tan Uyen,14,2,1,1,1
2022-01-01,Binh Duong,Tan Uyen,16,1,0,1,0
2022-01-01,Binh Duong,Tan Uyen,17,1,0,1,1
2022-01-01,Binh Duong,Tan Uyen,18,4,0,4,4
2022-01-01,Binh Duong,Tan Uyen,20,1,0,1,1
2022-01-01,Binh Duong,Tan Uyen,21,2,0,2,2
2022-01-01,Binh Duong,Thu Dau Mot Town,0,1,0,1,0
2022-01-01,Binh Duong,Thu Dau Mot Town,1,4,3,1,1
2022-01-01,Binh Duong,Thu Dau Mot Town,3,1,0,1,0
2022-01-01,Binh Duong,Thu Dau Mot Town,5,2,2,0,0
2022-01-01,Binh Duong,Thu Dau Mot Town,6,35,30,5,3
2022-01-01,Binh Duong,Thu Dau Mot Town,7,90,83,7,0
2022-01-01,Binh Duong,Thu Dau Mot Town,8,187,172,15,4
2022-01-01,Binh Duong,Thu Dau Mot Town,9,238,216,22,3
2022-01-01,Binh Duong,Thu Dau Mot Town,10,359,333,26,3
2022-01-01,Binh Duong,Thu Dau Mot Town,11,533,501,32,6
2022-01-01,Binh Duong,Thu Dau Mot Town,12,455,431,24,5
2022-01-01,Binh Duong,Thu Dau Mot Town,13,311,291,20,6
2022-01-01,Binh Duong,Thu Dau Mot Town,14,288,276,12,2
2022-01-01,Binh Duong,Thu Dau Mot Town,15,263,243,20,3
2022-01-01,Binh Duong,Thu Dau Mot Town,16,304,282,22,3
2022-01-01,Binh Duong,Thu Dau Mot Town,17,352,334,18,3
2022-01-01,Binh Duong,Thu Dau Mot Town,18,358,326,32,10
2022-01-01,Binh Duong,Thu Dau Mot Town,19,308,282,26,9
2022-01-01,Binh Duong,Thu Dau Mot Town,20,198,177,21,4
2022-01-01,Binh Duong,Thu Dau Mot Town,21,80,62,18,1
2022-01-01,Binh Duong,Thu Dau Mot Town,22,2,0,2,0
2022-01-01,Binh Duong,Thu Dau Mot Town,23,3,2,1,0
2022-01-01,Binh Duong,Thuan An,6,3,0,3,2
2022-01-01,Binh Duong,Thuan An,7,7,2,5,4
2022-01-01,Binh Duong,Thuan An,8,11,6,5,5
2022-01-01,Binh Duong,Thuan An,9,29,14,15,12
2022-01-01,Binh Duong,Thuan An,10,45,23,22,17
2022-01-01,Binh Duong,Thuan An,11,70,35,35,30
2022-01-01,Binh Duong,Thuan An,12,61,33,28,23
2022-01-01,Binh Duong,Thuan An,13,55,29,26,22
2022-01-01,Binh Duong,Thuan An,14,48,18,30,23
2022-01-01,Binh Duong,Thuan An,15,52,26,26,23
2022-01-01,Binh Duong,Thuan An,16,43,23,20,16
2022-01-01,Binh Duong,Thuan An,17,34,27,7,6
2022-01-01,Binh Duong,Thuan An,18,62,32,30,22
2022-01-01,Binh Duong,Thuan An,19,33,20,13,11
2022-01-01,Binh Duong,Thuan An,20,20,7,13,11
2022-01-01,Binh Duong,Thuan An,21,20,6,14,12
2022-01-01,Can Tho City,Binh Thuy District,7,1,1,0,0
2022-01-01,Can Tho City,Binh Thuy District,8,8,8,0,0
2022-01-01,Can Tho City,Binh Thuy District,9,8,7,1,0
2022-01-01,Can Tho City,Binh Thuy District,10,7,6,1,0
2022-01-01,Can Tho City,Binh Thuy District,11,11,9,2,0
2022-01-01,Can Tho City,Binh Thuy District,12,7,7,0,0
2022-01-01,Can Tho City,Binh Thuy District,13,13,13,0,0
2022-01-01,Can Tho City,Binh Thuy District,14,14,13,1,0
2022-01-01,Can Tho City,Binh Thuy District,15,12,12,0,0
2022-01-01,Can Tho City,Binh Thuy District,16,10,9,1,0
2022-01-01,Can Tho City,Binh Thuy District,17,14,13,1,0
2022-01-01,Can Tho City,Binh Thuy District,18,14,14,0,0
2022-01-01,Can Tho City,Binh Thuy District,19,9,8,1,0
2022-01-01,Can Tho City,Binh Thuy District,20,5,5,0,0
2022-01-01,Can Tho City,Binh Thuy District,21,1,0,1,0
2022-01-01,Can Tho City,Cai Rang District,6,1,1,0,0
2022-01-01,Can Tho City,Cai Rang District,7,2,2,0,0
2022-01-01,Can Tho City,Cai Rang District,8,9,8,1,1
2022-01-01,Can Tho City,Cai Rang District,9,11,9,2,0
2022-01-01,Can Tho City,Cai Rang District,10,11,11,0,0
2022-01-01,Can Tho City,Cai Rang District,11,5,4,1,1
2022-01-01,Can Tho City,Cai Rang District,12,11,11,0,0
2022-01-01,Can Tho City,Cai Rang District,13,4,3,1,1
2022-01-01,Can Tho City,Cai Rang District,14,5,5,0,0
2022-01-01,Can Tho City,Cai Rang District,15,8,8,0,0
2022-01-01,Can Tho City,Cai Rang District,16,7,7,0,0
2022-01-01,Can Tho City,Cai Rang District,17,12,12,0,0
2022-01-01,Can Tho City,Cai Rang District,18,12,12,0,0
2022-01-01,Can Tho City,Cai Rang District,19,4,3,1,0
2022-01-01,Can Tho City,Cai Rang District,20,7,6,1,0
2022-01-01,Can Tho City,Cai Rang District,21,4,4,0,0
2022-01-01,Can Tho City,Ninh Kieu District,0,12,9,3,0
2022-01-01,Can Tho City,Ninh Kieu District,1,5,3,2,0
2022-01-01,Can Tho City,Ninh Kieu District,2,2,2,0,0
2022-01-01,Can Tho City,Ninh Kieu District,3,1,1,0,0
2022-01-01,Can Tho City,Ninh Kieu District,5,3,2,1,0
2022-01-01,Can Tho City,Ninh Kieu District,6,49,39,10,0
2022-01-01,Can Tho City,Ninh Kieu District,7,159,152,7,0
2022-01-01,Can Tho City,Ninh Kieu District,8,246,226,20,0
2022-01-01,Can Tho City,Ninh Kieu District,9,283,255,28,0
2022-01-01,Can Tho City,Ninh Kieu District,10,453,426,27,0
2022-01-01,Can Tho City,Ninh Kieu District,11,687,658,29,0
2022-01-01,Can Tho City,Ninh Kieu District,12,554,529,25,0
2022-01-01,Can Tho City,Ninh Kieu District,13,444,420,24,0
2022-01-01,Can Tho City,Ninh Kieu District,14,387,360,27,0
2022-01-01,Can Tho City,Ninh Kieu District,15,339,317,22,0
2022-01-01,Can Tho City,Ninh Kieu District,16,377,352,25,0
2022-01-01,Can Tho City,Ninh Kieu District,17,446,423,23,0
2022-01-01,Can Tho City,Ninh Kieu District,18,489,463,26,0
2022-01-01,Can Tho City,Ninh Kieu District,19,423,396,27,1
2022-01-01,Can Tho City,Ninh Kieu District,20,283,257,26,0
2022-01-01,Can Tho City,Ninh Kieu District,21,139,122,17,0
2022-01-01,Can Tho City,Ninh Kieu District,22,3,3,0,0
2022-01-01,Can Tho City,Ninh Kieu District,23,4,3,1,0
2022-01-01,Dong Nai,Bien Hoa City,0,9,5,4,1
2022-01-01,Dong Nai,Bien Hoa City,1,2,1,1,0
2022-01-01,Dong Nai,Bien Hoa City,2,1,1,0,0
2022-01-01,Dong Nai,Bien Hoa City,4,1,1,0,0
2022-01-01,Dong Nai,Bien Hoa City,5,1,0,1,1
2022-01-01,Dong Nai,Bien Hoa City,6,37,22,15,10
2022-01-01,Dong Nai,Bien Hoa City,7,141,112,29,13
2022-01-01,Dong Nai,Bien Hoa City,8,296,247,49,19
2022-01-01,Dong Nai,Bien Hoa City,9,391,346,45,5
2022-01-01,Dong Nai,Bien Hoa City,10,678,604,74,20
2022-01-01,Dong Nai,Bien Hoa City,11,1031,905,126,43
2022-01-01,Dong Nai,Bien Hoa City,12,902,790,112,41
2022-01-01,Dong Nai,Bien Hoa City,13,772,682,90,34
2022-01-01,Dong Nai,Bien Hoa City,14,615,540,75,28
2022-01-01,Dong Nai,Bien Hoa City,15,474,433,41,6
2022-01-01,Dong Nai,Bien Hoa City,16,519,464,55,13
2022-01-01,Dong Nai,Bien Hoa City,17,652,566,86,32
2022-01-01,Dong Nai,Bien Hoa City,18,736,620,116,50
2022-01-01,Dong Nai,Bien Hoa City,19,725,565,160,83
2022-01-01,Dong Nai,Bien Hoa City,20,515,380,135,86
2022-01-01,Dong Nai,Bien Hoa City,21,248,138,110,65
2022-01-01,Dong Nai,Bien Hoa City,22,5,0,5,0
2022-01-01,Dong Nai,Bien Hoa City,23,2,1,1,0
2022-01-01,Dong Nai,Long Khanh,8,1,0,1,1
2022-01-01,Dong Nai,Long Khanh,11,1,0,1,1
2022-01-01,Dong Nai,Long Thanh,11,1,0,1,1
2022-01-01,Dong Nai,Long Thanh,15,4,0,4,4
2022-01-01,Dong Nai,Long Thanh,16,2,0,2,2
2022-01-01,Dong Nai,Long Thanh,18,1,0,1,0
2022-01-01,Dong Nai,Long Thanh,21,1,0,1,1
2022-01-01,Dong Nai,Thong Nhat,8,2,2,0,0
2022-01-01,Dong Nai,Thong Nhat,9,2,2,0,0
2022-01-01,Dong Nai,Thong Nhat,10,2,2,0,0
2022-01-01,Dong Nai,Thong Nhat,11,1,1,0,0
2022-01-01,Dong Nai,Thong Nhat,15,1,1,0,0
2022-01-01,Dong Nai,Thong Nhat,16,1,1,0,0
2022-01-01,Dong Nai,Thong Nhat,19,3,0,3,2
2022-01-01,Dong Nai,Thong Nhat,20,2,2,0,0
2022-01-01,Dong Nai,Thong Nhat,21,1,1,0,0
2022-01-01,Dong Nai,Trang Bom,6,1,0,1,0
2022-01-01,Dong Nai,Trang Bom,8,1,0,1,0
2022-01-01,Dong Nai,Trang Bom,11,1,1,0,0
2022-01-01,Dong Nai,Trang Bom,12,1,0,1,1
2022-01-01,Dong Nai,Trang Bom,13,1,0,1,0
2022-01-01,Dong Nai,Trang Bom,15,1,1,0,0
2022-01-01,Dong Nai,Trang Bom,16,3,0,3,3
2022-01-01,Dong Nai,Trang Bom,19,1,0,1,1
2022-01-01,Dong Nai,Trang Bom,20,1,0,1,1
2022-01-01,Hai Phong City,An Duong,9,1,1,0,0
2022-01-01,Hai Phong City,An Duong,10,2,0,2,1
2022-01-01,Hai Phong City,An Duong,11,1,0,1,0
2022-01-01,Hai Phong City,An Duong,12,5,3,2,2
2022-01-01,Hai Phong City,An Duong,14,1,0,1,1
2022-01-01,Hai Phong City,An Duong,15,1,0,1,0
2022-01-01,Hai Phong City,An Duong,16,2,1,1,1
2022-01-01,Hai Phong City,An Duong,17,1,1,0,0
2022-01-01,Hai Phong City,An Duong,18,1,0,1,1
2022-01-01,Hai Phong City,An Duong,19,1,0,1,0
2022-01-01,Hai Phong City,An Duong,20,1,0,1,0
2022-01-01,Hai Phong City,Duong Kinh District,14,2,0,2,2
2022-01-01,Hai Phong City,Duong Kinh District,17,1,0,1,1
2022-01-01,Hai Phong City,Duong Kinh District,18,1,0,1,1
2022-01-01,Hai Phong City,Hai An District,7,2,0,2,2
2022-01-01,Hai Phong City,Hai An District,8,12,7,5,2
2022-01-01,Hai Phong City,Hai An District,9,15,7,8,2
2022-01-01,Hai Phong City,Hai An District,10,21,21,0,0
2022-01-01,Hai Phong City,Hai An District,11,28,23,5,4
2022-01-01,Hai Phong City,Hai An District,12,26,22,4,3
2022-01-01,Hai Phong City,Hai An District,13,18,14,4,1
2022-01-01,Hai Phong City,Hai An District,14,11,10,1,0
2022-01-01,Hai Phong City,Hai An District,15,20,13,7,2
2022-01-01,Hai Phong City,Hai An District,16,14,10,4,1
2022-01-01,Hai Phong City,Hai An District,17,31,27,4,0
2022-01-01,Hai Phong City,Hai An District,18,29,22,7,3
2022-01-01,Hai Phong City,Hai An District,19,9,9,0,0
2022-01-01,Hai Phong City,Hai An District,20,20,13,7,3
2022-01-01,Hai Phong City,Hai An District,21,12,7,5,3
2022-01-01,Hai Phong City,Hong Bang District,0,2,1,1,0
2022-01-01,Hai Phong City,Hong Bang District,1,1,0,1,0
2022-01-01,Hai Phong City,Hong Bang District,7,13,7,6,2
2022-01-01,Hai Phong City,Hong Bang District,8,25,22,3,0
2022-01-01,Hai Phong City,Hong Bang District,9,39,33,6,1
2022-01-01,Hai Phong City,Hong Bang District,10,76,60,16,8
2022-01-01,Hai Phong City,Hong Bang District,11,145,94,51,34
2022-01-01,Hai Phong City,Hong Bang District,12,84,73,11,5
2022-01-01,Hai Phong City,Hong Bang District,13,43,40,3,0
2022-01-01,Hai Phong City,Hong Bang District,14,34,33,1,1
2022-01-01,Hai Phong City,Hong Bang District,15,41,39,2,1
2022-01-01,Hai Phong City,Hong Bang District,16,47,45,2,0
2022-01-01,Hai Phong City,Hong Bang District,17,95,66,29,17
2022-01-01,Hai Phong City,Hong Bang District,18,95,78,17,8
2022-01-01,Hai Phong City,Hong Bang District,19,63,52,11,5
2022-01-01,Hai Phong City,Hong Bang District,20,45,33,12,6
2022-01-01,Hai Phong City,Hong Bang District,21,28,19,9,0
2022-01-01,Hai Phong City,Hong Bang District,22,1,0,1,0
2022-01-01,Hai Phong City,Kien An District,0,1,0,1,0
2022-01-01,Hai Phong City,Kien An District,1,2,2,0,0
2022-01-01,Hai Phong City,Kien An District,7,2,0,2,2
2022-01-01,Hai Phong City,Kien An District,8,13,3,10,9
2022-01-01,Hai Phong City,Kien An District,9,12,4,8,5
2022-01-01,Hai Phong City,Kien An District,10,17,11,6,5
2022-01-01,Hai Phong City,Kien An District,11,17,8,9,7
2022-01-01,Hai Phong City,Kien An District,12,16,9,7,6
2022-01-01,Hai Phong City,Kien An District,13,14,6,8,6
2022-01-01,Hai Phong City,Kien An District,14,11,8,3,3
2022-01-01,Hai Phong City,Kien An District,15,7,5,2,2
2022-01-01,Hai Phong City,Kien An District,16,13,9,4,1
2022-01-01,Hai Phong City,Kien An District,17,11,8,3,1
2022-01-01,Hai Phong City,Kien An District,18,13,8,5,3
2022-01-01,Hai Phong City,Kien An District,19,9,2,7,2
2022-01-01,Hai Phong City,Kien An District,20,11,7,4,3
2022-01-01,Hai Phong City,Kien An District,21,3,1,2,2
2022-01-01,Hai Phong City,Le Chan District,0,7,4,3,0
2022-01-01,Hai Phong City,Le Chan District,1,8,3,5,0
2022-01-01,Hai Phong City,Le Chan District,2,6,2,4,1
2022-01-01,Hai Phong City,Le Chan District,6,3,2,1,0
2022-01-01,Hai Phong City,Le Chan District,7,25,17,8,1
2022-01-01,Hai Phong City,Le Chan District,8,79,66,13,4
2022-01-01,Hai Phong City,Le Chan District,9,110,92,18,2
2022-01-01,Hai Phong City,Le Chan District,10,251,213,38,17
2022-01-01,Hai Phong City,Le Chan District,11,465,345,120,83
2022-01-01,Hai Phong City,Le Chan District,12,325,283,42,10
2022-01-01,Hai Phong City,Le Chan District,13,170,148,22,1
2022-01-01,Hai Phong City,Le Chan District,14,184,154,30,4
2022-01-01,Hai Phong City,Le Chan District,15,192,174,18,0
2022-01-01,Hai Phong City,Le Chan District,16,220,178,42,7
2022-01-01,Hai Phong City,Le Chan District,17,276,215,61,33
2022-01-01,Hai Phong City,Le Chan District,18,304,229,75,36
2022-01-01,Hai Phong City,Le Chan District,19,256,214,42,7
2022-01-01,Hai Phong City,Le Chan District,20,203,157,46,15
2022-01-01,Hai Phong City,Le Chan District,21,93,65,28,11
2022-01-01,Hai Phong City,Le Chan District,22,2,0,2,1
2022-01-01,Hai Phong City,Le Chan District,23,1,0,1,0
2022-01-01,Hai Phong City,Ngo Quyen District,0,1,0,1,0
2022-01-01,Hai Phong City,Ngo Quyen District,1,2,0,2,1
2022-01-01,Hai Phong City,Ngo Quyen District,2,3,1,2,1
2022-01-01,Hai Phong City,Ngo Quyen District,4,1,1,0,0
2022-01-01,Hai Phong City,Ngo Quyen District,5,1,1,0,0
2022-01-01,Hai Phong City,Ngo Quyen District,7,31,19,12,7
2022-01-01,Hai Phong City,Ngo Quyen District,8,97,78,19,5
2022-01-01,Hai Phong City,Ngo Quyen District,9,121,106,15,1
2022-01-01,Hai Phong City,Ngo Quyen District,10,191,159,32,6
2022-01-01,Hai Phong City,Ngo Quyen District,11,327,250,77,51
2022-01-01,Hai Phong City,Ngo Quyen District,12,243,198,45,11
2022-01-01,Hai Phong City,Ngo Quyen District,13,136,121,15,1
2022-01-01,Hai Phong City,Ngo Quyen District,14,128,117,11,1
2022-01-01,Hai Phong City,Ngo Quyen District,15,164,143,21,2
2022-01-01,Hai Phong City,Ngo Quyen District,16,178,154,24,1
2022-01-01,Hai Phong City,Ngo Quyen District,17,236,186,50,22
2022-01-01,Hai Phong City,Ngo Quyen District,18,265,209,56,23
2022-01-01,Hai Phong City,Ngo Quyen District,19,228,190,38,8
2022-01-01,Hai Phong City,Ngo Quyen District,20,206,166,40,11
2022-01-01,Hai Phong City,Ngo Quyen District,21,86,71,15,4
2022-01-01,Hai Phong City,Ngo Quyen District,22,3,1,2,0
2022-01-01,Hai Phong City,Ngo Quyen District,23,1,1,0,0
2022-01-01,Hai Phong City,Thuy Nguyen,0,1,0,1,0
2022-01-01,Hai Phong City,Thuy Nguyen,9,1,0,1,1
2022-01-01,Hai Phong City,Thuy Nguyen,10,2,0,2,2
2022-01-01,Hai Phong City,Thuy Nguyen,11,2,1,1,1
2022-01-01,Hai Phong City,Thuy Nguyen,13,2,1,1,1
2022-01-01,Hai Phong City,Thuy Nguyen,14,1,0,1,1
2022-01-01,Hai Phong City,Thuy Nguyen,15,1,0,1,0
2022-01-01,Hai Phong City,Thuy Nguyen,18,2,0,2,2
2022-01-01,Hai Phong City,Thuy Nguyen,19,1,0,1,1
2022-01-01,Hai Phong City,Thuy Nguyen,21,1,0,1,1
2022-01-01,Hue City,Hue City,0,22,16,6,0
2022-01-01,Hue City,Hue City,1,14,3,11,3
2022-01-01,Hue City,Hue City,2,2,2,0,0
2022-01-01,Hue City,Hue City,3,9,3,6,0
2022-01-01,Hue City,Hue City,4,2,1,1,0
2022-01-01,Hue City,Hue City,5,1,1,0,0
2022-01-01,Hue City,Hue City,6,45,35,10,3
2022-01-01,Hue City,Hue City,7,241,223,18,2
2022-01-01,Hue City,Hue City,8,524,412,112,68
2022-01-01,Hue City,Hue City,9,442,404,38,6
2022-01-01,Hue City,Hue City,10,443,411,32,3
2022-01-01,Hue City,Hue City,11,709,660,49,6
2022-01-01,Hue City,Hue City,12,654,607,47,3
2022-01-01,Hue City,Hue City,13,389,367,22,0
2022-01-01,Hue City,Hue City,14,400,375,25,1
2022-01-01,Hue City,Hue City,15,512,464,48,6
2022-01-01,Hue City,Hue City,16,600,524,76,11
2022-01-01,Hue City,Hue City,17,726,620,106,41
2022-01-01,Hue City,Hue City,18,753,674,79,22
2022-01-01,Hue City,Hue City,19,628,567,61,13
2022-01-01,Hue City,Hue City,20,477,411,66,22
2022-01-01,Hue City,Hue City,21,246,191,55,14
2022-01-01,Hue City,Hue City,22,6,4,2,0
2022-01-01,Hue City,Hue City,23,2,2,0,0
2022-01-01,Hue City,Huong Thuy,10,2,0,2,2
2022-01-01,Hue City,Huong Thuy,11,3,2,1,0
2022-01-01,Hue City,Huong Thuy,15,3,0,3,1
2022-01-01,Hue City,Huong Thuy,16,4,1,3,1
2022-01-01,Hue City,Huong Thuy,17,1,1,0,0
2022-01-01,Hue City,Huong Thuy,18,2,1,1,1
2022-01-01,Hue City,Huong Thuy,20,2,0,2,2
2022-01-01,Hue City,Phu Vang,6,3,1,2,2
2022-01-01,Hue City,Phu Vang,7,5,3,2,1
2022-01-01,Hue City,Phu Vang,8,6,5,1,0
2022-01-01,Hue City,Phu Vang,9,1,1,0,0
2022-01-01,Hue City,Phu Vang,10,1,1,0,0
2022-01-01,Hue City,Phu Vang,11,2,0,2,0
2022-01-01,Hue City,Phu Vang,12,1,1,0,0
2022-01-01,Hue City,Phu Vang,13,2,2,0,0
2022-01-01,Hue City,Phu Vang,16,2,2,0,0
2022-01-01,Hue City,Phu Vang,17,1,0,1,0
2022-01-01,Hue City,Phu Vang,18,2,1,1,1
2022-01-01,Hue City,Phu Vang,19,3,1,2,0
2022-01-01,Hue City,Phu Vang,20,3,0,3,0
2022-01-01,Vung Tau,Ba Ria City,0,1,0,1,0
2022-01-01,Vung Tau,Ba Ria City,7,3,0,3,2
2022-01-01,Vung Tau,Ba Ria City,8,6,1,5,3
2022-01-01,Vung Tau,Ba Ria City,9,10,4,6,3
2022-01-01,Vung Tau,Ba Ria City,10,5,4,1,1
2022-01-01,Vung Tau,Ba Ria City,11,2,1,1,0
2022-01-01,Vung Tau,Ba Ria City,12,6,3,3,2
2022-01-01,Vung Tau,Ba Ria City,13,5,4,1,1
2022-01-01,Vung Tau,Ba Ria City,14,11,6,5,2
2022-01-01,Vung Tau,Ba Ria City,15,11,7,4,3
2022-01-01,Vung Tau,Ba Ria City,16,10,0,10,8
2022-01-01,Vung Tau,Ba Ria City,17,6,2,4,3
2022-01-01,Vung Tau,Ba Ria City,18,14,2,12,10
2022-01-01,Vung Tau,Ba Ria City,19,15,0,15,15
2022-01-01,Vung Tau,Ba Ria City,20,10,0,10,9
2022-01-01,Vung Tau,Ba Ria City,21,3,0,3,2
2022-01-01,Vung Tau,Vung Tau City,0,4,3,1,0
2022-01-01,Vung Tau,Vung Tau City,1,1,1,0,0
2022-01-01,Vung Tau,Vung Tau City,2,2,1,1,0
2022-01-01,Vung Tau,Vung Tau City,6,29,25,4,0
2022-01-01,Vung Tau,Vung Tau City,7,118,103,15,0
2022-01-01,Vung Tau,Vung Tau City,8,176,152,24,3
2022-01-01,Vung Tau,Vung Tau City,9,201,184,17,2
2022-01-01,Vung Tau,Vung Tau City,10,256,223,33,1
2022-01-01,Vung Tau,Vung Tau City,11,415,360,55,7
2022-01-01,Vung Tau,Vung Tau City,12,366,329,37,9
2022-01-01,Vung Tau,Vung Tau City,13,303,278,25,0
2022-01-01,Vung Tau,Vung Tau City,14,233,219,14,0
2022-01-01,Vung Tau,Vung Tau City,15,238,213,25,3
2022-01-01,Vung Tau,Vung Tau City,16,218,204,14,0
2022-01-01,Vung Tau,Vung Tau City,17,328,288,40,6
2022-01-01,Vung Tau,Vung Tau City,18,461,290,171,125
2022-01-01,Vung Tau,Vung Tau City,19,341,273,68,21
2022-01-01,Vung Tau,Vung Tau City,20,234,185,49,6
2022-01-01,Vung Tau,Vung Tau City,21,166,118,48,23
2022-01-01,Vung Tau,Vung Tau City,22,15,5,10,0
2022-01-01,Vung Tau,Vung Tau City,23,2,2,0,0
2022-01-02,Binh Duong,Ben Cat,10,1,1,0,0
2022-01-02,Binh Duong,Ben Cat,11,2,2,0,0
2022-01-02,Binh Duong,Ben Cat,12,1,1,0,0
2022-01-02,Binh Duong,Ben Cat,20,1,1,0,0
2022-01-02,Binh Duong,Di An,8,6,2,4,4
2022-01-02,Binh Duong,Di An,9,21,6,15,13
2022-01-02,Binh Duong,Di An,10,23,6,17,16
2022-01-02,Binh Duong,Di An,11,27,13,14,11
2022-01-02,Binh Duong,Di An,12,15,11,4,3
2022-01-02,Binh Duong,Di An,13,13,10,3,1
2022-01-02,Binh Duong,Di An,14,8,7,1,1
2022-01-02,Binh Duong,Di An,15,24,4,20,17
2022-01-02,Binh Duong,Di An,16,19,8,11,10
2022-01-02,Binh Duong,Di An,17,21,8,13,11
2022-01-02,Binh Duong,Di An,18,19,5,14,11
2022-01-02,Binh Duong,Di An,19,16,11,5,2
2022-01-02,Binh Duong,Di An,20,9,3,6,5
2022-01-02,Binh Duong,Di An,21,10,0,10,8
2022-01-02,Binh Duong,Tan Uyen,8,1,1,0,0
2022-01-02,Binh Duong,Tan Uyen,10,2,0,2,1
2022-01-02,Binh Duong,Tan Uyen,11,1,0,1,1
2022-01-02,Binh Duong,Tan Uyen,15,2,1,1,1
2022-01-02,Binh Duong,Tan Uyen,18,2,0,2,1
2022-01-02,Binh Duong,Thu Dau Mot Town,0,2,2,0,0
2022-01-02,Binh Duong,Thu Dau Mot Town,1,1,1,0,0
2022-01-02,Binh Duong,Thu Dau Mot Town,3,2,1,1,0
2022-01-02,Binh Duong,Thu Dau Mot Town,6,21,17,4,3
2022-01-02,Binh Duong,Thu Dau Mot Town,7,115,96,19,1
2022-01-02,Binh Duong,Thu Dau Mot Town,8,185,164,21,5
2022-01-02,Binh Duong,Thu Dau Mot Town,9,265,251,14,0
2022-01-02,Binh Duong,Thu Dau Mot Town,10,385,355,30,7
2022-01-02,Binh Duong,Thu Dau Mot Town,11,519,475,44,12
2022-01-02,Binh Duong,Thu Dau Mot Town,12,457,432,25,2
2022-01-02,Binh Duong,Thu Dau Mot Town,13,328,316,12,2
2022-01-02,Binh Duong,Thu Dau Mot Town,14,277,266,11,4
2022-01-02,Binh Duong,Thu Dau Mot Town,15,258,244,14,2
2022-01-02,Binh Duong,Thu Dau Mot Town,16,296,276,20,6
2022-01-02,Binh Duong,Thu Dau Mot Town,17,339,318,21,3
2022-01-02,Binh Duong,Thu Dau Mot Town,18,356,322,34,9
2022-01-02,Binh Duong,Thu Dau Mot Town,19,281,251,30,8
2022-01-02,Binh Duong,Thu Dau Mot Town,20,199,184,15,1
2022-01-02,Binh Duong,Thu Dau Mot Town,21,115,93,22,6
2022-01-02,Binh Duong,Thu Dau Mot Town,22,1,0,1,0
2022-01-02,Binh Duong,Thuan An,7,3,0,3,3
2022-01-02,Binh Duong,Thuan An,8,21,7,14,12
2022-01-02,Binh Duong,Thuan An,9,46,23,23,16
2022-01-02,Binh Duong,Thuan An,10,46,25,21,19
2022-01-02,Binh Duong,Thuan An,11,52,27,25,18
2022-01-02,Binh Duong,Thuan An,12,75,38,37,28
2022-01-02,Binh Duong,Thuan An,13,43,22,21,21
2022-01-02,Binh Duong,Thuan An,14,45,25,20,15
2022-01-02,Binh Duong,Thuan An,15,43,25,18,16
2022-01-02,Binh Duong,Thuan An,16,36,21,15,12
2022-01-02,Binh Duong,Thuan An,17,51,21,30,27
2022-01-02,Binh Duong,Thuan An,18,46,26,20,15
2022-01-02,Binh Duong,Thuan An,19,26,14,12,7
2022-01-02,Binh Duong,Thuan An,20,16,7,9,7
2022-01-02,Binh Duong,Thuan An,21,13,3,10,10
2022-01-02,Can Tho City,Binh Thuy District,7,1,1,0,0
2022-01-02,Can Tho City,Binh Thuy District,8,5,3,2,0
2022-01-02,Can Tho City,Binh Thuy District,9,8,6,2,0
2022-01-02,Can Tho City,Binh Thuy District,10,4,4,0,0
2022-01-02,Can Tho City,Binh Thuy District,11,12,11,1,0
2022-01-02,Can Tho City,Binh Thuy District,12,16,12,4,0
2022-01-02,Can Tho City,Binh Thuy District,13,5,5,0,0
2022-01-02,Can Tho City,Binh Thuy District,14,7,7,0,0
2022-01-02,Can Tho City,Binh Thuy District,15,7,5,2,1
2022-01-02,Can Tho City,Binh Thuy District,16,11,11,0,0
2022-01-02,Can Tho City,Binh Thuy District,17,17,14,3,0
2022-01-02,Can Tho City,Binh Thuy District,18,10,7,3,0
2022-01-02,Can Tho City,Binh Thuy District,19,7,7,0,0
2022-01-02,Can Tho City,Binh Thuy District,20,6,5,1,0
2022-01-02,Can Tho City,Binh Thuy District,21,1,1,0,0
2022-01-02,Can Tho City,Cai Rang District,2,1,1,0,0
2022-01-02,Can Tho City,Cai Rang District,3,1,1,0,0
2022-01-02,Can Tho City,Cai Rang District,6,1,1,0,0
2022-01-02,Can Tho City,Cai Rang District,7,1,1,0,0
2022-01-02,Can Tho City,Cai Rang District,8,3,2,1,0
2022-01-02,Can Tho City,Cai Rang District,9,5,5,0,0
2022-01-02,Can Tho City,Cai Rang District,10,8,8,0,0
2022-01-02,Can Tho City,Cai Rang District,11,14,11,3,0
2022-01-02,Can Tho City,Cai Rang District,12,7,7,0,0
2022-01-02,Can Tho City,Cai Rang District,13,11,9,2,0
2022-01-02,Can Tho City,Cai Rang District,14,5,5,0,0
2022-01-02,Can Tho City,Cai Rang District,15,9,9,0,0
2022-01-02,Can Tho City,Cai Rang District,16,11,8,3,0
2022-01-02,Can Tho City,Cai Rang District,17,15,14,1,0
2022-01-02,Can Tho City,Cai Rang District,18,19,17,2,0
2022-01-02,Can Tho City,Cai Rang District,19,9,8,1,1
2022-01-02,Can Tho City,Cai Rang District,20,6,5,1,1
2022-01-02,Can Tho City,Cai Rang District,21,3,1,2,2
2022-01-02,Can Tho City,Cai Rang District,22,1,0,1,0
2022-01-02,Can Tho City,Ninh Kieu District,0,4,4,0,0
2022-01-02,Can Tho City,Ninh Kieu District,1,2,0,2,0
2022-01-02,Can Tho City,Ninh Kieu District,2,3,3,0,0
2022-01-02,Can Tho City,Ninh Kieu District,5,2,1,1,0
2022-01-02,Can Tho City,Ninh Kieu District,6,50,45,5,0
2022-01-02,Can Tho City,Ninh Kieu District,7,132,121,11,0
2022-01-02,Can Tho City,Ninh Kieu District,8,230,212,18,0
2022-01-02,Can Tho City,Ninh Kieu District,9,279,253,26,0
2022-01-02,Can Tho City,Ninh Kieu District,10,432,413,19,0
2022-01-02,Can Tho City,Ninh Kieu District,11,546,516,30,0
2022-01-02,Can Tho City,Ninh Kieu District,12,586,569,17,0
2022-01-02,Can Tho City,Ninh Kieu District,13,363,346,17,0
2022-01-02,Can Tho City,Ninh Kieu District,14,347,326,21,0
2022-01-02,Can Tho City,Ninh Kieu District,15,297,285,12,0
2022-01-02,Can Tho City,Ninh Kieu District,16,379,352,27,0
2022-01-02,Can Tho City,Ninh Kieu District,17,461,441,20,1
2022-01-02,Can Tho City,Ninh Kieu District,18,468,450,18,0
2022-01-02,Can Tho City,Ninh Kieu District,19,347,329,18,0
2022-01-02,Can Tho City,Ninh Kieu District,20,290,267,23,0
2022-01-02,Can Tho City,Ninh Kieu District,21,159,141,18,0
2022-01-02,Can Tho City,Ninh Kieu District,22,2,1,1,0
2022-01-02,Can Tho City,Ninh Kieu District,23,2,2,0,0
2022-01-02,Dong Nai,Bien Hoa City,0,1,1,0,0
2022-01-02,Dong Nai,Bien Hoa City,1,1,1,0,0
2022-01-02,Dong Nai,Bien Hoa City,6,35,20,15,12
2022-01-02,Dong Nai,Bien Hoa City,7,162,124,38,23
2022-01-02,Dong Nai,Bien Hoa City,8,239,207,32,16
2022-01-02,Dong Nai,Bien Hoa City,9,419,365,54,9
2022-01-02,Dong Nai,Bien Hoa City,10,663,596,67,20
2022-01-02,Dong Nai,Bien Hoa City,11,951,865,86,24
2022-01-02,Dong Nai,Bien Hoa City,12,976,876,100,37
2022-01-02,Dong Nai,Bien Hoa City,13,678,626,52,14
2022-01-02,Dong Nai,Bien Hoa City,14,568,499,69,22
2022-01-02,Dong Nai,Bien Hoa City,15,519,455,64,29
2022-01-02,Dong Nai,Bien Hoa City,16,526,453,73,38
2022-01-02,Dong Nai,Bien Hoa City,17,582,525,57,23
2022-01-02,Dong Nai,Bien Hoa City,18,711,603,108,48
2022-01-02,Dong Nai,Bien Hoa City,19,587,480,107,71
2022-01-02,Dong Nai,Bien Hoa City,20,545,334,211,157
2022-01-02,Dong Nai,Bien Hoa City,21,228,135,93,64
2022-01-02,Dong Nai,Bien Hoa City,22,1,0,1,0
2022-01-02,Dong Nai,Bien Hoa City,23,2,1,1,0
2022-01-02,Dong Nai,Long Thanh,10,1,0,1,1
2022-01-02,Dong Nai,Long Thanh,11,1,0,1,1
2022-01-02,Dong Nai,Long Thanh,12,1,0,1,1
2022-01-02,Dong Nai,Long Thanh,14,1,0,1,1
2022-01-02,Dong Nai,Long Thanh,18,1,0,1,1
2022-01-02,Dong Nai,Thong Nhat,11,1,1,0,0
2022-01-02,Dong Nai,Thong Nhat,13,4,3,1,1
2022-01-02,Dong Nai,Thong Nhat,14,2,2,0,0
2022-01-02,Dong Nai,Thong Nhat,15,1,1,0,0
2022-01-02,Dong Nai,Thong Nhat,16,2,2,0,0
2022-01-02,Dong Nai,Thong Nhat,17,1,1,0,0
2022-01-02,Dong Nai,Thong Nhat,19,3,3,0,0
2022-01-02,Dong Nai,Thong Nhat,20,2,2,0,0
2022-01-02,Dong Nai,Thong Nhat,21,2,1,1,0
2022-01-02,Dong Nai,Trang Bom,13,1,0,1,1
2022-01-02,Dong Nai,Trang Bom,14,1,0,1,1
2022-01-02,Dong Nai,Vinh Cuu,9,1,1,0,0
2022-01-02,Hai Phong City,An Duong,4,1,0,1,1
2022-01-02,Hai Phong City,An Duong,8,2,1,1,1
2022-01-02,Hai Phong City,An Duong,9,2,1,1,1
2022-01-02,Hai Phong City,An Duong,10,3,3,0,0
2022-01-02,Hai Phong City,An Duong,11,1,0,1,1
2022-01-02,Hai Phong City,An Duong,12,2,1,1,1
2022-01-02,Hai Phong City,An Duong,14,1,1,0,0
2022-01-02,Hai Phong City,An Duong,15,2,2,0,0
2022-01-02,Hai Phong City,An Duong,16,2,2,0,0
2022-01-02,Hai Phong City,An Duong,17,2,2,0,0
2022-01-02,Hai Phong City,An Duong,18,3,3,0,0
2022-01-02,Hai Phong City,An Duong,19,1,1,0,0
2022-01-02,Hai Phong City,An Duong,20,4,1,3,2
2022-01-02,Hai Phong City,An Duong,21,3,1,2,2
2022-01-02,Hai Phong City,Duong Kinh District,15,1,0,1,1
2022-01-02,Hai Phong City,Hai An District,7,7,1,6,2
2022-01-02,Hai Phong City,Hai An District,8,7,5,2,1
2022-01-02,Hai Phong City,Hai An District,9,15,12,3,0
2022-01-02,Hai Phong City,Hai An District,10,12,10,2,0
2022-01-02,Hai Phong City,Hai An District,11,29,25,4,1
2022-01-02,Hai Phong City,Hai An District,12,29,21,8,0
2022-01-02,Hai Phong City,Hai An District,13,11,9,2,1
2022-01-02,Hai Phong City,Hai An District,14,12,12,0,0
2022-01-02,Hai Phong City,Hai An District,15,14,11,3,1
2022-01-02,Hai Phong City,Hai An District,16,18,16,2,0
2022-01-02,Hai Phong City,Hai An District,17,21,17,4,0
2022-01-02,Hai Phong City,Hai An District,18,29,26,3,0
2022-01-02,Hai Phong City,Hai An District,19,19,15,4,0
2022-01-02,Hai Phong City,Hai An District,20,15,13,2,0
2022-01-02,Hai Phong City,Hai An District,21,25,12,13,6
2022-01-02,Hai Phong City,Hong Bang District,2,1,1,0,0
2022-01-02,Hai Phong City,Hong Bang District,7,17,8,9,8
2022-01-02,Hai Phong City,Hong Bang District,8,32,28,4,2
2022-01-02,Hai Phong City,Hong Bang District,9,58,40,18,7
2022-01-02,Hai Phong City,Hong Bang District,10,86,66,20,9
2022-01-02,Hai Phong City,Hong Bang District,11,123,103,20,9
2022-01-02,Hai Phong City,Hong Bang District,12,92,84,8,0
2022-01-02,Hai Phong City,Hong Bang District,13,55,49,6,2
2022-01-02,Hai Phong City,Hong Bang District,14,50,41,9,2
2022-01-02,Hai Phong City,Hong Bang District,15,62,44,18,2
2022-01-02,Hai Phong City,Hong Bang District,16,59,54,5,1
2022-01-02,Hai Phong City,Hong Bang District,17,63,56,7,4
2022-01-02,Hai Phong City,Hong Bang District,18,86,75,11,5
2022-01-02,Hai Phong City,Hong Bang District,19,81,71,10,4
2022-01-02,Hai Phong City,Hong Bang District,20,51,42,9,3
2022-01-02,Hai Phong City,Hong Bang District,21,25,15,10,5
2022-01-02,Hai Phong City,Kien An District,7,3,0,3,3
2022-01-02,Hai Phong City,Kien An District,8,3,2,1,1
2022-01-02,Hai Phong City,Kien An District,9,5,3,2,2
2022-01-02,Hai Phong City,Kien An District,10,16,6,10,6
2022-01-02,Hai Phong City,Kien An District,11,8,5,3,3
2022-01-02,Hai Phong City,Kien An District,12,4,2,2,1
2022-01-02,Hai Phong City,Kien An District,13,13,6,7,6
2022-01-02,Hai Phong City,Kien An District,14,8,3,5,3
2022-01-02,Hai Phong City,Kien An District,15,12,9,3,3
2022-01-02,Hai Phong City,Kien An District,16,15,10,5,5
2022-01-02,Hai Phong City,Kien An District,17,5,2,3,3
2022-01-02,Hai Phong City,Kien An District,18,8,6,2,2
2022-01-02,Hai Phong City,Kien An District,19,6,3,3,3
2022-01-02,Hai Phong City,Kien An District,20,8,5,3,1
2022-01-02,Hai Phong City,Kien An District,21,5,1,4,4
2022-01-02,Hai Phong City,Le Chan District,0,1,0,1,0
2022-01-02,Hai Phong City,Le Chan District,1,2,2,0,0
2022-01-02,Hai Phong City,Le Chan District,2,1,0,1,0
2022-01-02,Hai Phong City,Le Chan District,4,2,2,0,0
2022-01-02,Hai Phong City,Le Chan District,5,1,1,0,0
2022-01-02,Hai Phong City,Le Chan District,6,3,0,3,2
2022-01-02,Hai Phong City,Le Chan District,7,36,20,16,12
2022-01-02,Hai Phong City,Le Chan District,8,90,68,22,10
2022-01-02,Hai Phong City,Le Chan District,9,115,95,20,9
2022-01-02,Hai Phong City,Le Chan District,10,220,204,16,3
2022-01-02,Hai Phong City,Le Chan District,11,352,290,62,23
2022-01-02,Hai Phong City,Le Chan District,12,269,242,27,4
2022-01-02,Hai Phong City,Le Chan District,13,132,122,10,0
2022-01-02,Hai Phong City,Le Chan District,14,164,143,21,1
2022-01-02,Hai Phong City,Le Chan District,15,212,198,14,3
2022-01-02,Hai Phong City,Le Chan District,16,240,207,33,1
2022-01-02,Hai Phong City,Le Chan District,17,249,227,22,6
2022-01-02,Hai Phong City,Le Chan District,18,298,243,55,23
2022-01-02,Hai Phong City,Le Chan District,19,212,189,23,4
2022-01-02,Hai Phong City,Le Chan District,20,174,135,39,8
2022-01-02,Hai Phong City,Le Chan District,21,101,67,34,13
2022-01-02,Hai Phong City,Le Chan District,22,1,0,1,0
2022-01-02,Hai Phong City,Le Chan District,23,1,1,0,0
2022-01-02,Hai Phong City,Ngo Quyen District,0,5,3,2,2
2022-01-02,Hai Phong City,Ngo Quyen District,3,2,0,2,1
2022-01-02,Hai Phong City,Ngo Quyen District,6,2,1,1,1
2022-01-02,Hai Phong City,Ngo Quyen District,7,36,23,13,7
2022-01-02,Hai Phong City,Ngo Quyen District,8,68,58,10,6
2022-01-02,Hai Phong City,Ngo Quyen District,9,116,100,16,4
2022-01-02,Hai Phong City,Ngo Quyen District,10,190,166,24,1
2022-01-02,Hai Phong City,Ngo Quyen District,11,296,254,42,18
2022-01-02,Hai Phong City,Ngo Quyen District,12,202,178,24,7
2022-01-02,Hai Phong City,Ngo Quyen District,13,147,130,17,1
2022-01-02,Hai Phong City,Ngo Quyen District,14,132,116,16,3
2022-01-02,Hai Phong City,Ngo Quyen District,15,181,161,20,7
2022-01-02,Hai Phong City,Ngo Quyen District,16,199,174,25,4
2022-01-02,Hai Phong City,Ngo Quyen District,17,222,197,25,11
2022-01-02,Hai Phong City,Ngo Quyen District,18,232,188,44,18
2022-01-02,Hai Phong City,Ngo Quyen District,19,186,161,25,5
2022-01-02,Hai Phong City,Ngo Quyen District,20,166,135,31,12
2022-01-02,Hai Phong City,Ngo Quyen District,21,81,63,18,9
2022-01-02,Hai Phong City,Ngo Quyen District,22,2,1,1,0
2022-01-02,Hai Phong City,Ngo Quyen District,23,2,1,1,0
2022-01-02,Hai Phong City,Thuy Nguyen,8,1,0,1,1
2022-01-02,Hai Phong City,Thuy Nguyen,9,1,0,1,1
2022-01-02,Hai Phong City,Thuy Nguyen,10,2,0,2,2
2022-01-02,Hai Phong City,Thuy Nguyen,11,4,0,4,2
2022-01-02,Hai Phong City,Thuy Nguyen,12,1,1,0,0
2022-01-02,Hai Phong City,Thuy Nguyen,15,1,1,0,0
2022-01-02,Hai Phong City,Thuy Nguyen,17,4,0,4,4
2022-01-02,Hai Phong City,Thuy Nguyen,18,2,0,2,2
2022-01-02,Hai Phong City,Thuy Nguyen,20,1,0,1,1
2022-01-02,Hai Phong City,Thuy Nguyen,21,2,0,2,2
2022-01-02,Hue City,Hue City,0,6,4,2,0
2022-01-02,Hue City,Hue City,1,3,3,0,0
2022-01-02,Hue City,Hue City,2,2,1,1,0
2022-01-02,Hue City,Hue City,3,1,1,0,0
2022-01-02,Hue City,Hue City,6,47,43,4,2
2022-01-02,Hue City,Hue City,7,210,191,19,1
2022-01-02,Hue City,Hue City,8,336,317,19,1
2022-01-02,Hue City,Hue City,9,306,286,20,0
2022-01-02,Hue City,Hue City,10,380,346,34,0
2022-01-02,Hue City,Hue City,11,651,617,34,3
2022-01-02,Hue City,Hue City,12,498,480,18,1
2022-01-02,Hue City,Hue City,13,313,284,29,1
2022-01-02,Hue City,Hue City,14,333,317,16,0
2022-01-02,Hue City,Hue City,15,399,364,35,0
2022-01-02,Hue City,Hue City,16,431,397,34,2
2022-01-02,Hue City,Hue City,17,558,522,36,2
2022-01-02,Hue City,Hue City,18,578,538,40,1
2022-01-02,Hue City,Hue City,19,485,447,38,6
2022-01-02,Hue City,Hue City,20,451,368,83,30
2022-01-02,Hue City,Hue City,21,257,198,59,26
2022-01-02,Hue City,Hue City,22,3,1,2,0
2022-01-02,Hue City,Hue City,23,3,2,1,0
2022-01-02,Hue City,Huong Thuy,7,1,1,0,0
2022-01-02,Hue City,Huong Thuy,8,1,0,1,0
2022-01-02,Hue City,Huong Thuy,10,3,2,1,1
2022-01-02,Hue City,Huong Thuy,12,1,0,1,0
2022-01-02,Hue City,Huong Thuy,16,2,2,0,0
2022-01-02,Hue City,Huong Thuy,18,1,1,0,0
2022-01-02,Hue City,Huong Thuy,20,4,0,4,3
2022-01-02,Hue City,Phu Vang,6,1,0,1,1
2022-01-02,Hue City,Phu Vang,7,10,7,3,2
2022-01-02,Hue City,Phu Vang,8,3,2,1,0
2022-01-02,Hue City,Phu Vang,10,4,2,2,1
2022-01-02,Hue City,Phu Vang,11,1,1,0,0
2022-01-02,Hue City,Phu Vang,14,4,3,1,0
2022-01-02,Hue City,Phu Vang,15,1,0,1,0
2022-01-02,Hue City,Phu Vang,16,4,3,1,0
2022-01-02,Hue City,Phu Vang,17,1,0,1,1
2022-01-02,Hue City,Phu Vang,19,2,1,1,0
2022-01-02,Hue City,Phu Vang,21,2,1,1,0
2022-01-02,Vung Tau,Ba Ria City,5,1,0,1,1
2022-01-02,Vung Tau,Ba Ria City,8,6,0,6,6
2022-01-02,Vung Tau,Ba Ria City,9,13,3,10,10
2022-01-02,Vung Tau,Ba Ria City,10,9,3,6,5
2022-01-02,Vung Tau,Ba Ria City,11,19,5,14,14
2022-01-02,Vung Tau,Ba Ria City,12,14,1,13,13
2022-01-02,Vung Tau,Ba Ria City,13,27,7,20,17
2022-01-02,Vung Tau,Ba Ria City,14,4,2,2,2
2022-01-02,Vung Tau,Ba Ria City,15,5,4,1,0
2022-01-02,Vung Tau,Ba Ria City,16,5,4,1,1
2022-01-02,Vung Tau,Ba Ria City,17,10,5,5,5
2022-01-02,Vung Tau,Ba Ria City,18,4,2,2,2
2022-01-02,Vung Tau,Ba Ria City,19,5,2,3,2
2022-01-02,Vung Tau,Ba Ria City,20,11,0,11,11
2022-01-02,Vung Tau,Vung Tau City,0,1,1,0,0
2022-01-02,Vung Tau,Vung Tau City,3,1,1,0,0
2022-01-02,Vung Tau,Vung Tau City,6,31,24,7,1
2022-01-02,Vung Tau,Vung Tau City,7,144,133,11,2
2022-01-02,Vung Tau,Vung Tau City,8,229,209,20,2
2022-01-02,Vung Tau,Vung Tau City,9,264,226,38,1
2022-01-02,Vung Tau,Vung Tau City,10,320,286,34,2
2022-01-02,Vung Tau,Vung Tau City,11,427,352,75,34
2022-01-02,Vung Tau,Vung Tau City,12,311,290,21,1
2022-01-02,Vung Tau,Vung Tau City,13,257,240,17,0
2022-01-02,Vung Tau,Vung Tau City,14,248,229,19,4
2022-01-02,Vung Tau,Vung Tau City,15,240,208,32,2
2022-01-02,Vung Tau,Vung Tau City,16,237,212,25,2
2022-01-02,Vung Tau,Vung Tau City,17,288,258,30,3
2022-01-02,Vung Tau,Vung Tau City,18,419,328,91,43
2022-01-02,Vung Tau,Vung Tau City,19,307,252,55,5
2022-01-02,Vung Tau,Vung Tau City,20,197,167,30,7
2022-01-02,Vung Tau,Vung Tau City,21,107,85,22,5
2022-01-02,Vung Tau,Vung Tau City,22,3,2,1,0
2022-01-03,Binh Duong,Ben Cat,9,1,1,0,0
2022-01-03,Binh Duong,Ben Cat,12,1,0,1,0
2022-01-03,Binh Duong,Ben Cat,15,1,0,1,1
2022-01-03,Binh Duong,Di An,7,6,1,5,5
2022-01-03,Binh Duong,Di An,8,8,4,4,3
2022-01-03,Binh Duong,Di An,9,6,4,2,1
2022-01-03,Binh Duong,Di An,10,6,4,2,2
2022-01-03,Binh Duong,Di An,11,28,9,19,12
2022-01-03,Binh Duong,Di An,12,24,9,15,13
2022-01-03,Binh Duong,Di An,13,14,8,6,4
2022-01-03,Binh Duong,Di An,14,7,3,4,3
2022-01-03,Binh Duong,Di An,15,19,8,11,7
2022-01-03,Binh Duong,Di An,16,21,10,11,8
2022-01-03,Binh Duong,Di An,17,15,8,7,5
2022-01-03,Binh Duong,Di An,18,15,6,9,8
2022-01-03,Binh Duong,Di An,19,18,7,11,11
2022-01-03,Binh Duong,Di An,20,14,1,13,13
2022-01-03,Binh Duong,Di An,21,2,0,2,2
2022-01-03,Binh Duong,Tan Uyen,10,1,0,1,0
2022-01-03,Binh Duong,Tan Uyen,12,1,1,0,0
2022-01-03,Binh Duong,Tan Uyen,13,1,1,0,0
2022-01-03,Binh Duong,Tan Uyen,21,1,1,0,0
2022-01-03,Binh Duong,Thu Dau Mot Town,1,2,0,2,0
2022-01-03,Binh Duong,Thu Dau Mot Town,3,1,1,0,0
2022-01-03,Binh Duong,Thu Dau Mot Town,4,1,0,1,1
2022-01-03,Binh Duong,Thu Dau Mot Town,5,1,1,0,0
2022-01-03,Binh Duong,Thu Dau Mot Town,6,28,26,2,0
2022-01-03,Binh Duong,Thu Dau Mot Town,7,96,91,5,2
2022-01-03,Binh Duong,Thu Dau Mot Town,8,153,146,7,1
2022-01-03,Binh Duong,Thu Dau Mot Town,9,218,204,14,0
2022-01-03,Binh Duong,Thu Dau Mot Town,10,352,330,22,4
2022-01-03,Binh Duong,Thu Dau Mot Town,11,525,498,27,5
2022-01-03,Binh Duong,Thu Dau Mot Town,12,423,389,34,5
2022-01-03,Binh Duong,Thu Dau Mot Town,13,333,322,11,0
2022-01-03,Binh Duong,Thu Dau Mot Town,14,251,237,14,1
2022-01-03,Binh Duong,Thu Dau Mot Town,15,249,233,16,3
2022-01-03,Binh Duong,Thu Dau Mot Town,16,251,237,14,1
2022-01-03,Binh Duong,Thu Dau Mot Town,17,310,294,16,0
2022-01-03,Binh Duong,Thu Dau Mot Town,18,331,310,21,4
2022-01-03,Binh Duong,Thu Dau Mot Town,19,296,270,26,7
2022-01-03,Binh Duong,Thu Dau Mot Town,20,226,180,46,22
2022-01-03,Binh Duong,Thu Dau Mot Town,21,129,76,53,34
2022-01-03,Binh Duong,Thu Dau Mot Town,22,2,1,1,0
2022-01-03,Binh Duong,Thuan An,7,5,0,5,5
2022-01-03,Binh Duong,Thuan An,8,12,6,6,5
2022-01-03,Binh Duong,Thuan An,9,20,13,7,6
2022-01-03,Binh Duong,Thuan An,10,37,23,14,10
2022-01-03,Binh Duong,Thuan An,11,74,43,31,24
2022-01-03,Binh Duong,Thuan An,12,59,41,18,13
2022-01-03,Binh Duong,Thuan An,13,41,26,15,12
2022-01-03,Binh Duong,Thuan An,14,31,26,5,5
2022-01-03,Binh Duong,Thuan An,15,31,20,11,9
2022-01-03,Binh Duong,Thuan An,16,30,13,17,13
2022-01-03,Binh Duong,Thuan An,17,35,23,12,10
2022-01-03,Binh Duong,Thuan An,18,25,19,6,5
2022-01-03,Binh Duong,Thuan An,19,26,13,13,8
2022-01-03,Binh Duong,Thuan An,20,23,7,16,16
2022-01-03,Binh Duong,Thuan An,21,17,2,15,15
2022-01-03,Can Tho City,Binh Thuy District,7,4,3,1,0
2022-01-03,Can Tho City,Binh Thuy District,8,1,1,0,0
2022-01-03,Can Tho City,Binh Thuy District,9,3,3,0,0
2022-01-03,Can Tho City,Binh Thuy District,10,9,7,2,0
2022-01-03,Can Tho City,Binh Thuy District,11,8,6,2,1
2022-01-03,Can Tho City,Binh Thuy District,12,10,9,1,0
2022-01-03,Can Tho City,Binh Thuy District,13,16,15,1,0
2022-01-03,Can Tho City,Binh Thuy District,14,12,12,0,0
2022-01-03,Can Tho City,Binh Thuy District,15,13,12,1,0
2022-01-03,Can Tho City,Binh Thuy District,16,3,3,0,0
2022-01-03,Can Tho City,Binh Thuy District,17,10,10,0,0
2022-01-03,Can Tho City,Binh Thuy District,18,11,11,0,0
2022-01-03,Can Tho City,Binh Thuy District,19,5,4,1,0
2022-01-03,Can Tho City,Binh Thuy District,20,10,9,1,0
2022-01-03,Can Tho City,Binh Thuy District,22,1,0,1,0
2022-01-03,Can Tho City,Cai Rang District,6,1,1,0,0
2022-01-03,Can Tho City,Cai Rang District,7,4,3,1,0
2022-01-03,Can Tho City,Cai Rang District,8,4,2,2,0
2022-01-03,Can Tho City,Cai Rang District,9,7,7,0,0
2022-01-03,Can Tho City,Cai Rang District,10,7,7,0,0
2022-01-03,Can Tho City,Cai Rang District,11,18,16,2,0
2022-01-03,Can Tho City,Cai Rang District,12,14,13,1,0
2022-01-03,Can Tho City,Cai Rang District,13,9,9,0,0
2022-01-03,Can Tho City,Cai Rang District,14,12,11,1,0
2022-01-03,Can Tho City,Cai Rang District,15,4,4,0,0
2022-01-03,Can Tho City,Cai Rang District,16,6,6,0,0
2022-01-03,Can Tho City,Cai Rang District,17,7,7,0,0
2022-01-03,Can Tho City,Cai Rang District,18,16,14,2,1
2022-01-03,Can Tho City,Cai Rang District,19,9,7,2,0
2022-01-03,Can Tho City,Cai Rang District,20,12,7,5,0
2022-01-03,Can Tho City,Cai Rang District,21,2,1,1,1
2022-01-03,Can Tho City,Ninh Kieu District,0,5,4,1,0
2022-01-03,Can Tho City,Ninh Kieu District,1,5,4,1,0
2022-01-03,Can Tho City,Ninh Kieu District,2,2,2,0,0
2022-01-03,Can Tho City,Ninh Kieu District,3,2,1,1,0
2022-01-03,Can Tho City,Ninh Kieu District,4,1,1,0,0
2022-01-03,Can Tho City,Ninh Kieu District,5,3,3,0,0
2022-01-03,Can Tho City,Ninh Kieu District,6,45,42,3,0
2022-01-03,Can Tho City,Ninh Kieu District,7,150,140,10,0
2022-01-03,Can Tho City,Ninh Kieu District,8,205,189,16,0
2022-01-03,Can Tho City,Ninh Kieu District,9,262,245,17,0
2022-01-03,Can Tho City,Ninh Kieu District,10,394,381,13,0
2022-01-03,Can Tho City,Ninh Kieu District,11,646,624,22,0
2022-01-03,Can Tho City,Ninh Kieu District,12,536,512,24,0
2022-01-03,Can Tho City,Ninh Kieu District,13,416,391,25,0
2022-01-03,Can Tho City,Ninh Kieu District,14,343,330,13,0
2022-01-03,Can Tho City,Ninh Kieu District,15,314,292,22,0
2022-01-03,Can Tho City,Ninh Kieu District,16,370,347,23,0
2022-01-03,Can Tho City,Ninh Kieu District,17,421,409,12,0
2022-01-03,Can Tho City,Ninh Kieu District,18,447,425,22,0
2022-01-03,Can Tho City,Ninh Kieu District,19,375,354,21,0
2022-01-03,Can Tho City,Ninh Kieu District,20,254,229,25,1
2022-01-03,Can Tho City,Ninh Kieu District,21,140,123,17,0
2022-01-03,Can Tho City,Ninh Kieu District,22,5,3,2,0
2022-01-03,Can Tho City,Ninh Kieu District,23,2,2,0,0
2022-01-03,Can Tho City,Phong Dien,16,1,0,1,1
2022-01-03,Dong Nai,Bien Hoa City,0,2,1,1,0
2022-01-03,Dong Nai,Bien Hoa City,1,2,0,2,1
2022-01-03,Dong Nai,Bien Hoa City,2,1,1,0,0
2022-01-03,Dong Nai,Bien Hoa City,3,1,0,1,1
2022-01-03,Dong Nai,Bien Hoa City,6,39,23,16,13
2022-01-03,Dong Nai,Bien Hoa City,7,131,105,26,10
2022-01-03,Dong Nai,Bien Hoa City,8,205,181,24,4
2022-01-03,Dong Nai,Bien Hoa City,9,372,334,38,5
2022-01-03,Dong Nai,Bien Hoa City,10,625,575,50,2
2022-01-03,Dong Nai,Bien Hoa City,11,937,856,81,17
2022-01-03,Dong Nai,Bien Hoa City,12,812,752,60,7
2022-01-03,Dong Nai,Bien Hoa City,13,647,598,49,6
2022-01-03,Dong Nai,Bien Hoa City,14,546,504,42,3
2022-01-03,Dong Nai,Bien Hoa City,15,458,431,27,4
2022-01-03,Dong Nai,Bien Hoa City,16,434,399,35,3
2022-01-03,Dong Nai,Bien Hoa City,17,544,513,31,2
2022-01-03,Dong Nai,Bien Hoa City,18,564,526,38,3
2022-01-03,Dong Nai,Bien Hoa City,19,566,497,69,24
2022-01-03,Dong Nai,Bien Hoa City,20,508,392,116,71
2022-01-03,Dong Nai,Bien Hoa City,21,200,138,62,28
2022-01-03,Dong Nai,Bien Hoa City,22,3,2,1,0
2022-01-03,Dong Nai,Bien Hoa City,23,2,1,1,0
2022-01-03,Dong Nai,Long Thanh,12,2,0,2,2
2022-01-03,Dong Nai,Long Thanh,15,2,0,2,2
2022-01-03,Dong Nai,Long Thanh,16,1,0,1,1
2022-01-03,Dong Nai,Long Thanh,17,2,0,2,2
2022-01-03,Dong Nai,Thong Nhat,8,1,1,0,0
2022-01-03,Dong Nai,Thong Nhat,9,3,3,0,0
2022-01-03,Dong Nai,Thong Nhat,10,1,1,0,0
2022-01-03,Dong Nai,Thong Nhat,11,1,1,0,0
2022-01-03,Dong Nai,Thong Nhat,13,1,1,0,0
2022-01-03,Dong Nai,Thong Nhat,14,1,1,0,0
2022-01-03,Dong Nai,Thong Nhat,17,1,1,0,0
2022-01-03,Dong Nai,Thong Nhat,19,1,1,0,0
2022-01-03,Dong Nai,Thong Nhat,20,3,2,1,1
2022-01-03,Dong Nai,Trang Bom,14,2,0,2,1
2022-01-03,Dong Nai,Trang Bom,19,2,0,2,2
2022-01-03,Hai Phong City,An Duong,7,2,1,1,0
2022-01-03,Hai Phong City,An Duong,9,1,0,1,1
2022-01-03,Hai Phong City,An Duong,10,2,2,0,0
2022-01-03,Hai Phong City,An Duong,11,2,1,1,1
2022-01-03,Hai Phong City,An Duong,12,2,1,1,1
2022-01-03,Hai Phong City,An Duong,13,4,2,2,1
2022-01-03,Hai Phong City,An Duong,14,1,1,0,0
2022-01-03,Hai Phong City,An Duong,15,6,3,3,2
2022-01-03,Hai Phong City,An Duong,16,2,1,1,1
2022-01-03,Hai Phong City,An Duong,17,2,1,1,0
2022-01-03,Hai Phong City,An Duong,18,1,0,1,0
2022-01-03,Hai Phong City,An Duong,19,2,1,1,1
2022-01-03,Hai Phong City,An Duong,20,4,2,2,0
2022-01-03,Hai Phong City,An Duong,21,4,1,3,1
2022-01-03,Hai Phong City,Duong Kinh District,11,1,0,1,0
2022-01-03,Hai Phong City,Duong Kinh District,13,2,0,2,0
2022-01-03,Hai Phong City,Hai An District,6,2,0,2,0
2022-01-03,Hai Phong City,Hai An District,7,6,5,1,1
2022-01-03,Hai Phong City,Hai An District,8,14,10,4,1
2022-01-03,Hai Phong City,Hai An District,9,11,10,1,1
2022-01-03,Hai Phong City,Hai An District,10,18,17,1,0
2022-01-03,Hai Phong City,Hai An District,11,32,27,5,1
2022-01-03,Hai Phong City,Hai An District,12,16,15,1,0
2022-01-03,Hai Phong City,Hai An District,13,13,12,1,1
2022-01-03,Hai Phong City,Hai An District,14,8,7,1,0
2022-01-03,Hai Phong City,Hai An District,15,12,10,2,0
2022-01-03,Hai Phong City,Hai An District,16,20,13,7,1
2022-01-03,Hai Phong City,Hai An District,17,16,15,1,0
2022-01-03,Hai Phong City,Hai An District,18,21,20,1,1
2022-01-03,Hai Phong City,Hai An District,19,12,12,0,0
2022-01-03,Hai Phong City,Hai An District,20,16,12,4,2
2022-01-03,Hai Phong City,Hai An District,21,8,7,1,1
2022-01-03,Hai Phong City,Hong Bang District,7,9,5,4,2
2022-01-03,Hai Phong City,Hong Bang District,8,25,25,0,0
2022-01-03,Hai Phong City,Hong Bang District,9,40,37,3,0
2022-01-03,Hai Phong City,Hong Bang District,10,59,55,4,0
2022-01-03,Hai Phong City,Hong Bang District,11,107,97,10,4
2022-01-03,Hai Phong City,Hong Bang District,12,89,81,8,3
2022-01-03,Hai Phong City,Hong Bang District,13,53,48,5,0
2022-01-03,Hai Phong City,Hong Bang District,14,58,50,8,2
2022-01-03,Hai Phong City,Hong Bang District,15,44,36,8,0
2022-01-03,Hai Phong City,Hong Bang District,16,58,53,5,0
2022-01-03,Hai Phong City,Hong Bang District,17,60,49,11,1
2022-01-03,Hai Phong City,Hong Bang District,18,62,51,11,3
2022-01-03,Hai Phong City,Hong Bang District,19,73,58,15,1
2022-01-03,Hai Phong City,Hong Bang District,20,36,33,3,1
2022-01-03,Hai Phong City,Hong Bang District,21,14,11,3,2
2022-01-03,Hai Phong City,Hong Bang District,23,1,0,1,0
2022-01-03,Hai Phong City,Kien An District,7,6,1,5,5
2022-01-03,Hai Phong City,Kien An District,8,5,3,2,1
2022-01-03,Hai Phong City,Kien An District,9,1,1,0,0
2022-01-03,Hai Phong City,Kien An District,10,2,1,1,0
2022-01-03,Hai Phong City,Kien An District,11,13,11,2,2
2022-01-03,Hai Phong City,Kien An District,12,9,5,4,3
2022-01-03,Hai Phong City,Kien An District,13,9,4,5,3
2022-01-03,Hai Phong City,Kien An District,14,4,1,3,0
2022-01-03,Hai Phong City,Kien An District,15,4,4,0,0
2022-01-03,Hai Phong City,Kien An District,16,6,4,2,2
2022-01-03,Hai Phong City,Kien An District,17,10,7,3,2
2022-01-03,Hai Phong City,Kien An District,18,7,6,1,1
2022-01-03,Hai Phong City,Kien An District,19,8,8,0,0
2022-01-03,Hai Phong City,Kien An District,20,11,2,9,8
2022-01-03,Hai Phong City,Le Chan District,0,1,1,0,0
2022-01-03,Hai Phong City,Le Chan District,1,1,0,1,0
2022-01-03,Hai Phong City,Le Chan District,3,1,1,0,0
2022-01-03,Hai Phong City,Le Chan District,5,1,1,0,0
2022-01-03,Hai Phong City,Le Chan District,6,1,0,1,1
2022-01-03,Hai Phong City,Le Chan District,7,27,23,4,3
2022-01-03,Hai Phong City,Le Chan District,8,94,86,8,1
2022-01-03,Hai Phong City,Le Chan District,9,83,77,6,0
2022-01-03,Hai Phong City,Le Chan District,10,131,121,10,1
2022-01-03,Hai Phong City,Le Chan District,11,309,285,24,3
2022-01-03,Hai Phong City,Le Chan District,12,207,194,13,0
2022-01-03,Hai Phong City,Le Chan District,13,162,145,17,0
2022-01-03,Hai Phong City,Le Chan District,14,140,126,14,0
2022-01-03,Hai Phong City,Le Chan District,15,170,163,7,4
2022-01-03,Hai Phong City,Le Chan District,16,179,167,12,2
2022-01-03,Hai Phong City,Le Chan District,17,220,194,26,2
2022-01-03,Hai Phong City,Le Chan District,18,257,235,22,5
2022-01-03,Hai Phong City,Le Chan District,19,218,196,22,3
2022-01-03,Hai Phong City,Le Chan District,20,145,123,22,2
2022-01-03,Hai Phong City,Le Chan District,21,78,62,16,4
2022-01-03,Hai Phong City,Le Chan District,22,2,0,2,1
2022-01-03,Hai Phong City,Ngo Quyen District,0,1,1,0,0
2022-01-03,Hai Phong City,Ngo Quyen District,1,1,1,0,0
2022-01-03,Hai Phong City,Ngo Quyen District,2,1,1,0,0
2022-01-03,Hai Phong City,Ngo Quyen District,3,1,1,0,0
2022-01-03,Hai Phong City,Ngo Quyen District,6,2,2,0,0
2022-01-03,Hai Phong City,Ngo Quyen District,7,33,28,5,2
2022-01-03,Hai Phong City,Ngo Quyen District,8,72,55,17,1
2022-01-03,Hai Phong City,Ngo Quyen District,9,90,78,12,1
2022-01-03,Hai Phong City,Ngo Quyen District,10,148,138,10,0
2022-01-03,Hai Phong City,Ngo Quyen District,11,272,249,23,1
2022-01-03,Hai Phong City,Ngo Quyen District,12,197,182,15,2
2022-01-03,Hai Phong City,Ngo Quyen District,13,124,115,9,0
2022-01-03,Hai Phong City,Ngo Quyen District,14,140,128,12,0
2022-01-03,Hai Phong City,Ngo Quyen District,15,136,126,10,0
2022-01-03,Hai Phong City,Ngo Quyen District,16,137,125,12,0
2022-01-03,Hai Phong City,Ngo Quyen District,17,155,138,17,0
2022-01-03,Hai Phong City,Ngo Quyen District,18,195,169,26,7
2022-01-03,Hai Phong City,Ngo Quyen District,19,168,152,16,3
2022-01-03,Hai Phong City,Ngo Quyen District,20,119,110,9,1
2022-01-03,Hai Phong City,Ngo Quyen District,21,66,54,12,0
2022-01-03,Hai Phong City,Ngo Quyen District,22,1,0,1,0
2022-01-03,Hai Phong City,Thuy Nguyen,12,1,0,1,1
2022-01-03,Hai Phong City,Thuy Nguyen,13,1,0,1,1
2022-01-03,Hai Phong City,Thuy Nguyen,15,1,0,1,1
2022-01-03,Hai Phong City,Thuy Nguyen,16,2,0,2,2
2022-01-03,Hue City,Hue City,0,6,5,1,0
2022-01-03,Hue City,Hue City,1,2,2,0,0
2022-01-03,Hue City,Hue City,3,1,1,0,0
2022-01-03,Hue City,Hue City,5,4,2,2,0
2022-01-03,Hue City,Hue City,6,53,47,6,2
2022-01-03,Hue City,Hue City,7,217,192,25,3
2022-01-03,Hue City,Hue City,8,381,346,35,0
2022-01-03,Hue City,Hue City,9,280,257,23,0
2022-01-03,Hue City,Hue City,10,405,374,31,2
2022-01-03,Hue City,Hue City,11,668,641,27,2
2022-01-03,Hue City,Hue City,12,464,451,13,1
2022-01-03,Hue City,Hue City,13,344,327,17,2
2022-01-03,Hue City,Hue City,14,316,288,28,0
2022-01-03,Hue City,Hue City,15,444,410,34,0
2022-01-03,Hue City,Hue City,16,416,398,18,2
2022-01-03,Hue City,Hue City,17,522,490,32,2
2022-01-03,Hue City,Hue City,18,587,533,54,4
2022-01-03,Hue City,Hue City,19,508,469,39,5
2022-01-03,Hue City,Hue City,20,388,342,46,3
2022-01-03,Hue City,Hue City,21,228,192,36,5
2022-01-03,Hue City,Hue City,23,4,4,0,0
2022-01-03,Hue City,Huong Thuy,17,5,2,3,1
2022-01-03,Hue City,Huong Thuy,18,2,0,2,2
2022-01-03,Hue City,Huong Thuy,19,2,2,0,0
2022-01-03,Hue City,Huong Thuy,21,2,0,2,0
2022-01-03,Hue City,Huong Tra,8,3,0,3,0
2022-01-03,Hue City,Phu Vang,7,1,0,1,0
2022-01-03,Hue City,Phu Vang,8,2,0,2,0
2022-01-03,Hue City,Phu Vang,9,3,2,1,1
2022-01-03,Hue City,Phu Vang,11,3,2,1,0
2022-01-03,Hue City,Phu Vang,13,1,1,0,0
2022-01-03,Hue City,Phu Vang,14,2,1,1,0
2022-01-03,Hue City,Phu Vang,15,1,1,0,0
2022-01-03,Hue City,Phu Vang,16,1,0,1,0
2022-01-03,Hue City,Phu Vang,17,4,3,1,0
2022-01-03,Hue City,Phu Vang,19,1,1,0,0
2022-01-03,Hue City,Phu Vang,20,1,0,1,1
2022-01-03,Hue City,Phu Vang,21,1,1,0,0
2022-01-03,Vung Tau,Ba Ria City,7,1,1,0,0
2022-01-03,Vung Tau,Ba Ria City,8,11,1,10,8
2022-01-03,Vung Tau,Ba Ria City,9,5,4,1,1
2022-01-03,Vung Tau,Ba Ria City,10,5,2,3,1
2022-01-03,Vung Tau,Ba Ria City,11,13,4,9,9
2022-01-03,Vung Tau,Ba Ria City,12,12,3,9,9
2022-01-03,Vung Tau,Ba Ria City,13,6,5,1,1
2022-01-03,Vung Tau,Ba Ria City,14,8,7,1,0
2022-01-03,Vung Tau,Ba Ria City,15,6,2,4,2
2022-01-03,Vung Tau,Ba Ria City,17,5,0,5,5
2022-01-03,Vung Tau,Ba Ria City,18,11,3,8,6
2022-01-03,Vung Tau,Ba Ria City,19,4,1,3,3
2022-01-03,Vung Tau,Ba Ria City,20,2,0,2,2
2022-01-03,Vung Tau,Ba Ria City,21,2,0,2,1
2022-01-03,Vung Tau,Tan Thanh,11,1,0,1,1
2022-01-03,Vung Tau,Vung Tau City,1,3,3,0,0
2022-01-03,Vung Tau,Vung Tau City,4,1,1,0,0
2022-01-03,Vung Tau,Vung Tau City,5,1,1,0,0
2022-01-03,Vung Tau,Vung Tau City,6,29,28,1,0
2022-01-03,Vung Tau,Vung Tau City,7,125,115,10,0
2022-01-03,Vung Tau,Vung Tau City,8,208,193,15,0
2022-01-03,Vung Tau,Vung Tau City,9,168,148,20,0
2022-01-03,Vung Tau,Vung Tau City,10,220,201,19,1
2022-01-03,Vung Tau,Vung Tau City,11,354,318,36,0
2022-01-03,Vung Tau,Vung Tau City,12,311,286,25,0
2022-01-03,Vung Tau,Vung Tau City,13,192,184,8,0
2022-01-03,Vung Tau,Vung Tau City,14,213,195,18,1
2022-01-03,Vung Tau,Vung Tau City,15,196,185,11,1
2022-01-03,Vung Tau,Vung Tau City,16,213,200,13,1
2022-01-03,Vung Tau,Vung Tau City,17,287,268,19,0
2022-01-03,Vung Tau,Vung Tau City,18,318,294,24,1
2022-01-03,Vung Tau,Vung Tau City,19,234,211,23,0
2022-01-03,Vung Tau,Vung Tau City,20,186,162,24,2
2022-01-03,Vung Tau,Vung Tau City,21,89,73,16,7
2022-01-03,Vung Tau,Vung Tau City,22,2,0,2,0
2022-01-03,Vung Tau,Vung Tau City,23,3,2,1,0
2022-01-04,Binh Duong,Ben Cat,9,1,0,1,1
2022-01-04,Binh Duong,Ben Cat,13,2,1,1,1
2022-01-04,Binh Duong,Ben Cat,20,1,0,1,0
2022-01-04,Binh Duong,Di An,7,2,0,2,1
2022-01-04,Binh Duong,Di An,8,8,1,7,6
2022-01-04,Binh Duong,Di An,9,5,3,2,0
2022-01-04,Binh Duong,Di An,10,9,6,3,1
2022-01-04,Binh Duong,Di An,11,25,14,11,8
2022-01-04,Binh Duong,Di An,12,22,12,10,6
2022-01-04,Binh Duong,Di An,13,19,5,14,14
2022-01-04,Binh Duong,Di An,14,28,5,23,23
2022-01-04,Binh Duong,Di An,15,14,3,11,11
2022-01-04,Binh Duong,Di An,16,7,2,5,5
2022-01-04,Binh Duong,Di An,17,16,4,12,11
2022-01-04,Binh Duong,Di An,18,12,6,6,4
2022-01-04,Binh Duong,Di An,19,11,8,3,1
2022-01-04,Binh Duong,Di An,20,7,2,5,4
2022-01-04,Binh Duong,Di An,21,3,0,3,3
2022-01-04,Binh Duong,Tan Uyen,9,1,0,1,0
2022-01-04,Binh Duong,Tan Uyen,12,1,0,1,0
2022-01-04,Binh Duong,Tan Uyen,14,2,2,0,0
2022-01-04,Binh Duong,Thu Dau Mot Town,0,1,1,0,0
2022-01-04,Binh Duong,Thu Dau Mot Town,2,1,1,0,0
2022-01-04,Binh Duong,Thu Dau Mot Town,3,3,2,1,0
2022-01-04,Binh Duong,Thu Dau Mot Town,5,2,1,1,1
2022-01-04,Binh Duong,Thu Dau Mot Town,6,28,23,5,1
2022-01-04,Binh Duong,Thu Dau Mot Town,7,85,76,9,1
2022-01-04,Binh Duong,Thu Dau Mot Town,8,204,186,18,2
2022-01-04,Binh Duong,Thu Dau Mot Town,9,235,214,21,1
2022-01-04,Binh Duong,Thu Dau Mot Town,10,293,269,24,1
2022-01-04,Binh Duong,Thu Dau Mot Town,11,590,553,37,4
2022-01-04,Binh Duong,Thu Dau Mot Town,12,404,375,29,2
2022-01-04,Binh Duong,Thu Dau Mot Town,13,356,330,26,6
2022-01-04,Binh Duong,Thu Dau Mot Town,14,265,252,13,0
2022-01-04,Binh Duong,Thu Dau Mot Town,15,219,211,8,2
2022-01-04,Binh Duong,Thu Dau Mot Town,16,214,197,17,3
2022-01-04,Binh Duong,Thu Dau Mot Town,17,310,290,20,1
2022-01-04,Binh Duong,Thu Dau Mot Town,18,298,280,18,2
2022-01-04,Binh Duong,Thu Dau Mot Town,19,269,253,16,3
2022-01-04,Binh Duong,Thu Dau Mot Town,20,207,180,27,4
2022-01-04,Binh Duong,Thu Dau Mot Town,21,103,85,18,2
2022-01-04,Binh Duong,Thu Dau Mot Town,22,3,0,3,0
2022-01-04,Binh Duong,Thu Dau Mot Town,23,2,2,0,0
2022-01-04,Binh Duong,Thuan An,6,2,0,2,2
2022-01-04,Binh Duong,Thuan An,7,2,0,2,1
2022-01-04,Binh Duong,Thuan An,8,13,5,8,7
2022-01-04,Binh Duong,Thuan An,9,33,13,20,15
2022-01-04,Binh Duong,Thuan An,10,51,23,28,23
2022-01-04,Binh Duong,Thuan An,11,83,47,36,31
2022-01-04,Binh Duong,Thuan An,12,45,40,5,3
2022-01-04,Binh Duong,Thuan An,13,45,25,20,17
2022-01-04,Binh Duong,Thuan An,14,47,21,26,23
2022-01-04,Binh Duong,Thuan An,15,38,28,10,7
2022-01-04,Binh Duong,Thuan An,16,26,19,7,5
2022-01-04,Binh Duong,Thuan An,17,24,20,4,1
2022-01-04,Binh Duong,Thuan An,18,44,33,11,8
2022-01-04,Binh Duong,Thuan An,19,25,13,12,9
2022-01-04,Binh Duong,Thuan An,20,14,9,5,3
2022-01-04,Binh Duong,Thuan An,21,4,1,3,2
2022-01-04,Can Tho City,Binh Thuy District,6,1,1,0,0
2022-01-04,Can Tho City,Binh Thuy District,7,1,0,1,1
2022-01-04,Can Tho City,Binh Thuy District,8,4,4,0,0
2022-01-04,Can Tho City,Binh Thuy District,9,5,5,0,0
2022-01-04,Can Tho City,Binh Thuy District,10,5,5,0,0
2022-01-04,Can Tho City,Binh Thuy District,11,8,6,2,0
2022-01-04,Can Tho City,Binh Thuy District,12,5,5,0,0
2022-01-04,Can Tho City,Binh Thuy District,13,9,9,0,0
2022-01-04,Can Tho City,Binh Thuy District,14,10,9,1,0
2022-01-04,Can Tho City,Binh Thuy District,15,6,6,0,0
2022-01-04,Can Tho City,Binh Thuy District,16,7,7,0,0
2022-01-04,Can Tho City,Binh Thuy District,17,10,9,1,0
2022-01-04,Can Tho City,Binh Thuy District,18,11,10,1,0
2022-01-04,Can Tho City,Binh Thuy District,19,10,9,1,0
2022-01-04,Can Tho City,Binh Thuy District,20,10,10,0,0
2022-01-04,Can Tho City,Binh Thuy District,21,2,1,1,0
2022-01-04,Can Tho City,Cai Rang District,6,1,1,0,0
2022-01-04,Can Tho City,Cai Rang District,7,1,1,0,0
2022-01-04,Can Tho City,Cai Rang District,8,4,3,1,0
2022-01-04,Can Tho City,Cai Rang District,9,3,3,0,0
2022-01-04,Can Tho City,Cai Rang District,10,9,7,2,1
2022-01-04,Can Tho City,Cai Rang District,11,16,14,2,2
2022-01-04,Can Tho City,Cai Rang District,12,8,7,1,0
2022-01-04,Can Tho City,Cai Rang District,13,11,10,1,0
2022-01-04,Can Tho City,Cai Rang District,14,5,5,0,0
2022-01-04,Can Tho City,Cai Rang District,15,5,5,0,0
2022-01-04,Can Tho City,Cai Rang District,16,8,8,0,0
2022-01-04,Can Tho City,Cai Rang District,17,5,5,0,0
2022-01-04,Can Tho City,Cai Rang District,18,5,5,0,0
2022-01-04,Can Tho City,Cai Rang District,19,11,9,2,0
2022-01-04,Can Tho City,Cai Rang District,20,6,5,1,0
2022-01-04,Can Tho City,Ninh Kieu District,0,6,6,0,0
2022-01-04,Can Tho City,Ninh Kieu District,1,1,1,0,0
2022-01-04,Can Tho City,Ninh Kieu District,3,2,2,0,0
2022-01-04,Can Tho City,Ninh Kieu District,4,1,1,0,0
2022-01-04,Can Tho City,Ninh Kieu District,5,1,1,0,0
2022-01-04,Can Tho City,Ninh Kieu District,6,47,45,2,0
2022-01-04,Can Tho City,Ninh Kieu District,7,170,165,5,0
2022-01-04,Can Tho City,Ninh Kieu District,8,246,228,18,0
2022-01-04,Can Tho City,Ninh Kieu District,9,272,256,16,0
2022-01-04,Can Tho City,Ninh Kieu District,10,426,408,18,0
2022-01-04,Can Tho City,Ninh Kieu District,11,712,688,24,0
2022-01-04,Can Tho City,Ninh Kieu District,12,491,471,20,0
2022-01-04,Can Tho City,Ninh Kieu District,13,362,345,17,0
2022-01-04,Can Tho City,Ninh Kieu District,14,296,282,14,0
2022-01-04,Can Tho City,Ninh Kieu District,15,337,321,16,0
2022-01-04,Can Tho City,Ninh Kieu District,16,316,302,14,0
2022-01-04,Can Tho City,Ninh Kieu District,17,458,445,13,0
2022-01-04,Can Tho City,Ninh Kieu District,18,455,427,28,0
2022-01-04,Can Tho City,Ninh Kieu District,19,337,320,17,0
2022-01-04,Can Tho City,Ninh Kieu District,20,229,202,27,0
2022-01-04,Can Tho City,Ninh Kieu District,21,134,117,17,0
2022-01-04,Can Tho City,Ninh Kieu District,22,7,6,1,0
2022-01-04,Can Tho City,Ninh Kieu District,23,1,1,0,0
2022-01-04,Dong Nai,Bien Hoa City,0,2,1,1,0
2022-01-04,Dong Nai,Bien Hoa City,1,2,1,1,0
2022-01-04,Dong Nai,Bien Hoa City,2,4,1,3,0
2022-01-04,Dong Nai,Bien Hoa City,3,1,1,0,0
2022-01-04,Dong Nai,Bien Hoa City,4,2,1,1,0
2022-01-04,Dong Nai,Bien Hoa City,5,3,2,1,1
2022-01-04,Dong Nai,Bien Hoa City,6,41,28,13,10
2022-01-04,Dong Nai,Bien Hoa City,7,147,124,23,14
2022-01-04,Dong Nai,Bien Hoa City,8,280,253,27,5
2022-01-04,Dong Nai,Bien Hoa City,9,333,312,21,3
2022-01-04,Dong Nai,Bien Hoa City,10,679,623,56,7
2022-01-04,Dong Nai,Bien Hoa City,11,1006,943,63,12
2022-01-04,Dong Nai,Bien Hoa City,12,747,694,53,18
2022-01-04,Dong Nai,Bien Hoa City,13,657,616,41,6
2022-01-04,Dong Nai,Bien Hoa City,14,570,535,35,4
2022-01-04,Dong Nai,Bien Hoa City,15,477,439,38,6
2022-01-04,Dong Nai,Bien Hoa City,16,467,437,30,2
2022-01-04,Dong Nai,Bien Hoa City,17,501,470,31,5
2022-01-04,Dong Nai,Bien Hoa City,18,568,520,48,2
2022-01-04,Dong Nai,Bien Hoa City,19,586,525,61,9
2022-01-04,Dong Nai,Bien Hoa City,20,411,359,52,8
2022-01-04,Dong Nai,Bien Hoa City,21,174,139,35,14
2022-01-04,Dong Nai,Bien Hoa City,22,1,1,0,0
2022-01-04,Dong Nai,Long Thanh,7,1,0,1,1
2022-01-04,Dong Nai,Long Thanh,11,1,0,1,1
2022-01-04,Dong Nai,Long Thanh,12,2,0,2,2
2022-01-04,Dong Nai,Long Thanh,16,1,0,1,1
2022-01-04,Dong Nai,Long Thanh,19,1,0,1,1
2022-01-04,Dong Nai,Thong Nhat,7,3,2,1,0
2022-01-04,Dong Nai,Thong Nhat,8,1,1,0,0
2022-01-04,Dong Nai,Thong Nhat,9,1,1,0,0
2022-01-04,Dong Nai,Thong Nhat,11,1,1,0,0
2022-01-04,Dong Nai,Thong Nhat,12,1,1,0,0
2022-01-04,Dong Nai,Thong Nhat,14,1,1,0,0
2022-01-04,Dong Nai,Thong Nhat,15,1,1,0,0
2022-01-04,Dong Nai,Thong Nhat,17,1,1,0,0
2022-01-04,Dong Nai,Thong Nhat,21,1,1,0,0
2022-01-04,Dong Nai,Trang Bom,11,1,1,0,0
2022-01-04,Dong Nai,Trang Bom,15,1,0,1,1
2022-01-04,Dong Nai,Trang Bom,16,1,0,1,1
2022-01-04,Hai Phong City,An Duong,7,1,0,1,1
2022-01-04,Hai Phong City,An Duong,8,3,1,2,1
2022-01-04,Hai Phong City,An Duong,10,1,1,0,0
2022-01-04,Hai Phong City,An Duong,11,3,3,0,0
2022-01-04,Hai Phong City,An Duong,13,1,1,0,0
2022-01-04,Hai Phong City,An Duong,14,5,5,0,0
2022-01-04,Hai Phong City,An Duong,15,3,3,0,0
2022-01-04,Hai Phong City,An Duong,17,2,1,1,0
2022-01-04,Hai Phong City,An Duong,18,3,1,2,1
2022-01-04,Hai Phong City,An Duong,20,2,0,2,0
2022-01-04,Hai Phong City,Duong Kinh District,10,1,0,1,1
2022-01-04,Hai Phong City,Duong Kinh District,14,1,1,0,0
2022-01-04,Hai Phong City,Hai An District,1,1,0,1,0
2022-01-04,Hai Phong City,Hai An District,7,6,1,5,4
2022-01-04,Hai Phong City,Hai An District,8,19,15,4,0
2022-01-04,Hai Phong City,Hai An District,9,15,12,3,0
2022-01-04,Hai Phong City,Hai An District,10,21,19,2,0
2022-01-04,Hai Phong City,Hai An District,11,36,34,2,1
2022-01-04,Hai Phong City,Hai An District,12,23,18,5,1
2022-01-04,Hai Phong City,Hai An District,13,21,16,5,0
2022-01-04,Hai Phong City,Hai An District,14,18,14,4,0
2022-01-04,Hai Phong City,Hai An District,15,11,10,1,0
2022-01-04,Hai Phong City,Hai An District,16,17,17,0,0
2022-01-04,Hai Phong City,Hai An District,17,18,17,1,0
2022-01-04,Hai Phong City,Hai An District,18,29,25,4,1
2022-01-04,Hai Phong City,Hai An District,19,25,20,5,2
2022-01-04,Hai Phong City,Hai An District,20,18,11,7,3
2022-01-04,Hai Phong City,Hai An District,21,13,11,2,1
2022-01-04,Hai Phong City,Hong Bang District,0,2,1,1,0
2022-01-04,Hai Phong City,Hong Bang District,3,1,1,0,0
2022-01-04,Hai Phong City,Hong Bang District,6,1,1,0,0
2022-01-04,Hai Phong City,Hong Bang District,7,20,11,9,7
2022-01-04,Hai Phong City,Hong Bang District,8,43,32,11,6
2022-01-04,Hai Phong City,Hong Bang District,9,50,45,5,1
2022-01-04,Hai Phong City,Hong Bang District,10,52,48,4,0
2022-01-04,Hai Phong City,Hong Bang District,11,123,114,9,4
2022-01-04,Hai Phong City,Hong Bang District,12,71,67,4,0
2022-01-04,Hai Phong City,Hong Bang District,13,46,42,4,0
2022-01-04,Hai Phong City,Hong Bang District,14,56,51,5,1
2022-01-04,Hai Phong City,Hong Bang District,15,53,47,6,2
2022-01-04,Hai Phong City,Hong Bang District,16,39,30,9,0
2022-01-04,Hai Phong City,Hong Bang District,17,51,44,7,0
2022-01-04,Hai Phong City,Hong Bang District,18,72,63,9,0
2022-01-04,Hai Phong City,Hong Bang District,19,56,49,7,1
2022-01-04,Hai Phong City,Hong Bang District,20,46,36,10,4
2022-01-04,Hai Phong City,Hong Bang District,21,9,9,0,0
2022-01-04,Hai Phong City,Kien An District,4,1,0,1,1
2022-01-04,Hai Phong City,Kien An District,7,1,0,1,1
2022-01-04,Hai Phong City,Kien An District,8,6,2,4,4
2022-01-04,Hai Phong City,Kien An District,9,8,2,6,5
2022-01-04,Hai Phong City,Kien An District,10,4,3,1,1
2022-01-04,Hai Phong City,Kien An District,11,9,6,3,2
2022-01-04,Hai Phong City,Kien An District,12,9,7,2,2
2022-01-04,Hai Phong City,Kien An District,13,8,6,2,2
2022-01-04,Hai Phong City,Kien An District,14,11,4,7,3
2022-01-04,Hai Phong City,Kien An District,15,10,5,5,4
2022-01-04,Hai Phong City,Kien An District,16,6,0,6,1
2022-01-04,Hai Phong City,Kien An District,17,4,1,3,2
2022-01-04,Hai Phong City,Kien An District,18,9,8,1,0
2022-01-04,Hai Phong City,Kien An District,19,6,4,2,0
2022-01-04,Hai Phong City,Kien An District,20,7,3,4,4
2022-01-04,Hai Phong City,Kien An District,21,5,0,5,5
2022-01-04,Hai Phong City,Le Chan District,0,1,0,1,0
2022-01-04,Hai Phong City,Le Chan District,2,2,1,1,1
2022-01-04,Hai Phong City,Le Chan District,5,1,1,0,0
2022-01-04,Hai Phong City,Le Chan District,6,3,3,0,0
2022-01-04,Hai Phong City,Le Chan District,7,49,28,21,17
2022-01-04,Hai Phong City,Le Chan District,8,109,88,21,5
2022-01-04,Hai Phong City,Le Chan District,9,81,73,8,1
2022-01-04,Hai Phong City,Le Chan District,10,158,141,17,0
2022-01-04,Hai Phong City,Le Chan District,11,325,297,28,1
2022-01-04,Hai Phong City,Le Chan District,12,244,223,21,0
2022-01-04,Hai Phong City,Le Chan District,13,120,107,13,0
2022-01-04,Hai Phong City,Le Chan District,14,152,137,15,0
2022-01-04,Hai Phong City,Le Chan District,15,168,151,17,2
2022-01-04,Hai Phong City,Le Chan District,16,153,139,14,0
2022-01-04,Hai Phong City,Le Chan District,17,190,176,14,0
2022-01-04,Hai Phong City,Le Chan District,18,254,234,20,0
2022-01-04,Hai Phong City,Le Chan District,19,198,175,23,2
2022-01-04,Hai Phong City,Le Chan District,20,151,138,13,0
2022-01-04,Hai Phong City,Le Chan District,21,72,51,21,5
2022-01-04,Hai Phong City,Le Chan District,22,5,1,4,0
2022-01-04,Hai Phong City,Ngo Quyen District,0,2,1,1,0
2022-01-04,Hai Phong City,Ngo Quyen District,1,1,1,0,0
2022-01-04,Hai Phong City,Ngo Quyen District,6,3,1,2,2
2022-01-04,Hai Phong City,Ngo Quyen District,7,44,32,12,10
2022-01-04,Hai Phong City,Ngo Quyen District,8,97,80,17,6
2022-01-04,Hai Phong City,Ngo Quyen District,9,100,93,7,0
2022-01-04,Hai Phong City,Ngo Quyen District,10,129,116,13,2
2022-01-04,Hai Phong City,Ngo Quyen District,11,245,229,16,0
2022-01-04,Hai Phong City,Ngo Quyen District,12,205,187,18,3
2022-01-04,Hai Phong City,Ngo Quyen District,13,145,133,12,0
2022-01-04,Hai Phong City,Ngo Quyen District,14,146,132,14,0
2022-01-04,Hai Phong City,Ngo Quyen District,15,175,157,18,5
2022-01-04,Hai Phong City,Ngo Quyen District,16,147,134,13,0
2022-01-04,Hai Phong City,Ngo Quyen District,17,162,140,22,0
2022-01-04,Hai Phong City,Ngo Quyen District,18,204,180,24,1
2022-01-04,Hai Phong City,Ngo Quyen District,19,169,146,23,1
2022-01-04,Hai Phong City,Ngo Quyen District,20,152,132,20,1
2022-01-04,Hai Phong City,Ngo Quyen District,21,69,50,19,4
2022-01-04,Hai Phong City,Ngo Quyen District,22,2,0,2,0
2022-01-04,Hai Phong City,Ngo Quyen District,23,1,1,0,0
2022-01-04,Hai Phong City,Thuy Nguyen,8,1,0,1,1
2022-01-04,Hai Phong City,Thuy Nguyen,9,1,0,1,1
2022-01-04,Hai Phong City,Thuy Nguyen,10,1,0,1,1
2022-01-04,Hai Phong City,Thuy Nguyen,11,2,0,2,1
2022-01-04,Hai Phong City,Thuy Nguyen,12,1,0,1,1
2022-01-04,Hai Phong City,Thuy Nguyen,13,1,0,1,1
2022-01-04,Hai Phong City,Thuy Nguyen,14,1,0,1,1
2022-01-04,Hai Phong City,Thuy Nguyen,15,2,1,1,1
2022-01-04,Hai Phong City,Thuy Nguyen,16,1,0,1,1
2022-01-04,Hai Phong City,Thuy Nguyen,17,1,0,1,1
2022-01-04,Hai Phong City,Thuy Nguyen,18,1,0,1,1
2022-01-04,Hai Phong City,Thuy Nguyen,19,3,0,3,2
2022-01-04,Hue City,Hue City,0,3,2,1,0
2022-01-04,Hue City,Hue City,1,3,3,0,0
2022-01-04,Hue City,Hue City,5,2,2,0,0
2022-01-04,Hue City,Hue City,6,68,61,7,2
2022-01-04,Hue City,Hue City,7,232,214,18,1
2022-01-04,Hue City,Hue City,8,355,332,23,2
2022-01-04,Hue City,Hue City,9,287,268,19,0
2022-01-04,Hue City,Hue City,10,300,285,15,0
2022-01-04,Hue City,Hue City,11,684,670,14,0
2022-01-04,Hue City,Hue City,12,427,406,21,1
2022-01-04,Hue City,Hue City,13,309,293,16,1
2022-01-04,Hue City,Hue City,14,371,348,23,0
2022-01-04,Hue City,Hue City,15,394,377,17,0
2022-01-04,Hue City,Hue City,16,370,343,27,0
2022-01-04,Hue City,Hue City,17,546,507,39,0
2022-01-04,Hue City,Hue City,18,622,569,53,3
2022-01-04,Hue City,Hue City,19,486,444,42,4
2022-01-04,Hue City,Hue City,20,382,334,48,1
2022-01-04,Hue City,Hue City,21,211,181,30,4
2022-01-04,Hue City,Hue City,22,3,1,2,0
2022-01-04,Hue City,Hue City,23,2,1,1,0
2022-01-04,Hue City,Huong Thuy,10,3,3,0,0
2022-01-04,Hue City,Huong Thuy,11,1,0,1,1
2022-01-04,Hue City,Huong Thuy,12,1,0,1,1
2022-01-04,Hue City,Huong Thuy,13,1,0,1,1
2022-01-04,Hue City,Huong Thuy,14,2,1,1,0
2022-01-04,Hue City,Huong Thuy,17,2,2,0,0
2022-01-04,Hue City,Huong Thuy,18,5,3,2,1
2022-01-04,Hue City,Huong Thuy,19,2,1,1,0
2022-01-04,Hue City,Huong Thuy,20,1,1,0,0
2022-01-04,Hue City,Huong Thuy,21,1,1,0,0
2022-01-04,Hue City,Huong Tra,21,1,0,1,0
2022-01-04,Hue City,Phu Vang,7,7,5,2,0
2022-01-04,Hue City,Phu Vang,8,6,5,1,1
2022-01-04,Hue City,Phu Vang,9,3,1,2,0
2022-01-04,Hue City,Phu Vang,10,2,1,1,0
2022-01-04,Hue City,Phu Vang,11,1,1,0,0
2022-01-04,Hue City,Phu Vang,13,1,1,0,0
2022-01-04,Hue City,Phu Vang,16,1,1,0,0
2022-01-04,Hue City,Phu Vang,17,3,3,0,0
2022-01-04,Hue City,Phu Vang,18,3,0,3,1
2022-01-04,Hue City,Phu Vang,20,3,2,1,1
2022-01-04,Hue City,Phu Vang,21,1,1,0,0
2022-01-04,Hue City,Phu Vang,22,1,1,0,0
2022-01-04,Vung Tau,Ba Ria City,7,1,0,1,0
2022-01-04,Vung Tau,Ba Ria City,9,6,0,6,5
2022-01-04,Vung Tau,Ba Ria City,10,6,0,6,6
2022-01-04,Vung Tau,Ba Ria City,11,15,1,14,14
2022-01-04,Vung Tau,Ba Ria City,12,8,1,7,6
2022-01-04,Vung Tau,Ba Ria City,13,11,1,10,9
2022-01-04,Vung Tau,Ba Ria City,14,8,0,8,7
2022-01-04,Vung Tau,Ba Ria City,15,12,1,11,10
2022-01-04,Vung Tau,Ba Ria City,16,5,1,4,3
2022-01-04,Vung Tau,Ba Ria City,17,3,0,3,3
2022-01-04,Vung Tau,Ba Ria City,18,13,0,13,13
2022-01-04,Vung Tau,Ba Ria City,19,8,0,8,8
2022-01-04,Vung Tau,Ba Ria City,20,5,0,5,5
2022-01-04,Vung Tau,Ba Ria City,21,2,0,2,2
2022-01-04,Vung Tau,Vung Tau City,0,6,6,0,0
2022-01-04,Vung Tau,Vung Tau City,5,2,2,0,0
2022-01-04,Vung Tau,Vung Tau City,6,49,40,9,1
2022-01-04,Vung Tau,Vung Tau City,7,122,111,11,0
2022-01-04,Vung Tau,Vung Tau City,8,183,164,19,1
2022-01-04,Vung Tau,Vung Tau City,9,168,154,14,0
2022-01-04,Vung Tau,Vung Tau City,10,187,169,18,0
2022-01-04,Vung Tau,Vung Tau City,11,322,309,13,1
2022-01-04,Vung Tau,Vung Tau City,12,253,240,13,0
2022-01-04,Vung Tau,Vung Tau City,13,217,205,12,0
2022-01-04,Vung Tau,Vung Tau City,14,223,206,17,0
2022-01-04,Vung Tau,Vung Tau City,15,209,198,11,3
2022-01-04,Vung Tau,Vung Tau City,16,197,186,11,0
2022-01-04,Vung Tau,Vung Tau City,17,289,269,20,0
2022-01-04,Vung Tau,Vung Tau City,18,271,244,27,4
2022-01-04,Vung Tau,Vung Tau City,19,218,205,13,0
2022-01-04,Vung Tau,Vung Tau City,20,161,148,13,0
2022-01-04,Vung Tau,Vung Tau City,21,82,66,16,4
2022-01-04,Vung Tau,Vung Tau City,23,4,2,2,0
2022-01-05,Binh Duong,Ben Cat,15,2,1,1,1
2022-01-05,Binh Duong,Ben Cat,19,1,0,1,1
2022-01-05,Binh Duong,Di An,7,2,0,2,1
2022-01-05,Binh Duong,Di An,8,6,0,6,6
2022-01-05,Binh Duong,Di An,9,21,6,15,13
2022-01-05,Binh Duong,Di An,10,15,9,6,5
2022-01-05,Binh Duong,Di An,11,27,16,11,10
2022-01-05,Binh Duong,Di An,12,13,13,0,0
2022-01-05,Binh Duong,Di An,13,14,11,3,1
2022-01-05,Binh Duong,Di An,14,8,7,1,0
2022-01-05,Binh Duong,Di An,15,16,12,4,2
2022-01-05,Binh Duong,Di An,16,11,8,3,2
2022-01-05,Binh Duong,Di An,17,6,5,1,1
2022-01-05,Binh Duong,Di An,18,15,6,9,5
2022-01-05,Binh Duong,Di An,19,7,6,1,1
2022-01-05,Binh Duong,Di An,20,6,3,3,3
2022-01-05,Binh Duong,Di An,21,1,0,1,1
2022-01-05,Binh Duong,Tan Uyen,11,5,3,2,1
2022-01-05,Binh Duong,Tan Uyen,13,2,1,1,1
2022-01-05,Binh Duong,Tan Uyen,15,2,1,1,1
2022-01-05,Binh Duong,Tan Uyen,16,2,1,1,1
2022-01-05,Binh Duong,Tan Uyen,20,1,0,1,1
2022-01-05,Binh Duong,Tan Uyen,21,2,0,2,2
2022-01-05,Binh Duong,Thu Dau Mot Town,0,2,1,1,0
2022-01-05,Binh Duong,Thu Dau Mot Town,2,1,1,0,0
2022-01-05,Binh Duong,Thu Dau Mot Town,5,1,1,0,0
2022-01-05,Binh Duong,Thu Dau Mot Town,6,44,33,11,9
2022-01-05,Binh Duong,Thu Dau Mot Town,7,119,104,15,4
2022-01-05,Binh Duong,Thu Dau Mot Town,8,181,168,13,1
2022-01-05,Binh Duong,Thu Dau Mot Town,9,230,217,13,3
2022-01-05,Binh Duong,Thu Dau Mot Town,10,298,280,18,0
2022-01-05,Binh Duong,Thu Dau Mot Town,11,530,502,28,3
2022-01-05,Binh Duong,Thu Dau Mot Town,12,369,355,14,1
2022-01-05,Binh Duong,Thu Dau Mot Town,13,383,364,19,1
2022-01-05,Binh Duong,Thu Dau Mot Town,14,263,248,15,1
2022-01-05,Binh Duong,Thu Dau Mot Town,15,232,223,9,0
2022-01-05,Binh Duong,Thu Dau Mot Town,16,227,215,12,2
2022-01-05,Binh Duong,Thu Dau Mot Town,17,300,282,18,2
2022-01-05,Binh Duong,Thu Dau Mot Town,18,308,291,17,2
2022-01-05,Binh Duong,Thu Dau Mot Town,19,277,257,20,7
2022-01-05,Binh Duong,Thu Dau Mot Town,20,172,152,20,5
2022-01-05,Binh Duong,Thu Dau Mot Town,21,77,65,12,4
2022-01-05,Binh Duong,Thu Dau Mot Town,22,1,0,1,1
2022-01-05,Binh Duong,Thu Dau Mot Town,23,2,2,0,0
2022-01-05,Binh Duong,Thuan An,6,1,0,1,0
2022-01-05,Binh Duong,Thuan An,7,11,1,10,6
2022-01-05,Binh Duong,Thuan An,8,19,9,10,6
2022-01-05,Binh Duong,Thuan An,9,36,23,13,11
2022-01-05,Binh Duong,Thuan An,10,40,30,10,9
2022-01-05,Binh Duong,Thuan An,11,77,47,30,24
2022-01-05,Binh Duong,Thuan An,12,44,33,11,9
2022-01-05,Binh Duong,Thuan An,13,49,27,22,18
2022-01-05,Binh Duong,Thuan An,14,56,25,31,26
2022-01-05,Binh Duong,Thuan An,15,45,32,13,10
2022-01-05,Binh Duong,Thuan An,16,37,27,10,5
2022-01-05,Binh Duong,Thuan An,17,34,25,9,6
2022-01-05,Binh Duong,Thuan An,18,30,21,9,4
2022-01-05,Binh Duong,Thuan An,19,30,17,13,9
2022-01-05,Binh Duong,Thuan An,20,24,10,14,11
2022-01-05,Binh Duong,Thuan An,21,11,3,8,5
2022-01-05,Can Tho City,Binh Thuy District,6,3,2,1,0
2022-01-05,Can Tho City,Binh Thuy District,7,1,1,0,0
2022-01-05,Can Tho City,Binh Thuy District,8,2,2,0,0
2022-01-05,Can Tho City,Binh Thuy District,9,5,5,0,0
2022-01-05,Can Tho City,Binh Thuy District,10,6,6,0,0
2022-01-05,Can Tho City,Binh Thuy District,11,15,14,1,0
2022-01-05,Can Tho City,Binh Thuy District,12,6,6,0,0
2022-01-05,Can Tho City,Binh Thuy District,13,7,7,0,0
2022-01-05,Can Tho City,Binh Thuy District,14,4,4,0,0
2022-01-05,Can Tho City,Binh Thuy District,15,12,9,3,1
2022-01-05,Can Tho City,Binh Thuy District,16,3,3,0,0
2022-01-05,Can Tho City,Binh Thuy District,17,10,7,3,2
2022-01-05,Can Tho City,Binh Thuy District,18,7,6,1,0
2022-01-05,Can Tho City,Binh Thuy District,19,6,5,1,0
2022-01-05,Can Tho City,Binh Thuy District,20,5,5,0,0
2022-01-05,Can Tho City,Binh Thuy District,21,4,3,1,1
2022-01-05,Can Tho City,Cai Rang District,6,1,1,0,0
2022-01-05,Can Tho City,Cai Rang District,7,7,4,3,0
2022-01-05,Can Tho City,Cai Rang District,8,2,2,0,0
2022-01-05,Can Tho City,Cai Rang District,9,9,9,0,0
2022-01-05,Can Tho City,Cai Rang District,10,10,9,1,1
2022-01-05,Can Tho City,Cai Rang District,11,10,10,0,0
2022-01-05,Can Tho City,Cai Rang District,12,6,6,0,0
2022-01-05,Can Tho City,Cai Rang District,13,6,5,1,1
2022-01-05,Can Tho City,Cai Rang District,14,8,5,3,0
2022-01-05,Can Tho City,Cai Rang District,15,7,7,0,0
2022-01-05,Can Tho City,Cai Rang District,16,8,8,0,0
2022-01-05,Can Tho City,Cai Rang District,17,10,10,0,0
2022-01-05,Can Tho City,Cai Rang District,18,16,13,3,0
2022-01-05,Can Tho City,Cai Rang District,19,9,4,5,0
2022-01-05,Can Tho City,Cai Rang District,20,5,4,1,0
2022-01-05,Can Tho City,Ninh Kieu District,0,11,9,2,0
2022-01-05,Can Tho City,Ninh Kieu District,1,3,3,0,0
2022-01-05,Can Tho City,Ninh Kieu District,3,1,1,0,0
2022-01-05,Can Tho City,Ninh Kieu District,4,1,0,1,0
2022-01-05,Can Tho City,Ninh Kieu District,5,6,5,1,0
2022-01-05,Can Tho City,Ninh Kieu District,6,54,48,6,0
2022-01-05,Can Tho City,Ninh Kieu District,7,191,181,10,0
2022-01-05,Can Tho City,Ninh Kieu District,8,249,240,9,0
2022-01-05,Can Tho City,Ninh Kieu District,9,273,263,10,0
2022-01-05,Can Tho City,Ninh Kieu District,10,450,427,23,0
2022-01-05,Can Tho City,Ninh Kieu District,11,706,675,31,0
2022-01-05,Can Tho City,Ninh Kieu District,12,467,451,16,0
2022-01-05,Can Tho City,Ninh Kieu District,13,338,321,17,0
2022-01-05,Can Tho City,Ninh Kieu District,14,319,307,12,0
2022-01-05,Can Tho City,Ninh Kieu District,15,263,253,10,1
2022-01-05,Can Tho City,Ninh Kieu District,16,338,324,14,0
2022-01-05,Can Tho City,Ninh Kieu District,17,411,392,19,0
2022-01-05,Can Tho City,Ninh Kieu District,18,442,418,24,1
2022-01-05,Can Tho City,Ninh Kieu District,19,397,376,21,0
2022-01-05,Can Tho City,Ninh Kieu District,20,276,259,17,0
2022-01-05,Can Tho City,Ninh Kieu District,21,144,129,15,0
2022-01-05,Can Tho City,Ninh Kieu District,22,5,4,1,0
2022-01-05,Can Tho City,Ninh Kieu District,23,5,5,0,0
2022-01-05,Dong Nai,Bien Hoa City,0,1,1,0,0
2022-01-05,Dong Nai,Bien Hoa City,2,1,1,0,0
2022-01-05,Dong Nai,Bien Hoa City,3,1,1,0,0
2022-01-05,Dong Nai,Bien Hoa City,5,2,0,2,1
2022-01-05,Dong Nai,Bien Hoa City,6,40,29,11,8
2022-01-05,Dong Nai,Bien Hoa City,7,128,114,14,2
2022-01-05,Dong Nai,Bien Hoa City,8,285,267,18,5
2022-01-05,Dong Nai,Bien Hoa City,9,326,299,27,1
2022-01-05,Dong Nai,Bien Hoa City,10,622,582,40,5
2022-01-05,Dong Nai,Bien Hoa City,11,950,885,65,8
2022-01-05,Dong Nai,Bien Hoa City,12,750,699,51,5
2022-01-05,Dong Nai,Bien Hoa City,13,668,636,32,5
2022-01-05,Dong Nai,Bien Hoa City,14,554,533,21,2
2022-01-05,Dong Nai,Bien Hoa City,15,469,435,34,4
2022-01-05,Dong Nai,Bien Hoa City,16,427,405,22,1
2022-01-05,Dong Nai,Bien Hoa City,17,560,527,33,3
2022-01-05,Dong Nai,Bien Hoa City,18,599,550,49,6
2022-01-05,Dong Nai,Bien Hoa City,19,520,482,38,4
2022-01-05,Dong Nai,Bien Hoa City,20,433,382,51,8
2022-01-05,Dong Nai,Bien Hoa City,21,208,156,52,16
2022-01-05,Dong Nai,Bien Hoa City,22,3,2,1,0
2022-01-05,Dong Nai,Bien Hoa City,23,1,1,0,0
2022-01-05,Dong Nai,Cam My,16,2,0,2,2
2022-01-05,Dong Nai,Cam My,17,1,0,1,1
2022-01-05,Dong Nai,Long Thanh,11,2,0,2,1
2022-01-05,Dong Nai,Thong Nhat,10,2,2,0,0
2022-01-05,Dong Nai,Thong Nhat,11,1,1,0,0
2022-01-05,Dong Nai,Thong Nhat,12,1,1,0,0
2022-01-05,Dong Nai,Thong Nhat,13,3,3,0,0
2022-01-05,Dong Nai,Thong Nhat,14,4,4,0,0
2022-01-05,Dong Nai,Thong Nhat,17,2,2,0,0
2022-01-05,Dong Nai,Trang Bom,1,1,0,1,1
2022-01-05,Dong Nai,Trang Bom,12,2,0,2,2
2022-01-05,Dong Nai,Trang Bom,14,4,0,4,4
2022-01-05,Hai Phong City,An Duong,8,2,2,0,0
2022-01-05,Hai Phong City,An Duong,9,1,1,0,0
2022-01-05,Hai Phong City,An Duong,10,1,1,0,0
2022-01-05,Hai Phong City,An Duong,11,3,2,1,0
2022-01-05,Hai Phong City,An Duong,14,1,0,1,0
2022-01-05,Hai Phong City,An Duong,16,2,2,0,0
2022-01-05,Hai Phong City,An Duong,17,1,0,1,0
2022-01-05,Hai Phong City,An Duong,18,3,1,2,2
2022-01-05,Hai Phong City,An Duong,19,2,1,1,0
2022-01-05,Hai Phong City,An Duong,21,1,0,1,1
2022-01-05,Hai Phong City,Hai An District,0,1,0,1,0
2022-01-05,Hai Phong City,Hai An District,7,4,4,0,0
2022-01-05,Hai Phong City,Hai An District,8,8,8,0,0
2022-01-05,Hai Phong City,Hai An District,9,10,9,1,0
2022-01-05,Hai Phong City,Hai An District,10,20,18,2,1
2022-01-05,Hai Phong City,Hai An District,11,49,42,7,0
2022-01-05,Hai Phong City,Hai An District,12,26,23,3,0
2022-01-05,Hai Phong City,Hai An District,13,27,18,9,2
2022-01-05,Hai Phong City,Hai An District,14,27,17,10,1
2022-01-05,Hai Phong City,Hai An District,15,20,17,3,0
2022-01-05,Hai Phong City,Hai An District,16,20,19,1,0
2022-01-05,Hai Phong City,Hai An District,17,11,10,1,0
2022-01-05,Hai Phong City,Hai An District,18,32,31,1,0
2022-01-05,Hai Phong City,Hai An District,19,7,7,0,0
2022-01-05,Hai Phong City,Hai An District,20,16,12,4,0
2022-01-05,Hai Phong City,Hai An District,21,6,4,2,1
2022-01-05,Hai Phong City,Hong Bang District,0,2,2,0,0
2022-01-05,Hai Phong City,Hong Bang District,3,1,1,0,0
2022-01-05,Hai Phong City,Hong Bang District,6,1,1,0,0
2022-01-05,Hai Phong City,Hong Bang District,7,18,11,7,4
2022-01-05,Hai Phong City,Hong Bang District,8,58,42,16,10
2022-01-05,Hai Phong City,Hong Bang District,9,38,36,2,0
2022-01-05,Hai Phong City,Hong Bang District,10,63,58,5,1
2022-01-05,Hai Phong City,Hong Bang District,11,137,123,14,1
2022-01-05,Hai Phong City,Hong Bang District,12,91,75,16,2
2022-01-05,Hai Phong City,Hong Bang District,13,33,33,0,0
2022-01-05,Hai Phong City,Hong Bang District,14,35,29,6,0
2022-01-05,Hai Phong City,Hong Bang District,15,48,42,6,1
2022-01-05,Hai Phong City,Hong Bang District,16,46,42,4,0
2022-01-05,Hai Phong City,Hong Bang District,17,49,40,9,0
2022-01-05,Hai Phong City,Hong Bang District,18,63,55,8,0
2022-01-05,Hai Phong City,Hong Bang District,19,47,38,9,0
2022-01-05,Hai Phong City,Hong Bang District,20,36,30,6,2
2022-01-05,Hai Phong City,Hong Bang District,21,13,12,1,0
2022-01-05,Hai Phong City,Hong Bang District,23,2,2,0,0
2022-01-05,Hai Phong City,Kien An District,7,4,1,3,2
2022-01-05,Hai Phong City,Kien An District,8,6,1,5,3
2022-01-05,Hai Phong City,Kien An District,9,7,2,5,4
2022-01-05,Hai Phong City,Kien An District,10,5,5,0,0
2022-01-05,Hai Phong City,Kien An District,11,12,6,6,5
2022-01-05,Hai Phong City,Kien An District,12,2,1,1,1
2022-01-05,Hai Phong City,Kien An District,13,8,5,3,1
2022-01-05,Hai Phong City,Kien An District,14,7,2,5,4
2022-01-05,Hai Phong City,Kien An District,15,5,2,3,1
2022-01-05,Hai Phong City,Kien An District,16,4,2,2,2
2022-01-05,Hai Phong City,Kien An District,17,10,5,5,4
2022-01-05,Hai Phong City,Kien An District,18,8,6,2,1
2022-01-05,Hai Phong City,Kien An District,19,8,4,4,4
2022-01-05,Hai Phong City,Kien An District,20,11,5,6,5
2022-01-05,Hai Phong City,Kien An District,21,5,1,4,2
2022-01-05,Hai Phong City,Le Chan District,4,2,0,2,0
2022-01-05,Hai Phong City,Le Chan District,5,1,0,1,1
2022-01-05,Hai Phong City,Le Chan District,7,56,36,20,15
2022-01-05,Hai Phong City,Le Chan District,8,113,97,16,4
2022-01-05,Hai Phong City,Le Chan District,9,99,89,10,1
2022-01-05,Hai Phong City,Le Chan District,10,151,139,12,0
2022-01-05,Hai Phong City,Le Chan District,11,330,302,28,2
2022-01-05,Hai Phong City,Le Chan District,12,214,200,14,2
2022-01-05,Hai Phong City,Le Chan District,13,112,100,12,0
2022-01-05,Hai Phong City,Le Chan District,14,146,129,17,0
2022-01-05,Hai Phong City,Le Chan District,15,200,180,20,1
2022-01-05,Hai Phong City,Le Chan District,16,220,201,19,2
2022-01-05,Hai Phong City,Le Chan District,17,190,175,15,0
2022-01-05,Hai Phong City,Le Chan District,18,295,257,38,1
2022-01-05,Hai Phong City,Le Chan District,19,190,170,20,0
2022-01-05,Hai Phong City,Le Chan District,20,145,121,24,1
2022-01-05,Hai Phong City,Le Chan District,21,98,73,25,3
2022-01-05,Hai Phong City,Le Chan District,22,1,0,1,0
2022-01-05,Hai Phong City,Ngo Quyen District,1,1,0,1,0
2022-01-05,Hai Phong City,Ngo Quyen District,6,2,1,1,1
2022-01-05,Hai Phong City,Ngo Quyen District,7,41,30,11,7
2022-01-05,Hai Phong City,Ngo Quyen District,8,92,77,15,6
2022-01-05,Hai Phong City,Ngo Quyen District,9,105,96,9,1
2022-01-05,Hai Phong City,Ngo Quyen District,10,117,105,12,0
2022-01-05,Hai Phong City,Ngo Quyen District,11,289,261,28,3
2022-01-05,Hai Phong City,Ngo Quyen District,12,178,169,9,1
2022-01-05,Hai Phong City,Ngo Quyen District,13,117,105,12,0
2022-01-05,Hai Phong City,Ngo Quyen District,14,160,142,18,1
2022-01-05,Hai Phong City,Ngo Quyen District,15,205,189,16,0
2022-01-05,Hai Phong City,Ngo Quyen District,16,142,130,12,0
2022-01-05,Hai Phong City,Ngo Quyen District,17,148,123,25,1
2022-01-05,Hai Phong City,Ngo Quyen District,18,185,167,18,1
2022-01-05,Hai Phong City,Ngo Quyen District,19,146,136,10,0
2022-01-05,Hai Phong City,Ngo Quyen District,20,139,125,14,0
2022-01-05,Hai Phong City,Ngo Quyen District,21,64,50,14,3
2022-01-05,Hai Phong City,Thuy Nguyen,13,1,0,1,1
2022-01-05,Hai Phong City,Thuy Nguyen,14,1,0,1,1
2022-01-05,Hai Phong City,Thuy Nguyen,15,1,0,1,1
2022-01-05,Hai Phong City,Thuy Nguyen,16,2,0,2,2
2022-01-05,Hai Phong City,Thuy Nguyen,19,1,0,1,1
2022-01-05,Hue City,Hue City,0,6,3,3,0
2022-01-05,Hue City,Hue City,1,2,1,1,0
2022-01-05,Hue City,Hue City,2,3,1,2,0
2022-01-05,Hue City,Hue City,4,3,2,1,0
2022-01-05,Hue City,Hue City,5,1,1,0,0
2022-01-05,Hue City,Hue City,6,72,62,10,4
2022-01-05,Hue City,Hue City,7,238,219,19,1
2022-01-05,Hue City,Hue City,8,379,360,19,2
2022-01-05,Hue City,Hue City,9,285,275,10,0
2022-01-05,Hue City,Hue City,10,410,390,20,0
2022-01-05,Hue City,Hue City,11,837,806,31,0
2022-01-05,Hue City,Hue City,12,521,492,29,2
2022-01-05,Hue City,Hue City,13,287,275,12,0
2022-01-05,Hue City,Hue City,14,334,316,18,2
2022-01-05,Hue City,Hue City,15,417,389,28,0
2022-01-05,Hue City,Hue City,16,441,415,26,1
2022-01-05,Hue City,Hue City,17,574,551,23,1
2022-01-05,Hue City,Hue City,18,653,602,51,8
2022-01-05,Hue City,Hue City,19,541,485,56,4
2022-01-05,Hue City,Hue City,20,400,358,42,1
2022-01-05,Hue City,Hue City,21,245,207,38,13
2022-01-05,Hue City,Hue City,22,8,1,7,0
2022-01-05,Hue City,Hue City,23,3,2,1,0
2022-01-05,Hue City,Huong Thuy,13,1,0,1,0
2022-01-05,Hue City,Huong Thuy,15,1,1,0,0
2022-01-05,Hue City,Huong Thuy,16,1,1,0,0
2022-01-05,Hue City,Huong Thuy,18,1,1,0,0
2022-01-05,Hue City,Huong Thuy,19,2,2,0,0
2022-01-05,Hue City,Phu Vang,7,2,2,0,0
2022-01-05,Hue City,Phu Vang,8,1,1,0,0
2022-01-05,Hue City,Phu Vang,10,2,1,1,1
2022-01-05,Hue City,Phu Vang,11,4,3,1,0
2022-01-05,Hue City,Phu Vang,13,1,1,0,0
2022-01-05,Hue City,Phu Vang,14,3,3,0,0
2022-01-05,Hue City,Phu Vang,16,1,1,0,0
2022-01-05,Hue City,Phu Vang,17,1,0,1,0
2022-01-05,Hue City,Phu Vang,18,3,1,2,1
2022-01-05,Hue City,Phu Vang,19,3,2,1,0
2022-01-05,Hue City,Phu Vang,20,1,0,1,0
2022-01-05,Vung Tau,Ba Ria City,6,1,0,1,1
2022-01-05,Vung Tau,Ba Ria City,7,3,0,3,3
2022-01-05,Vung Tau,Ba Ria City,8,14,0,14,14
2022-01-05,Vung Tau,Ba Ria City,9,5,0,5,5
2022-01-05,Vung Tau,Ba Ria City,10,14,1,13,13
2022-01-05,Vung Tau,Ba Ria City,11,14,0,14,14
2022-01-05,Vung Tau,Ba Ria City,12,5,2,3,3
2022-01-05,Vung Tau,Ba Ria City,13,8,4,4,4
2022-01-05,Vung Tau,Ba Ria City,14,7,7,0,0
2022-01-05,Vung Tau,Ba Ria City,15,4,0,4,4
2022-01-05,Vung Tau,Ba Ria City,16,3,2,1,1
2022-01-05,Vung Tau,Ba Ria City,17,10,1,9,9
2022-01-05,Vung Tau,Ba Ria City,18,2,0,2,2
2022-01-05,Vung Tau,Ba Ria City,19,2,0,2,2
2022-01-05,Vung Tau,Ba Ria City,20,5,0,5,5
2022-01-05,Vung Tau,Vung Tau City,0,2,1,1,0
2022-01-05,Vung Tau,Vung Tau City,1,2,1,1,0
2022-01-05,Vung Tau,Vung Tau City,2,2,1,1,0
2022-01-05,Vung Tau,Vung Tau City,5,3,2,1,0
2022-01-05,Vung Tau,Vung Tau City,6,48,42,6,2
2022-01-05,Vung Tau,Vung Tau City,7,136,123,13,0
2022-01-05,Vung Tau,Vung Tau City,8,192,182,10,1
2022-01-05,Vung Tau,Vung Tau City,9,163,150,13,2
2022-01-05,Vung Tau,Vung Tau City,10,173,164,9,1
2022-01-05,Vung Tau,Vung Tau City,11,314,296,18,0
2022-01-05,Vung Tau,Vung Tau City,12,239,227,12,2
2022-01-05,Vung Tau,Vung Tau City,13,173,165,8,0
2022-01-05,Vung Tau,Vung Tau City,14,185,175,10,1
2022-01-05,Vung Tau,Vung Tau City,15,208,197,11,1
2022-01-05,Vung Tau,Vung Tau City,16,186,170,16,0
2022-01-05,Vung Tau,Vung Tau City,17,284,263,21,0
2022-01-05,Vung Tau,Vung Tau City,18,342,313,29,2
2022-01-05,Vung Tau,Vung Tau City,19,202,189,13,2
2022-01-05,Vung Tau,Vung Tau City,20,175,151,24,2
2022-01-05,Vung Tau,Vung Tau City,21,70,48,22,5
2022-01-05,Vung Tau,Vung Tau City,22,1,1,0,0
2022-01-05,Vung Tau,Vung Tau City,23,2,2,0,0
2022-01-06,Binh Duong,Ben Cat,13,1,0,1,1
2022-01-06,Binh Duong,Ben Cat,18,1,0,1,1
2022-01-06,Binh Duong,Ben Cat,19,1,0,1,0
2022-01-06,Binh Duong,Di An,7,8,3,5,4
2022-01-06,Binh Duong,Di An,8,4,0,4,4
2022-01-06,Binh Duong,Di An,9,15,8,7,5
2022-01-06,Binh Duong,Di An,10,11,4,7,2
2022-01-06,Binh Duong,Di An,11,20,14,6,4
2022-01-06,Binh Duong,Di An,12,20,16,4,0
2022-01-06,Binh Duong,Di An,13,19,15,4,2
2022-01-06,Binh Duong,Di An,14,9,5,4,4
2022-01-06,Binh Duong,Di An,15,16,10,6,6
2022-01-06,Binh Duong,Di An,16,10,10,0,0
2022-01-06,Binh Duong,Di An,17,13,8,5,0
2022-01-06,Binh Duong,Di An,18,12,9,3,3
2022-01-06,Binh Duong,Di An,19,11,6,5,4
2022-01-06,Binh Duong,Di An,20,11,5,6,5
2022-01-06,Binh Duong,Di An,21,5,1,4,4
2022-01-06,Binh Duong,Tan Uyen,7,1,0,1,1
2022-01-06,Binh Duong,Tan Uyen,11,2,2,0,0
2022-01-06,Binh Duong,Tan Uyen,12,1,1,0,0
2022-01-06,Binh Duong,Tan Uyen,14,1,1,0,0
2022-01-06,Binh Duong,Tan Uyen,15,1,0,1,1
2022-01-06,Binh Duong,Tan Uyen,16,1,1,0,0
2022-01-06,Binh Duong,Tan Uyen,17,1,0,1,1
2022-01-06,Binh Duong,Thu Dau Mot Town,1,2,0,2,0
2022-01-06,Binh Duong,Thu Dau Mot Town,5,2,1,1,1
2022-01-06,Binh Duong,Thu Dau Mot Town,6,32,31,1,0
2022-01-06,Binh Duong,Thu Dau Mot Town,7,84,75,9,2
2022-01-06,Binh Duong,Thu Dau Mot Town,8,169,155,14,2
2022-01-06,Binh Duong,Thu Dau Mot Town,9,209,197,12,3
2022-01-06,Binh Duong,Thu Dau Mot Town,10,317,289,28,9
2022-01-06,Binh Duong,Thu Dau Mot Town,11,531,499,32,6
2022-01-06,Binh Duong,Thu Dau Mot Town,12,384,366,18,3
2022-01-06,Binh Duong,Thu Dau Mot Town,13,347,327,20,0
2022-01-06,Binh Duong,Thu Dau Mot Town,14,308,297,11,3
2022-01-06,Binh Duong,Thu Dau Mot Town,15,214,197,17,5
2022-01-06,Binh Duong,Thu Dau Mot Town,16,251,245,6,1
2022-01-06,Binh Duong,Thu Dau Mot Town,17,282,268,14,0
2022-01-06,Binh Duong,Thu Dau Mot Town,18,308,284,24,5
2022-01-06,Binh Duong,Thu Dau Mot Town,19,253,232,21,4
2022-01-06,Binh Duong,Thu Dau Mot Town,20,231,209,22,5
2022-01-06,Binh Duong,Thu Dau Mot Town,21,97,81,16,1
2022-01-06,Binh Duong,Thu Dau Mot Town,22,2,2,0,0
2022-01-06,Binh Duong,Thu Dau Mot Town,23,1,0,1,0
2022-01-06,Binh Duong,Thuan An,7,2,1,1,1
2022-01-06,Binh Duong,Thuan An,8,20,5,15,14
2022-01-06,Binh Duong,Thuan An,9,38,27,11,9
2022-01-06,Binh Duong,Thuan An,10,47,34,13,9
2022-01-06,Binh Duong,Thuan An,11,61,49,12,7
2022-01-06,Binh Duong,Thuan An,12,46,33,13,9
2022-01-06,Binh Duong,Thuan An,13,52,38,14,9
2022-01-06,Binh Duong,Thuan An,14,48,34,14,6
2022-01-06,Binh Duong,Thuan An,15,32,27,5,5
2022-01-06,Binh Duong,Thuan An,16,31,18,13,6
2022-01-06,Binh Duong,Thuan An,17,29,23,6,4
2022-01-06,Binh Duong,Thuan An,18,31,21,10,6
2022-01-06,Binh Duong,Thuan An,19,29,8,21,18
2022-01-06,Binh Duong,Thuan An,20,31,13,18,16
2022-01-06,Binh Duong,Thuan An,21,11,6,5,4
2022-01-06,Can Tho City,Binh Thuy District,7,1,1,0,0
2022-01-06,Can Tho City,Binh Thuy District,8,6,5,1,0
2022-01-06,Can Tho City,Binh Thuy District,9,5,5,0,0
2022-01-06,Can Tho City,Binh Thuy District,10,10,9,1,0
2022-01-06,Can Tho City,Binh Thuy District,11,7,6,1,0
2022-01-06,Can Tho City,Binh Thuy District,12,7,5,2,0
2022-01-06,Can Tho City,Binh Thuy District,13,9,9,0,0
2022-01-06,Can Tho City,Binh Thuy District,14,8,7,1,0
2022-01-06,Can Tho City,Binh Thuy District,15,7,6,1,0
2022-01-06,Can Tho City,Binh Thuy District,16,11,9,2,0
2022-01-06,Can Tho City,Binh Thuy District,17,17,14,3,0
2022-01-06,Can Tho City,Binh Thuy District,18,5,5,0,0
2022-01-06,Can Tho City,Binh Thuy District,19,10,10,0,0
2022-01-06,Can Tho City,Binh Thuy District,20,10,9,1,0
2022-01-06,Can Tho City,Binh Thuy District,21,1,1,0,0
2022-01-06,Can Tho City,Cai Rang District,6,1,1,0,0
2022-01-06,Can Tho City,Cai Rang District,7,4,4,0,0
2022-01-06,Can Tho City,Cai Rang District,8,6,5,1,0
2022-01-06,Can Tho City,Cai Rang District,9,3,3,0,0
2022-01-06,Can Tho City,Cai Rang District,10,5,5,0,0
2022-01-06,Can Tho City,Cai Rang District,11,11,11,0,0
2022-01-06,Can Tho City,Cai Rang District,12,9,9,0,0
2022-01-06,Can Tho City,Cai Rang District,13,3,3,0,0
2022-01-06,Can Tho City,Cai Rang District,14,10,10,0,0
2022-01-06,Can Tho City,Cai Rang District,15,5,5,0,0
2022-01-06,Can Tho City,Cai Rang District,16,10,10,0,0
2022-01-06,Can Tho City,Cai Rang District,17,7,7,0,0
2022-01-06,Can Tho City,Cai Rang District,18,4,4,0,0
2022-01-06,Can Tho City,Cai Rang District,19,10,10,0,0
2022-01-06,Can Tho City,Cai Rang District,20,5,3,2,0
2022-01-06,Can Tho City,Cai Rang District,21,1,0,1,1
2022-01-06,Can Tho City,Ninh Kieu District,0,3,3,0,0
2022-01-06,Can Tho City,Ninh Kieu District,1,2,1,1,0
2022-01-06,Can Tho City,Ninh Kieu District,3,2,2,0,0
2022-01-06,Can Tho City,Ninh Kieu District,4,1,1,0,0
2022-01-06,Can Tho City,Ninh Kieu District,5,4,4,0,0
2022-01-06,Can Tho City,Ninh Kieu District,6,63,58,5,1
2022-01-06,Can Tho City,Ninh Kieu District,7,157,147,10,1
2022-01-06,Can Tho City,Ninh Kieu District,8,273,261,12,0
2022-01-06,Can Tho City,Ninh Kieu District,9,257,244,13,0
2022-01-06,Can Tho City,Ninh Kieu District,10,490,477,13,0
2022-01-06,Can Tho City,Ninh Kieu District,11,715,688,27,0
2022-01-06,Can Tho City,Ninh Kieu District,12,451,436,15,0
2022-01-06,Can Tho City,Ninh Kieu District,13,373,354,19,0
2022-01-06,Can Tho City,Ninh Kieu District,14,283,270,13,0
2022-01-06,Can Tho City,Ninh Kieu District,15,310,288,22,0
2022-01-06,Can Tho City,Ninh Kieu District,16,310,298,12,0
2022-01-06,Can Tho City,Ninh Kieu District,17,403,385,18,0
2022-01-06,Can Tho City,Ninh Kieu District,18,429,405,24,0
2022-01-06,Can Tho City,Ninh Kieu District,19,310,291,19,0
2022-01-06,Can Tho City,Ninh Kieu District,20,295,271,24,0
2022-01-06,Can Tho City,Ninh Kieu District,21,132,121,11,0
2022-01-06,Can Tho City,Ninh Kieu District,22,3,1,2,0
2022-01-06,Can Tho City,Ninh Kieu District,23,2,2,0,0
2022-01-06,Dong Nai,Bien Hoa City,1,2,1,1,1
2022-01-06,Dong Nai,Bien Hoa City,3,2,1,1,1
2022-01-06,Dong Nai,Bien Hoa City,5,2,0,2,1
2022-01-06,Dong Nai,Bien Hoa City,6,38,27,11,10
2022-01-06,Dong Nai,Bien Hoa City,7,165,140,25,8
2022-01-06,Dong Nai,Bien Hoa City,8,272,248,24,7
2022-01-06,Dong Nai,Bien Hoa City,9,399,363,36,4
2022-01-06,Dong Nai,Bien Hoa City,10,642,609,33,2
2022-01-06,Dong Nai,Bien Hoa City,11,977,909,68,16
2022-01-06,Dong Nai,Bien Hoa City,12,704,655,49,9
2022-01-06,Dong Nai,Bien Hoa City,13,644,617,27,2
2022-01-06,Dong Nai,Bien Hoa City,14,526,494,32,5
2022-01-06,Dong Nai,Bien Hoa City,15,465,441,24,2
2022-01-06,Dong Nai,Bien Hoa City,16,420,394,26,3
2022-01-06,Dong Nai,Bien Hoa City,17,593,514,79,36
2022-01-06,Dong Nai,Bien Hoa City,18,828,439,389,311
2022-01-06,Dong Nai,Bien Hoa City,19,1198,418,780,686
2022-01-06,Dong Nai,Bien Hoa City,20,851,420,431,345
2022-01-06,Dong Nai,Bien Hoa City,21,270,163,107,69
2022-01-06,Dong Nai,Bien Hoa City,22,5,4,1,0
2022-01-06,Dong Nai,Bien Hoa City,23,2,2,0,0
2022-01-06,Dong Nai,Cam My,12,1,0,1,1
2022-01-06,Dong Nai,Long Khanh,13,1,0,1,1
2022-01-06,Dong Nai,Long Thanh,9,2,0,2,2
2022-01-06,Dong Nai,Long Thanh,12,2,0,2,1
2022-01-06,Dong Nai,Thong Nhat,7,1,1,0,0
2022-01-06,Dong Nai,Thong Nhat,9,1,1,0,0
2022-01-06,Dong Nai,Thong Nhat,11,1,1,0,0
2022-01-06,Dong Nai,Thong Nhat,13,4,4,0,0
2022-01-06,Dong Nai,Thong Nhat,17,1,1,0,0
2022-01-06,Dong Nai,Thong Nhat,19,2,0,2,2
2022-01-06,Dong Nai,Thong Nhat,20,1,0,1,1
2022-01-06,Dong Nai,Thong Nhat,22,1,1,0,0
2022-01-06,Dong Nai,Trang Bom,9,1,0,1,1
2022-01-06,Dong Nai,Trang Bom,10,1,0,1,1
2022-01-06,Dong Nai,Trang Bom,11,1,0,1,0
2022-01-06,Dong Nai,Trang Bom,13,3,0,3,1
2022-01-06,Dong Nai,Trang Bom,14,1,0,1,1
2022-01-06,Dong Nai,Trang Bom,15,1,0,1,1
2022-01-06,Dong Nai,Trang Bom,19,2,0,2,1
2022-01-06,Hai Phong City,An Duong,7,3,0,3,3
2022-01-06,Hai Phong City,An Duong,8,2,2,0,0
2022-01-06,Hai Phong City,An Duong,9,1,1,0,0
2022-01-06,Hai Phong City,An Duong,10,1,1,0,0
2022-01-06,Hai Phong City,An Duong,11,3,1,2,2
2022-01-06,Hai Phong City,An Duong,13,1,1,0,0
2022-01-06,Hai Phong City,An Duong,14,3,3,0,0
2022-01-06,Hai Phong City,An Duong,15,5,5,0,0
2022-01-06,Hai Phong City,An Duong,16,2,2,0,0
2022-01-06,Hai Phong City,An Duong,17,2,1,1,1
2022-01-06,Hai Phong City,An Duong,18,1,0,1,0
2022-01-06,Hai Phong City,An Duong,20,1,0,1,0
2022-01-06,Hai Phong City,Do Son District,18,1,0,1,1
2022-01-06,Hai Phong City,Duong Kinh District,15,2,0,2,2
2022-01-06,Hai Phong City,Hai An District,7,8,7,1,1
2022-01-06,Hai Phong City,Hai An District,8,15,11,4,1
2022-01-06,Hai Phong City,Hai An District,9,13,9,4,0
2022-01-06,Hai Phong City,Hai An District,10,18,17,1,0
2022-01-06,Hai Phong City,Hai An District,11,64,51,13,2
2022-01-06,Hai Phong City,Hai An District,12,29,26,3,0
2022-01-06,Hai Phong City,Hai An District,13,12,12,0,0
2022-01-06,Hai Phong City,Hai An District,14,14,13,1,0
2022-01-06,Hai Phong City,Hai An District,15,13,11,2,0
2022-01-06,Hai Phong City,Hai An District,16,25,22,3,0
2022-01-06,Hai Phong City,Hai An District,17,28,24,4,0
2022-01-06,Hai Phong City,Hai An District,18,43,40,3,0
2022-01-06,Hai Phong City,Hai An District,19,33,31,2,0
2022-01-06,Hai Phong City,Hai An District,20,8,5,3,0
2022-01-06,Hai Phong City,Hai An District,21,7,6,1,0
2022-01-06,Hai Phong City,Hai An District,22,1,0,1,0
2022-01-06,Hai Phong City,Hong Bang District,1,1,1,0,0
2022-01-06,Hai Phong City,Hong Bang District,7,23,18,5,3
2022-01-06,Hai Phong City,Hong Bang District,8,37,32,5,0
2022-01-06,Hai Phong City,Hong Bang District,9,44,39,5,0
2022-01-06,Hai Phong City,Hong Bang District,10,53,52,1,0
2022-01-06,Hai Phong City,Hong Bang District,11,125,106,19,2
2022-01-06,Hai Phong City,Hong Bang District,12,83,77,6,1
2022-01-06,Hai Phong City,Hong Bang District,13,33,32,1,0
2022-01-06,Hai Phong City,Hong Bang District,14,40,38,2,0
2022-01-06,Hai Phong City,Hong Bang District,15,45,39,6,0
2022-01-06,Hai Phong City,Hong Bang District,16,48,40,8,1
2022-01-06,Hai Phong City,Hong Bang District,17,36,31,5,1
2022-01-06,Hai Phong City,Hong Bang District,18,53,43,10,3
2022-01-06,Hai Phong City,Hong Bang District,19,49,43,6,1
2022-01-06,Hai Phong City,Hong Bang District,20,32,29,3,0
2022-01-06,Hai Phong City,Hong Bang District,21,6,5,1,0
2022-01-06,Hai Phong City,Hong Bang District,22,1,0,1,0
2022-01-06,Hai Phong City,Kien An District,8,5,2,3,2
2022-01-06,Hai Phong City,Kien An District,9,1,0,1,1
2022-01-06,Hai Phong City,Kien An District,10,3,2,1,1
2022-01-06,Hai Phong City,Kien An District,11,11,3,8,7
2022-01-06,Hai Phong City,Kien An District,12,8,7,1,1
2022-01-06,Hai Phong City,Kien An District,13,3,2,1,1
2022-01-06,Hai Phong City,Kien An District,14,6,5,1,0
2022-01-06,Hai Phong City,Kien An District,15,8,4,4,2
2022-01-06,Hai Phong City,Kien An District,16,13,10,3,2
2022-01-06,Hai Phong City,Kien An District,17,4,3,1,1
2022-01-06,Hai Phong City,Kien An District,18,5,4,1,1
2022-01-06,Hai Phong City,Kien An District,19,7,2,5,5
2022-01-06,Hai Phong City,Kien An District,20,10,2,8,5
2022-01-06,Hai Phong City,Kien An District,21,5,0,5,5
2022-01-06,Hai Phong City,Le Chan District,0,1,1,0,0
2022-01-06,Hai Phong City,Le Chan District,6,2,2,0,0
2022-01-06,Hai Phong City,Le Chan District,7,43,35,8,3
2022-01-06,Hai Phong City,Le Chan District,8,89,80,9,0
2022-01-06,Hai Phong City,Le Chan District,9,93,79,14,0
2022-01-06,Hai Phong City,Le Chan District,10,173,155,18,0
2022-01-06,Hai Phong City,Le Chan District,11,368,315,53,7
2022-01-06,Hai Phong City,Le Chan District,12,215,204,11,0
2022-01-06,Hai Phong City,Le Chan District,13,137,122,15,0
2022-01-06,Hai Phong City,Le Chan District,14,152,144,8,0
2022-01-06,Hai Phong City,Le Chan District,15,182,166,16,2
2022-01-06,Hai Phong City,Le Chan District,16,186,165,21,0
2022-01-06,Hai Phong City,Le Chan District,17,224,190,34,0
2022-01-06,Hai Phong City,Le Chan District,18,256,226,30,2
2022-01-06,Hai Phong City,Le Chan District,19,179,159,20,2
2022-01-06,Hai Phong City,Le Chan District,20,170,137,33,1
2022-01-06,Hai Phong City,Le Chan District,21,74,62,12,2
2022-01-06,Hai Phong City,Le Chan District,22,2,1,1,0
2022-01-06,Hai Phong City,Le Chan District,23,2,2,0,0
2022-01-06,Hai Phong City,Ngo Quyen District,0,2,2,0,0
2022-01-06,Hai Phong City,Ngo Quyen District,2,2,1,1,0
2022-01-06,Hai Phong City,Ngo Quyen District,6,5,3,2,0
2022-01-06,Hai Phong City,Ngo Quyen District,7,25,21,4,2
2022-01-06,Hai Phong City,Ngo Quyen District,8,99,83,16,2
2022-01-06,Hai Phong City,Ngo Quyen District,9,74,66,8,0
2022-01-06,Hai Phong City,Ngo Quyen District,10,141,131,10,0
2022-01-06,Hai Phong City,Ngo Quyen District,11,289,259,30,5
2022-01-06,Hai Phong City,Ngo Quyen District,12,171,164,7,1
2022-01-06,Hai Phong City,Ngo Quyen District,13,113,101,12,0
2022-01-06,Hai Phong City,Ngo Quyen District,14,128,116,12,0
2022-01-06,Hai Phong City,Ngo Quyen District,15,176,159,17,2
2022-01-06,Hai Phong City,Ngo Quyen District,16,166,152,14,1
2022-01-06,Hai Phong City,Ngo Quyen District,17,169,146,23,0
2022-01-06,Hai Phong City,Ngo Quyen District,18,216,195,21,1
2022-01-06,Hai Phong City,Ngo Quyen District,19,156,143,13,0
2022-01-06,Hai Phong City,Ngo Quyen District,20,146,126,20,2
2022-01-06,Hai Phong City,Ngo Quyen District,21,67,58,9,0
2022-01-06,Hai Phong City,Ngo Quyen District,22,3,1,2,0
2022-01-06,Hai Phong City,Thuy Nguyen,9,1,0,1,1
2022-01-06,Hai Phong City,Thuy Nguyen,11,2,0,2,2
2022-01-06,Hai Phong City,Thuy Nguyen,15,1,0,1,1
2022-01-06,Hai Phong City,Thuy Nguyen,16,1,0,1,1
2022-01-06,Hai Phong City,Thuy Nguyen,17,2,0,2,2
2022-01-06,Hai Phong City,Thuy Nguyen,18,2,0,2,2
2022-01-06,Hai Phong City,Thuy Nguyen,19,1,0,1,1
2022-01-06,Hue City,Hue City,0,2,1,1,0
2022-01-06,Hue City,Hue City,1,4,4,0,0
2022-01-06,Hue City,Hue City,2,3,3,0,0
2022-01-06,Hue City,Hue City,3,1,1,0,0
2022-01-06,Hue City,Hue City,5,1,0,1,0
2022-01-06,Hue City,Hue City,6,80,72,8,6
2022-01-06,Hue City,Hue City,7,229,209,20,2
2022-01-06,Hue City,Hue City,8,358,340,18,1
2022-01-06,Hue City,Hue City,9,270,253,17,0
2022-01-06,Hue City,Hue City,10,351,334,17,0
2022-01-06,Hue City,Hue City,11,728,692,36,1
2022-01-06,Hue City,Hue City,12,479,452,27,1
2022-01-06,Hue City,Hue City,13,260,248,12,1
2022-01-06,Hue City,Hue City,14,310,276,34,0
2022-01-06,Hue City,Hue City,15,373,344,29,10
2022-01-06,Hue City,Hue City,16,396,374,22,0
2022-01-06,Hue City,Hue City,17,516,484,32,1
2022-01-06,Hue City,Hue City,18,618,585,33,3
2022-01-06,Hue City,Hue City,19,468,432,36,4
2022-01-06,Hue City,Hue City,20,396,350,46,4
2022-01-06,Hue City,Hue City,21,215,179,36,0
2022-01-06,Hue City,Hue City,22,6,1,5,0
2022-01-06,Hue City,Hue City,23,2,1,1,0
2022-01-06,Hue City,Huong Thuy,10,1,0,1,0
2022-01-06,Hue City,Huong Thuy,12,1,1,0,0
2022-01-06,Hue City,Huong Thuy,17,1,1,0,0
2022-01-06,Hue City,Huong Thuy,18,2,1,1,0
2022-01-06,Hue City,Huong Thuy,19,1,0,1,1
2022-01-06,Hue City,Huong Tra,20,1,0,1,0
2022-01-06,Hue City,Phu Vang,6,1,0,1,1
2022-01-06,Hue City,Phu Vang,7,2,2,0,0
2022-01-06,Hue City,Phu Vang,8,5,5,0,0
2022-01-06,Hue City,Phu Vang,9,3,2,1,0
2022-01-06,Hue City,Phu Vang,10,1,1,0,0
2022-01-06,Hue City,Phu Vang,11,2,2,0,0
2022-01-06,Hue City,Phu Vang,12,1,1,0,0
2022-01-06,Hue City,Phu Vang,13,5,4,1,1
2022-01-06,Hue City,Phu Vang,16,1,1,0,0
2022-01-06,Hue City,Phu Vang,17,3,2,1,0
2022-01-06,Hue City,Phu Vang,19,1,0,1,1
2022-01-06,Hue City,Phu Vang,20,2,0,2,1
2022-01-06,Hue City,Phu Vang,21,3,2,1,0
2022-01-06,Vung Tau,Ba Ria City,7,1,0,1,1
2022-01-06,Vung Tau,Ba Ria City,8,8,0,8,6
2022-01-06,Vung Tau,Ba Ria City,9,8,2,6,6
2022-01-06,Vung Tau,Ba Ria City,10,15,6,9,8
2022-01-06,Vung Tau,Ba Ria City,11,7,5,2,2
2022-01-06,Vung Tau,Ba Ria City,12,10,4,6,4
2022-01-06,Vung Tau,Ba Ria City,13,15,10,5,4
2022-01-06,Vung Tau,Ba Ria City,14,5,2,3,3
2022-01-06,Vung Tau,Ba Ria City,15,12,4,8,3
2022-01-06,Vung Tau,Ba Ria City,16,15,3,12,12
2022-01-06,Vung Tau,Ba Ria City,17,5,5,0,0
2022-01-06,Vung Tau,Ba Ria City,18,5,4,1,1
2022-01-06,Vung Tau,Ba Ria City,19,1,1,0,0
2022-01-06,Vung Tau,Ba Ria City,20,2,1,1,1
2022-01-06,Vung Tau,Ba Ria City,21,3,0,3,2
2022-01-06,Vung Tau,Tan Thanh,10,1,0,1,1
2022-01-06,Vung Tau,Tan Thanh,11,2,0,2,2
2022-01-06,Vung Tau,Tan Thanh,12,1,0,1,1
2022-01-06,Vung Tau,Vung Tau City,0,2,2,0,0
2022-01-06,Vung Tau,Vung Tau City,1,1,1,0,0
2022-01-06,Vung Tau,Vung Tau City,2,2,1,1,0
2022-01-06,Vung Tau,Vung Tau City,6,45,37,8,3
2022-01-06,Vung Tau,Vung Tau City,7,117,103,14,3
2022-01-06,Vung Tau,Vung Tau City,8,197,184,13,1
2022-01-06,Vung Tau,Vung Tau City,9,165,151,14,0
2022-01-06,Vung Tau,Vung Tau City,10,180,169,11,0
2022-01-06,Vung Tau,Vung Tau City,11,357,334,23,1
2022-01-06,Vung Tau,Vung Tau City,12,240,225,15,2
2022-01-06,Vung Tau,Vung Tau City,13,218,199,19,4
2022-01-06,Vung Tau,Vung Tau City,14,226,214,12,0
2022-01-06,Vung Tau,Vung Tau City,15,204,190,14,0
2022-01-06,Vung Tau,Vung Tau City,16,213,204,9,1
2022-01-06,Vung Tau,Vung Tau City,17,263,245,18,0
2022-01-06,Vung Tau,Vung Tau City,18,276,258,18,0
2022-01-06,Vung Tau,Vung Tau City,19,226,201,25,5
2022-01-06,Vung Tau,Vung Tau City,20,183,170,13,0
2022-01-06,Vung Tau,Vung Tau City,21,69,49,20,5
2022-01-06,Vung Tau,Vung Tau City,22,3,2,1,0
2022-01-06,Vung Tau,Vung Tau City,23,2,2,0,0
2022-01-07,Binh Duong,Ben Cat,8,1,1,0,0
2022-01-07,Binh Duong,Ben Cat,9,1,1,0,0
2022-01-07,Binh Duong,Ben Cat,12,1,0,1,0
2022-01-07,Binh Duong,Di An,7,4,2,2,2
2022-01-07,Binh Duong,Di An,8,5,1,4,4
2022-01-07,Binh Duong,Di An,9,21,10,11,9
2022-01-07,Binh Duong,Di An,10,15,12,3,2
2022-01-07,Binh Duong,Di An,11,34,18,16,12
2022-01-07,Binh Duong,Di An,12,30,10,20,18
2022-01-07,Binh Duong,Di An,13,26,19,7,7
2022-01-07,Binh Duong,Di An,14,8,6,2,1
2022-01-07,Binh Duong,Di An,15,7,7,0,0
2022-01-07,Binh Duong,Di An,16,12,9,3,2
2022-01-07,Binh Duong,Di An,17,10,5,5,3
2022-01-07,Binh Duong,Di An,18,16,8,8,4
2022-01-07,Binh Duong,Di An,19,20,8,12,8
2022-01-07,Binh Duong,Di An,20,11,3,8,7
2022-01-07,Binh Duong,Di An,21,3,1,2,2
2022-01-07,Binh Duong,Di An,23,1,1,0,0
2022-01-07,Binh Duong,Tan Uyen,8,2,0,2,1
2022-01-07,Binh Duong,Tan Uyen,11,3,1,2,1
2022-01-07,Binh Duong,Tan Uyen,12,3,1,2,2
2022-01-07,Binh Duong,Tan Uyen,14,3,1,2,2
2022-01-07,Binh Duong,Tan Uyen,15,1,1,0,0
2022-01-07,Binh Duong,Tan Uyen,19,1,0,1,1
2022-01-07,Binh Duong,Thu Dau Mot Town,0,3,2,1,1
2022-01-07,Binh Duong,Thu Dau Mot Town,3,1,1,0,0
2022-01-07,Binh Duong,Thu Dau Mot Town,5,2,1,1,1
2022-01-07,Binh Duong,Thu Dau Mot Town,6,36,30,6,4
2022-01-07,Binh Duong,Thu Dau Mot Town,7,94,89,5,0
2022-01-07,Binh Duong,Thu Dau Mot Town,8,183,168,15,0
2022-01-07,Binh Duong,Thu Dau Mot Town,9,218,208,10,2
2022-01-07,Binh Duong,Thu Dau Mot Town,10,292,278,14,2
2022-01-07,Binh Duong,Thu Dau Mot Town,11,616,588,28,3
2022-01-07,Binh Duong,Thu Dau Mot Town,12,411,385,26,3
2022-01-07,Binh Duong,Thu Dau Mot Town,13,357,342,15,0
2022-01-07,Binh Duong,Thu Dau Mot Town,14,278,268,10,0
2022-01-07,Binh Duong,Thu Dau Mot Town,15,248,228,20,3
2022-01-07,Binh Duong,Thu Dau Mot Town,16,251,240,11,0
2022-01-07,Binh Duong,Thu Dau Mot Town,17,312,292,20,1
2022-01-07,Binh Duong,Thu Dau Mot Town,18,323,295,28,1
2022-01-07,Binh Duong,Thu Dau Mot Town,19,287,272,15,2
2022-01-07,Binh Duong,Thu Dau Mot Town,20,197,172,25,8
2022-01-07,Binh Duong,Thu Dau Mot Town,21,101,88,13,1
2022-01-07,Binh Duong,Thu Dau Mot Town,22,1,1,0,0
2022-01-07,Binh Duong,Thu Dau Mot Town,23,1,1,0,0
2022-01-07,Binh Duong,Thuan An,6,1,0,1,1
2022-01-07,Binh Duong,Thuan An,7,3,1,2,2
2022-01-07,Binh Duong,Thuan An,8,15,9,6,2
2022-01-07,Binh Duong,Thuan An,9,26,20,6,5
2022-01-07,Binh Duong,Thuan An,10,47,38,9,5
2022-01-07,Binh Duong,Thuan An,11,68,45,23,18
2022-01-07,Binh Duong,Thuan An,12,53,44,9,8
2022-01-07,Binh Duong,Thuan An,13,44,36,8,3
2022-01-07,Binh Duong,Thuan An,14,37,32,5,4
2022-01-07,Binh Duong,Thuan An,15,18,14,4,3
2022-01-07,Binh Duong,Thuan An,16,28,23,5,3
2022-01-07,Binh Duong,Thuan An,17,21,16,5,4
2022-01-07,Binh Duong,Thuan An,18,46,29,17,7
2022-01-07,Binh Duong,Thuan An,19,31,26,5,3
2022-01-07,Binh Duong,Thuan An,20,23,11,12,8
2022-01-07,Binh Duong,Thuan An,21,15,4,11,7
2022-01-07,Binh Duong,Thuan An,22,1,0,1,0
2022-01-07,Can Tho City,Binh Thuy District,7,4,4,0,0
2022-01-07,Can Tho City,Binh Thuy District,8,4,4,0,0
2022-01-07,Can Tho City,Binh Thuy District,9,9,7,2,0
2022-01-07,Can Tho City,Binh Thuy District,10,9,8,1,0
2022-01-07,Can Tho City,Binh Thuy District,11,13,12,1,0
2022-01-07,Can Tho City,Binh Thuy District,12,10,9,1,0
2022-01-07,Can Tho City,Binh Thuy District,13,3,3,0,0
2022-01-07,Can Tho City,Binh Thuy District,14,12,11,1,0
2022-01-07,Can Tho City,Binh Thuy District,15,9,9,0,0
2022-01-07,Can Tho City,Binh Thuy District,16,14,12,2,0
2022-01-07,Can Tho City,Binh Thuy District,17,7,7,0,0
2022-01-07,Can Tho City,Binh Thuy District,18,16,15,1,0
2022-01-07,Can Tho City,Binh Thuy District,19,11,11,0,0
2022-01-07,Can Tho City,Binh Thuy District,20,7,7,0,0
2022-01-07,Can Tho City,Binh Thuy District,21,1,0,1,0
2022-01-07,Can Tho City,Cai Rang District,6,2,2,0,0
2022-01-07,Can Tho City,Cai Rang District,7,1,1,0,0
2022-01-07,Can Tho City,Cai Rang District,8,2,2,0,0
2022-01-07,Can Tho City,Cai Rang District,9,1,1,0,0
2022-01-07,Can Tho City,Cai Rang District,10,10,9,1,0
2022-01-07,Can Tho City,Cai Rang District,11,17,16,1,0
2022-01-07,Can Tho City,Cai Rang District,12,6,6,0,0
2022-01-07,Can Tho City,Cai Rang District,13,9,8,1,0
2022-01-07,Can Tho City,Cai Rang District,14,8,7,1,1
2022-01-07,Can Tho City,Cai Rang District,15,10,8,2,0
2022-01-07,Can Tho City,Cai Rang District,16,5,5,0,0
2022-01-07,Can Tho City,Cai Rang District,17,13,12,1,0
2022-01-07,Can Tho City,Cai Rang District,18,5,5,0,0
2022-01-07,Can Tho City,Cai Rang District,19,3,3,0,0
2022-01-07,Can Tho City,Cai Rang District,20,11,9,2,0
2022-01-07,Can Tho City,Cai Rang District,21,2,0,2,0
2022-01-07,Can Tho City,Ninh Kieu District,0,6,3,3,0
2022-01-07,Can Tho City,Ninh Kieu District,1,3,2,1,0
2022-01-07,Can Tho City,Ninh Kieu District,2,3,3,0,0
2022-01-07,Can Tho City,Ninh Kieu District,3,1,1,0,0
2022-01-07,Can Tho City,Ninh Kieu District,4,1,1,0,0
2022-01-07,Can Tho City,Ninh Kieu District,5,5,5,0,0
2022-01-07,Can Tho City,Ninh Kieu District,6,45,42,3,0
2022-01-07,Can Tho City,Ninh Kieu District,7,154,142,12,0
2022-01-07,Can Tho City,Ninh Kieu District,8,251,233,18,0
2022-01-07,Can Tho City,Ninh Kieu District,9,295,277,18,0
2022-01-07,Can Tho City,Ninh Kieu District,10,473,454,19,0
2022-01-07,Can Tho City,Ninh Kieu District,11,756,720,36,0
2022-01-07,Can Tho City,Ninh Kieu District,12,517,495,22,0
2022-01-07,Can Tho City,Ninh Kieu District,13,346,328,18,0
2022-01-07,Can Tho City,Ninh Kieu District,14,320,303,17,0
2022-01-07,Can Tho City,Ninh Kieu District,15,263,250,13,0
2022-01-07,Can Tho City,Ninh Kieu District,16,340,327,13,0
2022-01-07,Can Tho City,Ninh Kieu District,17,481,464,17,0
2022-01-07,Can Tho City,Ninh Kieu District,18,483,460,23,1
2022-01-07,Can Tho City,Ninh Kieu District,19,364,354,10,1
2022-01-07,Can Tho City,Ninh Kieu District,20,286,270,16,0
2022-01-07,Can Tho City,Ninh Kieu District,21,141,123,18,1
2022-01-07,Can Tho City,Ninh Kieu District,22,5,5,0,0
2022-01-07,Can Tho City,Ninh Kieu District,23,4,2,2,0
2022-01-07,Dong Nai,Bien Hoa City,0,1,1,0,0
2022-01-07,Dong Nai,Bien Hoa City,1,2,2,0,0
2022-01-07,Dong Nai,Bien Hoa City,3,1,1,0,0
2022-01-07,Dong Nai,Bien Hoa City,6,49,34,15,13
2022-01-07,Dong Nai,Bien Hoa City,7,159,133,26,12
2022-01-07,Dong Nai,Bien Hoa City,8,282,259,23,4
2022-01-07,Dong Nai,Bien Hoa City,9,367,327,40,2
2022-01-07,Dong Nai,Bien Hoa City,10,710,658,52,19
2022-01-07,Dong Nai,Bien Hoa City,11,1053,984,69,15
2022-01-07,Dong Nai,Bien Hoa City,12,817,770,47,2
2022-01-07,Dong Nai,Bien Hoa City,13,702,664,38,2
2022-01-07,Dong Nai,Bien Hoa City,14,673,624,49,8
2022-01-07,Dong Nai,Bien Hoa City,15,468,431,37,4
2022-01-07,Dong Nai,Bien Hoa City,16,422,399,23,6
2022-01-07,Dong Nai,Bien Hoa City,17,580,530,50,9
2022-01-07,Dong Nai,Bien Hoa City,18,690,644,46,4
2022-01-07,Dong Nai,Bien Hoa City,19,619,567,52,9
2022-01-07,Dong Nai,Bien Hoa City,20,416,353,63,8
2022-01-07,Dong Nai,Bien Hoa City,21,202,143,59,29
2022-01-07,Dong Nai,Bien Hoa City,22,1,0,1,0
2022-01-07,Dong Nai,Bien Hoa City,23,5,3,2,0
2022-01-07,Dong Nai,Long Thanh,12,2,0,2,2
2022-01-07,Dong Nai,Long Thanh,17,2,0,2,2
2022-01-07,Dong Nai,Long Thanh,19,2,0,2,2
2022-01-07,Dong Nai,Thong Nhat,8,1,1,0,0
2022-01-07,Dong Nai,Thong Nhat,9,1,1,0,0
2022-01-07,Dong Nai,Thong Nhat,10,3,3,0,0
2022-01-07,Dong Nai,Thong Nhat,11,2,2,0,0
2022-01-07,Dong Nai,Thong Nhat,12,2,1,1,1
2022-01-07,Dong Nai,Thong Nhat,13,2,2,0,0
2022-01-07,Dong Nai,Thong Nhat,14,2,2,0,0
2022-01-07,Dong Nai,Thong Nhat,17,1,1,0,0
2022-01-07,Dong Nai,Trang Bom,10,2,0,2,1
2022-01-07,Dong Nai,Trang Bom,12,1,0,1,0
2022-01-07,Dong Nai,Trang Bom,13,1,0,1,1
2022-01-07,Hai Phong City,An Duong,8,4,2,2,1
2022-01-07,Hai Phong City,An Duong,10,1,1,0,0
2022-01-07,Hai Phong City,An Duong,11,1,1,0,0
2022-01-07,Hai Phong City,An Duong,12,1,1,0,0
2022-01-07,Hai Phong City,An Duong,13,3,2,1,1
2022-01-07,Hai Phong City,An Duong,14,1,1,0,0
2022-01-07,Hai Phong City,An Duong,15,2,2,0,0
2022-01-07,Hai Phong City,An Duong,16,2,1,1,0
2022-01-07,Hai Phong City,An Duong,18,1,1,0,0
2022-01-07,Hai Phong City,An Duong,19,1,0,1,0
2022-01-07,Hai Phong City,Do Son District,11,1,0,1,1
2022-01-07,Hai Phong City,Do Son District,12,1,0,1,1
2022-01-07,Hai Phong City,Do Son District,19,1,0,1,1
2022-01-07,Hai Phong City,Do Son District,21,1,0,1,1
2022-01-07,Hai Phong City,Duong Kinh District,19,3,0,3,2
2022-01-07,Hai Phong City,Duong Kinh District,20,2,1,1,1
2022-01-07,Hai Phong City,Hai An District,6,1,0,1,0
2022-01-07,Hai Phong City,Hai An District,7,6,3,3,0
2022-01-07,Hai Phong City,Hai An District,8,9,9,0,0
2022-01-07,Hai Phong City,Hai An District,9,9,9,0,0
2022-01-07,Hai Phong City,Hai An District,10,24,18,6,0
2022-01-07,Hai Phong City,Hai An District,11,51,44,7,1
2022-01-07,Hai Phong City,Hai An District,12,25,23,2,0
2022-01-07,Hai Phong City,Hai An District,13,9,8,1,0
2022-01-07,Hai Phong City,Hai An District,14,14,13,1,0
2022-01-07,Hai Phong City,Hai An District,15,28,24,4,1
2022-01-07,Hai Phong City,Hai An District,16,19,18,1,0
2022-01-07,Hai Phong City,Hai An District,17,28,22,6,0
2022-01-07,Hai Phong City,Hai An District,18,34,32,2,1
2022-01-07,Hai Phong City,Hai An District,19,30,26,4,0
2022-01-07,Hai Phong City,Hai An District,20,14,13,1,0
2022-01-07,Hai Phong City,Hai An District,21,10,7,3,2
2022-01-07,Hai Phong City,Hong Bang District,1,2,2,0,0
2022-01-07,Hai Phong City,Hong Bang District,6,1,1,0,0
2022-01-07,Hai Phong City,Hong Bang District,7,24,18,6,2
2022-01-07,Hai Phong City,Hong Bang District,8,47,37,10,2
2022-01-07,Hai Phong City,Hong Bang District,9,36,31,5,0
2022-01-07,Hai Phong City,Hong Bang District,10,70,63,7,0
2022-01-07,Hai Phong City,Hong Bang District,11,140,127,13,0
2022-01-07,Hai Phong City,Hong Bang District,12,59,53,6,0
2022-01-07,Hai Phong City,Hong Bang District,13,45,39,6,1
2022-01-07,Hai Phong City,Hong Bang District,14,58,51,7,2
2022-01-07,Hai Phong City,Hong Bang District,15,57,53,4,0
2022-01-07,Hai Phong City,Hong Bang District,16,34,28,6,0
2022-01-07,Hai Phong City,Hong Bang District,17,44,42,2,0
2022-01-07,Hai Phong City,Hong Bang District,18,74,69,5,1
2022-01-07,Hai Phong City,Hong Bang District,19,74,66,8,3
2022-01-07,Hai Phong City,Hong Bang District,20,36,29,7,0
2022-01-07,Hai Phong City,Hong Bang District,21,27,22,5,4
2022-01-07,Hai Phong City,Kien An District,0,2,1,1,0
2022-01-07,Hai Phong City,Kien An District,7,4,0,4,4
2022-01-07,Hai Phong City,Kien An District,8,4,2,2,2
2022-01-07,Hai Phong City,Kien An District,9,4,0,4,4
2022-01-07,Hai Phong City,Kien An District,10,6,3,3,3
2022-01-07,Hai Phong City,Kien An District,11,11,6,5,1
2022-01-07,Hai Phong City,Kien An District,12,3,3,0,0
2022-01-07,Hai Phong City,Kien An District,13,6,4,2,2
2022-01-07,Hai Phong City,Kien An District,14,8,5,3,1
2022-01-07,Hai Phong City,Kien An District,15,9,2,7,6
2022-01-07,Hai Phong City,Kien An District,16,5,4,1,1
2022-01-07,Hai Phong City,Kien An District,17,10,9,1,0
2022-01-07,Hai Phong City,Kien An District,18,6,6,0,0
2022-01-07,Hai Phong City,Kien An District,19,8,5,3,2
2022-01-07,Hai Phong City,Kien An District,20,10,3,7,4
2022-01-07,Hai Phong City,Kien An District,21,4,1,3,3
2022-01-07,Hai Phong City,Kien An District,23,1,0,1,1
2022-01-07,Hai Phong City,Le Chan District,0,1,1,0,0
2022-01-07,Hai Phong City,Le Chan District,1,1,0,1,0
2022-01-07,Hai Phong City,Le Chan District,3,1,0,1,0
2022-01-07,Hai Phong City,Le Chan District,4,1,1,0,0
2022-01-07,Hai Phong City,Le Chan District,6,3,1,2,2
2022-01-07,Hai Phong City,Le Chan District,7,62,45,17,12
2022-01-07,Hai Phong City,Le Chan District,8,114,94,20,0
2022-01-07,Hai Phong City,Le Chan District,9,96,80,16,0
2022-01-07,Hai Phong City,Le Chan District,10,200,184,16,0
2022-01-07,Hai Phong City,Le Chan District,11,345,306,39,1
2022-01-07,Hai Phong City,Le Chan District,12,219,201,18,1
2022-01-07,Hai Phong City,Le Chan District,13,144,125,19,2
2022-01-07,Hai Phong City,Le Chan District,14,156,130,26,4
2022-01-07,Hai Phong City,Le Chan District,15,211,188,23,3
2022-01-07,Hai Phong City,Le Chan District,16,171,155,16,1
2022-01-07,Hai Phong City,Le Chan District,17,202,182,20,1
2022-01-07,Hai Phong City,Le Chan District,18,279,252,27,3
2022-01-07,Hai Phong City,Le Chan District,19,212,192,20,1
2022-01-07,Hai Phong City,Le Chan District,20,131,110,21,0
2022-01-07,Hai Phong City,Le Chan District,21,86,75,11,3
2022-01-07,Hai Phong City,Ngo Quyen District,0,2,1,1,0
2022-01-07,Hai Phong City,Ngo Quyen District,1,1,0,1,0
2022-01-07,Hai Phong City,Ngo Quyen District,2,1,1,0,0
2022-01-07,Hai Phong City,Ngo Quyen District,3,1,0,1,1
2022-01-07,Hai Phong City,Ngo Quyen District,6,3,1,2,1
2022-01-07,Hai Phong City,Ngo Quyen District,7,31,26,5,2
2022-01-07,Hai Phong City,Ngo Quyen District,8,101,82,19,3
2022-01-07,Hai Phong City,Ngo Quyen District,9,98,87,11,1
2022-01-07,Hai Phong City,Ngo Quyen District,10,128,113,15,0
2022-01-07,Hai Phong City,Ngo Quyen District,11,319,293,26,5
2022-01-07,Hai Phong City,Ngo Quyen District,12,175,164,11,0
2022-01-07,Hai Phong City,Ngo Quyen District,13,139,125,14,0
2022-01-07,Hai Phong City,Ngo Quyen District,14,143,129,14,1
2022-01-07,Hai Phong City,Ngo Quyen District,15,161,142,19,5
2022-01-07,Hai Phong City,Ngo Quyen District,16,150,135,15,1
2022-01-07,Hai Phong City,Ngo Quyen District,17,169,148,21,1
2022-01-07,Hai Phong City,Ngo Quyen District,18,200,171,29,1
2022-01-07,Hai Phong City,Ngo Quyen District,19,196,184,12,0
2022-01-07,Hai Phong City,Ngo Quyen District,20,132,121,11,1
2022-01-07,Hai Phong City,Ngo Quyen District,21,72,59,13,1
2022-01-07,Hai Phong City,Thuy Nguyen,10,2,0,2,2
2022-01-07,Hai Phong City,Thuy Nguyen,11,2,0,2,1
2022-01-07,Hai Phong City,Thuy Nguyen,12,6,0,6,2
2022-01-07,Hai Phong City,Thuy Nguyen,13,3,0,3,3
2022-01-07,Hai Phong City,Thuy Nguyen,14,1,0,1,0
2022-01-07,Hai Phong City,Thuy Nguyen,15,2,1,1,1
2022-01-07,Hai Phong City,Thuy Nguyen,16,3,0,3,3
2022-01-07,Hai Phong City,Thuy Nguyen,17,1,0,1,1
2022-01-07,Hai Phong City,Thuy Nguyen,18,1,0,1,1
2022-01-07,Hai Phong City,Thuy Nguyen,21,5,0,5,3
2022-01-07,Hue City,Hue City,0,1,1,0,0
2022-01-07,Hue City,Hue City,1,4,1,3,0
2022-01-07,Hue City,Hue City,2,2,2,0,0
2022-01-07,Hue City,Hue City,3,1,1,0,0
2022-01-07,Hue City,Hue City,4,2,2,0,0
2022-01-07,Hue City,Hue City,6,63,57,6,0
2022-01-07,Hue City,Hue City,7,228,212,16,1
2022-01-07,Hue City,Hue City,8,367,334,33,2
2022-01-07,Hue City,Hue City,9,285,261,24,1
2022-01-07,Hue City,Hue City,10,413,397,16,0
2022-01-07,Hue City,Hue City,11,831,786,45,1
2022-01-07,Hue City,Hue City,12,483,460,23,0
2022-01-07,Hue City,Hue City,13,323,311,12,0
2022-01-07,Hue City,Hue City,14,365,340,25,0
2022-01-07,Hue City,Hue City,15,422,395,27,0
2022-01-07,Hue City,Hue City,16,389,360,29,0
2022-01-07,Hue City,Hue City,17,491,460,31,0
2022-01-07,Hue City,Hue City,18,602,569,33,0
2022-01-07,Hue City,Hue City,19,480,445,35,2
2022-01-07,Hue City,Hue City,20,388,347,41,2
2022-01-07,Hue City,Hue City,21,232,210,22,1
2022-01-07,Hue City,Hue City,22,10,3,7,0
2022-01-07,Hue City,Hue City,23,6,3,3,0
2022-01-07,Hue City,Huong Thuy,11,2,1,1,0
2022-01-07,Hue City,Huong Thuy,14,1,1,0,0
2022-01-07,Hue City,Huong Thuy,17,1,0,1,0
2022-01-07,Hue City,Huong Thuy,18,1,1,0,0
2022-01-07,Hue City,Huong Thuy,19,2,2,0,0
2022-01-07,Hue City,Phu Vang,6,3,2,1,1
2022-01-07,Hue City,Phu Vang,7,2,2,0,0
2022-01-07,Hue City,Phu Vang,8,4,4,0,0
2022-01-07,Hue City,Phu Vang,9,2,2,0,0
2022-01-07,Hue City,Phu Vang,10,4,1,3,3
2022-01-07,Hue City,Phu Vang,11,3,3,0,0
2022-01-07,Hue City,Phu Vang,12,1,1,0,0
2022-01-07,Hue City,Phu Vang,14,2,1,1,0
2022-01-07,Hue City,Phu Vang,16,2,2,0,0
2022-01-07,Hue City,Phu Vang,17,1,0,1,0
2022-01-07,Hue City,Phu Vang,19,1,0,1,0
2022-01-07,Hue City,Phu Vang,20,2,1,1,0
2022-01-07,Hue City,Phu Vang,21,1,0,1,0
2022-01-07,Vung Tau,Ba Ria City,7,1,0,1,1
2022-01-07,Vung Tau,Ba Ria City,8,6,0,6,6
2022-01-07,Vung Tau,Ba Ria City,9,9,4,5,5
2022-01-07,Vung Tau,Ba Ria City,10,8,8,0,0
2022-01-07,Vung Tau,Ba Ria City,11,9,4,5,5
2022-01-07,Vung Tau,Ba Ria City,12,8,7,1,0
2022-01-07,Vung Tau,Ba Ria City,13,8,5,3,2
2022-01-07,Vung Tau,Ba Ria City,14,3,2,1,1
2022-01-07,Vung Tau,Ba Ria City,15,6,5,1,1
2022-01-07,Vung Tau,Ba Ria City,16,7,5,2,0
2022-01-07,Vung Tau,Ba Ria City,17,4,2,2,1
2022-01-07,Vung Tau,Ba Ria City,18,9,5,4,4
2022-01-07,Vung Tau,Ba Ria City,19,10,4,6,5
2022-01-07,Vung Tau,Ba Ria City,20,6,3,3,3
2022-01-07,Vung Tau,Tan Thanh,10,1,0,1,1
2022-01-07,Vung Tau,Tan Thanh,11,1,0,1,1
2022-01-07,Vung Tau,Tan Thanh,16,1,0,1,1
2022-01-07,Vung Tau,Tan Thanh,17,1,0,1,1
2022-01-07,Vung Tau,Vung Tau City,1,2,1,1,0
2022-01-07,Vung Tau,Vung Tau City,2,1,1,0,0
2022-01-07,Vung Tau,Vung Tau City,5,2,2,0,0
2022-01-07,Vung Tau,Vung Tau City,6,50,43,7,3
2022-01-07,Vung Tau,Vung Tau City,7,121,110,11,2
2022-01-07,Vung Tau,Vung Tau City,8,180,168,12,0
2022-01-07,Vung Tau,Vung Tau City,9,159,152,7,0
2022-01-07,Vung Tau,Vung Tau City,10,198,188,10,2
2022-01-07,Vung Tau,Vung Tau City,11,342,321,21,2
2022-01-07,Vung Tau,Vung Tau City,12,238,227,11,0
2022-01-07,Vung Tau,Vung Tau City,13,201,190,11,2
2022-01-07,Vung Tau,Vung Tau City,14,222,206,16,3
2022-01-07,Vung Tau,Vung Tau City,15,241,218,23,0
2022-01-07,Vung Tau,Vung Tau City,16,211,191,20,1
2022-01-07,Vung Tau,Vung Tau City,17,258,233,25,0
2022-01-07,Vung Tau,Vung Tau City,18,339,307,32,6
2022-01-07,Vung Tau,Vung Tau City,19,246,221,25,0
2022-01-07,Vung Tau,Vung Tau City,20,195,171,24,0
2022-01-07,Vung Tau,Vung Tau City,21,90,69,21,7
2022-01-07,Vung Tau,Vung Tau City,22,2,2,0,0
2022-01-07,Vung Tau,Vung Tau City,23,1,1,0,0
2022-01-08,Binh Duong,Ben Cat,14,1,1,0,0
2022-01-08,Binh Duong,Ben Cat,15,2,0,2,1
2022-01-08,Binh Duong,Di An,6,3,0,3,3
2022-01-08,Binh Duong,Di An,7,5,0,5,4
2022-01-08,Binh Duong,Di An,8,10,7,3,0
2022-01-08,Binh Duong,Di An,9,14,7,7,6
2022-01-08,Binh Duong,Di An,10,24,19,5,5
2022-01-08,Binh Duong,Di An,11,35,18,17,15
2022-01-08,Binh Duong,Di An,12,26,13,13,12
2022-01-08,Binh Duong,Di An,13,18,13,5,3
2022-01-08,Binh Duong,Di An,14,15,11,4,2
2022-01-08,Binh Duong,Di An,15,18,12,6,5
2022-01-08,Binh Duong,Di An,16,13,10,3,2
2022-01-08,Binh Duong,Di An,17,13,7,6,3
2022-01-08,Binh Duong,Di An,18,17,13,4,2
2022-01-08,Binh Duong,Di An,19,12,9,3,3
2022-01-08,Binh Duong,Di An,20,6,3,3,3
2022-01-08,Binh Duong,Di An,21,4,0,4,4
2022-01-08,Binh Duong,Tan Uyen,8,1,0,1,1
2022-01-08,Binh Duong,Tan Uyen,9,2,0,2,1
2022-01-08,Binh Duong,Tan Uyen,11,2,1,1,1
2022-01-08,Binh Duong,Tan Uyen,12,1,0,1,1
2022-01-08,Binh Duong,Tan Uyen,13,1,0,1,1
2022-01-08,Binh Duong,Tan Uyen,14,3,1,2,0
2022-01-08,Binh Duong,Tan Uyen,15,3,0,3,3
2022-01-08,Binh Duong,Tan Uyen,16,1,0,1,1
2022-01-08,Binh Duong,Tan Uyen,17,1,0,1,1
2022-01-08,Binh Duong,Tan Uyen,18,2,0,2,2
2022-01-08,Binh Duong,Tan Uyen,20,1,0,1,0
2022-01-08,Binh Duong,Tan Uyen,21,1,0,1,0
2022-01-08,Binh Duong,Thu Dau Mot Town,2,1,1,0,0
2022-01-08,Binh Duong,Thu Dau Mot Town,3,1,0,1,0
2022-01-08,Binh Duong,Thu Dau Mot Town,5,2,1,1,0
2022-01-08,Binh Duong,Thu Dau Mot Town,6,31,27,4,1
2022-01-08,Binh Duong,Thu Dau Mot Town,7,103,95,8,1
2022-01-08,Binh Duong,Thu Dau Mot Town,8,195,178,17,7
2022-01-08,Binh Duong,Thu Dau Mot Town,9,251,237,14,3
2022-01-08,Binh Duong,Thu Dau Mot Town,10,363,346,17,3
2022-01-08,Binh Duong,Thu Dau Mot Town,11,575,534,41,6
2022-01-08,Binh Duong,Thu Dau Mot Town,12,475,446,29,4
2022-01-08,Binh Duong,Thu Dau Mot Town,13,348,328,20,5
2022-01-08,Binh Duong,Thu Dau Mot Town,14,259,246,13,2
2022-01-08,Binh Duong,Thu Dau Mot Town,15,247,234,13,0
2022-01-08,Binh Duong,Thu Dau Mot Town,16,280,261,19,0
2022-01-08,Binh Duong,Thu Dau Mot Town,17,315,299,16,0
2022-01-08,Binh Duong,Thu Dau Mot Town,18,360,348,12,0
2022-01-08,Binh Duong,Thu Dau Mot Town,19,275,251,24,7
2022-01-08,Binh Duong,Thu Dau Mot Town,20,242,209,33,5
2022-01-08,Binh Duong,Thu Dau Mot Town,21,91,71,20,3
2022-01-08,Binh Duong,Thu Dau Mot Town,22,1,0,1,0
2022-01-08,Binh Duong,Thuan An,0,1,0,1,1
2022-01-08,Binh Duong,Thuan An,6,1,0,1,1
2022-01-08,Binh Duong,Thuan An,7,6,1,5,3
2022-01-08,Binh Duong,Thuan An,8,16,5,11,8
2022-01-08,Binh Duong,Thuan An,9,38,12,26,22
2022-01-08,Binh Duong,Thuan An,10,65,33,32,26
2022-01-08,Binh Duong,Thuan An,11,76,43,33,22
2022-01-08,Binh Duong,Thuan An,12,43,34,9,8
2022-01-08,Binh Duong,Thuan An,13,32,22,10,7
2022-01-08,Binh Duong,Thuan An,14,31,20,11,8
2022-01-08,Binh Duong,Thuan An,15,26,20,6,4
2022-01-08,Binh Duong,Thuan An,16,38,29,9,8
2022-01-08,Binh Duong,Thuan An,17,43,19,24,22
2022-01-08,Binh Duong,Thuan An,18,65,38,27,20
2022-01-08,Binh Duong,Thuan An,19,35,14,21,17
2022-01-08,Binh Duong,Thuan An,20,35,13,22,20
2022-01-08,Binh Duong,Thuan An,21,20,2,18,14
2022-01-08,Binh Duong,Thuan An,22,1,1,0,0
2022-01-08,Can Tho City,Binh Thuy District,7,5,4,1,0
2022-01-08,Can Tho City,Binh Thuy District,8,1,1,0,0
2022-01-08,Can Tho City,Binh Thuy District,9,4,3,1,0
2022-01-08,Can Tho City,Binh Thuy District,10,5,3,2,0
2022-01-08,Can Tho City,Binh Thuy District,11,18,16,2,0
2022-01-08,Can Tho City,Binh Thuy District,12,10,9,1,0
2022-01-08,Can Tho City,Binh Thuy District,13,10,9,1,0
2022-01-08,Can Tho City,Binh Thuy District,14,9,9,0,0
2022-01-08,Can Tho City,Binh Thuy District,15,12,12,0,0
2022-01-08,Can Tho City,Binh Thuy District,16,10,10,0,0
2022-01-08,Can Tho City,Binh Thuy District,17,9,8,1,1
2022-01-08,Can Tho City,Binh Thuy District,18,16,14,2,0
2022-01-08,Can Tho City,Binh Thuy District,19,14,13,1,0
2022-01-08,Can Tho City,Binh Thuy District,20,12,12,0,0
2022-01-08,Can Tho City,Binh Thuy District,21,3,2,1,0
2022-01-08,Can Tho City,Cai Rang District,7,2,2,0,0
2022-01-08,Can Tho City,Cai Rang District,8,8,8,0,0
2022-01-08,Can Tho City,Cai Rang District,9,9,9,0,0
2022-01-08,Can Tho City,Cai Rang District,10,11,9,2,0
2022-01-08,Can Tho City,Cai Rang District,11,10,9,1,0
2022-01-08,Can Tho City,Cai Rang District,12,9,8,1,0
2022-01-08,Can Tho City,Cai Rang District,13,8,8,0,0
2022-01-08,Can Tho City,Cai Rang District,14,11,9,2,1
2022-01-08,Can Tho City,Cai Rang District,15,10,9,1,0
2022-01-08,Can Tho City,Cai Rang District,16,13,12,1,0
2022-01-08,Can Tho City,Cai Rang District,17,8,8,0,0
2022-01-08,Can Tho City,Cai Rang District,18,12,12,0,0
2022-01-08,Can Tho City,Cai Rang District,19,10,10,0,0
2022-01-08,Can Tho City,Cai Rang District,20,9,8,1,0
2022-01-08,Can Tho City,Ninh Kieu District,0,3,3,0,0
2022-01-08,Can Tho City,Ninh Kieu District,1,3,3,0,0
2022-01-08,Can Tho City,Ninh Kieu District,2,3,2,1,0
2022-01-08,Can Tho City,Ninh Kieu District,5,3,2,1,0
2022-01-08,Can Tho City,Ninh Kieu District,6,53,49,4,0
2022-01-08,Can Tho City,Ninh Kieu District,7,165,157,8,0
2022-01-08,Can Tho City,Ninh Kieu District,8,249,240,9,0
2022-01-08,Can Tho City,Ninh Kieu District,9,265,251,14,0
2022-01-08,Can Tho City,Ninh Kieu District,10,473,454,19,0
2022-01-08,Can Tho City,Ninh Kieu District,11,699,680,19,0
2022-01-08,Can Tho City,Ninh Kieu District,12,523,503,20,0
2022-01-08,Can Tho City,Ninh Kieu District,13,423,404,19,0
2022-01-08,Can Tho City,Ninh Kieu District,14,348,331,17,0
2022-01-08,Can Tho City,Ninh Kieu District,15,346,329,17,0
2022-01-08,Can Tho City,Ninh Kieu District,16,356,344,12,0
2022-01-08,Can Tho City,Ninh Kieu District,17,446,428,18,0
2022-01-08,Can Tho City,Ninh Kieu District,18,484,469,15,0
2022-01-08,Can Tho City,Ninh Kieu District,19,405,380,25,0
2022-01-08,Can Tho City,Ninh Kieu District,20,261,244,17,0
2022-01-08,Can Tho City,Ninh Kieu District,21,161,142,19,0
2022-01-08,Can Tho City,Ninh Kieu District,22,7,3,4,0
2022-01-08,Can Tho City,Ninh Kieu District,23,9,5,4,0
2022-01-08,Dong Nai,Bien Hoa City,0,3,2,1,0
2022-01-08,Dong Nai,Bien Hoa City,2,1,1,0,0
2022-01-08,Dong Nai,Bien Hoa City,5,1,0,1,1
2022-01-08,Dong Nai,Bien Hoa City,6,46,35,11,8
2022-01-08,Dong Nai,Bien Hoa City,7,162,137,25,16
2022-01-08,Dong Nai,Bien Hoa City,8,284,255,29,4
2022-01-08,Dong Nai,Bien Hoa City,9,443,407,36,4
2022-01-08,Dong Nai,Bien Hoa City,10,704,655,49,6
2022-01-08,Dong Nai,Bien Hoa City,11,1053,973,80,16
2022-01-08,Dong Nai,Bien Hoa City,12,850,780,70,9
2022-01-08,Dong Nai,Bien Hoa City,13,692,652,40,6
2022-01-08,Dong Nai,Bien Hoa City,14,555,507,48,11
2022-01-08,Dong Nai,Bien Hoa City,15,471,432,39,6
2022-01-08,Dong Nai,Bien Hoa City,16,513,467,46,1
2022-01-08,Dong Nai,Bien Hoa City,17,614,552,62,6
2022-01-08,Dong Nai,Bien Hoa City,18,637,581,56,9
2022-01-08,Dong Nai,Bien Hoa City,19,617,566,51,12
2022-01-08,Dong Nai,Bien Hoa City,20,490,428,62,21
2022-01-08,Dong Nai,Bien Hoa City,21,189,140,49,9
2022-01-08,Dong Nai,Bien Hoa City,22,3,0,3,0
2022-01-08,Dong Nai,Bien Hoa City,23,1,1,0,0
2022-01-08,Dong Nai,Cam My,16,1,0,1,0
2022-01-08,Dong Nai,Long Thanh,10,2,0,2,2
2022-01-08,Dong Nai,Long Thanh,11,1,0,1,1
2022-01-08,Dong Nai,Thong Nhat,8,1,1,0,0
2022-01-08,Dong Nai,Thong Nhat,9,1,1,0,0
2022-01-08,Dong Nai,Thong Nhat,11,2,2,0,0
2022-01-08,Dong Nai,Thong Nhat,12,3,3,0,0
2022-01-08,Dong Nai,Thong Nhat,17,1,1,0,0
2022-01-08,Dong Nai,Thong Nhat,19,2,2,0,0
2022-01-08,Dong Nai,Trang Bom,11,1,0,1,1
2022-01-08,Dong Nai,Trang Bom,13,1,0,1,1
2022-01-08,Dong Nai,Trang Bom,14,4,0,4,4
2022-01-08,Dong Nai,Trang Bom,20,1,0,1,1
2022-01-08,Hai Phong City,An Duong,7,2,0,2,1
2022-01-08,Hai Phong City,An Duong,9,1,1,0,0
2022-01-08,Hai Phong City,An Duong,10,1,0,1,1
2022-01-08,Hai Phong City,An Duong,11,3,2,1,1
2022-01-08,Hai Phong City,An Duong,12,4,3,1,0
2022-01-08,Hai Phong City,An Duong,14,4,2,2,1
2022-01-08,Hai Phong City,An Duong,15,2,1,1,1
2022-01-08,Hai Phong City,An Duong,16,2,2,0,0
2022-01-08,Hai Phong City,An Duong,17,5,4,1,0
2022-01-08,Hai Phong City,An Duong,18,3,1,2,1
2022-01-08,Hai Phong City,An Duong,19,1,1,0,0
2022-01-08,Hai Phong City,An Duong,20,1,0,1,0
2022-01-08,Hai Phong City,An Duong,21,1,1,0,0
2022-01-08,Hai Phong City,Duong Kinh District,15,2,1,1,0
2022-01-08,Hai Phong City,Duong Kinh District,21,1,0,1,1
2022-01-08,Hai Phong City,Hai An District,7,19,15,4,2
2022-01-08,Hai Phong City,Hai An District,8,18,14,4,0
2022-01-08,Hai Phong City,Hai An District,9,11,9,2,0
2022-01-08,Hai Phong City,Hai An District,10,27,24,3,0
2022-01-08,Hai Phong City,Hai An District,11,43,41,2,0
2022-01-08,Hai Phong City,Hai An District,12,34,32,2,0
2022-01-08,Hai Phong City,Hai An District,13,19,18,1,1
2022-01-08,Hai Phong City,Hai An District,14,20,18,2,1
2022-01-08,Hai Phong City,Hai An District,15,14,13,1,0
2022-01-08,Hai Phong City,Hai An District,16,16,11,5,1
2022-01-08,Hai Phong City,Hai An District,17,32,29,3,2
2022-01-08,Hai Phong City,Hai An District,18,42,32,10,4
2022-01-08,Hai Phong City,Hai An District,19,40,31,9,3
2022-01-08,Hai Phong City,Hai An District,20,21,16,5,0
2022-01-08,Hai Phong City,Hai An District,21,12,10,2,1
2022-01-08,Hai Phong City,Hai An District,23,1,0,1,1
2022-01-08,Hai Phong City,Hong Bang District,2,1,1,0,0
2022-01-08,Hai Phong City,Hong Bang District,7,17,10,7,0
2022-01-08,Hai Phong City,Hong Bang District,8,43,31,12,3
2022-01-08,Hai Phong City,Hong Bang District,9,37,34,3,0
2022-01-08,Hai Phong City,Hong Bang District,10,76,71,5,0
2022-01-08,Hai Phong City,Hong Bang District,11,124,111,13,6
2022-01-08,Hai Phong City,Hong Bang District,12,88,73,15,2
2022-01-08,Hai Phong City,Hong Bang District,13,47,41,6,1
2022-01-08,Hai Phong City,Hong Bang District,14,42,37,5,0
2022-01-08,Hai Phong City,Hong Bang District,15,57,53,4,0
2022-01-08,Hai Phong City,Hong Bang District,16,58,53,5,0
2022-01-08,Hai Phong City,Hong Bang District,17,70,60,10,1
2022-01-08,Hai Phong City,Hong Bang District,18,83,74,9,1
2022-01-08,Hai Phong City,Hong Bang District,19,83,71,12,3
2022-01-08,Hai Phong City,Hong Bang District,20,44,39,5,2
2022-01-08,Hai Phong City,Hong Bang District,21,12,7,5,4
2022-01-08,Hai Phong City,Kien An District,7,2,0,2,2
2022-01-08,Hai Phong City,Kien An District,8,6,2,4,4
2022-01-08,Hai Phong City,Kien An District,9,4,3,1,0
2022-01-08,Hai Phong City,Kien An District,10,10,6,4,3
2022-01-08,Hai Phong City,Kien An District,11,16,8,8,7
2022-01-08,Hai Phong City,Kien An District,12,8,5,3,3
2022-01-08,Hai Phong City,Kien An District,13,10,3,7,7
2022-01-08,Hai Phong City,Kien An District,14,16,8,8,7
2022-01-08,Hai Phong City,Kien An District,15,7,3,4,2
2022-01-08,Hai Phong City,Kien An District,16,7,5,2,2
2022-01-08,Hai Phong City,Kien An District,17,8,5,3,1
2022-01-08,Hai Phong City,Kien An District,18,13,5,8,6
2022-01-08,Hai Phong City,Kien An District,19,9,7,2,2
2022-01-08,Hai Phong City,Kien An District,20,12,8,4,4
2022-01-08,Hai Phong City,Kien An District,21,3,1,2,2
2022-01-08,Hai Phong City,Kien An District,22,1,0,1,1
2022-01-08,Hai Phong City,Le Chan District,3,2,1,1,0
2022-01-08,Hai Phong City,Le Chan District,5,1,1,0,0
2022-01-08,Hai Phong City,Le Chan District,6,2,2,0,0
2022-01-08,Hai Phong City,Le Chan District,7,49,37,12,2
2022-01-08,Hai Phong City,Le Chan District,8,115,102,13,1
2022-01-08,Hai Phong City,Le Chan District,9,89,78,11,0
2022-01-08,Hai Phong City,Le Chan District,10,190,179,11,1
2022-01-08,Hai Phong City,Le Chan District,11,374,333,41,13
2022-01-08,Hai Phong City,Le Chan District,12,286,262,24,4
2022-01-08,Hai Phong City,Le Chan District,13,122,107,15,1
2022-01-08,Hai Phong City,Le Chan District,14,155,138,17,1
2022-01-08,Hai Phong City,Le Chan District,15,177,164,13,0
2022-01-08,Hai Phong City,Le Chan District,16,217,197,20,0
2022-01-08,Hai Phong City,Le Chan District,17,243,211,32,5
2022-01-08,Hai Phong City,Le Chan District,18,329,284,45,8
2022-01-08,Hai Phong City,Le Chan District,19,241,222,19,3
2022-01-08,Hai Phong City,Le Chan District,20,176,154,22,4
2022-01-08,Hai Phong City,Le Chan District,21,95,73,22,0
2022-01-08,Hai Phong City,Le Chan District,23,1,1,0,0
2022-01-08,Hai Phong City,Ngo Quyen District,2,1,1,0,0
2022-01-08,Hai Phong City,Ngo Quyen District,3,1,1,0,0
2022-01-08,Hai Phong City,Ngo Quyen District,6,5,4,1,0
2022-01-08,Hai Phong City,Ngo Quyen District,7,31,25,6,4
2022-01-08,Hai Phong City,Ngo Quyen District,8,93,78,15,0
2022-01-08,Hai Phong City,Ngo Quyen District,9,102,90,12,0
2022-01-08,Hai Phong City,Ngo Quyen District,10,138,133,5,1
2022-01-08,Hai Phong City,Ngo Quyen District,11,266,231,35,14
2022-01-08,Hai Phong City,Ngo Quyen District,12,209,194,15,3
2022-01-08,Hai Phong City,Ngo Quyen District,13,114,107,7,0
2022-01-08,Hai Phong City,Ngo Quyen District,14,110,105,5,0
2022-01-08,Hai Phong City,Ngo Quyen District,15,164,150,14,3
2022-01-08,Hai Phong City,Ngo Quyen District,16,165,152,13,0
2022-01-08,Hai Phong City,Ngo Quyen District,17,198,178,20,1
2022-01-08,Hai Phong City,Ngo Quyen District,18,198,170,28,13
2022-01-08,Hai Phong City,Ngo Quyen District,19,183,171,12,1
2022-01-08,Hai Phong City,Ngo Quyen District,20,158,140,18,2
2022-01-08,Hai Phong City,Ngo Quyen District,21,67,51,16,2
2022-01-08,Hai Phong City,Ngo Quyen District,22,1,0,1,0
2022-01-08,Hai Phong City,Thuy Nguyen,8,2,0,2,2
2022-01-08,Hai Phong City,Thuy Nguyen,9,3,0,3,3
2022-01-08,Hai Phong City,Thuy Nguyen,10,1,0,1,1
2022-01-08,Hai Phong City,Thuy Nguyen,11,4,0,4,3
2022-01-08,Hai Phong City,Thuy Nguyen,14,1,0,1,1
2022-01-08,Hai Phong City,Thuy Nguyen,15,1,0,1,1
2022-01-08,Hai Phong City,Thuy Nguyen,17,2,0,2,1
2022-01-08,Hai Phong City,Thuy Nguyen,19,1,0,1,1
2022-01-08,Hai Phong City,Thuy Nguyen,21,1,0,1,0
2022-01-08,Hue City,Hue City,0,1,1,0,0
2022-01-08,Hue City,Hue City,1,5,5,0,0
2022-01-08,Hue City,Hue City,5,1,1,0,0
2022-01-08,Hue City,Hue City,6,58,52,6,1
2022-01-08,Hue City,Hue City,7,281,264,17,1
2022-01-08,Hue City,Hue City,8,438,404,34,0
2022-01-08,Hue City,Hue City,9,380,362,18,1
2022-01-08,Hue City,Hue City,10,526,489,37,2
2022-01-08,Hue City,Hue City,11,765,726,39,1
2022-01-08,Hue City,Hue City,12,550,531,19,0
2022-01-08,Hue City,Hue City,13,332,324,8,0
2022-01-08,Hue City,Hue City,14,406,371,35,2
2022-01-08,Hue City,Hue City,15,511,465,46,16
2022-01-08,Hue City,Hue City,16,615,550,65,19
2022-01-08,Hue City,Hue City,17,695,647,48,7
2022-01-08,Hue City,Hue City,18,679,621,58,7
2022-01-08,Hue City,Hue City,19,552,508,44,5
2022-01-08,Hue City,Hue City,20,400,357,43,8
2022-01-08,Hue City,Hue City,21,209,180,29,2
2022-01-08,Hue City,Hue City,22,1,0,1,1
2022-01-08,Hue City,Hue City,23,2,1,1,0
2022-01-08,Hue City,Huong Thuy,8,1,1,0,0
2022-01-08,Hue City,Huong Thuy,9,1,0,1,0
2022-01-08,Hue City,Huong Thuy,16,2,1,1,0
2022-01-08,Hue City,Huong Thuy,17,1,1,0,0
2022-01-08,Hue City,Huong Thuy,18,2,1,1,1
2022-01-08,Hue City,Huong Thuy,19,3,2,1,0
2022-01-08,Hue City,Huong Thuy,20,3,1,2,1
2022-01-08,Hue City,Huong Tra,8,1,1,0,0
2022-01-08,Hue City,Huong Tra,17,1,1,0,0
2022-01-08,Hue City,Phu Vang,7,1,1,0,0
2022-01-08,Hue City,Phu Vang,8,3,2,1,1
2022-01-08,Hue City,Phu Vang,9,1,1,0,0
2022-01-08,Hue City,Phu Vang,11,4,4,0,0
2022-01-08,Hue City,Phu Vang,12,2,2,0,0
2022-01-08,Hue City,Phu Vang,13,1,1,0,0
2022-01-08,Hue City,Phu Vang,15,2,0,2,1
2022-01-08,Hue City,Phu Vang,17,1,1,0,0
2022-01-08,Hue City,Phu Vang,18,1,1,0,0
2022-01-08,Hue City,Phu Vang,20,3,1,2,1
2022-01-08,Hue City,Phu Vang,21,1,1,0,0
2022-01-08,Vung Tau,Ba Ria City,7,3,0,3,2
2022-01-08,Vung Tau,Ba Ria City,8,4,0,4,4
2022-01-08,Vung Tau,Ba Ria City,9,15,2,13,9
2022-01-08,Vung Tau,Ba Ria City,10,11,2,9,7
2022-01-08,Vung Tau,Ba Ria City,11,26,3,23,20
2022-01-08,Vung Tau,Ba Ria City,12,13,6,7,5
2022-01-08,Vung Tau,Ba Ria City,13,14,5,9,8
2022-01-08,Vung Tau,Ba Ria City,14,7,4,3,3
2022-01-08,Vung Tau,Ba Ria City,15,7,7,0,0
2022-01-08,Vung Tau,Ba Ria City,16,9,4,5,4
2022-01-08,Vung Tau,Ba Ria City,17,4,3,1,1
2022-01-08,Vung Tau,Ba Ria City,18,4,2,2,1
2022-01-08,Vung Tau,Ba Ria City,19,6,5,1,1
2022-01-08,Vung Tau,Ba Ria City,20,5,1,4,3
2022-01-08,Vung Tau,Ba Ria City,21,1,0,1,1
2022-01-08,Vung Tau,Tan Thanh,11,2,0,2,2
2022-01-08,Vung Tau,Tan Thanh,12,1,0,1,1
2022-01-08,Vung Tau,Vung Tau City,0,2,1,1,0
2022-01-08,Vung Tau,Vung Tau City,1,2,2,0,0
2022-01-08,Vung Tau,Vung Tau City,5,3,1,2,0
2022-01-08,Vung Tau,Vung Tau City,6,32,25,7,3
2022-01-08,Vung Tau,Vung Tau City,7,114,103,11,3
2022-01-08,Vung Tau,Vung Tau City,8,179,166,13,1
2022-01-08,Vung Tau,Vung Tau City,9,202,186,16,1
2022-01-08,Vung Tau,Vung Tau City,10,248,229,19,0
2022-01-08,Vung Tau,Vung Tau City,11,334,310,24,1
2022-01-08,Vung Tau,Vung Tau City,12,334,313,21,3
2022-01-08,Vung Tau,Vung Tau City,13,219,203,16,1
2022-01-08,Vung Tau,Vung Tau City,14,242,211,31,11
2022-01-08,Vung Tau,Vung Tau City,15,212,191,21,3
2022-01-08,Vung Tau,Vung Tau City,16,233,220,13,1
2022-01-08,Vung Tau,Vung Tau City,17,313,283,30,2
2022-01-08,Vung Tau,Vung Tau City,18,343,303,40,9
2022-01-08,Vung Tau,Vung Tau City,19,283,251,32,1
2022-01-08,Vung Tau,Vung Tau City,20,204,176,28,2
2022-01-08,Vung Tau,Vung Tau City,21,118,79,39,15
2022-01-08,Vung Tau,Vung Tau City,22,1,1,0,0
2022-01-08,Vung Tau,Vung Tau City,23,2,1,1,0
2022-01-09,Binh Duong,Ben Cat,13,1,1,0,0
2022-01-09,Binh Duong,Di An,7,3,1,2,2
2022-01-09,Binh Duong,Di An,8,7,1,6,5
2022-01-09,Binh Duong,Di An,9,20,8,12,10
2022-01-09,Binh Duong,Di An,10,18,8,10,7
2022-01-09,Binh Duong,Di An,11,30,10,20,15
2022-01-09,Binh Duong,Di An,12,21,10,11,9
2022-01-09,Binh Duong,Di An,13,19,10,9,8
2022-01-09,Binh Duong,Di An,14,20,11,9,7
2022-01-09,Binh Duong,Di An,15,26,15,11,8
2022-01-09,Binh Duong,Di An,16,13,9,4,3
2022-01-09,Binh Duong,Di An,17,7,6,1,0
2022-01-09,Binh Duong,Di An,18,16,8,8,6
2022-01-09,Binh Duong,Di An,19,16,8,8,7
2022-01-09,Binh Duong,Di An,20,9,3,6,3
2022-01-09,Binh Duong,Di An,21,10,4,6,2
2022-01-09,Binh Duong,Tan Uyen,13,1,0,1,0
2022-01-09,Binh Duong,Tan Uyen,14,3,2,1,1
2022-01-09,Binh Duong,Tan Uyen,16,1,1,0,0
2022-01-09,Binh Duong,Tan Uyen,17,1,0,1,0
2022-01-09,Binh Duong,Tan Uyen,18,1,1,0,0
2022-01-09,Binh Duong,Tan Uyen,19,1,1,0,0
2022-01-09,Binh Duong,Thu Dau Mot Town,1,2,0,2,0
2022-01-09,Binh Duong,Thu Dau Mot Town,5,1,0,1,0
2022-01-09,Binh Duong,Thu Dau Mot Town,6,35,25,10,4
2022-01-09,Binh Duong,Thu Dau Mot Town,7,128,115,13,1
2022-01-09,Binh Duong,Thu Dau Mot Town,8,195,187,8,1
2022-01-09,Binh Duong,Thu Dau Mot Town,9,263,250,13,0
2022-01-09,Binh Duong,Thu Dau Mot Town,10,339,322,17,2
2022-01-09,Binh Duong,Thu Dau Mot Town,11,544,514,30,3
2022-01-09,Binh Duong,Thu Dau Mot Town,12,516,489,27,10
2022-01-09,Binh Duong,Thu Dau Mot Town,13,356,343,13,1
2022-01-09,Binh Duong,Thu Dau Mot Town,14,319,308,11,2
2022-01-09,Binh Duong,Thu Dau Mot Town,15,277,265,12,1
2022-01-09,Binh Duong,Thu Dau Mot Town,16,253,232,21,3
2022-01-09,Binh Duong,Thu Dau Mot Town,17,333,316,17,3
2022-01-09,Binh Duong,Thu Dau Mot Town,18,347,328,19,9
2022-01-09,Binh Duong,Thu Dau Mot Town,19,313,289,24,3
2022-01-09,Binh Duong,Thu Dau Mot Town,20,197,175,22,1
2022-01-09,Binh Duong,Thu Dau Mot Town,21,105,90,15,2
2022-01-09,Binh Duong,Thu Dau Mot Town,22,4,1,3,2
2022-01-09,Binh Duong,Thuan An,6,1,1,0,0
2022-01-09,Binh Duong,Thuan An,7,6,2,4,1
2022-01-09,Binh Duong,Thuan An,8,19,6,13,11
2022-01-09,Binh Duong,Thuan An,9,28,20,8,4
2022-01-09,Binh Duong,Thuan An,10,38,26,12,7
2022-01-09,Binh Duong,Thuan An,11,65,33,32,27
2022-01-09,Binh Duong,Thuan An,12,79,44,35,28
2022-01-09,Binh Duong,Thuan An,13,53,32,21,16
2022-01-09,Binh Duong,Thuan An,14,47,33,14,9
2022-01-09,Binh Duong,Thuan An,15,32,21,11,9
2022-01-09,Binh Duong,Thuan An,16,28,22,6,5
2022-01-09,Binh Duong,Thuan An,17,30,21,9,8
2022-01-09,Binh Duong,Thuan An,18,29,20,9,8
2022-01-09,Binh Duong,Thuan An,19,45,20,25,19
2022-01-09,Binh Duong,Thuan An,20,24,11,13,11
2022-01-09,Binh Duong,Thuan An,21,10,2,8,5
2022-01-09,Can Tho City,Binh Thuy District,6,1,0,1,0
2022-01-09,Can Tho City,Binh Thuy District,7,5,4,1,0
2022-01-09,Can Tho City,Binh Thuy District,8,4,4,0,0
2022-01-09,Can Tho City,Binh Thuy District,9,4,4,0,0
2022-01-09,Can Tho City,Binh Thuy District,10,10,10,0,0
2022-01-09,Can Tho City,Binh Thuy District,11,16,13,3,0
2022-01-09,Can Tho City,Binh Thuy District,12,13,12,1,0
2022-01-09,Can Tho City,Binh Thuy District,13,4,4,0,0
2022-01-09,Can Tho City,Binh Thuy District,14,9,9,0,0
2022-01-09,Can Tho City,Binh Thuy District,15,8,8,0,0
2022-01-09,Can Tho City,Binh Thuy District,16,10,10,0,0
2022-01-09,Can Tho City,Binh Thuy District,17,9,9,0,0
2022-01-09,Can Tho City,Binh Thuy District,18,9,9,0,0
2022-01-09,Can Tho City,Binh Thuy District,19,7,7,0,0
2022-01-09,Can Tho City,Binh Thuy District,20,5,4,1,0
2022-01-09,Can Tho City,Binh Thuy District,21,1,1,0,0
2022-01-09,Can Tho City,Cai Rang District,6,1,1,0,0
2022-01-09,Can Tho City,Cai Rang District,7,4,3,1,0
2022-01-09,Can Tho City,Cai Rang District,8,5,3,2,2
2022-01-09,Can Tho City,Cai Rang District,9,4,4,0,0
2022-01-09,Can Tho City,Cai Rang District,10,7,4,3,0
2022-01-09,Can Tho City,Cai Rang District,11,7,7,0,0
2022-01-09,Can Tho City,Cai Rang District,12,12,9,3,2
2022-01-09,Can Tho City,Cai Rang District,13,10,10,0,0
2022-01-09,Can Tho City,Cai Rang District,14,11,8,3,3
2022-01-09,Can Tho City,Cai Rang District,15,8,7,1,0
2022-01-09,Can Tho City,Cai Rang District,16,9,9,0,0
2022-01-09,Can Tho City,Cai Rang District,17,17,14,3,0
2022-01-09,Can Tho City,Cai Rang District,18,8,7,1,0
2022-01-09,Can Tho City,Cai Rang District,19,10,8,2,0
2022-01-09,Can Tho City,Cai Rang District,20,5,4,1,0
2022-01-09,Can Tho City,Cai Rang District,21,5,3,2,2
2022-01-09,Can Tho City,Ninh Kieu District,0,3,1,2,0
2022-01-09,Can Tho City,Ninh Kieu District,1,2,1,1,0
2022-01-09,Can Tho City,Ninh Kieu District,2,2,1,1,0
2022-01-09,Can Tho City,Ninh Kieu District,4,1,1,0,0
2022-01-09,Can Tho City,Ninh Kieu District,5,3,2,1,1
2022-01-09,Can Tho City,Ninh Kieu District,6,35,31,4,0
2022-01-09,Can Tho City,Ninh Kieu District,7,146,140,6,0
2022-01-09,Can Tho City,Ninh Kieu District,8,231,222,9,0
2022-01-09,Can Tho City,Ninh Kieu District,9,291,283,8,0
2022-01-09,Can Tho City,Ninh Kieu District,10,474,456,18,0
2022-01-09,Can Tho City,Ninh Kieu District,11,673,643,30,0
2022-01-09,Can Tho City,Ninh Kieu District,12,538,520,18,0
2022-01-09,Can Tho City,Ninh Kieu District,13,421,404,17,0
2022-01-09,Can Tho City,Ninh Kieu District,14,362,335,27,0
2022-01-09,Can Tho City,Ninh Kieu District,15,365,351,14,0
2022-01-09,Can Tho City,Ninh Kieu District,16,418,379,39,0
2022-01-09,Can Tho City,Ninh Kieu District,17,469,447,22,0
2022-01-09,Can Tho City,Ninh Kieu District,18,423,409,14,0
2022-01-09,Can Tho City,Ninh Kieu District,19,329,314,15,0
2022-01-09,Can Tho City,Ninh Kieu District,20,290,261,29,0
2022-01-09,Can Tho City,Ninh Kieu District,21,130,117,13,0
2022-01-09,Can Tho City,Ninh Kieu District,22,2,1,1,0
2022-01-09,Can Tho City,Ninh Kieu District,23,6,6,0,0
2022-01-09,Dong Nai,Bien Hoa City,1,1,1,0,0
2022-01-09,Dong Nai,Bien Hoa City,6,42,26,16,11
2022-01-09,Dong Nai,Bien Hoa City,7,166,141,25,13
2022-01-09,Dong Nai,Bien Hoa City,8,266,246,20,2
2022-01-09,Dong Nai,Bien Hoa City,9,456,417,39,10
2022-01-09,Dong Nai,Bien Hoa City,10,690,625,65,26
2022-01-09,Dong Nai,Bien Hoa City,11,1013,908,105,38
2022-01-09,Dong Nai,Bien Hoa City,12,955,885,70,23
2022-01-09,Dong Nai,Bien Hoa City,13,672,621,51,9
2022-01-09,Dong Nai,Bien Hoa City,14,543,505,38,3
2022-01-09,Dong Nai,Bien Hoa City,15,519,472,47,22
2022-01-09,Dong Nai,Bien Hoa City,16,495,458,37,6
2022-01-09,Dong Nai,Bien Hoa City,17,593,528,65,32
2022-01-09,Dong Nai,Bien Hoa City,18,785,609,176,108
2022-01-09,Dong Nai,Bien Hoa City,19,714,527,187,123
2022-01-09,Dong Nai,Bien Hoa City,20,468,341,127,69
2022-01-09,Dong Nai,Bien Hoa City,21,199,129,70,46
2022-01-09,Dong Nai,Bien Hoa City,22,3,0,3,0
2022-01-09,Dong Nai,Bien Hoa City,23,1,0,1,0
2022-01-09,Dong Nai,Long Khanh,11,1,0,1,1
2022-01-09,Dong Nai,Long Thanh,13,1,0,1,1
2022-01-09,Dong Nai,Long Thanh,14,2,0,2,2
2022-01-09,Dong Nai,Long Thanh,17,1,0,1,0
2022-01-09,Dong Nai,Long Thanh,18,4,0,4,2
2022-01-09,Dong Nai,Thong Nhat,9,2,2,0,0
2022-01-09,Dong Nai,Thong Nhat,10,3,3,0,0
2022-01-09,Dong Nai,Thong Nhat,11,1,1,0,0
2022-01-09,Dong Nai,Thong Nhat,12,2,2,0,0
2022-01-09,Dong Nai,Thong Nhat,14,2,2,0,0
2022-01-09,Dong Nai,Thong Nhat,15,1,1,0,0
2022-01-09,Dong Nai,Thong Nhat,16,1,1,0,0
2022-01-09,Dong Nai,Thong Nhat,17,1,1,0,0
2022-01-09,Dong Nai,Thong Nhat,18,3,3,0,0
2022-01-09,Dong Nai,Thong Nhat,20,1,1,0,0
2022-01-09,Dong Nai,Thong Nhat,21,2,2,0,0
2022-01-09,Dong Nai,Trang Bom,18,1,1,0,0
2022-01-09,Dong Nai,Trang Bom,20,1,0,1,1
2022-01-09,Dong Nai,Trang Bom,21,1,0,1,1
2022-01-09,Hai Phong City,An Duong,7,2,1,1,1
2022-01-09,Hai Phong City,An Duong,9,4,2,2,0
2022-01-09,Hai Phong City,An Duong,11,1,1,0,0
2022-01-09,Hai Phong City,An Duong,12,2,2,0,0
2022-01-09,Hai Phong City,An Duong,14,1,0,1,0
2022-01-09,Hai Phong City,An Duong,15,1,1,0,0
2022-01-09,Hai Phong City,An Duong,16,5,2,3,1
2022-01-09,Hai Phong City,An Duong,17,3,3,0,0
2022-01-09,Hai Phong City,An Duong,18,1,0,1,0
2022-01-09,Hai Phong City,Do Son District,17,1,0,1,1
2022-01-09,Hai Phong City,Hai An District,1,1,0,1,1
2022-01-09,Hai Phong City,Hai An District,7,8,3,5,2
2022-01-09,Hai Phong City,Hai An District,8,14,9,5,0
2022-01-09,Hai Phong City,Hai An District,9,8,4,4,2
2022-01-09,Hai Phong City,Hai An District,10,23,21,2,0
2022-01-09,Hai Phong City,Hai An District,11,43,34,9,2
2022-01-09,Hai Phong City,Hai An District,12,24,22,2,0
2022-01-09,Hai Phong City,Hai An District,13,15,13,2,0
2022-01-09,Hai Phong City,Hai An District,14,19,15,4,1
2022-01-09,Hai Phong City,Hai An District,15,21,21,0,0
2022-01-09,Hai Phong City,Hai An District,16,19,17,2,0
2022-01-09,Hai Phong City,Hai An District,17,36,29,7,2
2022-01-09,Hai Phong City,Hai An District,18,36,30,6,0
2022-01-09,Hai Phong City,Hai An District,19,15,13,2,0
2022-01-09,Hai Phong City,Hai An District,20,19,15,4,3
2022-01-09,Hai Phong City,Hai An District,21,12,8,4,2
2022-01-09,Hai Phong City,Hong Bang District,0,1,1,0,0
2022-01-09,Hai Phong City,Hong Bang District,4,1,0,1,1
2022-01-09,Hai Phong City,Hong Bang District,7,16,10,6,2
2022-01-09,Hai Phong City,Hong Bang District,8,27,25,2,2
2022-01-09,Hai Phong City,Hong Bang District,9,40,36,4,0
2022-01-09,Hai Phong City,Hong Bang District,10,69,64,5,1
2022-01-09,Hai Phong City,Hong Bang District,11,105,90,15,10
2022-01-09,Hai Phong City,Hong Bang District,12,93,81,12,5
2022-01-09,Hai Phong City,Hong Bang District,13,41,40,1,0
2022-01-09,Hai Phong City,Hong Bang District,14,25,21,4,0
2022-01-09,Hai Phong City,Hong Bang District,15,50,47,3,0
2022-01-09,Hai Phong City,Hong Bang District,16,52,46,6,1
2022-01-09,Hai Phong City,Hong Bang District,17,57,49,8,5
2022-01-09,Hai Phong City,Hong Bang District,18,88,79,9,6
2022-01-09,Hai Phong City,Hong Bang District,19,67,62,5,0
2022-01-09,Hai Phong City,Hong Bang District,20,46,46,0,0
2022-01-09,Hai Phong City,Hong Bang District,21,11,9,2,1
2022-01-09,Hai Phong City,Hong Bang District,22,1,0,1,0
2022-01-09,Hai Phong City,Kien An District,8,2,1,1,0
2022-01-09,Hai Phong City,Kien An District,9,8,2,6,5
2022-01-09,Hai Phong City,Kien An District,10,8,4,4,0
2022-01-09,Hai Phong City,Kien An District,11,23,12,11,7
2022-01-09,Hai Phong City,Kien An District,12,11,5,6,4
2022-01-09,Hai Phong City,Kien An District,13,7,7,0,0
2022-01-09,Hai Phong City,Kien An District,14,9,8,1,1
2022-01-09,Hai Phong City,Kien An District,15,4,4,0,0
2022-01-09,Hai Phong City,Kien An District,16,7,6,1,0
2022-01-09,Hai Phong City,Kien An District,17,8,4,4,1
2022-01-09,Hai Phong City,Kien An District,18,7,7,0,0
2022-01-09,Hai Phong City,Kien An District,19,7,4,3,1
2022-01-09,Hai Phong City,Kien An District,20,10,10,0,0
2022-01-09,Hai Phong City,Kien An District,21,4,3,1,1
2022-01-09,Hai Phong City,Le Chan District,0,1,1,0,0
2022-01-09,Hai Phong City,Le Chan District,1,1,0,1,0
2022-01-09,Hai Phong City,Le Chan District,2,1,1,0,0
2022-01-09,Hai Phong City,Le Chan District,4,1,1,0,0
2022-01-09,Hai Phong City,Le Chan District,6,2,1,1,1
2022-01-09,Hai Phong City,Le Chan District,7,38,30,8,2
2022-01-09,Hai Phong City,Le Chan District,8,90,71,19,5
2022-01-09,Hai Phong City,Le Chan District,9,119,107,12,0
2022-01-09,Hai Phong City,Le Chan District,10,195,174,21,2
2022-01-09,Hai Phong City,Le Chan District,11,450,373,77,37
2022-01-09,Hai Phong City,Le Chan District,12,270,236,34,8
2022-01-09,Hai Phong City,Le Chan District,13,156,143,13,0
2022-01-09,Hai Phong City,Le Chan District,14,141,126,15,1
2022-01-09,Hai Phong City,Le Chan District,15,188,172,16,0
2022-01-09,Hai Phong City,Le Chan District,16,189,171,18,0
2022-01-09,Hai Phong City,Le Chan District,17,286,241,45,12
2022-01-09,Hai Phong City,Le Chan District,18,302,259,43,11
2022-01-09,Hai Phong City,Le Chan District,19,204,183,21,4
2022-01-09,Hai Phong City,Le Chan District,20,132,116,16,3
2022-01-09,Hai Phong City,Le Chan District,21,69,53,16,3
2022-01-09,Hai Phong City,Le Chan District,22,2,0,2,1
2022-01-09,Hai Phong City,Le Chan District,23,1,1,0,0
2022-01-09,Hai Phong City,Ngo Quyen District,0,4,1,3,2
2022-01-09,Hai Phong City,Ngo Quyen District,1,2,1,1,1
2022-01-09,Hai Phong City,Ngo Quyen District,5,1,1,0,0
2022-01-09,Hai Phong City,Ngo Quyen District,6,5,2,3,2
2022-01-09,Hai Phong City,Ngo Quyen District,7,33,20,13,10
2022-01-09,Hai Phong City,Ngo Quyen District,8,75,65,10,0
2022-01-09,Hai Phong City,Ngo Quyen District,9,99,89,10,1
2022-01-09,Hai Phong City,Ngo Quyen District,10,160,147,13,2
2022-01-09,Hai Phong City,Ngo Quyen District,11,283,239,44,20
2022-01-09,Hai Phong City,Ngo Quyen District,12,229,197,32,7
2022-01-09,Hai Phong City,Ngo Quyen District,13,118,110,8,0
2022-01-09,Hai Phong City,Ngo Quyen District,14,108,100,8,1
2022-01-09,Hai Phong City,Ngo Quyen District,15,136,122,14,2
2022-01-09,Hai Phong City,Ngo Quyen District,16,170,158,12,1
2022-01-09,Hai Phong City,Ngo Quyen District,17,205,181,24,10
2022-01-09,Hai Phong City,Ngo Quyen District,18,228,200,28,10
2022-01-09,Hai Phong City,Ngo Quyen District,19,199,165,34,3
2022-01-09,Hai Phong City,Ngo Quyen District,20,163,147,16,0
2022-01-09,Hai Phong City,Ngo Quyen District,21,68,50,18,3
2022-01-09,Hai Phong City,Ngo Quyen District,22,1,0,1,0
2022-01-09,Hai Phong City,Thuy Nguyen,8,1,0,1,1
2022-01-09,Hai Phong City,Thuy Nguyen,9,1,0,1,1
2022-01-09,Hai Phong City,Thuy Nguyen,11,3,1,2,2
2022-01-09,Hai Phong City,Thuy Nguyen,14,1,0,1,1
2022-01-09,Hai Phong City,Thuy Nguyen,16,1,0,1,1
2022-01-09,Hai Phong City,Thuy Nguyen,17,1,0,1,1
2022-01-09,Hai Phong City,Thuy Nguyen,19,1,0,1,1
2022-01-09,Hai Phong City,Thuy Nguyen,20,4,0,4,4
2022-01-09,Hai Phong City,Thuy Nguyen,21,1,0,1,1
2022-01-09,Hue City,Hue City,0,3,2,1,0
2022-01-09,Hue City,Hue City,1,2,1,1,0
2022-01-09,Hue City,Hue City,5,3,2,1,1
2022-01-09,Hue City,Hue City,6,51,44,7,3
2022-01-09,Hue City,Hue City,7,265,247,18,0
2022-01-09,Hue City,Hue City,8,388,355,33,0
2022-01-09,Hue City,Hue City,9,322,301,21,0
2022-01-09,Hue City,Hue City,10,377,359,18,0
2022-01-09,Hue City,Hue City,11,712,675,37,3
2022-01-09,Hue City,Hue City,12,530,496,34,0
2022-01-09,Hue City,Hue City,13,338,311,27,1
2022-01-09,Hue City,Hue City,14,374,348,26,4
2022-01-09,Hue City,Hue City,15,412,387,25,2
2022-01-09,Hue City,Hue City,16,451,423,28,5
2022-01-09,Hue City,Hue City,17,592,551,41,1
2022-01-09,Hue City,Hue City,18,624,569,55,2
2022-01-09,Hue City,Hue City,19,525,477,48,3
2022-01-09,Hue City,Hue City,20,330,303,27,3
2022-01-09,Hue City,Hue City,21,209,167,42,12
2022-01-09,Hue City,Hue City,22,2,1,1,0
2022-01-09,Hue City,Hue City,23,1,1,0,0
2022-01-09,Hue City,Huong Thuy,11,1,1,0,0
2022-01-09,Hue City,Huong Thuy,18,1,1,0,0
2022-01-09,Hue City,Huong Thuy,20,2,2,0,0
2022-01-09,Hue City,Phu Vang,7,1,1,0,0
2022-01-09,Hue City,Phu Vang,8,4,3,1,0
2022-01-09,Hue City,Phu Vang,9,2,2,0,0
2022-01-09,Hue City,Phu Vang,10,1,1,0,0
2022-01-09,Hue City,Phu Vang,11,1,1,0,0
2022-01-09,Hue City,Phu Vang,12,2,2,0,0
2022-01-09,Hue City,Phu Vang,13,1,1,0,0
2022-01-09,Hue City,Phu Vang,14,1,1,0,0
2022-01-09,Hue City,Phu Vang,18,2,1,1,0
2022-01-09,Hue City,Phu Vang,19,2,2,0,0
2022-01-09,Hue City,Phu Vang,20,3,1,2,0
2022-01-09,Hue City,Phu Vang,21,1,0,1,1
2022-01-09,Vung Tau,Ba Ria City,7,1,0,1,1
2022-01-09,Vung Tau,Ba Ria City,8,9,1,8,5
2022-01-09,Vung Tau,Ba Ria City,9,3,2,1,1
2022-01-09,Vung Tau,Ba Ria City,10,5,3,2,2
2022-01-09,Vung Tau,Ba Ria City,11,18,2,16,13
2022-01-09,Vung Tau,Ba Ria City,12,13,2,11,8
2022-01-09,Vung Tau,Ba Ria City,13,6,2,4,3
2022-01-09,Vung Tau,Ba Ria City,14,7,4,3,1
2022-01-09,Vung Tau,Ba Ria City,15,8,4,4,4
2022-01-09,Vung Tau,Ba Ria City,16,10,3,7,7
2022-01-09,Vung Tau,Ba Ria City,17,11,5,6,4
2022-01-09,Vung Tau,Ba Ria City,18,7,2,5,5
2022-01-09,Vung Tau,Ba Ria City,19,4,3,1,1
2022-01-09,Vung Tau,Ba Ria City,20,5,1,4,4
2022-01-09,Vung Tau,Ba Ria City,21,2,0,2,2
2022-01-09,Vung Tau,Tan Thanh,12,1,0,1,1
2022-01-09,Vung Tau,Vung Tau City,0,3,1,2,0
2022-01-09,Vung Tau,Vung Tau City,6,25,23,2,0
2022-01-09,Vung Tau,Vung Tau City,7,140,125,15,2
2022-01-09,Vung Tau,Vung Tau City,8,207,194,13,0
2022-01-09,Vung Tau,Vung Tau City,9,237,216,21,0
2022-01-09,Vung Tau,Vung Tau City,10,253,231,22,1
2022-01-09,Vung Tau,Vung Tau City,11,364,346,18,0
2022-01-09,Vung Tau,Vung Tau City,12,353,318,35,0
2022-01-09,Vung Tau,Vung Tau City,13,225,211,14,0
2022-01-09,Vung Tau,Vung Tau City,14,191,173,18,0
2022-01-09,Vung Tau,Vung Tau City,15,207,189,18,1
2022-01-09,Vung Tau,Vung Tau City,16,220,207,13,0
2022-01-09,Vung Tau,Vung Tau City,17,293,274,19,5
2022-01-09,Vung Tau,Vung Tau City,18,342,301,41,10
2022-01-09,Vung Tau,Vung Tau City,19,275,243,32,4
2022-01-09,Vung Tau,Vung Tau City,20,161,138,23,2
2022-01-09,Vung Tau,Vung Tau City,21,86,70,16,4
2022-01-09,Vung Tau,Vung Tau City,22,2,1,1,0
2022-01-09,Vung Tau,Vung Tau City,23,1,1,0,0
2022-01-10,Binh Duong,Ben Cat,9,1,1,0,0
2022-01-10,Binh Duong,Ben Cat,12,1,0,1,1
2022-01-10,Binh Duong,Ben Cat,13,1,0,1,0
2022-01-10,Binh Duong,Di An,7,4,1,3,3
2022-01-10,Binh Duong,Di An,8,8,4,4,3
2022-01-10,Binh Duong,Di An,9,10,5,5,3
2022-01-10,Binh Duong,Di An,10,19,10,9,6
2022-01-10,Binh Duong,Di An,11,20,8,12,7
2022-01-10,Binh Duong,Di An,12,25,19,6,4
2022-01-10,Binh Duong,Di An,13,18,11,7,5
2022-01-10,Binh Duong,Di An,14,18,13,5,3
2022-01-10,Binh Duong,Di An,15,16,13,3,3
2022-01-10,Binh Duong,Di An,16,12,9,3,3
2022-01-10,Binh Duong,Di An,17,19,10,9,2
2022-01-10,Binh Duong,Di An,18,23,16,7,6
2022-01-10,Binh Duong,Di An,19,12,6,6,5
2022-01-10,Binh Duong,Di An,20,6,1,5,3
2022-01-10,Binh Duong,Di An,21,6,0,6,4
2022-01-10,Binh Duong,Tan Uyen,8,1,0,1,1
2022-01-10,Binh Duong,Tan Uyen,10,1,1,0,0
2022-01-10,Binh Duong,Tan Uyen,11,3,1,2,2
2022-01-10,Binh Duong,Tan Uyen,12,2,0,2,1
2022-01-10,Binh Duong,Tan Uyen,13,4,1,3,2
2022-01-10,Binh Duong,Tan Uyen,14,3,2,1,1
2022-01-10,Binh Duong,Tan Uyen,15,2,0,2,2
2022-01-10,Binh Duong,Tan Uyen,16,1,1,0,0
2022-01-10,Binh Duong,Tan Uyen,18,1,0,1,1
2022-01-10,Binh Duong,Tan Uyen,19,1,0,1,0
2022-01-10,Binh Duong,Tan Uyen,20,1,0,1,1
2022-01-10,Binh Duong,Tan Uyen,21,1,0,1,1
2022-01-10,Binh Duong,Thu Dau Mot Town,0,1,1,0,0
2022-01-10,Binh Duong,Thu Dau Mot Town,2,1,1,0,0
2022-01-10,Binh Duong,Thu Dau Mot Town,4,1,1,0,0
2022-01-10,Binh Duong,Thu Dau Mot Town,5,2,1,1,1
2022-01-10,Binh Duong,Thu Dau Mot Town,6,27,18,9,7
2022-01-10,Binh Duong,Thu Dau Mot Town,7,100,92,8,3
2022-01-10,Binh Duong,Thu Dau Mot Town,8,189,166,23,5
2022-01-10,Binh Duong,Thu Dau Mot Town,9,231,211,20,3
2022-01-10,Binh Duong,Thu Dau Mot Town,10,307,291,16,2
2022-01-10,Binh Duong,Thu Dau Mot Town,11,594,566,28,2
2022-01-10,Binh Duong,Thu Dau Mot Town,12,424,408,16,1
2022-01-10,Binh Duong,Thu Dau Mot Town,13,306,290,16,4
2022-01-10,Binh Duong,Thu Dau Mot Town,14,269,254,15,2
2022-01-10,Binh Duong,Thu Dau Mot Town,15,246,232,14,4
2022-01-10,Binh Duong,Thu Dau Mot Town,16,243,230,13,5
2022-01-10,Binh Duong,Thu Dau Mot Town,17,301,289,12,0
2022-01-10,Binh Duong,Thu Dau Mot Town,18,304,288,16,1
2022-01-10,Binh Duong,Thu Dau Mot Town,19,314,296,18,4
2022-01-10,Binh Duong,Thu Dau Mot Town,20,216,206,10,3
2022-01-10,Binh Duong,Thu Dau Mot Town,21,78,64,14,2
2022-01-10,Binh Duong,Thu Dau Mot Town,22,5,2,3,1
2022-01-10,Binh Duong,Thu Dau Mot Town,23,2,2,0,0
2022-01-10,Binh Duong,Thuan An,7,3,2,1,1
2022-01-10,Binh Duong,Thuan An,8,4,3,1,1
2022-01-10,Binh Duong,Thuan An,9,22,15,7,6
2022-01-10,Binh Duong,Thuan An,10,52,24,28,26
2022-01-10,Binh Duong,Thuan An,11,79,42,37,31
2022-01-10,Binh Duong,Thuan An,12,66,30,36,28
2022-01-10,Binh Duong,Thuan An,13,65,36,29,19
2022-01-10,Binh Duong,Thuan An,14,51,27,24,20
2022-01-10,Binh Duong,Thuan An,15,31,24,7,6
2022-01-10,Binh Duong,Thuan An,16,23,16,7,5
2022-01-10,Binh Duong,Thuan An,17,34,18,16,12
2022-01-10,Binh Duong,Thuan An,18,44,23,21,14
2022-01-10,Binh Duong,Thuan An,19,35,25,10,7
2022-01-10,Binh Duong,Thuan An,20,29,10,19,13
2022-01-10,Binh Duong,Thuan An,21,13,1,12,7
2022-01-10,Binh Duong,Thuan An,23,1,0,1,1
2022-01-10,Can Tho City,Binh Thuy District,0,1,1,0,0
2022-01-10,Can Tho City,Binh Thuy District,7,4,3,1,0
2022-01-10,Can Tho City,Binh Thuy District,8,4,3,1,0
2022-01-10,Can Tho City,Binh Thuy District,9,7,6,1,0
2022-01-10,Can Tho City,Binh Thuy District,10,6,5,1,0
2022-01-10,Can Tho City,Binh Thuy District,11,14,14,0,0
2022-01-10,Can Tho City,Binh Thuy District,12,7,7,0,0
2022-01-10,Can Tho City,Binh Thuy District,13,4,3,1,0
2022-01-10,Can Tho City,Binh Thuy District,14,8,8,0,0
2022-01-10,Can Tho City,Binh Thuy District,15,9,9,0,0
2022-01-10,Can Tho City,Binh Thuy District,16,10,8,2,0
2022-01-10,Can Tho City,Binh Thuy District,17,7,7,0,0
2022-01-10,Can Tho City,Binh Thuy District,18,13,12,1,0
2022-01-10,Can Tho City,Binh Thuy District,19,8,7,1,0
2022-01-10,Can Tho City,Binh Thuy District,20,11,8,3,1
2022-01-10,Can Tho City,Binh Thuy District,21,2,1,1,0
2022-01-10,Can Tho City,Cai Rang District,6,2,2,0,0
2022-01-10,Can Tho City,Cai Rang District,7,5,5,0,0
2022-01-10,Can Tho City,Cai Rang District,8,7,7,0,0
2022-01-10,Can Tho City,Cai Rang District,9,4,3,1,0
2022-01-10,Can Tho City,Cai Rang District,10,3,3,0,0
2022-01-10,Can Tho City,Cai Rang District,11,16,14,2,0
2022-01-10,Can Tho City,Cai Rang District,12,7,7,0,0
2022-01-10,Can Tho City,Cai Rang District,13,8,7,1,0
2022-01-10,Can Tho City,Cai Rang District,14,3,3,0,0
2022-01-10,Can Tho City,Cai Rang District,15,7,6,1,1
2022-01-10,Can Tho City,Cai Rang District,16,12,11,1,1
2022-01-10,Can Tho City,Cai Rang District,17,5,5,0,0
2022-01-10,Can Tho City,Cai Rang District,18,7,7,0,0
2022-01-10,Can Tho City,Cai Rang District,19,13,11,2,0
2022-01-10,Can Tho City,Cai Rang District,20,9,8,1,0
2022-01-10,Can Tho City,Cai Rang District,21,2,2,0,0
2022-01-10,Can Tho City,Cai Rang District,22,1,0,1,0
2022-01-10,Can Tho City,Ninh Kieu District,0,6,3,3,0
2022-01-10,Can Tho City,Ninh Kieu District,1,2,2,0,0
2022-01-10,Can Tho City,Ninh Kieu District,2,3,1,2,1
2022-01-10,Can Tho City,Ninh Kieu District,3,5,1,4,0
2022-01-10,Can Tho City,Ninh Kieu District,4,1,1,0,0
2022-01-10,Can Tho City,Ninh Kieu District,5,1,0,1,0
2022-01-10,Can Tho City,Ninh Kieu District,6,46,44,2,0
2022-01-10,Can Tho City,Ninh Kieu District,7,175,166,9,0
2022-01-10,Can Tho City,Ninh Kieu District,8,258,251,7,0
2022-01-10,Can Tho City,Ninh Kieu District,9,273,260,13,0
2022-01-10,Can Tho City,Ninh Kieu District,10,449,427,22,0
2022-01-10,Can Tho City,Ninh Kieu District,11,815,780,35,0
2022-01-10,Can Tho City,Ninh Kieu District,12,521,504,17,1
2022-01-10,Can Tho City,Ninh Kieu District,13,375,361,14,0
2022-01-10,Can Tho City,Ninh Kieu District,14,363,349,14,0
2022-01-10,Can Tho City,Ninh Kieu District,15,304,295,9,0
2022-01-10,Can Tho City,Ninh Kieu District,16,344,333,11,0
2022-01-10,Can Tho City,Ninh Kieu District,17,411,379,32,0
2022-01-10,Can Tho City,Ninh Kieu District,18,421,386,35,0
2022-01-10,Can Tho City,Ninh Kieu District,19,399,380,19,0
2022-01-10,Can Tho City,Ninh Kieu District,20,255,246,9,0
2022-01-10,Can Tho City,Ninh Kieu District,21,149,129,20,0
2022-01-10,Can Tho City,Ninh Kieu District,22,4,3,1,0
2022-01-10,Can Tho City,Ninh Kieu District,23,2,2,0,0
2022-01-10,Dong Nai,Bien Hoa City,0,3,1,2,0
2022-01-10,Dong Nai,Bien Hoa City,3,1,1,0,0
2022-01-10,Dong Nai,Bien Hoa City,4,1,1,0,0
2022-01-10,Dong Nai,Bien Hoa City,6,33,28,5,1
2022-01-10,Dong Nai,Bien Hoa City,7,178,143,35,8
2022-01-10,Dong Nai,Bien Hoa City,8,251,233,18,4
2022-01-10,Dong Nai,Bien Hoa City,9,368,337,31,4
2022-01-10,Dong Nai,Bien Hoa City,10,590,550,40,4
2022-01-10,Dong Nai,Bien Hoa City,11,1007,941,66,16
2022-01-10,Dong Nai,Bien Hoa City,12,754,704,50,7
2022-01-10,Dong Nai,Bien Hoa City,13,721,678,43,7
2022-01-10,Dong Nai,Bien Hoa City,14,574,528,46,13
2022-01-10,Dong Nai,Bien Hoa City,15,507,467,40,8
2022-01-10,Dong Nai,Bien Hoa City,16,447,416,31,7
2022-01-10,Dong Nai,Bien Hoa City,17,516,480,36,3
2022-01-10,Dong Nai,Bien Hoa City,18,610,559,51,3
2022-01-10,Dong Nai,Bien Hoa City,19,580,524,56,7
2022-01-10,Dong Nai,Bien Hoa City,20,476,384,92,39
2022-01-10,Dong Nai,Bien Hoa City,21,194,121,73,34
2022-01-10,Dong Nai,Bien Hoa City,22,4,2,2,0
2022-01-10,Dong Nai,Bien Hoa City,23,1,1,0,0
2022-01-10,Dong Nai,Long Thanh,11,1,0,1,1
2022-01-10,Dong Nai,Long Thanh,12,2,0,2,2
2022-01-10,Dong Nai,Long Thanh,13,4,0,4,4
2022-01-10,Dong Nai,Long Thanh,20,1,0,1,1
2022-01-10,Dong Nai,Thong Nhat,9,1,1,0,0
2022-01-10,Dong Nai,Thong Nhat,12,1,1,0,0
2022-01-10,Dong Nai,Thong Nhat,13,2,2,0,0
2022-01-10,Dong Nai,Thong Nhat,14,2,2,0,0
2022-01-10,Dong Nai,Thong Nhat,15,1,1,0,0
2022-01-10,Dong Nai,Thong Nhat,17,1,1,0,0
2022-01-10,Dong Nai,Thong Nhat,18,1,1,0,0
2022-01-10,Dong Nai,Thong Nhat,19,1,1,0,0
2022-01-10,Dong Nai,Trang Bom,10,1,0,1,1
2022-01-10,Dong Nai,Trang Bom,11,1,0,1,1
2022-01-10,Dong Nai,Trang Bom,13,2,1,1,1
2022-01-10,Hai Phong City,An Duong,6,1,0,1,0
2022-01-10,Hai Phong City,An Duong,7,3,0,3,2
2022-01-10,Hai Phong City,An Duong,8,3,2,1,1
2022-01-10,Hai Phong City,An Duong,10,5,4,1,0
2022-01-10,Hai Phong City,An Duong,12,2,1,1,1
2022-01-10,Hai Phong City,An Duong,13,2,1,1,1
2022-01-10,Hai Phong City,An Duong,14,2,0,2,0
2022-01-10,Hai Phong City,An Duong,15,4,3,1,1
2022-01-10,Hai Phong City,An Duong,17,5,4,1,0
2022-01-10,Hai Phong City,An Duong,18,2,2,0,0
2022-01-10,Hai Phong City,An Duong,19,4,0,4,1
2022-01-10,Hai Phong City,Duong Kinh District,16,1,0,1,1
2022-01-10,Hai Phong City,Hai An District,7,11,5,6,6
2022-01-10,Hai Phong City,Hai An District,8,7,7,0,0
2022-01-10,Hai Phong City,Hai An District,9,11,8,3,0
2022-01-10,Hai Phong City,Hai An District,10,25,21,4,0
2022-01-10,Hai Phong City,Hai An District,11,51,47,4,0
2022-01-10,Hai Phong City,Hai An District,12,35,34,1,0
2022-01-10,Hai Phong City,Hai An District,13,8,6,2,0
2022-01-10,Hai Phong City,Hai An District,14,15,12,3,0
2022-01-10,Hai Phong City,Hai An District,15,13,10,3,0
2022-01-10,Hai Phong City,Hai An District,16,22,20,2,0
2022-01-10,Hai Phong City,Hai An District,17,21,19,2,1
2022-01-10,Hai Phong City,Hai An District,18,25,19,6,0
2022-01-10,Hai Phong City,Hai An District,19,26,22,4,0
2022-01-10,Hai Phong City,Hai An District,20,12,11,1,1
2022-01-10,Hai Phong City,Hai An District,21,10,8,2,1
2022-01-10,Hai Phong City,Hong Bang District,2,1,0,1,0
2022-01-10,Hai Phong City,Hong Bang District,5,1,0,1,0
2022-01-10,Hai Phong City,Hong Bang District,7,15,12,3,1
2022-01-10,Hai Phong City,Hong Bang District,8,55,31,24,22
2022-01-10,Hai Phong City,Hong Bang District,9,35,30,5,1
2022-01-10,Hai Phong City,Hong Bang District,10,51,50,1,0
2022-01-10,Hai Phong City,Hong Bang District,11,130,108,22,12
2022-01-10,Hai Phong City,Hong Bang District,12,79,71,8,2
2022-01-10,Hai Phong City,Hong Bang District,13,37,34,3,0
2022-01-10,Hai Phong City,Hong Bang District,14,44,40,4,1
2022-01-10,Hai Phong City,Hong Bang District,15,51,47,4,0
2022-01-10,Hai Phong City,Hong Bang District,16,27,25,2,0
2022-01-10,Hai Phong City,Hong Bang District,17,43,38,5,0
2022-01-10,Hai Phong City,Hong Bang District,18,78,71,7,0
2022-01-10,Hai Phong City,Hong Bang District,19,61,59,2,0
2022-01-10,Hai Phong City,Hong Bang District,20,63,54,9,3
2022-01-10,Hai Phong City,Hong Bang District,21,28,14,14,5
2022-01-10,Hai Phong City,Hong Bang District,23,1,0,1,1
2022-01-10,Hai Phong City,Kien An District,7,2,1,1,1
2022-01-10,Hai Phong City,Kien An District,8,5,0,5,5
2022-01-10,Hai Phong City,Kien An District,9,4,0,4,3
2022-01-10,Hai Phong City,Kien An District,10,5,4,1,1
2022-01-10,Hai Phong City,Kien An District,11,14,11,3,1
2022-01-10,Hai Phong City,Kien An District,12,4,2,2,1
2022-01-10,Hai Phong City,Kien An District,13,4,2,2,1
2022-01-10,Hai Phong City,Kien An District,14,3,2,1,0
2022-01-10,Hai Phong City,Kien An District,15,12,5,7,5
2022-01-10,Hai Phong City,Kien An District,16,12,6,6,6
2022-01-10,Hai Phong City,Kien An District,17,1,1,0,0
2022-01-10,Hai Phong City,Kien An District,18,7,5,2,1
2022-01-10,Hai Phong City,Kien An District,19,17,9,8,6
2022-01-10,Hai Phong City,Kien An District,20,2,2,0,0
2022-01-10,Hai Phong City,Kien An District,21,3,0,3,3
2022-01-10,Hai Phong City,Le Chan District,0,2,1,1,1
2022-01-10,Hai Phong City,Le Chan District,5,1,0,1,0
2022-01-10,Hai Phong City,Le Chan District,6,5,3,2,0
2022-01-10,Hai Phong City,Le Chan District,7,44,27,17,11
2022-01-10,Hai Phong City,Le Chan District,8,88,68,20,11
2022-01-10,Hai Phong City,Le Chan District,9,105,88,17,5
2022-01-10,Hai Phong City,Le Chan District,10,125,117,8,0
2022-01-10,Hai Phong City,Le Chan District,11,320,281,39,17
2022-01-10,Hai Phong City,Le Chan District,12,230,202,28,2
2022-01-10,Hai Phong City,Le Chan District,13,111,99,12,0
2022-01-10,Hai Phong City,Le Chan District,14,130,119,11,0
2022-01-10,Hai Phong City,Le Chan District,15,172,154,18,1
2022-01-10,Hai Phong City,Le Chan District,16,159,144,15,0
2022-01-10,Hai Phong City,Le Chan District,17,188,163,25,1
2022-01-10,Hai Phong City,Le Chan District,18,252,219,33,4
2022-01-10,Hai Phong City,Le Chan District,19,210,183,27,1
2022-01-10,Hai Phong City,Le Chan District,20,167,147,20,1
2022-01-10,Hai Phong City,Le Chan District,21,76,50,26,1
2022-01-10,Hai Phong City,Le Chan District,22,3,1,2,0
2022-01-10,Hai Phong City,Le Chan District,23,2,1,1,0
2022-01-10,Hai Phong City,Ngo Quyen District,0,1,1,0,0
2022-01-10,Hai Phong City,Ngo Quyen District,6,3,1,2,1
2022-01-10,Hai Phong City,Ngo Quyen District,7,44,28,16,14
2022-01-10,Hai Phong City,Ngo Quyen District,8,137,88,49,32
2022-01-10,Hai Phong City,Ngo Quyen District,9,104,101,3,0
2022-01-10,Hai Phong City,Ngo Quyen District,10,130,116,14,3
2022-01-10,Hai Phong City,Ngo Quyen District,11,249,228,21,4
2022-01-10,Hai Phong City,Ngo Quyen District,12,184,168,16,1
2022-01-10,Hai Phong City,Ngo Quyen District,13,91,86,5,0
2022-01-10,Hai Phong City,Ngo Quyen District,14,126,110,16,1
2022-01-10,Hai Phong City,Ngo Quyen District,15,172,158,14,2
2022-01-10,Hai Phong City,Ngo Quyen District,16,140,125,15,1
2022-01-10,Hai Phong City,Ngo Quyen District,17,177,163,14,1
2022-01-10,Hai Phong City,Ngo Quyen District,18,202,180,22,1
2022-01-10,Hai Phong City,Ngo Quyen District,19,173,149,24,2
2022-01-10,Hai Phong City,Ngo Quyen District,20,160,140,20,5
2022-01-10,Hai Phong City,Ngo Quyen District,21,85,63,22,4
2022-01-10,Hai Phong City,Ngo Quyen District,22,2,1,1,0
2022-01-10,Hai Phong City,Ngo Quyen District,23,2,2,0,0
2022-01-10,Hai Phong City,Thuy Nguyen,10,3,0,3,2
2022-01-10,Hai Phong City,Thuy Nguyen,11,3,1,2,1
2022-01-10,Hai Phong City,Thuy Nguyen,13,1,0,1,0
2022-01-10,Hai Phong City,Thuy Nguyen,14,2,0,2,2
2022-01-10,Hai Phong City,Thuy Nguyen,16,2,0,2,1
2022-01-10,Hai Phong City,Thuy Nguyen,21,2,0,2,2
2022-01-10,Hue City,Hue City,0,1,1,0,0
2022-01-10,Hue City,Hue City,1,4,3,1,0
2022-01-10,Hue City,Hue City,4,5,4,1,0
2022-01-10,Hue City,Hue City,5,4,2,2,0
2022-01-10,Hue City,Hue City,6,65,59,6,0
2022-01-10,Hue City,Hue City,7,218,199,19,2
2022-01-10,Hue City,Hue City,8,330,306,24,0
2022-01-10,Hue City,Hue City,9,273,249,24,1
2022-01-10,Hue City,Hue City,10,383,370,13,0
2022-01-10,Hue City,Hue City,11,811,773,38,1
2022-01-10,Hue City,Hue City,12,535,509,26,0
2022-01-10,Hue City,Hue City,13,352,336,16,0
2022-01-10,Hue City,Hue City,14,354,327,27,0
2022-01-10,Hue City,Hue City,15,389,376,13,0
2022-01-10,Hue City,Hue City,16,442,418,24,2
2022-01-10,Hue City,Hue City,17,540,498,42,3
2022-01-10,Hue City,Hue City,18,687,625,62,3
2022-01-10,Hue City,Hue City,19,559,518,41,3
2022-01-10,Hue City,Hue City,20,377,343,34,2
2022-01-10,Hue City,Hue City,21,209,175,34,0
2022-01-10,Hue City,Hue City,22,3,0,3,0
2022-01-10,Hue City,Hue City,23,3,3,0,0
2022-01-10,Hue City,Huong Thuy,12,3,1,2,2
2022-01-10,Hue City,Huong Thuy,15,3,1,2,0
2022-01-10,Hue City,Huong Thuy,16,1,1,0,0
2022-01-10,Hue City,Huong Thuy,18,1,1,0,0
2022-01-10,Hue City,Huong Thuy,19,3,3,0,0
2022-01-10,Hue City,Huong Thuy,21,1,1,0,0
2022-01-10,Hue City,Huong Tra,9,1,1,0,0
2022-01-10,Hue City,Huong Tra,13,1,1,0,0
2022-01-10,Hue City,Huong Tra,16,1,0,1,0
2022-01-10,Hue City,Huong Tra,18,1,1,0,0
2022-01-10,Hue City,Huong Tra,20,1,1,0,0
2022-01-10,Hue City,Phu Vang,9,2,1,1,1
2022-01-10,Hue City,Phu Vang,11,3,2,1,1
2022-01-10,Hue City,Phu Vang,12,1,0,1,1
2022-01-10,Hue City,Phu Vang,14,1,1,0,0
2022-01-10,Hue City,Phu Vang,16,3,2,1,0
2022-01-10,Hue City,Phu Vang,17,1,1,0,0
2022-01-10,Hue City,Phu Vang,18,3,3,0,0
2022-01-10,Hue City,Phu Vang,19,2,1,1,0
2022-01-10,Hue City,Phu Vang,20,2,0,2,1
2022-01-10,Vung Tau,Ba Ria City,8,3,0,3,3
2022-01-10,Vung Tau,Ba Ria City,9,8,4,4,2
2022-01-10,Vung Tau,Ba Ria City,10,6,4,2,2
2022-01-10,Vung Tau,Ba Ria City,11,14,10,4,4
2022-01-10,Vung Tau,Ba Ria City,12,9,5,4,3
2022-01-10,Vung Tau,Ba Ria City,13,5,3,2,1
2022-01-10,Vung Tau,Ba Ria City,14,7,3,4,3
2022-01-10,Vung Tau,Ba Ria City,15,8,3,5,4
2022-01-10,Vung Tau,Ba Ria City,16,6,4,2,2
2022-01-10,Vung Tau,Ba Ria City,17,4,3,1,1
2022-01-10,Vung Tau,Ba Ria City,18,6,3,3,2
2022-01-10,Vung Tau,Ba Ria City,19,7,2,5,3
2022-01-10,Vung Tau,Ba Ria City,20,6,1,5,4
2022-01-10,Vung Tau,Ba Ria City,21,1,0,1,1
2022-01-10,Vung Tau,Tan Thanh,14,1,0,1,1
2022-01-10,Vung Tau,Vung Tau City,0,3,3,0,0
2022-01-10,Vung Tau,Vung Tau City,1,1,1,0,0
2022-01-10,Vung Tau,Vung Tau City,5,5,3,2,1
2022-01-10,Vung Tau,Vung Tau City,6,42,37,5,1
2022-01-10,Vung Tau,Vung Tau City,7,92,85,7,1
2022-01-10,Vung Tau,Vung Tau City,8,163,150,13,0
2022-01-10,Vung Tau,Vung Tau City,9,163,148,15,0
2022-01-10,Vung Tau,Vung Tau City,10,184,171,13,0
2022-01-10,Vung Tau,Vung Tau City,11,356,335,21,1
2022-01-10,Vung Tau,Vung Tau City,12,245,239,6,0
2022-01-10,Vung Tau,Vung Tau City,13,190,179,11,0
2022-01-10,Vung Tau,Vung Tau City,14,212,188,24,1
2022-01-10,Vung Tau,Vung Tau City,15,204,193,11,1
2022-01-10,Vung Tau,Vung Tau City,16,229,212,17,3
2022-01-10,Vung Tau,Vung Tau City,17,265,244,21,0
2022-01-10,Vung Tau,Vung Tau City,18,326,297,29,1
2022-01-10,Vung Tau,Vung Tau City,19,237,219,18,0
2022-01-10,Vung Tau,Vung Tau City,20,196,165,31,2
2022-01-10,Vung Tau,Vung Tau City,21,70,58,12,0
2022-01-10,Vung Tau,Vung Tau City,22,3,1,2,0
2022-01-10,Vung Tau,Vung Tau City,23,7,3,4,0
2022-01-11,Binh Duong,Ben Cat,14,2,0,2,2
2022-01-11,Binh Duong,Ben Cat,15,2,1,1,1
2022-01-11,Binh Duong,Ben Cat,17,1,1,0,0
2022-01-11,Binh Duong,Di An,6,1,0,1,1
2022-01-11,Binh Duong,Di An,7,5,0,5,4
2022-01-11,Binh Duong,Di An,8,15,2,13,12
2022-01-11,Binh Duong,Di An,9,31,12,19,16
2022-01-11,Binh Duong,Di An,10,22,11,11,9
2022-01-11,Binh Duong,Di An,11,26,17,9,5
2022-01-11,Binh Duong,Di An,12,19,12,7,5
2022-01-11,Binh Duong,Di An,13,24,8,16,14
2022-01-11,Binh Duong,Di An,14,26,10,16,14
2022-01-11,Binh Duong,Di An,15,21,8,13,13
2022-01-11,Binh Duong,Di An,16,18,8,10,5
2022-01-11,Binh Duong,Di An,17,11,8,3,3
2022-01-11,Binh Duong,Di An,18,19,16,3,1
2022-01-11,Binh Duong,Di An,19,11,7,4,4
2022-01-11,Binh Duong,Di An,20,14,6,8,8
2022-01-11,Binh Duong,Di An,21,5,2,3,1
2022-01-11,Binh Duong,Tan Uyen,10,1,0,1,1
2022-01-11,Binh Duong,Tan Uyen,11,4,1,3,2
2022-01-11,Binh Duong,Tan Uyen,12,4,3,1,1
2022-01-11,Binh Duong,Tan Uyen,13,4,3,1,1
2022-01-11,Binh Duong,Tan Uyen,14,1,1,0,0
2022-01-11,Binh Duong,Tan Uyen,15,2,1,1,0
2022-01-11,Binh Duong,Tan Uyen,19,2,0,2,2
2022-01-11,Binh Duong,Tan Uyen,20,1,0,1,1
2022-01-11,Binh Duong,Tan Uyen,21,2,0,2,1
2022-01-11,Binh Duong,Thu Dau Mot Town,1,2,1,1,0
2022-01-11,Binh Duong,Thu Dau Mot Town,2,1,1,0,0
2022-01-11,Binh Duong,Thu Dau Mot Town,3,2,0,2,1
2022-01-11,Binh Duong,Thu Dau Mot Town,6,33,25,8,6
2022-01-11,Binh Duong,Thu Dau Mot Town,7,94,83,11,4
2022-01-11,Binh Duong,Thu Dau Mot Town,8,207,191,16,7
2022-01-11,Binh Duong,Thu Dau Mot Town,9,246,225,21,9
2022-01-11,Binh Duong,Thu Dau Mot Town,10,330,310,20,3
2022-01-11,Binh Duong,Thu Dau Mot Town,11,582,552,30,6
2022-01-11,Binh Duong,Thu Dau Mot Town,12,449,430,19,3
2022-01-11,Binh Duong,Thu Dau Mot Town,13,420,404,16,2
2022-01-11,Binh Duong,Thu Dau Mot Town,14,310,295,15,4
2022-01-11,Binh Duong,Thu Dau Mot Town,15,244,227,17,5
2022-01-11,Binh Duong,Thu Dau Mot Town,16,240,229,11,0
2022-01-11,Binh Duong,Thu Dau Mot Town,17,296,288,8,0
2022-01-11,Binh Duong,Thu Dau Mot Town,18,324,302,22,4
2022-01-11,Binh Duong,Thu Dau Mot Town,19,304,275,29,2
2022-01-11,Binh Duong,Thu Dau Mot Town,20,220,202,18,3
2022-01-11,Binh Duong,Thu Dau Mot Town,21,100,83,17,2
2022-01-11,Binh Duong,Thu Dau Mot Town,22,1,1,0,0
2022-01-11,Binh Duong,Thuan An,7,5,3,2,2
2022-01-11,Binh Duong,Thuan An,8,16,5,11,8
2022-01-11,Binh Duong,Thuan An,9,32,12,20,16
2022-01-11,Binh Duong,Thuan An,10,47,28,19,17
2022-01-11,Binh Duong,Thuan An,11,114,56,58,49
2022-01-11,Binh Duong,Thuan An,12,72,43,29,23
2022-01-11,Binh Duong,Thuan An,13,62,42,20,17
2022-01-11,Binh Duong,Thuan An,14,37,25,12,12
2022-01-11,Binh Duong,Thuan An,15,34,23,11,8
2022-01-11,Binh Duong,Thuan An,16,41,25,16,12
2022-01-11,Binh Duong,Thuan An,17,25,22,3,1
2022-01-11,Binh Duong,Thuan An,18,28,24,4,3
2022-01-11,Binh Duong,Thuan An,19,23,19,4,1
2022-01-11,Binh Duong,Thuan An,20,27,15,12,11
2022-01-11,Binh Duong,Thuan An,21,5,2,3,3
2022-01-11,Can Tho City,Binh Thuy District,6,2,2,0,0
2022-01-11,Can Tho City,Binh Thuy District,7,4,4,0,0
2022-01-11,Can Tho City,Binh Thuy District,8,2,1,1,0
2022-01-11,Can Tho City,Binh Thuy District,9,3,3,0,0
2022-01-11,Can Tho City,Binh Thuy District,10,9,8,1,0
2022-01-11,Can Tho City,Binh Thuy District,11,13,12,1,0
2022-01-11,Can Tho City,Binh Thuy District,12,16,15,1,0
2022-01-11,Can Tho City,Binh Thuy District,13,10,9,1,0
2022-01-11,Can Tho City,Binh Thuy District,15,8,7,1,0
2022-01-11,Can Tho City,Binh Thuy District,16,11,11,0,0
2022-01-11,Can Tho City,Binh Thuy District,17,13,10,3,1
2022-01-11,Can Tho City,Binh Thuy District,18,7,7,0,0
2022-01-11,Can Tho City,Binh Thuy District,19,7,6,1,0
2022-01-11,Can Tho City,Binh Thuy District,20,12,12,0,0
2022-01-11,Can Tho City,Binh Thuy District,21,1,1,0,0
2022-01-11,Can Tho City,Cai Rang District,6,1,1,0,0
2022-01-11,Can Tho City,Cai Rang District,7,2,2,0,0
2022-01-11,Can Tho City,Cai Rang District,8,4,3,1,1
2022-01-11,Can Tho City,Cai Rang District,9,6,5,1,0
2022-01-11,Can Tho City,Cai Rang District,10,4,4,0,0
2022-01-11,Can Tho City,Cai Rang District,11,14,14,0,0
2022-01-11,Can Tho City,Cai Rang District,12,11,11,0,0
2022-01-11,Can Tho City,Cai Rang District,13,7,7,0,0
2022-01-11,Can Tho City,Cai Rang District,14,10,8,2,0
2022-01-11,Can Tho City,Cai Rang District,15,8,8,0,0
2022-01-11,Can Tho City,Cai Rang District,16,10,10,0,0
2022-01-11,Can Tho City,Cai Rang District,17,4,3,1,0
2022-01-11,Can Tho City,Cai Rang District,18,9,9,0,0
2022-01-11,Can Tho City,Cai Rang District,19,11,11,0,0
2022-01-11,Can Tho City,Cai Rang District,20,3,3,0,0
2022-01-11,Can Tho City,Cai Rang District,21,1,1,0,0
2022-01-11,Can Tho City,Cai Rang District,22,1,0,1,0
2022-01-11,Can Tho City,Ninh Kieu District,0,6,4,2,0
2022-01-11,Can Tho City,Ninh Kieu District,1,1,1,0,0
2022-01-11,Can Tho City,Ninh Kieu District,2,1,1,0,0
2022-01-11,Can Tho City,Ninh Kieu District,3,1,1,0,0
2022-01-11,Can Tho City,Ninh Kieu District,4,2,2,0,0
2022-01-11,Can Tho City,Ninh Kieu District,5,4,4,0,0
2022-01-11,Can Tho City,Ninh Kieu District,6,48,44,4,0
2022-01-11,Can Tho City,Ninh Kieu District,7,145,140,5,0
2022-01-11,Can Tho City,Ninh Kieu District,8,276,263,13,0
2022-01-11,Can Tho City,Ninh Kieu District,9,309,296,13,0
2022-01-11,Can Tho City,Ninh Kieu District,10,522,495,27,0
2022-01-11,Can Tho City,Ninh Kieu District,11,816,780,36,0
2022-01-11,Can Tho City,Ninh Kieu District,12,514,490,24,0
2022-01-11,Can Tho City,Ninh Kieu District,13,421,408,13,0
2022-01-11,Can Tho City,Ninh Kieu District,14,349,335,14,0
2022-01-11,Can Tho City,Ninh Kieu District,15,311,293,18,0
2022-01-11,Can Tho City,Ninh Kieu District,16,355,336,19,0
2022-01-11,Can Tho City,Ninh Kieu District,17,461,438,23,0
2022-01-11,Can Tho City,Ninh Kieu District,18,413,396,17,0
2022-01-11,Can Tho City,Ninh Kieu District,19,358,338,20,0
2022-01-11,Can Tho City,Ninh Kieu District,20,302,282,20,0
2022-01-11,Can Tho City,Ninh Kieu District,21,151,132,19,0
2022-01-11,Can Tho City,Ninh Kieu District,22,6,4,2,0
2022-01-11,Can Tho City,Ninh Kieu District,23,1,1,0,0
2022-01-11,Dong Nai,Bien Hoa City,1,2,2,0,0
2022-01-11,Dong Nai,Bien Hoa City,2,1,1,0,0
2022-01-11,Dong Nai,Bien Hoa City,3,2,2,0,0
2022-01-11,Dong Nai,Bien Hoa City,4,1,1,0,0
2022-01-11,Dong Nai,Bien Hoa City,5,1,0,1,1
2022-01-11,Dong Nai,Bien Hoa City,6,51,30,21,16
2022-01-11,Dong Nai,Bien Hoa City,7,180,142,38,20
2022-01-11,Dong Nai,Bien Hoa City,8,300,255,45,12
2022-01-11,Dong Nai,Bien Hoa City,9,419,377,42,4
2022-01-11,Dong Nai,Bien Hoa City,10,690,640,50,9
2022-01-11,Dong Nai,Bien Hoa City,11,1063,978,85,31
2022-01-11,Dong Nai,Bien Hoa City,12,824,758,66,5
2022-01-11,Dong Nai,Bien Hoa City,13,727,679,48,6
2022-01-11,Dong Nai,Bien Hoa City,14,649,597,52,6
2022-01-11,Dong Nai,Bien Hoa City,15,546,519,27,1
2022-01-11,Dong Nai,Bien Hoa City,16,520,492,28,2
2022-01-11,Dong Nai,Bien Hoa City,17,565,525,40,2
2022-01-11,Dong Nai,Bien Hoa City,18,627,575,52,8
2022-01-11,Dong Nai,Bien Hoa City,19,555,514,41,3
2022-01-11,Dong Nai,Bien Hoa City,20,433,373,60,13
2022-01-11,Dong Nai,Bien Hoa City,21,190,129,61,33
2022-01-11,Dong Nai,Bien Hoa City,22,3,1,2,0
2022-01-11,Dong Nai,Long Thanh,10,1,0,1,1
2022-01-11,Dong Nai,Long Thanh,11,3,0,3,2
2022-01-11,Dong Nai,Long Thanh,12,4,0,4,4
2022-01-11,Dong Nai,Long Thanh,14,2,0,2,2
2022-01-11,Dong Nai,Long Thanh,16,3,0,3,2
2022-01-11,Dong Nai,Long Thanh,17,1,0,1,0
2022-01-11,Dong Nai,Long Thanh,18,3,0,3,3
2022-01-11,Dong Nai,Thong Nhat,9,1,1,0,0
2022-01-11,Dong Nai,Thong Nhat,10,1,1,0,0
2022-01-11,Dong Nai,Thong Nhat,11,1,1,0,0
2022-01-11,Dong Nai,Thong Nhat,13,5,4,1,0
2022-01-11,Dong Nai,Thong Nhat,14,1,1,0,0
2022-01-11,Dong Nai,Thong Nhat,17,1,1,0,0
2022-01-11,Dong Nai,Thong Nhat,18,1,1,0,0
2022-01-11,Dong Nai,Thong Nhat,19,1,1,0,0
2022-01-11,Dong Nai,Thong Nhat,20,2,2,0,0
2022-01-11,Dong Nai,Trang Bom,9,1,0,1,0
2022-01-11,Dong Nai,Trang Bom,11,3,0,3,2
2022-01-11,Dong Nai,Trang Bom,12,2,1,1,1
2022-01-11,Dong Nai,Trang Bom,13,2,0,2,2
2022-01-11,Dong Nai,Trang Bom,20,1,0,1,1
2022-01-11,Hai Phong City,An Duong,8,2,0,2,2
2022-01-11,Hai Phong City,An Duong,9,1,0,1,0
2022-01-11,Hai Phong City,An Duong,10,2,1,1,1
2022-01-11,Hai Phong City,An Duong,12,1,1,0,0
2022-01-11,Hai Phong City,An Duong,13,3,1,2,2
2022-01-11,Hai Phong City,An Duong,14,3,1,2,1
2022-01-11,Hai Phong City,An Duong,15,2,1,1,0
2022-01-11,Hai Phong City,An Duong,16,1,1,0,0
2022-01-11,Hai Phong City,An Duong,17,4,3,1,1
2022-01-11,Hai Phong City,An Duong,18,2,2,0,0
2022-01-11,Hai Phong City,An Duong,19,3,2,1,0
2022-01-11,Hai Phong City,An Duong,20,1,0,1,0
2022-01-11,Hai Phong City,Duong Kinh District,20,2,0,2,1
2022-01-11,Hai Phong City,Hai An District,2,1,0,1,1
2022-01-11,Hai Phong City,Hai An District,7,5,5,0,0
2022-01-11,Hai Phong City,Hai An District,8,17,13,4,1
2022-01-11,Hai Phong City,Hai An District,9,16,14,2,0
2022-01-11,Hai Phong City,Hai An District,10,29,25,4,1
2022-01-11,Hai Phong City,Hai An District,11,49,42,7,1
2022-01-11,Hai Phong City,Hai An District,12,25,22,3,0
2022-01-11,Hai Phong City,Hai An District,13,22,19,3,1
2022-01-11,Hai Phong City,Hai An District,14,19,17,2,0
2022-01-11,Hai Phong City,Hai An District,15,14,12,2,0
2022-01-11,Hai Phong City,Hai An District,16,17,13,4,2
2022-01-11,Hai Phong City,Hai An District,17,31,25,6,1
2022-01-11,Hai Phong City,Hai An District,18,24,23,1,0
2022-01-11,Hai Phong City,Hai An District,19,24,23,1,0
2022-01-11,Hai Phong City,Hai An District,20,20,14,6,2
2022-01-11,Hai Phong City,Hai An District,21,6,4,2,1
2022-01-11,Hai Phong City,Hong Bang District,1,2,0,2,0
2022-01-11,Hai Phong City,Hong Bang District,7,15,13,2,0
2022-01-11,Hai Phong City,Hong Bang District,8,47,37,10,3
2022-01-11,Hai Phong City,Hong Bang District,9,40,35,5,1
2022-01-11,Hai Phong City,Hong Bang District,10,65,59,6,0
2022-01-11,Hai Phong City,Hong Bang District,11,127,118,9,2
2022-01-11,Hai Phong City,Hong Bang District,12,78,72,6,1
2022-01-11,Hai Phong City,Hong Bang District,13,56,53,3,0
2022-01-11,Hai Phong City,Hong Bang District,14,57,49,8,3
2022-01-11,Hai Phong City,Hong Bang District,15,63,58,5,0
2022-01-11,Hai Phong City,Hong Bang District,16,42,37,5,0
2022-01-11,Hai Phong City,Hong Bang District,17,46,40,6,0
2022-01-11,Hai Phong City,Hong Bang District,18,78,71,7,1
2022-01-11,Hai Phong City,Hong Bang District,19,80,75,5,0
2022-01-11,Hai Phong City,Hong Bang District,20,57,51,6,2
2022-01-11,Hai Phong City,Hong Bang District,21,17,14,3,2
2022-01-11,Hai Phong City,Kien An District,7,1,0,1,1
2022-01-11,Hai Phong City,Kien An District,8,3,1,2,2
2022-01-11,Hai Phong City,Kien An District,9,2,2,0,0
2022-01-11,Hai Phong City,Kien An District,10,12,10,2,2
2022-01-11,Hai Phong City,Kien An District,11,11,8,3,0
2022-01-11,Hai Phong City,Kien An District,12,6,6,0,0
2022-01-11,Hai Phong City,Kien An District,13,11,7,4,1
2022-01-11,Hai Phong City,Kien An District,14,7,3,4,2
2022-01-11,Hai Phong City,Kien An District,15,15,6,9,7
2022-01-11,Hai Phong City,Kien An District,16,14,3,11,10
2022-01-11,Hai Phong City,Kien An District,17,15,6,9,8
2022-01-11,Hai Phong City,Kien An District,18,13,8,5,2
2022-01-11,Hai Phong City,Kien An District,19,16,9,7,5
2022-01-11,Hai Phong City,Kien An District,20,23,2,21,16
2022-01-11,Hai Phong City,Kien An District,21,4,2,2,1
2022-01-11,Hai Phong City,Le Chan District,1,7,3,4,0
2022-01-11,Hai Phong City,Le Chan District,2,1,1,0,0
2022-01-11,Hai Phong City,Le Chan District,6,2,1,1,1
2022-01-11,Hai Phong City,Le Chan District,7,50,42,8,4
2022-01-11,Hai Phong City,Le Chan District,8,88,72,16,2
2022-01-11,Hai Phong City,Le Chan District,9,84,73,11,0
2022-01-11,Hai Phong City,Le Chan District,10,158,145,13,0
2022-01-11,Hai Phong City,Le Chan District,11,366,343,23,1
2022-01-11,Hai Phong City,Le Chan District,12,233,213,20,1
2022-01-11,Hai Phong City,Le Chan District,13,119,111,8,1
2022-01-11,Hai Phong City,Le Chan District,14,154,135,19,1
2022-01-11,Hai Phong City,Le Chan District,15,184,167,17,2
2022-01-11,Hai Phong City,Le Chan District,16,185,170,15,1
2022-01-11,Hai Phong City,Le Chan District,17,217,200,17,1
2022-01-11,Hai Phong City,Le Chan District,18,268,248,20,1
2022-01-11,Hai Phong City,Le Chan District,19,247,223,24,1
2022-01-11,Hai Phong City,Le Chan District,20,142,125,17,0
2022-01-11,Hai Phong City,Le Chan District,21,84,66,18,2
2022-01-11,Hai Phong City,Le Chan District,23,2,2,0,0
2022-01-11,Hai Phong City,Ngo Quyen District,0,1,1,0,0
2022-01-11,Hai Phong City,Ngo Quyen District,5,2,0,2,1
2022-01-11,Hai Phong City,Ngo Quyen District,6,2,1,1,1
2022-01-11,Hai Phong City,Ngo Quyen District,7,44,32,12,6
2022-01-11,Hai Phong City,Ngo Quyen District,8,101,80,21,6
2022-01-11,Hai Phong City,Ngo Quyen District,9,84,75,9,0
2022-01-11,Hai Phong City,Ngo Quyen District,10,172,153,19,0
2022-01-11,Hai Phong City,Ngo Quyen District,11,278,256,22,3
2022-01-11,Hai Phong City,Ngo Quyen District,12,188,173,15,0
2022-01-11,Hai Phong City,Ngo Quyen District,13,119,112,7,0
2022-01-11,Hai Phong City,Ngo Quyen District,14,156,147,9,0
2022-01-11,Hai Phong City,Ngo Quyen District,15,177,159,18,1
2022-01-11,Hai Phong City,Ngo Quyen District,16,155,139,16,0
2022-01-11,Hai Phong City,Ngo Quyen District,17,167,155,12,4
2022-01-11,Hai Phong City,Ngo Quyen District,18,173,164,9,0
2022-01-11,Hai Phong City,Ngo Quyen District,19,166,150,16,0
2022-01-11,Hai Phong City,Ngo Quyen District,20,166,146,20,1
2022-01-11,Hai Phong City,Ngo Quyen District,21,72,59,13,3
2022-01-11,Hai Phong City,Ngo Quyen District,22,2,1,1,0
2022-01-11,Hai Phong City,Ngo Quyen District,23,2,2,0,0
2022-01-11,Hai Phong City,Thuy Nguyen,6,1,0,1,1
2022-01-11,Hai Phong City,Thuy Nguyen,8,1,0,1,1
2022-01-11,Hai Phong City,Thuy Nguyen,9,2,1,1,0
2022-01-11,Hai Phong City,Thuy Nguyen,10,2,0,2,2
2022-01-11,Hai Phong City,Thuy Nguyen,11,1,0,1,1
2022-01-11,Hai Phong City,Thuy Nguyen,13,1,1,0,0
2022-01-11,Hai Phong City,Thuy Nguyen,14,1,1,0,0
2022-01-11,Hai Phong City,Thuy Nguyen,15,1,0,1,1
2022-01-11,Hai Phong City,Thuy Nguyen,16,1,0,1,1
2022-01-11,Hai Phong City,Thuy Nguyen,20,3,1,2,2
2022-01-11,Hai Phong City,Thuy Nguyen,21,1,0,1,1
2022-01-11,Hue City,Hue City,0,5,4,1,0
2022-01-11,Hue City,Hue City,3,1,0,1,0
2022-01-11,Hue City,Hue City,4,1,1,0,0
2022-01-11,Hue City,Hue City,5,2,1,1,0
2022-01-11,Hue City,Hue City,6,49,45,4,0
2022-01-11,Hue City,Hue City,7,259,247,12,0
2022-01-11,Hue City,Hue City,8,356,336,20,0
2022-01-11,Hue City,Hue City,9,298,277,21,0
2022-01-11,Hue City,Hue City,10,364,352,12,0
2022-01-11,Hue City,Hue City,11,846,811,35,0
2022-01-11,Hue City,Hue City,12,467,443,24,0
2022-01-11,Hue City,Hue City,13,276,264,12,0
2022-01-11,Hue City,Hue City,14,373,349,24,0
2022-01-11,Hue City,Hue City,15,539,493,46,6
2022-01-11,Hue City,Hue City,16,545,505,40,5
2022-01-11,Hue City,Hue City,17,745,706,39,4
2022-01-11,Hue City,Hue City,18,729,674,55,6
2022-01-11,Hue City,Hue City,19,623,558,65,6
2022-01-11,Hue City,Hue City,20,504,447,57,7
2022-01-11,Hue City,Hue City,21,230,196,34,2
2022-01-11,Hue City,Hue City,22,7,6,1,0
2022-01-11,Hue City,Hue City,23,1,1,0,0
2022-01-11,Hue City,Huong Thuy,8,2,2,0,0
2022-01-11,Hue City,Huong Thuy,9,2,1,1,0
2022-01-11,Hue City,Huong Thuy,11,2,1,1,1
2022-01-11,Hue City,Huong Thuy,16,2,2,0,0
2022-01-11,Hue City,Huong Thuy,18,2,1,1,0
2022-01-11,Hue City,Huong Thuy,19,2,2,0,0
2022-01-11,Hue City,Huong Tra,16,1,1,0,0
2022-01-11,Hue City,Huong Tra,18,1,0,1,1
2022-01-11,Hue City,Huong Tra,20,1,0,1,0
2022-01-11,Hue City,Huong Tra,21,1,1,0,0
2022-01-11,Hue City,Phu Vang,7,2,2,0,0
2022-01-11,Hue City,Phu Vang,8,2,2,0,0
2022-01-11,Hue City,Phu Vang,10,1,1,0,0
2022-01-11,Hue City,Phu Vang,12,2,2,0,0
2022-01-11,Hue City,Phu Vang,13,1,1,0,0
2022-01-11,Hue City,Phu Vang,15,2,1,1,0
2022-01-11,Hue City,Phu Vang,16,1,0,1,0
2022-01-11,Hue City,Phu Vang,17,2,1,1,1
2022-01-11,Hue City,Phu Vang,18,4,3,1,0
2022-01-11,Hue City,Phu Vang,19,1,1,0,0
2022-01-11,Hue City,Phu Vang,21,1,0,1,0
2022-01-11,Vung Tau,Ba Ria City,6,1,0,1,1
2022-01-11,Vung Tau,Ba Ria City,7,1,0,1,1
2022-01-11,Vung Tau,Ba Ria City,8,8,3,5,4
2022-01-11,Vung Tau,Ba Ria City,9,6,4,2,0
2022-01-11,Vung Tau,Ba Ria City,10,4,1,3,3
2022-01-11,Vung Tau,Ba Ria City,11,9,1,8,7
2022-01-11,Vung Tau,Ba Ria City,12,21,1,20,18
2022-01-11,Vung Tau,Ba Ria City,13,6,4,2,1
2022-01-11,Vung Tau,Ba Ria City,14,16,6,10,9
2022-01-11,Vung Tau,Ba Ria City,15,6,5,1,1
2022-01-11,Vung Tau,Ba Ria City,16,7,3,4,2
2022-01-11,Vung Tau,Ba Ria City,17,8,3,5,2
2022-01-11,Vung Tau,Ba Ria City,18,5,1,4,3
2022-01-11,Vung Tau,Ba Ria City,19,9,4,5,5
2022-01-11,Vung Tau,Ba Ria City,20,3,0,3,3
2022-01-11,Vung Tau,Ba Ria City,21,2,0,2,2
2022-01-11,Vung Tau,Vung Tau City,2,3,3,0,0
2022-01-11,Vung Tau,Vung Tau City,4,1,1,0,0
2022-01-11,Vung Tau,Vung Tau City,6,40,31,9,6
2022-01-11,Vung Tau,Vung Tau City,7,113,105,8,0
2022-01-11,Vung Tau,Vung Tau City,8,146,137,9,1
2022-01-11,Vung Tau,Vung Tau City,9,146,138,8,1
2022-01-11,Vung Tau,Vung Tau City,10,178,167,11,2
2022-01-11,Vung Tau,Vung Tau City,11,324,310,14,1
2022-01-11,Vung Tau,Vung Tau City,12,266,253,13,0
2022-01-11,Vung Tau,Vung Tau City,13,187,180,7,1
2022-01-11,Vung Tau,Vung Tau City,14,237,223,14,0
2022-01-11,Vung Tau,Vung Tau City,15,214,195,19,1
2022-01-11,Vung Tau,Vung Tau City,16,211,197,14,0
2022-01-11,Vung Tau,Vung Tau City,17,250,230,20,0
2022-01-11,Vung Tau,Vung Tau City,18,320,298,22,3
2022-01-11,Vung Tau,Vung Tau City,19,259,232,27,3
2022-01-11,Vung Tau,Vung Tau City,20,156,145,11,0
2022-01-11,Vung Tau,Vung Tau City,21,122,97,25,5
2022-01-11,Vung Tau,Vung Tau City,22,1,0,1,0
2022-01-12,Binh Duong,Ben Cat,19,1,1,0,0
2022-01-12,Binh Duong,Ben Cat,20,1,0,1,1
2022-01-12,Binh Duong,Di An,2,1,0,1,0
2022-01-12,Binh Duong,Di An,6,1,0,1,0
2022-01-12,Binh Duong,Di An,7,3,1,2,2
2022-01-12,Binh Duong,Di An,8,2,1,1,1
2022-01-12,Binh Duong,Di An,9,7,4,3,3
2022-01-12,Binh Duong,Di An,10,11,6,5,4
2022-01-12,Binh Duong,Di An,11,21,9,12,10
2022-01-12,Binh Duong,Di An,12,21,17,4,1
2022-01-12,Binh Duong,Di An,13,31,19,12,9
2022-01-12,Binh Duong,Di An,14,17,9,8,5
2022-01-12,Binh Duong,Di An,15,10,8,2,2
2022-01-12,Binh Duong,Di An,16,13,6,7,7
2022-01-12,Binh Duong,Di An,17,21,14,7,4
2022-01-12,Binh Duong,Di An,18,17,12,5,5
2022-01-12,Binh Duong,Di An,19,14,12,2,1
2022-01-12,Binh Duong,Di An,20,9,5,4,1
2022-01-12,Binh Duong,Di An,21,11,0,11,10
2022-01-12,Binh Duong,Tan Uyen,8,1,0,1,1
2022-01-12,Binh Duong,Tan Uyen,9,2,1,1,1
2022-01-12,Binh Duong,Tan Uyen,10,5,0,5,3
2022-01-12,Binh Duong,Tan Uyen,13,2,1,1,0
2022-01-12,Binh Duong,Tan Uyen,15,4,2,2,1
2022-01-12,Binh Duong,Tan Uyen,16,2,2,0,0
2022-01-12,Binh Duong,Tan Uyen,17,1,1,0,0
2022-01-12,Binh Duong,Tan Uyen,18,1,0,1,1
2022-01-12,Binh Duong,Tan Uyen,20,1,0,1,1
2022-01-12,Binh Duong,Tan Uyen,21,1,0,1,1
2022-01-12,Binh Duong,Thu Dau Mot Town,0,1,1,0,0
2022-01-12,Binh Duong,Thu Dau Mot Town,1,2,1,1,0
2022-01-12,Binh Duong,Thu Dau Mot Town,2,2,2,0,0
2022-01-12,Binh Duong,Thu Dau Mot Town,3,2,1,1,0
2022-01-12,Binh Duong,Thu Dau Mot Town,4,1,0,1,0
2022-01-12,Binh Duong,Thu Dau Mot Town,6,30,26,4,3
2022-01-12,Binh Duong,Thu Dau Mot Town,7,128,114,14,1
2022-01-12,Binh Duong,Thu Dau Mot Town,8,191,180,11,2
2022-01-12,Binh Duong,Thu Dau Mot Town,9,222,214,8,0
2022-01-12,Binh Duong,Thu Dau Mot Town,10,314,284,30,5
2022-01-12,Binh Duong,Thu Dau Mot Town,11,605,559,46,7
2022-01-12,Binh Duong,Thu Dau Mot Town,12,436,415,21,2
2022-01-12,Binh Duong,Thu Dau Mot Town,13,369,335,34,6
2022-01-12,Binh Duong,Thu Dau Mot Town,14,308,295,13,1
2022-01-12,Binh Duong,Thu Dau Mot Town,15,232,224,8,1
2022-01-12,Binh Duong,Thu Dau Mot Town,16,245,227,18,2
2022-01-12,Binh Duong,Thu Dau Mot Town,17,318,301,17,2
2022-01-12,Binh Duong,Thu Dau Mot Town,18,357,340,17,3
2022-01-12,Binh Duong,Thu Dau Mot Town,19,283,267,16,1
2022-01-12,Binh Duong,Thu Dau Mot Town,20,220,197,23,7
2022-01-12,Binh Duong,Thu Dau Mot Town,21,71,63,8,2
2022-01-12,Binh Duong,Thu Dau Mot Town,22,3,1,2,0
2022-01-12,Binh Duong,Thu Dau Mot Town,23,2,2,0,0
2022-01-12,Binh Duong,Thuan An,0,1,0,1,0
2022-01-12,Binh Duong,Thuan An,6,3,1,2,2
2022-01-12,Binh Duong,Thuan An,7,2,2,0,0
2022-01-12,Binh Duong,Thuan An,8,24,7,17,13
2022-01-12,Binh Duong,Thuan An,9,47,18,29,28
2022-01-12,Binh Duong,Thuan An,10,61,42,19,18
2022-01-12,Binh Duong,Thuan An,11,98,61,37,31
2022-01-12,Binh Duong,Thuan An,12,67,45,22,13
2022-01-12,Binh Duong,Thuan An,13,46,26,20,13
2022-01-12,Binh Duong,Thuan An,14,41,31,10,4
2022-01-12,Binh Duong,Thuan An,15,39,25,14,11
2022-01-12,Binh Duong,Thuan An,16,39,31,8,4
2022-01-12,Binh Duong,Thuan An,17,36,25,11,10
2022-01-12,Binh Duong,Thuan An,18,34,26,8,6
2022-01-12,Binh Duong,Thuan An,19,28,18,10,9
2022-01-12,Binh Duong,Thuan An,20,27,15,12,9
2022-01-12,Binh Duong,Thuan An,21,9,5,4,3
2022-01-12,Can Tho City,Binh Thuy District,6,1,0,1,0
2022-01-12,Can Tho City,Binh Thuy District,7,2,2,0,0
2022-01-12,Can Tho City,Binh Thuy District,8,4,4,0,0
2022-01-12,Can Tho City,Binh Thuy District,9,9,7,2,0
2022-01-12,Can Tho City,Binh Thuy District,10,9,8,1,0
2022-01-12,Can Tho City,Binh Thuy District,11,9,8,1,0
2022-01-12,Can Tho City,Binh Thuy District,12,8,8,0,0
2022-01-12,Can Tho City,Binh Thuy District,13,6,6,0,0
2022-01-12,Can Tho City,Binh Thuy District,14,11,11,0,0
2022-01-12,Can Tho City,Binh Thuy District,15,10,10,0,0
2022-01-12,Can Tho City,Binh Thuy District,16,5,5,0,0
2022-01-12,Can Tho City,Binh Thuy District,17,6,5,1,0
2022-01-12,Can Tho City,Binh Thuy District,18,10,10,0,0
2022-01-12,Can Tho City,Binh Thuy District,19,6,5,1,1
2022-01-12,Can Tho City,Binh Thuy District,20,11,6,5,0
2022-01-12,Can Tho City,Binh Thuy District,21,4,4,0,0
2022-01-12,Can Tho City,Cai Rang District,0,1,0,1,0
2022-01-12,Can Tho City,Cai Rang District,1,1,1,0,0
2022-01-12,Can Tho City,Cai Rang District,5,1,0,1,0
2022-01-12,Can Tho City,Cai Rang District,6,3,2,1,0
2022-01-12,Can Tho City,Cai Rang District,7,10,9,1,0
2022-01-12,Can Tho City,Cai Rang District,8,4,4,0,0
2022-01-12,Can Tho City,Cai Rang District,9,2,2,0,0
2022-01-12,Can Tho City,Cai Rang District,10,18,10,8,0
2022-01-12,Can Tho City,Cai Rang District,11,14,14,0,0
2022-01-12,Can Tho City,Cai Rang District,12,12,12,0,0
2022-01-12,Can Tho City,Cai Rang District,13,7,7,0,0
2022-01-12,Can Tho City,Cai Rang District,14,5,5,0,0
2022-01-12,Can Tho City,Cai Rang District,15,7,6,1,0
2022-01-12,Can Tho City,Cai Rang District,16,14,13,1,1
2022-01-12,Can Tho City,Cai Rang District,17,9,9,0,0
2022-01-12,Can Tho City,Cai Rang District,18,9,9,0,0
2022-01-12,Can Tho City,Cai Rang District,19,13,13,0,0
2022-01-12,Can Tho City,Cai Rang District,20,2,2,0,0
2022-01-12,Can Tho City,Cai Rang District,21,6,3,3,3
2022-01-12,Can Tho City,Ninh Kieu District,0,3,3,0,0
2022-01-12,Can Tho City,Ninh Kieu District,1,5,3,2,0
2022-01-12,Can Tho City,Ninh Kieu District,3,1,1,0,0
2022-01-12,Can Tho City,Ninh Kieu District,4,1,1,0,0
2022-01-12,Can Tho City,Ninh Kieu District,5,8,6,2,0
2022-01-12,Can Tho City,Ninh Kieu District,6,37,32,5,0
2022-01-12,Can Tho City,Ninh Kieu District,7,155,149,6,0
2022-01-12,Can Tho City,Ninh Kieu District,8,271,257,14,0
2022-01-12,Can Tho City,Ninh Kieu District,9,292,273,19,0
2022-01-12,Can Tho City,Ninh Kieu District,10,499,475,24,0
2022-01-12,Can Tho City,Ninh Kieu District,11,777,754,23,2
2022-01-12,Can Tho City,Ninh Kieu District,12,554,514,40,1
2022-01-12,Can Tho City,Ninh Kieu District,13,409,392,17,0
2022-01-12,Can Tho City,Ninh Kieu District,14,387,360,27,0
2022-01-12,Can Tho City,Ninh Kieu District,15,367,343,24,0
2022-01-12,Can Tho City,Ninh Kieu District,16,330,315,15,0
2022-01-12,Can Tho City,Ninh Kieu District,17,461,434,27,0
2022-01-12,Can Tho City,Ninh Kieu District,18,463,444,19,0
2022-01-12,Can Tho City,Ninh Kieu District,19,413,389,24,0
2022-01-12,Can Tho City,Ninh Kieu District,20,283,263,20,0
2022-01-12,Can Tho City,Ninh Kieu District,21,151,136,15,0
2022-01-12,Can Tho City,Ninh Kieu District,22,8,7,1,0
2022-01-12,Can Tho City,Ninh Kieu District,23,4,2,2,0
2022-01-12,Dong Nai,Bien Hoa City,0,3,1,2,1
2022-01-12,Dong Nai,Bien Hoa City,1,1,1,0,0
2022-01-12,Dong Nai,Bien Hoa City,2,1,0,1,0
2022-01-12,Dong Nai,Bien Hoa City,3,4,2,2,1
2022-01-12,Dong Nai,Bien Hoa City,6,39,27,12,8
2022-01-12,Dong Nai,Bien Hoa City,7,147,131,16,5
2022-01-12,Dong Nai,Bien Hoa City,8,330,301,29,7
2022-01-12,Dong Nai,Bien Hoa City,9,374,346,28,3
2022-01-12,Dong Nai,Bien Hoa City,10,674,638,36,6
2022-01-12,Dong Nai,Bien Hoa City,11,1037,954,83,19
2022-01-12,Dong Nai,Bien Hoa City,12,796,724,72,9
2022-01-12,Dong Nai,Bien Hoa City,13,698,659,39,2
2022-01-12,Dong Nai,Bien Hoa City,14,633,596,37,4
2022-01-12,Dong Nai,Bien Hoa City,15,544,511,33,3
2022-01-12,Dong Nai,Bien Hoa City,16,513,480,33,10
2022-01-12,Dong Nai,Bien Hoa City,17,545,502,43,7
2022-01-12,Dong Nai,Bien Hoa City,18,649,604,45,7
2022-01-12,Dong Nai,Bien Hoa City,19,576,525,51,2
2022-01-12,Dong Nai,Bien Hoa City,20,460,397,63,19
2022-01-12,Dong Nai,Bien Hoa City,21,203,134,69,36
2022-01-12,Dong Nai,Bien Hoa City,22,4,3,1,0
2022-01-12,Dong Nai,Long Thanh,10,1,0,1,1
2022-01-12,Dong Nai,Long Thanh,11,2,0,2,2
2022-01-12,Dong Nai,Long Thanh,12,1,0,1,1
2022-01-12,Dong Nai,Long Thanh,14,1,0,1,1
2022-01-12,Dong Nai,Long Thanh,15,1,0,1,1
2022-01-12,Dong Nai,Long Thanh,17,1,0,1,1
2022-01-12,Dong Nai,Long Thanh,20,1,0,1,1
2022-01-12,Dong Nai,Thong Nhat,7,1,1,0,0
2022-01-12,Dong Nai,Thong Nhat,9,3,2,1,0
2022-01-12,Dong Nai,Thong Nhat,11,1,0,1,0
2022-01-12,Dong Nai,Thong Nhat,12,1,1,0,0
2022-01-12,Dong Nai,Thong Nhat,13,1,1,0,0
2022-01-12,Dong Nai,Thong Nhat,14,1,1,0,0
2022-01-12,Dong Nai,Thong Nhat,17,1,1,0,0
2022-01-12,Dong Nai,Thong Nhat,19,2,2,0,0
2022-01-12,Dong Nai,Trang Bom,8,1,0,1,1
2022-01-12,Dong Nai,Trang Bom,9,1,0,1,1
2022-01-12,Dong Nai,Trang Bom,14,1,0,1,1
2022-01-12,Dong Nai,Trang Bom,19,2,1,1,1
2022-01-12,Hai Phong City,An Duong,7,1,0,1,1
2022-01-12,Hai Phong City,An Duong,9,1,0,1,0
2022-01-12,Hai Phong City,An Duong,11,1,1,0,0
2022-01-12,Hai Phong City,An Duong,12,2,1,1,0
2022-01-12,Hai Phong City,An Duong,13,1,1,0,0
2022-01-12,Hai Phong City,An Duong,14,2,2,0,0
2022-01-12,Hai Phong City,An Duong,15,8,8,0,0
2022-01-12,Hai Phong City,An Duong,16,1,1,0,0
2022-01-12,Hai Phong City,An Duong,17,1,1,0,0
2022-01-12,Hai Phong City,An Duong,20,2,1,1,1
2022-01-12,Hai Phong City,An Duong,21,1,0,1,1
2022-01-12,Hai Phong City,Do Son District,12,1,0,1,1
2022-01-12,Hai Phong City,Hai An District,1,1,0,1,0
2022-01-12,Hai Phong City,Hai An District,6,1,1,0,0
2022-01-12,Hai Phong City,Hai An District,7,4,3,1,0
2022-01-12,Hai Phong City,Hai An District,8,20,16,4,0
2022-01-12,Hai Phong City,Hai An District,9,13,10,3,0
2022-01-12,Hai Phong City,Hai An District,10,25,21,4,1
2022-01-12,Hai Phong City,Hai An District,11,63,58,5,2
2022-01-12,Hai Phong City,Hai An District,12,35,33,2,1
2022-01-12,Hai Phong City,Hai An District,13,16,13,3,1
2022-01-12,Hai Phong City,Hai An District,14,21,18,3,0
2022-01-12,Hai Phong City,Hai An District,15,19,19,0,0
2022-01-12,Hai Phong City,Hai An District,16,19,19,0,0
2022-01-12,Hai Phong City,Hai An District,17,26,22,4,1
2022-01-12,Hai Phong City,Hai An District,18,28,24,4,1
2022-01-12,Hai Phong City,Hai An District,19,26,24,2,0
2022-01-12,Hai Phong City,Hai An District,20,14,11,3,1
2022-01-12,Hai Phong City,Hai An District,21,12,8,4,2
2022-01-12,Hai Phong City,Hong Bang District,0,1,1,0,0
2022-01-12,Hai Phong City,Hong Bang District,3,1,1,0,0
2022-01-12,Hai Phong City,Hong Bang District,7,15,13,2,0
2022-01-12,Hai Phong City,Hong Bang District,8,53,43,10,1
2022-01-12,Hai Phong City,Hong Bang District,9,34,31,3,0
2022-01-12,Hai Phong City,Hong Bang District,10,47,44,3,1
2022-01-12,Hai Phong City,Hong Bang District,11,109,98,11,2
2022-01-12,Hai Phong City,Hong Bang District,12,86,82,4,0
2022-01-12,Hai Phong City,Hong Bang District,13,50,47,3,0
2022-01-12,Hai Phong City,Hong Bang District,14,62,55,7,2
2022-01-12,Hai Phong City,Hong Bang District,15,63,52,11,1
2022-01-12,Hai Phong City,Hong Bang District,16,49,47,2,1
2022-01-12,Hai Phong City,Hong Bang District,17,63,58,5,0
2022-01-12,Hai Phong City,Hong Bang District,18,71,61,10,3
2022-01-12,Hai Phong City,Hong Bang District,19,64,58,6,0
2022-01-12,Hai Phong City,Hong Bang District,20,50,45,5,1
2022-01-12,Hai Phong City,Hong Bang District,21,9,8,1,1
2022-01-12,Hai Phong City,Kien An District,7,1,0,1,1
2022-01-12,Hai Phong City,Kien An District,8,4,2,2,2
2022-01-12,Hai Phong City,Kien An District,9,6,2,4,4
2022-01-12,Hai Phong City,Kien An District,10,9,4,5,3
2022-01-12,Hai Phong City,Kien An District,11,12,8,4,2
2022-01-12,Hai Phong City,Kien An District,12,7,2,5,4
2022-01-12,Hai Phong City,Kien An District,13,4,1,3,2
2022-01-12,Hai Phong City,Kien An District,14,8,5,3,2
2022-01-12,Hai Phong City,Kien An District,15,18,11,7,3
2022-01-12,Hai Phong City,Kien An District,16,12,11,1,0
2022-01-12,Hai Phong City,Kien An District,17,7,3,4,4
2022-01-12,Hai Phong City,Kien An District,18,14,6,8,3
2022-01-12,Hai Phong City,Kien An District,19,11,8,3,3
2022-01-12,Hai Phong City,Kien An District,20,5,4,1,1
2022-01-12,Hai Phong City,Kien An District,21,10,5,5,4
2022-01-12,Hai Phong City,Le Chan District,4,1,1,0,0
2022-01-12,Hai Phong City,Le Chan District,5,1,1,0,0
2022-01-12,Hai Phong City,Le Chan District,6,2,2,0,0
2022-01-12,Hai Phong City,Le Chan District,7,41,35,6,2
2022-01-12,Hai Phong City,Le Chan District,8,92,78,14,0
2022-01-12,Hai Phong City,Le Chan District,9,103,88,15,1
2022-01-12,Hai Phong City,Le Chan District,10,160,144,16,0
2022-01-12,Hai Phong City,Le Chan District,11,362,317,45,11
2022-01-12,Hai Phong City,Le Chan District,12,215,197,18,1
2022-01-12,Hai Phong City,Le Chan District,13,126,119,7,0
2022-01-12,Hai Phong City,Le Chan District,14,140,129,11,1
2022-01-12,Hai Phong City,Le Chan District,15,198,173,25,2
2022-01-12,Hai Phong City,Le Chan District,16,191,172,19,2
2022-01-12,Hai Phong City,Le Chan District,17,221,193,28,0
2022-01-12,Hai Phong City,Le Chan District,18,272,249,23,0
2022-01-12,Hai Phong City,Le Chan District,19,201,184,17,0
2022-01-12,Hai Phong City,Le Chan District,20,170,152,18,1
2022-01-12,Hai Phong City,Le Chan District,21,71,59,12,1
2022-01-12,Hai Phong City,Le Chan District,22,2,1,1,0
2022-01-12,Hai Phong City,Le Chan District,23,2,0,2,0
2022-01-12,Hai Phong City,Ngo Quyen District,4,1,0,1,0
2022-01-12,Hai Phong City,Ngo Quyen District,7,25,19,6,3
2022-01-12,Hai Phong City,Ngo Quyen District,8,88,80,8,0
2022-01-12,Hai Phong City,Ngo Quyen District,9,90,77,13,0
2022-01-12,Hai Phong City,Ngo Quyen District,10,131,122,9,0
2022-01-12,Hai Phong City,Ngo Quyen District,11,287,258,29,7
2022-01-12,Hai Phong City,Ngo Quyen District,12,188,168,20,0
2022-01-12,Hai Phong City,Ngo Quyen District,13,119,108,11,0
2022-01-12,Hai Phong City,Ngo Quyen District,14,132,123,9,0
2022-01-12,Hai Phong City,Ngo Quyen District,15,172,153,19,0
2022-01-12,Hai Phong City,Ngo Quyen District,16,148,141,7,0
2022-01-12,Hai Phong City,Ngo Quyen District,17,167,145,22,1
2022-01-12,Hai Phong City,Ngo Quyen District,18,197,180,17,3
2022-01-12,Hai Phong City,Ngo Quyen District,19,173,158,15,0
2022-01-12,Hai Phong City,Ngo Quyen District,20,168,147,21,2
2022-01-12,Hai Phong City,Ngo Quyen District,21,73,67,6,0
2022-01-12,Hai Phong City,Ngo Quyen District,22,4,1,3,0
2022-01-12,Hai Phong City,Ngo Quyen District,23,1,1,0,0
2022-01-12,Hai Phong City,Thuy Nguyen,14,1,0,1,1
2022-01-12,Hai Phong City,Thuy Nguyen,19,1,0,1,0
2022-01-12,Hue City,Hue City,0,3,3,0,0
2022-01-12,Hue City,Hue City,1,2,2,0,0
2022-01-12,Hue City,Hue City,3,2,1,1,0
2022-01-12,Hue City,Hue City,4,1,1,0,0
2022-01-12,Hue City,Hue City,5,2,1,1,0
2022-01-12,Hue City,Hue City,6,62,46,16,3
2022-01-12,Hue City,Hue City,7,202,194,8,1
2022-01-12,Hue City,Hue City,8,326,312,14,1
2022-01-12,Hue City,Hue City,9,275,256,19,0
2022-01-12,Hue City,Hue City,10,340,325,15,1
2022-01-12,Hue City,Hue City,11,759,717,42,5
2022-01-12,Hue City,Hue City,12,532,503,29,2
2022-01-12,Hue City,Hue City,13,324,315,9,0
2022-01-12,Hue City,Hue City,14,319,302,17,0
2022-01-12,Hue City,Hue City,15,399,380,19,0
2022-01-12,Hue City,Hue City,16,385,363,22,0
2022-01-12,Hue City,Hue City,17,574,533,41,1
2022-01-12,Hue City,Hue City,18,627,576,51,3
2022-01-12,Hue City,Hue City,19,568,516,52,1
2022-01-12,Hue City,Hue City,20,448,401,47,1
2022-01-12,Hue City,Hue City,21,226,187,39,4
2022-01-12,Hue City,Hue City,22,7,7,0,0
2022-01-12,Hue City,Huong Thuy,11,1,0,1,0
2022-01-12,Hue City,Huong Thuy,13,2,1,1,1
2022-01-12,Hue City,Huong Thuy,14,1,0,1,1
2022-01-12,Hue City,Huong Thuy,15,1,1,0,0
2022-01-12,Hue City,Huong Thuy,17,2,1,1,1
2022-01-12,Hue City,Huong Thuy,18,1,1,0,0
2022-01-12,Hue City,Huong Thuy,19,2,2,0,0
2022-01-12,Hue City,Huong Thuy,21,1,1,0,0
2022-01-12,Hue City,Huong Tra,12,1,1,0,0
2022-01-12,Hue City,Phu Vang,6,2,0,2,2
2022-01-12,Hue City,Phu Vang,7,1,1,0,0
2022-01-12,Hue City,Phu Vang,8,1,1,0,0
2022-01-12,Hue City,Phu Vang,9,1,1,0,0
2022-01-12,Hue City,Phu Vang,10,2,0,2,2
2022-01-12,Hue City,Phu Vang,11,1,0,1,1
2022-01-12,Hue City,Phu Vang,12,4,2,2,0
2022-01-12,Hue City,Phu Vang,13,1,0,1,0
2022-01-12,Hue City,Phu Vang,14,1,1,0,0
2022-01-12,Hue City,Phu Vang,15,2,2,0,0
2022-01-12,Hue City,Phu Vang,16,1,1,0,0
2022-01-12,Hue City,Phu Vang,17,2,2,0,0
2022-01-12,Hue City,Phu Vang,19,1,1,0,0
2022-01-12,Hue City,Phu Vang,20,1,1,0,0
2022-01-12,Vung Tau,Ba Ria City,8,6,3,3,3
2022-01-12,Vung Tau,Ba Ria City,9,4,4,0,0
2022-01-12,Vung Tau,Ba Ria City,10,3,2,1,1
2022-01-12,Vung Tau,Ba Ria City,11,7,3,4,4
2022-01-12,Vung Tau,Ba Ria City,12,8,3,5,5
2022-01-12,Vung Tau,Ba Ria City,13,7,6,1,1
2022-01-12,Vung Tau,Ba Ria City,14,6,6,0,0
2022-01-12,Vung Tau,Ba Ria City,15,5,4,1,1
2022-01-12,Vung Tau,Ba Ria City,16,6,4,2,2
2022-01-12,Vung Tau,Ba Ria City,17,3,1,2,0
2022-01-12,Vung Tau,Ba Ria City,18,5,3,2,0
2022-01-12,Vung Tau,Ba Ria City,19,6,2,4,1
2022-01-12,Vung Tau,Ba Ria City,20,3,2,1,1
2022-01-12,Vung Tau,Ba Ria City,21,1,0,1,1
2022-01-12,Vung Tau,Tan Thanh,10,1,0,1,1
2022-01-12,Vung Tau,Tan Thanh,19,1,0,1,1
2022-01-12,Vung Tau,Vung Tau City,0,1,1,0,0
2022-01-12,Vung Tau,Vung Tau City,1,1,1,0,0
2022-01-12,Vung Tau,Vung Tau City,4,1,1,0,0
2022-01-12,Vung Tau,Vung Tau City,5,1,1,0,0
2022-01-12,Vung Tau,Vung Tau City,6,41,34,7,4
2022-01-12,Vung Tau,Vung Tau City,7,104,94,10,5
2022-01-12,Vung Tau,Vung Tau City,8,145,141,4,0
2022-01-12,Vung Tau,Vung Tau City,9,142,137,5,0
2022-01-12,Vung Tau,Vung Tau City,10,186,175,11,0
2022-01-12,Vung Tau,Vung Tau City,11,338,317,21,1
2022-01-12,Vung Tau,Vung Tau City,12,255,242,13,3
2022-01-12,Vung Tau,Vung Tau City,13,212,190,22,5
2022-01-12,Vung Tau,Vung Tau City,14,234,217,17,0
2022-01-12,Vung Tau,Vung Tau City,15,217,205,12,0
2022-01-12,Vung Tau,Vung Tau City,16,206,199,7,0
2022-01-12,Vung Tau,Vung Tau City,17,241,230,11,0
2022-01-12,Vung Tau,Vung Tau City,18,280,267,13,0
2022-01-12,Vung Tau,Vung Tau City,19,230,216,14,0
2022-01-12,Vung Tau,Vung Tau City,20,175,150,25,5
2022-01-12,Vung Tau,Vung Tau City,21,95,73,22,8
2022-01-12,Vung Tau,Vung Tau City,22,2,1,1,0
2022-01-12,Vung Tau,Vung Tau City,23,1,1,0,0
2022-01-13,Binh Duong,Ben Cat,9,1,0,1,1
2022-01-13,Binh Duong,Ben Cat,11,2,0,2,2
2022-01-13,Binh Duong,Ben Cat,12,1,1,0,0
2022-01-13,Binh Duong,Ben Cat,17,2,0,2,2
2022-01-13,Binh Duong,Ben Cat,19,1,0,1,1
2022-01-13,Binh Duong,Ben Cat,20,1,0,1,1
2022-01-13,Binh Duong,Di An,7,7,3,4,4
2022-01-13,Binh Duong,Di An,8,5,1,4,3
2022-01-13,Binh Duong,Di An,9,19,7,12,10
2022-01-13,Binh Duong,Di An,10,17,12,5,4
2022-01-13,Binh Duong,Di An,11,33,21,12,8
2022-01-13,Binh Duong,Di An,12,30,20,10,4
2022-01-13,Binh Duong,Di An,13,20,12,8,6
2022-01-13,Binh Duong,Di An,14,13,8,5,4
2022-01-13,Binh Duong,Di An,15,13,12,1,1
2022-01-13,Binh Duong,Di An,16,19,13,6,6
2022-01-13,Binh Duong,Di An,17,29,12,17,6
2022-01-13,Binh Duong,Di An,18,14,11,3,1
2022-01-13,Binh Duong,Di An,19,7,7,0,0
2022-01-13,Binh Duong,Di An,20,9,4,5,4
2022-01-13,Binh Duong,Di An,21,8,2,6,5
2022-01-13,Binh Duong,Tan Uyen,9,1,0,1,1
2022-01-13,Binh Duong,Tan Uyen,11,5,3,2,2
2022-01-13,Binh Duong,Tan Uyen,12,1,0,1,0
2022-01-13,Binh Duong,Tan Uyen,13,2,1,1,1
2022-01-13,Binh Duong,Tan Uyen,14,2,2,0,0
2022-01-13,Binh Duong,Tan Uyen,15,1,1,0,0
2022-01-13,Binh Duong,Tan Uyen,16,1,1,0,0
2022-01-13,Binh Duong,Tan Uyen,18,2,1,1,0
2022-01-13,Binh Duong,Tan Uyen,20,2,0,2,2
2022-01-13,Binh Duong,Thu Dau Mot Town,2,1,1,0,0
2022-01-13,Binh Duong,Thu Dau Mot Town,4,1,1,0,0
2022-01-13,Binh Duong,Thu Dau Mot Town,5,1,1,0,0
2022-01-13,Binh Duong,Thu Dau Mot Town,6,25,22,3,1
2022-01-13,Binh Duong,Thu Dau Mot Town,7,111,99,12,5
2022-01-13,Binh Duong,Thu Dau Mot Town,8,197,185,12,1
2022-01-13,Binh Duong,Thu Dau Mot Town,9,212,207,5,0
2022-01-13,Binh Duong,Thu Dau Mot Town,10,316,308,8,0
2022-01-13,Binh Duong,Thu Dau Mot Town,11,604,568,36,10
2022-01-13,Binh Duong,Thu Dau Mot Town,12,413,392,21,3
2022-01-13,Binh Duong,Thu Dau Mot Town,13,382,366,16,3
2022-01-13,Binh Duong,Thu Dau Mot Town,14,302,284,18,0
2022-01-13,Binh Duong,Thu Dau Mot Town,15,269,249,20,1
2022-01-13,Binh Duong,Thu Dau Mot Town,16,242,230,12,1
2022-01-13,Binh Duong,Thu Dau Mot Town,17,336,314,22,5
2022-01-13,Binh Duong,Thu Dau Mot Town,18,345,328,17,5
2022-01-13,Binh Duong,Thu Dau Mot Town,19,301,279,22,3
2022-01-13,Binh Duong,Thu Dau Mot Town,20,216,191,25,6
2022-01-13,Binh Duong,Thu Dau Mot Town,21,98,76,22,2
2022-01-13,Binh Duong,Thu Dau Mot Town,22,2,1,1,0
2022-01-13,Binh Duong,Thuan An,6,3,0,3,3
2022-01-13,Binh Duong,Thuan An,7,6,0,6,6
2022-01-13,Binh Duong,Thuan An,8,13,8,5,1
2022-01-13,Binh Duong,Thuan An,9,33,23,10,8
2022-01-13,Binh Duong,Thuan An,10,56,37,19,17
2022-01-13,Binh Duong,Thuan An,11,64,51,13,9
2022-01-13,Binh Duong,Thuan An,12,68,57,11,3
2022-01-13,Binh Duong,Thuan An,13,66,50,16,11
2022-01-13,Binh Duong,Thuan An,14,38,29,9,7
2022-01-13,Binh Duong,Thuan An,15,36,34,2,0
2022-01-13,Binh Duong,Thuan An,16,37,30,7,6
2022-01-13,Binh Duong,Thuan An,17,34,25,9,4
2022-01-13,Binh Duong,Thuan An,18,37,26,11,5
2022-01-13,Binh Duong,Thuan An,19,28,19,9,8
2022-01-13,Binh Duong,Thuan An,20,38,19,19,11
2022-01-13,Binh Duong,Thuan An,21,17,0,17,15
2022-01-13,Can Tho City,Binh Thuy District,7,2,2,0,0
2022-01-13,Can Tho City,Binh Thuy District,8,7,7,0,0
2022-01-13,Can Tho City,Binh Thuy District,9,5,5,0,0
2022-01-13,Can Tho City,Binh Thuy District,10,7,7,0,0
2022-01-13,Can Tho City,Binh Thuy District,11,12,10,2,1
2022-01-13,Can Tho City,Binh Thuy District,12,10,10,0,0
2022-01-13,Can Tho City,Binh Thuy District,13,14,13,1,0
2022-01-13,Can Tho City,Binh Thuy District,14,9,7,2,0
2022-01-13,Can Tho City,Binh Thuy District,15,6,6,0,0
2022-01-13,Can Tho City,Binh Thuy District,16,12,12,0,0
2022-01-13,Can Tho City,Binh Thuy District,17,9,5,4,0
2022-01-13,Can Tho City,Binh Thuy District,18,8,8,0,0
2022-01-13,Can Tho City,Binh Thuy District,19,7,6,1,0
2022-01-13,Can Tho City,Binh Thuy District,20,6,5,1,0
2022-01-13,Can Tho City,Binh Thuy District,21,3,3,0,0
2022-01-13,Can Tho City,Cai Rang District,6,3,2,1,0
2022-01-13,Can Tho City,Cai Rang District,7,8,8,0,0
2022-01-13,Can Tho City,Cai Rang District,8,6,4,2,0
2022-01-13,Can Tho City,Cai Rang District,9,5,5,0,0
2022-01-13,Can Tho City,Cai Rang District,10,7,7,0,0
2022-01-13,Can Tho City,Cai Rang District,11,11,11,0,0
2022-01-13,Can Tho City,Cai Rang District,12,5,5,0,0
2022-01-13,Can Tho City,Cai Rang District,13,7,7,0,0
2022-01-13,Can Tho City,Cai Rang District,14,8,8,0,0
2022-01-13,Can Tho City,Cai Rang District,15,8,8,0,0
2022-01-13,Can Tho City,Cai Rang District,16,10,10,0,0
2022-01-13,Can Tho City,Cai Rang District,17,10,10,0,0
2022-01-13,Can Tho City,Cai Rang District,18,8,8,0,0
2022-01-13,Can Tho City,Cai Rang District,19,8,8,0,0
2022-01-13,Can Tho City,Cai Rang District,20,5,4,1,0
2022-01-13,Can Tho City,Cai Rang District,21,1,1,0,0
2022-01-13,Can Tho City,Ninh Kieu District,0,1,1,0,0
2022-01-13,Can Tho City,Ninh Kieu District,1,1,1,0,0
2022-01-13,Can Tho City,Ninh Kieu District,2,1,1,0,0
2022-01-13,Can Tho City,Ninh Kieu District,3,1,1,0,0
2022-01-13,Can Tho City,Ninh Kieu District,4,2,2,0,0
2022-01-13,Can Tho City,Ninh Kieu District,5,4,2,2,0
2022-01-13,Can Tho City,Ninh Kieu District,6,47,47,0,0
2022-01-13,Can Tho City,Ninh Kieu District,7,163,155,8,0
2022-01-13,Can Tho City,Ninh Kieu District,8,268,257,11,0
2022-01-13,Can Tho City,Ninh Kieu District,9,283,267,16,0
2022-01-13,Can Tho City,Ninh Kieu District,10,477,459,18,0
2022-01-13,Can Tho City,Ninh Kieu District,11,791,762,29,0
2022-01-13,Can Tho City,Ninh Kieu District,12,546,524,22,0
2022-01-13,Can Tho City,Ninh Kieu District,13,481,461,20,0
2022-01-13,Can Tho City,Ninh Kieu District,14,357,342,15,0
2022-01-13,Can Tho City,Ninh Kieu District,15,357,341,16,0
2022-01-13,Can Tho City,Ninh Kieu District,16,405,386,19,0
2022-01-13,Can Tho City,Ninh Kieu District,17,454,432,22,0
2022-01-13,Can Tho City,Ninh Kieu District,18,477,461,16,0
2022-01-13,Can Tho City,Ninh Kieu District,19,384,359,25,0
2022-01-13,Can Tho City,Ninh Kieu District,20,279,260,19,0
2022-01-13,Can Tho City,Ninh Kieu District,21,161,136,25,0
2022-01-13,Can Tho City,Ninh Kieu District,22,8,7,1,0
2022-01-13,Can Tho City,Ninh Kieu District,23,3,1,2,0
2022-01-13,Dong Nai,Bien Hoa City,0,1,1,0,0
2022-01-13,Dong Nai,Bien Hoa City,2,2,2,0,0
2022-01-13,Dong Nai,Bien Hoa City,5,1,0,1,0
2022-01-13,Dong Nai,Bien Hoa City,6,53,35,18,12
2022-01-13,Dong Nai,Bien Hoa City,7,180,153,27,18
2022-01-13,Dong Nai,Bien Hoa City,8,298,262,36,9
2022-01-13,Dong Nai,Bien Hoa City,9,396,362,34,10
2022-01-13,Dong Nai,Bien Hoa City,10,687,638,49,2
2022-01-13,Dong Nai,Bien Hoa City,11,1065,990,75,11
2022-01-13,Dong Nai,Bien Hoa City,12,768,725,43,3
2022-01-13,Dong Nai,Bien Hoa City,13,715,671,44,7
2022-01-13,Dong Nai,Bien Hoa City,14,589,556,33,10
2022-01-13,Dong Nai,Bien Hoa City,15,483,454,29,7
2022-01-13,Dong Nai,Bien Hoa City,16,439,407,32,2
2022-01-13,Dong Nai,Bien Hoa City,17,584,550,34,3
2022-01-13,Dong Nai,Bien Hoa City,18,624,572,52,12
2022-01-13,Dong Nai,Bien Hoa City,19,577,523,54,9
2022-01-13,Dong Nai,Bien Hoa City,20,429,361,68,26
2022-01-13,Dong Nai,Bien Hoa City,21,185,137,48,19
2022-01-13,Dong Nai,Bien Hoa City,23,2,0,2,0
2022-01-13,Dong Nai,Cam My,20,1,0,1,1
2022-01-13,Dong Nai,Long Thanh,9,1,0,1,1
2022-01-13,Dong Nai,Long Thanh,10,2,0,2,2
2022-01-13,Dong Nai,Long Thanh,11,1,0,1,1
2022-01-13,Dong Nai,Long Thanh,17,1,0,1,0
2022-01-13,Dong Nai,Thong Nhat,9,1,1,0,0
2022-01-13,Dong Nai,Thong Nhat,10,1,1,0,0
2022-01-13,Dong Nai,Thong Nhat,11,1,1,0,0
2022-01-13,Dong Nai,Thong Nhat,12,2,2,0,0
2022-01-13,Dong Nai,Thong Nhat,13,1,1,0,0
2022-01-13,Dong Nai,Thong Nhat,14,4,3,1,0
2022-01-13,Dong Nai,Thong Nhat,17,1,1,0,0
2022-01-13,Dong Nai,Trang Bom,10,1,0,1,1
2022-01-13,Dong Nai,Trang Bom,13,1,0,1,1
2022-01-13,Dong Nai,Trang Bom,15,3,0,3,2
2022-01-13,Dong Nai,Trang Bom,16,1,0,1,1
2022-01-13,Dong Nai,Trang Bom,19,1,0,1,1
2022-01-13,Dong Nai,Trang Bom,20,1,0,1,1
2022-01-13,Dong Nai,Vinh Cuu,7,1,0,1,1
2022-01-13,Hai Phong City,An Duong,7,1,1,0,0
2022-01-13,Hai Phong City,An Duong,8,2,2,0,0
2022-01-13,Hai Phong City,An Duong,9,1,1,0,0
2022-01-13,Hai Phong City,An Duong,10,2,0,2,1
2022-01-13,Hai Phong City,An Duong,11,1,1,0,0
2022-01-13,Hai Phong City,An Duong,12,3,2,1,0
2022-01-13,Hai Phong City,An Duong,13,4,4,0,0
2022-01-13,Hai Phong City,An Duong,14,2,1,1,1
2022-01-13,Hai Phong City,An Duong,15,6,3,3,0
2022-01-13,Hai Phong City,An Duong,16,2,2,0,0
2022-01-13,Hai Phong City,An Duong,17,2,0,2,1
2022-01-13,Hai Phong City,An Duong,18,3,1,2,1
2022-01-13,Hai Phong City,An Duong,19,3,1,2,0
2022-01-13,Hai Phong City,An Duong,20,3,1,2,2
2022-01-13,Hai Phong City,Duong Kinh District,12,1,0,1,1
2022-01-13,Hai Phong City,Duong Kinh District,13,3,1,2,2
2022-01-13,Hai Phong City,Duong Kinh District,15,1,0,1,1
2022-01-13,Hai Phong City,Hai An District,7,4,4,0,0
2022-01-13,Hai Phong City,Hai An District,8,11,10,1,0
2022-01-13,Hai Phong City,Hai An District,9,8,6,2,0
2022-01-13,Hai Phong City,Hai An District,10,23,22,1,0
2022-01-13,Hai Phong City,Hai An District,11,50,44,6,1
2022-01-13,Hai Phong City,Hai An District,12,38,31,7,1
2022-01-13,Hai Phong City,Hai An District,13,15,14,1,0
2022-01-13,Hai Phong City,Hai An District,14,9,8,1,0
2022-01-13,Hai Phong City,Hai An District,15,17,12,5,0
2022-01-13,Hai Phong City,Hai An District,16,16,13,3,0
2022-01-13,Hai Phong City,Hai An District,17,17,16,1,0
2022-01-13,Hai Phong City,Hai An District,18,29,25,4,1
2022-01-13,Hai Phong City,Hai An District,19,31,27,4,2
2022-01-13,Hai Phong City,Hai An District,20,20,18,2,0
2022-01-13,Hai Phong City,Hai An District,21,4,4,0,0
2022-01-13,Hai Phong City,Hong Bang District,0,1,0,1,0
2022-01-13,Hai Phong City,Hong Bang District,1,2,2,0,0
2022-01-13,Hai Phong City,Hong Bang District,2,1,1,0,0
2022-01-13,Hai Phong City,Hong Bang District,4,1,1,0,0
2022-01-13,Hai Phong City,Hong Bang District,6,3,1,2,1
2022-01-13,Hai Phong City,Hong Bang District,7,21,14,7,3
2022-01-13,Hai Phong City,Hong Bang District,8,51,47,4,1
2022-01-13,Hai Phong City,Hong Bang District,9,32,28,4,0
2022-01-13,Hai Phong City,Hong Bang District,10,82,71,11,1
2022-01-13,Hai Phong City,Hong Bang District,11,130,118,12,4
2022-01-13,Hai Phong City,Hong Bang District,12,83,77,6,0
2022-01-13,Hai Phong City,Hong Bang District,13,46,43,3,1
2022-01-13,Hai Phong City,Hong Bang District,14,40,37,3,1
2022-01-13,Hai Phong City,Hong Bang District,15,55,49,6,0
2022-01-13,Hai Phong City,Hong Bang District,16,50,44,6,2
2022-01-13,Hai Phong City,Hong Bang District,17,55,50,5,0
2022-01-13,Hai Phong City,Hong Bang District,18,69,67,2,0
2022-01-13,Hai Phong City,Hong Bang District,19,72,66,6,0
2022-01-13,Hai Phong City,Hong Bang District,20,39,37,2,0
2022-01-13,Hai Phong City,Hong Bang District,21,28,21,7,1
2022-01-13,Hai Phong City,Kien An District,7,1,0,1,0
2022-01-13,Hai Phong City,Kien An District,8,4,1,3,3
2022-01-13,Hai Phong City,Kien An District,9,7,2,5,4
2022-01-13,Hai Phong City,Kien An District,10,6,3,3,3
2022-01-13,Hai Phong City,Kien An District,11,12,11,1,1
2022-01-13,Hai Phong City,Kien An District,12,15,9,6,4
2022-01-13,Hai Phong City,Kien An District,13,7,4,3,2
2022-01-13,Hai Phong City,Kien An District,14,11,7,4,3
2022-01-13,Hai Phong City,Kien An District,15,16,11,5,4
2022-01-13,Hai Phong City,Kien An District,16,11,7,4,3
2022-01-13,Hai Phong City,Kien An District,17,8,7,1,1
2022-01-13,Hai Phong City,Kien An District,18,12,9,3,1
2022-01-13,Hai Phong City,Kien An District,19,2,1,1,0
2022-01-13,Hai Phong City,Kien An District,20,8,4,4,4
2022-01-13,Hai Phong City,Kien An District,21,1,1,0,0
2022-01-13,Hai Phong City,Kien An District,22,1,1,0,0
2022-01-13,Hai Phong City,Le Chan District,1,2,1,1,0
2022-01-13,Hai Phong City,Le Chan District,4,1,1,0,0
2022-01-13,Hai Phong City,Le Chan District,6,6,3,3,3
2022-01-13,Hai Phong City,Le Chan District,7,45,38,7,3
2022-01-13,Hai Phong City,Le Chan District,8,83,79,4,0
2022-01-13,Hai Phong City,Le Chan District,9,94,84,10,2
2022-01-13,Hai Phong City,Le Chan District,10,184,160,24,0
2022-01-13,Hai Phong City,Le Chan District,11,363,320,43,11
2022-01-13,Hai Phong City,Le Chan District,12,255,232,23,1
2022-01-13,Hai Phong City,Le Chan District,13,110,103,7,0
2022-01-13,Hai Phong City,Le Chan District,14,157,147,10,1
2022-01-13,Hai Phong City,Le Chan District,15,178,155,23,3
2022-01-13,Hai Phong City,Le Chan District,16,169,146,23,1
2022-01-13,Hai Phong City,Le Chan District,17,217,191,26,1
2022-01-13,Hai Phong City,Le Chan District,18,271,241,30,6
2022-01-13,Hai Phong City,Le Chan District,19,227,204,23,2
2022-01-13,Hai Phong City,Le Chan District,20,159,140,19,0
2022-01-13,Hai Phong City,Le Chan District,21,75,56,19,2
2022-01-13,Hai Phong City,Le Chan District,22,1,0,1,0
2022-01-13,Hai Phong City,Ngo Quyen District,0,1,1,0,0
2022-01-13,Hai Phong City,Ngo Quyen District,5,1,1,0,0
2022-01-13,Hai Phong City,Ngo Quyen District,6,1,0,1,1
2022-01-13,Hai Phong City,Ngo Quyen District,7,35,28,7,3
2022-01-13,Hai Phong City,Ngo Quyen District,8,99,85,14,0
2022-01-13,Hai Phong City,Ngo Quyen District,9,83,74,9,0
2022-01-13,Hai Phong City,Ngo Quyen District,10,126,115,11,0
2022-01-13,Hai Phong City,Ngo Quyen District,11,275,248,27,7
2022-01-13,Hai Phong City,Ngo Quyen District,12,195,172,23,6
2022-01-13,Hai Phong City,Ngo Quyen District,13,127,112,15,0
2022-01-13,Hai Phong City,Ngo Quyen District,14,147,131,16,0
2022-01-13,Hai Phong City,Ngo Quyen District,15,166,156,10,1
2022-01-13,Hai Phong City,Ngo Quyen District,16,163,147,16,0
2022-01-13,Hai Phong City,Ngo Quyen District,17,186,175,11,1
2022-01-13,Hai Phong City,Ngo Quyen District,18,233,202,31,2
2022-01-13,Hai Phong City,Ngo Quyen District,19,205,188,17,1
2022-01-13,Hai Phong City,Ngo Quyen District,20,142,126,16,0
2022-01-13,Hai Phong City,Ngo Quyen District,21,76,53,23,5
2022-01-13,Hai Phong City,Ngo Quyen District,22,2,0,2,0
2022-01-13,Hai Phong City,Ngo Quyen District,23,3,2,1,0
2022-01-13,Hai Phong City,Thuy Nguyen,10,4,0,4,4
2022-01-13,Hai Phong City,Thuy Nguyen,11,1,0,1,1
2022-01-13,Hai Phong City,Thuy Nguyen,14,2,0,2,2
2022-01-13,Hai Phong City,Thuy Nguyen,15,1,0,1,1
2022-01-13,Hai Phong City,Thuy Nguyen,16,1,0,1,1
2022-01-13,Hai Phong City,Thuy Nguyen,17,1,0,1,1
2022-01-13,Hai Phong City,Thuy Nguyen,18,1,0,1,1
2022-01-13,Hai Phong City,Thuy Nguyen,19,1,1,0,0
2022-01-13,Hue City,Hue City,0,4,4,0,0
2022-01-13,Hue City,Hue City,1,1,1,0,0
2022-01-13,Hue City,Hue City,2,3,3,0,0
2022-01-13,Hue City,Hue City,3,1,1,0,0
2022-01-13,Hue City,Hue City,4,1,1,0,0
2022-01-13,Hue City,Hue City,5,2,2,0,0
2022-01-13,Hue City,Hue City,6,68,61,7,1
2022-01-13,Hue City,Hue City,7,225,209,16,1
2022-01-13,Hue City,Hue City,8,359,341,18,1
2022-01-13,Hue City,Hue City,9,249,238,11,0
2022-01-13,Hue City,Hue City,10,365,347,18,0
2022-01-13,Hue City,Hue City,11,784,757,27,1
2022-01-13,Hue City,Hue City,12,493,467,26,2
2022-01-13,Hue City,Hue City,13,303,287,16,0
2022-01-13,Hue City,Hue City,14,357,331,26,1
2022-01-13,Hue City,Hue City,15,401,385,16,0
2022-01-13,Hue City,Hue City,16,420,394,26,1
2022-01-13,Hue City,Hue City,17,551,524,27,1
2022-01-13,Hue City,Hue City,18,620,571,49,5
2022-01-13,Hue City,Hue City,19,567,512,55,6
2022-01-13,Hue City,Hue City,20,402,371,31,3
2022-01-13,Hue City,Hue City,21,195,170,25,0
2022-01-13,Hue City,Hue City,22,2,2,0,0
2022-01-13,Hue City,Hue City,23,2,2,0,0
2022-01-13,Hue City,Huong Thuy,10,2,1,1,0
2022-01-13,Hue City,Huong Thuy,11,1,0,1,0
2022-01-13,Hue City,Huong Thuy,14,3,0,3,2
2022-01-13,Hue City,Huong Thuy,15,1,1,0,0
2022-01-13,Hue City,Huong Thuy,17,3,1,2,0
2022-01-13,Hue City,Huong Thuy,18,2,1,1,0
2022-01-13,Hue City,Huong Thuy,19,2,1,1,0
2022-01-13,Hue City,Huong Thuy,21,1,0,1,0
2022-01-13,Hue City,Huong Tra,17,1,1,0,0
2022-01-13,Hue City,Huong Tra,18,1,1,0,0
2022-01-13,Hue City,Huong Tra,21,1,1,0,0
2022-01-13,Hue City,Phu Vang,7,3,3,0,0
2022-01-13,Hue City,Phu Vang,8,1,1,0,0
2022-01-13,Hue City,Phu Vang,10,1,1,0,0
2022-01-13,Hue City,Phu Vang,11,2,1,1,0
2022-01-13,Hue City,Phu Vang,15,2,2,0,0
2022-01-13,Hue City,Phu Vang,16,2,2,0,0
2022-01-13,Hue City,Phu Vang,18,1,1,0,0
2022-01-13,Vung Tau,Ba Ria City,8,6,0,6,2
2022-01-13,Vung Tau,Ba Ria City,9,11,5,6,5
2022-01-13,Vung Tau,Ba Ria City,10,2,2,0,0
2022-01-13,Vung Tau,Ba Ria City,11,8,4,4,3
2022-01-13,Vung Tau,Ba Ria City,12,7,4,3,3
2022-01-13,Vung Tau,Ba Ria City,13,15,4,11,7
2022-01-13,Vung Tau,Ba Ria City,14,10,2,8,6
2022-01-13,Vung Tau,Ba Ria City,15,4,1,3,3
2022-01-13,Vung Tau,Ba Ria City,16,2,2,0,0
2022-01-13,Vung Tau,Ba Ria City,17,13,5,8,6
2022-01-13,Vung Tau,Ba Ria City,18,10,4,6,5
2022-01-13,Vung Tau,Ba Ria City,19,5,1,4,4
2022-01-13,Vung Tau,Tan Thanh,15,1,0,1,1
2022-01-13,Vung Tau,Tan Thanh,16,1,0,1,1
2022-01-13,Vung Tau,Vung Tau City,0,1,1,0,0
2022-01-13,Vung Tau,Vung Tau City,1,1,1,0,0
2022-01-13,Vung Tau,Vung Tau City,6,52,48,4,0
2022-01-13,Vung Tau,Vung Tau City,7,109,105,4,0
2022-01-13,Vung Tau,Vung Tau City,8,176,168,8,2
2022-01-13,Vung Tau,Vung Tau City,9,168,157,11,0
2022-01-13,Vung Tau,Vung Tau City,10,205,192,13,2
2022-01-13,Vung Tau,Vung Tau City,11,362,338,24,2
2022-01-13,Vung Tau,Vung Tau City,12,231,217,14,0
2022-01-13,Vung Tau,Vung Tau City,13,207,194,13,0
2022-01-13,Vung Tau,Vung Tau City,14,189,179,10,2
2022-01-13,Vung Tau,Vung Tau City,15,218,199,19,0
2022-01-13,Vung Tau,Vung Tau City,16,202,188,14,0
2022-01-13,Vung Tau,Vung Tau City,17,251,240,11,1
2022-01-13,Vung Tau,Vung Tau City,18,324,303,21,2
2022-01-13,Vung Tau,Vung Tau City,19,228,209,19,2
2022-01-13,Vung Tau,Vung Tau City,20,172,158,14,1
2022-01-13,Vung Tau,Vung Tau City,21,87,76,11,3
2022-01-13,Vung Tau,Vung Tau City,22,2,2,0,0
2022-01-13,Vung Tau,Vung Tau City,23,1,1,0,0
2022-01-14,Binh Duong,Ben Cat,9,1,1,0,0
2022-01-14,Binh Duong,Bàu Bàng,16,1,0,1,1
2022-01-14,Binh Duong,Di An,6,2,0,2,2
2022-01-14,Binh Duong,Di An,7,4,3,1,1
2022-01-14,Binh Duong,Di An,8,14,4,10,6
2022-01-14,Binh Duong,Di An,9,19,7,12,9
2022-01-14,Binh Duong,Di An,10,27,12,15,12
2022-01-14,Binh Duong,Di An,11,45,18,27,26
2022-01-14,Binh Duong,Di An,12,46,24,22,18
2022-01-14,Binh Duong,Di An,13,22,7,15,15
2022-01-14,Binh Duong,Di An,14,34,16,18,14
2022-01-14,Binh Duong,Di An,15,12,8,4,3
2022-01-14,Binh Duong,Di An,16,14,11,3,2
2022-01-14,Binh Duong,Di An,17,12,10,2,2
2022-01-14,Binh Duong,Di An,18,19,14,5,3
2022-01-14,Binh Duong,Di An,19,16,12,4,3
2022-01-14,Binh Duong,Di An,20,10,5,5,4
2022-01-14,Binh Duong,Di An,21,2,1,1,1
2022-01-14,Binh Duong,Di An,22,1,1,0,0
2022-01-14,Binh Duong,Tan Uyen,9,1,0,1,1
2022-01-14,Binh Duong,Tan Uyen,10,1,0,1,0
2022-01-14,Binh Duong,Tan Uyen,11,2,2,0,0
2022-01-14,Binh Duong,Tan Uyen,12,1,0,1,0
2022-01-14,Binh Duong,Tan Uyen,13,1,1,0,0
2022-01-14,Binh Duong,Tan Uyen,14,2,2,0,0
2022-01-14,Binh Duong,Tan Uyen,16,1,1,0,0
2022-01-14,Binh Duong,Tan Uyen,18,1,1,0,0
2022-01-14,Binh Duong,Tan Uyen,19,1,0,1,1
2022-01-14,Binh Duong,Tan Uyen,20,1,1,0,0
2022-01-14,Binh Duong,Thu Dau Mot Town,0,1,1,0,0
2022-01-14,Binh Duong,Thu Dau Mot Town,2,1,0,1,0
2022-01-14,Binh Duong,Thu Dau Mot Town,5,1,0,1,1
2022-01-14,Binh Duong,Thu Dau Mot Town,6,30,26,4,3
2022-01-14,Binh Duong,Thu Dau Mot Town,7,116,103,13,3
2022-01-14,Binh Duong,Thu Dau Mot Town,8,203,190,13,0
2022-01-14,Binh Duong,Thu Dau Mot Town,9,241,231,10,0
2022-01-14,Binh Duong,Thu Dau Mot Town,10,386,370,16,3
2022-01-14,Binh Duong,Thu Dau Mot Town,11,643,603,40,8
2022-01-14,Binh Duong,Thu Dau Mot Town,12,424,407,17,1
2022-01-14,Binh Duong,Thu Dau Mot Town,13,401,375,26,1
2022-01-14,Binh Duong,Thu Dau Mot Town,14,340,324,16,2
2022-01-14,Binh Duong,Thu Dau Mot Town,15,243,227,16,4
2022-01-14,Binh Duong,Thu Dau Mot Town,16,257,247,10,3
2022-01-14,Binh Duong,Thu Dau Mot Town,17,344,332,12,0
2022-01-14,Binh Duong,Thu Dau Mot Town,18,342,329,13,0
2022-01-14,Binh Duong,Thu Dau Mot Town,19,293,275,18,5
2022-01-14,Binh Duong,Thu Dau Mot Town,20,209,190,19,3
2022-01-14,Binh Duong,Thu Dau Mot Town,21,109,97,12,2
2022-01-14,Binh Duong,Thu Dau Mot Town,22,3,0,3,0
2022-01-14,Binh Duong,Thu Dau Mot Town,23,1,1,0,0
2022-01-14,Binh Duong,Thuan An,6,3,2,1,1
2022-01-14,Binh Duong,Thuan An,7,7,1,6,5
2022-01-14,Binh Duong,Thuan An,8,11,4,7,4
2022-01-14,Binh Duong,Thuan An,9,43,18,25,20
2022-01-14,Binh Duong,Thuan An,10,62,36,26,23
2022-01-14,Binh Duong,Thuan An,11,107,52,55,48
2022-01-14,Binh Duong,Thuan An,12,81,50,31,23
2022-01-14,Binh Duong,Thuan An,13,79,46,33,28
2022-01-14,Binh Duong,Thuan An,14,37,34,3,0
2022-01-14,Binh Duong,Thuan An,15,39,33,6,1
2022-01-14,Binh Duong,Thuan An,16,18,16,2,0
2022-01-14,Binh Duong,Thuan An,17,44,35,9,7
2022-01-14,Binh Duong,Thuan An,18,32,23,9,6
2022-01-14,Binh Duong,Thuan An,19,35,21,14,10
2022-01-14,Binh Duong,Thuan An,20,26,11,15,12
2022-01-14,Binh Duong,Thuan An,21,12,4,8,4
2022-01-14,Binh Duong,Thuan An,22,1,1,0,0
2022-01-14,Can Tho City,Binh Thuy District,6,1,1,0,0
2022-01-14,Can Tho City,Binh Thuy District,7,1,1,0,0
2022-01-14,Can Tho City,Binh Thuy District,8,4,2,2,0
2022-01-14,Can Tho City,Binh Thuy District,9,6,5,1,0
2022-01-14,Can Tho City,Binh Thuy District,10,7,7,0,0
2022-01-14,Can Tho City,Binh Thuy District,11,20,19,1,0
2022-01-14,Can Tho City,Binh Thuy District,12,3,3,0,0
2022-01-14,Can Tho City,Binh Thuy District,13,9,9,0,0
2022-01-14,Can Tho City,Binh Thuy District,14,12,12,0,0
2022-01-14,Can Tho City,Binh Thuy District,15,14,14,0,0
2022-01-14,Can Tho City,Binh Thuy District,16,7,7,0,0
2022-01-14,Can Tho City,Binh Thuy District,17,9,7,2,0
2022-01-14,Can Tho City,Binh Thuy District,18,13,12,1,0
2022-01-14,Can Tho City,Binh Thuy District,19,9,7,2,0
2022-01-14,Can Tho City,Binh Thuy District,20,7,6,1,0
2022-01-14,Can Tho City,Binh Thuy District,21,4,4,0,0
2022-01-14,Can Tho City,Cai Rang District,6,2,2,0,0
2022-01-14,Can Tho City,Cai Rang District,7,1,1,0,0
2022-01-14,Can Tho City,Cai Rang District,8,5,5,0,0
2022-01-14,Can Tho City,Cai Rang District,9,5,5,0,0
2022-01-14,Can Tho City,Cai Rang District,10,7,7,0,0
2022-01-14,Can Tho City,Cai Rang District,11,14,12,2,0
2022-01-14,Can Tho City,Cai Rang District,12,5,4,1,0
2022-01-14,Can Tho City,Cai Rang District,13,7,7,0,0
2022-01-14,Can Tho City,Cai Rang District,14,10,9,1,0
2022-01-14,Can Tho City,Cai Rang District,15,7,7,0,0
2022-01-14,Can Tho City,Cai Rang District,16,11,11,0,0
2022-01-14,Can Tho City,Cai Rang District,17,6,6,0,0
2022-01-14,Can Tho City,Cai Rang District,18,5,5,0,0
2022-01-14,Can Tho City,Cai Rang District,19,3,3,0,0
2022-01-14,Can Tho City,Cai Rang District,20,4,4,0,0
2022-01-14,Can Tho City,Cai Rang District,21,1,1,0,0
2022-01-14,Can Tho City,Ninh Kieu District,0,7,7,0,0
2022-01-14,Can Tho City,Ninh Kieu District,1,3,3,0,0
2022-01-14,Can Tho City,Ninh Kieu District,4,1,1,0,0
2022-01-14,Can Tho City,Ninh Kieu District,5,4,2,2,0
2022-01-14,Can Tho City,Ninh Kieu District,6,63,57,6,0
2022-01-14,Can Tho City,Ninh Kieu District,7,153,142,11,0
2022-01-14,Can Tho City,Ninh Kieu District,8,250,240,10,0
2022-01-14,Can Tho City,Ninh Kieu District,9,311,301,10,0
2022-01-14,Can Tho City,Ninh Kieu District,10,512,488,24,0
2022-01-14,Can Tho City,Ninh Kieu District,11,856,824,32,0
2022-01-14,Can Tho City,Ninh Kieu District,12,515,487,28,0
2022-01-14,Can Tho City,Ninh Kieu District,13,440,416,24,0
2022-01-14,Can Tho City,Ninh Kieu District,14,403,380,23,0
2022-01-14,Can Tho City,Ninh Kieu District,15,371,360,11,0
2022-01-14,Can Tho City,Ninh Kieu District,16,369,349,20,0
2022-01-14,Can Tho City,Ninh Kieu District,17,456,444,12,0
2022-01-14,Can Tho City,Ninh Kieu District,18,477,455,22,1
2022-01-14,Can Tho City,Ninh Kieu District,19,398,377,21,0
2022-01-14,Can Tho City,Ninh Kieu District,20,291,274,17,0
2022-01-14,Can Tho City,Ninh Kieu District,21,142,125,17,0
2022-01-14,Can Tho City,Ninh Kieu District,22,5,4,1,0
2022-01-14,Can Tho City,Ninh Kieu District,23,3,3,0,0
2022-01-14,Dong Nai,Bien Hoa City,0,3,2,1,0
2022-01-14,Dong Nai,Bien Hoa City,1,1,1,0,0
2022-01-14,Dong Nai,Bien Hoa City,2,5,3,2,0
2022-01-14,Dong Nai,Bien Hoa City,3,1,1,0,0
2022-01-14,Dong Nai,Bien Hoa City,4,3,1,2,0
2022-01-14,Dong Nai,Bien Hoa City,6,60,41,19,12
2022-01-14,Dong Nai,Bien Hoa City,7,154,139,15,8
2022-01-14,Dong Nai,Bien Hoa City,8,287,260,27,3
2022-01-14,Dong Nai,Bien Hoa City,9,389,347,42,4
2022-01-14,Dong Nai,Bien Hoa City,10,684,621,63,3
2022-01-14,Dong Nai,Bien Hoa City,11,1121,1047,74,9
2022-01-14,Dong Nai,Bien Hoa City,12,777,733,44,0
2022-01-14,Dong Nai,Bien Hoa City,13,800,756,44,7
2022-01-14,Dong Nai,Bien Hoa City,14,634,606,28,4
2022-01-14,Dong Nai,Bien Hoa City,15,511,467,44,9
2022-01-14,Dong Nai,Bien Hoa City,16,494,465,29,3
2022-01-14,Dong Nai,Bien Hoa City,17,611,571,40,6
2022-01-14,Dong Nai,Bien Hoa City,18,654,577,77,15
2022-01-14,Dong Nai,Bien Hoa City,19,565,506,59,8
2022-01-14,Dong Nai,Bien Hoa City,20,472,398,74,21
2022-01-14,Dong Nai,Bien Hoa City,21,223,161,62,19
2022-01-14,Dong Nai,Bien Hoa City,22,1,0,1,0
2022-01-14,Dong Nai,Bien Hoa City,23,3,2,1,0
2022-01-14,Dong Nai,Cam My,10,1,0,1,1
2022-01-14,Dong Nai,Long Thanh,11,1,0,1,1
2022-01-14,Dong Nai,Long Thanh,16,1,0,1,1
2022-01-14,Dong Nai,Long Thanh,17,1,0,1,1
2022-01-14,Dong Nai,Long Thanh,19,1,0,1,1
2022-01-14,Dong Nai,Thong Nhat,8,3,3,0,0
2022-01-14,Dong Nai,Thong Nhat,9,1,1,0,0
2022-01-14,Dong Nai,Thong Nhat,13,3,3,0,0
2022-01-14,Dong Nai,Thong Nhat,14,1,1,0,0
2022-01-14,Dong Nai,Thong Nhat,16,1,1,0,0
2022-01-14,Dong Nai,Thong Nhat,17,1,1,0,0
2022-01-14,Dong Nai,Trang Bom,13,1,0,1,1
2022-01-14,Dong Nai,Trang Bom,21,2,0,2,2
2022-01-14,Hai Phong City,An Duong,7,1,0,1,1
2022-01-14,Hai Phong City,An Duong,8,3,2,1,0
2022-01-14,Hai Phong City,An Duong,9,1,0,1,1
2022-01-14,Hai Phong City,An Duong,10,2,0,2,1
2022-01-14,Hai Phong City,An Duong,11,3,3,0,0
2022-01-14,Hai Phong City,An Duong,13,1,1,0,0
2022-01-14,Hai Phong City,An Duong,14,3,2,1,0
2022-01-14,Hai Phong City,An Duong,15,5,2,3,2
2022-01-14,Hai Phong City,An Duong,16,5,4,1,0
2022-01-14,Hai Phong City,An Duong,17,2,1,1,0
2022-01-14,Hai Phong City,An Duong,18,2,2,0,0
2022-01-14,Hai Phong City,An Duong,19,4,1,3,1
2022-01-14,Hai Phong City,An Duong,21,1,1,0,0
2022-01-14,Hai Phong City,Duong Kinh District,12,2,0,2,2
2022-01-14,Hai Phong City,Duong Kinh District,13,1,0,1,1
2022-01-14,Hai Phong City,Hai An District,7,7,4,3,1
2022-01-14,Hai Phong City,Hai An District,8,19,17,2,0
2022-01-14,Hai Phong City,Hai An District,9,9,8,1,0
2022-01-14,Hai Phong City,Hai An District,10,22,17,5,1
2022-01-14,Hai Phong City,Hai An District,11,57,53,4,2
2022-01-14,Hai Phong City,Hai An District,12,24,21,3,0
2022-01-14,Hai Phong City,Hai An District,13,15,13,2,0
2022-01-14,Hai Phong City,Hai An District,14,17,13,4,0
2022-01-14,Hai Phong City,Hai An District,15,17,14,3,0
2022-01-14,Hai Phong City,Hai An District,16,13,9,4,0
2022-01-14,Hai Phong City,Hai An District,17,27,20,7,3
2022-01-14,Hai Phong City,Hai An District,18,31,26,5,2
2022-01-14,Hai Phong City,Hai An District,19,23,19,4,1
2022-01-14,Hai Phong City,Hai An District,20,16,15,1,0
2022-01-14,Hai Phong City,Hai An District,21,14,11,3,1
2022-01-14,Hai Phong City,Hong Bang District,4,1,1,0,0
2022-01-14,Hai Phong City,Hong Bang District,7,15,11,4,1
2022-01-14,Hai Phong City,Hong Bang District,8,42,36,6,0
2022-01-14,Hai Phong City,Hong Bang District,9,36,30,6,0
2022-01-14,Hai Phong City,Hong Bang District,10,70,65,5,0
2022-01-14,Hai Phong City,Hong Bang District,11,156,142,14,3
2022-01-14,Hai Phong City,Hong Bang District,12,79,70,9,2
2022-01-14,Hai Phong City,Hong Bang District,13,44,38,6,0
2022-01-14,Hai Phong City,Hong Bang District,14,57,54,3,1
2022-01-14,Hai Phong City,Hong Bang District,15,52,49,3,0
2022-01-14,Hai Phong City,Hong Bang District,16,52,44,8,1
2022-01-14,Hai Phong City,Hong Bang District,17,52,49,3,0
2022-01-14,Hai Phong City,Hong Bang District,18,76,65,11,4
2022-01-14,Hai Phong City,Hong Bang District,19,70,63,7,1
2022-01-14,Hai Phong City,Hong Bang District,20,75,60,15,2
2022-01-14,Hai Phong City,Hong Bang District,21,18,10,8,2
2022-01-14,Hai Phong City,Hong Bang District,22,1,1,0,0
2022-01-14,Hai Phong City,Kien An District,6,2,1,1,0
2022-01-14,Hai Phong City,Kien An District,7,5,0,5,5
2022-01-14,Hai Phong City,Kien An District,8,10,1,9,8
2022-01-14,Hai Phong City,Kien An District,9,18,0,18,13
2022-01-14,Hai Phong City,Kien An District,10,11,5,6,3
2022-01-14,Hai Phong City,Kien An District,11,12,7,5,2
2022-01-14,Hai Phong City,Kien An District,12,16,8,8,5
2022-01-14,Hai Phong City,Kien An District,13,5,5,0,0
2022-01-14,Hai Phong City,Kien An District,14,11,7,4,2
2022-01-14,Hai Phong City,Kien An District,15,10,8,2,2
2022-01-14,Hai Phong City,Kien An District,16,9,5,4,1
2022-01-14,Hai Phong City,Kien An District,17,5,4,1,0
2022-01-14,Hai Phong City,Kien An District,18,6,3,3,2
2022-01-14,Hai Phong City,Kien An District,19,7,2,5,3
2022-01-14,Hai Phong City,Kien An District,20,7,2,5,4
2022-01-14,Hai Phong City,Kien An District,21,1,0,1,1
2022-01-14,Hai Phong City,Le Chan District,5,1,1,0,0
2022-01-14,Hai Phong City,Le Chan District,7,40,33,7,2
2022-01-14,Hai Phong City,Le Chan District,8,87,78,9,0
2022-01-14,Hai Phong City,Le Chan District,9,78,71,7,0
2022-01-14,Hai Phong City,Le Chan District,10,182,166,16,2
2022-01-14,Hai Phong City,Le Chan District,11,376,337,39,7
2022-01-14,Hai Phong City,Le Chan District,12,238,221,17,1
2022-01-14,Hai Phong City,Le Chan District,13,149,128,21,1
2022-01-14,Hai Phong City,Le Chan District,14,163,148,15,1
2022-01-14,Hai Phong City,Le Chan District,15,183,162,21,2
2022-01-14,Hai Phong City,Le Chan District,16,205,181,24,0
2022-01-14,Hai Phong City,Le Chan District,17,242,212,30,0
2022-01-14,Hai Phong City,Le Chan District,18,343,299,44,9
2022-01-14,Hai Phong City,Le Chan District,19,220,191,29,2
2022-01-14,Hai Phong City,Le Chan District,20,169,145,24,5
2022-01-14,Hai Phong City,Le Chan District,21,80,60,20,1
2022-01-14,Hai Phong City,Le Chan District,22,1,0,1,0
2022-01-14,Hai Phong City,Ngo Quyen District,0,3,1,2,0
2022-01-14,Hai Phong City,Ngo Quyen District,1,1,1,0,0
2022-01-14,Hai Phong City,Ngo Quyen District,6,1,0,1,1
2022-01-14,Hai Phong City,Ngo Quyen District,7,45,37,8,2
2022-01-14,Hai Phong City,Ngo Quyen District,8,116,95,21,5
2022-01-14,Hai Phong City,Ngo Quyen District,9,100,85,15,0
2022-01-14,Hai Phong City,Ngo Quyen District,10,129,119,10,1
2022-01-14,Hai Phong City,Ngo Quyen District,11,293,262,31,7
2022-01-14,Hai Phong City,Ngo Quyen District,12,165,152,13,1
2022-01-14,Hai Phong City,Ngo Quyen District,13,135,125,10,0
2022-01-14,Hai Phong City,Ngo Quyen District,14,140,129,11,2
2022-01-14,Hai Phong City,Ngo Quyen District,15,161,139,22,1
2022-01-14,Hai Phong City,Ngo Quyen District,16,179,162,17,0
2022-01-14,Hai Phong City,Ngo Quyen District,17,167,153,14,2
2022-01-14,Hai Phong City,Ngo Quyen District,18,234,194,40,11
2022-01-14,Hai Phong City,Ngo Quyen District,19,202,184,18,2
2022-01-14,Hai Phong City,Ngo Quyen District,20,163,141,22,1
2022-01-14,Hai Phong City,Ngo Quyen District,21,73,63,10,1
2022-01-14,Hai Phong City,Ngo Quyen District,22,1,0,1,1
2022-01-14,Hai Phong City,Thuy Nguyen,8,1,0,1,1
2022-01-14,Hai Phong City,Thuy Nguyen,9,2,0,2,2
2022-01-14,Hai Phong City,Thuy Nguyen,10,1,0,1,1
2022-01-14,Hai Phong City,Thuy Nguyen,12,2,0,2,2
2022-01-14,Hai Phong City,Thuy Nguyen,13,1,0,1,1
2022-01-14,Hai Phong City,Thuy Nguyen,14,2,0,2,2
2022-01-14,Hai Phong City,Thuy Nguyen,15,3,0,3,3
2022-01-14,Hai Phong City,Thuy Nguyen,16,1,0,1,1
2022-01-14,Hai Phong City,Thuy Nguyen,17,1,0,1,1
2022-01-14,Hai Phong City,Thuy Nguyen,18,2,0,2,2
2022-01-14,Hue City,Hue City,0,1,1,0,0
2022-01-14,Hue City,Hue City,1,5,4,1,1
2022-01-14,Hue City,Hue City,4,1,1,0,0
2022-01-14,Hue City,Hue City,6,59,57,2,1
2022-01-14,Hue City,Hue City,7,250,233,17,2
2022-01-14,Hue City,Hue City,8,346,331,15,0
2022-01-14,Hue City,Hue City,9,273,252,21,1
2022-01-14,Hue City,Hue City,10,381,359,22,0
2022-01-14,Hue City,Hue City,11,747,711,36,1
2022-01-14,Hue City,Hue City,12,525,491,34,1
2022-01-14,Hue City,Hue City,13,295,281,14,0
2022-01-14,Hue City,Hue City,14,371,348,23,0
2022-01-14,Hue City,Hue City,15,364,348,16,0
2022-01-14,Hue City,Hue City,16,439,420,19,0
2022-01-14,Hue City,Hue City,17,571,544,27,0
2022-01-14,Hue City,Hue City,18,693,645,48,2
2022-01-14,Hue City,Hue City,19,528,495,33,1
2022-01-14,Hue City,Hue City,20,395,349,46,0
2022-01-14,Hue City,Hue City,21,207,175,32,0
2022-01-14,Hue City,Hue City,22,5,3,2,1
2022-01-14,Hue City,Hue City,23,4,3,1,0
2022-01-14,Hue City,Huong Thuy,9,2,2,0,0
2022-01-14,Hue City,Huong Thuy,13,1,1,0,0
2022-01-14,Hue City,Huong Thuy,14,1,1,0,0
2022-01-14,Hue City,Huong Thuy,15,1,1,0,0
2022-01-14,Hue City,Huong Thuy,17,1,1,0,0
2022-01-14,Hue City,Huong Thuy,20,1,0,1,1
2022-01-14,Hue City,Huong Thuy,21,1,1,0,0
2022-01-14,Hue City,Huong Tra,16,1,1,0,0
2022-01-14,Hue City,Huong Tra,19,1,1,0,0
2022-01-14,Hue City,Phu Vang,6,2,0,2,1
2022-01-14,Hue City,Phu Vang,10,1,1,0,0
2022-01-14,Hue City,Phu Vang,12,1,1,0,0
2022-01-14,Hue City,Phu Vang,14,1,1,0,0
2022-01-14,Hue City,Phu Vang,16,1,1,0,0
2022-01-14,Hue City,Phu Vang,17,1,1,0,0
2022-01-14,Hue City,Phu Vang,18,5,3,2,1
2022-01-14,Hue City,Phu Vang,19,3,2,1,0
2022-01-14,Hue City,Phu Vang,20,1,0,1,0
2022-01-14,Vung Tau,Ba Ria City,6,2,0,2,2
2022-01-14,Vung Tau,Ba Ria City,7,1,0,1,1
2022-01-14,Vung Tau,Ba Ria City,8,4,0,4,4
2022-01-14,Vung Tau,Ba Ria City,9,5,3,2,2
2022-01-14,Vung Tau,Ba Ria City,10,8,2,6,4
2022-01-14,Vung Tau,Ba Ria City,11,7,2,5,5
2022-01-14,Vung Tau,Ba Ria City,12,6,2,4,1
2022-01-14,Vung Tau,Ba Ria City,13,14,5,9,9
2022-01-14,Vung Tau,Ba Ria City,14,5,4,1,0
2022-01-14,Vung Tau,Ba Ria City,15,6,1,5,2
2022-01-14,Vung Tau,Ba Ria City,16,7,3,4,3
2022-01-14,Vung Tau,Ba Ria City,17,9,3,6,5
2022-01-14,Vung Tau,Ba Ria City,18,14,2,12,10
2022-01-14,Vung Tau,Ba Ria City,19,3,1,2,1
2022-01-14,Vung Tau,Ba Ria City,20,8,0,8,8
2022-01-14,Vung Tau,Ba Ria City,21,2,0,2,2
2022-01-14,Vung Tau,Tan Thanh,12,1,0,1,1
2022-01-14,Vung Tau,Vung Tau City,0,3,1,2,0
2022-01-14,Vung Tau,Vung Tau City,1,3,2,1,0
2022-01-14,Vung Tau,Vung Tau City,2,1,1,0,0
2022-01-14,Vung Tau,Vung Tau City,4,1,0,1,0
2022-01-14,Vung Tau,Vung Tau City,6,41,39,2,2
2022-01-14,Vung Tau,Vung Tau City,7,109,98,11,0
2022-01-14,Vung Tau,Vung Tau City,8,166,156,10,0
2022-01-14,Vung Tau,Vung Tau City,9,136,127,9,0
2022-01-14,Vung Tau,Vung Tau City,10,213,201,12,0
2022-01-14,Vung Tau,Vung Tau City,11,338,312,26,0
2022-01-14,Vung Tau,Vung Tau City,12,253,239,14,0
2022-01-14,Vung Tau,Vung Tau City,13,199,194,5,1
2022-01-14,Vung Tau,Vung Tau City,14,220,201,19,2
2022-01-14,Vung Tau,Vung Tau City,15,216,205,11,1
2022-01-14,Vung Tau,Vung Tau City,16,212,197,15,1
2022-01-14,Vung Tau,Vung Tau City,17,268,251,17,0
2022-01-14,Vung Tau,Vung Tau City,18,337,311,26,0
2022-01-14,Vung Tau,Vung Tau City,19,253,234,19,0
2022-01-14,Vung Tau,Vung Tau City,20,192,170,22,6
2022-01-14,Vung Tau,Vung Tau City,21,85,70,15,3
2022-01-15,Binh Duong,Ben Cat,12,1,0,1,1
2022-01-15,Binh Duong,Ben Cat,13,1,1,0,0
2022-01-15,Binh Duong,Ben Cat,20,1,1,0,0
2022-01-15,Binh Duong,Di An,7,3,2,1,1
2022-01-15,Binh Duong,Di An,8,14,3,11,9
2022-01-15,Binh Duong,Di An,9,18,9,9,8
2022-01-15,Binh Duong,Di An,10,26,21,5,5
2022-01-15,Binh Duong,Di An,11,31,17,14,12
2022-01-15,Binh Duong,Di An,12,32,16,16,11
2022-01-15,Binh Duong,Di An,13,40,17,23,18
2022-01-15,Binh Duong,Di An,14,25,13,12,11
2022-01-15,Binh Duong,Di An,15,15,11,4,4
2022-01-15,Binh Duong,Di An,16,10,8,2,2
2022-01-15,Binh Duong,Di An,17,21,14,7,4
2022-01-15,Binh Duong,Di An,18,30,15,15,13
2022-01-15,Binh Duong,Di An,19,32,9,23,19
2022-01-15,Binh Duong,Di An,20,21,5,16,15
2022-01-15,Binh Duong,Di An,21,6,2,4,4
2022-01-15,Binh Duong,Tan Uyen,10,1,0,1,1
2022-01-15,Binh Duong,Tan Uyen,11,1,0,1,1
2022-01-15,Binh Duong,Tan Uyen,12,1,1,0,0
2022-01-15,Binh Duong,Tan Uyen,13,2,2,0,0
2022-01-15,Binh Duong,Tan Uyen,14,6,2,4,2
2022-01-15,Binh Duong,Tan Uyen,15,2,1,1,0
2022-01-15,Binh Duong,Tan Uyen,19,1,0,1,0
2022-01-15,Binh Duong,Tan Uyen,20,2,1,1,1
2022-01-15,Binh Duong,Thu Dau Mot Town,1,2,1,1,0
2022-01-15,Binh Duong,Thu Dau Mot Town,3,3,3,0,0
2022-01-15,Binh Duong,Thu Dau Mot Town,5,1,1,0,0
2022-01-15,Binh Duong,Thu Dau Mot Town,6,31,28,3,0
2022-01-15,Binh Duong,Thu Dau Mot Town,7,118,110,8,1
2022-01-15,Binh Duong,Thu Dau Mot Town,8,194,188,6,0
2022-01-15,Binh Duong,Thu Dau Mot Town,9,286,266,20,2
2022-01-15,Binh Duong,Thu Dau Mot Town,10,381,355,26,6
2022-01-15,Binh Duong,Thu Dau Mot Town,11,660,613,47,7
2022-01-15,Binh Duong,Thu Dau Mot Town,12,488,466,22,2
2022-01-15,Binh Duong,Thu Dau Mot Town,13,430,400,30,9
2022-01-15,Binh Duong,Thu Dau Mot Town,14,354,336,18,0
2022-01-15,Binh Duong,Thu Dau Mot Town,15,275,259,16,4
2022-01-15,Binh Duong,Thu Dau Mot Town,16,278,265,13,1
2022-01-15,Binh Duong,Thu Dau Mot Town,17,347,333,14,3
2022-01-15,Binh Duong,Thu Dau Mot Town,18,394,365,29,1
2022-01-15,Binh Duong,Thu Dau Mot Town,19,356,332,24,7
2022-01-15,Binh Duong,Thu Dau Mot Town,20,245,220,25,2
2022-01-15,Binh Duong,Thu Dau Mot Town,21,132,102,30,13
2022-01-15,Binh Duong,Thu Dau Mot Town,22,5,3,2,0
2022-01-15,Binh Duong,Thuan An,6,1,1,0,0
2022-01-15,Binh Duong,Thuan An,7,10,3,7,5
2022-01-15,Binh Duong,Thuan An,8,24,12,12,10
2022-01-15,Binh Duong,Thuan An,9,45,23,22,21
2022-01-15,Binh Duong,Thuan An,10,51,42,9,4
2022-01-15,Binh Duong,Thuan An,11,66,52,14,9
2022-01-15,Binh Duong,Thuan An,12,59,43,16,12
2022-01-15,Binh Duong,Thuan An,13,70,45,25,23
2022-01-15,Binh Duong,Thuan An,14,36,29,7,6
2022-01-15,Binh Duong,Thuan An,15,33,27,6,6
2022-01-15,Binh Duong,Thuan An,16,42,24,18,15
2022-01-15,Binh Duong,Thuan An,17,77,33,44,33
2022-01-15,Binh Duong,Thuan An,18,69,38,31,26
2022-01-15,Binh Duong,Thuan An,19,78,33,45,35
2022-01-15,Binh Duong,Thuan An,20,46,15,31,28
2022-01-15,Binh Duong,Thuan An,21,21,2,19,14
2022-01-15,Binh Duong,Thuan An,22,1,0,1,1
2022-01-15,Can Tho City,Binh Thuy District,0,1,0,1,0
2022-01-15,Can Tho City,Binh Thuy District,6,1,1,0,0
2022-01-15,Can Tho City,Binh Thuy District,7,1,1,0,0
2022-01-15,Can Tho City,Binh Thuy District,8,3,3,0,0
2022-01-15,Can Tho City,Binh Thuy District,9,8,8,0,0
2022-01-15,Can Tho City,Binh Thuy District,10,5,4,1,0
2022-01-15,Can Tho City,Binh Thuy District,11,13,13,0,0
2022-01-15,Can Tho City,Binh Thuy District,12,7,7,0,0
2022-01-15,Can Tho City,Binh Thuy District,13,10,9,1,0
2022-01-15,Can Tho City,Binh Thuy District,14,13,12,1,0
2022-01-15,Can Tho City,Binh Thuy District,15,17,16,1,0
2022-01-15,Can Tho City,Binh Thuy District,16,19,16,3,1
2022-01-15,Can Tho City,Binh Thuy District,17,15,15,0,0
2022-01-15,Can Tho City,Binh Thuy District,18,20,19,1,0
2022-01-15,Can Tho City,Binh Thuy District,19,18,16,2,0
2022-01-15,Can Tho City,Binh Thuy District,20,10,9,1,1
2022-01-15,Can Tho City,Binh Thuy District,21,3,2,1,0
2022-01-15,Can Tho City,Binh Thuy District,22,1,0,1,0
2022-01-15,Can Tho City,Cai Rang District,6,1,1,0,0
2022-01-15,Can Tho City,Cai Rang District,7,3,3,0,0
2022-01-15,Can Tho City,Cai Rang District,8,12,12,0,0
2022-01-15,Can Tho City,Cai Rang District,9,7,7,0,0
2022-01-15,Can Tho City,Cai Rang District,10,19,17,2,0
2022-01-15,Can Tho City,Cai Rang District,11,23,20,3,0
2022-01-15,Can Tho City,Cai Rang District,12,10,9,1,0
2022-01-15,Can Tho City,Cai Rang District,13,10,10,0,0
2022-01-15,Can Tho City,Cai Rang District,14,9,6,3,0
2022-01-15,Can Tho City,Cai Rang District,15,6,6,0,0
2022-01-15,Can Tho City,Cai Rang District,16,16,14,2,0
2022-01-15,Can Tho City,Cai Rang District,17,10,9,1,0
2022-01-15,Can Tho City,Cai Rang District,18,10,8,2,1
2022-01-15,Can Tho City,Cai Rang District,19,8,7,1,0
2022-01-15,Can Tho City,Cai Rang District,20,5,4,1,0
2022-01-15,Can Tho City,Cai Rang District,21,1,1,0,0
2022-01-15,Can Tho City,Cai Rang District,22,1,0,1,1
2022-01-15,Can Tho City,Ninh Kieu District,0,8,8,0,0
2022-01-15,Can Tho City,Ninh Kieu District,1,9,9,0,0
2022-01-15,Can Tho City,Ninh Kieu District,2,3,2,1,0
2022-01-15,Can Tho City,Ninh Kieu District,3,1,1,0,0
2022-01-15,Can Tho City,Ninh Kieu District,4,1,1,0,0
2022-01-15,Can Tho City,Ninh Kieu District,5,2,1,1,0
2022-01-15,Can Tho City,Ninh Kieu District,6,56,52,4,0
2022-01-15,Can Tho City,Ninh Kieu District,7,173,161,12,0
2022-01-15,Can Tho City,Ninh Kieu District,8,277,258,19,0
2022-01-15,Can Tho City,Ninh Kieu District,9,330,314,16,1
2022-01-15,Can Tho City,Ninh Kieu District,10,563,537,26,0
2022-01-15,Can Tho City,Ninh Kieu District,11,815,786,29,0
2022-01-15,Can Tho City,Ninh Kieu District,12,630,607,23,0
2022-01-15,Can Tho City,Ninh Kieu District,13,443,429,14,0
2022-01-15,Can Tho City,Ninh Kieu District,14,496,469,27,0
2022-01-15,Can Tho City,Ninh Kieu District,15,338,328,10,0
2022-01-15,Can Tho City,Ninh Kieu District,16,485,464,21,0
2022-01-15,Can Tho City,Ninh Kieu District,17,601,574,27,0
2022-01-15,Can Tho City,Ninh Kieu District,18,555,532,23,0
2022-01-15,Can Tho City,Ninh Kieu District,19,441,427,14,0
2022-01-15,Can Tho City,Ninh Kieu District,20,357,332,25,0
2022-01-15,Can Tho City,Ninh Kieu District,21,209,181,28,0
2022-01-15,Can Tho City,Ninh Kieu District,22,4,3,1,0
2022-01-15,Can Tho City,Ninh Kieu District,23,1,1,0,0
2022-01-15,Dong Nai,Bien Hoa City,0,1,1,0,0
2022-01-15,Dong Nai,Bien Hoa City,1,2,1,1,1
2022-01-15,Dong Nai,Bien Hoa City,2,3,2,1,1
2022-01-15,Dong Nai,Bien Hoa City,3,1,1,0,0
2022-01-15,Dong Nai,Bien Hoa City,4,2,2,0,0
2022-01-15,Dong Nai,Bien Hoa City,5,2,0,2,1
2022-01-15,Dong Nai,Bien Hoa City,6,54,41,13,8
2022-01-15,Dong Nai,Bien Hoa City,7,161,142,19,2
2022-01-15,Dong Nai,Bien Hoa City,8,284,261,23,5
2022-01-15,Dong Nai,Bien Hoa City,9,428,387,41,5
2022-01-15,Dong Nai,Bien Hoa City,10,804,737,67,11
2022-01-15,Dong Nai,Bien Hoa City,11,1140,1069,71,14
2022-01-15,Dong Nai,Bien Hoa City,12,922,852,70,11
2022-01-15,Dong Nai,Bien Hoa City,13,784,730,54,12
2022-01-15,Dong Nai,Bien Hoa City,14,691,635,56,11
2022-01-15,Dong Nai,Bien Hoa City,15,551,516,35,6
2022-01-15,Dong Nai,Bien Hoa City,16,551,497,54,7
2022-01-15,Dong Nai,Bien Hoa City,17,708,626,82,30
2022-01-15,Dong Nai,Bien Hoa City,18,870,746,124,57
2022-01-15,Dong Nai,Bien Hoa City,19,676,584,92,30
2022-01-15,Dong Nai,Bien Hoa City,20,582,470,112,50
2022-01-15,Dong Nai,Bien Hoa City,21,303,191,112,57
2022-01-15,Dong Nai,Bien Hoa City,22,5,2,3,0
2022-01-15,Dong Nai,Bien Hoa City,23,3,3,0,0
2022-01-15,Dong Nai,Long Thanh,11,2,0,2,2
2022-01-15,Dong Nai,Long Thanh,18,3,0,3,3
2022-01-15,Dong Nai,Long Thanh,20,1,0,1,1
2022-01-15,Dong Nai,Thong Nhat,7,2,2,0,0
2022-01-15,Dong Nai,Thong Nhat,8,1,1,0,0
2022-01-15,Dong Nai,Thong Nhat,9,2,2,0,0
2022-01-15,Dong Nai,Thong Nhat,10,1,1,0,0
2022-01-15,Dong Nai,Thong Nhat,13,1,1,0,0
2022-01-15,Dong Nai,Thong Nhat,14,1,1,0,0
2022-01-15,Dong Nai,Thong Nhat,15,1,1,0,0
2022-01-15,Dong Nai,Thong Nhat,19,1,1,0,0
2022-01-15,Dong Nai,Thong Nhat,21,1,1,0,0
2022-01-15,Dong Nai,Trang Bom,9,2,0,2,1
2022-01-15,Dong Nai,Trang Bom,10,2,0,2,2
2022-01-15,Dong Nai,Trang Bom,11,1,0,1,0
2022-01-15,Dong Nai,Trang Bom,12,2,1,1,0
2022-01-15,Dong Nai,Trang Bom,13,1,0,1,0
2022-01-15,Dong Nai,Trang Bom,18,2,1,1,1
2022-01-15,Hai Phong City,An Duong,3,1,0,1,0
2022-01-15,Hai Phong City,An Duong,8,5,4,1,1
2022-01-15,Hai Phong City,An Duong,9,2,1,1,1
2022-01-15,Hai Phong City,An Duong,10,1,1,0,0
2022-01-15,Hai Phong City,An Duong,11,2,1,1,0
2022-01-15,Hai Phong City,An Duong,12,2,1,1,0
2022-01-15,Hai Phong City,An Duong,13,3,3,0,0
2022-01-15,Hai Phong City,An Duong,14,1,1,0,0
2022-01-15,Hai Phong City,An Duong,15,5,3,2,1
2022-01-15,Hai Phong City,An Duong,16,2,2,0,0
2022-01-15,Hai Phong City,An Duong,17,3,3,0,0
2022-01-15,Hai Phong City,An Duong,18,3,2,1,0
2022-01-15,Hai Phong City,An Duong,19,2,1,1,0
2022-01-15,Hai Phong City,An Duong,20,1,0,1,0
2022-01-15,Hai Phong City,Duong Kinh District,15,1,0,1,1
2022-01-15,Hai Phong City,Hai An District,0,2,1,1,0
2022-01-15,Hai Phong City,Hai An District,7,2,2,0,0
2022-01-15,Hai Phong City,Hai An District,8,14,13,1,0
2022-01-15,Hai Phong City,Hai An District,9,10,9,1,0
2022-01-15,Hai Phong City,Hai An District,10,24,23,1,0
2022-01-15,Hai Phong City,Hai An District,11,41,35,6,0
2022-01-15,Hai Phong City,Hai An District,12,39,35,4,0
2022-01-15,Hai Phong City,Hai An District,13,25,22,3,0
2022-01-15,Hai Phong City,Hai An District,14,28,22,6,0
2022-01-15,Hai Phong City,Hai An District,15,25,22,3,0
2022-01-15,Hai Phong City,Hai An District,16,26,21,5,0
2022-01-15,Hai Phong City,Hai An District,17,47,39,8,0
2022-01-15,Hai Phong City,Hai An District,18,39,33,6,0
2022-01-15,Hai Phong City,Hai An District,19,23,21,2,0
2022-01-15,Hai Phong City,Hai An District,20,19,18,1,0
2022-01-15,Hai Phong City,Hai An District,21,18,14,4,1
2022-01-15,Hai Phong City,Hai An District,22,1,0,1,0
2022-01-15,Hai Phong City,Hong Bang District,0,1,0,1,0
2022-01-15,Hai Phong City,Hong Bang District,6,1,0,1,0
2022-01-15,Hai Phong City,Hong Bang District,7,14,12,2,0
2022-01-15,Hai Phong City,Hong Bang District,8,33,27,6,0
2022-01-15,Hai Phong City,Hong Bang District,9,53,51,2,0
2022-01-15,Hai Phong City,Hong Bang District,10,74,67,7,0
2022-01-15,Hai Phong City,Hong Bang District,11,132,111,21,6
2022-01-15,Hai Phong City,Hong Bang District,12,99,93,6,2
2022-01-15,Hai Phong City,Hong Bang District,13,58,55,3,1
2022-01-15,Hai Phong City,Hong Bang District,14,49,47,2,0
2022-01-15,Hai Phong City,Hong Bang District,15,67,62,5,1
2022-01-15,Hai Phong City,Hong Bang District,16,62,57,5,0
2022-01-15,Hai Phong City,Hong Bang District,17,80,68,12,2
2022-01-15,Hai Phong City,Hong Bang District,18,114,101,13,2
2022-01-15,Hai Phong City,Hong Bang District,19,110,94,16,8
2022-01-15,Hai Phong City,Hong Bang District,20,89,70,19,7
2022-01-15,Hai Phong City,Hong Bang District,21,33,19,14,5
2022-01-15,Hai Phong City,Kien An District,7,2,0,2,2
2022-01-15,Hai Phong City,Kien An District,8,6,4,2,2
2022-01-15,Hai Phong City,Kien An District,9,6,4,2,1
2022-01-15,Hai Phong City,Kien An District,10,11,9,2,2
2022-01-15,Hai Phong City,Kien An District,11,16,14,2,0
2022-01-15,Hai Phong City,Kien An District,12,7,5,2,2
2022-01-15,Hai Phong City,Kien An District,13,17,8,9,8
2022-01-15,Hai Phong City,Kien An District,14,15,9,6,5
2022-01-15,Hai Phong City,Kien An District,15,16,12,4,2
2022-01-15,Hai Phong City,Kien An District,16,7,5,2,1
2022-01-15,Hai Phong City,Kien An District,17,9,8,1,1
2022-01-15,Hai Phong City,Kien An District,18,9,8,1,0
2022-01-15,Hai Phong City,Kien An District,19,9,3,6,0
2022-01-15,Hai Phong City,Kien An District,20,14,7,7,4
2022-01-15,Hai Phong City,Kien An District,21,10,2,8,5
2022-01-15,Hai Phong City,Le Chan District,0,8,5,3,0
2022-01-15,Hai Phong City,Le Chan District,1,2,2,0,0
2022-01-15,Hai Phong City,Le Chan District,6,5,4,1,0
2022-01-15,Hai Phong City,Le Chan District,7,64,51,13,2
2022-01-15,Hai Phong City,Le Chan District,8,94,83,11,1
2022-01-15,Hai Phong City,Le Chan District,9,132,113,19,1
2022-01-15,Hai Phong City,Le Chan District,10,242,206,36,1
2022-01-15,Hai Phong City,Le Chan District,11,396,370,26,6
2022-01-15,Hai Phong City,Le Chan District,12,333,297,36,0
2022-01-15,Hai Phong City,Le Chan District,13,172,153,19,1
2022-01-15,Hai Phong City,Le Chan District,14,178,162,16,2
2022-01-15,Hai Phong City,Le Chan District,15,240,201,39,0
2022-01-15,Hai Phong City,Le Chan District,16,240,215,25,1
2022-01-15,Hai Phong City,Le Chan District,17,310,272,38,4
2022-01-15,Hai Phong City,Le Chan District,18,402,348,54,21
2022-01-15,Hai Phong City,Le Chan District,19,294,262,32,6
2022-01-15,Hai Phong City,Le Chan District,20,205,178,27,1
2022-01-15,Hai Phong City,Le Chan District,21,97,68,29,3
2022-01-15,Hai Phong City,Le Chan District,22,3,1,2,1
2022-01-15,Hai Phong City,Le Chan District,23,3,2,1,1
2022-01-15,Hai Phong City,Ngo Quyen District,0,3,1,2,0
2022-01-15,Hai Phong City,Ngo Quyen District,1,2,2,0,0
2022-01-15,Hai Phong City,Ngo Quyen District,3,1,0,1,0
2022-01-15,Hai Phong City,Ngo Quyen District,5,1,1,0,0
2022-01-15,Hai Phong City,Ngo Quyen District,7,36,25,11,1
2022-01-15,Hai Phong City,Ngo Quyen District,8,117,98,19,0
2022-01-15,Hai Phong City,Ngo Quyen District,9,96,90,6,0
2022-01-15,Hai Phong City,Ngo Quyen District,10,195,181,14,1
2022-01-15,Hai Phong City,Ngo Quyen District,11,315,295,20,4
2022-01-15,Hai Phong City,Ngo Quyen District,12,225,203,22,0
2022-01-15,Hai Phong City,Ngo Quyen District,13,149,131,18,0
2022-01-15,Hai Phong City,Ngo Quyen District,14,163,149,14,0
2022-01-15,Hai Phong City,Ngo Quyen District,15,190,181,9,0
2022-01-15,Hai Phong City,Ngo Quyen District,16,253,225,28,0
2022-01-15,Hai Phong City,Ngo Quyen District,17,238,223,15,4
2022-01-15,Hai Phong City,Ngo Quyen District,18,310,262,48,7
2022-01-15,Hai Phong City,Ngo Quyen District,19,270,237,33,3
2022-01-15,Hai Phong City,Ngo Quyen District,20,189,175,14,1
2022-01-15,Hai Phong City,Ngo Quyen District,21,95,81,14,0
2022-01-15,Hai Phong City,Ngo Quyen District,22,4,2,2,0
2022-01-15,Hai Phong City,Ngo Quyen District,23,3,0,3,0
2022-01-15,Hai Phong City,Thuy Nguyen,7,2,0,2,1
2022-01-15,Hai Phong City,Thuy Nguyen,9,1,0,1,1
2022-01-15,Hai Phong City,Thuy Nguyen,10,4,0,4,3
2022-01-15,Hai Phong City,Thuy Nguyen,11,2,0,2,2
2022-01-15,Hai Phong City,Thuy Nguyen,12,2,1,1,0
2022-01-15,Hai Phong City,Thuy Nguyen,14,1,0,1,1
2022-01-15,Hai Phong City,Thuy Nguyen,15,3,0,3,2
2022-01-15,Hai Phong City,Thuy Nguyen,16,1,1,0,0
2022-01-15,Hai Phong City,Thuy Nguyen,19,1,0,1,1
2022-01-15,Hue City,Hue City,0,26,19,7,1
2022-01-15,Hue City,Hue City,1,8,8,0,0
2022-01-15,Hue City,Hue City,2,3,1,2,0
2022-01-15,Hue City,Hue City,3,2,2,0,0
2022-01-15,Hue City,Hue City,5,2,2,0,0
2022-01-15,Hue City,Hue City,6,45,44,1,0
2022-01-15,Hue City,Hue City,7,294,273,21,3
2022-01-15,Hue City,Hue City,8,371,356,15,1
2022-01-15,Hue City,Hue City,9,362,337,25,0
2022-01-15,Hue City,Hue City,10,529,499,30,0
2022-01-15,Hue City,Hue City,11,866,817,49,0
2022-01-15,Hue City,Hue City,12,619,581,38,0
2022-01-15,Hue City,Hue City,13,418,396,22,0
2022-01-15,Hue City,Hue City,14,389,373,16,0
2022-01-15,Hue City,Hue City,15,512,482,30,0
2022-01-15,Hue City,Hue City,16,520,499,21,2
2022-01-15,Hue City,Hue City,17,732,685,47,0
2022-01-15,Hue City,Hue City,18,776,723,53,0
2022-01-15,Hue City,Hue City,19,640,592,48,6
2022-01-15,Hue City,Hue City,20,518,482,36,1
2022-01-15,Hue City,Hue City,21,291,241,50,4
2022-01-15,Hue City,Hue City,22,4,2,2,0
2022-01-15,Hue City,Hue City,23,3,3,0,0
2022-01-15,Hue City,Huong Thuy,10,1,1,0,0
2022-01-15,Hue City,Huong Thuy,11,2,0,2,1
2022-01-15,Hue City,Huong Thuy,13,1,1,0,0
2022-01-15,Hue City,Huong Thuy,14,1,0,1,1
2022-01-15,Hue City,Huong Thuy,15,1,1,0,0
2022-01-15,Hue City,Huong Thuy,17,2,2,0,0
2022-01-15,Hue City,Huong Thuy,18,1,1,0,0
2022-01-15,Hue City,Huong Thuy,19,1,1,0,0
2022-01-15,Hue City,Huong Tra,11,1,0,1,1
2022-01-15,Hue City,Huong Tra,14,1,0,1,1
2022-01-15,Hue City,Huong Tra,15,1,1,0,0
2022-01-15,Hue City,Huong Tra,17,1,1,0,0
2022-01-15,Hue City,Phu Vang,6,2,1,1,1
2022-01-15,Hue City,Phu Vang,7,1,1,0,0
2022-01-15,Hue City,Phu Vang,8,1,1,0,0
2022-01-15,Hue City,Phu Vang,10,1,0,1,0
2022-01-15,Hue City,Phu Vang,11,2,1,1,0
2022-01-15,Hue City,Phu Vang,12,1,1,0,0
2022-01-15,Hue City,Phu Vang,14,1,1,0,0
2022-01-15,Hue City,Phu Vang,15,2,2,0,0
2022-01-15,Hue City,Phu Vang,16,1,1,0,0
2022-01-15,Hue City,Phu Vang,17,1,1,0,0
2022-01-15,Hue City,Phu Vang,18,2,1,1,1
2022-01-15,Hue City,Phu Vang,19,2,2,0,0
2022-01-15,Vung Tau,Ba Ria City,8,3,2,1,1
2022-01-15,Vung Tau,Ba Ria City,9,1,0,1,0
2022-01-15,Vung Tau,Ba Ria City,10,9,5,4,0
2022-01-15,Vung Tau,Ba Ria City,11,10,5,5,5
2022-01-15,Vung Tau,Ba Ria City,12,8,6,2,2
2022-01-15,Vung Tau,Ba Ria City,13,7,3,4,2
2022-01-15,Vung Tau,Ba Ria City,14,8,4,4,2
2022-01-15,Vung Tau,Ba Ria City,15,11,8,3,2
2022-01-15,Vung Tau,Ba Ria City,16,5,5,0,0
2022-01-15,Vung Tau,Ba Ria City,17,10,9,1,1
2022-01-15,Vung Tau,Ba Ria City,18,14,7,7,5
2022-01-15,Vung Tau,Ba Ria City,19,5,5,0,0
2022-01-15,Vung Tau,Ba Ria City,20,4,2,2,2
2022-01-15,Vung Tau,Ba Ria City,21,3,0,3,2
2022-01-15,Vung Tau,Tan Thanh,10,2,0,2,1
2022-01-15,Vung Tau,Tan Thanh,15,1,0,1,1
2022-01-15,Vung Tau,Vung Tau City,0,3,2,1,0
2022-01-15,Vung Tau,Vung Tau City,2,3,2,1,0
2022-01-15,Vung Tau,Vung Tau City,6,44,36,8,0
2022-01-15,Vung Tau,Vung Tau City,7,110,101,9,1
2022-01-15,Vung Tau,Vung Tau City,8,187,173,14,1
2022-01-15,Vung Tau,Vung Tau City,9,172,160,12,0
2022-01-15,Vung Tau,Vung Tau City,10,246,229,17,1
2022-01-15,Vung Tau,Vung Tau City,11,348,333,15,0
2022-01-15,Vung Tau,Vung Tau City,12,313,299,14,0
2022-01-15,Vung Tau,Vung Tau City,13,237,220,17,4
2022-01-15,Vung Tau,Vung Tau City,14,247,241,6,0
2022-01-15,Vung Tau,Vung Tau City,15,255,234,21,1
2022-01-15,Vung Tau,Vung Tau City,16,244,229,15,0
2022-01-15,Vung Tau,Vung Tau City,17,351,327,24,1
2022-01-15,Vung Tau,Vung Tau City,18,343,323,20,1
2022-01-15,Vung Tau,Vung Tau City,19,278,250,28,2
2022-01-15,Vung Tau,Vung Tau City,20,231,211,20,1
2022-01-15,Vung Tau,Vung Tau City,21,135,107,28,15
2022-01-15,Vung Tau,Vung Tau City,22,6,1,5,1
2022-01-15,Vung Tau,Vung Tau City,23,1,1,0,0
2022-01-16,Binh Duong,Ben Cat,11,1,0,1,1
2022-01-16,Binh Duong,Ben Cat,13,1,0,1,0
2022-01-16,Binh Duong,Di An,6,1,0,1,1
2022-01-16,Binh Duong,Di An,7,7,1,6,5
2022-01-16,Binh Duong,Di An,8,8,2,6,5
2022-01-16,Binh Duong,Di An,9,21,10,11,7
2022-01-16,Binh Duong,Di An,10,24,11,13,11
2022-01-16,Binh Duong,Di An,11,35,8,27,23
2022-01-16,Binh Duong,Di An,12,46,16,30,28
2022-01-16,Binh Duong,Di An,13,38,9,29,27
2022-01-16,Binh Duong,Di An,14,28,8,20,16
2022-01-16,Binh Duong,Di An,15,18,9,9,7
2022-01-16,Binh Duong,Di An,16,22,14,8,6
2022-01-16,Binh Duong,Di An,17,11,5,6,6
2022-01-16,Binh Duong,Di An,18,25,10,15,12
2022-01-16,Binh Duong,Di An,19,26,15,11,10
2022-01-16,Binh Duong,Di An,20,13,7,6,4
2022-01-16,Binh Duong,Di An,21,8,0,8,5
2022-01-16,Binh Duong,Tan Uyen,12,1,1,0,0
2022-01-16,Binh Duong,Tan Uyen,13,1,0,1,1
2022-01-16,Binh Duong,Tan Uyen,14,1,1,0,0
2022-01-16,Binh Duong,Tan Uyen,15,2,0,2,2
2022-01-16,Binh Duong,Tan Uyen,16,1,1,0,0
2022-01-16,Binh Duong,Tan Uyen,19,2,2,0,0
2022-01-16,Binh Duong,Thu Dau Mot Town,3,1,0,1,0
2022-01-16,Binh Duong,Thu Dau Mot Town,5,1,1,0,0
2022-01-16,Binh Duong,Thu Dau Mot Town,6,41,28,13,6
2022-01-16,Binh Duong,Thu Dau Mot Town,7,144,132,12,3
2022-01-16,Binh Duong,Thu Dau Mot Town,8,233,218,15,5
2022-01-16,Binh Duong,Thu Dau Mot Town,9,267,245,22,2
2022-01-16,Binh Duong,Thu Dau Mot Town,10,398,374,24,4
2022-01-16,Binh Duong,Thu Dau Mot Town,11,565,536,29,5
2022-01-16,Binh Duong,Thu Dau Mot Town,12,544,507,37,10
2022-01-16,Binh Duong,Thu Dau Mot Town,13,400,377,23,2
2022-01-16,Binh Duong,Thu Dau Mot Town,14,346,323,23,4
2022-01-16,Binh Duong,Thu Dau Mot Town,15,308,292,16,3
2022-01-16,Binh Duong,Thu Dau Mot Town,16,292,270,22,6
2022-01-16,Binh Duong,Thu Dau Mot Town,17,353,330,23,14
2022-01-16,Binh Duong,Thu Dau Mot Town,18,395,366,29,5
2022-01-16,Binh Duong,Thu Dau Mot Town,19,333,305,28,3
2022-01-16,Binh Duong,Thu Dau Mot Town,20,216,197,19,5
2022-01-16,Binh Duong,Thu Dau Mot Town,21,100,84,16,5
2022-01-16,Binh Duong,Thu Dau Mot Town,22,2,0,2,1
2022-01-16,Binh Duong,Thuan An,6,3,0,3,3
2022-01-16,Binh Duong,Thuan An,7,16,3,13,10
2022-01-16,Binh Duong,Thuan An,8,14,10,4,4
2022-01-16,Binh Duong,Thuan An,9,20,9,11,5
2022-01-16,Binh Duong,Thuan An,10,54,39,15,8
2022-01-16,Binh Duong,Thuan An,11,85,52,33,20
2022-01-16,Binh Duong,Thuan An,12,85,45,40,26
2022-01-16,Binh Duong,Thuan An,13,77,41,36,31
2022-01-16,Binh Duong,Thuan An,14,66,30,36,30
2022-01-16,Binh Duong,Thuan An,15,60,24,36,30
2022-01-16,Binh Duong,Thuan An,16,54,32,22,19
2022-01-16,Binh Duong,Thuan An,17,56,27,29,25
2022-01-16,Binh Duong,Thuan An,18,60,27,33,28
2022-01-16,Binh Duong,Thuan An,19,40,21,19,16
2022-01-16,Binh Duong,Thuan An,20,28,10,18,17
2022-01-16,Binh Duong,Thuan An,21,10,0,10,10
2022-01-16,Binh Duong,Thuan An,23,1,0,1,1
2022-01-16,Can Tho City,Binh Thuy District,7,3,1,2,0
2022-01-16,Can Tho City,Binh Thuy District,8,3,3,0,0
2022-01-16,Can Tho City,Binh Thuy District,9,5,4,1,0
2022-01-16,Can Tho City,Binh Thuy District,10,10,8,2,0
2022-01-16,Can Tho City,Binh Thuy District,11,16,13,3,0
2022-01-16,Can Tho City,Binh Thuy District,12,12,11,1,0
2022-01-16,Can Tho City,Binh Thuy District,13,14,13,1,1
2022-01-16,Can Tho City,Binh Thuy District,14,10,10,0,0
2022-01-16,Can Tho City,Binh Thuy District,15,16,16,0,0
2022-01-16,Can Tho City,Binh Thuy District,16,7,6,1,0
2022-01-16,Can Tho City,Binh Thuy District,17,8,7,1,0
2022-01-16,Can Tho City,Binh Thuy District,18,11,11,0,0
2022-01-16,Can Tho City,Binh Thuy District,19,9,9,0,0
2022-01-16,Can Tho City,Binh Thuy District,20,3,2,1,0
2022-01-16,Can Tho City,Cai Rang District,0,3,2,1,0
2022-01-16,Can Tho City,Cai Rang District,7,5,5,0,0
2022-01-16,Can Tho City,Cai Rang District,8,4,4,0,0
2022-01-16,Can Tho City,Cai Rang District,9,6,5,1,0
2022-01-16,Can Tho City,Cai Rang District,10,10,9,1,0
2022-01-16,Can Tho City,Cai Rang District,11,11,11,0,0
2022-01-16,Can Tho City,Cai Rang District,12,8,8,0,0
2022-01-16,Can Tho City,Cai Rang District,13,8,7,1,0
2022-01-16,Can Tho City,Cai Rang District,14,3,2,1,0
2022-01-16,Can Tho City,Cai Rang District,15,2,1,1,1
2022-01-16,Can Tho City,Cai Rang District,16,10,10,0,0
2022-01-16,Can Tho City,Cai Rang District,17,7,7,0,0
2022-01-16,Can Tho City,Cai Rang District,18,11,11,0,0
2022-01-16,Can Tho City,Cai Rang District,19,9,9,0,0
2022-01-16,Can Tho City,Cai Rang District,20,7,6,1,0
2022-01-16,Can Tho City,Cai Rang District,21,2,2,0,0
2022-01-16,Can Tho City,Ninh Kieu District,0,5,5,0,0
2022-01-16,Can Tho City,Ninh Kieu District,1,6,3,3,0
2022-01-16,Can Tho City,Ninh Kieu District,2,3,0,3,0
2022-01-16,Can Tho City,Ninh Kieu District,5,2,2,0,0
2022-01-16,Can Tho City,Ninh Kieu District,6,54,49,5,0
2022-01-16,Can Tho City,Ninh Kieu District,7,173,165,8,0
2022-01-16,Can Tho City,Ninh Kieu District,8,247,233,14,0
2022-01-16,Can Tho City,Ninh Kieu District,9,299,285,14,0
2022-01-16,Can Tho City,Ninh Kieu District,10,507,484,23,0
2022-01-16,Can Tho City,Ninh Kieu District,11,775,736,39,0
2022-01-16,Can Tho City,Ninh Kieu District,12,542,515,27,0
2022-01-16,Can Tho City,Ninh Kieu District,13,445,430,15,0
2022-01-16,Can Tho City,Ninh Kieu District,14,393,375,18,0
2022-01-16,Can Tho City,Ninh Kieu District,15,330,311,19,0
2022-01-16,Can Tho City,Ninh Kieu District,16,415,396,19,0
2022-01-16,Can Tho City,Ninh Kieu District,17,508,480,28,0
2022-01-16,Can Tho City,Ninh Kieu District,18,476,457,19,0
2022-01-16,Can Tho City,Ninh Kieu District,19,397,373,24,0
2022-01-16,Can Tho City,Ninh Kieu District,20,336,311,25,0
2022-01-16,Can Tho City,Ninh Kieu District,21,132,123,9,0
2022-01-16,Can Tho City,Ninh Kieu District,22,2,0,2,0
2022-01-16,Can Tho City,Ninh Kieu District,23,4,3,1,0
2022-01-16,Dong Nai,Bien Hoa City,1,1,0,1,0
2022-01-16,Dong Nai,Bien Hoa City,2,1,0,1,0
2022-01-16,Dong Nai,Bien Hoa City,6,35,22,13,11
2022-01-16,Dong Nai,Bien Hoa City,7,185,144,41,26
2022-01-16,Dong Nai,Bien Hoa City,8,338,280,58,30
2022-01-16,Dong Nai,Bien Hoa City,9,430,379,51,19
2022-01-16,Dong Nai,Bien Hoa City,10,726,655,71,27
2022-01-16,Dong Nai,Bien Hoa City,11,1201,1039,162,73
2022-01-16,Dong Nai,Bien Hoa City,12,1064,890,174,101
2022-01-16,Dong Nai,Bien Hoa City,13,824,751,73,23
2022-01-16,Dong Nai,Bien Hoa City,14,611,554,57,18
2022-01-16,Dong Nai,Bien Hoa City,15,551,477,74,25
2022-01-16,Dong Nai,Bien Hoa City,16,582,460,122,75
2022-01-16,Dong Nai,Bien Hoa City,17,692,552,140,82
2022-01-16,Dong Nai,Bien Hoa City,18,737,595,142,83
2022-01-16,Dong Nai,Bien Hoa City,19,805,562,243,164
2022-01-16,Dong Nai,Bien Hoa City,20,689,389,300,229
2022-01-16,Dong Nai,Bien Hoa City,21,261,168,93,53
2022-01-16,Dong Nai,Bien Hoa City,22,2,0,2,0
2022-01-16,Dong Nai,Bien Hoa City,23,2,1,1,0
2022-01-16,Dong Nai,Long Thanh,10,1,0,1,1
2022-01-16,Dong Nai,Long Thanh,11,4,0,4,4
2022-01-16,Dong Nai,Long Thanh,12,1,0,1,1
2022-01-16,Dong Nai,Long Thanh,14,3,0,3,3
2022-01-16,Dong Nai,Long Thanh,15,1,0,1,1
2022-01-16,Dong Nai,Long Thanh,17,1,0,1,1
2022-01-16,Dong Nai,Thong Nhat,8,2,2,0,0
2022-01-16,Dong Nai,Thong Nhat,9,3,3,0,0
2022-01-16,Dong Nai,Thong Nhat,10,3,3,0,0
2022-01-16,Dong Nai,Thong Nhat,11,2,2,0,0
2022-01-16,Dong Nai,Thong Nhat,13,1,1,0,0
2022-01-16,Dong Nai,Thong Nhat,14,2,2,0,0
2022-01-16,Dong Nai,Thong Nhat,15,1,1,0,0
2022-01-16,Dong Nai,Thong Nhat,16,1,1,0,0
2022-01-16,Dong Nai,Thong Nhat,18,2,2,0,0
2022-01-16,Dong Nai,Thong Nhat,19,1,0,1,1
2022-01-16,Dong Nai,Thong Nhat,20,2,0,2,2
2022-01-16,Dong Nai,Trang Bom,18,1,1,0,0
2022-01-16,Dong Nai,Trang Bom,19,1,0,1,1
2022-01-16,Dong Nai,Vinh Cuu,10,1,0,1,0
2022-01-16,Hai Phong City,An Duong,7,1,1,0,0
2022-01-16,Hai Phong City,An Duong,8,1,0,1,1
2022-01-16,Hai Phong City,An Duong,9,4,3,1,1
2022-01-16,Hai Phong City,An Duong,10,1,0,1,0
2022-01-16,Hai Phong City,An Duong,11,4,1,3,2
2022-01-16,Hai Phong City,An Duong,12,2,1,1,0
2022-01-16,Hai Phong City,An Duong,13,7,4,3,2
2022-01-16,Hai Phong City,An Duong,14,5,3,2,0
2022-01-16,Hai Phong City,An Duong,15,2,0,2,0
2022-01-16,Hai Phong City,An Duong,16,3,1,2,2
2022-01-16,Hai Phong City,An Duong,17,3,1,2,0
2022-01-16,Hai Phong City,An Duong,18,1,0,1,0
2022-01-16,Hai Phong City,An Duong,19,2,1,1,1
2022-01-16,Hai Phong City,An Duong,21,1,0,1,1
2022-01-16,Hai Phong City,Do Son District,13,1,0,1,1
2022-01-16,Hai Phong City,Duong Kinh District,21,1,0,1,1
2022-01-16,Hai Phong City,Hai An District,5,1,1,0,0
2022-01-16,Hai Phong City,Hai An District,6,1,1,0,0
2022-01-16,Hai Phong City,Hai An District,7,8,6,2,0
2022-01-16,Hai Phong City,Hai An District,8,14,7,7,6
2022-01-16,Hai Phong City,Hai An District,9,16,15,1,0
2022-01-16,Hai Phong City,Hai An District,10,29,25,4,0
2022-01-16,Hai Phong City,Hai An District,11,36,32,4,2
2022-01-16,Hai Phong City,Hai An District,12,32,29,3,1
2022-01-16,Hai Phong City,Hai An District,13,18,16,2,0
2022-01-16,Hai Phong City,Hai An District,14,16,11,5,1
2022-01-16,Hai Phong City,Hai An District,15,18,14,4,0
2022-01-16,Hai Phong City,Hai An District,16,17,17,0,0
2022-01-16,Hai Phong City,Hai An District,17,30,26,4,0
2022-01-16,Hai Phong City,Hai An District,18,48,40,8,2
2022-01-16,Hai Phong City,Hai An District,19,22,18,4,0
2022-01-16,Hai Phong City,Hai An District,20,20,18,2,0
2022-01-16,Hai Phong City,Hai An District,21,14,12,2,0
2022-01-16,Hai Phong City,Hong Bang District,4,1,1,0,0
2022-01-16,Hai Phong City,Hong Bang District,7,24,20,4,1
2022-01-16,Hai Phong City,Hong Bang District,8,38,31,7,4
2022-01-16,Hai Phong City,Hong Bang District,9,49,40,9,4
2022-01-16,Hai Phong City,Hong Bang District,10,57,51,6,1
2022-01-16,Hai Phong City,Hong Bang District,11,143,103,40,20
2022-01-16,Hai Phong City,Hong Bang District,12,102,82,20,14
2022-01-16,Hai Phong City,Hong Bang District,13,69,59,10,2
2022-01-16,Hai Phong City,Hong Bang District,14,49,43,6,2
2022-01-16,Hai Phong City,Hong Bang District,15,48,43,5,3
2022-01-16,Hai Phong City,Hong Bang District,16,53,48,5,3
2022-01-16,Hai Phong City,Hong Bang District,17,62,52,10,2
2022-01-16,Hai Phong City,Hong Bang District,18,95,68,27,15
2022-01-16,Hai Phong City,Hong Bang District,19,80,66,14,7
2022-01-16,Hai Phong City,Hong Bang District,20,43,39,4,1
2022-01-16,Hai Phong City,Hong Bang District,21,21,16,5,1
2022-01-16,Hai Phong City,Hong Bang District,23,1,0,1,0
2022-01-16,Hai Phong City,Kien An District,7,4,1,3,0
2022-01-16,Hai Phong City,Kien An District,8,4,3,1,1
2022-01-16,Hai Phong City,Kien An District,9,6,2,4,4
2022-01-16,Hai Phong City,Kien An District,10,13,7,6,6
2022-01-16,Hai Phong City,Kien An District,11,15,10,5,2
2022-01-16,Hai Phong City,Kien An District,12,19,7,12,11
2022-01-16,Hai Phong City,Kien An District,13,11,9,2,1
2022-01-16,Hai Phong City,Kien An District,14,14,7,7,4
2022-01-16,Hai Phong City,Kien An District,15,11,8,3,3
2022-01-16,Hai Phong City,Kien An District,16,12,9,3,3
2022-01-16,Hai Phong City,Kien An District,17,10,5,5,2
2022-01-16,Hai Phong City,Kien An District,18,14,10,4,0
2022-01-16,Hai Phong City,Kien An District,19,10,8,2,1
2022-01-16,Hai Phong City,Kien An District,20,8,2,6,4
2022-01-16,Hai Phong City,Kien An District,21,7,1,6,6
2022-01-16,Hai Phong City,Le Chan District,0,2,1,1,0
2022-01-16,Hai Phong City,Le Chan District,1,3,2,1,0
2022-01-16,Hai Phong City,Le Chan District,4,1,0,1,0
2022-01-16,Hai Phong City,Le Chan District,6,1,0,1,0
2022-01-16,Hai Phong City,Le Chan District,7,59,50,9,7
2022-01-16,Hai Phong City,Le Chan District,8,107,93,14,3
2022-01-16,Hai Phong City,Le Chan District,9,112,98,14,0
2022-01-16,Hai Phong City,Le Chan District,10,239,208,31,9
2022-01-16,Hai Phong City,Le Chan District,11,498,369,129,96
2022-01-16,Hai Phong City,Le Chan District,12,321,274,47,13
2022-01-16,Hai Phong City,Le Chan District,13,155,139,16,0
2022-01-16,Hai Phong City,Le Chan District,14,165,155,10,2
2022-01-16,Hai Phong City,Le Chan District,15,221,189,32,9
2022-01-16,Hai Phong City,Le Chan District,16,198,174,24,2
2022-01-16,Hai Phong City,Le Chan District,17,281,259,22,5
2022-01-16,Hai Phong City,Le Chan District,18,335,259,76,36
2022-01-16,Hai Phong City,Le Chan District,19,271,236,35,11
2022-01-16,Hai Phong City,Le Chan District,20,203,161,42,10
2022-01-16,Hai Phong City,Le Chan District,21,82,63,19,1
2022-01-16,Hai Phong City,Le Chan District,22,1,0,1,0
2022-01-16,Hai Phong City,Ngo Quyen District,0,1,1,0,0
2022-01-16,Hai Phong City,Ngo Quyen District,2,1,0,1,0
2022-01-16,Hai Phong City,Ngo Quyen District,4,1,0,1,0
2022-01-16,Hai Phong City,Ngo Quyen District,5,2,0,2,0
2022-01-16,Hai Phong City,Ngo Quyen District,7,42,27,15,10
2022-01-16,Hai Phong City,Ngo Quyen District,8,98,82,16,4
2022-01-16,Hai Phong City,Ngo Quyen District,9,135,121,14,4
2022-01-16,Hai Phong City,Ngo Quyen District,10,209,185,24,5
2022-01-16,Hai Phong City,Ngo Quyen District,11,349,288,61,30
2022-01-16,Hai Phong City,Ngo Quyen District,12,251,221,30,6
2022-01-16,Hai Phong City,Ngo Quyen District,13,178,162,16,0
2022-01-16,Hai Phong City,Ngo Quyen District,14,167,150,17,2
2022-01-16,Hai Phong City,Ngo Quyen District,15,210,186,24,7
2022-01-16,Hai Phong City,Ngo Quyen District,16,194,173,21,3
2022-01-16,Hai Phong City,Ngo Quyen District,17,205,180,25,7
2022-01-16,Hai Phong City,Ngo Quyen District,18,318,228,90,53
2022-01-16,Hai Phong City,Ngo Quyen District,19,205,172,33,14
2022-01-16,Hai Phong City,Ngo Quyen District,20,171,147,24,6
2022-01-16,Hai Phong City,Ngo Quyen District,21,69,55,14,1
2022-01-16,Hai Phong City,Ngo Quyen District,23,1,1,0,0
2022-01-16,Hai Phong City,Thuy Nguyen,10,1,0,1,1
2022-01-16,Hai Phong City,Thuy Nguyen,11,1,0,1,1
2022-01-16,Hai Phong City,Thuy Nguyen,14,1,0,1,1
2022-01-16,Hai Phong City,Thuy Nguyen,16,1,0,1,1
2022-01-16,Hai Phong City,Thuy Nguyen,18,5,0,5,4
2022-01-16,Hai Phong City,Thuy Nguyen,19,1,0,1,1
2022-01-16,Hai Phong City,Thuy Nguyen,20,1,0,1,1
2022-01-16,Hue City,Hue City,0,12,9,3,0
2022-01-16,Hue City,Hue City,1,4,3,1,0
2022-01-16,Hue City,Hue City,2,4,3,1,0
2022-01-16,Hue City,Hue City,3,1,1,0,0
2022-01-16,Hue City,Hue City,4,1,1,0,0
2022-01-16,Hue City,Hue City,5,2,2,0,0
2022-01-16,Hue City,Hue City,6,66,54,12,8
2022-01-16,Hue City,Hue City,7,292,267,25,1
2022-01-16,Hue City,Hue City,8,424,406,18,1
2022-01-16,Hue City,Hue City,9,355,331,24,0
2022-01-16,Hue City,Hue City,10,450,428,22,1
2022-01-16,Hue City,Hue City,11,817,776,41,2
2022-01-16,Hue City,Hue City,12,635,590,45,1
2022-01-16,Hue City,Hue City,13,361,342,19,0
2022-01-16,Hue City,Hue City,14,423,397,26,0
2022-01-16,Hue City,Hue City,15,445,427,18,1
2022-01-16,Hue City,Hue City,16,473,435,38,1
2022-01-16,Hue City,Hue City,17,633,594,39,2
2022-01-16,Hue City,Hue City,18,705,656,49,3
2022-01-16,Hue City,Hue City,19,627,572,55,5
2022-01-16,Hue City,Hue City,20,429,380,49,4
2022-01-16,Hue City,Hue City,21,195,169,26,3
2022-01-16,Hue City,Hue City,22,5,1,4,1
2022-01-16,Hue City,Hue City,23,3,1,2,1
2022-01-16,Hue City,Huong Thuy,8,1,1,0,0
2022-01-16,Hue City,Huong Thuy,16,2,2,0,0
2022-01-16,Hue City,Huong Thuy,17,2,2,0,0
2022-01-16,Hue City,Huong Thuy,18,1,1,0,0
2022-01-16,Hue City,Huong Thuy,19,3,3,0,0
2022-01-16,Hue City,Huong Thuy,21,1,0,1,0
2022-01-16,Hue City,Huong Tra,9,1,1,0,0
2022-01-16,Hue City,Huong Tra,12,1,1,0,0
2022-01-16,Hue City,Huong Tra,14,2,1,1,1
2022-01-16,Hue City,Huong Tra,16,1,1,0,0
2022-01-16,Hue City,Huong Tra,18,1,0,1,0
2022-01-16,Hue City,Huong Tra,19,1,0,1,0
2022-01-16,Hue City,Phu Vang,6,1,1,0,0
2022-01-16,Hue City,Phu Vang,7,2,2,0,0
2022-01-16,Hue City,Phu Vang,8,3,2,1,0
2022-01-16,Hue City,Phu Vang,10,4,1,3,2
2022-01-16,Hue City,Phu Vang,11,7,2,5,4
2022-01-16,Hue City,Phu Vang,14,1,1,0,0
2022-01-16,Hue City,Phu Vang,15,2,1,1,1
2022-01-16,Hue City,Phu Vang,16,2,1,1,0
2022-01-16,Hue City,Phu Vang,18,1,1,0,0
2022-01-16,Hue City,Phu Vang,19,1,1,0,0
2022-01-16,Hue City,Phu Vang,20,3,1,2,0
2022-01-16,Vung Tau,Ba Ria City,7,1,0,1,1
2022-01-16,Vung Tau,Ba Ria City,8,18,2,16,12
2022-01-16,Vung Tau,Ba Ria City,9,11,4,7,7
2022-01-16,Vung Tau,Ba Ria City,10,6,4,2,1
2022-01-16,Vung Tau,Ba Ria City,11,12,3,9,6
2022-01-16,Vung Tau,Ba Ria City,12,12,3,9,8
2022-01-16,Vung Tau,Ba Ria City,13,10,6,4,4
2022-01-16,Vung Tau,Ba Ria City,14,12,7,5,4
2022-01-16,Vung Tau,Ba Ria City,15,5,3,2,1
2022-01-16,Vung Tau,Ba Ria City,16,6,5,1,1
2022-01-16,Vung Tau,Ba Ria City,17,9,3,6,4
2022-01-16,Vung Tau,Ba Ria City,18,8,2,6,5
2022-01-16,Vung Tau,Ba Ria City,19,10,0,10,8
2022-01-16,Vung Tau,Ba Ria City,20,5,0,5,5
2022-01-16,Vung Tau,Tan Thanh,17,1,0,1,1
2022-01-16,Vung Tau,Tan Thanh,18,1,0,1,0
2022-01-16,Vung Tau,Vung Tau City,0,4,3,1,0
2022-01-16,Vung Tau,Vung Tau City,1,1,1,0,0
2022-01-16,Vung Tau,Vung Tau City,2,1,1,0,0
2022-01-16,Vung Tau,Vung Tau City,5,1,1,0,0
2022-01-16,Vung Tau,Vung Tau City,6,34,29,5,2
2022-01-16,Vung Tau,Vung Tau City,7,137,123,14,4
2022-01-16,Vung Tau,Vung Tau City,8,211,197,14,1
2022-01-16,Vung Tau,Vung Tau City,9,225,213,12,1
2022-01-16,Vung Tau,Vung Tau City,10,286,256,30,1
2022-01-16,Vung Tau,Vung Tau City,11,384,355,29,4
2022-01-16,Vung Tau,Vung Tau City,12,348,337,11,0
2022-01-16,Vung Tau,Vung Tau City,13,211,197,14,0
2022-01-16,Vung Tau,Vung Tau City,14,243,226,17,0
2022-01-16,Vung Tau,Vung Tau City,15,222,205,17,1
2022-01-16,Vung Tau,Vung Tau City,16,232,208,24,1
2022-01-16,Vung Tau,Vung Tau City,17,260,231,29,4
2022-01-16,Vung Tau,Vung Tau City,18,356,314,42,8
2022-01-16,Vung Tau,Vung Tau City,19,257,232,25,4
2022-01-16,Vung Tau,Vung Tau City,20,193,156,37,9
2022-01-16,Vung Tau,Vung Tau City,21,98,75,23,9
2022-01-16,Vung Tau,Vung Tau City,23,4,1,3,0
2022-01-17,Binh Duong,Ben Cat,11,1,0,1,0
2022-01-17,Binh Duong,Di An,6,2,0,2,1
2022-01-17,Binh Duong,Di An,7,5,0,5,5
2022-01-17,Binh Duong,Di An,8,10,2,8,7
2022-01-17,Binh Duong,Di An,9,6,2,4,2
2022-01-17,Binh Duong,Di An,10,19,13,6,6
2022-01-17,Binh Duong,Di An,11,26,16,10,9
2022-01-17,Binh Duong,Di An,12,23,12,11,11
2022-01-17,Binh Duong,Di An,13,22,11,11,10
2022-01-17,Binh Duong,Di An,14,17,10,7,6
2022-01-17,Binh Duong,Di An,15,18,6,12,9
2022-01-17,Binh Duong,Di An,16,13,11,2,2
2022-01-17,Binh Duong,Di An,17,8,8,0,0
2022-01-17,Binh Duong,Di An,18,15,6,9,7
2022-01-17,Binh Duong,Di An,19,17,12,5,4
2022-01-17,Binh Duong,Di An,20,8,5,3,3
2022-01-17,Binh Duong,Di An,21,2,0,2,0
2022-01-17,Binh Duong,Tan Uyen,10,2,1,1,0
2022-01-17,Binh Duong,Tan Uyen,11,2,1,1,0
2022-01-17,Binh Duong,Tan Uyen,12,1,1,0,0
2022-01-17,Binh Duong,Tan Uyen,13,2,2,0,0
2022-01-17,Binh Duong,Tan Uyen,14,2,0,2,2
2022-01-17,Binh Duong,Tan Uyen,16,1,0,1,1
2022-01-17,Binh Duong,Tan Uyen,18,1,0,1,1
2022-01-17,Binh Duong,Tan Uyen,20,1,0,1,1
2022-01-17,Binh Duong,Tan Uyen,21,1,0,1,1
2022-01-17,Binh Duong,Thu Dau Mot Town,2,1,1,0,0
2022-01-17,Binh Duong,Thu Dau Mot Town,3,1,1,0,0
2022-01-17,Binh Duong,Thu Dau Mot Town,5,1,1,0,0
2022-01-17,Binh Duong,Thu Dau Mot Town,6,25,17,8,5
2022-01-17,Binh Duong,Thu Dau Mot Town,7,85,80,5,2
2022-01-17,Binh Duong,Thu Dau Mot Town,8,166,155,11,6
2022-01-17,Binh Duong,Thu Dau Mot Town,9,241,227,14,0
2022-01-17,Binh Duong,Thu Dau Mot Town,10,324,307,17,2
2022-01-17,Binh Duong,Thu Dau Mot Town,11,583,536,47,12
2022-01-17,Binh Duong,Thu Dau Mot Town,12,436,419,17,1
2022-01-17,Binh Duong,Thu Dau Mot Town,13,351,323,28,1
2022-01-17,Binh Duong,Thu Dau Mot Town,14,301,287,14,2
2022-01-17,Binh Duong,Thu Dau Mot Town,15,250,236,14,1
2022-01-17,Binh Duong,Thu Dau Mot Town,16,264,251,13,3
2022-01-17,Binh Duong,Thu Dau Mot Town,17,308,295,13,0
2022-01-17,Binh Duong,Thu Dau Mot Town,18,356,330,26,8
2022-01-17,Binh Duong,Thu Dau Mot Town,19,281,264,17,2
2022-01-17,Binh Duong,Thu Dau Mot Town,20,212,201,11,2
2022-01-17,Binh Duong,Thu Dau Mot Town,21,78,66,12,1
2022-01-17,Binh Duong,Thu Dau Mot Town,23,1,0,1,0
2022-01-17,Binh Duong,Thuan An,7,6,2,4,2
2022-01-17,Binh Duong,Thuan An,8,13,3,10,8
2022-01-17,Binh Duong,Thuan An,9,37,19,18,15
2022-01-17,Binh Duong,Thuan An,10,48,35,13,9
2022-01-17,Binh Duong,Thuan An,11,91,66,25,19
2022-01-17,Binh Duong,Thuan An,12,71,53,18,12
2022-01-17,Binh Duong,Thuan An,13,52,38,14,10
2022-01-17,Binh Duong,Thuan An,14,37,27,10,8
2022-01-17,Binh Duong,Thuan An,15,51,27,24,17
2022-01-17,Binh Duong,Thuan An,16,32,23,9,7
2022-01-17,Binh Duong,Thuan An,17,24,18,6,4
2022-01-17,Binh Duong,Thuan An,18,34,23,11,7
2022-01-17,Binh Duong,Thuan An,19,24,21,3,1
2022-01-17,Binh Duong,Thuan An,20,31,20,11,10
2022-01-17,Binh Duong,Thuan An,21,10,5,5,5
2022-01-17,Binh Duong,Thuan An,22,1,0,1,0
2022-01-17,Can Tho City,Binh Thuy District,6,1,1,0,0
2022-01-17,Can Tho City,Binh Thuy District,7,1,1,0,0
2022-01-17,Can Tho City,Binh Thuy District,8,5,3,2,1
2022-01-17,Can Tho City,Binh Thuy District,9,4,4,0,0
2022-01-17,Can Tho City,Binh Thuy District,10,6,6,0,0
2022-01-17,Can Tho City,Binh Thuy District,11,8,8,0,0
2022-01-17,Can Tho City,Binh Thuy District,12,13,11,2,0
2022-01-17,Can Tho City,Binh Thuy District,13,13,12,1,0
2022-01-17,Can Tho City,Binh Thuy District,14,16,12,4,0
2022-01-17,Can Tho City,Binh Thuy District,15,12,12,0,0
2022-01-17,Can Tho City,Binh Thuy District,16,4,4,0,0
2022-01-17,Can Tho City,Binh Thuy District,17,9,9,0,0
2022-01-17,Can Tho City,Binh Thuy District,18,19,17,2,0
2022-01-17,Can Tho City,Binh Thuy District,19,7,7,0,0
2022-01-17,Can Tho City,Binh Thuy District,20,3,3,0,0
2022-01-17,Can Tho City,Binh Thuy District,21,1,1,0,0
2022-01-17,Can Tho City,Cai Rang District,0,1,0,1,1
2022-01-17,Can Tho City,Cai Rang District,6,2,1,1,1
2022-01-17,Can Tho City,Cai Rang District,7,3,3,0,0
2022-01-17,Can Tho City,Cai Rang District,8,6,6,0,0
2022-01-17,Can Tho City,Cai Rang District,9,6,5,1,0
2022-01-17,Can Tho City,Cai Rang District,10,11,6,5,1
2022-01-17,Can Tho City,Cai Rang District,11,11,11,0,0
2022-01-17,Can Tho City,Cai Rang District,12,9,9,0,0
2022-01-17,Can Tho City,Cai Rang District,13,10,10,0,0
2022-01-17,Can Tho City,Cai Rang District,14,8,6,2,0
2022-01-17,Can Tho City,Cai Rang District,15,7,7,0,0
2022-01-17,Can Tho City,Cai Rang District,16,11,10,1,0
2022-01-17,Can Tho City,Cai Rang District,17,7,6,1,0
2022-01-17,Can Tho City,Cai Rang District,18,7,7,0,0
2022-01-17,Can Tho City,Cai Rang District,19,9,6,3,2
2022-01-17,Can Tho City,Cai Rang District,20,9,6,3,0
2022-01-17,Can Tho City,Cai Rang District,21,3,3,0,0
2022-01-17,Can Tho City,Cai Rang District,22,1,1,0,0
2022-01-17,Can Tho City,Ninh Kieu District,0,3,2,1,0
2022-01-17,Can Tho City,Ninh Kieu District,1,1,0,1,0
2022-01-17,Can Tho City,Ninh Kieu District,4,2,2,0,0
2022-01-17,Can Tho City,Ninh Kieu District,5,1,1,0,0
2022-01-17,Can Tho City,Ninh Kieu District,6,49,46,3,0
2022-01-17,Can Tho City,Ninh Kieu District,7,145,130,15,0
2022-01-17,Can Tho City,Ninh Kieu District,8,262,252,10,0
2022-01-17,Can Tho City,Ninh Kieu District,9,308,292,16,0
2022-01-17,Can Tho City,Ninh Kieu District,10,431,417,14,0
2022-01-17,Can Tho City,Ninh Kieu District,11,810,774,36,0
2022-01-17,Can Tho City,Ninh Kieu District,12,489,477,12,0
2022-01-17,Can Tho City,Ninh Kieu District,13,436,419,17,0
2022-01-17,Can Tho City,Ninh Kieu District,14,284,275,9,0
2022-01-17,Can Tho City,Ninh Kieu District,15,272,257,15,0
2022-01-17,Can Tho City,Ninh Kieu District,16,337,325,12,0
2022-01-17,Can Tho City,Ninh Kieu District,17,462,436,26,0
2022-01-17,Can Tho City,Ninh Kieu District,18,441,420,21,0
2022-01-17,Can Tho City,Ninh Kieu District,19,332,310,22,0
2022-01-17,Can Tho City,Ninh Kieu District,20,288,263,25,0
2022-01-17,Can Tho City,Ninh Kieu District,21,132,120,12,0
2022-01-17,Can Tho City,Ninh Kieu District,22,3,3,0,0
2022-01-17,Can Tho City,Ninh Kieu District,23,2,2,0,0
2022-01-17,Can Tho City,Phong Dien,17,1,1,0,0
2022-01-17,Dong Nai,Bien Hoa City,1,2,2,0,0
2022-01-17,Dong Nai,Bien Hoa City,5,1,1,0,0
2022-01-17,Dong Nai,Bien Hoa City,6,28,22,6,4
2022-01-17,Dong Nai,Bien Hoa City,7,162,125,37,23
2022-01-17,Dong Nai,Bien Hoa City,8,297,255,42,19
2022-01-17,Dong Nai,Bien Hoa City,9,388,342,46,7
2022-01-17,Dong Nai,Bien Hoa City,10,665,604,61,15
2022-01-17,Dong Nai,Bien Hoa City,11,1063,942,121,38
2022-01-17,Dong Nai,Bien Hoa City,12,827,759,68,17
2022-01-17,Dong Nai,Bien Hoa City,13,720,652,68,8
2022-01-17,Dong Nai,Bien Hoa City,14,603,554,49,3
2022-01-17,Dong Nai,Bien Hoa City,15,471,425,46,8
2022-01-17,Dong Nai,Bien Hoa City,16,489,458,31,9
2022-01-17,Dong Nai,Bien Hoa City,17,555,517,38,7
2022-01-17,Dong Nai,Bien Hoa City,18,644,591,53,14
2022-01-17,Dong Nai,Bien Hoa City,19,546,514,32,6
2022-01-17,Dong Nai,Bien Hoa City,20,387,336,51,23
2022-01-17,Dong Nai,Bien Hoa City,21,205,134,71,37
2022-01-17,Dong Nai,Bien Hoa City,22,5,2,3,0
2022-01-17,Dong Nai,Bien Hoa City,23,3,2,1,1
2022-01-17,Dong Nai,Long Thanh,14,2,0,2,2
2022-01-17,Dong Nai,Long Thanh,15,2,0,2,2
2022-01-17,Dong Nai,Long Thanh,16,1,0,1,1
2022-01-17,Dong Nai,Long Thanh,17,1,0,1,1
2022-01-17,Dong Nai,Long Thanh,18,1,0,1,0
2022-01-17,Dong Nai,Thong Nhat,8,2,2,0,0
2022-01-17,Dong Nai,Thong Nhat,11,1,1,0,0
2022-01-17,Dong Nai,Thong Nhat,12,2,2,0,0
2022-01-17,Dong Nai,Thong Nhat,13,1,1,0,0
2022-01-17,Dong Nai,Thong Nhat,14,2,2,0,0
2022-01-17,Dong Nai,Thong Nhat,17,1,1,0,0
2022-01-17,Dong Nai,Thong Nhat,18,6,2,4,0
2022-01-17,Dong Nai,Thong Nhat,21,2,1,1,1
2022-01-17,Dong Nai,Trang Bom,10,1,0,1,1
2022-01-17,Dong Nai,Trang Bom,12,1,0,1,1
2022-01-17,Dong Nai,Trang Bom,18,1,0,1,1
2022-01-17,Hai Phong City,An Duong,8,1,0,1,1
2022-01-17,Hai Phong City,An Duong,9,1,1,0,0
2022-01-17,Hai Phong City,An Duong,10,1,0,1,0
2022-01-17,Hai Phong City,An Duong,11,4,2,2,1
2022-01-17,Hai Phong City,An Duong,12,1,1,0,0
2022-01-17,Hai Phong City,An Duong,13,5,3,2,0
2022-01-17,Hai Phong City,An Duong,14,2,1,1,0
2022-01-17,Hai Phong City,An Duong,15,11,3,8,3
2022-01-17,Hai Phong City,An Duong,16,3,1,2,1
2022-01-17,Hai Phong City,An Duong,17,1,1,0,0
2022-01-17,Hai Phong City,An Duong,18,2,1,1,1
2022-01-17,Hai Phong City,An Duong,19,1,0,1,0
2022-01-17,Hai Phong City,An Duong,20,1,1,0,0
2022-01-17,Hai Phong City,Hai An District,3,1,1,0,0
2022-01-17,Hai Phong City,Hai An District,7,7,3,4,3
2022-01-17,Hai Phong City,Hai An District,8,26,15,11,5
2022-01-17,Hai Phong City,Hai An District,9,20,11,9,5
2022-01-17,Hai Phong City,Hai An District,10,21,18,3,1
2022-01-17,Hai Phong City,Hai An District,11,60,54,6,4
2022-01-17,Hai Phong City,Hai An District,12,31,25,6,0
2022-01-17,Hai Phong City,Hai An District,13,11,10,1,0
2022-01-17,Hai Phong City,Hai An District,14,7,5,2,1
2022-01-17,Hai Phong City,Hai An District,15,17,12,5,1
2022-01-17,Hai Phong City,Hai An District,16,18,15,3,0
2022-01-17,Hai Phong City,Hai An District,17,24,20,4,0
2022-01-17,Hai Phong City,Hai An District,18,30,27,3,0
2022-01-17,Hai Phong City,Hai An District,19,28,23,5,0
2022-01-17,Hai Phong City,Hai An District,20,22,17,5,0
2022-01-17,Hai Phong City,Hai An District,21,12,8,4,0
2022-01-17,Hai Phong City,Hong Bang District,2,1,0,1,1
2022-01-17,Hai Phong City,Hong Bang District,4,1,0,1,1
2022-01-17,Hai Phong City,Hong Bang District,6,3,0,3,1
2022-01-17,Hai Phong City,Hong Bang District,7,14,7,7,5
2022-01-17,Hai Phong City,Hong Bang District,8,54,23,31,27
2022-01-17,Hai Phong City,Hong Bang District,9,60,38,22,16
2022-01-17,Hai Phong City,Hong Bang District,10,66,54,12,7
2022-01-17,Hai Phong City,Hong Bang District,11,179,122,57,41
2022-01-17,Hai Phong City,Hong Bang District,12,104,90,14,7
2022-01-17,Hai Phong City,Hong Bang District,13,47,46,1,0
2022-01-17,Hai Phong City,Hong Bang District,14,50,42,8,1
2022-01-17,Hai Phong City,Hong Bang District,15,55,42,13,2
2022-01-17,Hai Phong City,Hong Bang District,16,47,43,4,0
2022-01-17,Hai Phong City,Hong Bang District,17,49,43,6,0
2022-01-17,Hai Phong City,Hong Bang District,18,94,90,4,1
2022-01-17,Hai Phong City,Hong Bang District,19,68,61,7,0
2022-01-17,Hai Phong City,Hong Bang District,20,36,30,6,0
2022-01-17,Hai Phong City,Hong Bang District,21,17,9,8,2
2022-01-17,Hai Phong City,Hong Bang District,22,2,1,1,0
2022-01-17,Hai Phong City,Kien An District,7,2,0,2,2
2022-01-17,Hai Phong City,Kien An District,8,2,0,2,2
2022-01-17,Hai Phong City,Kien An District,9,6,2,4,4
2022-01-17,Hai Phong City,Kien An District,10,6,4,2,2
2022-01-17,Hai Phong City,Kien An District,11,7,5,2,0
2022-01-17,Hai Phong City,Kien An District,12,12,3,9,8
2022-01-17,Hai Phong City,Kien An District,13,7,6,1,1
2022-01-17,Hai Phong City,Kien An District,14,7,4,3,2
2022-01-17,Hai Phong City,Kien An District,15,19,9,10,9
2022-01-17,Hai Phong City,Kien An District,16,9,4,5,3
2022-01-17,Hai Phong City,Kien An District,17,8,3,5,4
2022-01-17,Hai Phong City,Kien An District,18,7,3,4,3
2022-01-17,Hai Phong City,Kien An District,19,8,0,8,5
2022-01-17,Hai Phong City,Kien An District,20,7,1,6,6
2022-01-17,Hai Phong City,Kien An District,21,8,2,6,5
2022-01-17,Hai Phong City,Le Chan District,0,5,2,3,1
2022-01-17,Hai Phong City,Le Chan District,2,1,0,1,0
2022-01-17,Hai Phong City,Le Chan District,7,43,27,16,12
2022-01-17,Hai Phong City,Le Chan District,8,139,59,80,62
2022-01-17,Hai Phong City,Le Chan District,9,113,79,34,24
2022-01-17,Hai Phong City,Le Chan District,10,223,180,43,20
2022-01-17,Hai Phong City,Le Chan District,11,377,285,92,51
2022-01-17,Hai Phong City,Le Chan District,12,243,195,48,22
2022-01-17,Hai Phong City,Le Chan District,13,118,108,10,0
2022-01-17,Hai Phong City,Le Chan District,14,117,97,20,3
2022-01-17,Hai Phong City,Le Chan District,15,192,170,22,2
2022-01-17,Hai Phong City,Le Chan District,16,194,169,25,1
2022-01-17,Hai Phong City,Le Chan District,17,202,177,25,0
2022-01-17,Hai Phong City,Le Chan District,18,253,231,22,1
2022-01-17,Hai Phong City,Le Chan District,19,214,188,26,2
2022-01-17,Hai Phong City,Le Chan District,20,141,118,23,0
2022-01-17,Hai Phong City,Le Chan District,21,90,66,24,3
2022-01-17,Hai Phong City,Le Chan District,22,3,1,2,1
2022-01-17,Hai Phong City,Ngo Quyen District,0,1,1,0,0
2022-01-17,Hai Phong City,Ngo Quyen District,6,1,1,0,0
2022-01-17,Hai Phong City,Ngo Quyen District,7,35,16,19,14
2022-01-17,Hai Phong City,Ngo Quyen District,8,132,56,76,68
2022-01-17,Hai Phong City,Ngo Quyen District,9,139,82,57,44
2022-01-17,Hai Phong City,Ngo Quyen District,10,160,139,21,9
2022-01-17,Hai Phong City,Ngo Quyen District,11,278,211,67,38
2022-01-17,Hai Phong City,Ngo Quyen District,12,206,176,30,8
2022-01-17,Hai Phong City,Ngo Quyen District,13,109,99,10,0
2022-01-17,Hai Phong City,Ngo Quyen District,14,137,127,10,0
2022-01-17,Hai Phong City,Ngo Quyen District,15,162,144,18,4
2022-01-17,Hai Phong City,Ngo Quyen District,16,172,154,18,0
2022-01-17,Hai Phong City,Ngo Quyen District,17,150,133,17,0
2022-01-17,Hai Phong City,Ngo Quyen District,18,203,184,19,0
2022-01-17,Hai Phong City,Ngo Quyen District,19,168,148,20,1
2022-01-17,Hai Phong City,Ngo Quyen District,20,141,131,10,3
2022-01-17,Hai Phong City,Ngo Quyen District,21,78,64,14,1
2022-01-17,Hai Phong City,Ngo Quyen District,23,1,1,0,0
2022-01-17,Hai Phong City,Thuy Nguyen,6,1,0,1,0
2022-01-17,Hai Phong City,Thuy Nguyen,9,1,0,1,1
2022-01-17,Hai Phong City,Thuy Nguyen,10,4,0,4,3
2022-01-17,Hai Phong City,Thuy Nguyen,11,4,0,4,3
2022-01-17,Hai Phong City,Thuy Nguyen,15,1,0,1,1
2022-01-17,Hue City,Hue City,0,2,2,0,0
2022-01-17,Hue City,Hue City,1,6,6,0,0
2022-01-17,Hue City,Hue City,3,2,2,0,0
2022-01-17,Hue City,Hue City,5,4,2,2,2
2022-01-17,Hue City,Hue City,6,61,54,7,0
2022-01-17,Hue City,Hue City,7,234,208,26,2
2022-01-17,Hue City,Hue City,8,422,386,36,0
2022-01-17,Hue City,Hue City,9,296,279,17,1
2022-01-17,Hue City,Hue City,10,425,398,27,1
2022-01-17,Hue City,Hue City,11,841,797,44,1
2022-01-17,Hue City,Hue City,12,464,443,21,1
2022-01-17,Hue City,Hue City,13,325,308,17,0
2022-01-17,Hue City,Hue City,14,341,325,16,0
2022-01-17,Hue City,Hue City,15,412,386,26,0
2022-01-17,Hue City,Hue City,16,402,369,33,0
2022-01-17,Hue City,Hue City,17,569,531,38,0
2022-01-17,Hue City,Hue City,18,733,681,52,5
2022-01-17,Hue City,Hue City,19,681,620,61,6
2022-01-17,Hue City,Hue City,20,470,429,41,3
2022-01-17,Hue City,Hue City,21,238,197,41,8
2022-01-17,Hue City,Hue City,22,3,0,3,0
2022-01-17,Hue City,Hue City,23,1,1,0,0
2022-01-17,Hue City,Huong Thuy,11,1,1,0,0
2022-01-17,Hue City,Huong Thuy,12,3,2,1,1
2022-01-17,Hue City,Huong Thuy,17,1,1,0,0
2022-01-17,Hue City,Huong Thuy,19,2,1,1,0
2022-01-17,Hue City,Huong Thuy,20,1,1,0,0
2022-01-17,Hue City,Huong Tra,21,3,1,2,2
2022-01-17,Hue City,Phu Vang,6,1,1,0,0
2022-01-17,Hue City,Phu Vang,9,1,1,0,0
2022-01-17,Hue City,Phu Vang,11,1,1,0,0
2022-01-17,Hue City,Phu Vang,12,1,1,0,0
2022-01-17,Hue City,Phu Vang,13,1,1,0,0
2022-01-17,Hue City,Phu Vang,14,1,1,0,0
2022-01-17,Hue City,Phu Vang,16,3,1,2,0
2022-01-17,Hue City,Phu Vang,17,2,2,0,0
2022-01-17,Hue City,Phu Vang,18,3,2,1,0
2022-01-17,Hue City,Phu Vang,21,2,0,2,0
2022-01-17,Vung Tau,Ba Ria City,7,2,0,2,2
2022-01-17,Vung Tau,Ba Ria City,8,2,0,2,2
2022-01-17,Vung Tau,Ba Ria City,9,6,2,4,3
2022-01-17,Vung Tau,Ba Ria City,10,11,7,4,3
2022-01-17,Vung Tau,Ba Ria City,11,17,1,16,12
2022-01-17,Vung Tau,Ba Ria City,12,8,2,6,4
2022-01-17,Vung Tau,Ba Ria City,13,9,0,9,9
2022-01-17,Vung Tau,Ba Ria City,14,9,5,4,4
2022-01-17,Vung Tau,Ba Ria City,15,6,2,4,4
2022-01-17,Vung Tau,Ba Ria City,16,4,2,2,2
2022-01-17,Vung Tau,Ba Ria City,17,11,3,8,7
2022-01-17,Vung Tau,Ba Ria City,18,15,4,11,11
2022-01-17,Vung Tau,Ba Ria City,19,6,2,4,3
2022-01-17,Vung Tau,Ba Ria City,20,4,1,3,2
2022-01-17,Vung Tau,Ba Ria City,22,1,0,1,1
2022-01-17,Vung Tau,Tan Thanh,11,1,0,1,1
2022-01-17,Vung Tau,Tan Thanh,18,2,0,2,1
2022-01-17,Vung Tau,Vung Tau City,0,3,2,1,0
2022-01-17,Vung Tau,Vung Tau City,5,1,1,0,0
2022-01-17,Vung Tau,Vung Tau City,6,29,26,3,2
2022-01-17,Vung Tau,Vung Tau City,7,101,96,5,0
2022-01-17,Vung Tau,Vung Tau City,8,170,155,15,3
2022-01-17,Vung Tau,Vung Tau City,9,188,170,18,0
2022-01-17,Vung Tau,Vung Tau City,10,185,157,28,4
2022-01-17,Vung Tau,Vung Tau City,11,397,350,47,13
2022-01-17,Vung Tau,Vung Tau City,12,292,271,21,0
2022-01-17,Vung Tau,Vung Tau City,13,205,186,19,0
2022-01-17,Vung Tau,Vung Tau City,14,219,192,27,4
2022-01-17,Vung Tau,Vung Tau City,15,232,212,20,3
2022-01-17,Vung Tau,Vung Tau City,16,188,173,15,0
2022-01-17,Vung Tau,Vung Tau City,17,233,210,23,2
2022-01-17,Vung Tau,Vung Tau City,18,307,268,39,1
2022-01-17,Vung Tau,Vung Tau City,19,267,243,24,0
2022-01-17,Vung Tau,Vung Tau City,20,185,159,26,5
2022-01-17,Vung Tau,Vung Tau City,21,106,77,29,12
2022-01-17,Vung Tau,Vung Tau City,22,3,2,1,0
2022-01-18,Binh Duong,Ben Cat,12,1,0,1,1
2022-01-18,Binh Duong,Ben Cat,13,1,1,0,0
2022-01-18,Binh Duong,Di An,6,1,0,1,1
2022-01-18,Binh Duong,Di An,7,5,0,5,5
2022-01-18,Binh Duong,Di An,8,7,4,3,3
2022-01-18,Binh Duong,Di An,9,17,9,8,8
2022-01-18,Binh Duong,Di An,10,17,9,8,5
2022-01-18,Binh Duong,Di An,11,49,20,29,28
2022-01-18,Binh Duong,Di An,12,26,11,15,11
2022-01-18,Binh Duong,Di An,13,23,11,12,10
2022-01-18,Binh Duong,Di An,14,34,25,9,8
2022-01-18,Binh Duong,Di An,15,15,11,4,3
2022-01-18,Binh Duong,Di An,16,8,7,1,1
2022-01-18,Binh Duong,Di An,17,9,6,3,3
2022-01-18,Binh Duong,Di An,18,19,9,10,5
2022-01-18,Binh Duong,Di An,19,9,4,5,5
2022-01-18,Binh Duong,Di An,20,13,6,7,6
2022-01-18,Binh Duong,Di An,21,5,2,3,2
2022-01-18,Binh Duong,Phu Giao,16,1,0,1,1
2022-01-18,Binh Duong,Phu Giao,17,1,0,1,1
2022-01-18,Binh Duong,Tan Uyen,6,1,0,1,1
2022-01-18,Binh Duong,Tan Uyen,8,1,0,1,0
2022-01-18,Binh Duong,Tan Uyen,11,2,1,1,1
2022-01-18,Binh Duong,Tan Uyen,12,1,1,0,0
2022-01-18,Binh Duong,Tan Uyen,14,2,2,0,0
2022-01-18,Binh Duong,Tan Uyen,15,2,0,2,2
2022-01-18,Binh Duong,Tan Uyen,16,1,0,1,1
2022-01-18,Binh Duong,Tan Uyen,17,1,0,1,0
2022-01-18,Binh Duong,Thu Dau Mot Town,4,1,1,0,0
2022-01-18,Binh Duong,Thu Dau Mot Town,6,27,23,4,3
2022-01-18,Binh Duong,Thu Dau Mot Town,7,102,92,10,2
2022-01-18,Binh Duong,Thu Dau Mot Town,8,205,180,25,12
2022-01-18,Binh Duong,Thu Dau Mot Town,9,238,215,23,4
2022-01-18,Binh Duong,Thu Dau Mot Town,10,357,328,29,4
2022-01-18,Binh Duong,Thu Dau Mot Town,11,574,536,38,8
2022-01-18,Binh Duong,Thu Dau Mot Town,12,406,379,27,6
2022-01-18,Binh Duong,Thu Dau Mot Town,13,354,333,21,2
2022-01-18,Binh Duong,Thu Dau Mot Town,14,300,280,20,2
2022-01-18,Binh Duong,Thu Dau Mot Town,15,264,250,14,1
2022-01-18,Binh Duong,Thu Dau Mot Town,16,261,250,11,0
2022-01-18,Binh Duong,Thu Dau Mot Town,17,287,281,6,1
2022-01-18,Binh Duong,Thu Dau Mot Town,18,308,296,12,1
2022-01-18,Binh Duong,Thu Dau Mot Town,19,269,249,20,2
2022-01-18,Binh Duong,Thu Dau Mot Town,20,191,177,14,1
2022-01-18,Binh Duong,Thu Dau Mot Town,21,102,82,20,5
2022-01-18,Binh Duong,Thu Dau Mot Town,23,1,1,0,0
2022-01-18,Binh Duong,Thuan An,6,2,0,2,2
2022-01-18,Binh Duong,Thuan An,7,5,1,4,3
2022-01-18,Binh Duong,Thuan An,8,21,9,12,10
2022-01-18,Binh Duong,Thuan An,9,48,15,33,28
2022-01-18,Binh Duong,Thuan An,10,64,42,22,19
2022-01-18,Binh Duong,Thuan An,11,91,56,35,32
2022-01-18,Binh Duong,Thuan An,12,78,43,35,30
2022-01-18,Binh Duong,Thuan An,13,56,35,21,13
2022-01-18,Binh Duong,Thuan An,14,62,38,24,20
2022-01-18,Binh Duong,Thuan An,15,41,28,13,12
2022-01-18,Binh Duong,Thuan An,16,27,20,7,4
2022-01-18,Binh Duong,Thuan An,17,37,20,17,12
2022-01-18,Binh Duong,Thuan An,18,38,26,12,10
2022-01-18,Binh Duong,Thuan An,19,28,19,9,4
2022-01-18,Binh Duong,Thuan An,20,22,11,11,9
2022-01-18,Binh Duong,Thuan An,21,11,2,9,7
2022-01-18,Binh Duong,Thuan An,22,1,0,1,1
2022-01-18,Can Tho City,Binh Thuy District,6,2,2,0,0
2022-01-18,Can Tho City,Binh Thuy District,7,3,2,1,0
2022-01-18,Can Tho City,Binh Thuy District,8,6,5,1,0
2022-01-18,Can Tho City,Binh Thuy District,9,4,3,1,0
2022-01-18,Can Tho City,Binh Thuy District,10,7,6,1,0
2022-01-18,Can Tho City,Binh Thuy District,11,7,7,0,0
2022-01-18,Can Tho City,Binh Thuy District,12,9,8,1,0
2022-01-18,Can Tho City,Binh Thuy District,13,14,14,0,0
2022-01-18,Can Tho City,Binh Thuy District,14,15,14,1,1
2022-01-18,Can Tho City,Binh Thuy District,15,6,6,0,0
2022-01-18,Can Tho City,Binh Thuy District,16,4,4,0,0
2022-01-18,Can Tho City,Binh Thuy District,17,10,10,0,0
2022-01-18,Can Tho City,Binh Thuy District,18,11,10,1,0
2022-01-18,Can Tho City,Binh Thuy District,19,5,5,0,0
2022-01-18,Can Tho City,Binh Thuy District,20,9,8,1,0
2022-01-18,Can Tho City,Binh Thuy District,21,2,1,1,0
2022-01-18,Can Tho City,Cai Rang District,6,2,1,1,1
2022-01-18,Can Tho City,Cai Rang District,7,2,2,0,0
2022-01-18,Can Tho City,Cai Rang District,8,5,3,2,0
2022-01-18,Can Tho City,Cai Rang District,9,3,3,0,0
2022-01-18,Can Tho City,Cai Rang District,10,10,10,0,0
2022-01-18,Can Tho City,Cai Rang District,11,13,13,0,0
2022-01-18,Can Tho City,Cai Rang District,12,4,3,1,0
2022-01-18,Can Tho City,Cai Rang District,13,8,7,1,0
2022-01-18,Can Tho City,Cai Rang District,14,7,6,1,0
2022-01-18,Can Tho City,Cai Rang District,15,4,4,0,0
2022-01-18,Can Tho City,Cai Rang District,16,11,10,1,0
2022-01-18,Can Tho City,Cai Rang District,17,11,11,0,0
2022-01-18,Can Tho City,Cai Rang District,18,11,9,2,0
2022-01-18,Can Tho City,Cai Rang District,19,6,5,1,0
2022-01-18,Can Tho City,Cai Rang District,20,7,5,2,0
2022-01-18,Can Tho City,Cai Rang District,21,1,1,0,0
2022-01-18,Can Tho City,Cai Rang District,23,1,0,1,0
2022-01-18,Can Tho City,Ninh Kieu District,0,4,3,1,0
2022-01-18,Can Tho City,Ninh Kieu District,1,5,1,4,0
2022-01-18,Can Tho City,Ninh Kieu District,2,1,1,0,0
2022-01-18,Can Tho City,Ninh Kieu District,3,2,1,1,0
2022-01-18,Can Tho City,Ninh Kieu District,5,1,1,0,0
2022-01-18,Can Tho City,Ninh Kieu District,6,68,63,5,1
2022-01-18,Can Tho City,Ninh Kieu District,7,167,150,17,0
2022-01-18,Can Tho City,Ninh Kieu District,8,257,242,15,0
2022-01-18,Can Tho City,Ninh Kieu District,9,289,275,14,1
2022-01-18,Can Tho City,Ninh Kieu District,10,487,463,24,0
2022-01-18,Can Tho City,Ninh Kieu District,11,750,716,34,0
2022-01-18,Can Tho City,Ninh Kieu District,12,543,518,25,0
2022-01-18,Can Tho City,Ninh Kieu District,13,403,381,22,0
2022-01-18,Can Tho City,Ninh Kieu District,14,357,343,14,1
2022-01-18,Can Tho City,Ninh Kieu District,15,329,314,15,0
2022-01-18,Can Tho City,Ninh Kieu District,16,340,323,17,0
2022-01-18,Can Tho City,Ninh Kieu District,17,407,389,18,0
2022-01-18,Can Tho City,Ninh Kieu District,18,469,449,20,0
2022-01-18,Can Tho City,Ninh Kieu District,19,363,345,18,1
2022-01-18,Can Tho City,Ninh Kieu District,20,243,228,15,0
2022-01-18,Can Tho City,Ninh Kieu District,21,145,127,18,0
2022-01-18,Can Tho City,Ninh Kieu District,22,5,2,3,1
2022-01-18,Can Tho City,Ninh Kieu District,23,4,3,1,0
2022-01-18,Dong Nai,Bien Hoa City,0,2,1,1,0
2022-01-18,Dong Nai,Bien Hoa City,1,4,3,1,0
2022-01-18,Dong Nai,Bien Hoa City,2,1,0,1,0
2022-01-18,Dong Nai,Bien Hoa City,3,1,1,0,0
2022-01-18,Dong Nai,Bien Hoa City,5,2,1,1,1
2022-01-18,Dong Nai,Bien Hoa City,6,45,26,19,15
2022-01-18,Dong Nai,Bien Hoa City,7,172,139,33,15
2022-01-18,Dong Nai,Bien Hoa City,8,279,254,25,5
2022-01-18,Dong Nai,Bien Hoa City,9,359,333,26,4
2022-01-18,Dong Nai,Bien Hoa City,10,623,576,47,9
2022-01-18,Dong Nai,Bien Hoa City,11,995,929,66,10
2022-01-18,Dong Nai,Bien Hoa City,12,781,728,53,5
2022-01-18,Dong Nai,Bien Hoa City,13,773,704,69,21
2022-01-18,Dong Nai,Bien Hoa City,14,630,578,52,10
2022-01-18,Dong Nai,Bien Hoa City,15,524,477,47,8
2022-01-18,Dong Nai,Bien Hoa City,16,466,429,37,5
2022-01-18,Dong Nai,Bien Hoa City,17,514,487,27,5
2022-01-18,Dong Nai,Bien Hoa City,18,605,565,40,0
2022-01-18,Dong Nai,Bien Hoa City,19,617,552,65,11
2022-01-18,Dong Nai,Bien Hoa City,20,446,381,65,15
2022-01-18,Dong Nai,Bien Hoa City,21,177,121,56,25
2022-01-18,Dong Nai,Bien Hoa City,22,2,1,1,0
2022-01-18,Dong Nai,Long Khanh,19,1,0,1,1
2022-01-18,Dong Nai,Long Thanh,10,1,0,1,1
2022-01-18,Dong Nai,Long Thanh,11,1,0,1,1
2022-01-18,Dong Nai,Long Thanh,12,2,0,2,2
2022-01-18,Dong Nai,Long Thanh,13,4,0,4,4
2022-01-18,Dong Nai,Long Thanh,14,2,0,2,2
2022-01-18,Dong Nai,Long Thanh,18,1,0,1,1
2022-01-18,Dong Nai,Thong Nhat,9,3,3,0,0
2022-01-18,Dong Nai,Thong Nhat,10,1,1,0,0
2022-01-18,Dong Nai,Thong Nhat,12,1,1,0,0
2022-01-18,Dong Nai,Thong Nhat,13,2,2,0,0
2022-01-18,Dong Nai,Thong Nhat,15,1,1,0,0
2022-01-18,Dong Nai,Thong Nhat,18,3,3,0,0
2022-01-18,Dong Nai,Trang Bom,10,3,0,3,3
2022-01-18,Hai Phong City,An Duong,7,1,1,0,0
2022-01-18,Hai Phong City,An Duong,8,4,1,3,1
2022-01-18,Hai Phong City,An Duong,9,4,2,2,1
2022-01-18,Hai Phong City,An Duong,10,1,1,0,0
2022-01-18,Hai Phong City,An Duong,11,3,1,2,1
2022-01-18,Hai Phong City,An Duong,12,4,4,0,0
2022-01-18,Hai Phong City,An Duong,13,1,0,1,1
2022-01-18,Hai Phong City,An Duong,14,2,1,1,1
2022-01-18,Hai Phong City,An Duong,15,3,1,2,2
2022-01-18,Hai Phong City,An Duong,16,2,2,0,0
2022-01-18,Hai Phong City,An Duong,17,1,1,0,0
2022-01-18,Hai Phong City,An Duong,18,2,2,0,0
2022-01-18,Hai Phong City,An Duong,19,1,0,1,1
2022-01-18,Hai Phong City,An Duong,20,1,0,1,1
2022-01-18,Hai Phong City,An Duong,21,1,0,1,1
2022-01-18,Hai Phong City,Do Son District,17,2,0,2,2
2022-01-18,Hai Phong City,Duong Kinh District,9,1,0,1,1
2022-01-18,Hai Phong City,Duong Kinh District,15,3,0,3,3
2022-01-18,Hai Phong City,Hai An District,0,1,0,1,1
2022-01-18,Hai Phong City,Hai An District,4,1,0,1,1
2022-01-18,Hai Phong City,Hai An District,7,9,5,4,4
2022-01-18,Hai Phong City,Hai An District,8,17,13,4,1
2022-01-18,Hai Phong City,Hai An District,9,11,7,4,0
2022-01-18,Hai Phong City,Hai An District,10,24,24,0,0
2022-01-18,Hai Phong City,Hai An District,11,57,53,4,0
2022-01-18,Hai Phong City,Hai An District,12,29,25,4,1
2022-01-18,Hai Phong City,Hai An District,13,17,16,1,0
2022-01-18,Hai Phong City,Hai An District,14,13,5,8,0
2022-01-18,Hai Phong City,Hai An District,15,26,22,4,1
2022-01-18,Hai Phong City,Hai An District,16,17,15,2,1
2022-01-18,Hai Phong City,Hai An District,17,22,21,1,0
2022-01-18,Hai Phong City,Hai An District,18,28,23,5,0
2022-01-18,Hai Phong City,Hai An District,19,24,22,2,1
2022-01-18,Hai Phong City,Hai An District,20,8,8,0,0
2022-01-18,Hai Phong City,Hai An District,21,6,4,2,0
2022-01-18,Hai Phong City,Hong Bang District,3,1,1,0,0
2022-01-18,Hai Phong City,Hong Bang District,7,27,16,11,6
2022-01-18,Hai Phong City,Hong Bang District,8,46,32,14,8
2022-01-18,Hai Phong City,Hong Bang District,9,30,27,3,0
2022-01-18,Hai Phong City,Hong Bang District,10,55,49,6,1
2022-01-18,Hai Phong City,Hong Bang District,11,136,124,12,2
2022-01-18,Hai Phong City,Hong Bang District,12,70,62,8,0
2022-01-18,Hai Phong City,Hong Bang District,13,59,56,3,0
2022-01-18,Hai Phong City,Hong Bang District,14,56,48,8,4
2022-01-18,Hai Phong City,Hong Bang District,15,42,37,5,0
2022-01-18,Hai Phong City,Hong Bang District,16,56,54,2,1
2022-01-18,Hai Phong City,Hong Bang District,17,71,63,8,1
2022-01-18,Hai Phong City,Hong Bang District,18,93,84,9,3
2022-01-18,Hai Phong City,Hong Bang District,19,65,58,7,2
2022-01-18,Hai Phong City,Hong Bang District,20,47,42,5,1
2022-01-18,Hai Phong City,Hong Bang District,21,20,12,8,0
2022-01-18,Hai Phong City,Kien An District,7,3,0,3,1
2022-01-18,Hai Phong City,Kien An District,8,7,3,4,3
2022-01-18,Hai Phong City,Kien An District,9,6,4,2,1
2022-01-18,Hai Phong City,Kien An District,10,4,3,1,1
2022-01-18,Hai Phong City,Kien An District,11,14,11,3,2
2022-01-18,Hai Phong City,Kien An District,12,7,7,0,0
2022-01-18,Hai Phong City,Kien An District,13,17,13,4,4
2022-01-18,Hai Phong City,Kien An District,14,14,7,7,7
2022-01-18,Hai Phong City,Kien An District,15,21,11,10,7
2022-01-18,Hai Phong City,Kien An District,16,8,6,2,1
2022-01-18,Hai Phong City,Kien An District,17,12,9,3,2
2022-01-18,Hai Phong City,Kien An District,18,18,12,6,2
2022-01-18,Hai Phong City,Kien An District,19,21,16,5,1
2022-01-18,Hai Phong City,Kien An District,20,7,4,3,2
2022-01-18,Hai Phong City,Le Chan District,0,1,0,1,0
2022-01-18,Hai Phong City,Le Chan District,1,1,1,0,0
2022-01-18,Hai Phong City,Le Chan District,5,1,1,0,0
2022-01-18,Hai Phong City,Le Chan District,6,5,2,3,0
2022-01-18,Hai Phong City,Le Chan District,7,50,42,8,3
2022-01-18,Hai Phong City,Le Chan District,8,92,75,17,3
2022-01-18,Hai Phong City,Le Chan District,9,81,70,11,0
2022-01-18,Hai Phong City,Le Chan District,10,184,161,23,1
2022-01-18,Hai Phong City,Le Chan District,11,358,332,26,5
2022-01-18,Hai Phong City,Le Chan District,12,249,229,20,3
2022-01-18,Hai Phong City,Le Chan District,13,136,120,16,0
2022-01-18,Hai Phong City,Le Chan District,14,163,150,13,1
2022-01-18,Hai Phong City,Le Chan District,15,213,191,22,3
2022-01-18,Hai Phong City,Le Chan District,16,184,164,20,2
2022-01-18,Hai Phong City,Le Chan District,17,235,214,21,1
2022-01-18,Hai Phong City,Le Chan District,18,301,279,22,3
2022-01-18,Hai Phong City,Le Chan District,19,247,225,22,4
2022-01-18,Hai Phong City,Le Chan District,20,157,142,15,1
2022-01-18,Hai Phong City,Le Chan District,21,70,57,13,1
2022-01-18,Hai Phong City,Le Chan District,22,2,1,1,0
2022-01-18,Hai Phong City,Le Chan District,23,1,1,0,0
2022-01-18,Hai Phong City,Ngo Quyen District,1,2,1,1,0
2022-01-18,Hai Phong City,Ngo Quyen District,6,2,1,1,0
2022-01-18,Hai Phong City,Ngo Quyen District,7,45,31,14,10
2022-01-18,Hai Phong City,Ngo Quyen District,8,100,80,20,12
2022-01-18,Hai Phong City,Ngo Quyen District,9,72,67,5,0
2022-01-18,Hai Phong City,Ngo Quyen District,10,135,122,13,0
2022-01-18,Hai Phong City,Ngo Quyen District,11,243,220,23,4
2022-01-18,Hai Phong City,Ngo Quyen District,12,165,154,11,1
2022-01-18,Hai Phong City,Ngo Quyen District,13,166,155,11,0
2022-01-18,Hai Phong City,Ngo Quyen District,14,174,158,16,0
2022-01-18,Hai Phong City,Ngo Quyen District,15,177,162,15,0
2022-01-18,Hai Phong City,Ngo Quyen District,16,183,176,7,0
2022-01-18,Hai Phong City,Ngo Quyen District,17,163,150,13,0
2022-01-18,Hai Phong City,Ngo Quyen District,18,195,168,27,3
2022-01-18,Hai Phong City,Ngo Quyen District,19,227,200,27,6
2022-01-18,Hai Phong City,Ngo Quyen District,20,140,126,14,0
2022-01-18,Hai Phong City,Ngo Quyen District,21,95,70,25,5
2022-01-18,Hai Phong City,Ngo Quyen District,22,1,0,1,0
2022-01-18,Hai Phong City,Thuy Nguyen,0,1,0,1,1
2022-01-18,Hai Phong City,Thuy Nguyen,12,1,0,1,1
2022-01-18,Hai Phong City,Thuy Nguyen,17,1,0,1,1
2022-01-18,Hai Phong City,Thuy Nguyen,19,1,1,0,0
2022-01-18,Hue City,Hue City,0,6,6,0,0
2022-01-18,Hue City,Hue City,2,1,1,0,0
2022-01-18,Hue City,Hue City,4,1,1,0,0
2022-01-18,Hue City,Hue City,6,51,45,6,0
2022-01-18,Hue City,Hue City,7,246,230,16,1
2022-01-18,Hue City,Hue City,8,364,346,18,0
2022-01-18,Hue City,Hue City,9,357,330,27,2
2022-01-18,Hue City,Hue City,10,439,411,28,1
2022-01-18,Hue City,Hue City,11,904,862,42,8
2022-01-18,Hue City,Hue City,12,573,539,34,2
2022-01-18,Hue City,Hue City,13,325,310,15,0
2022-01-18,Hue City,Hue City,14,363,324,39,1
2022-01-18,Hue City,Hue City,15,470,438,32,3
2022-01-18,Hue City,Hue City,16,511,473,38,2
2022-01-18,Hue City,Hue City,17,688,626,62,2
2022-01-18,Hue City,Hue City,18,771,713,58,3
2022-01-18,Hue City,Hue City,19,635,585,50,0
2022-01-18,Hue City,Hue City,20,456,419,37,4
2022-01-18,Hue City,Hue City,21,243,213,30,2
2022-01-18,Hue City,Hue City,22,2,0,2,0
2022-01-18,Hue City,Huong Thuy,7,1,1,0,0
2022-01-18,Hue City,Huong Thuy,9,2,0,2,0
2022-01-18,Hue City,Huong Thuy,10,4,2,2,1
2022-01-18,Hue City,Huong Thuy,11,1,1,0,0
2022-01-18,Hue City,Huong Thuy,12,1,1,0,0
2022-01-18,Hue City,Huong Thuy,15,2,0,2,2
2022-01-18,Hue City,Huong Thuy,17,1,1,0,0
2022-01-18,Hue City,Huong Thuy,18,2,2,0,0
2022-01-18,Hue City,Huong Thuy,19,2,1,1,1
2022-01-18,Hue City,Huong Thuy,20,6,1,5,3
2022-01-18,Hue City,Huong Thuy,21,1,0,1,1
2022-01-18,Hue City,Huong Tra,11,1,1,0,0
2022-01-18,Hue City,Huong Tra,18,1,1,0,0
2022-01-18,Hue City,Huong Tra,23,1,1,0,0
2022-01-18,Hue City,Phu Vang,6,1,0,1,1
2022-01-18,Hue City,Phu Vang,7,1,1,0,0
2022-01-18,Hue City,Phu Vang,8,1,0,1,0
2022-01-18,Hue City,Phu Vang,9,1,0,1,0
2022-01-18,Hue City,Phu Vang,11,4,1,3,0
2022-01-18,Hue City,Phu Vang,15,1,1,0,0
2022-01-18,Hue City,Phu Vang,16,3,1,2,1
2022-01-18,Hue City,Phu Vang,17,4,4,0,0
2022-01-18,Vung Tau,Ba Ria City,6,1,0,1,0
2022-01-18,Vung Tau,Ba Ria City,7,2,0,2,1
2022-01-18,Vung Tau,Ba Ria City,8,3,0,3,2
2022-01-18,Vung Tau,Ba Ria City,9,10,6,4,4
2022-01-18,Vung Tau,Ba Ria City,10,8,7,1,0
2022-01-18,Vung Tau,Ba Ria City,11,17,8,9,7
2022-01-18,Vung Tau,Ba Ria City,12,7,7,0,0
2022-01-18,Vung Tau,Ba Ria City,13,7,5,2,2
2022-01-18,Vung Tau,Ba Ria City,14,12,3,9,5
2022-01-18,Vung Tau,Ba Ria City,15,3,3,0,0
2022-01-18,Vung Tau,Ba Ria City,16,3,3,0,0
2022-01-18,Vung Tau,Ba Ria City,17,4,4,0,0
2022-01-18,Vung Tau,Ba Ria City,18,6,3,3,2
2022-01-18,Vung Tau,Ba Ria City,19,5,0,5,4
2022-01-18,Vung Tau,Ba Ria City,20,3,0,3,3
2022-01-18,Vung Tau,Ba Ria City,21,1,0,1,1
2022-01-18,Vung Tau,Tan Thanh,10,2,0,2,2
2022-01-18,Vung Tau,Tan Thanh,12,2,0,2,2
2022-01-18,Vung Tau,Tan Thanh,13,1,0,1,1
2022-01-18,Vung Tau,Tan Thanh,14,1,0,1,1
2022-01-18,Vung Tau,Vung Tau City,0,1,1,0,0
2022-01-18,Vung Tau,Vung Tau City,1,1,0,1,0
2022-01-18,Vung Tau,Vung Tau City,5,1,1,0,0
2022-01-18,Vung Tau,Vung Tau City,6,49,42,7,3
2022-01-18,Vung Tau,Vung Tau City,7,128,117,11,0
2022-01-18,Vung Tau,Vung Tau City,8,155,140,15,4
2022-01-18,Vung Tau,Vung Tau City,9,162,151,11,1
2022-01-18,Vung Tau,Vung Tau City,10,197,183,14,6
2022-01-18,Vung Tau,Vung Tau City,11,332,298,34,10
2022-01-18,Vung Tau,Vung Tau City,12,284,271,13,3
2022-01-18,Vung Tau,Vung Tau City,13,220,202,18,7
2022-01-18,Vung Tau,Vung Tau City,14,237,217,20,5
2022-01-18,Vung Tau,Vung Tau City,15,204,194,10,1
2022-01-18,Vung Tau,Vung Tau City,16,171,158,13,0
2022-01-18,Vung Tau,Vung Tau City,17,246,232,14,1
2022-01-18,Vung Tau,Vung Tau City,18,321,290,31,7
2022-01-18,Vung Tau,Vung Tau City,19,249,215,34,3
2022-01-18,Vung Tau,Vung Tau City,20,178,158,20,3
2022-01-18,Vung Tau,Vung Tau City,21,83,62,21,3
2022-01-18,Vung Tau,Vung Tau City,22,3,1,2,0
2022-01-18,Vung Tau,Vung Tau City,23,1,1,0,0
2022-01-19,Binh Duong,Ben Cat,14,1,1,0,0
2022-01-19,Binh Duong,Ben Cat,17,1,1,0,0
2022-01-19,Binh Duong,Di An,6,1,0,1,1
2022-01-19,Binh Duong,Di An,7,6,2,4,3
2022-01-19,Binh Duong,Di An,8,6,4,2,2
2022-01-19,Binh Duong,Di An,9,20,10,10,8
2022-01-19,Binh Duong,Di An,10,24,12,12,8
2022-01-19,Binh Duong,Di An,11,35,15,20,16
2022-01-19,Binh Duong,Di An,12,27,18,9,8
2022-01-19,Binh Duong,Di An,13,24,17,7,2
2022-01-19,Binh Duong,Di An,14,28,16,12,11
2022-01-19,Binh Duong,Di An,15,15,11,4,2
2022-01-19,Binh Duong,Di An,16,14,9,5,4
2022-01-19,Binh Duong,Di An,17,17,13,4,3
2022-01-19,Binh Duong,Di An,18,21,11,10,10
2022-01-19,Binh Duong,Di An,19,18,7,11,6
2022-01-19,Binh Duong,Di An,20,6,2,4,4
2022-01-19,Binh Duong,Di An,21,3,0,3,3
2022-01-19,Binh Duong,Di An,22,1,1,0,0
2022-01-19,Binh Duong,Tan Uyen,8,3,1,2,1
2022-01-19,Binh Duong,Tan Uyen,10,1,1,0,0
2022-01-19,Binh Duong,Tan Uyen,11,4,2,2,2
2022-01-19,Binh Duong,Tan Uyen,12,3,0,3,2
2022-01-19,Binh Duong,Tan Uyen,13,1,0,1,1
2022-01-19,Binh Duong,Tan Uyen,14,1,0,1,1
2022-01-19,Binh Duong,Tan Uyen,16,1,1,0,0
2022-01-19,Binh Duong,Tan Uyen,17,3,1,2,1
2022-01-19,Binh Duong,Tan Uyen,18,1,1,0,0
2022-01-19,Binh Duong,Thu Dau Mot Town,0,2,2,0,0
2022-01-19,Binh Duong,Thu Dau Mot Town,1,1,1,0,0
2022-01-19,Binh Duong,Thu Dau Mot Town,2,1,1,0,0
2022-01-19,Binh Duong,Thu Dau Mot Town,5,1,1,0,0
2022-01-19,Binh Duong,Thu Dau Mot Town,6,35,29,6,1
2022-01-19,Binh Duong,Thu Dau Mot Town,7,101,94,7,2
2022-01-19,Binh Duong,Thu Dau Mot Town,8,164,153,11,4
2022-01-19,Binh Duong,Thu Dau Mot Town,9,244,226,18,3
2022-01-19,Binh Duong,Thu Dau Mot Town,10,317,300,17,2
2022-01-19,Binh Duong,Thu Dau Mot Town,11,580,552,28,6
2022-01-19,Binh Duong,Thu Dau Mot Town,12,432,420,12,2
2022-01-19,Binh Duong,Thu Dau Mot Town,13,379,360,19,1
2022-01-19,Binh Duong,Thu Dau Mot Town,14,267,258,9,3
2022-01-19,Binh Duong,Thu Dau Mot Town,15,254,237,17,2
2022-01-19,Binh Duong,Thu Dau Mot Town,16,241,225,16,1
2022-01-19,Binh Duong,Thu Dau Mot Town,17,303,286,17,1
2022-01-19,Binh Duong,Thu Dau Mot Town,18,342,321,21,1
2022-01-19,Binh Duong,Thu Dau Mot Town,19,295,283,12,1
2022-01-19,Binh Duong,Thu Dau Mot Town,20,230,213,17,2
2022-01-19,Binh Duong,Thu Dau Mot Town,21,79,70,9,3
2022-01-19,Binh Duong,Thu Dau Mot Town,22,1,0,1,0
2022-01-19,Binh Duong,Thu Dau Mot Town,23,4,3,1,1
2022-01-19,Binh Duong,Thuan An,6,1,0,1,1
2022-01-19,Binh Duong,Thuan An,7,3,0,3,3
2022-01-19,Binh Duong,Thuan An,8,18,6,12,9
2022-01-19,Binh Duong,Thuan An,9,43,16,27,19
2022-01-19,Binh Duong,Thuan An,10,90,46,44,36
2022-01-19,Binh Duong,Thuan An,11,69,49,20,12
2022-01-19,Binh Duong,Thuan An,12,66,50,16,12
2022-01-19,Binh Duong,Thuan An,13,73,43,30,22
2022-01-19,Binh Duong,Thuan An,14,51,38,13,8
2022-01-19,Binh Duong,Thuan An,15,40,26,14,10
2022-01-19,Binh Duong,Thuan An,16,38,29,9,5
2022-01-19,Binh Duong,Thuan An,17,30,24,6,3
2022-01-19,Binh Duong,Thuan An,18,33,19,14,10
2022-01-19,Binh Duong,Thuan An,19,19,16,3,3
2022-01-19,Binh Duong,Thuan An,20,19,10,9,7
2022-01-19,Binh Duong,Thuan An,21,16,4,12,9
2022-01-19,Can Tho City,Binh Thuy District,7,4,3,1,0
2022-01-19,Can Tho City,Binh Thuy District,8,5,5,0,0
2022-01-19,Can Tho City,Binh Thuy District,9,4,3,1,0
2022-01-19,Can Tho City,Binh Thuy District,10,11,9,2,0
2022-01-19,Can Tho City,Binh Thuy District,11,7,7,0,0
2022-01-19,Can Tho City,Binh Thuy District,12,13,13,0,0
2022-01-19,Can Tho City,Binh Thuy District,13,8,8,0,0
2022-01-19,Can Tho City,Binh Thuy District,14,7,6,1,0
2022-01-19,Can Tho City,Binh Thuy District,15,8,8,0,0
2022-01-19,Can Tho City,Binh Thuy District,16,6,6,0,0
2022-01-19,Can Tho City,Binh Thuy District,17,9,9,0,0
2022-01-19,Can Tho City,Binh Thuy District,18,16,16,0,0
2022-01-19,Can Tho City,Binh Thuy District,19,5,5,0,0
2022-01-19,Can Tho City,Binh Thuy District,20,10,10,0,0
2022-01-19,Can Tho City,Binh Thuy District,21,2,2,0,0
2022-01-19,Can Tho City,Cai Rang District,6,1,1,0,0
2022-01-19,Can Tho City,Cai Rang District,7,2,2,0,0
2022-01-19,Can Tho City,Cai Rang District,8,7,5,2,0
2022-01-19,Can Tho City,Cai Rang District,9,6,5,1,0
2022-01-19,Can Tho City,Cai Rang District,10,7,7,0,0
2022-01-19,Can Tho City,Cai Rang District,11,12,12,0,0
2022-01-19,Can Tho City,Cai Rang District,12,11,10,1,0
2022-01-19,Can Tho City,Cai Rang District,13,4,3,1,0
2022-01-19,Can Tho City,Cai Rang District,14,5,4,1,0
2022-01-19,Can Tho City,Cai Rang District,15,10,10,0,0
2022-01-19,Can Tho City,Cai Rang District,16,5,5,0,0
2022-01-19,Can Tho City,Cai Rang District,17,10,7,3,0
2022-01-19,Can Tho City,Cai Rang District,18,7,7,0,0
2022-01-19,Can Tho City,Cai Rang District,19,8,8,0,0
2022-01-19,Can Tho City,Cai Rang District,20,5,4,1,0
2022-01-19,Can Tho City,Cai Rang District,21,4,3,1,1
2022-01-19,Can Tho City,Ninh Kieu District,0,3,3,0,0
2022-01-19,Can Tho City,Ninh Kieu District,1,2,1,1,0
2022-01-19,Can Tho City,Ninh Kieu District,2,1,1,0,0
2022-01-19,Can Tho City,Ninh Kieu District,3,1,1,0,0
2022-01-19,Can Tho City,Ninh Kieu District,4,1,1,0,0
2022-01-19,Can Tho City,Ninh Kieu District,5,1,1,0,0
2022-01-19,Can Tho City,Ninh Kieu District,6,46,43,3,1
2022-01-19,Can Tho City,Ninh Kieu District,7,144,140,4,0
2022-01-19,Can Tho City,Ninh Kieu District,8,256,241,15,0
2022-01-19,Can Tho City,Ninh Kieu District,9,289,270,19,0
2022-01-19,Can Tho City,Ninh Kieu District,10,447,427,20,0
2022-01-19,Can Tho City,Ninh Kieu District,11,810,770,40,0
2022-01-19,Can Tho City,Ninh Kieu District,12,498,472,26,0
2022-01-19,Can Tho City,Ninh Kieu District,13,417,398,19,0
2022-01-19,Can Tho City,Ninh Kieu District,14,381,366,15,0
2022-01-19,Can Tho City,Ninh Kieu District,15,330,320,10,0
2022-01-19,Can Tho City,Ninh Kieu District,16,314,301,13,0
2022-01-19,Can Tho City,Ninh Kieu District,17,461,437,24,0
2022-01-19,Can Tho City,Ninh Kieu District,18,414,395,19,0
2022-01-19,Can Tho City,Ninh Kieu District,19,336,316,20,0
2022-01-19,Can Tho City,Ninh Kieu District,20,265,240,25,0
2022-01-19,Can Tho City,Ninh Kieu District,21,135,124,11,0
2022-01-19,Can Tho City,Ninh Kieu District,22,3,2,1,0
2022-01-19,Can Tho City,Ninh Kieu District,23,3,3,0,0
2022-01-19,Dong Nai,Bien Hoa City,0,1,1,0,0
2022-01-19,Dong Nai,Bien Hoa City,1,4,2,2,0
2022-01-19,Dong Nai,Bien Hoa City,2,2,1,1,0
2022-01-19,Dong Nai,Bien Hoa City,5,1,1,0,0
2022-01-19,Dong Nai,Bien Hoa City,6,53,31,22,15
2022-01-19,Dong Nai,Bien Hoa City,7,141,119,22,12
2022-01-19,Dong Nai,Bien Hoa City,8,306,285,21,5
2022-01-19,Dong Nai,Bien Hoa City,9,386,358,28,2
2022-01-19,Dong Nai,Bien Hoa City,10,655,624,31,4
2022-01-19,Dong Nai,Bien Hoa City,11,1014,948,66,7
2022-01-19,Dong Nai,Bien Hoa City,12,789,734,55,8
2022-01-19,Dong Nai,Bien Hoa City,13,687,648,39,6
2022-01-19,Dong Nai,Bien Hoa City,14,592,556,36,4
2022-01-19,Dong Nai,Bien Hoa City,15,514,482,32,3
2022-01-19,Dong Nai,Bien Hoa City,16,448,408,40,6
2022-01-19,Dong Nai,Bien Hoa City,17,535,514,21,3
2022-01-19,Dong Nai,Bien Hoa City,18,661,623,38,3
2022-01-19,Dong Nai,Bien Hoa City,19,583,540,43,4
2022-01-19,Dong Nai,Bien Hoa City,20,389,338,51,14
2022-01-19,Dong Nai,Bien Hoa City,21,207,128,79,35
2022-01-19,Dong Nai,Bien Hoa City,23,2,1,1,0
2022-01-19,Dong Nai,Long Thanh,9,1,0,1,1
2022-01-19,Dong Nai,Long Thanh,11,2,0,2,1
2022-01-19,Dong Nai,Long Thanh,12,1,0,1,1
2022-01-19,Dong Nai,Long Thanh,13,1,0,1,1
2022-01-19,Dong Nai,Long Thanh,15,1,0,1,1
2022-01-19,Dong Nai,Thong Nhat,7,1,1,0,0
2022-01-19,Dong Nai,Thong Nhat,8,1,1,0,0
2022-01-19,Dong Nai,Thong Nhat,11,1,1,0,0
2022-01-19,Dong Nai,Thong Nhat,12,1,1,0,0
2022-01-19,Dong Nai,Thong Nhat,14,3,2,1,0
2022-01-19,Dong Nai,Thong Nhat,15,1,1,0,0
2022-01-19,Dong Nai,Thong Nhat,18,1,1,0,0
2022-01-19,Dong Nai,Thong Nhat,19,2,2,0,0
2022-01-19,Dong Nai,Trang Bom,11,3,0,3,3
2022-01-19,Dong Nai,Trang Bom,13,1,1,0,0
2022-01-19,Dong Nai,Trang Bom,15,2,0,2,2
2022-01-19,Hai Phong City,An Duong,8,2,2,0,0
2022-01-19,Hai Phong City,An Duong,9,3,2,1,1
2022-01-19,Hai Phong City,An Duong,12,5,4,1,1
2022-01-19,Hai Phong City,An Duong,13,3,1,2,1
2022-01-19,Hai Phong City,An Duong,14,6,3,3,2
2022-01-19,Hai Phong City,An Duong,15,5,3,2,2
2022-01-19,Hai Phong City,An Duong,16,1,0,1,0
2022-01-19,Hai Phong City,An Duong,17,5,1,4,2
2022-01-19,Hai Phong City,An Duong,18,1,1,0,0
2022-01-19,Hai Phong City,An Duong,20,1,1,0,0
2022-01-19,Hai Phong City,Hai An District,7,3,3,0,0
2022-01-19,Hai Phong City,Hai An District,8,14,9,5,0
2022-01-19,Hai Phong City,Hai An District,9,13,11,2,0
2022-01-19,Hai Phong City,Hai An District,10,27,25,2,0
2022-01-19,Hai Phong City,Hai An District,11,57,53,4,1
2022-01-19,Hai Phong City,Hai An District,12,19,15,4,0
2022-01-19,Hai Phong City,Hai An District,13,20,19,1,0
2022-01-19,Hai Phong City,Hai An District,14,20,18,2,0
2022-01-19,Hai Phong City,Hai An District,15,17,16,1,0
2022-01-19,Hai Phong City,Hai An District,16,14,14,0,0
2022-01-19,Hai Phong City,Hai An District,17,16,16,0,0
2022-01-19,Hai Phong City,Hai An District,18,25,23,2,1
2022-01-19,Hai Phong City,Hai An District,19,24,20,4,0
2022-01-19,Hai Phong City,Hai An District,20,23,20,3,0
2022-01-19,Hai Phong City,Hai An District,21,12,9,3,1
2022-01-19,Hai Phong City,Hong Bang District,0,2,1,1,0
2022-01-19,Hai Phong City,Hong Bang District,1,1,1,0,0
2022-01-19,Hai Phong City,Hong Bang District,6,1,1,0,0
2022-01-19,Hai Phong City,Hong Bang District,7,10,9,1,1
2022-01-19,Hai Phong City,Hong Bang District,8,32,29,3,0
2022-01-19,Hai Phong City,Hong Bang District,9,40,37,3,0
2022-01-19,Hai Phong City,Hong Bang District,10,68,61,7,0
2022-01-19,Hai Phong City,Hong Bang District,11,136,120,16,10
2022-01-19,Hai Phong City,Hong Bang District,12,84,77,7,2
2022-01-19,Hai Phong City,Hong Bang District,13,39,36,3,0
2022-01-19,Hai Phong City,Hong Bang District,14,50,48,2,0
2022-01-19,Hai Phong City,Hong Bang District,15,48,42,6,2
2022-01-19,Hai Phong City,Hong Bang District,16,56,53,3,0
2022-01-19,Hai Phong City,Hong Bang District,17,44,40,4,0
2022-01-19,Hai Phong City,Hong Bang District,18,64,59,5,0
2022-01-19,Hai Phong City,Hong Bang District,19,77,68,9,0
2022-01-19,Hai Phong City,Hong Bang District,20,41,32,9,1
2022-01-19,Hai Phong City,Hong Bang District,21,21,17,4,1
2022-01-19,Hai Phong City,Kien An District,7,1,1,0,0
2022-01-19,Hai Phong City,Kien An District,8,7,1,6,6
2022-01-19,Hai Phong City,Kien An District,9,8,5,3,3
2022-01-19,Hai Phong City,Kien An District,10,9,6,3,2
2022-01-19,Hai Phong City,Kien An District,11,5,4,1,1
2022-01-19,Hai Phong City,Kien An District,12,8,8,0,0
2022-01-19,Hai Phong City,Kien An District,13,11,6,5,3
2022-01-19,Hai Phong City,Kien An District,14,7,4,3,2
2022-01-19,Hai Phong City,Kien An District,15,12,10,2,2
2022-01-19,Hai Phong City,Kien An District,16,1,1,0,0
2022-01-19,Hai Phong City,Kien An District,17,10,9,1,0
2022-01-19,Hai Phong City,Kien An District,18,7,6,1,1
2022-01-19,Hai Phong City,Kien An District,19,10,6,4,1
2022-01-19,Hai Phong City,Kien An District,20,16,4,12,8
2022-01-19,Hai Phong City,Kien An District,21,3,1,2,1
2022-01-19,Hai Phong City,Le Chan District,0,1,1,0,0
2022-01-19,Hai Phong City,Le Chan District,5,1,1,0,0
2022-01-19,Hai Phong City,Le Chan District,6,2,1,1,0
2022-01-19,Hai Phong City,Le Chan District,7,45,35,10,4
2022-01-19,Hai Phong City,Le Chan District,8,95,84,11,0
2022-01-19,Hai Phong City,Le Chan District,9,101,86,15,1
2022-01-19,Hai Phong City,Le Chan District,10,175,156,19,0
2022-01-19,Hai Phong City,Le Chan District,11,380,352,28,3
2022-01-19,Hai Phong City,Le Chan District,12,228,213,15,0
2022-01-19,Hai Phong City,Le Chan District,13,121,113,8,0
2022-01-19,Hai Phong City,Le Chan District,14,129,115,14,0
2022-01-19,Hai Phong City,Le Chan District,15,189,173,16,0
2022-01-19,Hai Phong City,Le Chan District,16,216,194,22,1
2022-01-19,Hai Phong City,Le Chan District,17,219,198,21,0
2022-01-19,Hai Phong City,Le Chan District,18,281,253,28,2
2022-01-19,Hai Phong City,Le Chan District,19,237,216,21,1
2022-01-19,Hai Phong City,Le Chan District,20,155,142,13,0
2022-01-19,Hai Phong City,Le Chan District,21,76,61,15,2
2022-01-19,Hai Phong City,Le Chan District,22,1,0,1,0
2022-01-19,Hai Phong City,Ngo Quyen District,0,3,3,0,0
2022-01-19,Hai Phong City,Ngo Quyen District,1,1,1,0,0
2022-01-19,Hai Phong City,Ngo Quyen District,2,1,1,0,0
2022-01-19,Hai Phong City,Ngo Quyen District,6,3,2,1,0
2022-01-19,Hai Phong City,Ngo Quyen District,7,31,23,8,3
2022-01-19,Hai Phong City,Ngo Quyen District,8,91,77,14,0
2022-01-19,Hai Phong City,Ngo Quyen District,9,107,87,20,1
2022-01-19,Hai Phong City,Ngo Quyen District,10,178,162,16,0
2022-01-19,Hai Phong City,Ngo Quyen District,11,250,232,18,1
2022-01-19,Hai Phong City,Ngo Quyen District,12,176,164,12,1
2022-01-19,Hai Phong City,Ngo Quyen District,13,116,106,10,0
2022-01-19,Hai Phong City,Ngo Quyen District,14,160,148,12,0
2022-01-19,Hai Phong City,Ngo Quyen District,15,171,162,9,0
2022-01-19,Hai Phong City,Ngo Quyen District,16,157,150,7,0
2022-01-19,Hai Phong City,Ngo Quyen District,17,164,158,6,0
2022-01-19,Hai Phong City,Ngo Quyen District,18,211,190,21,1
2022-01-19,Hai Phong City,Ngo Quyen District,19,161,146,15,0
2022-01-19,Hai Phong City,Ngo Quyen District,20,136,130,6,2
2022-01-19,Hai Phong City,Ngo Quyen District,21,84,73,11,2
2022-01-19,Hai Phong City,Ngo Quyen District,23,1,0,1,0
2022-01-19,Hai Phong City,Thuy Nguyen,9,1,0,1,1
2022-01-19,Hai Phong City,Thuy Nguyen,11,1,0,1,1
2022-01-19,Hai Phong City,Thuy Nguyen,12,2,1,1,1
2022-01-19,Hai Phong City,Thuy Nguyen,14,2,1,1,1
2022-01-19,Hai Phong City,Thuy Nguyen,15,1,0,1,1
2022-01-19,Hai Phong City,Thuy Nguyen,17,1,0,1,1
2022-01-19,Hai Phong City,Thuy Nguyen,18,2,1,1,1
2022-01-19,Hai Phong City,Thuy Nguyen,19,2,0,2,1
2022-01-19,Hue City,Hue City,0,5,4,1,0
2022-01-19,Hue City,Hue City,1,1,1,0,0
2022-01-19,Hue City,Hue City,2,9,4,5,0
2022-01-19,Hue City,Hue City,5,1,0,1,0
2022-01-19,Hue City,Hue City,6,69,57,12,7
2022-01-19,Hue City,Hue City,7,273,238,35,10
2022-01-19,Hue City,Hue City,8,422,390,32,4
2022-01-19,Hue City,Hue City,9,318,301,17,0
2022-01-19,Hue City,Hue City,10,476,452,24,0
2022-01-19,Hue City,Hue City,11,885,840,45,1
2022-01-19,Hue City,Hue City,12,554,524,30,2
2022-01-19,Hue City,Hue City,13,400,385,15,0
2022-01-19,Hue City,Hue City,14,389,362,27,2
2022-01-19,Hue City,Hue City,15,488,457,31,4
2022-01-19,Hue City,Hue City,16,542,503,39,2
2022-01-19,Hue City,Hue City,17,717,660,57,10
2022-01-19,Hue City,Hue City,18,744,667,77,16
2022-01-19,Hue City,Hue City,19,578,531,47,2
2022-01-19,Hue City,Hue City,20,435,382,53,6
2022-01-19,Hue City,Hue City,21,274,224,50,15
2022-01-19,Hue City,Hue City,22,2,2,0,0
2022-01-19,Hue City,Hue City,23,1,1,0,0
2022-01-19,Hue City,Huong Thuy,8,1,0,1,1
2022-01-19,Hue City,Huong Thuy,11,2,1,1,1
2022-01-19,Hue City,Huong Thuy,12,1,1,0,0
2022-01-19,Hue City,Huong Thuy,13,1,0,1,0
2022-01-19,Hue City,Huong Thuy,14,5,2,3,0
2022-01-19,Hue City,Huong Thuy,15,3,3,0,0
2022-01-19,Hue City,Huong Thuy,16,1,0,1,0
2022-01-19,Hue City,Huong Thuy,18,1,0,1,1
2022-01-19,Hue City,Huong Thuy,19,2,0,2,1
2022-01-19,Hue City,Huong Tra,12,1,0,1,1
2022-01-19,Hue City,Huong Tra,14,1,1,0,0
2022-01-19,Hue City,Huong Tra,15,2,2,0,0
2022-01-19,Hue City,Huong Tra,16,1,0,1,0
2022-01-19,Hue City,Huong Tra,17,2,2,0,0
2022-01-19,Hue City,Huong Tra,18,1,1,0,0
2022-01-19,Hue City,Huong Tra,19,1,1,0,0
2022-01-19,Hue City,Huong Tra,20,1,1,0,0
2022-01-19,Hue City,Phu Vang,6,1,0,1,0
2022-01-19,Hue City,Phu Vang,9,2,2,0,0
2022-01-19,Hue City,Phu Vang,11,2,1,1,0
2022-01-19,Hue City,Phu Vang,12,1,1,0,0
2022-01-19,Hue City,Phu Vang,14,1,0,1,0
2022-01-19,Hue City,Phu Vang,17,4,2,2,1
2022-01-19,Hue City,Phu Vang,18,2,2,0,0
2022-01-19,Hue City,Phu Vang,21,2,1,1,1
2022-01-19,Vung Tau,Ba Ria City,7,1,0,1,1
2022-01-19,Vung Tau,Ba Ria City,8,3,2,1,1
2022-01-19,Vung Tau,Ba Ria City,9,7,3,4,2
2022-01-19,Vung Tau,Ba Ria City,10,8,1,7,7
2022-01-19,Vung Tau,Ba Ria City,11,17,0,17,16
2022-01-19,Vung Tau,Ba Ria City,12,7,0,7,5
2022-01-19,Vung Tau,Ba Ria City,13,11,0,11,11
2022-01-19,Vung Tau,Ba Ria City,14,14,0,14,13
2022-01-19,Vung Tau,Ba Ria City,15,20,3,17,16
2022-01-19,Vung Tau,Ba Ria City,16,20,1,19,17
2022-01-19,Vung Tau,Ba Ria City,17,7,3,4,3
2022-01-19,Vung Tau,Ba Ria City,18,10,2,8,6
2022-01-19,Vung Tau,Ba Ria City,19,6,1,5,4
2022-01-19,Vung Tau,Ba Ria City,20,1,0,1,1
2022-01-19,Vung Tau,Ba Ria City,22,1,0,1,0
2022-01-19,Vung Tau,Tan Thanh,12,1,0,1,1
2022-01-19,Vung Tau,Vung Tau City,0,1,1,0,0
2022-01-19,Vung Tau,Vung Tau City,2,3,3,0,0
2022-01-19,Vung Tau,Vung Tau City,4,1,0,1,0
2022-01-19,Vung Tau,Vung Tau City,5,1,0,1,0
2022-01-19,Vung Tau,Vung Tau City,6,47,42,5,1
2022-01-19,Vung Tau,Vung Tau City,7,101,94,7,3
2022-01-19,Vung Tau,Vung Tau City,8,147,139,8,1
2022-01-19,Vung Tau,Vung Tau City,9,155,142,13,0
2022-01-19,Vung Tau,Vung Tau City,10,194,180,14,3
2022-01-19,Vung Tau,Vung Tau City,11,337,317,20,0
2022-01-19,Vung Tau,Vung Tau City,12,242,230,12,2
2022-01-19,Vung Tau,Vung Tau City,13,205,189,16,1
2022-01-19,Vung Tau,Vung Tau City,14,207,192,15,1
2022-01-19,Vung Tau,Vung Tau City,15,191,177,14,0
2022-01-19,Vung Tau,Vung Tau City,16,194,185,9,2
2022-01-19,Vung Tau,Vung Tau City,17,212,200,12,0
2022-01-19,Vung Tau,Vung Tau City,18,319,298,21,1
2022-01-19,Vung Tau,Vung Tau City,19,211,195,16,0
2022-01-19,Vung Tau,Vung Tau City,20,167,152,15,3
2022-01-19,Vung Tau,Vung Tau City,21,70,55,15,3
2022-01-19,Vung Tau,Vung Tau City,22,2,1,1,0
2022-01-19,Vung Tau,Vung Tau City,23,1,1,0,0
2022-01-20,Binh Duong,Ben Cat,9,1,0,1,0
2022-01-20,Binh Duong,Ben Cat,12,1,1,0,0
2022-01-20,Binh Duong,Di An,7,6,0,6,5
2022-01-20,Binh Duong,Di An,8,13,6,7,5
2022-01-20,Binh Duong,Di An,9,14,6,8,7
2022-01-20,Binh Duong,Di An,10,26,15,11,9
2022-01-20,Binh Duong,Di An,11,32,19,13,11
2022-01-20,Binh Duong,Di An,12,34,16,18,12
2022-01-20,Binh Duong,Di An,13,30,20,10,7
2022-01-20,Binh Duong,Di An,14,14,13,1,1
2022-01-20,Binh Duong,Di An,15,16,15,1,1
2022-01-20,Binh Duong,Di An,16,9,6,3,1
2022-01-20,Binh Duong,Di An,17,16,12,4,3
2022-01-20,Binh Duong,Di An,18,17,5,12,11
2022-01-20,Binh Duong,Di An,19,17,12,5,4
2022-01-20,Binh Duong,Di An,20,11,8,3,2
2022-01-20,Binh Duong,Di An,21,15,2,13,10
2022-01-20,Binh Duong,Tan Uyen,9,1,0,1,1
2022-01-20,Binh Duong,Tan Uyen,11,2,1,1,1
2022-01-20,Binh Duong,Tan Uyen,12,1,1,0,0
2022-01-20,Binh Duong,Tan Uyen,13,2,1,1,1
2022-01-20,Binh Duong,Tan Uyen,14,2,1,1,1
2022-01-20,Binh Duong,Tan Uyen,17,3,1,2,2
2022-01-20,Binh Duong,Tan Uyen,19,1,1,0,0
2022-01-20,Binh Duong,Tan Uyen,20,1,0,1,1
2022-01-20,Binh Duong,Tan Uyen,21,1,0,1,1
2022-01-20,Binh Duong,Thu Dau Mot Town,1,1,1,0,0
2022-01-20,Binh Duong,Thu Dau Mot Town,3,1,1,0,0
2022-01-20,Binh Duong,Thu Dau Mot Town,4,1,1,0,0
2022-01-20,Binh Duong,Thu Dau Mot Town,5,1,1,0,0
2022-01-20,Binh Duong,Thu Dau Mot Town,6,26,25,1,0
2022-01-20,Binh Duong,Thu Dau Mot Town,7,91,86,5,0
2022-01-20,Binh Duong,Thu Dau Mot Town,8,187,171,16,2
2022-01-20,Binh Duong,Thu Dau Mot Town,9,227,217,10,0
2022-01-20,Binh Duong,Thu Dau Mot Town,10,307,281,26,5
2022-01-20,Binh Duong,Thu Dau Mot Town,11,609,552,57,27
2022-01-20,Binh Duong,Thu Dau Mot Town,12,420,388,32,7
2022-01-20,Binh Duong,Thu Dau Mot Town,13,369,341,28,7
2022-01-20,Binh Duong,Thu Dau Mot Town,14,329,316,13,4
2022-01-20,Binh Duong,Thu Dau Mot Town,15,226,214,12,0
2022-01-20,Binh Duong,Thu Dau Mot Town,16,248,233,15,4
2022-01-20,Binh Duong,Thu Dau Mot Town,17,351,330,21,2
2022-01-20,Binh Duong,Thu Dau Mot Town,18,356,342,14,2
2022-01-20,Binh Duong,Thu Dau Mot Town,19,284,267,17,1
2022-01-20,Binh Duong,Thu Dau Mot Town,20,235,209,26,3
2022-01-20,Binh Duong,Thu Dau Mot Town,21,88,71,17,1
2022-01-20,Binh Duong,Thu Dau Mot Town,22,3,1,2,0
2022-01-20,Binh Duong,Thu Dau Mot Town,23,1,0,1,0
2022-01-20,Binh Duong,Thuan An,7,5,1,4,2
2022-01-20,Binh Duong,Thuan An,8,20,3,17,17
2022-01-20,Binh Duong,Thuan An,9,31,15,16,13
2022-01-20,Binh Duong,Thuan An,10,62,40,22,17
2022-01-20,Binh Duong,Thuan An,11,99,56,43,39
2022-01-20,Binh Duong,Thuan An,12,63,46,17,13
2022-01-20,Binh Duong,Thuan An,13,60,41,19,15
2022-01-20,Binh Duong,Thuan An,14,49,33,16,15
2022-01-20,Binh Duong,Thuan An,15,27,21,6,3
2022-01-20,Binh Duong,Thuan An,16,36,28,8,2
2022-01-20,Binh Duong,Thuan An,17,23,19,4,3
2022-01-20,Binh Duong,Thuan An,18,39,29,10,8
2022-01-20,Binh Duong,Thuan An,19,26,18,8,4
2022-01-20,Binh Duong,Thuan An,20,26,16,10,8
2022-01-20,Binh Duong,Thuan An,21,13,6,7,4
2022-01-20,Can Tho City,Binh Thuy District,7,2,2,0,0
2022-01-20,Can Tho City,Binh Thuy District,8,5,5,0,0
2022-01-20,Can Tho City,Binh Thuy District,9,5,5,0,0
2022-01-20,Can Tho City,Binh Thuy District,10,13,13,0,0
2022-01-20,Can Tho City,Binh Thuy District,11,14,13,1,0
2022-01-20,Can Tho City,Binh Thuy District,12,9,8,1,0
2022-01-20,Can Tho City,Binh Thuy District,13,14,14,0,0
2022-01-20,Can Tho City,Binh Thuy District,14,8,8,0,0
2022-01-20,Can Tho City,Binh Thuy District,15,12,11,1,0
2022-01-20,Can Tho City,Binh Thuy District,16,9,9,0,0
2022-01-20,Can Tho City,Binh Thuy District,17,11,11,0,0
2022-01-20,Can Tho City,Binh Thuy District,18,13,11,2,0
2022-01-20,Can Tho City,Binh Thuy District,19,7,7,0,0
2022-01-20,Can Tho City,Binh Thuy District,20,6,6,0,0
2022-01-20,Can Tho City,Binh Thuy District,21,1,1,0,0
2022-01-20,Can Tho City,Cai Rang District,5,1,1,0,0
2022-01-20,Can Tho City,Cai Rang District,6,2,1,1,0
2022-01-20,Can Tho City,Cai Rang District,7,2,2,0,0
2022-01-20,Can Tho City,Cai Rang District,8,1,1,0,0
2022-01-20,Can Tho City,Cai Rang District,9,8,8,0,0
2022-01-20,Can Tho City,Cai Rang District,10,7,5,2,1
2022-01-20,Can Tho City,Cai Rang District,11,18,17,1,0
2022-01-20,Can Tho City,Cai Rang District,12,13,13,0,0
2022-01-20,Can Tho City,Cai Rang District,13,8,8,0,0
2022-01-20,Can Tho City,Cai Rang District,14,6,6,0,0
2022-01-20,Can Tho City,Cai Rang District,15,6,5,1,0
2022-01-20,Can Tho City,Cai Rang District,16,15,15,0,0
2022-01-20,Can Tho City,Cai Rang District,17,8,8,0,0
2022-01-20,Can Tho City,Cai Rang District,18,6,5,1,0
2022-01-20,Can Tho City,Cai Rang District,19,11,9,2,0
2022-01-20,Can Tho City,Cai Rang District,20,8,8,0,0
2022-01-20,Can Tho City,Cai Rang District,21,2,1,1,0
2022-01-20,Can Tho City,Ninh Kieu District,0,3,1,2,0
2022-01-20,Can Tho City,Ninh Kieu District,2,3,2,1,0
2022-01-20,Can Tho City,Ninh Kieu District,4,1,0,1,0
2022-01-20,Can Tho City,Ninh Kieu District,5,3,3,0,0
2022-01-20,Can Tho City,Ninh Kieu District,6,65,57,8,0
2022-01-20,Can Tho City,Ninh Kieu District,7,164,151,13,0
2022-01-20,Can Tho City,Ninh Kieu District,8,232,223,9,0
2022-01-20,Can Tho City,Ninh Kieu District,9,282,273,9,0
2022-01-20,Can Tho City,Ninh Kieu District,10,487,458,29,0
2022-01-20,Can Tho City,Ninh Kieu District,11,774,741,33,0
2022-01-20,Can Tho City,Ninh Kieu District,12,523,504,19,0
2022-01-20,Can Tho City,Ninh Kieu District,13,422,402,20,0
2022-01-20,Can Tho City,Ninh Kieu District,14,360,342,18,0
2022-01-20,Can Tho City,Ninh Kieu District,15,323,304,19,0
2022-01-20,Can Tho City,Ninh Kieu District,16,347,334,13,0
2022-01-20,Can Tho City,Ninh Kieu District,17,377,362,15,0
2022-01-20,Can Tho City,Ninh Kieu District,18,411,395,16,0
2022-01-20,Can Tho City,Ninh Kieu District,19,392,370,22,0
2022-01-20,Can Tho City,Ninh Kieu District,20,317,295,22,0
2022-01-20,Can Tho City,Ninh Kieu District,21,144,128,16,0
2022-01-20,Can Tho City,Ninh Kieu District,22,5,1,4,0
2022-01-20,Can Tho City,Ninh Kieu District,23,4,1,3,0
2022-01-20,Dong Nai,Bien Hoa City,0,2,1,1,0
2022-01-20,Dong Nai,Bien Hoa City,1,1,0,1,0
2022-01-20,Dong Nai,Bien Hoa City,2,2,1,1,0
2022-01-20,Dong Nai,Bien Hoa City,5,2,1,1,0
2022-01-20,Dong Nai,Bien Hoa City,6,50,37,13,9
2022-01-20,Dong Nai,Bien Hoa City,7,139,121,18,7
2022-01-20,Dong Nai,Bien Hoa City,8,284,252,32,7
2022-01-20,Dong Nai,Bien Hoa City,9,385,347,38,8
2022-01-20,Dong Nai,Bien Hoa City,10,677,619,58,10
2022-01-20,Dong Nai,Bien Hoa City,11,1006,941,65,17
2022-01-20,Dong Nai,Bien Hoa City,12,756,717,39,6
2022-01-20,Dong Nai,Bien Hoa City,13,716,673,43,7
2022-01-20,Dong Nai,Bien Hoa City,14,608,577,31,7
2022-01-20,Dong Nai,Bien Hoa City,15,485,448,37,3
2022-01-20,Dong Nai,Bien Hoa City,16,434,396,38,7
2022-01-20,Dong Nai,Bien Hoa City,17,560,513,47,11
2022-01-20,Dong Nai,Bien Hoa City,18,665,596,69,22
2022-01-20,Dong Nai,Bien Hoa City,19,580,536,44,11
2022-01-20,Dong Nai,Bien Hoa City,20,433,386,47,10
2022-01-20,Dong Nai,Bien Hoa City,21,185,135,50,15
2022-01-20,Dong Nai,Bien Hoa City,22,7,4,3,0
2022-01-20,Dong Nai,Bien Hoa City,23,2,2,0,0
2022-01-20,Dong Nai,Long Khanh,11,1,0,1,1
2022-01-20,Dong Nai,Long Thanh,9,2,0,2,2
2022-01-20,Dong Nai,Long Thanh,10,2,0,2,2
2022-01-20,Dong Nai,Long Thanh,15,2,0,2,1
2022-01-20,Dong Nai,Long Thanh,16,1,0,1,1
2022-01-20,Dong Nai,Long Thanh,18,2,0,2,2
2022-01-20,Dong Nai,Long Thanh,19,2,0,2,2
2022-01-20,Dong Nai,Thong Nhat,9,4,4,0,0
2022-01-20,Dong Nai,Thong Nhat,11,1,1,0,0
2022-01-20,Dong Nai,Thong Nhat,13,3,3,0,0
2022-01-20,Dong Nai,Thong Nhat,15,1,1,0,0
2022-01-20,Dong Nai,Thong Nhat,19,2,2,0,0
2022-01-20,Dong Nai,Trang Bom,11,1,0,1,1
2022-01-20,Dong Nai,Trang Bom,12,2,0,2,2
2022-01-20,Dong Nai,Trang Bom,13,1,0,1,1
2022-01-20,Hai Phong City,An Duong,4,1,0,1,1
2022-01-20,Hai Phong City,An Duong,7,2,1,1,1
2022-01-20,Hai Phong City,An Duong,8,2,0,2,0
2022-01-20,Hai Phong City,An Duong,9,2,1,1,0
2022-01-20,Hai Phong City,An Duong,10,4,3,1,0
2022-01-20,Hai Phong City,An Duong,11,6,2,4,1
2022-01-20,Hai Phong City,An Duong,12,5,2,3,2
2022-01-20,Hai Phong City,An Duong,13,2,1,1,1
2022-01-20,Hai Phong City,An Duong,14,5,1,4,2
2022-01-20,Hai Phong City,An Duong,15,8,5,3,2
2022-01-20,Hai Phong City,An Duong,16,2,1,1,1
2022-01-20,Hai Phong City,An Duong,17,3,1,2,1
2022-01-20,Hai Phong City,An Duong,18,2,1,1,1
2022-01-20,Hai Phong City,An Duong,19,4,1,3,1
2022-01-20,Hai Phong City,An Duong,20,2,0,2,0
2022-01-20,Hai Phong City,An Duong,21,1,1,0,0
2022-01-20,Hai Phong City,Duong Kinh District,15,1,1,0,0
2022-01-20,Hai Phong City,Duong Kinh District,17,1,0,1,0
2022-01-20,Hai Phong City,Hai An District,7,1,1,0,0
2022-01-20,Hai Phong City,Hai An District,8,15,14,1,0
2022-01-20,Hai Phong City,Hai An District,9,12,12,0,0
2022-01-20,Hai Phong City,Hai An District,10,13,11,2,0
2022-01-20,Hai Phong City,Hai An District,11,57,51,6,1
2022-01-20,Hai Phong City,Hai An District,12,38,28,10,1
2022-01-20,Hai Phong City,Hai An District,13,26,23,3,0
2022-01-20,Hai Phong City,Hai An District,14,15,8,7,1
2022-01-20,Hai Phong City,Hai An District,15,18,13,5,1
2022-01-20,Hai Phong City,Hai An District,16,12,11,1,0
2022-01-20,Hai Phong City,Hai An District,17,24,22,2,0
2022-01-20,Hai Phong City,Hai An District,18,28,25,3,0
2022-01-20,Hai Phong City,Hai An District,19,18,14,4,0
2022-01-20,Hai Phong City,Hai An District,20,18,14,4,2
2022-01-20,Hai Phong City,Hai An District,21,7,7,0,0
2022-01-20,Hai Phong City,Hai An District,23,1,0,1,0
2022-01-20,Hai Phong City,Hong Bang District,0,1,1,0,0
2022-01-20,Hai Phong City,Hong Bang District,4,1,0,1,0
2022-01-20,Hai Phong City,Hong Bang District,6,1,1,0,0
2022-01-20,Hai Phong City,Hong Bang District,7,16,14,2,1
2022-01-20,Hai Phong City,Hong Bang District,8,35,28,7,0
2022-01-20,Hai Phong City,Hong Bang District,9,41,32,9,0
2022-01-20,Hai Phong City,Hong Bang District,10,72,64,8,3
2022-01-20,Hai Phong City,Hong Bang District,11,164,114,50,36
2022-01-20,Hai Phong City,Hong Bang District,12,119,85,34,21
2022-01-20,Hai Phong City,Hong Bang District,13,44,44,0,0
2022-01-20,Hai Phong City,Hong Bang District,14,44,35,9,4
2022-01-20,Hai Phong City,Hong Bang District,15,48,42,6,0
2022-01-20,Hai Phong City,Hong Bang District,16,47,43,4,2
2022-01-20,Hai Phong City,Hong Bang District,17,65,58,7,0
2022-01-20,Hai Phong City,Hong Bang District,18,64,52,12,4
2022-01-20,Hai Phong City,Hong Bang District,19,50,42,8,0
2022-01-20,Hai Phong City,Hong Bang District,20,46,42,4,1
2022-01-20,Hai Phong City,Hong Bang District,21,11,7,4,0
2022-01-20,Hai Phong City,Kien An District,7,1,0,1,1
2022-01-20,Hai Phong City,Kien An District,8,3,2,1,1
2022-01-20,Hai Phong City,Kien An District,9,8,4,4,4
2022-01-20,Hai Phong City,Kien An District,10,4,3,1,1
2022-01-20,Hai Phong City,Kien An District,11,17,10,7,7
2022-01-20,Hai Phong City,Kien An District,12,4,3,1,1
2022-01-20,Hai Phong City,Kien An District,13,4,1,3,3
2022-01-20,Hai Phong City,Kien An District,14,12,3,9,7
2022-01-20,Hai Phong City,Kien An District,15,7,2,5,5
2022-01-20,Hai Phong City,Kien An District,16,5,4,1,1
2022-01-20,Hai Phong City,Kien An District,17,6,6,0,0
2022-01-20,Hai Phong City,Kien An District,18,9,7,2,2
2022-01-20,Hai Phong City,Kien An District,19,4,3,1,0
2022-01-20,Hai Phong City,Kien An District,20,8,5,3,1
2022-01-20,Hai Phong City,Kien An District,21,5,2,3,3
2022-01-20,Hai Phong City,Le Chan District,0,1,1,0,0
2022-01-20,Hai Phong City,Le Chan District,1,2,2,0,0
2022-01-20,Hai Phong City,Le Chan District,2,1,1,0,0
2022-01-20,Hai Phong City,Le Chan District,6,3,3,0,0
2022-01-20,Hai Phong City,Le Chan District,7,36,31,5,1
2022-01-20,Hai Phong City,Le Chan District,8,80,69,11,0
2022-01-20,Hai Phong City,Le Chan District,9,98,85,13,0
2022-01-20,Hai Phong City,Le Chan District,10,185,159,26,2
2022-01-20,Hai Phong City,Le Chan District,11,410,327,83,51
2022-01-20,Hai Phong City,Le Chan District,12,317,250,67,30
2022-01-20,Hai Phong City,Le Chan District,13,161,144,17,0
2022-01-20,Hai Phong City,Le Chan District,14,141,127,14,2
2022-01-20,Hai Phong City,Le Chan District,15,150,137,13,1
2022-01-20,Hai Phong City,Le Chan District,16,179,154,25,1
2022-01-20,Hai Phong City,Le Chan District,17,239,217,22,6
2022-01-20,Hai Phong City,Le Chan District,18,298,262,36,7
2022-01-20,Hai Phong City,Le Chan District,19,244,216,28,3
2022-01-20,Hai Phong City,Le Chan District,20,153,137,16,1
2022-01-20,Hai Phong City,Le Chan District,21,86,74,12,0
2022-01-20,Hai Phong City,Le Chan District,22,1,0,1,1
2022-01-20,Hai Phong City,Ngo Quyen District,0,1,0,1,1
2022-01-20,Hai Phong City,Ngo Quyen District,5,1,1,0,0
2022-01-20,Hai Phong City,Ngo Quyen District,6,1,0,1,1
2022-01-20,Hai Phong City,Ngo Quyen District,7,40,35,5,3
2022-01-20,Hai Phong City,Ngo Quyen District,8,73,68,5,2
2022-01-20,Hai Phong City,Ngo Quyen District,9,94,87,7,1
2022-01-20,Hai Phong City,Ngo Quyen District,10,142,132,10,0
2022-01-20,Hai Phong City,Ngo Quyen District,11,273,221,52,26
2022-01-20,Hai Phong City,Ngo Quyen District,12,255,211,44,20
2022-01-20,Hai Phong City,Ngo Quyen District,13,137,121,16,1
2022-01-20,Hai Phong City,Ngo Quyen District,14,154,135,19,4
2022-01-20,Hai Phong City,Ngo Quyen District,15,153,144,9,1
2022-01-20,Hai Phong City,Ngo Quyen District,16,162,146,16,3
2022-01-20,Hai Phong City,Ngo Quyen District,17,177,155,22,0
2022-01-20,Hai Phong City,Ngo Quyen District,18,180,159,21,7
2022-01-20,Hai Phong City,Ngo Quyen District,19,164,146,18,2
2022-01-20,Hai Phong City,Ngo Quyen District,20,147,129,18,0
2022-01-20,Hai Phong City,Ngo Quyen District,21,71,56,15,2
2022-01-20,Hai Phong City,Ngo Quyen District,22,1,1,0,0
2022-01-20,Hai Phong City,Ngo Quyen District,23,2,1,1,0
2022-01-20,Hai Phong City,Thuy Nguyen,8,1,0,1,1
2022-01-20,Hai Phong City,Thuy Nguyen,9,1,0,1,1
2022-01-20,Hai Phong City,Thuy Nguyen,10,1,0,1,1
2022-01-20,Hai Phong City,Thuy Nguyen,11,1,1,0,0
2022-01-20,Hai Phong City,Thuy Nguyen,14,1,0,1,1
2022-01-20,Hai Phong City,Thuy Nguyen,15,2,0,2,2
2022-01-20,Hai Phong City,Thuy Nguyen,20,1,0,1,1
2022-01-20,Hue City,Hue City,0,3,1,2,0
2022-01-20,Hue City,Hue City,1,5,3,2,1
2022-01-20,Hue City,Hue City,2,3,2,1,0
2022-01-20,Hue City,Hue City,4,1,1,0,0
2022-01-20,Hue City,Hue City,5,1,1,0,0
2022-01-20,Hue City,Hue City,6,60,49,11,7
2022-01-20,Hue City,Hue City,7,244,223,21,1
2022-01-20,Hue City,Hue City,8,355,330,25,0
2022-01-20,Hue City,Hue City,9,257,240,17,0
2022-01-20,Hue City,Hue City,10,339,326,13,0
2022-01-20,Hue City,Hue City,11,766,742,24,0
2022-01-20,Hue City,Hue City,12,494,471,23,0
2022-01-20,Hue City,Hue City,13,316,292,24,1
2022-01-20,Hue City,Hue City,14,347,320,27,2
2022-01-20,Hue City,Hue City,15,396,370,26,0
2022-01-20,Hue City,Hue City,16,418,394,24,1
2022-01-20,Hue City,Hue City,17,544,504,40,3
2022-01-20,Hue City,Hue City,18,582,550,32,0
2022-01-20,Hue City,Hue City,19,500,460,40,4
2022-01-20,Hue City,Hue City,20,394,347,47,9
2022-01-20,Hue City,Hue City,21,247,195,52,8
2022-01-20,Hue City,Hue City,22,5,3,2,2
2022-01-20,Hue City,Huong Thuy,12,1,1,0,0
2022-01-20,Hue City,Huong Thuy,16,1,0,1,0
2022-01-20,Hue City,Huong Thuy,17,1,1,0,0
2022-01-20,Hue City,Huong Thuy,19,1,0,1,1
2022-01-20,Hue City,Huong Thuy,20,1,0,1,1
2022-01-20,Hue City,Huong Thuy,21,1,0,1,1
2022-01-20,Hue City,Huong Tra,7,1,1,0,0
2022-01-20,Hue City,Huong Tra,10,2,1,1,1
2022-01-20,Hue City,Huong Tra,15,2,1,1,1
2022-01-20,Hue City,Huong Tra,16,1,1,0,0
2022-01-20,Hue City,Huong Tra,19,1,0,1,0
2022-01-20,Hue City,Huong Tra,20,1,1,0,0
2022-01-20,Hue City,Phu Vang,6,1,0,1,0
2022-01-20,Hue City,Phu Vang,7,3,1,2,0
2022-01-20,Hue City,Phu Vang,8,1,1,0,0
2022-01-20,Hue City,Phu Vang,9,2,1,1,0
2022-01-20,Hue City,Phu Vang,14,1,1,0,0
2022-01-20,Hue City,Phu Vang,16,1,1,0,0
2022-01-20,Hue City,Phu Vang,18,3,3,0,0
2022-01-20,Hue City,Phu Vang,19,2,2,0,0
2022-01-20,Hue City,Phu Vang,21,1,1,0,0
2022-01-20,Vung Tau,Ba Ria City,6,1,0,1,1
2022-01-20,Vung Tau,Ba Ria City,7,1,0,1,1
2022-01-20,Vung Tau,Ba Ria City,8,5,3,2,2
2022-01-20,Vung Tau,Ba Ria City,10,4,3,1,1
2022-01-20,Vung Tau,Ba Ria City,11,8,3,5,5
2022-01-20,Vung Tau,Ba Ria City,12,11,2,9,9
2022-01-20,Vung Tau,Ba Ria City,13,11,5,6,6
2022-01-20,Vung Tau,Ba Ria City,14,15,5,10,4
2022-01-20,Vung Tau,Ba Ria City,15,10,3,7,6
2022-01-20,Vung Tau,Ba Ria City,16,5,3,2,2
2022-01-20,Vung Tau,Ba Ria City,17,16,4,12,10
2022-01-20,Vung Tau,Ba Ria City,18,11,0,11,11
2022-01-20,Vung Tau,Ba Ria City,19,12,0,12,12
2022-01-20,Vung Tau,Ba Ria City,20,6,0,6,6
2022-01-20,Vung Tau,Ba Ria City,21,1,0,1,0
2022-01-20,Vung Tau,Tan Thanh,17,1,0,1,1
2022-01-20,Vung Tau,Vung Tau City,0,1,0,1,1
2022-01-20,Vung Tau,Vung Tau City,1,1,1,0,0
2022-01-20,Vung Tau,Vung Tau City,2,1,1,0,0
2022-01-20,Vung Tau,Vung Tau City,4,2,1,1,1
2022-01-20,Vung Tau,Vung Tau City,5,2,2,0,0
2022-01-20,Vung Tau,Vung Tau City,6,42,36,6,1
2022-01-20,Vung Tau,Vung Tau City,7,111,103,8,3
2022-01-20,Vung Tau,Vung Tau City,8,186,177,9,1
2022-01-20,Vung Tau,Vung Tau City,9,129,120,9,0
2022-01-20,Vung Tau,Vung Tau City,10,176,162,14,3
2022-01-20,Vung Tau,Vung Tau City,11,321,295,26,3
2022-01-20,Vung Tau,Vung Tau City,12,276,261,15,0
2022-01-20,Vung Tau,Vung Tau City,13,182,176,6,0
2022-01-20,Vung Tau,Vung Tau City,14,218,204,14,1
2022-01-20,Vung Tau,Vung Tau City,15,218,204,14,0
2022-01-20,Vung Tau,Vung Tau City,16,213,197,16,0
2022-01-20,Vung Tau,Vung Tau City,17,266,252,14,0
2022-01-20,Vung Tau,Vung Tau City,18,294,284,10,1
2022-01-20,Vung Tau,Vung Tau City,19,220,204,16,2
2022-01-20,Vung Tau,Vung Tau City,20,165,145,20,0
2022-01-20,Vung Tau,Vung Tau City,21,71,56,15,1
2022-01-20,Vung Tau,Vung Tau City,22,3,2,1,0
2022-01-20,Vung Tau,Vung Tau City,23,2,1,1,0
2022-01-21,Binh Duong,Ben Cat,14,1,0,1,0
2022-01-21,Binh Duong,Ben Cat,18,3,2,1,0
2022-01-21,Binh Duong,Ben Cat,19,1,0,1,0
2022-01-21,Binh Duong,Ben Cat,20,1,0,1,1
2022-01-21,Binh Duong,Di An,6,3,0,3,3
2022-01-21,Binh Duong,Di An,7,2,0,2,2
2022-01-21,Binh Duong,Di An,8,6,1,5,3
2022-01-21,Binh Duong,Di An,9,20,9,11,6
2022-01-21,Binh Duong,Di An,10,27,18,9,8
2022-01-21,Binh Duong,Di An,11,17,8,9,6
2022-01-21,Binh Duong,Di An,12,28,10,18,14
2022-01-21,Binh Duong,Di An,13,21,15,6,3
2022-01-21,Binh Duong,Di An,14,18,12,6,5
2022-01-21,Binh Duong,Di An,15,11,10,1,1
2022-01-21,Binh Duong,Di An,16,15,11,4,2
2022-01-21,Binh Duong,Di An,17,20,14,6,2
2022-01-21,Binh Duong,Di An,18,24,17,7,7
2022-01-21,Binh Duong,Di An,19,18,11,7,7
2022-01-21,Binh Duong,Di An,20,6,3,3,2
2022-01-21,Binh Duong,Di An,21,3,0,3,2
2022-01-21,Binh Duong,Tan Uyen,8,1,1,0,0
2022-01-21,Binh Duong,Tan Uyen,9,1,0,1,1
2022-01-21,Binh Duong,Tan Uyen,10,1,0,1,1
2022-01-21,Binh Duong,Tan Uyen,11,6,0,6,4
2022-01-21,Binh Duong,Tan Uyen,12,1,0,1,1
2022-01-21,Binh Duong,Tan Uyen,13,1,0,1,0
2022-01-21,Binh Duong,Tan Uyen,14,1,1,0,0
2022-01-21,Binh Duong,Tan Uyen,16,1,1,0,0
2022-01-21,Binh Duong,Tan Uyen,19,2,1,1,1
2022-01-21,Binh Duong,Thu Dau Mot Town,2,1,0,1,1
2022-01-21,Binh Duong,Thu Dau Mot Town,5,1,0,1,0
2022-01-21,Binh Duong,Thu Dau Mot Town,6,39,31,8,6
2022-01-21,Binh Duong,Thu Dau Mot Town,7,104,90,14,2
2022-01-21,Binh Duong,Thu Dau Mot Town,8,194,179,15,4
2022-01-21,Binh Duong,Thu Dau Mot Town,9,233,217,16,4
2022-01-21,Binh Duong,Thu Dau Mot Town,10,335,313,22,7
2022-01-21,Binh Duong,Thu Dau Mot Town,11,586,550,36,11
2022-01-21,Binh Duong,Thu Dau Mot Town,12,458,433,25,5
2022-01-21,Binh Duong,Thu Dau Mot Town,13,357,330,27,6
2022-01-21,Binh Duong,Thu Dau Mot Town,14,332,313,19,5
2022-01-21,Binh Duong,Thu Dau Mot Town,15,233,221,12,5
2022-01-21,Binh Duong,Thu Dau Mot Town,16,264,249,15,3
2022-01-21,Binh Duong,Thu Dau Mot Town,17,321,302,19,7
2022-01-21,Binh Duong,Thu Dau Mot Town,18,312,282,30,6
2022-01-21,Binh Duong,Thu Dau Mot Town,19,314,285,29,9
2022-01-21,Binh Duong,Thu Dau Mot Town,20,202,184,18,0
2022-01-21,Binh Duong,Thu Dau Mot Town,21,98,86,12,1
2022-01-21,Binh Duong,Thu Dau Mot Town,22,3,0,3,1
2022-01-21,Binh Duong,Thu Dau Mot Town,23,1,1,0,0
2022-01-21,Binh Duong,Thuan An,6,3,0,3,3
2022-01-21,Binh Duong,Thuan An,7,4,1,3,3
2022-01-21,Binh Duong,Thuan An,8,15,6,9,8
2022-01-21,Binh Duong,Thuan An,9,29,21,8,5
2022-01-21,Binh Duong,Thuan An,10,49,33,16,10
2022-01-21,Binh Duong,Thuan An,11,74,39,35,22
2022-01-21,Binh Duong,Thuan An,12,54,37,17,13
2022-01-21,Binh Duong,Thuan An,13,54,33,21,11
2022-01-21,Binh Duong,Thuan An,14,48,32,16,13
2022-01-21,Binh Duong,Thuan An,15,26,23,3,2
2022-01-21,Binh Duong,Thuan An,16,33,20,13,5
2022-01-21,Binh Duong,Thuan An,17,26,21,5,3
2022-01-21,Binh Duong,Thuan An,18,40,25,15,13
2022-01-21,Binh Duong,Thuan An,19,27,19,8,4
2022-01-21,Binh Duong,Thuan An,20,21,11,10,8
2022-01-21,Binh Duong,Thuan An,21,10,5,5,2
2022-01-21,Can Tho City,Binh Thuy District,6,1,1,0,0
2022-01-21,Can Tho City,Binh Thuy District,7,4,3,1,0
2022-01-21,Can Tho City,Binh Thuy District,8,2,2,0,0
2022-01-21,Can Tho City,Binh Thuy District,9,6,5,1,0
2022-01-21,Can Tho City,Binh Thuy District,10,8,7,1,0
2022-01-21,Can Tho City,Binh Thuy District,11,16,15,1,0
2022-01-21,Can Tho City,Binh Thuy District,12,10,10,0,0
2022-01-21,Can Tho City,Binh Thuy District,13,13,10,3,0
2022-01-21,Can Tho City,Binh Thuy District,14,10,7,3,0
2022-01-21,Can Tho City,Binh Thuy District,15,7,7,0,0
2022-01-21,Can Tho City,Binh Thuy District,16,7,7,0,0
2022-01-21,Can Tho City,Binh Thuy District,17,10,10,0,0
2022-01-21,Can Tho City,Binh Thuy District,18,11,7,4,0
2022-01-21,Can Tho City,Binh Thuy District,19,11,10,1,0
2022-01-21,Can Tho City,Binh Thuy District,20,4,3,1,0
2022-01-21,Can Tho City,Binh Thuy District,21,1,1,0,0
2022-01-21,Can Tho City,Cai Rang District,6,2,2,0,0
2022-01-21,Can Tho City,Cai Rang District,7,4,4,0,0
2022-01-21,Can Tho City,Cai Rang District,8,4,4,0,0
2022-01-21,Can Tho City,Cai Rang District,9,5,5,0,0
2022-01-21,Can Tho City,Cai Rang District,10,7,7,0,0
2022-01-21,Can Tho City,Cai Rang District,11,20,19,1,0
2022-01-21,Can Tho City,Cai Rang District,12,15,13,2,2
2022-01-21,Can Tho City,Cai Rang District,13,10,10,0,0
2022-01-21,Can Tho City,Cai Rang District,14,6,5,1,0
2022-01-21,Can Tho City,Cai Rang District,15,4,3,1,0
2022-01-21,Can Tho City,Cai Rang District,16,4,4,0,0
2022-01-21,Can Tho City,Cai Rang District,17,15,13,2,0
2022-01-21,Can Tho City,Cai Rang District,18,11,10,1,0
2022-01-21,Can Tho City,Cai Rang District,19,11,10,1,1
2022-01-21,Can Tho City,Cai Rang District,20,6,6,0,0
2022-01-21,Can Tho City,Cai Rang District,21,1,1,0,0
2022-01-21,Can Tho City,Ninh Kieu District,0,3,2,1,0
2022-01-21,Can Tho City,Ninh Kieu District,1,5,4,1,0
2022-01-21,Can Tho City,Ninh Kieu District,2,1,1,0,0
2022-01-21,Can Tho City,Ninh Kieu District,5,1,0,1,0
2022-01-21,Can Tho City,Ninh Kieu District,6,43,41,2,1
2022-01-21,Can Tho City,Ninh Kieu District,7,187,178,9,0
2022-01-21,Can Tho City,Ninh Kieu District,8,289,271,18,0
2022-01-21,Can Tho City,Ninh Kieu District,9,274,265,9,0
2022-01-21,Can Tho City,Ninh Kieu District,10,426,419,7,0
2022-01-21,Can Tho City,Ninh Kieu District,11,745,701,44,0
2022-01-21,Can Tho City,Ninh Kieu District,12,492,467,25,0
2022-01-21,Can Tho City,Ninh Kieu District,13,362,347,15,0
2022-01-21,Can Tho City,Ninh Kieu District,14,380,364,16,0
2022-01-21,Can Tho City,Ninh Kieu District,15,307,298,9,0
2022-01-21,Can Tho City,Ninh Kieu District,16,341,324,17,0
2022-01-21,Can Tho City,Ninh Kieu District,17,427,409,18,0
2022-01-21,Can Tho City,Ninh Kieu District,18,463,444,19,0
2022-01-21,Can Tho City,Ninh Kieu District,19,363,346,17,0
2022-01-21,Can Tho City,Ninh Kieu District,20,281,259,22,0
2022-01-21,Can Tho City,Ninh Kieu District,21,146,130,16,0
2022-01-21,Can Tho City,Ninh Kieu District,22,1,1,0,0
2022-01-21,Can Tho City,Ninh Kieu District,23,6,3,3,0
2022-01-21,Dong Nai,Bien Hoa City,0,1,0,1,0
2022-01-21,Dong Nai,Bien Hoa City,1,2,2,0,0
2022-01-21,Dong Nai,Bien Hoa City,2,5,4,1,1
2022-01-21,Dong Nai,Bien Hoa City,3,1,1,0,0
2022-01-21,Dong Nai,Bien Hoa City,5,3,2,1,0
2022-01-21,Dong Nai,Bien Hoa City,6,43,30,13,9
2022-01-21,Dong Nai,Bien Hoa City,7,170,140,30,18
2022-01-21,Dong Nai,Bien Hoa City,8,269,245,24,9
2022-01-21,Dong Nai,Bien Hoa City,9,371,335,36,5
2022-01-21,Dong Nai,Bien Hoa City,10,668,624,44,9
2022-01-21,Dong Nai,Bien Hoa City,11,1125,1005,120,15
2022-01-21,Dong Nai,Bien Hoa City,12,843,791,52,10
2022-01-21,Dong Nai,Bien Hoa City,13,772,709,63,17
2022-01-21,Dong Nai,Bien Hoa City,14,612,559,53,11
2022-01-21,Dong Nai,Bien Hoa City,15,475,440,35,4
2022-01-21,Dong Nai,Bien Hoa City,16,470,442,28,4
2022-01-21,Dong Nai,Bien Hoa City,17,563,512,51,6
2022-01-21,Dong Nai,Bien Hoa City,18,593,543,50,9
2022-01-21,Dong Nai,Bien Hoa City,19,591,545,46,11
2022-01-21,Dong Nai,Bien Hoa City,20,414,353,61,20
2022-01-21,Dong Nai,Bien Hoa City,21,205,132,73,28
2022-01-21,Dong Nai,Bien Hoa City,22,4,3,1,0
2022-01-21,Dong Nai,Bien Hoa City,23,1,0,1,0
2022-01-21,Dong Nai,Long Thanh,10,1,0,1,0
2022-01-21,Dong Nai,Long Thanh,11,3,0,3,3
2022-01-21,Dong Nai,Long Thanh,14,4,0,4,2
2022-01-21,Dong Nai,Long Thanh,18,2,0,2,2
2022-01-21,Dong Nai,Long Thanh,19,1,0,1,0
2022-01-21,Dong Nai,Long Thanh,20,1,0,1,1
2022-01-21,Dong Nai,Thong Nhat,8,2,2,0,0
2022-01-21,Dong Nai,Thong Nhat,9,2,2,0,0
2022-01-21,Dong Nai,Thong Nhat,10,1,1,0,0
2022-01-21,Dong Nai,Thong Nhat,11,1,1,0,0
2022-01-21,Dong Nai,Thong Nhat,12,2,2,0,0
2022-01-21,Dong Nai,Thong Nhat,13,3,3,0,0
2022-01-21,Dong Nai,Thong Nhat,14,1,1,0,0
2022-01-21,Dong Nai,Thong Nhat,16,2,2,0,0
2022-01-21,Dong Nai,Thong Nhat,17,1,1,0,0
2022-01-21,Dong Nai,Thong Nhat,20,3,3,0,0
2022-01-21,Dong Nai,Thong Nhat,21,1,0,1,1
2022-01-21,Dong Nai,Trang Bom,12,1,1,0,0
2022-01-21,Dong Nai,Trang Bom,13,1,0,1,0
2022-01-21,Dong Nai,Trang Bom,14,1,1,0,0
2022-01-21,Dong Nai,Vinh Cuu,10,1,1,0,0
2022-01-21,Hai Phong City,An Duong,7,1,0,1,1
2022-01-21,Hai Phong City,An Duong,8,3,0,3,3
2022-01-21,Hai Phong City,An Duong,9,1,1,0,0
2022-01-21,Hai Phong City,An Duong,10,6,2,4,2
2022-01-21,Hai Phong City,An Duong,11,2,2,0,0
2022-01-21,Hai Phong City,An Duong,12,1,1,0,0
2022-01-21,Hai Phong City,An Duong,13,1,0,1,1
2022-01-21,Hai Phong City,An Duong,14,7,2,5,5
2022-01-21,Hai Phong City,An Duong,15,8,2,6,4
2022-01-21,Hai Phong City,An Duong,16,2,1,1,1
2022-01-21,Hai Phong City,An Duong,17,5,1,4,4
2022-01-21,Hai Phong City,An Duong,18,5,1,4,1
2022-01-21,Hai Phong City,An Duong,19,2,0,2,2
2022-01-21,Hai Phong City,Hai An District,7,6,6,0,0
2022-01-21,Hai Phong City,Hai An District,8,20,15,5,0
2022-01-21,Hai Phong City,Hai An District,9,14,11,3,1
2022-01-21,Hai Phong City,Hai An District,10,30,25,5,1
2022-01-21,Hai Phong City,Hai An District,11,59,49,10,2
2022-01-21,Hai Phong City,Hai An District,12,33,27,6,0
2022-01-21,Hai Phong City,Hai An District,13,14,12,2,0
2022-01-21,Hai Phong City,Hai An District,14,11,10,1,0
2022-01-21,Hai Phong City,Hai An District,15,24,15,9,2
2022-01-21,Hai Phong City,Hai An District,16,26,23,3,2
2022-01-21,Hai Phong City,Hai An District,17,30,22,8,2
2022-01-21,Hai Phong City,Hai An District,18,41,32,9,7
2022-01-21,Hai Phong City,Hai An District,19,27,14,13,2
2022-01-21,Hai Phong City,Hai An District,20,17,13,4,3
2022-01-21,Hai Phong City,Hai An District,21,15,7,8,2
2022-01-21,Hai Phong City,Hai An District,22,1,0,1,0
2022-01-21,Hai Phong City,Hong Bang District,5,1,1,0,0
2022-01-21,Hai Phong City,Hong Bang District,6,1,1,0,0
2022-01-21,Hai Phong City,Hong Bang District,7,17,15,2,1
2022-01-21,Hai Phong City,Hong Bang District,8,44,41,3,2
2022-01-21,Hai Phong City,Hong Bang District,9,33,30,3,0
2022-01-21,Hai Phong City,Hong Bang District,10,63,57,6,1
2022-01-21,Hai Phong City,Hong Bang District,11,125,113,12,4
2022-01-21,Hai Phong City,Hong Bang District,12,87,76,11,1
2022-01-21,Hai Phong City,Hong Bang District,13,42,40,2,0
2022-01-21,Hai Phong City,Hong Bang District,14,41,36,5,1
2022-01-21,Hai Phong City,Hong Bang District,15,38,33,5,5
2022-01-21,Hai Phong City,Hong Bang District,16,62,52,10,0
2022-01-21,Hai Phong City,Hong Bang District,17,79,55,24,15
2022-01-21,Hai Phong City,Hong Bang District,18,95,55,40,36
2022-01-21,Hai Phong City,Hong Bang District,19,73,35,38,27
2022-01-21,Hai Phong City,Hong Bang District,20,55,25,30,22
2022-01-21,Hai Phong City,Hong Bang District,21,24,10,14,10
2022-01-21,Hai Phong City,Kien An District,7,2,0,2,0
2022-01-21,Hai Phong City,Kien An District,8,3,0,3,3
2022-01-21,Hai Phong City,Kien An District,9,5,3,2,2
2022-01-21,Hai Phong City,Kien An District,10,7,4,3,0
2022-01-21,Hai Phong City,Kien An District,11,15,12,3,0
2022-01-21,Hai Phong City,Kien An District,12,7,7,0,0
2022-01-21,Hai Phong City,Kien An District,13,7,7,0,0
2022-01-21,Hai Phong City,Kien An District,14,12,9,3,2
2022-01-21,Hai Phong City,Kien An District,15,3,1,2,0
2022-01-21,Hai Phong City,Kien An District,16,9,7,2,2
2022-01-21,Hai Phong City,Kien An District,17,14,8,6,2
2022-01-21,Hai Phong City,Kien An District,18,24,11,13,8
2022-01-21,Hai Phong City,Kien An District,19,14,8,6,4
2022-01-21,Hai Phong City,Kien An District,20,12,4,8,6
2022-01-21,Hai Phong City,Le Chan District,0,5,1,4,0
2022-01-21,Hai Phong City,Le Chan District,4,1,1,0,0
2022-01-21,Hai Phong City,Le Chan District,6,1,1,0,0
2022-01-21,Hai Phong City,Le Chan District,7,46,37,9,4
2022-01-21,Hai Phong City,Le Chan District,8,103,87,16,4
2022-01-21,Hai Phong City,Le Chan District,9,107,94,13,1
2022-01-21,Hai Phong City,Le Chan District,10,187,168,19,3
2022-01-21,Hai Phong City,Le Chan District,11,358,311,47,13
2022-01-21,Hai Phong City,Le Chan District,12,251,229,22,2
2022-01-21,Hai Phong City,Le Chan District,13,108,102,6,0
2022-01-21,Hai Phong City,Le Chan District,14,134,115,19,3
2022-01-21,Hai Phong City,Le Chan District,15,161,139,22,4
2022-01-21,Hai Phong City,Le Chan District,16,180,155,25,6
2022-01-21,Hai Phong City,Le Chan District,17,273,200,73,51
2022-01-21,Hai Phong City,Le Chan District,18,447,255,192,158
2022-01-21,Hai Phong City,Le Chan District,19,364,235,129,90
2022-01-21,Hai Phong City,Le Chan District,20,231,145,86,66
2022-01-21,Hai Phong City,Le Chan District,21,107,52,55,31
2022-01-21,Hai Phong City,Le Chan District,22,4,0,4,2
2022-01-21,Hai Phong City,Le Chan District,23,1,0,1,0
2022-01-21,Hai Phong City,Ngo Quyen District,1,1,1,0,0
2022-01-21,Hai Phong City,Ngo Quyen District,2,1,1,0,0
2022-01-21,Hai Phong City,Ngo Quyen District,7,24,22,2,1
2022-01-21,Hai Phong City,Ngo Quyen District,8,85,74,11,2
2022-01-21,Hai Phong City,Ngo Quyen District,9,76,70,6,0
2022-01-21,Hai Phong City,Ngo Quyen District,10,133,125,8,1
2022-01-21,Hai Phong City,Ngo Quyen District,11,304,265,39,9
2022-01-21,Hai Phong City,Ngo Quyen District,12,195,177,18,1
2022-01-21,Hai Phong City,Ngo Quyen District,13,109,99,10,0
2022-01-21,Hai Phong City,Ngo Quyen District,14,148,136,12,2
2022-01-21,Hai Phong City,Ngo Quyen District,15,163,147,16,3
2022-01-21,Hai Phong City,Ngo Quyen District,16,154,137,17,2
2022-01-21,Hai Phong City,Ngo Quyen District,17,219,160,59,42
2022-01-21,Hai Phong City,Ngo Quyen District,18,383,223,160,118
2022-01-21,Hai Phong City,Ngo Quyen District,19,285,193,92,61
2022-01-21,Hai Phong City,Ngo Quyen District,20,232,145,87,58
2022-01-21,Hai Phong City,Ngo Quyen District,21,112,52,60,32
2022-01-21,Hai Phong City,Ngo Quyen District,22,2,0,2,0
2022-01-21,Hai Phong City,Thuy Nguyen,14,2,0,2,2
2022-01-21,Hai Phong City,Thuy Nguyen,19,1,0,1,0
2022-01-21,Hai Phong City,Thuy Nguyen,20,1,0,1,1
2022-01-21,Hai Phong City,Thuy Nguyen,21,1,0,1,0
2022-01-21,Hue City,Hue City,0,2,2,0,0
2022-01-21,Hue City,Hue City,1,5,4,1,0
2022-01-21,Hue City,Hue City,2,4,1,3,0
2022-01-21,Hue City,Hue City,4,1,1,0,0
2022-01-21,Hue City,Hue City,5,1,1,0,0
2022-01-21,Hue City,Hue City,6,53,48,5,2
2022-01-21,Hue City,Hue City,7,214,199,15,0
2022-01-21,Hue City,Hue City,8,338,310,28,0
2022-01-21,Hue City,Hue City,9,228,219,9,0
2022-01-21,Hue City,Hue City,10,397,367,30,3
2022-01-21,Hue City,Hue City,11,878,820,58,1
2022-01-21,Hue City,Hue City,12,534,510,24,0
2022-01-21,Hue City,Hue City,13,279,259,20,0
2022-01-21,Hue City,Hue City,14,358,339,19,0
2022-01-21,Hue City,Hue City,15,366,340,26,3
2022-01-21,Hue City,Hue City,16,412,394,18,0
2022-01-21,Hue City,Hue City,17,612,573,39,0
2022-01-21,Hue City,Hue City,18,632,598,34,1
2022-01-21,Hue City,Hue City,19,539,498,41,0
2022-01-21,Hue City,Hue City,20,401,368,33,5
2022-01-21,Hue City,Hue City,21,205,171,34,1
2022-01-21,Hue City,Hue City,22,3,1,2,1
2022-01-21,Hue City,Hue City,23,2,2,0,0
2022-01-21,Hue City,Huong Thuy,7,1,0,1,1
2022-01-21,Hue City,Huong Thuy,8,1,1,0,0
2022-01-21,Hue City,Huong Thuy,9,1,1,0,0
2022-01-21,Hue City,Huong Thuy,11,2,1,1,0
2022-01-21,Hue City,Huong Thuy,15,1,1,0,0
2022-01-21,Hue City,Huong Thuy,16,1,0,1,1
2022-01-21,Hue City,Huong Tra,9,2,1,1,0
2022-01-21,Hue City,Huong Tra,11,1,1,0,0
2022-01-21,Hue City,Huong Tra,12,1,1,0,0
2022-01-21,Hue City,Huong Tra,14,2,1,1,0
2022-01-21,Hue City,Huong Tra,15,1,1,0,0
2022-01-21,Hue City,Huong Tra,18,1,1,0,0
2022-01-21,Hue City,Huong Tra,21,1,1,0,0
2022-01-21,Hue City,Phu Vang,6,2,1,1,0
2022-01-21,Hue City,Phu Vang,8,1,1,0,0
2022-01-21,Hue City,Phu Vang,10,2,0,2,0
2022-01-21,Hue City,Phu Vang,11,1,1,0,0
2022-01-21,Hue City,Phu Vang,13,2,0,2,0
2022-01-21,Hue City,Phu Vang,14,1,1,0,0
2022-01-21,Hue City,Phu Vang,16,2,1,1,0
2022-01-21,Hue City,Phu Vang,19,5,1,4,1
2022-01-21,Hue City,Phu Vang,20,1,1,0,0
2022-01-21,Hue City,Phu Vang,21,1,1,0,0
2022-01-21,Vung Tau,Ba Ria City,7,2,0,2,2
2022-01-21,Vung Tau,Ba Ria City,8,2,0,2,2
2022-01-21,Vung Tau,Ba Ria City,9,4,2,2,2
2022-01-21,Vung Tau,Ba Ria City,10,9,5,4,3
2022-01-21,Vung Tau,Ba Ria City,11,12,3,9,9
2022-01-21,Vung Tau,Ba Ria City,12,10,2,8,8
2022-01-21,Vung Tau,Ba Ria City,13,3,3,0,0
2022-01-21,Vung Tau,Ba Ria City,14,3,1,2,2
2022-01-21,Vung Tau,Ba Ria City,15,9,4,5,0
2022-01-21,Vung Tau,Ba Ria City,16,9,3,6,4
2022-01-21,Vung Tau,Ba Ria City,17,10,5,5,5
2022-01-21,Vung Tau,Ba Ria City,18,6,2,4,3
2022-01-21,Vung Tau,Ba Ria City,19,3,1,2,2
2022-01-21,Vung Tau,Ba Ria City,20,3,0,3,2
2022-01-21,Vung Tau,Ba Ria City,21,4,0,4,4
2022-01-21,Vung Tau,Tan Thanh,18,1,0,1,1
2022-01-21,Vung Tau,Vung Tau City,0,1,1,0,0
2022-01-21,Vung Tau,Vung Tau City,5,1,1,0,0
2022-01-21,Vung Tau,Vung Tau City,6,31,28,3,1
2022-01-21,Vung Tau,Vung Tau City,7,114,106,8,1
2022-01-21,Vung Tau,Vung Tau City,8,171,152,19,3
2022-01-21,Vung Tau,Vung Tau City,9,153,143,10,0
2022-01-21,Vung Tau,Vung Tau City,10,189,172,17,0
2022-01-21,Vung Tau,Vung Tau City,11,347,312,35,0
2022-01-21,Vung Tau,Vung Tau City,12,315,286,29,0
2022-01-21,Vung Tau,Vung Tau City,13,186,176,10,0
2022-01-21,Vung Tau,Vung Tau City,14,199,189,10,0
2022-01-21,Vung Tau,Vung Tau City,15,186,170,16,1
2022-01-21,Vung Tau,Vung Tau City,16,173,163,10,0
2022-01-21,Vung Tau,Vung Tau City,17,264,245,19,4
2022-01-21,Vung Tau,Vung Tau City,18,332,313,19,0
2022-01-21,Vung Tau,Vung Tau City,19,262,236,26,4
2022-01-21,Vung Tau,Vung Tau City,20,172,152,20,2
2022-01-21,Vung Tau,Vung Tau City,21,76,53,23,2
2022-01-21,Vung Tau,Vung Tau City,22,1,1,0,0
2022-01-21,Vung Tau,Vung Tau City,23,1,0,1,1
2022-01-22,Binh Duong,Di An,6,2,0,2,2
2022-01-22,Binh Duong,Di An,7,7,2,5,4
2022-01-22,Binh Duong,Di An,8,5,3,2,1
2022-01-22,Binh Duong,Di An,9,11,4,7,6
2022-01-22,Binh Duong,Di An,10,11,6,5,5
2022-01-22,Binh Duong,Di An,11,36,13,23,16
2022-01-22,Binh Duong,Di An,12,31,15,16,14
2022-01-22,Binh Duong,Di An,13,25,17,8,4
2022-01-22,Binh Duong,Di An,14,14,6,8,6
2022-01-22,Binh Duong,Di An,15,19,13,6,6
2022-01-22,Binh Duong,Di An,16,8,6,2,1
2022-01-22,Binh Duong,Di An,17,28,18,10,7
2022-01-22,Binh Duong,Di An,18,19,15,4,4
2022-01-22,Binh Duong,Di An,19,22,14,8,7
2022-01-22,Binh Duong,Di An,20,7,1,6,4
2022-01-22,Binh Duong,Di An,21,11,3,8,7
2022-01-22,Binh Duong,Tan Uyen,9,1,1,0,0
2022-01-22,Binh Duong,Tan Uyen,10,2,1,1,1
2022-01-22,Binh Duong,Tan Uyen,11,2,0,2,2
2022-01-22,Binh Duong,Tan Uyen,12,1,1,0,0
2022-01-22,Binh Duong,Tan Uyen,13,2,1,1,1
2022-01-22,Binh Duong,Tan Uyen,14,1,0,1,1
2022-01-22,Binh Duong,Tan Uyen,15,1,1,0,0
2022-01-22,Binh Duong,Tan Uyen,16,3,1,2,1
2022-01-22,Binh Duong,Tan Uyen,19,1,0,1,1
2022-01-22,Binh Duong,Thu Dau Mot Town,1,2,0,2,1
2022-01-22,Binh Duong,Thu Dau Mot Town,5,3,1,2,1
2022-01-22,Binh Duong,Thu Dau Mot Town,6,38,22,16,14
2022-01-22,Binh Duong,Thu Dau Mot Town,7,100,94,6,0
2022-01-22,Binh Duong,Thu Dau Mot Town,8,202,190,12,5
2022-01-22,Binh Duong,Thu Dau Mot Town,9,263,247,16,6
2022-01-22,Binh Duong,Thu Dau Mot Town,10,377,356,21,2
2022-01-22,Binh Duong,Thu Dau Mot Town,11,571,521,50,26
2022-01-22,Binh Duong,Thu Dau Mot Town,12,453,425,28,5
2022-01-22,Binh Duong,Thu Dau Mot Town,13,396,365,31,11
2022-01-22,Binh Duong,Thu Dau Mot Town,14,308,287,21,10
2022-01-22,Binh Duong,Thu Dau Mot Town,15,245,232,13,5
2022-01-22,Binh Duong,Thu Dau Mot Town,16,260,235,25,3
2022-01-22,Binh Duong,Thu Dau Mot Town,17,299,278,21,6
2022-01-22,Binh Duong,Thu Dau Mot Town,18,423,328,95,72
2022-01-22,Binh Duong,Thu Dau Mot Town,19,369,272,97,70
2022-01-22,Binh Duong,Thu Dau Mot Town,20,235,169,66,45
2022-01-22,Binh Duong,Thu Dau Mot Town,21,129,97,32,10
2022-01-22,Binh Duong,Thu Dau Mot Town,22,2,1,1,0
2022-01-22,Binh Duong,Thu Dau Mot Town,23,4,2,2,1
2022-01-22,Binh Duong,Thuan An,0,1,0,1,0
2022-01-22,Binh Duong,Thuan An,1,1,1,0,0
2022-01-22,Binh Duong,Thuan An,6,2,1,1,1
2022-01-22,Binh Duong,Thuan An,7,3,1,2,1
2022-01-22,Binh Duong,Thuan An,8,16,9,7,5
2022-01-22,Binh Duong,Thuan An,9,26,17,9,9
2022-01-22,Binh Duong,Thuan An,10,64,32,32,29
2022-01-22,Binh Duong,Thuan An,11,87,48,39,30
2022-01-22,Binh Duong,Thuan An,12,65,36,29,22
2022-01-22,Binh Duong,Thuan An,13,68,39,29,20
2022-01-22,Binh Duong,Thuan An,14,49,23,26,22
2022-01-22,Binh Duong,Thuan An,15,33,20,13,12
2022-01-22,Binh Duong,Thuan An,16,27,19,8,6
2022-01-22,Binh Duong,Thuan An,17,32,20,12,11
2022-01-22,Binh Duong,Thuan An,18,41,23,18,13
2022-01-22,Binh Duong,Thuan An,19,37,18,19,15
2022-01-22,Binh Duong,Thuan An,20,39,10,29,24
2022-01-22,Binh Duong,Thuan An,21,4,2,2,1
2022-01-22,Binh Duong,Thuan An,22,1,0,1,0
2022-01-22,Binh Duong,Thuan An,23,1,0,1,0
2022-01-22,Can Tho City,Binh Thuy District,7,2,1,1,0
2022-01-22,Can Tho City,Binh Thuy District,8,5,5,0,0
2022-01-22,Can Tho City,Binh Thuy District,9,8,8,0,0
2022-01-22,Can Tho City,Binh Thuy District,10,7,6,1,0
2022-01-22,Can Tho City,Binh Thuy District,11,10,10,0,0
2022-01-22,Can Tho City,Binh Thuy District,12,18,17,1,0
2022-01-22,Can Tho City,Binh Thuy District,13,13,12,1,0
2022-01-22,Can Tho City,Binh Thuy District,14,10,8,2,0
2022-01-22,Can Tho City,Binh Thuy District,15,6,6,0,0
2022-01-22,Can Tho City,Binh Thuy District,16,13,13,0,0
2022-01-22,Can Tho City,Binh Thuy District,17,16,12,4,0
2022-01-22,Can Tho City,Binh Thuy District,18,17,16,1,0
2022-01-22,Can Tho City,Binh Thuy District,19,7,7,0,0
2022-01-22,Can Tho City,Binh Thuy District,20,9,9,0,0
2022-01-22,Can Tho City,Binh Thuy District,21,2,2,0,0
2022-01-22,Can Tho City,Cai Rang District,8,8,7,1,0
2022-01-22,Can Tho City,Cai Rang District,9,5,4,1,0
2022-01-22,Can Tho City,Cai Rang District,10,9,9,0,0
2022-01-22,Can Tho City,Cai Rang District,11,13,13,0,0
2022-01-22,Can Tho City,Cai Rang District,12,9,8,1,0
2022-01-22,Can Tho City,Cai Rang District,13,11,10,1,0
2022-01-22,Can Tho City,Cai Rang District,14,8,8,0,0
2022-01-22,Can Tho City,Cai Rang District,15,8,8,0,0
2022-01-22,Can Tho City,Cai Rang District,16,4,3,1,0
2022-01-22,Can Tho City,Cai Rang District,17,9,9,0,0
2022-01-22,Can Tho City,Cai Rang District,18,14,13,1,0
2022-01-22,Can Tho City,Cai Rang District,19,4,4,0,0
2022-01-22,Can Tho City,Cai Rang District,20,6,5,1,0
2022-01-22,Can Tho City,Cai Rang District,21,8,6,2,1
2022-01-22,Can Tho City,Ninh Kieu District,0,3,3,0,0
2022-01-22,Can Tho City,Ninh Kieu District,1,1,1,0,0
2022-01-22,Can Tho City,Ninh Kieu District,4,1,1,0,0
2022-01-22,Can Tho City,Ninh Kieu District,5,1,1,0,0
2022-01-22,Can Tho City,Ninh Kieu District,6,42,40,2,0
2022-01-22,Can Tho City,Ninh Kieu District,7,160,149,11,0
2022-01-22,Can Tho City,Ninh Kieu District,8,291,268,23,0
2022-01-22,Can Tho City,Ninh Kieu District,9,253,242,11,0
2022-01-22,Can Tho City,Ninh Kieu District,10,433,421,12,0
2022-01-22,Can Tho City,Ninh Kieu District,11,680,660,20,0
2022-01-22,Can Tho City,Ninh Kieu District,12,553,526,27,0
2022-01-22,Can Tho City,Ninh Kieu District,13,445,420,25,0
2022-01-22,Can Tho City,Ninh Kieu District,14,344,324,20,0
2022-01-22,Can Tho City,Ninh Kieu District,15,305,288,17,0
2022-01-22,Can Tho City,Ninh Kieu District,16,359,348,11,0
2022-01-22,Can Tho City,Ninh Kieu District,17,373,361,12,0
2022-01-22,Can Tho City,Ninh Kieu District,18,406,392,14,0
2022-01-22,Can Tho City,Ninh Kieu District,19,326,310,16,0
2022-01-22,Can Tho City,Ninh Kieu District,20,274,250,24,0
2022-01-22,Can Tho City,Ninh Kieu District,21,152,134,18,0
2022-01-22,Can Tho City,Ninh Kieu District,22,1,0,1,0
2022-01-22,Can Tho City,Ninh Kieu District,23,3,3,0,0
2022-01-22,Dong Nai,Bien Hoa City,0,1,0,1,1
2022-01-22,Dong Nai,Bien Hoa City,1,1,1,0,0
2022-01-22,Dong Nai,Bien Hoa City,2,2,1,1,0
2022-01-22,Dong Nai,Bien Hoa City,5,3,2,1,0
2022-01-22,Dong Nai,Bien Hoa City,6,44,30,14,6
2022-01-22,Dong Nai,Bien Hoa City,7,179,143,36,23
2022-01-22,Dong Nai,Bien Hoa City,8,294,253,41,16
2022-01-22,Dong Nai,Bien Hoa City,9,409,365,44,10
2022-01-22,Dong Nai,Bien Hoa City,10,715,645,70,27
2022-01-22,Dong Nai,Bien Hoa City,11,1114,975,139,57
2022-01-22,Dong Nai,Bien Hoa City,12,940,863,77,27
2022-01-22,Dong Nai,Bien Hoa City,13,776,710,66,15
2022-01-22,Dong Nai,Bien Hoa City,14,606,555,51,11
2022-01-22,Dong Nai,Bien Hoa City,15,500,442,58,15
2022-01-22,Dong Nai,Bien Hoa City,16,511,446,65,25
2022-01-22,Dong Nai,Bien Hoa City,17,681,553,128,69
2022-01-22,Dong Nai,Bien Hoa City,18,721,552,169,123
2022-01-22,Dong Nai,Bien Hoa City,19,778,519,259,179
2022-01-22,Dong Nai,Bien Hoa City,20,541,372,169,117
2022-01-22,Dong Nai,Bien Hoa City,21,272,181,91,51
2022-01-22,Dong Nai,Bien Hoa City,22,3,2,1,0
2022-01-22,Dong Nai,Bien Hoa City,23,3,0,3,1
2022-01-22,Dong Nai,Cam My,11,1,0,1,1
2022-01-22,Dong Nai,Cam My,12,1,0,1,1
2022-01-22,Dong Nai,Cam My,14,1,0,1,1
2022-01-22,Dong Nai,Long Khanh,19,1,0,1,1
2022-01-22,Dong Nai,Long Thanh,9,3,0,3,3
2022-01-22,Dong Nai,Long Thanh,11,6,0,6,6
2022-01-22,Dong Nai,Long Thanh,15,1,0,1,1
2022-01-22,Dong Nai,Thong Nhat,9,2,2,0,0
2022-01-22,Dong Nai,Thong Nhat,10,2,2,0,0
2022-01-22,Dong Nai,Thong Nhat,12,1,1,0,0
2022-01-22,Dong Nai,Thong Nhat,13,1,1,0,0
2022-01-22,Dong Nai,Thong Nhat,14,1,1,0,0
2022-01-22,Dong Nai,Thong Nhat,15,2,2,0,0
2022-01-22,Dong Nai,Thong Nhat,18,2,2,0,0
2022-01-22,Dong Nai,Thong Nhat,20,1,1,0,0
2022-01-22,Dong Nai,Thong Nhat,21,1,1,0,0
2022-01-22,Dong Nai,Trang Bom,10,2,2,0,0
2022-01-22,Dong Nai,Trang Bom,12,1,1,0,0
2022-01-22,Dong Nai,Trang Bom,13,1,0,1,1
2022-01-22,Dong Nai,Trang Bom,14,1,0,1,1
2022-01-22,Dong Nai,Trang Bom,16,1,0,1,1
2022-01-22,Dong Nai,Trang Bom,17,1,0,1,1
2022-01-22,Dong Nai,Trang Bom,18,3,0,3,3
2022-01-22,Hai Phong City,An Duong,7,2,0,2,1
2022-01-22,Hai Phong City,An Duong,9,5,3,2,1
2022-01-22,Hai Phong City,An Duong,10,4,3,1,1
2022-01-22,Hai Phong City,An Duong,11,2,2,0,0
2022-01-22,Hai Phong City,An Duong,13,3,1,2,2
2022-01-22,Hai Phong City,An Duong,14,4,3,1,1
2022-01-22,Hai Phong City,An Duong,15,4,2,2,2
2022-01-22,Hai Phong City,An Duong,16,3,1,2,2
2022-01-22,Hai Phong City,An Duong,17,2,2,0,0
2022-01-22,Hai Phong City,An Duong,18,6,3,3,1
2022-01-22,Hai Phong City,An Duong,19,1,0,1,0
2022-01-22,Hai Phong City,An Duong,20,2,0,2,0
2022-01-22,Hai Phong City,Do Son District,16,1,0,1,1
2022-01-22,Hai Phong City,Duong Kinh District,15,2,0,2,2
2022-01-22,Hai Phong City,Hai An District,5,1,1,0,0
2022-01-22,Hai Phong City,Hai An District,7,9,8,1,1
2022-01-22,Hai Phong City,Hai An District,8,8,8,0,0
2022-01-22,Hai Phong City,Hai An District,9,11,11,0,0
2022-01-22,Hai Phong City,Hai An District,10,30,25,5,0
2022-01-22,Hai Phong City,Hai An District,11,22,21,1,1
2022-01-22,Hai Phong City,Hai An District,12,28,26,2,0
2022-01-22,Hai Phong City,Hai An District,13,13,13,0,0
2022-01-22,Hai Phong City,Hai An District,14,13,10,3,1
2022-01-22,Hai Phong City,Hai An District,15,18,16,2,0
2022-01-22,Hai Phong City,Hai An District,16,20,17,3,1
2022-01-22,Hai Phong City,Hai An District,17,24,21,3,1
2022-01-22,Hai Phong City,Hai An District,18,31,27,4,0
2022-01-22,Hai Phong City,Hai An District,19,25,22,3,3
2022-01-22,Hai Phong City,Hai An District,20,25,20,5,0
2022-01-22,Hai Phong City,Hai An District,21,9,8,1,0
2022-01-22,Hai Phong City,Hong Bang District,2,1,0,1,0
2022-01-22,Hai Phong City,Hong Bang District,3,1,0,1,1
2022-01-22,Hai Phong City,Hong Bang District,6,1,1,0,0
2022-01-22,Hai Phong City,Hong Bang District,7,18,14,4,1
2022-01-22,Hai Phong City,Hong Bang District,8,25,22,3,2
2022-01-22,Hai Phong City,Hong Bang District,9,35,33,2,2
2022-01-22,Hai Phong City,Hong Bang District,10,63,58,5,0
2022-01-22,Hai Phong City,Hong Bang District,11,150,102,48,34
2022-01-22,Hai Phong City,Hong Bang District,12,98,82,16,4
2022-01-22,Hai Phong City,Hong Bang District,13,36,33,3,0
2022-01-22,Hai Phong City,Hong Bang District,14,27,25,2,1
2022-01-22,Hai Phong City,Hong Bang District,15,29,28,1,0
2022-01-22,Hai Phong City,Hong Bang District,16,44,39,5,3
2022-01-22,Hai Phong City,Hong Bang District,17,60,52,8,2
2022-01-22,Hai Phong City,Hong Bang District,18,92,65,27,16
2022-01-22,Hai Phong City,Hong Bang District,19,58,50,8,4
2022-01-22,Hai Phong City,Hong Bang District,20,54,43,11,10
2022-01-22,Hai Phong City,Hong Bang District,21,20,16,4,2
2022-01-22,Hai Phong City,Kien An District,7,6,1,5,4
2022-01-22,Hai Phong City,Kien An District,8,4,1,3,3
2022-01-22,Hai Phong City,Kien An District,9,3,3,0,0
2022-01-22,Hai Phong City,Kien An District,10,7,5,2,1
2022-01-22,Hai Phong City,Kien An District,11,14,10,4,3
2022-01-22,Hai Phong City,Kien An District,12,7,3,4,4
2022-01-22,Hai Phong City,Kien An District,13,12,9,3,2
2022-01-22,Hai Phong City,Kien An District,14,2,0,2,1
2022-01-22,Hai Phong City,Kien An District,15,11,6,5,1
2022-01-22,Hai Phong City,Kien An District,16,8,5,3,1
2022-01-22,Hai Phong City,Kien An District,17,6,3,3,1
2022-01-22,Hai Phong City,Kien An District,18,14,4,10,9
2022-01-22,Hai Phong City,Kien An District,19,21,6,15,14
2022-01-22,Hai Phong City,Kien An District,20,11,8,3,2
2022-01-22,Hai Phong City,Kien An District,21,5,2,3,2
2022-01-22,Hai Phong City,Le Chan District,0,2,1,1,1
2022-01-22,Hai Phong City,Le Chan District,1,1,1,0,0
2022-01-22,Hai Phong City,Le Chan District,3,1,0,1,0
2022-01-22,Hai Phong City,Le Chan District,4,2,1,1,1
2022-01-22,Hai Phong City,Le Chan District,6,1,1,0,0
2022-01-22,Hai Phong City,Le Chan District,7,41,27,14,11
2022-01-22,Hai Phong City,Le Chan District,8,79,69,10,1
2022-01-22,Hai Phong City,Le Chan District,9,133,113,20,1
2022-01-22,Hai Phong City,Le Chan District,10,189,171,18,4
2022-01-22,Hai Phong City,Le Chan District,11,418,340,78,33
2022-01-22,Hai Phong City,Le Chan District,12,300,266,34,6
2022-01-22,Hai Phong City,Le Chan District,13,142,122,20,2
2022-01-22,Hai Phong City,Le Chan District,14,138,124,14,2
2022-01-22,Hai Phong City,Le Chan District,15,152,127,25,5
2022-01-22,Hai Phong City,Le Chan District,16,156,138,18,1
2022-01-22,Hai Phong City,Le Chan District,17,232,198,34,9
2022-01-22,Hai Phong City,Le Chan District,18,335,265,70,35
2022-01-22,Hai Phong City,Le Chan District,19,209,168,41,13
2022-01-22,Hai Phong City,Le Chan District,20,166,133,33,11
2022-01-22,Hai Phong City,Le Chan District,21,82,64,18,6
2022-01-22,Hai Phong City,Le Chan District,22,2,1,1,1
2022-01-22,Hai Phong City,Le Chan District,23,1,1,0,0
2022-01-22,Hai Phong City,Ngo Quyen District,3,1,0,1,1
2022-01-22,Hai Phong City,Ngo Quyen District,6,1,1,0,0
2022-01-22,Hai Phong City,Ngo Quyen District,7,51,32,19,11
2022-01-22,Hai Phong City,Ngo Quyen District,8,88,70,18,1
2022-01-22,Hai Phong City,Ngo Quyen District,9,109,95,14,1
2022-01-22,Hai Phong City,Ngo Quyen District,10,162,151,11,0
2022-01-22,Hai Phong City,Ngo Quyen District,11,272,231,41,25
2022-01-22,Hai Phong City,Ngo Quyen District,12,216,189,27,11
2022-01-22,Hai Phong City,Ngo Quyen District,13,115,110,5,0
2022-01-22,Hai Phong City,Ngo Quyen District,14,131,127,4,0
2022-01-22,Hai Phong City,Ngo Quyen District,15,163,151,12,1
2022-01-22,Hai Phong City,Ngo Quyen District,16,133,121,12,0
2022-01-22,Hai Phong City,Ngo Quyen District,17,177,149,28,6
2022-01-22,Hai Phong City,Ngo Quyen District,18,218,185,33,15
2022-01-22,Hai Phong City,Ngo Quyen District,19,211,172,39,12
2022-01-22,Hai Phong City,Ngo Quyen District,20,176,158,18,5
2022-01-22,Hai Phong City,Ngo Quyen District,21,72,55,17,5
2022-01-22,Hai Phong City,Ngo Quyen District,22,1,0,1,0
2022-01-22,Hai Phong City,Ngo Quyen District,23,2,1,1,1
2022-01-22,Hai Phong City,Thuy Nguyen,10,1,0,1,1
2022-01-22,Hai Phong City,Thuy Nguyen,11,1,0,1,1
2022-01-22,Hai Phong City,Thuy Nguyen,12,1,0,1,1
2022-01-22,Hai Phong City,Thuy Nguyen,13,3,0,3,3
2022-01-22,Hai Phong City,Thuy Nguyen,17,3,1,2,1
2022-01-22,Hai Phong City,Thuy Nguyen,18,1,0,1,1
2022-01-22,Hue City,Hue City,0,3,3,0,0
2022-01-22,Hue City,Hue City,1,1,1,0,0
2022-01-22,Hue City,Hue City,4,2,1,1,0
2022-01-22,Hue City,Hue City,5,1,1,0,0
2022-01-22,Hue City,Hue City,6,58,51,7,0
2022-01-22,Hue City,Hue City,7,216,199,17,1
2022-01-22,Hue City,Hue City,8,318,299,19,0
2022-01-22,Hue City,Hue City,9,315,300,15,0
2022-01-22,Hue City,Hue City,10,385,366,19,0
2022-01-22,Hue City,Hue City,11,715,689,26,2
2022-01-22,Hue City,Hue City,12,561,541,20,0
2022-01-22,Hue City,Hue City,13,329,312,17,0
2022-01-22,Hue City,Hue City,14,315,297,18,1
2022-01-22,Hue City,Hue City,15,367,349,18,0
2022-01-22,Hue City,Hue City,16,394,380,14,2
2022-01-22,Hue City,Hue City,17,548,519,29,0
2022-01-22,Hue City,Hue City,18,587,556,31,1
2022-01-22,Hue City,Hue City,19,464,433,31,1
2022-01-22,Hue City,Hue City,20,384,349,35,2
2022-01-22,Hue City,Hue City,21,217,191,26,2
2022-01-22,Hue City,Hue City,22,2,0,2,0
2022-01-22,Hue City,Hue City,23,3,3,0,0
2022-01-22,Hue City,Huong Thuy,6,1,0,1,1
2022-01-22,Hue City,Huong Thuy,10,1,0,1,1
2022-01-22,Hue City,Huong Thuy,11,1,1,0,0
2022-01-22,Hue City,Huong Thuy,12,1,1,0,0
2022-01-22,Hue City,Huong Thuy,13,1,1,0,0
2022-01-22,Hue City,Huong Thuy,14,4,3,1,0
2022-01-22,Hue City,Huong Thuy,16,2,2,0,0
2022-01-22,Hue City,Huong Thuy,20,3,1,2,0
2022-01-22,Hue City,Huong Thuy,21,2,0,2,2
2022-01-22,Hue City,Huong Tra,10,2,1,1,1
2022-01-22,Hue City,Huong Tra,12,1,1,0,0
2022-01-22,Hue City,Huong Tra,16,1,0,1,0
2022-01-22,Hue City,Huong Tra,21,1,0,1,0
2022-01-22,Hue City,Phu Vang,8,2,1,1,0
2022-01-22,Hue City,Phu Vang,11,1,1,0,0
2022-01-22,Hue City,Phu Vang,15,1,1,0,0
2022-01-22,Hue City,Phu Vang,17,2,0,2,1
2022-01-22,Hue City,Phu Vang,18,4,4,0,0
2022-01-22,Hue City,Phu Vang,20,2,2,0,0
2022-01-22,Vung Tau,Ba Ria City,8,1,0,1,1
2022-01-22,Vung Tau,Ba Ria City,9,11,3,8,4
2022-01-22,Vung Tau,Ba Ria City,10,8,2,6,3
2022-01-22,Vung Tau,Ba Ria City,11,10,3,7,6
2022-01-22,Vung Tau,Ba Ria City,12,3,1,2,0
2022-01-22,Vung Tau,Ba Ria City,13,13,1,12,11
2022-01-22,Vung Tau,Ba Ria City,14,14,3,11,10
2022-01-22,Vung Tau,Ba Ria City,15,15,3,12,11
2022-01-22,Vung Tau,Ba Ria City,16,10,1,9,8
2022-01-22,Vung Tau,Ba Ria City,17,6,2,4,4
2022-01-22,Vung Tau,Ba Ria City,18,7,3,4,3
2022-01-22,Vung Tau,Ba Ria City,19,8,0,8,6
2022-01-22,Vung Tau,Ba Ria City,20,7,0,7,7
2022-01-22,Vung Tau,Vung Tau City,0,2,1,1,0
2022-01-22,Vung Tau,Vung Tau City,1,1,1,0,0
2022-01-22,Vung Tau,Vung Tau City,6,30,28,2,0
2022-01-22,Vung Tau,Vung Tau City,7,103,91,12,0
2022-01-22,Vung Tau,Vung Tau City,8,162,149,13,0
2022-01-22,Vung Tau,Vung Tau City,9,167,152,15,1
2022-01-22,Vung Tau,Vung Tau City,10,178,168,10,0
2022-01-22,Vung Tau,Vung Tau City,11,383,354,29,2
2022-01-22,Vung Tau,Vung Tau City,12,276,260,16,0
2022-01-22,Vung Tau,Vung Tau City,13,189,176,13,3
2022-01-22,Vung Tau,Vung Tau City,14,197,179,18,1
2022-01-22,Vung Tau,Vung Tau City,15,203,191,12,2
2022-01-22,Vung Tau,Vung Tau City,16,198,182,16,3
2022-01-22,Vung Tau,Vung Tau City,17,260,237,23,2
2022-01-22,Vung Tau,Vung Tau City,18,324,305,19,2
2022-01-22,Vung Tau,Vung Tau City,19,275,244,31,4
2022-01-22,Vung Tau,Vung Tau City,20,189,170,19,2
2022-01-22,Vung Tau,Vung Tau City,21,95,79,16,4
2022-01-22,Vung Tau,Vung Tau City,22,3,2,1,0
2022-01-23,Binh Duong,Ben Cat,8,2,1,1,1
2022-01-23,Binh Duong,Ben Cat,15,1,0,1,0
2022-01-23,Binh Duong,Ben Cat,18,2,0,2,0
2022-01-23,Binh Duong,Di An,8,14,8,6,5
2022-01-23,Binh Duong,Di An,9,15,9,6,6
2022-01-23,Binh Duong,Di An,10,20,13,7,5
2022-01-23,Binh Duong,Di An,11,26,17,9,6
2022-01-23,Binh Duong,Di An,12,21,11,10,8
2022-01-23,Binh Duong,Di An,13,26,15,11,10
2022-01-23,Binh Duong,Di An,14,12,8,4,4
2022-01-23,Binh Duong,Di An,15,11,6,5,4
2022-01-23,Binh Duong,Di An,16,13,10,3,2
2022-01-23,Binh Duong,Di An,17,17,11,6,3
2022-01-23,Binh Duong,Di An,18,17,8,9,6
2022-01-23,Binh Duong,Di An,19,17,7,10,9
2022-01-23,Binh Duong,Di An,20,10,2,8,8
2022-01-23,Binh Duong,Di An,21,6,0,6,4
2022-01-23,Binh Duong,Tan Uyen,6,2,0,2,2
2022-01-23,Binh Duong,Tan Uyen,10,1,0,1,1
2022-01-23,Binh Duong,Tan Uyen,11,1,0,1,1
2022-01-23,Binh Duong,Tan Uyen,12,1,0,1,1
2022-01-23,Binh Duong,Tan Uyen,13,1,0,1,1
2022-01-23,Binh Duong,Tan Uyen,16,1,0,1,1
2022-01-23,Binh Duong,Tan Uyen,18,2,1,1,1
2022-01-23,Binh Duong,Thu Dau Mot Town,0,1,1,0,0
2022-01-23,Binh Duong,Thu Dau Mot Town,5,1,0,1,1
2022-01-23,Binh Duong,Thu Dau Mot Town,6,31,23,8,5
2022-01-23,Binh Duong,Thu Dau Mot Town,7,116,92,24,20
2022-01-23,Binh Duong,Thu Dau Mot Town,8,239,184,55,34
2022-01-23,Binh Duong,Thu Dau Mot Town,9,301,253,48,31
2022-01-23,Binh Duong,Thu Dau Mot Town,10,408,344,64,37
2022-01-23,Binh Duong,Thu Dau Mot Town,11,636,500,136,97
2022-01-23,Binh Duong,Thu Dau Mot Town,12,644,468,176,134
2022-01-23,Binh Duong,Thu Dau Mot Town,13,410,351,59,36
2022-01-23,Binh Duong,Thu Dau Mot Town,14,354,301,53,32
2022-01-23,Binh Duong,Thu Dau Mot Town,15,277,261,16,8
2022-01-23,Binh Duong,Thu Dau Mot Town,16,295,266,29,14
2022-01-23,Binh Duong,Thu Dau Mot Town,17,341,290,51,25
2022-01-23,Binh Duong,Thu Dau Mot Town,18,390,338,52,37
2022-01-23,Binh Duong,Thu Dau Mot Town,19,394,293,101,51
2022-01-23,Binh Duong,Thu Dau Mot Town,20,252,209,43,15
2022-01-23,Binh Duong,Thu Dau Mot Town,21,112,81,31,9
2022-01-23,Binh Duong,Thu Dau Mot Town,22,2,1,1,0
2022-01-23,Binh Duong,Thuan An,6,1,1,0,0
2022-01-23,Binh Duong,Thuan An,7,2,0,2,2
2022-01-23,Binh Duong,Thuan An,8,18,8,10,10
2022-01-23,Binh Duong,Thuan An,9,24,10,14,14
2022-01-23,Binh Duong,Thuan An,10,62,23,39,31
2022-01-23,Binh Duong,Thuan An,11,85,30,55,44
2022-01-23,Binh Duong,Thuan An,12,92,37,55,48
2022-01-23,Binh Duong,Thuan An,13,44,26,18,15
2022-01-23,Binh Duong,Thuan An,14,63,31,32,25
2022-01-23,Binh Duong,Thuan An,15,45,26,19,16
2022-01-23,Binh Duong,Thuan An,16,42,29,13,10
2022-01-23,Binh Duong,Thuan An,17,46,27,19,18
2022-01-23,Binh Duong,Thuan An,18,36,21,15,11
2022-01-23,Binh Duong,Thuan An,19,43,11,32,27
2022-01-23,Binh Duong,Thuan An,20,45,3,42,39
2022-01-23,Binh Duong,Thuan An,21,10,2,8,7
2022-01-23,Binh Duong,Thuan An,23,1,0,1,1
2022-01-23,Can Tho City,Binh Thuy District,7,2,2,0,0
2022-01-23,Can Tho City,Binh Thuy District,8,2,2,0,0
2022-01-23,Can Tho City,Binh Thuy District,9,6,5,1,0
2022-01-23,Can Tho City,Binh Thuy District,10,11,11,0,0
2022-01-23,Can Tho City,Binh Thuy District,11,6,5,1,0
2022-01-23,Can Tho City,Binh Thuy District,12,11,10,1,0
2022-01-23,Can Tho City,Binh Thuy District,13,9,9,0,0
2022-01-23,Can Tho City,Binh Thuy District,14,16,16,0,0
2022-01-23,Can Tho City,Binh Thuy District,15,10,8,2,0
2022-01-23,Can Tho City,Binh Thuy District,16,6,6,0,0
2022-01-23,Can Tho City,Binh Thuy District,17,13,11,2,0
2022-01-23,Can Tho City,Binh Thuy District,18,10,9,1,0
2022-01-23,Can Tho City,Binh Thuy District,19,16,14,2,0
2022-01-23,Can Tho City,Binh Thuy District,20,12,11,1,0
2022-01-23,Can Tho City,Binh Thuy District,21,3,1,2,0
2022-01-23,Can Tho City,Cai Rang District,8,4,3,1,1
2022-01-23,Can Tho City,Cai Rang District,9,5,5,0,0
2022-01-23,Can Tho City,Cai Rang District,10,9,7,2,0
2022-01-23,Can Tho City,Cai Rang District,11,9,9,0,0
2022-01-23,Can Tho City,Cai Rang District,12,16,13,3,0
2022-01-23,Can Tho City,Cai Rang District,13,12,10,2,0
2022-01-23,Can Tho City,Cai Rang District,14,5,5,0,0
2022-01-23,Can Tho City,Cai Rang District,15,11,11,0,0
2022-01-23,Can Tho City,Cai Rang District,16,11,11,0,0
2022-01-23,Can Tho City,Cai Rang District,17,9,8,1,0
2022-01-23,Can Tho City,Cai Rang District,18,12,11,1,0
2022-01-23,Can Tho City,Cai Rang District,19,9,8,1,0
2022-01-23,Can Tho City,Cai Rang District,20,3,3,0,0
2022-01-23,Can Tho City,Cai Rang District,21,5,3,2,1
2022-01-23,Can Tho City,Ninh Kieu District,0,2,2,0,0
2022-01-23,Can Tho City,Ninh Kieu District,1,1,1,0,0
2022-01-23,Can Tho City,Ninh Kieu District,2,1,1,0,0
2022-01-23,Can Tho City,Ninh Kieu District,4,1,1,0,0
2022-01-23,Can Tho City,Ninh Kieu District,5,1,0,1,0
2022-01-23,Can Tho City,Ninh Kieu District,6,37,34,3,1
2022-01-23,Can Tho City,Ninh Kieu District,7,148,135,13,0
2022-01-23,Can Tho City,Ninh Kieu District,8,249,235,14,0
2022-01-23,Can Tho City,Ninh Kieu District,9,285,275,10,0
2022-01-23,Can Tho City,Ninh Kieu District,10,405,388,17,0
2022-01-23,Can Tho City,Ninh Kieu District,11,576,557,19,0
2022-01-23,Can Tho City,Ninh Kieu District,12,528,505,23,0
2022-01-23,Can Tho City,Ninh Kieu District,13,372,356,16,0
2022-01-23,Can Tho City,Ninh Kieu District,14,306,290,16,0
2022-01-23,Can Tho City,Ninh Kieu District,15,287,276,11,0
2022-01-23,Can Tho City,Ninh Kieu District,16,336,311,25,0
2022-01-23,Can Tho City,Ninh Kieu District,17,373,357,16,0
2022-01-23,Can Tho City,Ninh Kieu District,18,409,388,21,1
2022-01-23,Can Tho City,Ninh Kieu District,19,339,325,14,0
2022-01-23,Can Tho City,Ninh Kieu District,20,240,218,22,0
2022-01-23,Can Tho City,Ninh Kieu District,21,148,136,12,0
2022-01-23,Can Tho City,Ninh Kieu District,22,1,1,0,0
2022-01-23,Can Tho City,Ninh Kieu District,23,2,2,0,0
2022-01-23,Dong Nai,Bien Hoa City,0,5,1,4,1
2022-01-23,Dong Nai,Bien Hoa City,1,1,1,0,0
2022-01-23,Dong Nai,Bien Hoa City,3,2,2,0,0
2022-01-23,Dong Nai,Bien Hoa City,5,1,0,1,0
2022-01-23,Dong Nai,Bien Hoa City,6,34,22,12,5
2022-01-23,Dong Nai,Bien Hoa City,7,154,114,40,20
2022-01-23,Dong Nai,Bien Hoa City,8,332,266,66,36
2022-01-23,Dong Nai,Bien Hoa City,9,444,386,58,13
2022-01-23,Dong Nai,Bien Hoa City,10,830,685,145,84
2022-01-23,Dong Nai,Bien Hoa City,11,1080,944,136,62
2022-01-23,Dong Nai,Bien Hoa City,12,1080,919,161,68
2022-01-23,Dong Nai,Bien Hoa City,13,790,689,101,35
2022-01-23,Dong Nai,Bien Hoa City,14,636,543,93,37
2022-01-23,Dong Nai,Bien Hoa City,15,549,441,108,61
2022-01-23,Dong Nai,Bien Hoa City,16,579,441,138,92
2022-01-23,Dong Nai,Bien Hoa City,17,605,497,108,75
2022-01-23,Dong Nai,Bien Hoa City,18,818,573,245,178
2022-01-23,Dong Nai,Bien Hoa City,19,742,540,202,135
2022-01-23,Dong Nai,Bien Hoa City,20,553,372,181,109
2022-01-23,Dong Nai,Bien Hoa City,21,223,136,87,50
2022-01-23,Dong Nai,Bien Hoa City,22,2,0,2,0
2022-01-23,Dong Nai,Bien Hoa City,23,2,1,1,0
2022-01-23,Dong Nai,Long Thanh,9,1,0,1,1
2022-01-23,Dong Nai,Long Thanh,10,2,0,2,2
2022-01-23,Dong Nai,Long Thanh,12,1,0,1,1
2022-01-23,Dong Nai,Long Thanh,15,3,0,3,2
2022-01-23,Dong Nai,Long Thanh,18,2,0,2,2
2022-01-23,Dong Nai,Long Thanh,20,4,0,4,4
2022-01-23,Dong Nai,Thong Nhat,8,2,2,0,0
2022-01-23,Dong Nai,Thong Nhat,10,1,1,0,0
2022-01-23,Dong Nai,Thong Nhat,11,2,2,0,0
2022-01-23,Dong Nai,Thong Nhat,12,3,3,0,0
2022-01-23,Dong Nai,Thong Nhat,13,2,2,0,0
2022-01-23,Dong Nai,Thong Nhat,15,2,2,0,0
2022-01-23,Dong Nai,Thong Nhat,18,3,1,2,2
2022-01-23,Dong Nai,Thong Nhat,20,2,2,0,0
2022-01-23,Dong Nai,Trang Bom,10,2,0,2,2
2022-01-23,Dong Nai,Trang Bom,13,1,0,1,1
2022-01-23,Dong Nai,Trang Bom,14,2,0,2,2
2022-01-23,Dong Nai,Trang Bom,17,2,0,2,2
2022-01-23,Dong Nai,Trang Bom,18,1,0,1,1
2022-01-23,Hai Phong City,An Duong,7,1,1,0,0
2022-01-23,Hai Phong City,An Duong,8,2,2,0,0
2022-01-23,Hai Phong City,An Duong,9,6,2,4,4
2022-01-23,Hai Phong City,An Duong,10,4,1,3,3
2022-01-23,Hai Phong City,An Duong,11,2,1,1,1
2022-01-23,Hai Phong City,An Duong,12,2,2,0,0
2022-01-23,Hai Phong City,An Duong,13,1,0,1,0
2022-01-23,Hai Phong City,An Duong,14,3,1,2,2
2022-01-23,Hai Phong City,An Duong,15,5,3,2,2
2022-01-23,Hai Phong City,An Duong,16,3,0,3,2
2022-01-23,Hai Phong City,An Duong,17,4,2,2,1
2022-01-23,Hai Phong City,An Duong,18,4,2,2,1
2022-01-23,Hai Phong City,An Duong,20,1,0,1,1
2022-01-23,Hai Phong City,An Duong,21,1,0,1,1
2022-01-23,Hai Phong City,Duong Kinh District,15,3,0,3,2
2022-01-23,Hai Phong City,Hai An District,7,6,5,1,0
2022-01-23,Hai Phong City,Hai An District,8,18,12,6,0
2022-01-23,Hai Phong City,Hai An District,9,18,16,2,0
2022-01-23,Hai Phong City,Hai An District,10,20,20,0,0
2022-01-23,Hai Phong City,Hai An District,11,43,34,9,4
2022-01-23,Hai Phong City,Hai An District,12,28,26,2,0
2022-01-23,Hai Phong City,Hai An District,13,15,13,2,0
2022-01-23,Hai Phong City,Hai An District,14,16,13,3,1
2022-01-23,Hai Phong City,Hai An District,15,23,18,5,1
2022-01-23,Hai Phong City,Hai An District,16,17,16,1,0
2022-01-23,Hai Phong City,Hai An District,17,19,16,3,0
2022-01-23,Hai Phong City,Hai An District,18,10,8,2,0
2022-01-23,Hai Phong City,Hai An District,19,19,17,2,0
2022-01-23,Hai Phong City,Hai An District,20,21,18,3,0
2022-01-23,Hai Phong City,Hai An District,21,13,9,4,3
2022-01-23,Hai Phong City,Hong Bang District,0,1,1,0,0
2022-01-23,Hai Phong City,Hong Bang District,6,1,0,1,1
2022-01-23,Hai Phong City,Hong Bang District,7,19,10,9,7
2022-01-23,Hai Phong City,Hong Bang District,8,38,29,9,5
2022-01-23,Hai Phong City,Hong Bang District,9,30,26,4,1
2022-01-23,Hai Phong City,Hong Bang District,10,80,68,12,3
2022-01-23,Hai Phong City,Hong Bang District,11,116,97,19,10
2022-01-23,Hai Phong City,Hong Bang District,12,94,83,11,2
2022-01-23,Hai Phong City,Hong Bang District,13,51,47,4,2
2022-01-23,Hai Phong City,Hong Bang District,14,43,40,3,0
2022-01-23,Hai Phong City,Hong Bang District,15,43,37,6,1
2022-01-23,Hai Phong City,Hong Bang District,16,33,30,3,0
2022-01-23,Hai Phong City,Hong Bang District,17,52,48,4,1
2022-01-23,Hai Phong City,Hong Bang District,18,69,56,13,5
2022-01-23,Hai Phong City,Hong Bang District,19,57,50,7,4
2022-01-23,Hai Phong City,Hong Bang District,20,63,42,21,16
2022-01-23,Hai Phong City,Hong Bang District,21,24,13,11,10
2022-01-23,Hai Phong City,Hong Bang District,22,1,0,1,0
2022-01-23,Hai Phong City,Kien An District,7,1,0,1,1
2022-01-23,Hai Phong City,Kien An District,8,3,0,3,3
2022-01-23,Hai Phong City,Kien An District,9,2,1,1,1
2022-01-23,Hai Phong City,Kien An District,10,13,7,6,2
2022-01-23,Hai Phong City,Kien An District,11,14,9,5,1
2022-01-23,Hai Phong City,Kien An District,12,13,5,8,5
2022-01-23,Hai Phong City,Kien An District,13,12,9,3,1
2022-01-23,Hai Phong City,Kien An District,14,10,5,5,4
2022-01-23,Hai Phong City,Kien An District,15,13,4,9,8
2022-01-23,Hai Phong City,Kien An District,16,26,7,19,17
2022-01-23,Hai Phong City,Kien An District,17,14,7,7,5
2022-01-23,Hai Phong City,Kien An District,18,13,9,4,2
2022-01-23,Hai Phong City,Kien An District,19,17,13,4,4
2022-01-23,Hai Phong City,Kien An District,20,9,5,4,3
2022-01-23,Hai Phong City,Kien An District,21,1,1,0,0
2022-01-23,Hai Phong City,Le Chan District,0,3,1,2,0
2022-01-23,Hai Phong City,Le Chan District,1,1,1,0,0
2022-01-23,Hai Phong City,Le Chan District,2,2,0,2,0
2022-01-23,Hai Phong City,Le Chan District,4,2,2,0,0
2022-01-23,Hai Phong City,Le Chan District,5,1,1,0,0
2022-01-23,Hai Phong City,Le Chan District,6,1,0,1,0
2022-01-23,Hai Phong City,Le Chan District,7,64,36,28,20
2022-01-23,Hai Phong City,Le Chan District,8,100,80,20,8
2022-01-23,Hai Phong City,Le Chan District,9,100,87,13,2
2022-01-23,Hai Phong City,Le Chan District,10,195,175,20,4
2022-01-23,Hai Phong City,Le Chan District,11,355,304,51,14
2022-01-23,Hai Phong City,Le Chan District,12,259,220,39,7
2022-01-23,Hai Phong City,Le Chan District,13,168,146,22,2
2022-01-23,Hai Phong City,Le Chan District,14,139,125,14,0
2022-01-23,Hai Phong City,Le Chan District,15,180,164,16,2
2022-01-23,Hai Phong City,Le Chan District,16,148,127,21,4
2022-01-23,Hai Phong City,Le Chan District,17,218,189,29,3
2022-01-23,Hai Phong City,Le Chan District,18,278,230,48,29
2022-01-23,Hai Phong City,Le Chan District,19,198,166,32,13
2022-01-23,Hai Phong City,Le Chan District,20,144,111,33,10
2022-01-23,Hai Phong City,Le Chan District,21,91,57,34,20
2022-01-23,Hai Phong City,Le Chan District,22,1,1,0,0
2022-01-23,Hai Phong City,Le Chan District,23,1,0,1,0
2022-01-23,Hai Phong City,Ngo Quyen District,1,1,1,0,0
2022-01-23,Hai Phong City,Ngo Quyen District,3,1,0,1,0
2022-01-23,Hai Phong City,Ngo Quyen District,7,30,20,10,8
2022-01-23,Hai Phong City,Ngo Quyen District,8,76,61,15,9
2022-01-23,Hai Phong City,Ngo Quyen District,9,100,90,10,1
2022-01-23,Hai Phong City,Ngo Quyen District,10,122,108,14,0
2022-01-23,Hai Phong City,Ngo Quyen District,11,244,214,30,11
2022-01-23,Hai Phong City,Ngo Quyen District,12,189,160,29,8
2022-01-23,Hai Phong City,Ngo Quyen District,13,125,110,15,1
2022-01-23,Hai Phong City,Ngo Quyen District,14,132,125,7,0
2022-01-23,Hai Phong City,Ngo Quyen District,15,150,137,13,2
2022-01-23,Hai Phong City,Ngo Quyen District,16,144,128,16,1
2022-01-23,Hai Phong City,Ngo Quyen District,17,178,157,21,4
2022-01-23,Hai Phong City,Ngo Quyen District,18,212,180,32,22
2022-01-23,Hai Phong City,Ngo Quyen District,19,185,159,26,8
2022-01-23,Hai Phong City,Ngo Quyen District,20,132,116,16,6
2022-01-23,Hai Phong City,Ngo Quyen District,21,83,53,30,19
2022-01-23,Hai Phong City,Ngo Quyen District,22,1,1,0,0
2022-01-23,Hai Phong City,Thuy Nguyen,11,2,0,2,1
2022-01-23,Hai Phong City,Thuy Nguyen,13,2,0,2,2
2022-01-23,Hai Phong City,Thuy Nguyen,14,2,0,2,2
2022-01-23,Hai Phong City,Thuy Nguyen,15,1,0,1,1
2022-01-23,Hai Phong City,Thuy Nguyen,16,2,0,2,1
2022-01-23,Hai Phong City,Thuy Nguyen,18,1,0,1,1
2022-01-23,Hai Phong City,Thuy Nguyen,19,1,0,1,1
2022-01-23,Hue City,Hue City,1,1,1,0,0
2022-01-23,Hue City,Hue City,6,55,46,9,1
2022-01-23,Hue City,Hue City,7,263,240,23,2
2022-01-23,Hue City,Hue City,8,344,328,16,0
2022-01-23,Hue City,Hue City,9,277,256,21,1
2022-01-23,Hue City,Hue City,10,363,346,17,0
2022-01-23,Hue City,Hue City,11,687,652,35,1
2022-01-23,Hue City,Hue City,12,537,511,26,0
2022-01-23,Hue City,Hue City,13,325,311,14,0
2022-01-23,Hue City,Hue City,14,290,264,26,3
2022-01-23,Hue City,Hue City,15,359,342,17,2
2022-01-23,Hue City,Hue City,16,417,389,28,1
2022-01-23,Hue City,Hue City,17,508,479,29,1
2022-01-23,Hue City,Hue City,18,557,516,41,5
2022-01-23,Hue City,Hue City,19,464,425,39,1
2022-01-23,Hue City,Hue City,20,335,301,34,2
2022-01-23,Hue City,Hue City,21,196,163,33,2
2022-01-23,Hue City,Hue City,22,1,0,1,0
2022-01-23,Hue City,Huong Thuy,7,1,0,1,1
2022-01-23,Hue City,Huong Thuy,8,1,0,1,0
2022-01-23,Hue City,Huong Thuy,9,1,1,0,0
2022-01-23,Hue City,Huong Thuy,12,3,0,3,1
2022-01-23,Hue City,Huong Thuy,13,1,0,1,1
2022-01-23,Hue City,Huong Thuy,16,1,1,0,0
2022-01-23,Hue City,Huong Thuy,17,1,1,0,0
2022-01-23,Hue City,Huong Thuy,18,1,1,0,0
2022-01-23,Hue City,Huong Thuy,19,2,2,0,0
2022-01-23,Hue City,Huong Thuy,21,2,1,1,0
2022-01-23,Hue City,Huong Tra,7,2,2,0,0
2022-01-23,Hue City,Huong Tra,14,1,1,0,0
2022-01-23,Hue City,Huong Tra,18,2,0,2,0
2022-01-23,Hue City,Phu Vang,16,3,2,1,0
2022-01-23,Hue City,Phu Vang,17,2,2,0,0
2022-01-23,Hue City,Phu Vang,18,3,3,0,0
2022-01-23,Hue City,Phu Vang,20,3,3,0,0
2022-01-23,Hue City,Phu Vang,21,2,2,0,0
2022-01-23,Vung Tau,Ba Ria City,7,1,0,1,1
2022-01-23,Vung Tau,Ba Ria City,8,9,0,9,8
2022-01-23,Vung Tau,Ba Ria City,9,18,1,17,15
2022-01-23,Vung Tau,Ba Ria City,10,20,3,17,15
2022-01-23,Vung Tau,Ba Ria City,11,8,1,7,7
2022-01-23,Vung Tau,Ba Ria City,12,10,2,8,7
2022-01-23,Vung Tau,Ba Ria City,13,3,0,3,3
2022-01-23,Vung Tau,Ba Ria City,14,7,3,4,3
2022-01-23,Vung Tau,Ba Ria City,15,12,3,9,8
2022-01-23,Vung Tau,Ba Ria City,16,11,2,9,8
2022-01-23,Vung Tau,Ba Ria City,17,9,3,6,6
2022-01-23,Vung Tau,Ba Ria City,18,9,2,7,6
2022-01-23,Vung Tau,Ba Ria City,19,3,0,3,2
2022-01-23,Vung Tau,Ba Ria City,20,10,0,10,10
2022-01-23,Vung Tau,Ba Ria City,21,1,0,1,1
2022-01-23,Vung Tau,Ba Ria City,22,1,0,1,0
2022-01-23,Vung Tau,Tan Thanh,17,1,0,1,1
2022-01-23,Vung Tau,Tan Thanh,20,1,0,1,1
2022-01-23,Vung Tau,Vung Tau City,4,1,0,1,0
2022-01-23,Vung Tau,Vung Tau City,6,37,33,4,1
2022-01-23,Vung Tau,Vung Tau City,7,120,110,10,0
2022-01-23,Vung Tau,Vung Tau City,8,194,181,13,0
2022-01-23,Vung Tau,Vung Tau City,9,189,173,16,2
2022-01-23,Vung Tau,Vung Tau City,10,210,197,13,0
2022-01-23,Vung Tau,Vung Tau City,11,363,340,23,0
2022-01-23,Vung Tau,Vung Tau City,12,322,301,21,6
2022-01-23,Vung Tau,Vung Tau City,13,206,199,7,0
2022-01-23,Vung Tau,Vung Tau City,14,190,175,15,0
2022-01-23,Vung Tau,Vung Tau City,15,188,174,14,0
2022-01-23,Vung Tau,Vung Tau City,16,182,173,9,0
2022-01-23,Vung Tau,Vung Tau City,17,264,244,20,1
2022-01-23,Vung Tau,Vung Tau City,18,355,312,43,8
2022-01-23,Vung Tau,Vung Tau City,19,267,238,29,1
2022-01-23,Vung Tau,Vung Tau City,20,188,164,24,1
2022-01-23,Vung Tau,Vung Tau City,21,93,72,21,5
2022-01-23,Vung Tau,Vung Tau City,22,2,0,2,0
2022-01-23,Vung Tau,Vung Tau City,23,5,2,3,0
2022-01-24,Binh Duong,Ben Cat,10,1,1,0,0
2022-01-24,Binh Duong,Ben Cat,11,2,2,0,0
2022-01-24,Binh Duong,Ben Cat,12,3,0,3,2
2022-01-24,Binh Duong,Di An,5,2,0,2,2
2022-01-24,Binh Duong,Di An,6,3,0,3,2
2022-01-24,Binh Duong,Di An,7,4,3,1,1
2022-01-24,Binh Duong,Di An,8,7,4,3,3
2022-01-24,Binh Duong,Di An,9,20,9,11,5
2022-01-24,Binh Duong,Di An,10,12,8,4,2
2022-01-24,Binh Duong,Di An,11,33,11,22,17
2022-01-24,Binh Duong,Di An,12,35,12,23,18
2022-01-24,Binh Duong,Di An,13,20,14,6,5
2022-01-24,Binh Duong,Di An,14,16,13,3,2
2022-01-24,Binh Duong,Di An,15,18,9,9,7
2022-01-24,Binh Duong,Di An,16,12,5,7,4
2022-01-24,Binh Duong,Di An,17,21,8,13,11
2022-01-24,Binh Duong,Di An,18,12,4,8,8
2022-01-24,Binh Duong,Di An,19,19,6,13,11
2022-01-24,Binh Duong,Di An,20,16,1,15,13
2022-01-24,Binh Duong,Di An,21,5,0,5,5
2022-01-24,Binh Duong,Di An,22,1,1,0,0
2022-01-24,Binh Duong,Di An,23,1,0,1,1
2022-01-24,Binh Duong,Tan Uyen,6,1,0,1,1
2022-01-24,Binh Duong,Tan Uyen,9,2,1,1,1
2022-01-24,Binh Duong,Tan Uyen,10,3,2,1,1
2022-01-24,Binh Duong,Tan Uyen,11,1,0,1,1
2022-01-24,Binh Duong,Tan Uyen,12,2,1,1,1
2022-01-24,Binh Duong,Tan Uyen,15,1,0,1,1
2022-01-24,Binh Duong,Tan Uyen,16,1,1,0,0
2022-01-24,Binh Duong,Tan Uyen,17,1,1,0,0
2022-01-24,Binh Duong,Tan Uyen,19,1,0,1,1
2022-01-24,Binh Duong,Thu Dau Mot Town,0,1,0,1,0
2022-01-24,Binh Duong,Thu Dau Mot Town,2,1,1,0,0
2022-01-24,Binh Duong,Thu Dau Mot Town,5,1,0,1,0
2022-01-24,Binh Duong,Thu Dau Mot Town,6,37,19,18,18
2022-01-24,Binh Duong,Thu Dau Mot Town,7,120,105,15,4
2022-01-24,Binh Duong,Thu Dau Mot Town,8,181,165,16,8
2022-01-24,Binh Duong,Thu Dau Mot Town,9,238,217,21,4
2022-01-24,Binh Duong,Thu Dau Mot Town,10,349,319,30,10
2022-01-24,Binh Duong,Thu Dau Mot Town,11,643,547,96,55
2022-01-24,Binh Duong,Thu Dau Mot Town,12,462,430,32,20
2022-01-24,Binh Duong,Thu Dau Mot Town,13,390,363,27,10
2022-01-24,Binh Duong,Thu Dau Mot Town,14,318,294,24,5
2022-01-24,Binh Duong,Thu Dau Mot Town,15,262,233,29,6
2022-01-24,Binh Duong,Thu Dau Mot Town,16,256,231,25,10
2022-01-24,Binh Duong,Thu Dau Mot Town,17,338,307,31,10
2022-01-24,Binh Duong,Thu Dau Mot Town,18,361,322,39,13
2022-01-24,Binh Duong,Thu Dau Mot Town,19,286,270,16,4
2022-01-24,Binh Duong,Thu Dau Mot Town,20,250,220,30,6
2022-01-24,Binh Duong,Thu Dau Mot Town,21,106,80,26,8
2022-01-24,Binh Duong,Thu Dau Mot Town,22,2,1,1,0
2022-01-24,Binh Duong,Thu Dau Mot Town,23,1,1,0,0
2022-01-24,Binh Duong,Thuan An,0,1,0,1,0
2022-01-24,Binh Duong,Thuan An,7,5,2,3,3
2022-01-24,Binh Duong,Thuan An,8,16,9,7,5
2022-01-24,Binh Duong,Thuan An,9,38,6,32,31
2022-01-24,Binh Duong,Thuan An,10,77,28,49,45
2022-01-24,Binh Duong,Thuan An,11,58,45,13,9
2022-01-24,Binh Duong,Thuan An,12,69,33,36,33
2022-01-24,Binh Duong,Thuan An,13,68,33,35,25
2022-01-24,Binh Duong,Thuan An,14,56,29,27,25
2022-01-24,Binh Duong,Thuan An,15,46,22,24,19
2022-01-24,Binh Duong,Thuan An,16,34,23,11,7
2022-01-24,Binh Duong,Thuan An,17,26,17,9,6
2022-01-24,Binh Duong,Thuan An,18,31,22,9,6
2022-01-24,Binh Duong,Thuan An,19,37,18,19,16
2022-01-24,Binh Duong,Thuan An,20,21,5,16,14
2022-01-24,Binh Duong,Thuan An,21,15,3,12,11
2022-01-24,Binh Duong,Thuan An,23,1,0,1,0
2022-01-24,Can Tho City,Binh Thuy District,7,3,3,0,0
2022-01-24,Can Tho City,Binh Thuy District,8,4,3,1,0
2022-01-24,Can Tho City,Binh Thuy District,9,3,3,0,0
2022-01-24,Can Tho City,Binh Thuy District,10,10,10,0,0
2022-01-24,Can Tho City,Binh Thuy District,11,9,9,0,0
2022-01-24,Can Tho City,Binh Thuy District,12,8,8,0,0
2022-01-24,Can Tho City,Binh Thuy District,13,15,15,0,0
2022-01-24,Can Tho City,Binh Thuy District,14,11,10,1,0
2022-01-24,Can Tho City,Binh Thuy District,15,13,9,4,1
2022-01-24,Can Tho City,Binh Thuy District,16,8,8,0,0
2022-01-24,Can Tho City,Binh Thuy District,17,10,8,2,0
2022-01-24,Can Tho City,Binh Thuy District,18,12,10,2,0
2022-01-24,Can Tho City,Binh Thuy District,19,14,13,1,0
2022-01-24,Can Tho City,Binh Thuy District,20,5,5,0,0
2022-01-24,Can Tho City,Binh Thuy District,21,1,1,0,0
2022-01-24,Can Tho City,Cai Rang District,6,1,1,0,0
2022-01-24,Can Tho City,Cai Rang District,7,3,3,0,0
2022-01-24,Can Tho City,Cai Rang District,8,5,4,1,0
2022-01-24,Can Tho City,Cai Rang District,9,6,5,1,0
2022-01-24,Can Tho City,Cai Rang District,10,5,4,1,1
2022-01-24,Can Tho City,Cai Rang District,11,10,9,1,0
2022-01-24,Can Tho City,Cai Rang District,12,9,9,0,0
2022-01-24,Can Tho City,Cai Rang District,13,9,8,1,0
2022-01-24,Can Tho City,Cai Rang District,14,8,6,2,2
2022-01-24,Can Tho City,Cai Rang District,15,3,3,0,0
2022-01-24,Can Tho City,Cai Rang District,16,11,10,1,1
2022-01-24,Can Tho City,Cai Rang District,17,7,7,0,0
2022-01-24,Can Tho City,Cai Rang District,18,7,5,2,0
2022-01-24,Can Tho City,Cai Rang District,19,7,7,0,0
2022-01-24,Can Tho City,Cai Rang District,20,7,6,1,0
2022-01-24,Can Tho City,Cai Rang District,21,4,4,0,0
2022-01-24,Can Tho City,Ninh Kieu District,0,2,2,0,0
2022-01-24,Can Tho City,Ninh Kieu District,1,1,1,0,0
2022-01-24,Can Tho City,Ninh Kieu District,2,2,2,0,0
2022-01-24,Can Tho City,Ninh Kieu District,5,2,1,1,0
2022-01-24,Can Tho City,Ninh Kieu District,6,44,37,7,0
2022-01-24,Can Tho City,Ninh Kieu District,7,115,110,5,0
2022-01-24,Can Tho City,Ninh Kieu District,8,205,196,9,0
2022-01-24,Can Tho City,Ninh Kieu District,9,272,248,24,0
2022-01-24,Can Tho City,Ninh Kieu District,10,408,385,23,0
2022-01-24,Can Tho City,Ninh Kieu District,11,713,688,25,0
2022-01-24,Can Tho City,Ninh Kieu District,12,500,483,17,0
2022-01-24,Can Tho City,Ninh Kieu District,13,378,363,15,0
2022-01-24,Can Tho City,Ninh Kieu District,14,330,310,20,0
2022-01-24,Can Tho City,Ninh Kieu District,15,283,267,16,0
2022-01-24,Can Tho City,Ninh Kieu District,16,288,283,5,0
2022-01-24,Can Tho City,Ninh Kieu District,17,305,289,16,0
2022-01-24,Can Tho City,Ninh Kieu District,18,370,349,21,0
2022-01-24,Can Tho City,Ninh Kieu District,19,348,326,22,0
2022-01-24,Can Tho City,Ninh Kieu District,20,262,246,16,0
2022-01-24,Can Tho City,Ninh Kieu District,21,130,118,12,1
2022-01-24,Can Tho City,Ninh Kieu District,22,3,2,1,0
2022-01-24,Can Tho City,Ninh Kieu District,23,4,4,0,0
2022-01-24,Dong Nai,Bien Hoa City,0,5,4,1,0
2022-01-24,Dong Nai,Bien Hoa City,1,1,1,0,0
2022-01-24,Dong Nai,Bien Hoa City,2,1,1,0,0
2022-01-24,Dong Nai,Bien Hoa City,3,5,4,1,0
2022-01-24,Dong Nai,Bien Hoa City,4,2,1,1,0
2022-01-24,Dong Nai,Bien Hoa City,5,2,2,0,0
2022-01-24,Dong Nai,Bien Hoa City,6,36,30,6,3
2022-01-24,Dong Nai,Bien Hoa City,7,156,126,30,7
2022-01-24,Dong Nai,Bien Hoa City,8,294,270,24,3
2022-01-24,Dong Nai,Bien Hoa City,9,395,363,32,6
2022-01-24,Dong Nai,Bien Hoa City,10,699,634,65,21
2022-01-24,Dong Nai,Bien Hoa City,11,1066,949,117,51
2022-01-24,Dong Nai,Bien Hoa City,12,910,827,83,22
2022-01-24,Dong Nai,Bien Hoa City,13,871,774,97,45
2022-01-24,Dong Nai,Bien Hoa City,14,639,574,65,20
2022-01-24,Dong Nai,Bien Hoa City,15,537,479,58,18
2022-01-24,Dong Nai,Bien Hoa City,16,461,425,36,11
2022-01-24,Dong Nai,Bien Hoa City,17,533,470,63,21
2022-01-24,Dong Nai,Bien Hoa City,18,676,588,88,42
2022-01-24,Dong Nai,Bien Hoa City,19,634,513,121,75
2022-01-24,Dong Nai,Bien Hoa City,20,465,362,103,56
2022-01-24,Dong Nai,Bien Hoa City,21,276,144,132,75
2022-01-24,Dong Nai,Bien Hoa City,22,5,2,3,1
2022-01-24,Dong Nai,Bien Hoa City,23,1,1,0,0
2022-01-24,Dong Nai,Cam My,10,1,0,1,1
2022-01-24,Dong Nai,Long Thanh,11,1,0,1,1
2022-01-24,Dong Nai,Long Thanh,14,1,0,1,1
2022-01-24,Dong Nai,Long Thanh,15,1,0,1,1
2022-01-24,Dong Nai,Long Thanh,19,1,0,1,1
2022-01-24,Dong Nai,Long Thanh,20,2,0,2,2
2022-01-24,Dong Nai,Thong Nhat,9,2,2,0,0
2022-01-24,Dong Nai,Thong Nhat,10,2,2,0,0
2022-01-24,Dong Nai,Thong Nhat,11,3,2,1,0
2022-01-24,Dong Nai,Thong Nhat,12,2,2,0,0
2022-01-24,Dong Nai,Thong Nhat,13,2,2,0,0
2022-01-24,Dong Nai,Thong Nhat,14,2,2,0,0
2022-01-24,Dong Nai,Thong Nhat,16,1,1,0,0
2022-01-24,Dong Nai,Thong Nhat,18,1,1,0,0
2022-01-24,Dong Nai,Thong Nhat,19,1,1,0,0
2022-01-24,Dong Nai,Thong Nhat,20,1,0,1,1
2022-01-24,Dong Nai,Thong Nhat,21,1,1,0,0
2022-01-24,Dong Nai,Trang Bom,7,1,0,1,1
2022-01-24,Dong Nai,Trang Bom,9,1,0,1,1
2022-01-24,Dong Nai,Trang Bom,10,1,0,1,1
2022-01-24,Dong Nai,Trang Bom,12,1,0,1,1
2022-01-24,Dong Nai,Trang Bom,15,1,1,0,0
2022-01-24,Dong Nai,Trang Bom,16,1,0,1,1
2022-01-24,Dong Nai,Trang Bom,17,1,0,1,1
2022-01-24,Dong Nai,Vinh Cuu,13,1,1,0,0
2022-01-24,Hai Phong City,An Duong,7,2,1,1,1
2022-01-24,Hai Phong City,An Duong,8,3,2,1,1
2022-01-24,Hai Phong City,An Duong,9,2,1,1,1
2022-01-24,Hai Phong City,An Duong,10,2,1,1,1
2022-01-24,Hai Phong City,An Duong,11,5,3,2,0
2022-01-24,Hai Phong City,An Duong,12,1,0,1,1
2022-01-24,Hai Phong City,An Duong,14,3,1,2,2
2022-01-24,Hai Phong City,An Duong,15,1,1,0,0
2022-01-24,Hai Phong City,An Duong,16,1,1,0,0
2022-01-24,Hai Phong City,An Duong,17,2,1,1,0
2022-01-24,Hai Phong City,An Duong,19,1,0,1,0
2022-01-24,Hai Phong City,An Duong,21,1,1,0,0
2022-01-24,Hai Phong City,An Lao,11,1,0,1,1
2022-01-24,Hai Phong City,Duong Kinh District,20,1,0,1,1
2022-01-24,Hai Phong City,Hai An District,7,5,4,1,1
2022-01-24,Hai Phong City,Hai An District,8,11,8,3,1
2022-01-24,Hai Phong City,Hai An District,9,9,7,2,0
2022-01-24,Hai Phong City,Hai An District,10,15,13,2,0
2022-01-24,Hai Phong City,Hai An District,11,49,43,6,5
2022-01-24,Hai Phong City,Hai An District,12,39,29,10,1
2022-01-24,Hai Phong City,Hai An District,13,15,13,2,1
2022-01-24,Hai Phong City,Hai An District,14,19,15,4,0
2022-01-24,Hai Phong City,Hai An District,15,17,16,1,0
2022-01-24,Hai Phong City,Hai An District,16,6,4,2,1
2022-01-24,Hai Phong City,Hai An District,17,12,11,1,0
2022-01-24,Hai Phong City,Hai An District,18,17,15,2,0
2022-01-24,Hai Phong City,Hai An District,19,20,17,3,1
2022-01-24,Hai Phong City,Hai An District,20,8,5,3,0
2022-01-24,Hai Phong City,Hai An District,21,15,7,8,7
2022-01-24,Hai Phong City,Hong Bang District,2,1,0,1,1
2022-01-24,Hai Phong City,Hong Bang District,6,1,1,0,0
2022-01-24,Hai Phong City,Hong Bang District,7,21,14,7,4
2022-01-24,Hai Phong City,Hong Bang District,8,38,34,4,0
2022-01-24,Hai Phong City,Hong Bang District,9,26,20,6,4
2022-01-24,Hai Phong City,Hong Bang District,10,52,47,5,1
2022-01-24,Hai Phong City,Hong Bang District,11,144,120,24,16
2022-01-24,Hai Phong City,Hong Bang District,12,82,68,14,4
2022-01-24,Hai Phong City,Hong Bang District,13,57,55,2,0
2022-01-24,Hai Phong City,Hong Bang District,14,51,46,5,2
2022-01-24,Hai Phong City,Hong Bang District,15,58,52,6,1
2022-01-24,Hai Phong City,Hong Bang District,16,32,30,2,0
2022-01-24,Hai Phong City,Hong Bang District,17,40,39,1,0
2022-01-24,Hai Phong City,Hong Bang District,18,58,53,5,1
2022-01-24,Hai Phong City,Hong Bang District,19,61,52,9,3
2022-01-24,Hai Phong City,Hong Bang District,20,33,31,2,0
2022-01-24,Hai Phong City,Hong Bang District,21,21,18,3,0
2022-01-24,Hai Phong City,Kien An District,0,1,1,0,0
2022-01-24,Hai Phong City,Kien An District,1,1,0,1,1
2022-01-24,Hai Phong City,Kien An District,8,2,0,2,1
2022-01-24,Hai Phong City,Kien An District,9,3,0,3,3
2022-01-24,Hai Phong City,Kien An District,10,1,1,0,0
2022-01-24,Hai Phong City,Kien An District,11,16,7,9,7
2022-01-24,Hai Phong City,Kien An District,12,7,2,5,5
2022-01-24,Hai Phong City,Kien An District,13,15,3,12,9
2022-01-24,Hai Phong City,Kien An District,14,11,7,4,4
2022-01-24,Hai Phong City,Kien An District,15,8,4,4,2
2022-01-24,Hai Phong City,Kien An District,16,8,4,4,1
2022-01-24,Hai Phong City,Kien An District,17,5,5,0,0
2022-01-24,Hai Phong City,Kien An District,18,12,7,5,2
2022-01-24,Hai Phong City,Kien An District,19,13,7,6,4
2022-01-24,Hai Phong City,Kien An District,20,12,4,8,3
2022-01-24,Hai Phong City,Kien An District,21,7,3,4,3
2022-01-24,Hai Phong City,Le Chan District,0,1,1,0,0
2022-01-24,Hai Phong City,Le Chan District,2,1,0,1,1
2022-01-24,Hai Phong City,Le Chan District,6,5,3,2,1
2022-01-24,Hai Phong City,Le Chan District,7,34,31,3,2
2022-01-24,Hai Phong City,Le Chan District,8,91,82,9,3
2022-01-24,Hai Phong City,Le Chan District,9,88,75,13,0
2022-01-24,Hai Phong City,Le Chan District,10,149,139,10,0
2022-01-24,Hai Phong City,Le Chan District,11,309,261,48,24
2022-01-24,Hai Phong City,Le Chan District,12,254,224,30,7
2022-01-24,Hai Phong City,Le Chan District,13,137,122,15,0
2022-01-24,Hai Phong City,Le Chan District,14,129,116,13,1
2022-01-24,Hai Phong City,Le Chan District,15,152,139,13,2
2022-01-24,Hai Phong City,Le Chan District,16,151,135,16,1
2022-01-24,Hai Phong City,Le Chan District,17,173,154,19,4
2022-01-24,Hai Phong City,Le Chan District,18,212,191,21,3
2022-01-24,Hai Phong City,Le Chan District,19,185,150,35,13
2022-01-24,Hai Phong City,Le Chan District,20,133,115,18,0
2022-01-24,Hai Phong City,Le Chan District,21,68,48,20,5
2022-01-24,Hai Phong City,Le Chan District,22,1,1,0,0
2022-01-24,Hai Phong City,Ngo Quyen District,1,1,1,0,0
2022-01-24,Hai Phong City,Ngo Quyen District,2,1,1,0,0
2022-01-24,Hai Phong City,Ngo Quyen District,6,1,1,0,0
2022-01-24,Hai Phong City,Ngo Quyen District,7,22,17,5,0
2022-01-24,Hai Phong City,Ngo Quyen District,8,72,61,11,1
2022-01-24,Hai Phong City,Ngo Quyen District,9,82,77,5,1
2022-01-24,Hai Phong City,Ngo Quyen District,10,103,96,7,0
2022-01-24,Hai Phong City,Ngo Quyen District,11,258,216,42,25
2022-01-24,Hai Phong City,Ngo Quyen District,12,192,166,26,8
2022-01-24,Hai Phong City,Ngo Quyen District,13,144,126,18,0
2022-01-24,Hai Phong City,Ngo Quyen District,14,143,130,13,2
2022-01-24,Hai Phong City,Ngo Quyen District,15,173,152,21,2
2022-01-24,Hai Phong City,Ngo Quyen District,16,144,137,7,0
2022-01-24,Hai Phong City,Ngo Quyen District,17,121,113,8,1
2022-01-24,Hai Phong City,Ngo Quyen District,18,160,144,16,0
2022-01-24,Hai Phong City,Ngo Quyen District,19,177,158,19,1
2022-01-24,Hai Phong City,Ngo Quyen District,20,124,104,20,4
2022-01-24,Hai Phong City,Ngo Quyen District,21,65,55,10,5
2022-01-24,Hai Phong City,Ngo Quyen District,22,2,0,2,0
2022-01-24,Hai Phong City,Ngo Quyen District,23,1,1,0,0
2022-01-24,Hai Phong City,Thuy Nguyen,11,1,0,1,1
2022-01-24,Hai Phong City,Thuy Nguyen,12,3,0,3,3
2022-01-24,Hai Phong City,Thuy Nguyen,14,3,0,3,1
2022-01-24,Hai Phong City,Thuy Nguyen,15,1,0,1,1
2022-01-24,Hai Phong City,Thuy Nguyen,16,1,0,1,1
2022-01-24,Hue City,Hue City,1,3,3,0,0
2022-01-24,Hue City,Hue City,2,1,0,1,0
2022-01-24,Hue City,Hue City,6,54,46,8,1
2022-01-24,Hue City,Hue City,7,217,201,16,0
2022-01-24,Hue City,Hue City,8,347,329,18,1
2022-01-24,Hue City,Hue City,9,274,258,16,2
2022-01-24,Hue City,Hue City,10,325,308,17,0
2022-01-24,Hue City,Hue City,11,766,735,31,0
2022-01-24,Hue City,Hue City,12,517,497,20,1
2022-01-24,Hue City,Hue City,13,330,316,14,0
2022-01-24,Hue City,Hue City,14,349,326,23,2
2022-01-24,Hue City,Hue City,15,364,334,30,3
2022-01-24,Hue City,Hue City,16,371,356,15,0
2022-01-24,Hue City,Hue City,17,474,443,31,1
2022-01-24,Hue City,Hue City,18,585,542,43,1
2022-01-24,Hue City,Hue City,19,455,421,34,0
2022-01-24,Hue City,Hue City,20,393,338,55,5
2022-01-24,Hue City,Hue City,21,219,191,28,5
2022-01-24,Hue City,Hue City,22,5,2,3,0
2022-01-24,Hue City,Hue City,23,2,1,1,0
2022-01-24,Hue City,Huong Thuy,7,1,0,1,1
2022-01-24,Hue City,Huong Thuy,11,1,1,0,0
2022-01-24,Hue City,Huong Thuy,15,3,1,2,1
2022-01-24,Hue City,Huong Thuy,17,1,1,0,0
2022-01-24,Hue City,Huong Thuy,18,1,1,0,0
2022-01-24,Hue City,Huong Thuy,19,1,0,1,0
2022-01-24,Hue City,Huong Tra,9,1,1,0,0
2022-01-24,Hue City,Huong Tra,12,1,1,0,0
2022-01-24,Hue City,Huong Tra,15,1,0,1,0
2022-01-24,Hue City,Huong Tra,21,1,1,0,0
2022-01-24,Hue City,Phu Vang,8,1,1,0,0
2022-01-24,Hue City,Phu Vang,10,1,0,1,1
2022-01-24,Hue City,Phu Vang,11,2,2,0,0
2022-01-24,Hue City,Phu Vang,13,1,1,0,0
2022-01-24,Hue City,Phu Vang,15,2,0,2,2
2022-01-24,Hue City,Phu Vang,16,1,1,0,0
2022-01-24,Hue City,Phu Vang,17,1,0,1,0
2022-01-24,Hue City,Phu Vang,18,2,2,0,0
2022-01-24,Hue City,Phu Vang,19,1,1,0,0
2022-01-24,Hue City,Phu Vang,20,2,0,2,0
2022-01-24,Hue City,Phu Vang,21,2,2,0,0
2022-01-24,Vung Tau,Ba Ria City,7,1,0,1,1
2022-01-24,Vung Tau,Ba Ria City,9,7,2,5,5
2022-01-24,Vung Tau,Ba Ria City,10,12,2,10,10
2022-01-24,Vung Tau,Ba Ria City,11,12,8,4,3
2022-01-24,Vung Tau,Ba Ria City,12,17,2,15,12
2022-01-24,Vung Tau,Ba Ria City,13,7,4,3,3
2022-01-24,Vung Tau,Ba Ria City,14,9,9,0,0
2022-01-24,Vung Tau,Ba Ria City,15,7,5,2,2
2022-01-24,Vung Tau,Ba Ria City,16,1,1,0,0
2022-01-24,Vung Tau,Ba Ria City,17,10,5,5,3
2022-01-24,Vung Tau,Ba Ria City,18,6,5,1,1
2022-01-24,Vung Tau,Ba Ria City,19,7,0,7,6
2022-01-24,Vung Tau,Ba Ria City,20,3,0,3,3
2022-01-24,Vung Tau,Ba Ria City,21,2,0,2,2
2022-01-24,Vung Tau,Tan Thanh,15,1,0,1,1
2022-01-24,Vung Tau,Tan Thanh,16,1,0,1,1
2022-01-24,Vung Tau,Vung Tau City,0,3,3,0,0
2022-01-24,Vung Tau,Vung Tau City,1,1,1,0,0
2022-01-24,Vung Tau,Vung Tau City,5,2,1,1,0
2022-01-24,Vung Tau,Vung Tau City,6,37,33,4,0
2022-01-24,Vung Tau,Vung Tau City,7,76,75,1,0
2022-01-24,Vung Tau,Vung Tau City,8,173,159,14,4
2022-01-24,Vung Tau,Vung Tau City,9,204,180,24,1
2022-01-24,Vung Tau,Vung Tau City,10,197,178,19,2
2022-01-24,Vung Tau,Vung Tau City,11,353,332,21,2
2022-01-24,Vung Tau,Vung Tau City,12,293,279,14,1
2022-01-24,Vung Tau,Vung Tau City,13,236,222,14,0
2022-01-24,Vung Tau,Vung Tau City,14,214,202,12,1
2022-01-24,Vung Tau,Vung Tau City,15,192,183,9,1
2022-01-24,Vung Tau,Vung Tau City,16,196,184,12,3
2022-01-24,Vung Tau,Vung Tau City,17,216,204,12,1
2022-01-24,Vung Tau,Vung Tau City,18,316,301,15,3
2022-01-24,Vung Tau,Vung Tau City,19,216,195,21,3
2022-01-24,Vung Tau,Vung Tau City,20,174,152,22,0
2022-01-24,Vung Tau,Vung Tau City,21,90,75,15,2
2022-01-24,Vung Tau,Vung Tau City,22,4,2,2,0
2022-01-24,Vung Tau,Vung Tau City,23,3,3,0,0
2022-01-25,Binh Duong,Ben Cat,18,1,0,1,0
2022-01-25,Binh Duong,Di An,7,3,2,1,1
2022-01-25,Binh Duong,Di An,8,8,4,4,3
2022-01-25,Binh Duong,Di An,9,11,5,6,3
2022-01-25,Binh Duong,Di An,10,13,10,3,0
2022-01-25,Binh Duong,Di An,11,15,8,7,6
2022-01-25,Binh Duong,Di An,12,29,17,12,9
2022-01-25,Binh Duong,Di An,13,21,14,7,6
2022-01-25,Binh Duong,Di An,14,9,9,0,0
2022-01-25,Binh Duong,Di An,15,13,10,3,2
2022-01-25,Binh Duong,Di An,16,5,3,2,2
2022-01-25,Binh Duong,Di An,17,16,11,5,3
2022-01-25,Binh Duong,Di An,18,14,9,5,5
2022-01-25,Binh Duong,Di An,19,9,5,4,3
2022-01-25,Binh Duong,Di An,20,6,5,1,1
2022-01-25,Binh Duong,Di An,21,4,2,2,1
2022-01-25,Binh Duong,Di An,23,1,0,1,1
2022-01-25,Binh Duong,Tan Uyen,11,1,1,0,0
2022-01-25,Binh Duong,Tan Uyen,17,1,1,0,0
2022-01-25,Binh Duong,Tan Uyen,20,1,1,0,0
2022-01-25,Binh Duong,Thu Dau Mot Town,0,1,1,0,0
2022-01-25,Binh Duong,Thu Dau Mot Town,3,1,1,0,0
2022-01-25,Binh Duong,Thu Dau Mot Town,6,36,24,12,8
2022-01-25,Binh Duong,Thu Dau Mot Town,7,83,72,11,4
2022-01-25,Binh Duong,Thu Dau Mot Town,8,164,147,17,1
2022-01-25,Binh Duong,Thu Dau Mot Town,9,226,206,20,4
2022-01-25,Binh Duong,Thu Dau Mot Town,10,309,281,28,2
2022-01-25,Binh Duong,Thu Dau Mot Town,11,552,516,36,3
2022-01-25,Binh Duong,Thu Dau Mot Town,12,407,382,25,6
2022-01-25,Binh Duong,Thu Dau Mot Town,13,321,294,27,8
2022-01-25,Binh Duong,Thu Dau Mot Town,14,241,226,15,4
2022-01-25,Binh Duong,Thu Dau Mot Town,15,219,199,20,2
2022-01-25,Binh Duong,Thu Dau Mot Town,16,215,201,14,1
2022-01-25,Binh Duong,Thu Dau Mot Town,17,305,292,13,0
2022-01-25,Binh Duong,Thu Dau Mot Town,18,322,304,18,7
2022-01-25,Binh Duong,Thu Dau Mot Town,19,257,236,21,4
2022-01-25,Binh Duong,Thu Dau Mot Town,20,176,159,17,6
2022-01-25,Binh Duong,Thu Dau Mot Town,21,64,57,7,1
2022-01-25,Binh Duong,Thu Dau Mot Town,22,2,1,1,0
2022-01-25,Binh Duong,Thu Dau Mot Town,23,1,1,0,0
2022-01-25,Binh Duong,Thuan An,5,1,0,1,1
2022-01-25,Binh Duong,Thuan An,6,4,1,3,3
2022-01-25,Binh Duong,Thuan An,7,4,2,2,2
2022-01-25,Binh Duong,Thuan An,8,9,7,2,1
2022-01-25,Binh Duong,Thuan An,9,43,15,28,23
2022-01-25,Binh Duong,Thuan An,10,55,33,22,17
2022-01-25,Binh Duong,Thuan An,11,82,40,42,32
2022-01-25,Binh Duong,Thuan An,12,76,41,35,29
2022-01-25,Binh Duong,Thuan An,13,56,33,23,19
2022-01-25,Binh Duong,Thuan An,14,48,24,24,18
2022-01-25,Binh Duong,Thuan An,15,31,17,14,8
2022-01-25,Binh Duong,Thuan An,16,25,14,11,6
2022-01-25,Binh Duong,Thuan An,17,33,26,7,4
2022-01-25,Binh Duong,Thuan An,18,23,21,2,2
2022-01-25,Binh Duong,Thuan An,19,22,17,5,4
2022-01-25,Binh Duong,Thuan An,20,23,12,11,8
2022-01-25,Binh Duong,Thuan An,21,10,4,6,5
2022-01-25,Binh Duong,Thuan An,23,1,0,1,0
2022-01-25,Can Tho City,Binh Thuy District,6,1,0,1,0
2022-01-25,Can Tho City,Binh Thuy District,7,2,2,0,0
2022-01-25,Can Tho City,Binh Thuy District,8,4,4,0,0
2022-01-25,Can Tho City,Binh Thuy District,9,5,3,2,0
2022-01-25,Can Tho City,Binh Thuy District,10,4,4,0,0
2022-01-25,Can Tho City,Binh Thuy District,11,10,9,1,0
2022-01-25,Can Tho City,Binh Thuy District,12,13,11,2,0
2022-01-25,Can Tho City,Binh Thuy District,13,8,8,0,0
2022-01-25,Can Tho City,Binh Thuy District,14,15,15,0,0
2022-01-25,Can Tho City,Binh Thuy District,15,7,7,0,0
2022-01-25,Can Tho City,Binh Thuy District,16,5,5,0,0
2022-01-25,Can Tho City,Binh Thuy District,17,6,3,3,0
2022-01-25,Can Tho City,Binh Thuy District,18,4,4,0,0
2022-01-25,Can Tho City,Binh Thuy District,19,3,3,0,0
2022-01-25,Can Tho City,Binh Thuy District,20,6,6,0,0
2022-01-25,Can Tho City,Cai Rang District,6,2,2,0,0
2022-01-25,Can Tho City,Cai Rang District,7,3,2,1,1
2022-01-25,Can Tho City,Cai Rang District,8,3,3,0,0
2022-01-25,Can Tho City,Cai Rang District,9,4,4,0,0
2022-01-25,Can Tho City,Cai Rang District,10,9,5,4,0
2022-01-25,Can Tho City,Cai Rang District,11,11,9,2,0
2022-01-25,Can Tho City,Cai Rang District,12,12,12,0,0
2022-01-25,Can Tho City,Cai Rang District,13,11,10,1,0
2022-01-25,Can Tho City,Cai Rang District,14,4,4,0,0
2022-01-25,Can Tho City,Cai Rang District,15,9,8,1,1
2022-01-25,Can Tho City,Cai Rang District,16,13,12,1,0
2022-01-25,Can Tho City,Cai Rang District,17,7,6,1,0
2022-01-25,Can Tho City,Cai Rang District,18,9,8,1,0
2022-01-25,Can Tho City,Cai Rang District,19,10,5,5,5
2022-01-25,Can Tho City,Cai Rang District,20,7,7,0,0
2022-01-25,Can Tho City,Cai Rang District,21,1,1,0,0
2022-01-25,Can Tho City,Ninh Kieu District,0,2,1,1,0
2022-01-25,Can Tho City,Ninh Kieu District,1,1,1,0,0
2022-01-25,Can Tho City,Ninh Kieu District,2,3,3,0,0
2022-01-25,Can Tho City,Ninh Kieu District,4,1,1,0,0
2022-01-25,Can Tho City,Ninh Kieu District,6,30,27,3,0
2022-01-25,Can Tho City,Ninh Kieu District,7,121,114,7,0
2022-01-25,Can Tho City,Ninh Kieu District,8,175,164,11,0
2022-01-25,Can Tho City,Ninh Kieu District,9,206,185,21,0
2022-01-25,Can Tho City,Ninh Kieu District,10,312,303,9,0
2022-01-25,Can Tho City,Ninh Kieu District,11,536,519,17,0
2022-01-25,Can Tho City,Ninh Kieu District,12,340,332,8,0
2022-01-25,Can Tho City,Ninh Kieu District,13,349,326,23,0
2022-01-25,Can Tho City,Ninh Kieu District,14,268,251,17,0
2022-01-25,Can Tho City,Ninh Kieu District,15,240,226,14,0
2022-01-25,Can Tho City,Ninh Kieu District,16,242,231,11,0
2022-01-25,Can Tho City,Ninh Kieu District,17,295,282,13,0
2022-01-25,Can Tho City,Ninh Kieu District,18,277,267,10,0
2022-01-25,Can Tho City,Ninh Kieu District,19,328,313,15,0
2022-01-25,Can Tho City,Ninh Kieu District,20,207,187,20,0
2022-01-25,Can Tho City,Ninh Kieu District,21,126,101,25,0
2022-01-25,Can Tho City,Ninh Kieu District,22,2,2,0,0
2022-01-25,Can Tho City,Ninh Kieu District,23,1,1,0,0
2022-01-25,Dong Nai,Bien Hoa City,0,2,2,0,0
2022-01-25,Dong Nai,Bien Hoa City,1,3,0,3,0
2022-01-25,Dong Nai,Bien Hoa City,2,1,1,0,0
2022-01-25,Dong Nai,Bien Hoa City,3,1,1,0,0
2022-01-25,Dong Nai,Bien Hoa City,5,7,6,1,1
2022-01-25,Dong Nai,Bien Hoa City,6,36,27,9,3
2022-01-25,Dong Nai,Bien Hoa City,7,141,122,19,6
2022-01-25,Dong Nai,Bien Hoa City,8,263,237,26,8
2022-01-25,Dong Nai,Bien Hoa City,9,359,323,36,7
2022-01-25,Dong Nai,Bien Hoa City,10,608,548,60,12
2022-01-25,Dong Nai,Bien Hoa City,11,985,899,86,31
2022-01-25,Dong Nai,Bien Hoa City,12,735,673,62,5
2022-01-25,Dong Nai,Bien Hoa City,13,674,647,27,3
2022-01-25,Dong Nai,Bien Hoa City,14,568,537,31,1
2022-01-25,Dong Nai,Bien Hoa City,15,426,398,28,1
2022-01-25,Dong Nai,Bien Hoa City,16,421,377,44,11
2022-01-25,Dong Nai,Bien Hoa City,17,506,463,43,9
2022-01-25,Dong Nai,Bien Hoa City,18,586,524,62,18
2022-01-25,Dong Nai,Bien Hoa City,19,580,519,61,21
2022-01-25,Dong Nai,Bien Hoa City,20,410,366,44,8
2022-01-25,Dong Nai,Bien Hoa City,21,183,149,34,8
2022-01-25,Dong Nai,Bien Hoa City,22,2,0,2,1
2022-01-25,Dong Nai,Bien Hoa City,23,3,1,2,0
2022-01-25,Dong Nai,Long Thanh,9,2,0,2,2
2022-01-25,Dong Nai,Long Thanh,10,1,0,1,1
2022-01-25,Dong Nai,Long Thanh,11,1,0,1,1
2022-01-25,Dong Nai,Long Thanh,12,3,0,3,3
2022-01-25,Dong Nai,Long Thanh,15,3,0,3,1
2022-01-25,Dong Nai,Long Thanh,16,1,0,1,0
2022-01-25,Dong Nai,Long Thanh,18,3,0,3,3
2022-01-25,Dong Nai,Long Thanh,19,2,0,2,2
2022-01-25,Dong Nai,Thong Nhat,4,1,1,0,0
2022-01-25,Dong Nai,Thong Nhat,8,3,3,0,0
2022-01-25,Dong Nai,Thong Nhat,9,2,2,0,0
2022-01-25,Dong Nai,Thong Nhat,10,3,3,0,0
2022-01-25,Dong Nai,Thong Nhat,12,3,3,0,0
2022-01-25,Dong Nai,Thong Nhat,13,3,3,0,0
2022-01-25,Dong Nai,Thong Nhat,15,2,2,0,0
2022-01-25,Dong Nai,Thong Nhat,17,1,1,0,0
2022-01-25,Dong Nai,Thong Nhat,19,2,2,0,0
2022-01-25,Dong Nai,Trang Bom,9,1,0,1,1
2022-01-25,Dong Nai,Trang Bom,12,2,0,2,2
2022-01-25,Dong Nai,Trang Bom,13,1,0,1,1
2022-01-25,Dong Nai,Trang Bom,15,1,0,1,1
2022-01-25,Dong Nai,Trang Bom,17,3,0,3,2
2022-01-25,Hai Phong City,An Duong,7,1,0,1,1
2022-01-25,Hai Phong City,An Duong,9,1,0,1,1
2022-01-25,Hai Phong City,An Duong,10,2,1,1,1
2022-01-25,Hai Phong City,An Duong,11,6,4,2,1
2022-01-25,Hai Phong City,An Duong,12,2,2,0,0
2022-01-25,Hai Phong City,An Duong,13,2,1,1,1
2022-01-25,Hai Phong City,An Duong,14,5,1,4,4
2022-01-25,Hai Phong City,An Duong,15,3,2,1,1
2022-01-25,Hai Phong City,An Duong,16,2,2,0,0
2022-01-25,Hai Phong City,An Duong,18,1,0,1,1
2022-01-25,Hai Phong City,An Duong,19,2,2,0,0
2022-01-25,Hai Phong City,An Duong,20,4,0,4,3
2022-01-25,Hai Phong City,Do Son District,12,3,0,3,1
2022-01-25,Hai Phong City,Do Son District,13,1,0,1,0
2022-01-25,Hai Phong City,Do Son District,19,1,0,1,1
2022-01-25,Hai Phong City,Duong Kinh District,15,2,0,2,2
2022-01-25,Hai Phong City,Hai An District,5,1,0,1,0
2022-01-25,Hai Phong City,Hai An District,7,7,6,1,0
2022-01-25,Hai Phong City,Hai An District,8,7,4,3,0
2022-01-25,Hai Phong City,Hai An District,9,9,6,3,0
2022-01-25,Hai Phong City,Hai An District,10,16,14,2,0
2022-01-25,Hai Phong City,Hai An District,11,25,22,3,0
2022-01-25,Hai Phong City,Hai An District,12,21,20,1,0
2022-01-25,Hai Phong City,Hai An District,13,12,10,2,0
2022-01-25,Hai Phong City,Hai An District,14,14,11,3,0
2022-01-25,Hai Phong City,Hai An District,15,5,5,0,0
2022-01-25,Hai Phong City,Hai An District,16,13,12,1,0
2022-01-25,Hai Phong City,Hai An District,17,20,13,7,1
2022-01-25,Hai Phong City,Hai An District,18,14,14,0,0
2022-01-25,Hai Phong City,Hai An District,19,9,6,3,0
2022-01-25,Hai Phong City,Hai An District,20,13,12,1,0
2022-01-25,Hai Phong City,Hai An District,21,11,7,4,1
2022-01-25,Hai Phong City,Hong Bang District,3,1,1,0,0
2022-01-25,Hai Phong City,Hong Bang District,7,15,14,1,0
2022-01-25,Hai Phong City,Hong Bang District,8,35,32,3,1
2022-01-25,Hai Phong City,Hong Bang District,9,33,27,6,1
2022-01-25,Hai Phong City,Hong Bang District,10,35,30,5,2
2022-01-25,Hai Phong City,Hong Bang District,11,77,73,4,0
2022-01-25,Hai Phong City,Hong Bang District,12,44,42,2,0
2022-01-25,Hai Phong City,Hong Bang District,13,36,35,1,0
2022-01-25,Hai Phong City,Hong Bang District,14,39,33,6,0
2022-01-25,Hai Phong City,Hong Bang District,15,23,20,3,0
2022-01-25,Hai Phong City,Hong Bang District,16,30,29,1,0
2022-01-25,Hai Phong City,Hong Bang District,17,36,30,6,0
2022-01-25,Hai Phong City,Hong Bang District,18,56,53,3,0
2022-01-25,Hai Phong City,Hong Bang District,19,53,49,4,1
2022-01-25,Hai Phong City,Hong Bang District,20,38,31,7,2
2022-01-25,Hai Phong City,Hong Bang District,21,14,11,3,0
2022-01-25,Hai Phong City,Hong Bang District,22,1,0,1,1
2022-01-25,Hai Phong City,Kien An District,9,1,0,1,1
2022-01-25,Hai Phong City,Kien An District,10,11,6,5,3
2022-01-25,Hai Phong City,Kien An District,11,10,7,3,2
2022-01-25,Hai Phong City,Kien An District,12,7,5,2,2
2022-01-25,Hai Phong City,Kien An District,13,8,5,3,2
2022-01-25,Hai Phong City,Kien An District,14,5,3,2,2
2022-01-25,Hai Phong City,Kien An District,15,3,3,0,0
2022-01-25,Hai Phong City,Kien An District,16,10,2,8,4
2022-01-25,Hai Phong City,Kien An District,17,10,9,1,1
2022-01-25,Hai Phong City,Kien An District,18,10,4,6,5
2022-01-25,Hai Phong City,Kien An District,19,13,6,7,6
2022-01-25,Hai Phong City,Kien An District,20,12,7,5,5
2022-01-25,Hai Phong City,Kien An District,21,3,2,1,1
2022-01-25,Hai Phong City,Le Chan District,0,1,1,0,0
2022-01-25,Hai Phong City,Le Chan District,2,2,0,2,1
2022-01-25,Hai Phong City,Le Chan District,3,1,1,0,0
2022-01-25,Hai Phong City,Le Chan District,4,1,1,0,0
2022-01-25,Hai Phong City,Le Chan District,6,4,0,4,0
2022-01-25,Hai Phong City,Le Chan District,7,32,23,9,1
2022-01-25,Hai Phong City,Le Chan District,8,75,66,9,1
2022-01-25,Hai Phong City,Le Chan District,9,62,52,10,0
2022-01-25,Hai Phong City,Le Chan District,10,121,106,15,0
2022-01-25,Hai Phong City,Le Chan District,11,264,240,24,2
2022-01-25,Hai Phong City,Le Chan District,12,175,159,16,0
2022-01-25,Hai Phong City,Le Chan District,13,99,92,7,0
2022-01-25,Hai Phong City,Le Chan District,14,96,83,13,0
2022-01-25,Hai Phong City,Le Chan District,15,129,112,17,0
2022-01-25,Hai Phong City,Le Chan District,16,121,109,12,0
2022-01-25,Hai Phong City,Le Chan District,17,136,122,14,2
2022-01-25,Hai Phong City,Le Chan District,18,210,195,15,0
2022-01-25,Hai Phong City,Le Chan District,19,177,157,20,1
2022-01-25,Hai Phong City,Le Chan District,20,122,107,15,1
2022-01-25,Hai Phong City,Le Chan District,21,60,50,10,0
2022-01-25,Hai Phong City,Le Chan District,23,1,0,1,0
2022-01-25,Hai Phong City,Ngo Quyen District,0,1,1,0,0
2022-01-25,Hai Phong City,Ngo Quyen District,6,3,1,2,1
2022-01-25,Hai Phong City,Ngo Quyen District,7,25,18,7,1
2022-01-25,Hai Phong City,Ngo Quyen District,8,74,62,12,0
2022-01-25,Hai Phong City,Ngo Quyen District,9,81,70,11,0
2022-01-25,Hai Phong City,Ngo Quyen District,10,121,114,7,0
2022-01-25,Hai Phong City,Ngo Quyen District,11,206,180,26,1
2022-01-25,Hai Phong City,Ngo Quyen District,12,144,134,10,0
2022-01-25,Hai Phong City,Ngo Quyen District,13,90,86,4,0
2022-01-25,Hai Phong City,Ngo Quyen District,14,125,113,12,0
2022-01-25,Hai Phong City,Ngo Quyen District,15,131,120,11,0
2022-01-25,Hai Phong City,Ngo Quyen District,16,103,98,5,0
2022-01-25,Hai Phong City,Ngo Quyen District,17,136,119,17,0
2022-01-25,Hai Phong City,Ngo Quyen District,18,170,152,18,1
2022-01-25,Hai Phong City,Ngo Quyen District,19,157,134,23,1
2022-01-25,Hai Phong City,Ngo Quyen District,20,147,127,20,0
2022-01-25,Hai Phong City,Ngo Quyen District,21,67,51,16,1
2022-01-25,Hai Phong City,Ngo Quyen District,23,1,0,1,1
2022-01-25,Hai Phong City,Thuy Nguyen,18,1,0,1,1
2022-01-25,Hai Phong City,Thuy Nguyen,19,1,0,1,1
2022-01-25,Hai Phong City,Thuy Nguyen,21,1,0,1,0
2022-01-25,Hue City,Hue City,1,6,3,3,0
2022-01-25,Hue City,Hue City,4,1,1,0,0
2022-01-25,Hue City,Hue City,6,48,38,10,0
2022-01-25,Hue City,Hue City,7,157,137,20,1
2022-01-25,Hue City,Hue City,8,259,244,15,0
2022-01-25,Hue City,Hue City,9,181,176,5,0
2022-01-25,Hue City,Hue City,10,215,202,13,0
2022-01-25,Hue City,Hue City,11,512,497,15,0
2022-01-25,Hue City,Hue City,12,397,375,22,0
2022-01-25,Hue City,Hue City,13,246,226,20,1
2022-01-25,Hue City,Hue City,14,245,238,7,0
2022-01-25,Hue City,Hue City,15,298,279,19,0
2022-01-25,Hue City,Hue City,16,295,275,20,2
2022-01-25,Hue City,Hue City,17,380,354,26,2
2022-01-25,Hue City,Hue City,18,452,424,28,1
2022-01-25,Hue City,Hue City,19,379,352,27,0
2022-01-25,Hue City,Hue City,20,262,240,22,0
2022-01-25,Hue City,Hue City,21,207,169,38,3
2022-01-25,Hue City,Hue City,22,4,2,2,0
2022-01-25,Hue City,Hue City,23,1,1,0,0
2022-01-25,Hue City,Huong Thuy,9,2,1,1,0
2022-01-25,Hue City,Huong Thuy,15,1,1,0,0
2022-01-25,Hue City,Huong Thuy,19,2,0,2,0
2022-01-25,Hue City,Huong Thuy,20,1,1,0,0
2022-01-25,Hue City,Huong Tra,10,1,1,0,0
2022-01-25,Hue City,Huong Tra,11,1,1,0,0
2022-01-25,Hue City,Huong Tra,19,1,0,1,0
2022-01-25,Hue City,Phu Vang,6,1,1,0,0
2022-01-25,Hue City,Phu Vang,7,1,1,0,0
2022-01-25,Hue City,Phu Vang,11,1,1,0,0
2022-01-25,Hue City,Phu Vang,12,1,1,0,0
2022-01-25,Hue City,Phu Vang,13,1,1,0,0
2022-01-25,Hue City,Phu Vang,14,1,1,0,0
2022-01-25,Hue City,Phu Vang,15,1,1,0,0
2022-01-25,Hue City,Phu Vang,17,2,2,0,0
2022-01-25,Hue City,Phu Vang,18,2,1,1,0
2022-01-25,Hue City,Phu Vang,19,1,1,0,0
2022-01-25,Vung Tau,Ba Ria City,7,2,0,2,2
2022-01-25,Vung Tau,Ba Ria City,8,3,0,3,3
2022-01-25,Vung Tau,Ba Ria City,9,10,2,8,6
2022-01-25,Vung Tau,Ba Ria City,10,7,1,6,6
2022-01-25,Vung Tau,Ba Ria City,11,4,3,1,1
2022-01-25,Vung Tau,Ba Ria City,12,7,0,7,6
2022-01-25,Vung Tau,Ba Ria City,13,9,5,4,4
2022-01-25,Vung Tau,Ba Ria City,14,9,5,4,3
2022-01-25,Vung Tau,Ba Ria City,15,4,1,3,3
2022-01-25,Vung Tau,Ba Ria City,16,9,3,6,5
2022-01-25,Vung Tau,Ba Ria City,17,7,1,6,4
2022-01-25,Vung Tau,Ba Ria City,18,9,5,4,3
2022-01-25,Vung Tau,Ba Ria City,19,5,4,1,0
2022-01-25,Vung Tau,Ba Ria City,20,1,0,1,1
2022-01-25,Vung Tau,Tan Thanh,10,1,0,1,1
2022-01-25,Vung Tau,Tan Thanh,21,2,0,2,2
2022-01-25,Vung Tau,Vung Tau City,0,2,1,1,0
2022-01-25,Vung Tau,Vung Tau City,6,27,23,4,1
2022-01-25,Vung Tau,Vung Tau City,7,88,88,0,0
2022-01-25,Vung Tau,Vung Tau City,8,150,135,15,1
2022-01-25,Vung Tau,Vung Tau City,9,160,151,9,0
2022-01-25,Vung Tau,Vung Tau City,10,144,130,14,0
2022-01-25,Vung Tau,Vung Tau City,11,323,305,18,1
2022-01-25,Vung Tau,Vung Tau City,12,252,242,10,0
2022-01-25,Vung Tau,Vung Tau City,13,203,192,11,0
2022-01-25,Vung Tau,Vung Tau City,14,178,165,13,1
2022-01-25,Vung Tau,Vung Tau City,15,190,172,18,1
2022-01-25,Vung Tau,Vung Tau City,16,144,134,10,0
2022-01-25,Vung Tau,Vung Tau City,17,216,208,8,0
2022-01-25,Vung Tau,Vung Tau City,18,259,246,13,0
2022-01-25,Vung Tau,Vung Tau City,19,235,223,12,0
2022-01-25,Vung Tau,Vung Tau City,20,145,134,11,0
2022-01-25,Vung Tau,Vung Tau City,21,103,78,25,2
2022-01-25,Vung Tau,Vung Tau City,22,1,1,0,0
2022-01-25,Vung Tau,Vung Tau City,23,1,0,1,0
2022-01-26,Binh Duong,Di An,7,8,3,5,4
2022-01-26,Binh Duong,Di An,8,9,4,5,3
2022-01-26,Binh Duong,Di An,9,18,5,13,9
2022-01-26,Binh Duong,Di An,10,21,13,8,6
2022-01-26,Binh Duong,Di An,11,40,13,27,19
2022-01-26,Binh Duong,Di An,12,30,15,15,14
2022-01-26,Binh Duong,Di An,13,26,13,13,11
2022-01-26,Binh Duong,Di An,14,15,13,2,1
2022-01-26,Binh Duong,Di An,15,9,8,1,0
2022-01-26,Binh Duong,Di An,16,17,11,6,2
2022-01-26,Binh Duong,Di An,17,14,8,6,2
2022-01-26,Binh Duong,Di An,18,18,7,11,7
2022-01-26,Binh Duong,Di An,19,8,4,4,3
2022-01-26,Binh Duong,Di An,20,9,5,4,1
2022-01-26,Binh Duong,Di An,21,4,1,3,2
2022-01-26,Binh Duong,Tan Uyen,8,1,1,0,0
2022-01-26,Binh Duong,Tan Uyen,9,1,0,1,1
2022-01-26,Binh Duong,Tan Uyen,10,2,0,2,1
2022-01-26,Binh Duong,Tan Uyen,11,1,0,1,0
2022-01-26,Binh Duong,Tan Uyen,12,1,1,0,0
2022-01-26,Binh Duong,Tan Uyen,13,1,1,0,0
2022-01-26,Binh Duong,Tan Uyen,14,2,1,1,1
2022-01-26,Binh Duong,Tan Uyen,15,2,2,0,0
2022-01-26,Binh Duong,Tan Uyen,17,1,1,0,0
2022-01-26,Binh Duong,Tan Uyen,19,1,1,0,0
2022-01-26,Binh Duong,Tan Uyen,21,2,2,0,0
2022-01-26,Binh Duong,Thu Dau Mot Town,2,1,1,0,0
2022-01-26,Binh Duong,Thu Dau Mot Town,5,1,1,0,0
2022-01-26,Binh Duong,Thu Dau Mot Town,6,26,21,5,1
2022-01-26,Binh Duong,Thu Dau Mot Town,7,67,64,3,1
2022-01-26,Binh Duong,Thu Dau Mot Town,8,173,158,15,4
2022-01-26,Binh Duong,Thu Dau Mot Town,9,235,204,31,7
2022-01-26,Binh Duong,Thu Dau Mot Town,10,364,338,26,2
2022-01-26,Binh Duong,Thu Dau Mot Town,11,587,540,47,8
2022-01-26,Binh Duong,Thu Dau Mot Town,12,455,429,26,7
2022-01-26,Binh Duong,Thu Dau Mot Town,13,345,322,23,3
2022-01-26,Binh Duong,Thu Dau Mot Town,14,315,298,17,4
2022-01-26,Binh Duong,Thu Dau Mot Town,15,210,197,13,1
2022-01-26,Binh Duong,Thu Dau Mot Town,16,214,203,11,3
2022-01-26,Binh Duong,Thu Dau Mot Town,17,335,306,29,4
2022-01-26,Binh Duong,Thu Dau Mot Town,18,362,344,18,3
2022-01-26,Binh Duong,Thu Dau Mot Town,19,286,265,21,4
2022-01-26,Binh Duong,Thu Dau Mot Town,20,215,195,20,2
2022-01-26,Binh Duong,Thu Dau Mot Town,21,104,84,20,3
2022-01-26,Binh Duong,Thuan An,3,1,0,1,1
2022-01-26,Binh Duong,Thuan An,6,2,0,2,2
2022-01-26,Binh Duong,Thuan An,7,3,2,1,0
2022-01-26,Binh Duong,Thuan An,8,10,5,5,4
2022-01-26,Binh Duong,Thuan An,9,41,24,17,14
2022-01-26,Binh Duong,Thuan An,10,47,33,14,5
2022-01-26,Binh Duong,Thuan An,11,81,53,28,20
2022-01-26,Binh Duong,Thuan An,12,90,55,35,22
2022-01-26,Binh Duong,Thuan An,13,65,38,27,24
2022-01-26,Binh Duong,Thuan An,14,44,28,16,12
2022-01-26,Binh Duong,Thuan An,15,31,26,5,3
2022-01-26,Binh Duong,Thuan An,16,34,29,5,3
2022-01-26,Binh Duong,Thuan An,17,23,16,7,2
2022-01-26,Binh Duong,Thuan An,18,23,14,9,9
2022-01-26,Binh Duong,Thuan An,19,41,22,19,15
2022-01-26,Binh Duong,Thuan An,20,26,13,13,9
2022-01-26,Binh Duong,Thuan An,21,13,5,8,6
2022-01-26,Binh Duong,Thuan An,22,1,0,1,0
2022-01-26,Can Tho City,Binh Thuy District,1,1,0,1,0
2022-01-26,Can Tho City,Binh Thuy District,7,1,1,0,0
2022-01-26,Can Tho City,Binh Thuy District,8,1,0,1,0
2022-01-26,Can Tho City,Binh Thuy District,9,6,5,1,0
2022-01-26,Can Tho City,Binh Thuy District,10,6,6,0,0
2022-01-26,Can Tho City,Binh Thuy District,11,14,12,2,0
2022-01-26,Can Tho City,Binh Thuy District,12,16,14,2,0
2022-01-26,Can Tho City,Binh Thuy District,13,7,7,0,0
2022-01-26,Can Tho City,Binh Thuy District,14,6,6,0,0
2022-01-26,Can Tho City,Binh Thuy District,15,6,6,0,0
2022-01-26,Can Tho City,Binh Thuy District,16,6,6,0,0
2022-01-26,Can Tho City,Binh Thuy District,17,14,12,2,0
2022-01-26,Can Tho City,Binh Thuy District,18,12,8,4,0
2022-01-26,Can Tho City,Binh Thuy District,19,13,12,1,0
2022-01-26,Can Tho City,Binh Thuy District,20,10,9,1,0
2022-01-26,Can Tho City,Binh Thuy District,21,4,3,1,0
2022-01-26,Can Tho City,Binh Thuy District,22,2,0,2,0
2022-01-26,Can Tho City,Cai Rang District,6,1,1,0,0
2022-01-26,Can Tho City,Cai Rang District,7,3,3,0,0
2022-01-26,Can Tho City,Cai Rang District,8,5,4,1,0
2022-01-26,Can Tho City,Cai Rang District,9,5,5,0,0
2022-01-26,Can Tho City,Cai Rang District,10,7,7,0,0
2022-01-26,Can Tho City,Cai Rang District,11,17,17,0,0
2022-01-26,Can Tho City,Cai Rang District,12,12,11,1,0
2022-01-26,Can Tho City,Cai Rang District,13,6,6,0,0
2022-01-26,Can Tho City,Cai Rang District,14,6,5,1,0
2022-01-26,Can Tho City,Cai Rang District,15,7,7,0,0
2022-01-26,Can Tho City,Cai Rang District,16,8,7,1,0
2022-01-26,Can Tho City,Cai Rang District,17,8,7,1,0
2022-01-26,Can Tho City,Cai Rang District,18,7,7,0,0
2022-01-26,Can Tho City,Cai Rang District,19,3,3,0,0
2022-01-26,Can Tho City,Cai Rang District,20,3,3,0,0
2022-01-26,Can Tho City,Cai Rang District,21,2,2,0,0
2022-01-26,Can Tho City,Ninh Kieu District,0,3,1,2,0
2022-01-26,Can Tho City,Ninh Kieu District,1,3,2,1,0
2022-01-26,Can Tho City,Ninh Kieu District,3,1,0,1,0
2022-01-26,Can Tho City,Ninh Kieu District,5,2,2,0,0
2022-01-26,Can Tho City,Ninh Kieu District,6,38,37,1,0
2022-01-26,Can Tho City,Ninh Kieu District,7,103,102,1,0
2022-01-26,Can Tho City,Ninh Kieu District,8,157,144,13,0
2022-01-26,Can Tho City,Ninh Kieu District,9,185,172,13,0
2022-01-26,Can Tho City,Ninh Kieu District,10,331,317,14,0
2022-01-26,Can Tho City,Ninh Kieu District,11,578,559,19,0
2022-01-26,Can Tho City,Ninh Kieu District,12,447,428,19,0
2022-01-26,Can Tho City,Ninh Kieu District,13,327,312,15,0
2022-01-26,Can Tho City,Ninh Kieu District,14,274,257,17,1
2022-01-26,Can Tho City,Ninh Kieu District,15,244,230,14,0
2022-01-26,Can Tho City,Ninh Kieu District,16,253,235,18,0
2022-01-26,Can Tho City,Ninh Kieu District,17,291,278,13,0
2022-01-26,Can Tho City,Ninh Kieu District,18,330,319,11,0
2022-01-26,Can Tho City,Ninh Kieu District,19,239,221,18,0
2022-01-26,Can Tho City,Ninh Kieu District,20,243,217,26,0
2022-01-26,Can Tho City,Ninh Kieu District,21,100,85,15,0
2022-01-26,Can Tho City,Ninh Kieu District,22,2,2,0,0
2022-01-26,Can Tho City,Ninh Kieu District,23,2,2,0,0
2022-01-26,Dong Nai,Bien Hoa City,0,4,1,3,0
2022-01-26,Dong Nai,Bien Hoa City,1,1,1,0,0
2022-01-26,Dong Nai,Bien Hoa City,2,1,0,1,0
2022-01-26,Dong Nai,Bien Hoa City,3,1,1,0,0
2022-01-26,Dong Nai,Bien Hoa City,4,1,1,0,0
2022-01-26,Dong Nai,Bien Hoa City,6,31,26,5,2
2022-01-26,Dong Nai,Bien Hoa City,7,117,105,12,5
2022-01-26,Dong Nai,Bien Hoa City,8,263,234,29,7
2022-01-26,Dong Nai,Bien Hoa City,9,355,323,32,3
2022-01-26,Dong Nai,Bien Hoa City,10,681,619,62,13
2022-01-26,Dong Nai,Bien Hoa City,11,1076,988,88,26
2022-01-26,Dong Nai,Bien Hoa City,12,830,773,57,6
2022-01-26,Dong Nai,Bien Hoa City,13,719,665,54,13
2022-01-26,Dong Nai,Bien Hoa City,14,545,508,37,5
2022-01-26,Dong Nai,Bien Hoa City,15,467,433,34,5
2022-01-26,Dong Nai,Bien Hoa City,16,430,398,32,3
2022-01-26,Dong Nai,Bien Hoa City,17,459,434,25,4
2022-01-26,Dong Nai,Bien Hoa City,18,605,559,46,14
2022-01-26,Dong Nai,Bien Hoa City,19,605,520,85,25
2022-01-26,Dong Nai,Bien Hoa City,20,476,407,69,22
2022-01-26,Dong Nai,Bien Hoa City,21,211,147,64,20
2022-01-26,Dong Nai,Bien Hoa City,22,3,1,2,0
2022-01-26,Dong Nai,Bien Hoa City,23,2,1,1,0
2022-01-26,Dong Nai,Long Thanh,11,1,0,1,1
2022-01-26,Dong Nai,Long Thanh,14,3,0,3,2
2022-01-26,Dong Nai,Long Thanh,15,3,0,3,3
2022-01-26,Dong Nai,Long Thanh,16,1,0,1,1
2022-01-26,Dong Nai,Long Thanh,18,2,0,2,1
2022-01-26,Dong Nai,Long Thanh,19,1,0,1,1
2022-01-26,Dong Nai,Long Thanh,20,2,0,2,2
2022-01-26,Dong Nai,Long Thanh,21,3,0,3,3
2022-01-26,Dong Nai,Thong Nhat,7,2,2,0,0
2022-01-26,Dong Nai,Thong Nhat,8,1,1,0,0
2022-01-26,Dong Nai,Thong Nhat,9,1,1,0,0
2022-01-26,Dong Nai,Thong Nhat,10,1,1,0,0
2022-01-26,Dong Nai,Thong Nhat,12,2,2,0,0
2022-01-26,Dong Nai,Thong Nhat,14,2,2,0,0
2022-01-26,Dong Nai,Thong Nhat,15,1,1,0,0
2022-01-26,Dong Nai,Thong Nhat,17,1,1,0,0
2022-01-26,Dong Nai,Thong Nhat,20,1,1,0,0
2022-01-26,Dong Nai,Trang Bom,12,1,0,1,1
2022-01-26,Dong Nai,Trang Bom,13,3,0,3,1
2022-01-26,Dong Nai,Trang Bom,17,1,1,0,0
2022-01-26,Hai Phong City,An Duong,8,1,1,0,0
2022-01-26,Hai Phong City,An Duong,9,5,1,4,4
2022-01-26,Hai Phong City,An Duong,10,4,1,3,3
2022-01-26,Hai Phong City,An Duong,11,2,2,0,0
2022-01-26,Hai Phong City,An Duong,12,3,1,2,1
2022-01-26,Hai Phong City,An Duong,13,5,0,5,5
2022-01-26,Hai Phong City,An Duong,14,6,4,2,2
2022-01-26,Hai Phong City,An Duong,15,3,2,1,1
2022-01-26,Hai Phong City,An Duong,16,4,3,1,0
2022-01-26,Hai Phong City,An Duong,17,2,1,1,0
2022-01-26,Hai Phong City,An Duong,18,2,2,0,0
2022-01-26,Hai Phong City,An Duong,19,7,6,1,1
2022-01-26,Hai Phong City,An Duong,20,2,2,0,0
2022-01-26,Hai Phong City,Duong Kinh District,12,2,1,1,1
2022-01-26,Hai Phong City,Duong Kinh District,14,4,0,4,3
2022-01-26,Hai Phong City,Duong Kinh District,20,1,0,1,1
2022-01-26,Hai Phong City,Hai An District,6,1,0,1,0
2022-01-26,Hai Phong City,Hai An District,7,10,6,4,1
2022-01-26,Hai Phong City,Hai An District,8,7,5,2,0
2022-01-26,Hai Phong City,Hai An District,9,10,8,2,0
2022-01-26,Hai Phong City,Hai An District,10,16,16,0,0
2022-01-26,Hai Phong City,Hai An District,11,44,41,3,1
2022-01-26,Hai Phong City,Hai An District,12,28,25,3,0
2022-01-26,Hai Phong City,Hai An District,13,20,18,2,0
2022-01-26,Hai Phong City,Hai An District,14,13,13,0,0
2022-01-26,Hai Phong City,Hai An District,15,16,14,2,1
2022-01-26,Hai Phong City,Hai An District,16,9,8,1,0
2022-01-26,Hai Phong City,Hai An District,17,16,15,1,0
2022-01-26,Hai Phong City,Hai An District,18,23,19,4,1
2022-01-26,Hai Phong City,Hai An District,19,21,14,7,1
2022-01-26,Hai Phong City,Hai An District,20,16,12,4,0
2022-01-26,Hai Phong City,Hai An District,21,6,5,1,0
2022-01-26,Hai Phong City,Hong Bang District,7,6,5,1,0
2022-01-26,Hai Phong City,Hong Bang District,8,42,33,9,1
2022-01-26,Hai Phong City,Hong Bang District,9,35,30,5,0
2022-01-26,Hai Phong City,Hong Bang District,10,51,46,5,0
2022-01-26,Hai Phong City,Hong Bang District,11,152,120,32,16
2022-01-26,Hai Phong City,Hong Bang District,12,92,82,10,1
2022-01-26,Hai Phong City,Hong Bang District,13,40,33,7,0
2022-01-26,Hai Phong City,Hong Bang District,14,38,36,2,1
2022-01-26,Hai Phong City,Hong Bang District,15,38,31,7,1
2022-01-26,Hai Phong City,Hong Bang District,16,36,34,2,0
2022-01-26,Hai Phong City,Hong Bang District,17,43,38,5,0
2022-01-26,Hai Phong City,Hong Bang District,18,72,65,7,2
2022-01-26,Hai Phong City,Hong Bang District,19,58,51,7,3
2022-01-26,Hai Phong City,Hong Bang District,20,45,39,6,0
2022-01-26,Hai Phong City,Hong Bang District,21,16,11,5,0
2022-01-26,Hai Phong City,Kien An District,7,1,0,1,1
2022-01-26,Hai Phong City,Kien An District,8,1,1,0,0
2022-01-26,Hai Phong City,Kien An District,9,2,2,0,0
2022-01-26,Hai Phong City,Kien An District,10,6,4,2,2
2022-01-26,Hai Phong City,Kien An District,11,10,5,5,2
2022-01-26,Hai Phong City,Kien An District,12,10,7,3,1
2022-01-26,Hai Phong City,Kien An District,13,3,3,0,0
2022-01-26,Hai Phong City,Kien An District,14,1,0,1,1
2022-01-26,Hai Phong City,Kien An District,15,7,3,4,3
2022-01-26,Hai Phong City,Kien An District,16,10,3,7,5
2022-01-26,Hai Phong City,Kien An District,17,8,3,5,5
2022-01-26,Hai Phong City,Kien An District,18,12,4,8,6
2022-01-26,Hai Phong City,Kien An District,19,14,7,7,7
2022-01-26,Hai Phong City,Kien An District,20,6,1,5,5
2022-01-26,Hai Phong City,Kien An District,21,9,4,5,2
2022-01-26,Hai Phong City,Le Chan District,6,2,1,1,0
2022-01-26,Hai Phong City,Le Chan District,7,34,25,9,4
2022-01-26,Hai Phong City,Le Chan District,8,77,72,5,0
2022-01-26,Hai Phong City,Le Chan District,9,58,54,4,0
2022-01-26,Hai Phong City,Le Chan District,10,120,111,9,0
2022-01-26,Hai Phong City,Le Chan District,11,324,264,60,17
2022-01-26,Hai Phong City,Le Chan District,12,251,219,32,4
2022-01-26,Hai Phong City,Le Chan District,13,109,102,7,0
2022-01-26,Hai Phong City,Le Chan District,14,125,107,18,2
2022-01-26,Hai Phong City,Le Chan District,15,136,121,15,2
2022-01-26,Hai Phong City,Le Chan District,16,154,138,16,1
2022-01-26,Hai Phong City,Le Chan District,17,170,155,15,0
2022-01-26,Hai Phong City,Le Chan District,18,220,197,23,4
2022-01-26,Hai Phong City,Le Chan District,19,166,149,17,3
2022-01-26,Hai Phong City,Le Chan District,20,107,93,14,0
2022-01-26,Hai Phong City,Le Chan District,21,58,48,10,0
2022-01-26,Hai Phong City,Le Chan District,22,2,0,2,2
2022-01-26,Hai Phong City,Ngo Quyen District,0,1,0,1,0
2022-01-26,Hai Phong City,Ngo Quyen District,6,1,1,0,0
2022-01-26,Hai Phong City,Ngo Quyen District,7,34,25,9,0
2022-01-26,Hai Phong City,Ngo Quyen District,8,78,68,10,1
2022-01-26,Hai Phong City,Ngo Quyen District,9,81,77,4,0
2022-01-26,Hai Phong City,Ngo Quyen District,10,137,113,24,1
2022-01-26,Hai Phong City,Ngo Quyen District,11,243,208,35,8
2022-01-26,Hai Phong City,Ngo Quyen District,12,180,160,20,1
2022-01-26,Hai Phong City,Ngo Quyen District,13,116,105,11,0
2022-01-26,Hai Phong City,Ngo Quyen District,14,141,125,16,1
2022-01-26,Hai Phong City,Ngo Quyen District,15,135,128,7,0
2022-01-26,Hai Phong City,Ngo Quyen District,16,142,129,13,2
2022-01-26,Hai Phong City,Ngo Quyen District,17,135,119,16,1
2022-01-26,Hai Phong City,Ngo Quyen District,18,181,162,19,2
2022-01-26,Hai Phong City,Ngo Quyen District,19,127,112,15,1
2022-01-26,Hai Phong City,Ngo Quyen District,20,116,100,16,0
2022-01-26,Hai Phong City,Ngo Quyen District,21,65,52,13,0
2022-01-26,Hai Phong City,Thuy Nguyen,13,1,0,1,1
2022-01-26,Hai Phong City,Thuy Nguyen,14,3,0,3,3
2022-01-26,Hai Phong City,Thuy Nguyen,16,1,1,0,0
2022-01-26,Hai Phong City,Thuy Nguyen,17,2,0,2,2
2022-01-26,Hai Phong City,Thuy Nguyen,18,5,0,5,5
2022-01-26,Hai Phong City,Thuy Nguyen,19,2,0,2,2
2022-01-26,Hue City,Hue City,0,3,2,1,0
2022-01-26,Hue City,Hue City,2,2,1,1,0
2022-01-26,Hue City,Hue City,3,5,2,3,0
2022-01-26,Hue City,Hue City,4,1,1,0,0
2022-01-26,Hue City,Hue City,5,1,0,1,0
2022-01-26,Hue City,Hue City,6,39,35,4,0
2022-01-26,Hue City,Hue City,7,172,159,13,0
2022-01-26,Hue City,Hue City,8,237,229,8,0
2022-01-26,Hue City,Hue City,9,209,194,15,0
2022-01-26,Hue City,Hue City,10,269,249,20,0
2022-01-26,Hue City,Hue City,11,591,557,34,1
2022-01-26,Hue City,Hue City,12,419,400,19,3
2022-01-26,Hue City,Hue City,13,238,228,10,0
2022-01-26,Hue City,Hue City,14,253,235,18,0
2022-01-26,Hue City,Hue City,15,279,258,21,0
2022-01-26,Hue City,Hue City,16,307,285,22,0
2022-01-26,Hue City,Hue City,17,349,322,27,0
2022-01-26,Hue City,Hue City,18,479,445,34,0
2022-01-26,Hue City,Hue City,19,380,350,30,0
2022-01-26,Hue City,Hue City,20,293,269,24,2
2022-01-26,Hue City,Hue City,21,176,151,25,0
2022-01-26,Hue City,Hue City,22,1,0,1,0
2022-01-26,Hue City,Hue City,23,1,1,0,0
2022-01-26,Hue City,Huong Thuy,7,1,1,0,0
2022-01-26,Hue City,Huong Thuy,15,3,0,3,0
2022-01-26,Hue City,Huong Thuy,16,1,0,1,1
2022-01-26,Hue City,Huong Thuy,18,2,2,0,0
2022-01-26,Hue City,Huong Thuy,19,2,2,0,0
2022-01-26,Hue City,Huong Thuy,20,1,1,0,0
2022-01-26,Hue City,Huong Tra,15,1,1,0,0
2022-01-26,Hue City,Phu Vang,7,1,1,0,0
2022-01-26,Hue City,Phu Vang,11,3,3,0,0
2022-01-26,Hue City,Phu Vang,14,1,1,0,0
2022-01-26,Hue City,Phu Vang,15,2,1,1,1
2022-01-26,Hue City,Phu Vang,17,2,1,1,0
2022-01-26,Hue City,Phu Vang,18,3,2,1,0
2022-01-26,Hue City,Phu Vang,19,5,3,2,0
2022-01-26,Hue City,Phu Vang,20,1,1,0,0
2022-01-26,Hue City,Phu Vang,21,1,1,0,0
2022-01-26,Vung Tau,Ba Ria City,9,7,1,6,6
2022-01-26,Vung Tau,Ba Ria City,10,11,8,3,1
2022-01-26,Vung Tau,Ba Ria City,11,4,3,1,1
2022-01-26,Vung Tau,Ba Ria City,12,10,6,4,2
2022-01-26,Vung Tau,Ba Ria City,13,2,2,0,0
2022-01-26,Vung Tau,Ba Ria City,14,4,3,1,1
2022-01-26,Vung Tau,Ba Ria City,15,8,5,3,1
2022-01-26,Vung Tau,Ba Ria City,16,7,6,1,1
2022-01-26,Vung Tau,Ba Ria City,17,7,3,4,4
2022-01-26,Vung Tau,Ba Ria City,18,8,2,6,5
2022-01-26,Vung Tau,Ba Ria City,19,7,3,4,3
2022-01-26,Vung Tau,Ba Ria City,20,6,0,6,5
2022-01-26,Vung Tau,Ba Ria City,21,2,0,2,2
2022-01-26,Vung Tau,Tan Thanh,11,1,0,1,1
2022-01-26,Vung Tau,Tan Thanh,13,1,0,1,1
2022-01-26,Vung Tau,Vung Tau City,0,1,1,0,0
2022-01-26,Vung Tau,Vung Tau City,1,1,1,0,0
2022-01-26,Vung Tau,Vung Tau City,6,21,19,2,0
2022-01-26,Vung Tau,Vung Tau City,7,82,72,10,1
2022-01-26,Vung Tau,Vung Tau City,8,118,110,8,0
2022-01-26,Vung Tau,Vung Tau City,9,152,148,4,0
2022-01-26,Vung Tau,Vung Tau City,10,185,177,8,0
2022-01-26,Vung Tau,Vung Tau City,11,368,341,27,1
2022-01-26,Vung Tau,Vung Tau City,12,271,253,18,0
2022-01-26,Vung Tau,Vung Tau City,13,181,166,15,2
2022-01-26,Vung Tau,Vung Tau City,14,230,219,11,0
2022-01-26,Vung Tau,Vung Tau City,15,166,160,6,0
2022-01-26,Vung Tau,Vung Tau City,16,174,159,15,3
2022-01-26,Vung Tau,Vung Tau City,17,190,173,17,0
2022-01-26,Vung Tau,Vung Tau City,18,266,251,15,0
2022-01-26,Vung Tau,Vung Tau City,19,240,226,14,0
2022-01-26,Vung Tau,Vung Tau City,20,166,149,17,2
2022-01-26,Vung Tau,Vung Tau City,21,77,59,18,1
2022-01-26,Vung Tau,Vung Tau City,22,2,1,1,0
2022-01-26,Vung Tau,Vung Tau City,23,1,0,1,0
2022-01-27,Binh Duong,Ben Cat,12,3,0,3,3
2022-01-27,Binh Duong,Ben Cat,13,1,0,1,1
2022-01-27,Binh Duong,Di An,8,2,1,1,0
2022-01-27,Binh Duong,Di An,9,12,7,5,1
2022-01-27,Binh Duong,Di An,10,18,11,7,6
2022-01-27,Binh Duong,Di An,11,25,16,9,7
2022-01-27,Binh Duong,Di An,12,25,17,8,7
2022-01-27,Binh Duong,Di An,13,25,15,10,7
2022-01-27,Binh Duong,Di An,14,23,15,8,7
2022-01-27,Binh Duong,Di An,15,5,4,1,1
2022-01-27,Binh Duong,Di An,16,16,7,9,5
2022-01-27,Binh Duong,Di An,17,16,8,8,7
2022-01-27,Binh Duong,Di An,18,13,7,6,4
2022-01-27,Binh Duong,Di An,19,6,5,1,0
2022-01-27,Binh Duong,Di An,20,7,4,3,3
2022-01-27,Binh Duong,Di An,21,2,1,1,0
2022-01-27,Binh Duong,Tan Uyen,8,1,1,0,0
2022-01-27,Binh Duong,Tan Uyen,11,3,2,1,1
2022-01-27,Binh Duong,Tan Uyen,12,1,1,0,0
2022-01-27,Binh Duong,Tan Uyen,14,1,0,1,1
2022-01-27,Binh Duong,Tan Uyen,17,1,1,0,0
2022-01-27,Binh Duong,Tan Uyen,21,1,0,1,1
2022-01-27,Binh Duong,Thu Dau Mot Town,5,1,0,1,0
2022-01-27,Binh Duong,Thu Dau Mot Town,6,33,25,8,4
2022-01-27,Binh Duong,Thu Dau Mot Town,7,87,80,7,1
2022-01-27,Binh Duong,Thu Dau Mot Town,8,153,142,11,1
2022-01-27,Binh Duong,Thu Dau Mot Town,9,204,172,32,8
2022-01-27,Binh Duong,Thu Dau Mot Town,10,307,271,36,12
2022-01-27,Binh Duong,Thu Dau Mot Town,11,529,473,56,22
2022-01-27,Binh Duong,Thu Dau Mot Town,12,435,405,30,10
2022-01-27,Binh Duong,Thu Dau Mot Town,13,363,341,22,3
2022-01-27,Binh Duong,Thu Dau Mot Town,14,305,282,23,2
2022-01-27,Binh Duong,Thu Dau Mot Town,15,233,210,23,4
2022-01-27,Binh Duong,Thu Dau Mot Town,16,210,194,16,0
2022-01-27,Binh Duong,Thu Dau Mot Town,17,256,236,20,2
2022-01-27,Binh Duong,Thu Dau Mot Town,18,316,294,22,1
2022-01-27,Binh Duong,Thu Dau Mot Town,19,280,263,17,0
2022-01-27,Binh Duong,Thu Dau Mot Town,20,205,177,28,1
2022-01-27,Binh Duong,Thu Dau Mot Town,21,118,92,26,10
2022-01-27,Binh Duong,Thu Dau Mot Town,22,1,1,0,0
2022-01-27,Binh Duong,Thu Dau Mot Town,23,3,2,1,0
2022-01-27,Binh Duong,Thuan An,7,5,4,1,0
2022-01-27,Binh Duong,Thuan An,8,18,7,11,7
2022-01-27,Binh Duong,Thuan An,9,28,23,5,3
2022-01-27,Binh Duong,Thuan An,10,58,33,25,18
2022-01-27,Binh Duong,Thuan An,11,64,43,21,13
2022-01-27,Binh Duong,Thuan An,12,70,46,24,19
2022-01-27,Binh Duong,Thuan An,13,52,39,13,9
2022-01-27,Binh Duong,Thuan An,14,37,24,13,10
2022-01-27,Binh Duong,Thuan An,15,32,24,8,7
2022-01-27,Binh Duong,Thuan An,16,21,12,9,8
2022-01-27,Binh Duong,Thuan An,17,32,19,13,10
2022-01-27,Binh Duong,Thuan An,18,24,16,8,8
2022-01-27,Binh Duong,Thuan An,19,32,21,11,9
2022-01-27,Binh Duong,Thuan An,20,25,11,14,7
2022-01-27,Binh Duong,Thuan An,21,15,5,10,8
2022-01-27,Can Tho City,Binh Thuy District,6,1,1,0,0
2022-01-27,Can Tho City,Binh Thuy District,7,2,1,1,0
2022-01-27,Can Tho City,Binh Thuy District,8,1,1,0,0
2022-01-27,Can Tho City,Binh Thuy District,9,13,10,3,0
2022-01-27,Can Tho City,Binh Thuy District,10,7,7,0,0
2022-01-27,Can Tho City,Binh Thuy District,11,7,7,0,0
2022-01-27,Can Tho City,Binh Thuy District,12,6,5,1,0
2022-01-27,Can Tho City,Binh Thuy District,13,12,12,0,0
2022-01-27,Can Tho City,Binh Thuy District,14,6,5,1,0
2022-01-27,Can Tho City,Binh Thuy District,15,14,13,1,0
2022-01-27,Can Tho City,Binh Thuy District,16,9,7,2,1
2022-01-27,Can Tho City,Binh Thuy District,17,6,5,1,0
2022-01-27,Can Tho City,Binh Thuy District,18,5,5,0,0
2022-01-27,Can Tho City,Binh Thuy District,19,7,7,0,0
2022-01-27,Can Tho City,Binh Thuy District,20,4,3,1,0
2022-01-27,Can Tho City,Binh Thuy District,21,5,4,1,0
2022-01-27,Can Tho City,Cai Rang District,7,4,2,2,0
2022-01-27,Can Tho City,Cai Rang District,8,3,3,0,0
2022-01-27,Can Tho City,Cai Rang District,9,3,3,0,0
2022-01-27,Can Tho City,Cai Rang District,10,4,4,0,0
2022-01-27,Can Tho City,Cai Rang District,11,7,7,0,0
2022-01-27,Can Tho City,Cai Rang District,12,2,2,0,0
2022-01-27,Can Tho City,Cai Rang District,13,5,5,0,0
2022-01-27,Can Tho City,Cai Rang District,14,4,4,0,0
2022-01-27,Can Tho City,Cai Rang District,15,10,9,1,0
2022-01-27,Can Tho City,Cai Rang District,16,6,6,0,0
2022-01-27,Can Tho City,Cai Rang District,17,6,5,1,0
2022-01-27,Can Tho City,Cai Rang District,18,7,7,0,0
2022-01-27,Can Tho City,Cai Rang District,19,1,1,0,0
2022-01-27,Can Tho City,Cai Rang District,20,4,2,2,0
2022-01-27,Can Tho City,Cai Rang District,21,3,2,1,0
2022-01-27,Can Tho City,Cai Rang District,23,2,1,1,0
2022-01-27,Can Tho City,Ninh Kieu District,0,1,0,1,0
2022-01-27,Can Tho City,Ninh Kieu District,1,3,3,0,0
2022-01-27,Can Tho City,Ninh Kieu District,3,3,1,2,0
2022-01-27,Can Tho City,Ninh Kieu District,5,1,1,0,0
2022-01-27,Can Tho City,Ninh Kieu District,6,37,34,3,0
2022-01-27,Can Tho City,Ninh Kieu District,7,84,78,6,0
2022-01-27,Can Tho City,Ninh Kieu District,8,168,158,10,0
2022-01-27,Can Tho City,Ninh Kieu District,9,158,147,11,0
2022-01-27,Can Tho City,Ninh Kieu District,10,280,266,14,0
2022-01-27,Can Tho City,Ninh Kieu District,11,446,426,20,0
2022-01-27,Can Tho City,Ninh Kieu District,12,296,288,8,0
2022-01-27,Can Tho City,Ninh Kieu District,13,308,295,13,0
2022-01-27,Can Tho City,Ninh Kieu District,14,237,220,17,0
2022-01-27,Can Tho City,Ninh Kieu District,15,204,195,9,0
2022-01-27,Can Tho City,Ninh Kieu District,16,176,167,9,0
2022-01-27,Can Tho City,Ninh Kieu District,17,215,206,9,0
2022-01-27,Can Tho City,Ninh Kieu District,18,249,229,20,0
2022-01-27,Can Tho City,Ninh Kieu District,19,231,217,14,0
2022-01-27,Can Tho City,Ninh Kieu District,20,176,156,20,0
2022-01-27,Can Tho City,Ninh Kieu District,21,88,79,9,0
2022-01-27,Can Tho City,Ninh Kieu District,22,2,0,2,0
2022-01-27,Can Tho City,Ninh Kieu District,23,2,2,0,0
2022-01-27,Dong Nai,Bien Hoa City,0,1,0,1,0
2022-01-27,Dong Nai,Bien Hoa City,1,1,0,1,0
2022-01-27,Dong Nai,Bien Hoa City,3,1,1,0,0
2022-01-27,Dong Nai,Bien Hoa City,5,1,1,0,0
2022-01-27,Dong Nai,Bien Hoa City,6,35,22,13,6
2022-01-27,Dong Nai,Bien Hoa City,7,113,92,21,9
2022-01-27,Dong Nai,Bien Hoa City,8,244,219,25,2
2022-01-27,Dong Nai,Bien Hoa City,9,351,320,31,5
2022-01-27,Dong Nai,Bien Hoa City,10,631,575,56,15
2022-01-27,Dong Nai,Bien Hoa City,11,976,858,118,40
2022-01-27,Dong Nai,Bien Hoa City,12,807,744,63,6
2022-01-27,Dong Nai,Bien Hoa City,13,733,686,47,8
2022-01-27,Dong Nai,Bien Hoa City,14,562,522,40,7
2022-01-27,Dong Nai,Bien Hoa City,15,437,405,32,5
2022-01-27,Dong Nai,Bien Hoa City,16,395,358,37,10
2022-01-27,Dong Nai,Bien Hoa City,17,434,405,29,9
2022-01-27,Dong Nai,Bien Hoa City,18,534,487,47,9
2022-01-27,Dong Nai,Bien Hoa City,19,495,437,58,15
2022-01-27,Dong Nai,Bien Hoa City,20,419,351,68,15
2022-01-27,Dong Nai,Bien Hoa City,21,220,160,60,25
2022-01-27,Dong Nai,Long Thanh,13,1,0,1,1
2022-01-27,Dong Nai,Long Thanh,14,1,0,1,1
2022-01-27,Dong Nai,Long Thanh,19,1,0,1,1
2022-01-27,Dong Nai,Thong Nhat,7,2,1,1,0
2022-01-27,Dong Nai,Thong Nhat,8,2,2,0,0
2022-01-27,Dong Nai,Thong Nhat,12,1,1,0,0
2022-01-27,Dong Nai,Thong Nhat,13,1,1,0,0
2022-01-27,Dong Nai,Thong Nhat,17,4,1,3,0
2022-01-27,Dong Nai,Trang Bom,10,1,0,1,1
2022-01-27,Dong Nai,Trang Bom,14,3,0,3,0
2022-01-27,Dong Nai,Trang Bom,18,1,0,1,1
2022-01-27,Hai Phong City,An Duong,7,2,2,0,0
2022-01-27,Hai Phong City,An Duong,8,2,0,2,1
2022-01-27,Hai Phong City,An Duong,9,2,1,1,1
2022-01-27,Hai Phong City,An Duong,10,3,2,1,1
2022-01-27,Hai Phong City,An Duong,11,4,3,1,0
2022-01-27,Hai Phong City,An Duong,12,2,0,2,1
2022-01-27,Hai Phong City,An Duong,13,1,0,1,1
2022-01-27,Hai Phong City,An Duong,14,1,0,1,1
2022-01-27,Hai Phong City,An Duong,15,1,1,0,0
2022-01-27,Hai Phong City,An Duong,16,5,4,1,0
2022-01-27,Hai Phong City,An Duong,17,3,2,1,0
2022-01-27,Hai Phong City,An Duong,19,3,0,3,2
2022-01-27,Hai Phong City,An Duong,20,1,1,0,0
2022-01-27,Hai Phong City,Do Son District,9,1,0,1,1
2022-01-27,Hai Phong City,Do Son District,11,1,0,1,0
2022-01-27,Hai Phong City,Do Son District,15,1,0,1,1
2022-01-27,Hai Phong City,Hai An District,7,7,6,1,0
2022-01-27,Hai Phong City,Hai An District,8,7,6,1,0
2022-01-27,Hai Phong City,Hai An District,9,8,7,1,1
2022-01-27,Hai Phong City,Hai An District,10,18,13,5,0
2022-01-27,Hai Phong City,Hai An District,11,37,30,7,0
2022-01-27,Hai Phong City,Hai An District,12,22,17,5,0
2022-01-27,Hai Phong City,Hai An District,13,13,12,1,0
2022-01-27,Hai Phong City,Hai An District,14,12,10,2,1
2022-01-27,Hai Phong City,Hai An District,15,15,11,4,0
2022-01-27,Hai Phong City,Hai An District,16,21,15,6,2
2022-01-27,Hai Phong City,Hai An District,17,10,10,0,0
2022-01-27,Hai Phong City,Hai An District,18,23,18,5,0
2022-01-27,Hai Phong City,Hai An District,19,21,17,4,1
2022-01-27,Hai Phong City,Hai An District,20,16,10,6,3
2022-01-27,Hai Phong City,Hai An District,21,11,7,4,1
2022-01-27,Hai Phong City,Hong Bang District,7,25,16,9,5
2022-01-27,Hai Phong City,Hong Bang District,8,22,21,1,1
2022-01-27,Hai Phong City,Hong Bang District,9,34,30,4,0
2022-01-27,Hai Phong City,Hong Bang District,10,47,43,4,0
2022-01-27,Hai Phong City,Hong Bang District,11,113,95,18,7
2022-01-27,Hai Phong City,Hong Bang District,12,61,52,9,1
2022-01-27,Hai Phong City,Hong Bang District,13,36,32,4,0
2022-01-27,Hai Phong City,Hong Bang District,14,49,42,7,3
2022-01-27,Hai Phong City,Hong Bang District,15,57,43,14,4
2022-01-27,Hai Phong City,Hong Bang District,16,37,35,2,1
2022-01-27,Hai Phong City,Hong Bang District,17,36,32,4,0
2022-01-27,Hai Phong City,Hong Bang District,18,63,60,3,0
2022-01-27,Hai Phong City,Hong Bang District,19,64,52,12,2
2022-01-27,Hai Phong City,Hong Bang District,20,48,37,11,5
2022-01-27,Hai Phong City,Hong Bang District,21,14,8,6,1
2022-01-27,Hai Phong City,Kien An District,8,3,2,1,1
2022-01-27,Hai Phong City,Kien An District,9,8,3,5,5
2022-01-27,Hai Phong City,Kien An District,10,9,3,6,6
2022-01-27,Hai Phong City,Kien An District,11,7,4,3,2
2022-01-27,Hai Phong City,Kien An District,12,6,5,1,0
2022-01-27,Hai Phong City,Kien An District,13,4,2,2,1
2022-01-27,Hai Phong City,Kien An District,14,3,3,0,0
2022-01-27,Hai Phong City,Kien An District,15,5,1,4,3
2022-01-27,Hai Phong City,Kien An District,16,7,5,2,2
2022-01-27,Hai Phong City,Kien An District,17,6,4,2,0
2022-01-27,Hai Phong City,Kien An District,18,6,5,1,1
2022-01-27,Hai Phong City,Kien An District,19,3,2,1,0
2022-01-27,Hai Phong City,Kien An District,20,5,2,3,2
2022-01-27,Hai Phong City,Kien An District,21,1,1,0,0
2022-01-27,Hai Phong City,Le Chan District,0,1,1,0,0
2022-01-27,Hai Phong City,Le Chan District,2,1,1,0,0
2022-01-27,Hai Phong City,Le Chan District,6,1,1,0,0
2022-01-27,Hai Phong City,Le Chan District,7,31,28,3,2
2022-01-27,Hai Phong City,Le Chan District,8,54,50,4,0
2022-01-27,Hai Phong City,Le Chan District,9,76,65,11,1
2022-01-27,Hai Phong City,Le Chan District,10,139,115,24,2
2022-01-27,Hai Phong City,Le Chan District,11,253,218,35,6
2022-01-27,Hai Phong City,Le Chan District,12,230,205,25,0
2022-01-27,Hai Phong City,Le Chan District,13,102,93,9,1
2022-01-27,Hai Phong City,Le Chan District,14,108,92,16,5
2022-01-27,Hai Phong City,Le Chan District,15,125,106,19,4
2022-01-27,Hai Phong City,Le Chan District,16,129,114,15,2
2022-01-27,Hai Phong City,Le Chan District,17,125,111,14,1
2022-01-27,Hai Phong City,Le Chan District,18,192,170,22,8
2022-01-27,Hai Phong City,Le Chan District,19,187,161,26,6
2022-01-27,Hai Phong City,Le Chan District,20,108,88,20,5
2022-01-27,Hai Phong City,Le Chan District,21,51,41,10,0
2022-01-27,Hai Phong City,Le Chan District,22,2,2,0,0
2022-01-27,Hai Phong City,Le Chan District,23,1,0,1,0
2022-01-27,Hai Phong City,Ngo Quyen District,2,2,2,0,0
2022-01-27,Hai Phong City,Ngo Quyen District,4,1,0,1,0
2022-01-27,Hai Phong City,Ngo Quyen District,6,1,0,1,0
2022-01-27,Hai Phong City,Ngo Quyen District,7,45,34,11,5
2022-01-27,Hai Phong City,Ngo Quyen District,8,65,55,10,0
2022-01-27,Hai Phong City,Ngo Quyen District,9,72,63,9,0
2022-01-27,Hai Phong City,Ngo Quyen District,10,128,117,11,0
2022-01-27,Hai Phong City,Ngo Quyen District,11,226,187,39,7
2022-01-27,Hai Phong City,Ngo Quyen District,12,176,153,23,0
2022-01-27,Hai Phong City,Ngo Quyen District,13,102,92,10,0
2022-01-27,Hai Phong City,Ngo Quyen District,14,114,106,8,0
2022-01-27,Hai Phong City,Ngo Quyen District,15,146,135,11,3
2022-01-27,Hai Phong City,Ngo Quyen District,16,121,114,7,1
2022-01-27,Hai Phong City,Ngo Quyen District,17,120,102,18,0
2022-01-27,Hai Phong City,Ngo Quyen District,18,170,148,22,6
2022-01-27,Hai Phong City,Ngo Quyen District,19,160,126,34,8
2022-01-27,Hai Phong City,Ngo Quyen District,20,127,105,22,2
2022-01-27,Hai Phong City,Ngo Quyen District,21,67,50,17,0
2022-01-27,Hai Phong City,Ngo Quyen District,22,2,1,1,0
2022-01-27,Hai Phong City,Thuy Nguyen,10,1,1,0,0
2022-01-27,Hai Phong City,Thuy Nguyen,16,7,0,7,2
2022-01-27,Hai Phong City,Thuy Nguyen,17,3,1,2,1
2022-01-27,Hai Phong City,Thuy Nguyen,18,1,0,1,1
2022-01-27,Hue City,Hue City,0,2,2,0,0
2022-01-27,Hue City,Hue City,2,1,1,0,0
2022-01-27,Hue City,Hue City,4,1,0,1,0
2022-01-27,Hue City,Hue City,6,37,34,3,1
2022-01-27,Hue City,Hue City,7,125,116,9,0
2022-01-27,Hue City,Hue City,8,210,200,10,0
2022-01-27,Hue City,Hue City,9,197,174,23,0
2022-01-27,Hue City,Hue City,10,209,194,15,0
2022-01-27,Hue City,Hue City,11,445,418,27,2
2022-01-27,Hue City,Hue City,12,353,319,34,0
2022-01-27,Hue City,Hue City,13,206,198,8,0
2022-01-27,Hue City,Hue City,14,215,209,6,0
2022-01-27,Hue City,Hue City,15,243,228,15,0
2022-01-27,Hue City,Hue City,16,237,219,18,2
2022-01-27,Hue City,Hue City,17,290,265,25,0
2022-01-27,Hue City,Hue City,18,374,345,29,1
2022-01-27,Hue City,Hue City,19,299,274,25,0
2022-01-27,Hue City,Hue City,20,268,238,30,3
2022-01-27,Hue City,Hue City,21,137,115,22,2
2022-01-27,Hue City,Hue City,22,4,0,4,0
2022-01-27,Hue City,Hue City,23,2,0,2,0
2022-01-27,Hue City,Huong Thuy,14,1,1,0,0
2022-01-27,Hue City,Huong Thuy,17,2,1,1,1
2022-01-27,Hue City,Huong Thuy,18,3,3,0,0
2022-01-27,Hue City,Huong Thuy,20,1,0,1,1
2022-01-27,Hue City,Huong Tra,7,1,0,1,1
2022-01-27,Hue City,Huong Tra,15,1,1,0,0
2022-01-27,Hue City,Phu Vang,8,1,1,0,0
2022-01-27,Hue City,Phu Vang,9,2,2,0,0
2022-01-27,Hue City,Phu Vang,12,1,1,0,0
2022-01-27,Hue City,Phu Vang,14,1,1,0,0
2022-01-27,Hue City,Phu Vang,16,1,1,0,0
2022-01-27,Hue City,Phu Vang,17,2,2,0,0
2022-01-27,Hue City,Phu Vang,18,3,3,0,0
2022-01-27,Hue City,Phu Vang,19,2,2,0,0
2022-01-27,Vung Tau,Ba Ria City,8,4,0,4,3
2022-01-27,Vung Tau,Ba Ria City,9,2,2,0,0
2022-01-27,Vung Tau,Ba Ria City,10,8,6,2,2
2022-01-27,Vung Tau,Ba Ria City,11,2,0,2,2
2022-01-27,Vung Tau,Ba Ria City,12,5,4,1,1
2022-01-27,Vung Tau,Ba Ria City,13,2,0,2,2
2022-01-27,Vung Tau,Ba Ria City,14,8,4,4,4
2022-01-27,Vung Tau,Ba Ria City,15,7,3,4,3
2022-01-27,Vung Tau,Ba Ria City,16,4,0,4,4
2022-01-27,Vung Tau,Ba Ria City,17,9,3,6,3
2022-01-27,Vung Tau,Ba Ria City,18,6,3,3,2
2022-01-27,Vung Tau,Ba Ria City,19,5,2,3,2
2022-01-27,Vung Tau,Ba Ria City,20,7,0,7,7
2022-01-27,Vung Tau,Ba Ria City,21,1,0,1,1
2022-01-27,Vung Tau,Vung Tau City,2,1,1,0,0
2022-01-27,Vung Tau,Vung Tau City,5,4,2,2,1
2022-01-27,Vung Tau,Vung Tau City,6,22,17,5,2
2022-01-27,Vung Tau,Vung Tau City,7,69,65,4,0
2022-01-27,Vung Tau,Vung Tau City,8,141,130,11,1
2022-01-27,Vung Tau,Vung Tau City,9,129,121,8,1
2022-01-27,Vung Tau,Vung Tau City,10,176,166,10,1
2022-01-27,Vung Tau,Vung Tau City,11,288,268,20,1
2022-01-27,Vung Tau,Vung Tau City,12,252,233,19,0
2022-01-27,Vung Tau,Vung Tau City,13,188,177,11,1
2022-01-27,Vung Tau,Vung Tau City,14,188,169,19,1
2022-01-27,Vung Tau,Vung Tau City,15,142,132,10,1
2022-01-27,Vung Tau,Vung Tau City,16,146,133,13,3
2022-01-27,Vung Tau,Vung Tau City,17,201,180,21,3
2022-01-27,Vung Tau,Vung Tau City,18,247,231,16,1
2022-01-27,Vung Tau,Vung Tau City,19,222,201,21,0
2022-01-27,Vung Tau,Vung Tau City,20,136,122,14,0
2022-01-27,Vung Tau,Vung Tau City,21,79,68,11,3
2022-01-27,Vung Tau,Vung Tau City,23,1,1,0,0
2022-01-28,Binh Duong,Ben Cat,12,1,1,0,0
2022-01-28,Binh Duong,Ben Cat,13,1,0,1,1
2022-01-28,Binh Duong,Ben Cat,15,1,1,0,0
2022-01-28,Binh Duong,Ben Cat,17,1,0,1,0
2022-01-28,Binh Duong,Di An,7,3,2,1,1
2022-01-28,Binh Duong,Di An,8,5,2,3,1
2022-01-28,Binh Duong,Di An,9,12,7,5,4
2022-01-28,Binh Duong,Di An,10,16,8,8,7
2022-01-28,Binh Duong,Di An,11,18,7,11,10
2022-01-28,Binh Duong,Di An,12,28,17,11,8
2022-01-28,Binh Duong,Di An,13,26,16,10,8
2022-01-28,Binh Duong,Di An,14,17,11,6,5
2022-01-28,Binh Duong,Di An,15,20,8,12,9
2022-01-28,Binh Duong,Di An,16,13,11,2,1
2022-01-28,Binh Duong,Di An,17,14,8,6,4
2022-01-28,Binh Duong,Di An,18,10,2,8,7
2022-01-28,Binh Duong,Di An,19,17,2,15,12
2022-01-28,Binh Duong,Di An,20,17,2,15,13
2022-01-28,Binh Duong,Di An,21,4,1,3,3
2022-01-28,Binh Duong,Tan Uyen,7,1,0,1,1
2022-01-28,Binh Duong,Tan Uyen,10,2,0,2,2
2022-01-28,Binh Duong,Tan Uyen,11,5,1,4,3
2022-01-28,Binh Duong,Tan Uyen,12,1,0,1,1
2022-01-28,Binh Duong,Tan Uyen,13,1,0,1,0
2022-01-28,Binh Duong,Tan Uyen,14,1,0,1,0
2022-01-28,Binh Duong,Tan Uyen,18,1,0,1,1
2022-01-28,Binh Duong,Thu Dau Mot Town,0,1,0,1,0
2022-01-28,Binh Duong,Thu Dau Mot Town,2,1,0,1,0
2022-01-28,Binh Duong,Thu Dau Mot Town,6,28,24,4,4
2022-01-28,Binh Duong,Thu Dau Mot Town,7,72,65,7,1
2022-01-28,Binh Duong,Thu Dau Mot Town,8,142,124,18,7
2022-01-28,Binh Duong,Thu Dau Mot Town,9,212,184,28,4
2022-01-28,Binh Duong,Thu Dau Mot Town,10,348,308,40,10
2022-01-28,Binh Duong,Thu Dau Mot Town,11,556,485,71,32
2022-01-28,Binh Duong,Thu Dau Mot Town,12,443,385,58,13
2022-01-28,Binh Duong,Thu Dau Mot Town,13,352,317,35,8
2022-01-28,Binh Duong,Thu Dau Mot Town,14,297,274,23,5
2022-01-28,Binh Duong,Thu Dau Mot Town,15,206,190,16,1
2022-01-28,Binh Duong,Thu Dau Mot Town,16,236,213,23,4
2022-01-28,Binh Duong,Thu Dau Mot Town,17,282,260,22,10
2022-01-28,Binh Duong,Thu Dau Mot Town,18,292,250,42,12
2022-01-28,Binh Duong,Thu Dau Mot Town,19,282,239,43,11
2022-01-28,Binh Duong,Thu Dau Mot Town,20,234,182,52,27
2022-01-28,Binh Duong,Thu Dau Mot Town,21,119,93,26,5
2022-01-28,Binh Duong,Thuan An,6,2,1,1,1
2022-01-28,Binh Duong,Thuan An,7,2,1,1,1
2022-01-28,Binh Duong,Thuan An,8,6,1,5,2
2022-01-28,Binh Duong,Thuan An,9,52,16,36,31
2022-01-28,Binh Duong,Thuan An,10,62,28,34,28
2022-01-28,Binh Duong,Thuan An,11,110,32,78,64
2022-01-28,Binh Duong,Thuan An,12,85,32,53,47
2022-01-28,Binh Duong,Thuan An,13,68,33,35,30
2022-01-28,Binh Duong,Thuan An,14,62,32,30,27
2022-01-28,Binh Duong,Thuan An,15,44,19,25,17
2022-01-28,Binh Duong,Thuan An,16,26,19,7,7
2022-01-28,Binh Duong,Thuan An,17,37,17,20,12
2022-01-28,Binh Duong,Thuan An,18,28,17,11,4
2022-01-28,Binh Duong,Thuan An,19,32,16,16,13
2022-01-28,Binh Duong,Thuan An,20,38,11,27,19
2022-01-28,Binh Duong,Thuan An,21,13,6,7,6
2022-01-28,Can Tho City,Binh Thuy District,6,2,0,2,1
2022-01-28,Can Tho City,Binh Thuy District,7,2,2,0,0
2022-01-28,Can Tho City,Binh Thuy District,8,1,1,0,0
2022-01-28,Can Tho City,Binh Thuy District,9,3,3,0,0
2022-01-28,Can Tho City,Binh Thuy District,10,3,3,0,0
2022-01-28,Can Tho City,Binh Thuy District,11,13,13,0,0
2022-01-28,Can Tho City,Binh Thuy District,12,15,12,3,0
2022-01-28,Can Tho City,Binh Thuy District,13,13,12,1,0
2022-01-28,Can Tho City,Binh Thuy District,14,7,7,0,0
2022-01-28,Can Tho City,Binh Thuy District,15,7,7,0,0
2022-01-28,Can Tho City,Binh Thuy District,16,4,3,1,0
2022-01-28,Can Tho City,Binh Thuy District,17,5,5,0,0
2022-01-28,Can Tho City,Binh Thuy District,18,8,7,1,0
2022-01-28,Can Tho City,Binh Thuy District,19,5,5,0,0
2022-01-28,Can Tho City,Binh Thuy District,20,7,5,2,0
2022-01-28,Can Tho City,Cai Rang District,6,2,2,0,0
2022-01-28,Can Tho City,Cai Rang District,7,1,1,0,0
2022-01-28,Can Tho City,Cai Rang District,8,6,5,1,0
2022-01-28,Can Tho City,Cai Rang District,9,2,1,1,0
2022-01-28,Can Tho City,Cai Rang District,10,8,8,0,0
2022-01-28,Can Tho City,Cai Rang District,11,13,13,0,0
2022-01-28,Can Tho City,Cai Rang District,12,3,3,0,0
2022-01-28,Can Tho City,Cai Rang District,13,6,6,0,0
2022-01-28,Can Tho City,Cai Rang District,14,4,4,0,0
2022-01-28,Can Tho City,Cai Rang District,15,4,3,1,0
2022-01-28,Can Tho City,Cai Rang District,16,3,3,0,0
2022-01-28,Can Tho City,Cai Rang District,17,8,8,0,0
2022-01-28,Can Tho City,Cai Rang District,18,8,6,2,0
2022-01-28,Can Tho City,Cai Rang District,19,6,6,0,0
2022-01-28,Can Tho City,Cai Rang District,20,8,6,2,2
2022-01-28,Can Tho City,Cai Rang District,21,3,3,0,0
2022-01-28,Can Tho City,Ninh Kieu District,0,4,2,2,0
2022-01-28,Can Tho City,Ninh Kieu District,1,1,1,0,0
2022-01-28,Can Tho City,Ninh Kieu District,2,1,1,0,0
2022-01-28,Can Tho City,Ninh Kieu District,3,2,0,2,0
2022-01-28,Can Tho City,Ninh Kieu District,4,1,1,0,0
2022-01-28,Can Tho City,Ninh Kieu District,5,2,2,0,0
2022-01-28,Can Tho City,Ninh Kieu District,6,23,23,0,0
2022-01-28,Can Tho City,Ninh Kieu District,7,104,100,4,0
2022-01-28,Can Tho City,Ninh Kieu District,8,171,164,7,0
2022-01-28,Can Tho City,Ninh Kieu District,9,172,164,8,0
2022-01-28,Can Tho City,Ninh Kieu District,10,262,246,16,0
2022-01-28,Can Tho City,Ninh Kieu District,11,466,449,17,0
2022-01-28,Can Tho City,Ninh Kieu District,12,323,309,14,0
2022-01-28,Can Tho City,Ninh Kieu District,13,263,255,8,0
2022-01-28,Can Tho City,Ninh Kieu District,14,243,229,14,0
2022-01-28,Can Tho City,Ninh Kieu District,15,202,192,10,0
2022-01-28,Can Tho City,Ninh Kieu District,16,224,211,13,0
2022-01-28,Can Tho City,Ninh Kieu District,17,262,248,14,0
2022-01-28,Can Tho City,Ninh Kieu District,18,256,238,18,0
2022-01-28,Can Tho City,Ninh Kieu District,19,243,224,19,0
2022-01-28,Can Tho City,Ninh Kieu District,20,198,170,28,0
2022-01-28,Can Tho City,Ninh Kieu District,21,98,85,13,0
2022-01-28,Can Tho City,Ninh Kieu District,22,3,2,1,0
2022-01-28,Can Tho City,Ninh Kieu District,23,1,1,0,0
2022-01-28,Dong Nai,Bien Hoa City,0,4,1,3,0
2022-01-28,Dong Nai,Bien Hoa City,4,1,1,0,0
2022-01-28,Dong Nai,Bien Hoa City,5,1,1,0,0
2022-01-28,Dong Nai,Bien Hoa City,6,23,19,4,3
2022-01-28,Dong Nai,Bien Hoa City,7,127,105,22,3
2022-01-28,Dong Nai,Bien Hoa City,8,279,241,38,13
2022-01-28,Dong Nai,Bien Hoa City,9,429,386,43,6
2022-01-28,Dong Nai,Bien Hoa City,10,662,551,111,31
2022-01-28,Dong Nai,Bien Hoa City,11,1053,898,155,46
2022-01-28,Dong Nai,Bien Hoa City,12,809,728,81,17
2022-01-28,Dong Nai,Bien Hoa City,13,699,642,57,15
2022-01-28,Dong Nai,Bien Hoa City,14,547,504,43,6
2022-01-28,Dong Nai,Bien Hoa City,15,408,366,42,6
2022-01-28,Dong Nai,Bien Hoa City,16,414,358,56,14
2022-01-28,Dong Nai,Bien Hoa City,17,463,410,53,20
2022-01-28,Dong Nai,Bien Hoa City,18,537,468,69,14
2022-01-28,Dong Nai,Bien Hoa City,19,616,495,121,62
2022-01-28,Dong Nai,Bien Hoa City,20,475,371,104,52
2022-01-28,Dong Nai,Bien Hoa City,21,213,148,65,31
2022-01-28,Dong Nai,Bien Hoa City,22,2,0,2,0
2022-01-28,Dong Nai,Long Khanh,18,1,0,1,1
2022-01-28,Dong Nai,Long Thanh,11,1,0,1,1
2022-01-28,Dong Nai,Long Thanh,14,4,0,4,3
2022-01-28,Dong Nai,Long Thanh,19,2,0,2,2
2022-01-28,Dong Nai,Thong Nhat,9,2,2,0,0
2022-01-28,Dong Nai,Thong Nhat,11,1,1,0,0
2022-01-28,Dong Nai,Thong Nhat,12,1,1,0,0
2022-01-28,Dong Nai,Thong Nhat,13,1,1,0,0
2022-01-28,Dong Nai,Thong Nhat,14,2,1,1,1
2022-01-28,Dong Nai,Thong Nhat,16,3,3,0,0
2022-01-28,Dong Nai,Thong Nhat,17,1,1,0,0
2022-01-28,Dong Nai,Thong Nhat,19,1,1,0,0
2022-01-28,Dong Nai,Thong Nhat,21,3,3,0,0
2022-01-28,Dong Nai,Trang Bom,14,2,0,2,2
2022-01-28,Hai Phong City,An Duong,8,2,2,0,0
2022-01-28,Hai Phong City,An Duong,9,1,0,1,1
2022-01-28,Hai Phong City,An Duong,10,3,1,2,1
2022-01-28,Hai Phong City,An Duong,11,5,3,2,2
2022-01-28,Hai Phong City,An Duong,12,2,0,2,1
2022-01-28,Hai Phong City,An Duong,13,5,3,2,1
2022-01-28,Hai Phong City,An Duong,14,1,1,0,0
2022-01-28,Hai Phong City,An Duong,15,1,0,1,1
2022-01-28,Hai Phong City,An Duong,16,5,1,4,3
2022-01-28,Hai Phong City,An Duong,17,2,1,1,0
2022-01-28,Hai Phong City,An Duong,18,1,0,1,1
2022-01-28,Hai Phong City,An Duong,19,3,0,3,1
2022-01-28,Hai Phong City,An Duong,21,1,1,0,0
2022-01-28,Hai Phong City,Hai An District,7,10,7,3,2
2022-01-28,Hai Phong City,Hai An District,8,10,9,1,0
2022-01-28,Hai Phong City,Hai An District,9,12,10,2,0
2022-01-28,Hai Phong City,Hai An District,10,23,18,5,1
2022-01-28,Hai Phong City,Hai An District,11,34,24,10,2
2022-01-28,Hai Phong City,Hai An District,12,31,23,8,2
2022-01-28,Hai Phong City,Hai An District,13,5,5,0,0
2022-01-28,Hai Phong City,Hai An District,14,11,11,0,0
2022-01-28,Hai Phong City,Hai An District,15,13,12,1,0
2022-01-28,Hai Phong City,Hai An District,16,17,13,4,1
2022-01-28,Hai Phong City,Hai An District,17,21,16,5,1
2022-01-28,Hai Phong City,Hai An District,18,33,22,11,4
2022-01-28,Hai Phong City,Hai An District,19,18,11,7,3
2022-01-28,Hai Phong City,Hai An District,20,14,11,3,1
2022-01-28,Hai Phong City,Hai An District,21,9,7,2,1
2022-01-28,Hai Phong City,Hong Bang District,0,1,1,0,0
2022-01-28,Hai Phong City,Hong Bang District,7,8,7,1,0
2022-01-28,Hai Phong City,Hong Bang District,8,28,27,1,0
2022-01-28,Hai Phong City,Hong Bang District,9,32,24,8,0
2022-01-28,Hai Phong City,Hong Bang District,10,65,52,13,6
2022-01-28,Hai Phong City,Hong Bang District,11,135,99,36,22
2022-01-28,Hai Phong City,Hong Bang District,12,80,69,11,5
2022-01-28,Hai Phong City,Hong Bang District,13,60,44,16,5
2022-01-28,Hai Phong City,Hong Bang District,14,47,42,5,2
2022-01-28,Hai Phong City,Hong Bang District,15,45,38,7,2
2022-01-28,Hai Phong City,Hong Bang District,16,39,25,14,6
2022-01-28,Hai Phong City,Hong Bang District,17,38,28,10,5
2022-01-28,Hai Phong City,Hong Bang District,18,73,53,20,11
2022-01-28,Hai Phong City,Hong Bang District,19,63,44,19,8
2022-01-28,Hai Phong City,Hong Bang District,20,54,38,16,9
2022-01-28,Hai Phong City,Hong Bang District,21,20,13,7,5
2022-01-28,Hai Phong City,Kien An District,7,1,0,1,1
2022-01-28,Hai Phong City,Kien An District,8,6,1,5,4
2022-01-28,Hai Phong City,Kien An District,9,3,1,2,2
2022-01-28,Hai Phong City,Kien An District,10,9,3,6,3
2022-01-28,Hai Phong City,Kien An District,11,10,6,4,3
2022-01-28,Hai Phong City,Kien An District,12,7,2,5,3
2022-01-28,Hai Phong City,Kien An District,13,7,4,3,2
2022-01-28,Hai Phong City,Kien An District,15,5,4,1,0
2022-01-28,Hai Phong City,Kien An District,16,8,2,6,6
2022-01-28,Hai Phong City,Kien An District,17,5,3,2,2
2022-01-28,Hai Phong City,Kien An District,18,13,1,12,9
2022-01-28,Hai Phong City,Kien An District,19,3,1,2,1
2022-01-28,Hai Phong City,Kien An District,20,4,2,2,1
2022-01-28,Hai Phong City,Kien An District,21,1,1,0,0
2022-01-28,Hai Phong City,Le Chan District,0,1,1,0,0
2022-01-28,Hai Phong City,Le Chan District,5,2,0,2,2
2022-01-28,Hai Phong City,Le Chan District,7,23,18,5,2
2022-01-28,Hai Phong City,Le Chan District,8,58,46,12,0
2022-01-28,Hai Phong City,Le Chan District,9,74,65,9,1
2022-01-28,Hai Phong City,Le Chan District,10,143,123,20,7
2022-01-28,Hai Phong City,Le Chan District,11,272,217,55,27
2022-01-28,Hai Phong City,Le Chan District,12,223,175,48,10
2022-01-28,Hai Phong City,Le Chan District,13,152,119,33,9
2022-01-28,Hai Phong City,Le Chan District,14,124,102,22,10
2022-01-28,Hai Phong City,Le Chan District,15,120,97,23,15
2022-01-28,Hai Phong City,Le Chan District,16,114,101,13,7
2022-01-28,Hai Phong City,Le Chan District,17,137,118,19,7
2022-01-28,Hai Phong City,Le Chan District,18,206,147,59,33
2022-01-28,Hai Phong City,Le Chan District,19,178,142,36,17
2022-01-28,Hai Phong City,Le Chan District,20,140,101,39,22
2022-01-28,Hai Phong City,Le Chan District,21,80,55,25,11
2022-01-28,Hai Phong City,Le Chan District,22,1,1,0,0
2022-01-28,Hai Phong City,Ngo Quyen District,0,1,1,0,0
2022-01-28,Hai Phong City,Ngo Quyen District,6,2,0,2,1
2022-01-28,Hai Phong City,Ngo Quyen District,7,25,19,6,1
2022-01-28,Hai Phong City,Ngo Quyen District,8,69,57,12,0
2022-01-28,Hai Phong City,Ngo Quyen District,9,74,68,6,0
2022-01-28,Hai Phong City,Ngo Quyen District,10,129,111,18,4
2022-01-28,Hai Phong City,Ngo Quyen District,11,273,217,56,23
2022-01-28,Hai Phong City,Ngo Quyen District,12,213,187,26,5
2022-01-28,Hai Phong City,Ngo Quyen District,13,140,130,10,1
2022-01-28,Hai Phong City,Ngo Quyen District,14,124,109,15,7
2022-01-28,Hai Phong City,Ngo Quyen District,15,129,103,26,14
2022-01-28,Hai Phong City,Ngo Quyen District,16,129,112,17,5
2022-01-28,Hai Phong City,Ngo Quyen District,17,121,105,16,2
2022-01-28,Hai Phong City,Ngo Quyen District,18,159,120,39,16
2022-01-28,Hai Phong City,Ngo Quyen District,19,159,138,21,9
2022-01-28,Hai Phong City,Ngo Quyen District,20,131,104,27,7
2022-01-28,Hai Phong City,Ngo Quyen District,21,50,35,15,4
2022-01-28,Hai Phong City,Ngo Quyen District,22,2,0,2,0
2022-01-28,Hai Phong City,Ngo Quyen District,23,1,0,1,0
2022-01-28,Hai Phong City,Thuy Nguyen,10,2,0,2,1
2022-01-28,Hai Phong City,Thuy Nguyen,12,1,0,1,1
2022-01-28,Hai Phong City,Thuy Nguyen,13,1,1,0,0
2022-01-28,Hai Phong City,Thuy Nguyen,14,1,0,1,1
2022-01-28,Hai Phong City,Thuy Nguyen,17,2,1,1,1
2022-01-28,Hai Phong City,Thuy Nguyen,18,1,0,1,1
2022-01-28,Hai Phong City,Thuy Nguyen,19,5,0,5,5
2022-01-28,Hai Phong City,Thuy Nguyen,20,4,0,4,4
2022-01-28,Hue City,Hue City,0,1,1,0,0
2022-01-28,Hue City,Hue City,6,36,33,3,0
2022-01-28,Hue City,Hue City,7,147,130,17,1
2022-01-28,Hue City,Hue City,8,229,214,15,0
2022-01-28,Hue City,Hue City,9,190,175,15,0
2022-01-28,Hue City,Hue City,10,209,188,21,1
2022-01-28,Hue City,Hue City,11,486,448,38,0
2022-01-28,Hue City,Hue City,12,329,298,31,0
2022-01-28,Hue City,Hue City,13,229,211,18,0
2022-01-28,Hue City,Hue City,14,222,203,19,0
2022-01-28,Hue City,Hue City,15,237,208,29,2
2022-01-28,Hue City,Hue City,16,245,220,25,1
2022-01-28,Hue City,Hue City,17,269,248,21,0
2022-01-28,Hue City,Hue City,18,373,337,36,0
2022-01-28,Hue City,Hue City,19,307,291,16,1
2022-01-28,Hue City,Hue City,20,266,236,30,2
2022-01-28,Hue City,Hue City,21,128,103,25,0
2022-01-28,Hue City,Hue City,22,2,2,0,0
2022-01-28,Hue City,Hue City,23,1,1,0,0
2022-01-28,Hue City,Huong Thuy,10,1,0,1,0
2022-01-28,Hue City,Huong Thuy,11,1,0,1,0
2022-01-28,Hue City,Huong Thuy,12,3,0,3,2
2022-01-28,Hue City,Huong Thuy,13,1,0,1,0
2022-01-28,Hue City,Huong Thuy,14,2,2,0,0
2022-01-28,Hue City,Huong Thuy,15,1,1,0,0
2022-01-28,Hue City,Huong Thuy,17,2,2,0,0
2022-01-28,Hue City,Huong Thuy,18,1,1,0,0
2022-01-28,Hue City,Huong Tra,14,1,1,0,0
2022-01-28,Hue City,Phu Vang,6,2,1,1,1
2022-01-28,Hue City,Phu Vang,10,3,3,0,0
2022-01-28,Hue City,Phu Vang,11,1,1,0,0
2022-01-28,Hue City,Phu Vang,13,2,1,1,0
2022-01-28,Hue City,Phu Vang,14,1,1,0,0
2022-01-28,Hue City,Phu Vang,15,2,0,2,2
2022-01-28,Hue City,Phu Vang,16,1,0,1,1
2022-01-28,Hue City,Phu Vang,17,1,1,0,0
2022-01-28,Hue City,Phu Vang,18,1,1,0,0
2022-01-28,Hue City,Phu Vang,20,2,1,1,0
2022-01-28,Hue City,Phu Vang,21,1,1,0,0
2022-01-28,Vung Tau,Ba Ria City,7,2,0,2,2
2022-01-28,Vung Tau,Ba Ria City,8,4,0,4,4
2022-01-28,Vung Tau,Ba Ria City,9,3,1,2,2
2022-01-28,Vung Tau,Ba Ria City,10,4,3,1,0
2022-01-28,Vung Tau,Ba Ria City,11,14,4,10,8
2022-01-28,Vung Tau,Ba Ria City,12,10,3,7,5
2022-01-28,Vung Tau,Ba Ria City,13,11,4,7,6
2022-01-28,Vung Tau,Ba Ria City,14,3,2,1,0
2022-01-28,Vung Tau,Ba Ria City,15,7,4,3,0
2022-01-28,Vung Tau,Ba Ria City,16,12,2,10,9
2022-01-28,Vung Tau,Ba Ria City,17,2,1,1,1
2022-01-28,Vung Tau,Ba Ria City,18,3,3,0,0
2022-01-28,Vung Tau,Ba Ria City,19,8,1,7,7
2022-01-28,Vung Tau,Ba Ria City,20,2,0,2,2
2022-01-28,Vung Tau,Ba Ria City,21,2,0,2,1
2022-01-28,Vung Tau,Vung Tau City,6,28,21,7,2
2022-01-28,Vung Tau,Vung Tau City,7,59,57,2,0
2022-01-28,Vung Tau,Vung Tau City,8,121,113,8,0
2022-01-28,Vung Tau,Vung Tau City,9,156,149,7,1
2022-01-28,Vung Tau,Vung Tau City,10,159,149,10,2
2022-01-28,Vung Tau,Vung Tau City,11,299,271,28,3
2022-01-28,Vung Tau,Vung Tau City,12,236,221,15,0
2022-01-28,Vung Tau,Vung Tau City,13,184,172,12,0
2022-01-28,Vung Tau,Vung Tau City,14,186,158,28,1
2022-01-28,Vung Tau,Vung Tau City,15,153,132,21,3
2022-01-28,Vung Tau,Vung Tau City,16,148,138,10,2
2022-01-28,Vung Tau,Vung Tau City,17,196,176,20,3
2022-01-28,Vung Tau,Vung Tau City,18,266,246,20,0
2022-01-28,Vung Tau,Vung Tau City,19,221,209,12,0
2022-01-28,Vung Tau,Vung Tau City,20,141,122,19,1
2022-01-28,Vung Tau,Vung Tau City,21,69,55,14,3
2022-01-28,Vung Tau,Vung Tau City,23,1,1,0,0
2022-01-29,Binh Duong,Di An,7,1,0,1,1
2022-01-29,Binh Duong,Di An,8,2,1,1,1
2022-01-29,Binh Duong,Di An,9,2,0,2,2
2022-01-29,Binh Duong,Di An,10,3,3,0,0
2022-01-29,Binh Duong,Di An,11,4,3,1,0
2022-01-29,Binh Duong,Di An,12,13,7,6,2
2022-01-29,Binh Duong,Di An,13,10,8,2,1
2022-01-29,Binh Duong,Di An,14,5,5,0,0
2022-01-29,Binh Duong,Di An,15,10,5,5,1
2022-01-29,Binh Duong,Di An,16,9,7,2,2
2022-01-29,Binh Duong,Di An,17,7,5,2,2
2022-01-29,Binh Duong,Di An,18,1,1,0,0
2022-01-29,Binh Duong,Di An,19,7,2,5,0
2022-01-29,Binh Duong,Di An,20,2,2,0,0
2022-01-29,Binh Duong,Di An,21,3,1,2,1
2022-01-29,Binh Duong,Di An,22,1,0,1,0
2022-01-29,Binh Duong,Tan Uyen,10,1,1,0,0
2022-01-29,Binh Duong,Tan Uyen,11,3,2,1,0
2022-01-29,Binh Duong,Tan Uyen,12,1,1,0,0
2022-01-29,Binh Duong,Tan Uyen,14,2,0,2,2
2022-01-29,Binh Duong,Tan Uyen,15,4,1,3,3
2022-01-29,Binh Duong,Thu Dau Mot Town,6,8,6,2,2
2022-01-29,Binh Duong,Thu Dau Mot Town,7,56,48,8,3
2022-01-29,Binh Duong,Thu Dau Mot Town,8,108,97,11,2
2022-01-29,Binh Duong,Thu Dau Mot Town,9,159,141,18,6
2022-01-29,Binh Duong,Thu Dau Mot Town,10,235,218,17,3
2022-01-29,Binh Duong,Thu Dau Mot Town,11,365,345,20,6
2022-01-29,Binh Duong,Thu Dau Mot Town,12,352,327,25,2
2022-01-29,Binh Duong,Thu Dau Mot Town,13,280,257,23,5
2022-01-29,Binh Duong,Thu Dau Mot Town,14,217,200,17,2
2022-01-29,Binh Duong,Thu Dau Mot Town,15,176,166,10,4
2022-01-29,Binh Duong,Thu Dau Mot Town,16,158,154,4,2
2022-01-29,Binh Duong,Thu Dau Mot Town,17,169,161,8,0
2022-01-29,Binh Duong,Thu Dau Mot Town,18,220,215,5,1
2022-01-29,Binh Duong,Thu Dau Mot Town,19,218,200,18,1
2022-01-29,Binh Duong,Thu Dau Mot Town,20,162,147,15,1
2022-01-29,Binh Duong,Thu Dau Mot Town,21,71,63,8,0
2022-01-29,Binh Duong,Thu Dau Mot Town,22,3,2,1,0
2022-01-29,Binh Duong,Thuan An,1,1,0,1,0
2022-01-29,Binh Duong,Thuan An,6,1,0,1,1
2022-01-29,Binh Duong,Thuan An,7,1,1,0,0
2022-01-29,Binh Duong,Thuan An,8,8,2,6,6
2022-01-29,Binh Duong,Thuan An,9,19,8,11,9
2022-01-29,Binh Duong,Thuan An,10,21,11,10,8
2022-01-29,Binh Duong,Thuan An,11,35,19,16,13
2022-01-29,Binh Duong,Thuan An,12,50,19,31,26
2022-01-29,Binh Duong,Thuan An,13,43,19,24,21
2022-01-29,Binh Duong,Thuan An,14,37,14,23,19
2022-01-29,Binh Duong,Thuan An,15,25,18,7,5
2022-01-29,Binh Duong,Thuan An,16,25,15,10,8
2022-01-29,Binh Duong,Thuan An,17,34,19,15,14
2022-01-29,Binh Duong,Thuan An,18,19,11,8,5
2022-01-29,Binh Duong,Thuan An,19,25,10,15,11
2022-01-29,Binh Duong,Thuan An,20,17,6,11,9
2022-01-29,Binh Duong,Thuan An,21,17,2,15,12
2022-01-29,Can Tho City,Binh Thuy District,8,3,3,0,0
2022-01-29,Can Tho City,Binh Thuy District,9,2,2,0,0
2022-01-29,Can Tho City,Binh Thuy District,10,2,2,0,0
2022-01-29,Can Tho City,Binh Thuy District,11,7,4,3,0
2022-01-29,Can Tho City,Binh Thuy District,12,3,3,0,0
2022-01-29,Can Tho City,Binh Thuy District,13,6,6,0,0
2022-01-29,Can Tho City,Binh Thuy District,14,4,4,0,0
2022-01-29,Can Tho City,Binh Thuy District,15,4,4,0,0
2022-01-29,Can Tho City,Binh Thuy District,16,5,5,0,0
2022-01-29,Can Tho City,Binh Thuy District,17,3,3,0,0
2022-01-29,Can Tho City,Binh Thuy District,18,7,6,1,0
2022-01-29,Can Tho City,Binh Thuy District,19,5,5,0,0
2022-01-29,Can Tho City,Binh Thuy District,20,2,2,0,0
2022-01-29,Can Tho City,Binh Thuy District,21,1,1,0,0
2022-01-29,Can Tho City,Cai Rang District,7,2,1,1,1
2022-01-29,Can Tho City,Cai Rang District,8,1,1,0,0
2022-01-29,Can Tho City,Cai Rang District,9,2,2,0,0
2022-01-29,Can Tho City,Cai Rang District,10,7,7,0,0
2022-01-29,Can Tho City,Cai Rang District,11,10,10,0,0
2022-01-29,Can Tho City,Cai Rang District,12,5,5,0,0
2022-01-29,Can Tho City,Cai Rang District,13,11,10,1,1
2022-01-29,Can Tho City,Cai Rang District,14,5,5,0,0
2022-01-29,Can Tho City,Cai Rang District,15,5,5,0,0
2022-01-29,Can Tho City,Cai Rang District,16,16,13,3,0
2022-01-29,Can Tho City,Cai Rang District,17,6,6,0,0
2022-01-29,Can Tho City,Cai Rang District,18,11,11,0,0
2022-01-29,Can Tho City,Cai Rang District,19,5,4,1,0
2022-01-29,Can Tho City,Cai Rang District,20,9,8,1,0
2022-01-29,Can Tho City,Cai Rang District,21,1,1,0,0
2022-01-29,Can Tho City,Ninh Kieu District,1,1,1,0,0
2022-01-29,Can Tho City,Ninh Kieu District,6,17,16,1,0
2022-01-29,Can Tho City,Ninh Kieu District,7,59,54,5,0
2022-01-29,Can Tho City,Ninh Kieu District,8,99,95,4,0
2022-01-29,Can Tho City,Ninh Kieu District,9,121,113,8,0
2022-01-29,Can Tho City,Ninh Kieu District,10,183,176,7,0
2022-01-29,Can Tho City,Ninh Kieu District,11,295,276,19,0
2022-01-29,Can Tho City,Ninh Kieu District,12,246,232,14,0
2022-01-29,Can Tho City,Ninh Kieu District,13,177,173,4,0
2022-01-29,Can Tho City,Ninh Kieu District,14,145,136,9,0
2022-01-29,Can Tho City,Ninh Kieu District,15,130,125,5,0
2022-01-29,Can Tho City,Ninh Kieu District,16,158,152,6,0
2022-01-29,Can Tho City,Ninh Kieu District,17,158,152,6,0
2022-01-29,Can Tho City,Ninh Kieu District,18,189,180,9,0
2022-01-29,Can Tho City,Ninh Kieu District,19,151,138,13,0
2022-01-29,Can Tho City,Ninh Kieu District,20,124,111,13,0
2022-01-29,Can Tho City,Ninh Kieu District,21,87,78,9,0
2022-01-29,Can Tho City,Ninh Kieu District,22,1,1,0,0
2022-01-29,Can Tho City,Ninh Kieu District,23,3,2,1,0
2022-01-29,Dong Nai,Bien Hoa City,2,2,2,0,0
2022-01-29,Dong Nai,Bien Hoa City,5,2,1,1,1
2022-01-29,Dong Nai,Bien Hoa City,6,26,13,13,8
2022-01-29,Dong Nai,Bien Hoa City,7,78,71,7,2
2022-01-29,Dong Nai,Bien Hoa City,8,182,169,13,5
2022-01-29,Dong Nai,Bien Hoa City,9,283,263,20,3
2022-01-29,Dong Nai,Bien Hoa City,10,524,484,40,7
2022-01-29,Dong Nai,Bien Hoa City,11,685,634,51,3
2022-01-29,Dong Nai,Bien Hoa City,12,740,682,58,10
2022-01-29,Dong Nai,Bien Hoa City,13,591,553,38,7
2022-01-29,Dong Nai,Bien Hoa City,14,406,376,30,7
2022-01-29,Dong Nai,Bien Hoa City,15,357,332,25,4
2022-01-29,Dong Nai,Bien Hoa City,16,359,339,20,4
2022-01-29,Dong Nai,Bien Hoa City,17,384,362,22,3
2022-01-29,Dong Nai,Bien Hoa City,18,461,426,35,18
2022-01-29,Dong Nai,Bien Hoa City,19,487,417,70,33
2022-01-29,Dong Nai,Bien Hoa City,20,434,325,109,63
2022-01-29,Dong Nai,Bien Hoa City,21,230,145,85,48
2022-01-29,Dong Nai,Bien Hoa City,22,2,0,2,0
2022-01-29,Dong Nai,Bien Hoa City,23,1,1,0,0
2022-01-29,Dong Nai,Long Thanh,10,1,0,1,1
2022-01-29,Dong Nai,Long Thanh,12,5,0,5,4
2022-01-29,Dong Nai,Long Thanh,13,5,0,5,2
2022-01-29,Dong Nai,Long Thanh,15,1,0,1,1
2022-01-29,Dong Nai,Long Thanh,17,3,0,3,3
2022-01-29,Dong Nai,Long Thanh,18,2,0,2,2
2022-01-29,Dong Nai,Long Thanh,19,1,0,1,1
2022-01-29,Dong Nai,Long Thanh,20,2,0,2,2
2022-01-29,Dong Nai,Thong Nhat,11,1,1,0,0
2022-01-29,Dong Nai,Thong Nhat,12,1,1,0,0
2022-01-29,Dong Nai,Thong Nhat,13,1,1,0,0
2022-01-29,Dong Nai,Thong Nhat,19,1,1,0,0
2022-01-29,Dong Nai,Thong Nhat,20,3,3,0,0
2022-01-29,Hai Phong City,An Duong,12,1,1,0,0
2022-01-29,Hai Phong City,An Duong,13,3,0,3,3
2022-01-29,Hai Phong City,An Duong,14,2,1,1,1
2022-01-29,Hai Phong City,An Duong,15,1,0,1,1
2022-01-29,Hai Phong City,An Duong,17,1,1,0,0
2022-01-29,Hai Phong City,An Duong,18,1,1,0,0
2022-01-29,Hai Phong City,An Duong,21,1,0,1,0
2022-01-29,Hai Phong City,Hai An District,8,2,1,1,1
2022-01-29,Hai Phong City,Hai An District,9,3,3,0,0
2022-01-29,Hai Phong City,Hai An District,10,3,3,0,0
2022-01-29,Hai Phong City,Hai An District,11,13,12,1,1
2022-01-29,Hai Phong City,Hai An District,12,27,21,6,2
2022-01-29,Hai Phong City,Hai An District,13,9,9,0,0
2022-01-29,Hai Phong City,Hai An District,14,7,5,2,0
2022-01-29,Hai Phong City,Hai An District,15,7,7,0,0
2022-01-29,Hai Phong City,Hai An District,16,5,4,1,1
2022-01-29,Hai Phong City,Hai An District,17,11,10,1,0
2022-01-29,Hai Phong City,Hai An District,18,8,8,0,0
2022-01-29,Hai Phong City,Hai An District,19,8,7,1,1
2022-01-29,Hai Phong City,Hai An District,20,12,8,4,2
2022-01-29,Hai Phong City,Hai An District,21,4,2,2,1
2022-01-29,Hai Phong City,Hong Bang District,8,13,11,2,0
2022-01-29,Hai Phong City,Hong Bang District,9,10,10,0,0
2022-01-29,Hai Phong City,Hong Bang District,10,48,45,3,0
2022-01-29,Hai Phong City,Hong Bang District,11,72,65,7,4
2022-01-29,Hai Phong City,Hong Bang District,12,69,60,9,6
2022-01-29,Hai Phong City,Hong Bang District,13,42,37,5,2
2022-01-29,Hai Phong City,Hong Bang District,14,26,25,1,0
2022-01-29,Hai Phong City,Hong Bang District,15,30,29,1,0
2022-01-29,Hai Phong City,Hong Bang District,16,22,21,1,0
2022-01-29,Hai Phong City,Hong Bang District,17,36,27,9,6
2022-01-29,Hai Phong City,Hong Bang District,18,51,36,15,9
2022-01-29,Hai Phong City,Hong Bang District,19,49,40,9,7
2022-01-29,Hai Phong City,Hong Bang District,20,32,16,16,12
2022-01-29,Hai Phong City,Hong Bang District,21,9,5,4,1
2022-01-29,Hai Phong City,Hong Bang District,22,1,1,0,0
2022-01-29,Hai Phong City,Kien An District,8,1,0,1,1
2022-01-29,Hai Phong City,Kien An District,9,2,1,1,1
2022-01-29,Hai Phong City,Kien An District,10,5,3,2,1
2022-01-29,Hai Phong City,Kien An District,11,12,5,7,5
2022-01-29,Hai Phong City,Kien An District,12,11,7,4,4
2022-01-29,Hai Phong City,Kien An District,13,4,4,0,0
2022-01-29,Hai Phong City,Kien An District,14,2,2,0,0
2022-01-29,Hai Phong City,Kien An District,16,4,4,0,0
2022-01-29,Hai Phong City,Kien An District,17,5,3,2,2
2022-01-29,Hai Phong City,Kien An District,18,6,2,4,4
2022-01-29,Hai Phong City,Kien An District,19,8,3,5,3
2022-01-29,Hai Phong City,Kien An District,20,5,2,3,1
2022-01-29,Hai Phong City,Kien An District,21,4,1,3,3
2022-01-29,Hai Phong City,Le Chan District,0,1,1,0,0
2022-01-29,Hai Phong City,Le Chan District,4,1,0,1,0
2022-01-29,Hai Phong City,Le Chan District,7,14,13,1,0
2022-01-29,Hai Phong City,Le Chan District,8,32,30,2,0
2022-01-29,Hai Phong City,Le Chan District,9,42,39,3,1
2022-01-29,Hai Phong City,Le Chan District,10,99,88,11,2
2022-01-29,Hai Phong City,Le Chan District,11,187,166,21,11
2022-01-29,Hai Phong City,Le Chan District,12,156,139,17,5
2022-01-29,Hai Phong City,Le Chan District,13,67,63,4,0
2022-01-29,Hai Phong City,Le Chan District,14,80,71,9,0
2022-01-29,Hai Phong City,Le Chan District,15,79,70,9,1
2022-01-29,Hai Phong City,Le Chan District,16,106,98,8,4
2022-01-29,Hai Phong City,Le Chan District,17,123,114,9,9
2022-01-29,Hai Phong City,Le Chan District,18,181,132,49,33
2022-01-29,Hai Phong City,Le Chan District,19,164,115,49,37
2022-01-29,Hai Phong City,Le Chan District,20,98,77,21,12
2022-01-29,Hai Phong City,Le Chan District,21,64,46,18,6
2022-01-29,Hai Phong City,Le Chan District,22,1,0,1,1
2022-01-29,Hai Phong City,Ngo Quyen District,3,1,1,0,0
2022-01-29,Hai Phong City,Ngo Quyen District,7,9,8,1,0
2022-01-29,Hai Phong City,Ngo Quyen District,8,61,58,3,1
2022-01-29,Hai Phong City,Ngo Quyen District,9,46,42,4,1
2022-01-29,Hai Phong City,Ngo Quyen District,10,99,80,19,9
2022-01-29,Hai Phong City,Ngo Quyen District,11,152,138,14,7
2022-01-29,Hai Phong City,Ngo Quyen District,12,161,132,29,17
2022-01-29,Hai Phong City,Ngo Quyen District,13,88,78,10,2
2022-01-29,Hai Phong City,Ngo Quyen District,14,62,58,4,2
2022-01-29,Hai Phong City,Ngo Quyen District,15,93,89,4,1
2022-01-29,Hai Phong City,Ngo Quyen District,16,75,67,8,3
2022-01-29,Hai Phong City,Ngo Quyen District,17,104,91,13,4
2022-01-29,Hai Phong City,Ngo Quyen District,18,138,115,23,14
2022-01-29,Hai Phong City,Ngo Quyen District,19,121,110,11,5
2022-01-29,Hai Phong City,Ngo Quyen District,20,117,98,19,9
2022-01-29,Hai Phong City,Ngo Quyen District,21,61,51,10,4
2022-01-29,Hai Phong City,Thuy Nguyen,10,1,0,1,1
2022-01-29,Hai Phong City,Thuy Nguyen,16,2,0,2,2
2022-01-29,Hai Phong City,Thuy Nguyen,17,2,0,2,2
2022-01-29,Hai Phong City,Thuy Nguyen,18,1,0,1,1
2022-01-29,Hai Phong City,Thuy Nguyen,19,1,0,1,1
2022-01-29,Hue City,Hue City,6,19,18,1,0
2022-01-29,Hue City,Hue City,7,88,74,14,0
2022-01-29,Hue City,Hue City,8,121,116,5,0
2022-01-29,Hue City,Hue City,9,125,117,8,0
2022-01-29,Hue City,Hue City,10,152,141,11,0
2022-01-29,Hue City,Hue City,11,286,265,21,0
2022-01-29,Hue City,Hue City,12,268,242,26,0
2022-01-29,Hue City,Hue City,13,149,140,9,1
2022-01-29,Hue City,Hue City,14,137,128,9,0
2022-01-29,Hue City,Hue City,15,151,141,10,0
2022-01-29,Hue City,Hue City,16,189,176,13,0
2022-01-29,Hue City,Hue City,17,194,183,11,0
2022-01-29,Hue City,Hue City,18,261,247,14,0
2022-01-29,Hue City,Hue City,19,243,227,16,0
2022-01-29,Hue City,Hue City,20,213,181,32,5
2022-01-29,Hue City,Hue City,21,124,105,19,3
2022-01-29,Hue City,Hue City,22,1,0,1,0
2022-01-29,Hue City,Huong Thuy,12,1,0,1,1
2022-01-29,Hue City,Huong Thuy,18,1,0,1,1
2022-01-29,Hue City,Huong Thuy,19,2,1,1,1
2022-01-29,Hue City,Phu Vang,12,1,1,0,0
2022-01-29,Hue City,Phu Vang,18,1,1,0,0
2022-01-29,Hue City,Phu Vang,20,2,2,0,0
2022-01-29,Vung Tau,Ba Ria City,8,3,0,3,2
2022-01-29,Vung Tau,Ba Ria City,9,7,0,7,5
2022-01-29,Vung Tau,Ba Ria City,10,5,0,5,4
2022-01-29,Vung Tau,Ba Ria City,11,4,0,4,3
2022-01-29,Vung Tau,Ba Ria City,12,5,0,5,4
2022-01-29,Vung Tau,Ba Ria City,13,2,0,2,2
2022-01-29,Vung Tau,Ba Ria City,14,1,0,1,1
2022-01-29,Vung Tau,Ba Ria City,15,2,0,2,1
2022-01-29,Vung Tau,Ba Ria City,16,5,2,3,2
2022-01-29,Vung Tau,Ba Ria City,17,4,0,4,4
2022-01-29,Vung Tau,Ba Ria City,18,3,0,3,2
2022-01-29,Vung Tau,Ba Ria City,19,5,1,4,3
2022-01-29,Vung Tau,Ba Ria City,20,2,1,1,1
2022-01-29,Vung Tau,Vung Tau City,0,1,1,0,0
2022-01-29,Vung Tau,Vung Tau City,2,1,0,1,0
2022-01-29,Vung Tau,Vung Tau City,5,1,1,0,0
2022-01-29,Vung Tau,Vung Tau City,6,12,11,1,1
2022-01-29,Vung Tau,Vung Tau City,7,52,46,6,0
2022-01-29,Vung Tau,Vung Tau City,8,106,97,9,0
2022-01-29,Vung Tau,Vung Tau City,9,107,99,8,1
2022-01-29,Vung Tau,Vung Tau City,10,150,143,7,2
2022-01-29,Vung Tau,Vung Tau City,11,193,183,10,0
2022-01-29,Vung Tau,Vung Tau City,12,239,231,8,0
2022-01-29,Vung Tau,Vung Tau City,13,151,144,7,0
2022-01-29,Vung Tau,Vung Tau City,14,151,138,13,0
2022-01-29,Vung Tau,Vung Tau City,15,125,120,5,0
2022-01-29,Vung Tau,Vung Tau City,16,130,123,7,0
2022-01-29,Vung Tau,Vung Tau City,17,149,139,10,0
2022-01-29,Vung Tau,Vung Tau City,18,184,170,14,2
2022-01-29,Vung Tau,Vung Tau City,19,156,142,14,1
2022-01-29,Vung Tau,Vung Tau City,20,108,101,7,0
2022-01-29,Vung Tau,Vung Tau City,21,87,73,14,1
2022-01-29,Vung Tau,Vung Tau City,22,1,1,0,0
2022-01-30,Binh Duong,Di An,7,1,1,0,0
2022-01-30,Binh Duong,Di An,8,1,1,0,0
2022-01-30,Binh Duong,Di An,9,7,4,3,1
2022-01-30,Binh Duong,Di An,10,12,8,4,3
2022-01-30,Binh Duong,Di An,11,17,7,10,10
2022-01-30,Binh Duong,Di An,12,15,6,9,8
2022-01-30,Binh Duong,Di An,13,19,9,10,9
2022-01-30,Binh Duong,Di An,14,6,2,4,1
2022-01-30,Binh Duong,Di An,15,8,8,0,0
2022-01-30,Binh Duong,Di An,16,8,7,1,1
2022-01-30,Binh Duong,Di An,17,10,6,4,4
2022-01-30,Binh Duong,Di An,18,8,6,2,1
2022-01-30,Binh Duong,Di An,19,12,2,10,9
2022-01-30,Binh Duong,Di An,20,8,3,5,2
2022-01-30,Binh Duong,Tan Uyen,8,1,1,0,0
2022-01-30,Binh Duong,Tan Uyen,10,1,0,1,0
2022-01-30,Binh Duong,Tan Uyen,14,1,0,1,0
2022-01-30,Binh Duong,Tan Uyen,18,1,0,1,0
2022-01-30,Binh Duong,Tan Uyen,19,1,0,1,0
2022-01-30,Binh Duong,Thu Dau Mot Town,6,5,1,4,1
2022-01-30,Binh Duong,Thu Dau Mot Town,7,41,37,4,4
2022-01-30,Binh Duong,Thu Dau Mot Town,8,100,95,5,0
2022-01-30,Binh Duong,Thu Dau Mot Town,9,127,120,7,1
2022-01-30,Binh Duong,Thu Dau Mot Town,10,199,185,14,2
2022-01-30,Binh Duong,Thu Dau Mot Town,11,286,261,25,5
2022-01-30,Binh Duong,Thu Dau Mot Town,12,252,239,13,5
2022-01-30,Binh Duong,Thu Dau Mot Town,13,236,224,12,5
2022-01-30,Binh Duong,Thu Dau Mot Town,14,197,182,15,6
2022-01-30,Binh Duong,Thu Dau Mot Town,15,176,166,10,3
2022-01-30,Binh Duong,Thu Dau Mot Town,16,172,159,13,2
2022-01-30,Binh Duong,Thu Dau Mot Town,17,185,167,18,8
2022-01-30,Binh Duong,Thu Dau Mot Town,18,208,187,21,13
2022-01-30,Binh Duong,Thu Dau Mot Town,19,171,147,24,12
2022-01-30,Binh Duong,Thu Dau Mot Town,20,133,112,21,11
2022-01-30,Binh Duong,Thu Dau Mot Town,21,65,54,11,3
2022-01-30,Binh Duong,Thuan An,6,2,0,2,2
2022-01-30,Binh Duong,Thuan An,7,3,0,3,2
2022-01-30,Binh Duong,Thuan An,8,6,1,5,5
2022-01-30,Binh Duong,Thuan An,9,24,10,14,14
2022-01-30,Binh Duong,Thuan An,10,31,21,10,4
2022-01-30,Binh Duong,Thuan An,11,42,23,19,18
2022-01-30,Binh Duong,Thuan An,12,37,26,11,7
2022-01-30,Binh Duong,Thuan An,13,51,28,23,20
2022-01-30,Binh Duong,Thuan An,14,28,20,8,7
2022-01-30,Binh Duong,Thuan An,15,30,14,16,15
2022-01-30,Binh Duong,Thuan An,16,22,17,5,4
2022-01-30,Binh Duong,Thuan An,17,25,14,11,7
2022-01-30,Binh Duong,Thuan An,18,25,11,14,7
2022-01-30,Binh Duong,Thuan An,19,22,13,9,7
2022-01-30,Binh Duong,Thuan An,20,26,14,12,10
2022-01-30,Binh Duong,Thuan An,21,15,4,11,7
2022-01-30,Can Tho City,Binh Thuy District,7,2,0,2,0
2022-01-30,Can Tho City,Binh Thuy District,8,2,1,1,0
2022-01-30,Can Tho City,Binh Thuy District,9,2,2,0,0
2022-01-30,Can Tho City,Binh Thuy District,10,5,5,0,0
2022-01-30,Can Tho City,Binh Thuy District,11,4,4,0,0
2022-01-30,Can Tho City,Binh Thuy District,12,3,3,0,0
2022-01-30,Can Tho City,Binh Thuy District,13,4,4,0,0
2022-01-30,Can Tho City,Binh Thuy District,14,1,0,1,0
2022-01-30,Can Tho City,Binh Thuy District,16,6,6,0,0
2022-01-30,Can Tho City,Binh Thuy District,18,2,2,0,0
2022-01-30,Can Tho City,Binh Thuy District,19,4,3,1,1
2022-01-30,Can Tho City,Binh Thuy District,20,6,5,1,0
2022-01-30,Can Tho City,Binh Thuy District,21,1,0,1,0
2022-01-30,Can Tho City,Cai Rang District,7,1,0,1,1
2022-01-30,Can Tho City,Cai Rang District,8,2,2,0,0
2022-01-30,Can Tho City,Cai Rang District,9,3,2,1,0
2022-01-30,Can Tho City,Cai Rang District,10,3,3,0,0
2022-01-30,Can Tho City,Cai Rang District,11,7,7,0,0
2022-01-30,Can Tho City,Cai Rang District,12,9,6,3,0
2022-01-30,Can Tho City,Cai Rang District,13,5,5,0,0
2022-01-30,Can Tho City,Cai Rang District,14,3,3,0,0
2022-01-30,Can Tho City,Cai Rang District,15,5,5,0,0
2022-01-30,Can Tho City,Cai Rang District,16,4,4,0,0
2022-01-30,Can Tho City,Cai Rang District,17,9,8,1,0
2022-01-30,Can Tho City,Cai Rang District,18,11,11,0,0
2022-01-30,Can Tho City,Cai Rang District,19,4,4,0,0
2022-01-30,Can Tho City,Cai Rang District,20,9,7,2,1
2022-01-30,Can Tho City,Cai Rang District,21,5,4,1,0
2022-01-30,Can Tho City,Ninh Kieu District,6,17,17,0,0
2022-01-30,Can Tho City,Ninh Kieu District,7,52,49,3,0
2022-01-30,Can Tho City,Ninh Kieu District,8,101,98,3,0
2022-01-30,Can Tho City,Ninh Kieu District,9,142,128,14,0
2022-01-30,Can Tho City,Ninh Kieu District,10,154,148,6,0
2022-01-30,Can Tho City,Ninh Kieu District,11,196,181,15,0
2022-01-30,Can Tho City,Ninh Kieu District,12,216,202,14,0
2022-01-30,Can Tho City,Ninh Kieu District,13,173,152,21,0
2022-01-30,Can Tho City,Ninh Kieu District,14,144,134,10,0
2022-01-30,Can Tho City,Ninh Kieu District,15,123,118,5,0
2022-01-30,Can Tho City,Ninh Kieu District,16,94,88,6,0
2022-01-30,Can Tho City,Ninh Kieu District,17,166,157,9,0
2022-01-30,Can Tho City,Ninh Kieu District,18,165,158,7,0
2022-01-30,Can Tho City,Ninh Kieu District,19,133,125,8,0
2022-01-30,Can Tho City,Ninh Kieu District,20,110,103,7,0
2022-01-30,Can Tho City,Ninh Kieu District,21,72,66,6,0
2022-01-30,Can Tho City,Ninh Kieu District,22,4,2,2,0
2022-01-30,Dong Nai,Bien Hoa City,1,2,2,0,0
2022-01-30,Dong Nai,Bien Hoa City,5,1,1,0,0
2022-01-30,Dong Nai,Bien Hoa City,6,16,11,5,3
2022-01-30,Dong Nai,Bien Hoa City,7,68,59,9,6
2022-01-30,Dong Nai,Bien Hoa City,8,146,127,19,5
2022-01-30,Dong Nai,Bien Hoa City,9,270,249,21,1
2022-01-30,Dong Nai,Bien Hoa City,10,433,392,41,13
2022-01-30,Dong Nai,Bien Hoa City,11,593,543,50,7
2022-01-30,Dong Nai,Bien Hoa City,12,655,577,78,17
2022-01-30,Dong Nai,Bien Hoa City,13,489,449,40,9
2022-01-30,Dong Nai,Bien Hoa City,14,399,366,33,12
2022-01-30,Dong Nai,Bien Hoa City,15,347,316,31,6
2022-01-30,Dong Nai,Bien Hoa City,16,296,274,22,4
2022-01-30,Dong Nai,Bien Hoa City,17,340,310,30,12
2022-01-30,Dong Nai,Bien Hoa City,18,433,386,47,21
2022-01-30,Dong Nai,Bien Hoa City,19,493,385,108,73
2022-01-30,Dong Nai,Bien Hoa City,20,435,277,158,118
2022-01-30,Dong Nai,Bien Hoa City,21,236,147,89,58
2022-01-30,Dong Nai,Bien Hoa City,22,3,1,2,1
2022-01-30,Dong Nai,Bien Hoa City,23,1,1,0,0
2022-01-30,Dong Nai,Long Thanh,9,1,0,1,1
2022-01-30,Dong Nai,Long Thanh,10,3,0,3,2
2022-01-30,Dong Nai,Long Thanh,11,2,0,2,1
2022-01-30,Dong Nai,Long Thanh,12,2,0,2,0
2022-01-30,Dong Nai,Long Thanh,16,1,0,1,1
2022-01-30,Dong Nai,Long Thanh,18,1,0,1,1
2022-01-30,Dong Nai,Long Thanh,19,5,0,5,5
2022-01-30,Dong Nai,Long Thanh,20,1,0,1,1
2022-01-30,Dong Nai,Thong Nhat,8,1,1,0,0
2022-01-30,Dong Nai,Thong Nhat,9,2,2,0,0
2022-01-30,Dong Nai,Thong Nhat,10,2,2,0,0
2022-01-30,Dong Nai,Thong Nhat,12,3,3,0,0
2022-01-30,Dong Nai,Thong Nhat,13,1,1,0,0
2022-01-30,Dong Nai,Thong Nhat,14,1,1,0,0
2022-01-30,Dong Nai,Thong Nhat,17,1,1,0,0
2022-01-30,Dong Nai,Thong Nhat,19,3,2,1,1
2022-01-30,Dong Nai,Thong Nhat,20,1,1,0,0
2022-01-30,Dong Nai,Thong Nhat,21,1,1,0,0
2022-01-30,Hai Phong City,An Duong,8,1,0,1,1
2022-01-30,Hai Phong City,An Duong,9,2,0,2,2
2022-01-30,Hai Phong City,An Duong,10,3,2,1,1
2022-01-30,Hai Phong City,An Duong,11,1,0,1,1
2022-01-30,Hai Phong City,An Duong,12,4,1,3,3
2022-01-30,Hai Phong City,An Duong,13,2,0,2,2
2022-01-30,Hai Phong City,An Duong,14,2,0,2,2
2022-01-30,Hai Phong City,An Duong,15,2,1,1,1
2022-01-30,Hai Phong City,An Duong,17,1,1,0,0
2022-01-30,Hai Phong City,An Duong,19,1,0,1,1
2022-01-30,Hai Phong City,Hai An District,9,3,1,2,1
2022-01-30,Hai Phong City,Hai An District,10,10,8,2,2
2022-01-30,Hai Phong City,Hai An District,11,7,7,0,0
2022-01-30,Hai Phong City,Hai An District,12,8,5,3,3
2022-01-30,Hai Phong City,Hai An District,13,3,3,0,0
2022-01-30,Hai Phong City,Hai An District,14,4,4,0,0
2022-01-30,Hai Phong City,Hai An District,15,7,5,2,0
2022-01-30,Hai Phong City,Hai An District,16,4,2,2,2
2022-01-30,Hai Phong City,Hai An District,17,6,4,2,2
2022-01-30,Hai Phong City,Hai An District,18,6,6,0,0
2022-01-30,Hai Phong City,Hai An District,19,9,4,5,4
2022-01-30,Hai Phong City,Hai An District,20,3,3,0,0
2022-01-30,Hai Phong City,Hai An District,21,7,5,2,2
2022-01-30,Hai Phong City,Hong Bang District,7,3,1,2,0
2022-01-30,Hai Phong City,Hong Bang District,8,12,10,2,0
2022-01-30,Hai Phong City,Hong Bang District,9,27,19,8,2
2022-01-30,Hai Phong City,Hong Bang District,10,22,19,3,1
2022-01-30,Hai Phong City,Hong Bang District,11,51,36,15,10
2022-01-30,Hai Phong City,Hong Bang District,12,51,29,22,19
2022-01-30,Hai Phong City,Hong Bang District,13,23,22,1,0
2022-01-30,Hai Phong City,Hong Bang District,14,11,9,2,0
2022-01-30,Hai Phong City,Hong Bang District,15,17,16,1,0
2022-01-30,Hai Phong City,Hong Bang District,16,22,20,2,0
2022-01-30,Hai Phong City,Hong Bang District,17,14,9,5,3
2022-01-30,Hai Phong City,Hong Bang District,18,14,9,5,5
2022-01-30,Hai Phong City,Hong Bang District,19,25,16,9,4
2022-01-30,Hai Phong City,Hong Bang District,20,17,12,5,4
2022-01-30,Hai Phong City,Hong Bang District,21,10,6,4,2
2022-01-30,Hai Phong City,Hong Bang District,22,1,0,1,0
2022-01-30,Hai Phong City,Kien An District,8,2,1,1,0
2022-01-30,Hai Phong City,Kien An District,9,3,0,3,2
2022-01-30,Hai Phong City,Kien An District,10,4,3,1,0
2022-01-30,Hai Phong City,Kien An District,11,4,1,3,3
2022-01-30,Hai Phong City,Kien An District,12,3,2,1,1
2022-01-30,Hai Phong City,Kien An District,13,2,1,1,1
2022-01-30,Hai Phong City,Kien An District,14,2,0,2,0
2022-01-30,Hai Phong City,Kien An District,15,4,2,2,2
2022-01-30,Hai Phong City,Kien An District,16,7,1,6,4
2022-01-30,Hai Phong City,Kien An District,17,4,3,1,1
2022-01-30,Hai Phong City,Kien An District,18,5,4,1,0
2022-01-30,Hai Phong City,Kien An District,19,4,0,4,4
2022-01-30,Hai Phong City,Kien An District,20,15,4,11,10
2022-01-30,Hai Phong City,Le Chan District,1,1,0,1,0
2022-01-30,Hai Phong City,Le Chan District,3,1,1,0,0
2022-01-30,Hai Phong City,Le Chan District,6,1,1,0,0
2022-01-30,Hai Phong City,Le Chan District,7,22,14,8,4
2022-01-30,Hai Phong City,Le Chan District,8,31,24,7,1
2022-01-30,Hai Phong City,Le Chan District,9,32,27,5,0
2022-01-30,Hai Phong City,Le Chan District,10,87,81,6,1
2022-01-30,Hai Phong City,Le Chan District,11,143,115,28,21
2022-01-30,Hai Phong City,Le Chan District,12,180,119,61,50
2022-01-30,Hai Phong City,Le Chan District,13,112,86,26,16
2022-01-30,Hai Phong City,Le Chan District,14,67,60,7,1
2022-01-30,Hai Phong City,Le Chan District,15,66,57,9,3
2022-01-30,Hai Phong City,Le Chan District,16,89,71,18,8
2022-01-30,Hai Phong City,Le Chan District,17,133,89,44,30
2022-01-30,Hai Phong City,Le Chan District,18,151,102,49,38
2022-01-30,Hai Phong City,Le Chan District,19,154,87,67,51
2022-01-30,Hai Phong City,Le Chan District,20,95,61,34,26
2022-01-30,Hai Phong City,Le Chan District,21,51,25,26,23
2022-01-30,Hai Phong City,Le Chan District,22,3,0,3,1
2022-01-30,Hai Phong City,Le Chan District,23,1,0,1,1
2022-01-30,Hai Phong City,Ngo Quyen District,0,3,0,3,0
2022-01-30,Hai Phong City,Ngo Quyen District,1,2,1,1,1
2022-01-30,Hai Phong City,Ngo Quyen District,6,1,1,0,0
2022-01-30,Hai Phong City,Ngo Quyen District,7,15,11,4,2
2022-01-30,Hai Phong City,Ngo Quyen District,8,53,49,4,2
2022-01-30,Hai Phong City,Ngo Quyen District,9,72,61,11,4
2022-01-30,Hai Phong City,Ngo Quyen District,10,78,69,9,3
2022-01-30,Hai Phong City,Ngo Quyen District,11,144,119,25,16
2022-01-30,Hai Phong City,Ngo Quyen District,12,140,113,27,13
2022-01-30,Hai Phong City,Ngo Quyen District,13,97,81,16,7
2022-01-30,Hai Phong City,Ngo Quyen District,14,88,76,12,1
2022-01-30,Hai Phong City,Ngo Quyen District,15,80,71,9,1
2022-01-30,Hai Phong City,Ngo Quyen District,16,98,81,17,8
2022-01-30,Hai Phong City,Ngo Quyen District,17,106,73,33,23
2022-01-30,Hai Phong City,Ngo Quyen District,18,138,100,38,25
2022-01-30,Hai Phong City,Ngo Quyen District,19,151,94,57,40
2022-01-30,Hai Phong City,Ngo Quyen District,20,121,79,42,27
2022-01-30,Hai Phong City,Ngo Quyen District,21,64,46,18,7
2022-01-30,Hai Phong City,Thuy Nguyen,12,1,0,1,1
2022-01-30,Hai Phong City,Thuy Nguyen,17,1,0,1,1
2022-01-30,Hai Phong City,Thuy Nguyen,18,1,0,1,1
2022-01-30,Hai Phong City,Thuy Nguyen,19,1,0,1,0
2022-01-30,Hai Phong City,Thuy Nguyen,20,1,0,1,1
2022-01-30,Hue City,Hue City,2,1,1,0,0
2022-01-30,Hue City,Hue City,6,18,14,4,0
2022-01-30,Hue City,Hue City,7,75,68,7,1
2022-01-30,Hue City,Hue City,8,128,119,9,1
2022-01-30,Hue City,Hue City,9,163,155,8,2
2022-01-30,Hue City,Hue City,10,154,137,17,0
2022-01-30,Hue City,Hue City,11,227,212,15,0
2022-01-30,Hue City,Hue City,12,242,230,12,2
2022-01-30,Hue City,Hue City,13,140,136,4,0
2022-01-30,Hue City,Hue City,14,119,115,4,0
2022-01-30,Hue City,Hue City,15,156,145,11,0
2022-01-30,Hue City,Hue City,16,145,136,9,1
2022-01-30,Hue City,Hue City,17,174,160,14,0
2022-01-30,Hue City,Hue City,18,233,221,12,0
2022-01-30,Hue City,Hue City,19,187,171,16,1
2022-01-30,Hue City,Hue City,20,182,162,20,5
2022-01-30,Hue City,Hue City,21,106,87,19,0
2022-01-30,Hue City,Hue City,22,4,1,3,2
2022-01-30,Hue City,Hue City,23,1,1,0,0
2022-01-30,Hue City,Huong Thuy,13,1,1,0,0
2022-01-30,Hue City,Huong Thuy,19,1,0,1,1
2022-01-30,Hue City,Huong Tra,7,1,1,0,0
2022-01-30,Hue City,Phu Vang,10,1,1,0,0
2022-01-30,Hue City,Phu Vang,15,1,1,0,0
2022-01-30,Hue City,Phu Vang,18,1,0,1,1
2022-01-30,Hue City,Phu Vang,22,1,0,1,1
2022-01-30,Vung Tau,Ba Ria City,7,1,0,1,1
2022-01-30,Vung Tau,Ba Ria City,9,2,2,0,0
2022-01-30,Vung Tau,Ba Ria City,10,4,2,2,2
2022-01-30,Vung Tau,Ba Ria City,11,2,1,1,1
2022-01-30,Vung Tau,Ba Ria City,12,4,2,2,1
2022-01-30,Vung Tau,Ba Ria City,13,9,1,8,7
2022-01-30,Vung Tau,Ba Ria City,14,4,1,3,3
2022-01-30,Vung Tau,Ba Ria City,15,1,1,0,0
2022-01-30,Vung Tau,Ba Ria City,16,2,1,1,1
2022-01-30,Vung Tau,Ba Ria City,17,8,0,8,8
2022-01-30,Vung Tau,Ba Ria City,18,5,0,5,5
2022-01-30,Vung Tau,Ba Ria City,19,7,0,7,7
2022-01-30,Vung Tau,Ba Ria City,20,10,0,10,9
2022-01-30,Vung Tau,Ba Ria City,21,4,0,4,4
2022-01-30,Vung Tau,Vung Tau City,5,2,1,1,1
2022-01-30,Vung Tau,Vung Tau City,6,11,11,0,0
2022-01-30,Vung Tau,Vung Tau City,7,44,40,4,0
2022-01-30,Vung Tau,Vung Tau City,8,102,101,1,0
2022-01-30,Vung Tau,Vung Tau City,9,104,96,8,0
2022-01-30,Vung Tau,Vung Tau City,10,125,120,5,1
2022-01-30,Vung Tau,Vung Tau City,11,231,217,14,2
2022-01-30,Vung Tau,Vung Tau City,12,200,186,14,0
2022-01-30,Vung Tau,Vung Tau City,13,151,147,4,0
2022-01-30,Vung Tau,Vung Tau City,14,121,113,8,1
2022-01-30,Vung Tau,Vung Tau City,15,108,103,5,0
2022-01-30,Vung Tau,Vung Tau City,16,125,115,10,1
2022-01-30,Vung Tau,Vung Tau City,17,135,125,10,0
2022-01-30,Vung Tau,Vung Tau City,18,170,157,13,2
2022-01-30,Vung Tau,Vung Tau City,19,186,168,18,5
2022-01-30,Vung Tau,Vung Tau City,20,118,110,8,3
2022-01-30,Vung Tau,Vung Tau City,21,84,74,10,3
2022-01-30,Vung Tau,Vung Tau City,22,1,0,1,0
2022-01-31,Binh Duong,Di An,8,1,0,1,1
2022-01-31,Binh Duong,Di An,9,2,0,2,0
2022-01-31,Binh Duong,Di An,10,5,1,4,4
2022-01-31,Binh Duong,Di An,11,1,0,1,1
2022-01-31,Binh Duong,Di An,12,10,0,10,10
2022-01-31,Binh Duong,Di An,13,5,0,5,3
2022-01-31,Binh Duong,Di An,14,4,1,3,3
2022-01-31,Binh Duong,Di An,15,4,4,0,0
2022-01-31,Binh Duong,Di An,17,5,4,1,1
2022-01-31,Binh Duong,Di An,18,4,2,2,2
2022-01-31,Binh Duong,Di An,19,4,2,2,2
2022-01-31,Binh Duong,Di An,20,8,3,5,4
2022-01-31,Binh Duong,Di An,21,2,0,2,2
2022-01-31,Binh Duong,Thu Dau Mot Town,5,1,0,1,1
2022-01-31,Binh Duong,Thu Dau Mot Town,6,15,8,7,7
2022-01-31,Binh Duong,Thu Dau Mot Town,7,35,25,10,9
2022-01-31,Binh Duong,Thu Dau Mot Town,8,72,60,12,6
2022-01-31,Binh Duong,Thu Dau Mot Town,9,97,85,12,7
2022-01-31,Binh Duong,Thu Dau Mot Town,10,136,122,14,2
2022-01-31,Binh Duong,Thu Dau Mot Town,11,163,152,11,4
2022-01-31,Binh Duong,Thu Dau Mot Town,12,128,122,6,1
2022-01-31,Binh Duong,Thu Dau Mot Town,13,124,110,14,7
2022-01-31,Binh Duong,Thu Dau Mot Town,14,104,94,10,4
2022-01-31,Binh Duong,Thu Dau Mot Town,15,101,94,7,6
2022-01-31,Binh Duong,Thu Dau Mot Town,16,113,104,9,3
2022-01-31,Binh Duong,Thu Dau Mot Town,17,91,81,10,2
2022-01-31,Binh Duong,Thu Dau Mot Town,18,107,90,17,13
2022-01-31,Binh Duong,Thu Dau Mot Town,19,132,81,51,42
2022-01-31,Binh Duong,Thu Dau Mot Town,20,124,61,63,41
2022-01-31,Binh Duong,Thu Dau Mot Town,21,66,31,35,22
2022-01-31,Binh Duong,Thu Dau Mot Town,23,1,1,0,0
2022-01-31,Binh Duong,Thuan An,7,2,1,1,0
2022-01-31,Binh Duong,Thuan An,9,9,6,3,3
2022-01-31,Binh Duong,Thuan An,10,27,11,16,15
2022-01-31,Binh Duong,Thuan An,11,28,17,11,10
2022-01-31,Binh Duong,Thuan An,12,40,23,17,11
2022-01-31,Binh Duong,Thuan An,13,21,12,9,8
2022-01-31,Binh Duong,Thuan An,14,26,18,8,6
2022-01-31,Binh Duong,Thuan An,15,21,9,12,9
2022-01-31,Binh Duong,Thuan An,16,14,10,4,1
2022-01-31,Binh Duong,Thuan An,17,9,2,7,7
2022-01-31,Binh Duong,Thuan An,18,11,0,11,10
2022-01-31,Binh Duong,Thuan An,19,13,3,10,8
2022-01-31,Binh Duong,Thuan An,20,23,2,21,20
2022-01-31,Binh Duong,Thuan An,21,11,0,11,8
2022-01-31,Can Tho City,Binh Thuy District,8,2,2,0,0
2022-01-31,Can Tho City,Binh Thuy District,9,4,4,0,0
2022-01-31,Can Tho City,Binh Thuy District,10,7,7,0,0
2022-01-31,Can Tho City,Binh Thuy District,11,8,8,0,0
2022-01-31,Can Tho City,Binh Thuy District,12,2,2,0,0
2022-01-31,Can Tho City,Binh Thuy District,13,6,5,1,0
2022-01-31,Can Tho City,Binh Thuy District,14,7,5,2,0
2022-01-31,Can Tho City,Binh Thuy District,15,4,4,0,0
2022-01-31,Can Tho City,Binh Thuy District,16,1,1,0,0
2022-01-31,Can Tho City,Binh Thuy District,17,4,2,2,1
2022-01-31,Can Tho City,Binh Thuy District,18,4,4,0,0
2022-01-31,Can Tho City,Binh Thuy District,19,11,8,3,0
2022-01-31,Can Tho City,Binh Thuy District,20,8,8,0,0
2022-01-31,Can Tho City,Binh Thuy District,21,3,2,1,0
2022-01-31,Can Tho City,Cai Rang District,7,1,1,0,0
2022-01-31,Can Tho City,Cai Rang District,8,2,2,0,0
2022-01-31,Can Tho City,Cai Rang District,9,3,2,1,0
2022-01-31,Can Tho City,Cai Rang District,10,4,4,0,0
2022-01-31,Can Tho City,Cai Rang District,11,5,3,2,1
2022-01-31,Can Tho City,Cai Rang District,12,2,1,1,0
2022-01-31,Can Tho City,Cai Rang District,13,1,0,1,0
2022-01-31,Can Tho City,Cai Rang District,14,1,0,1,1
2022-01-31,Can Tho City,Cai Rang District,15,2,0,2,0
2022-01-31,Can Tho City,Cai Rang District,16,2,1,1,1
2022-01-31,Can Tho City,Cai Rang District,17,1,1,0,0
2022-01-31,Can Tho City,Cai Rang District,19,2,2,0,0
2022-01-31,Can Tho City,Cai Rang District,20,1,1,0,0
2022-01-31,Can Tho City,Ninh Kieu District,0,1,1,0,0
2022-01-31,Can Tho City,Ninh Kieu District,3,1,1,0,0
2022-01-31,Can Tho City,Ninh Kieu District,6,13,10,3,0
2022-01-31,Can Tho City,Ninh Kieu District,7,40,35,5,0
2022-01-31,Can Tho City,Ninh Kieu District,8,71,62,9,0
2022-01-31,Can Tho City,Ninh Kieu District,9,93,87,6,0
2022-01-31,Can Tho City,Ninh Kieu District,10,88,82,6,0
2022-01-31,Can Tho City,Ninh Kieu District,11,111,103,8,0
2022-01-31,Can Tho City,Ninh Kieu District,12,106,100,6,0
2022-01-31,Can Tho City,Ninh Kieu District,13,113,98,15,0
2022-01-31,Can Tho City,Ninh Kieu District,14,101,93,8,0
2022-01-31,Can Tho City,Ninh Kieu District,15,90,82,8,0
2022-01-31,Can Tho City,Ninh Kieu District,16,95,92,3,0
2022-01-31,Can Tho City,Ninh Kieu District,17,68,63,5,0
2022-01-31,Can Tho City,Ninh Kieu District,18,75,70,5,0
2022-01-31,Can Tho City,Ninh Kieu District,19,86,80,6,0
2022-01-31,Can Tho City,Ninh Kieu District,20,88,77,11,0
2022-01-31,Can Tho City,Ninh Kieu District,21,53,49,4,1
2022-01-31,Can Tho City,Ninh Kieu District,22,1,0,1,0
2022-01-31,Dong Nai,Bien Hoa City,0,1,1,0,0
2022-01-31,Dong Nai,Bien Hoa City,5,1,0,1,0
2022-01-31,Dong Nai,Bien Hoa City,6,16,9,7,3
2022-01-31,Dong Nai,Bien Hoa City,7,66,51,15,13
2022-01-31,Dong Nai,Bien Hoa City,8,104,87,17,9
2022-01-31,Dong Nai,Bien Hoa City,9,165,151,14,3
2022-01-31,Dong Nai,Bien Hoa City,10,270,237,33,8
2022-01-31,Dong Nai,Bien Hoa City,11,376,328,48,18
2022-01-31,Dong Nai,Bien Hoa City,12,404,366,38,12
2022-01-31,Dong Nai,Bien Hoa City,13,351,299,52,30
2022-01-31,Dong Nai,Bien Hoa City,14,281,244,37,18
2022-01-31,Dong Nai,Bien Hoa City,15,223,198,25,4
2022-01-31,Dong Nai,Bien Hoa City,16,213,168,45,9
2022-01-31,Dong Nai,Bien Hoa City,17,222,168,54,22
2022-01-31,Dong Nai,Bien Hoa City,18,214,162,52,36
2022-01-31,Dong Nai,Bien Hoa City,19,295,144,151,99
2022-01-31,Dong Nai,Bien Hoa City,20,294,112,182,152
2022-01-31,Dong Nai,Bien Hoa City,21,161,76,85,63
2022-01-31,Dong Nai,Long Thanh,19,1,0,1,0
2022-01-31,Dong Nai,Long Thanh,20,3,0,3,3
2022-01-31,Dong Nai,Long Thanh,21,2,0,2,2
2022-01-31,Dong Nai,Thong Nhat,7,2,2,0,0
2022-01-31,Dong Nai,Thong Nhat,8,1,1,0,0
2022-01-31,Dong Nai,Thong Nhat,9,1,1,0,0
2022-01-31,Dong Nai,Thong Nhat,10,1,1,0,0
2022-01-31,Dong Nai,Thong Nhat,11,4,4,0,0
2022-01-31,Dong Nai,Thong Nhat,12,3,3,0,0
2022-01-31,Dong Nai,Thong Nhat,13,3,2,1,1
2022-01-31,Dong Nai,Thong Nhat,14,1,1,0,0
2022-01-31,Dong Nai,Thong Nhat,15,1,1,0,0
2022-01-31,Dong Nai,Thong Nhat,16,3,3,0,0
2022-01-31,Dong Nai,Thong Nhat,18,2,2,0,0
2022-01-31,Dong Nai,Thong Nhat,19,2,2,0,0
2022-01-31,Dong Nai,Thong Nhat,20,4,3,1,0
2022-01-31,Hai Phong City,An Duong,9,2,0,2,1
2022-01-31,Hai Phong City,An Duong,12,1,0,1,1
2022-01-31,Hai Phong City,Hai An District,7,1,0,1,0
2022-01-31,Hai Phong City,Hai An District,8,1,0,1,0
2022-01-31,Hai Phong City,Hai An District,11,2,0,2,2
2022-01-31,Hai Phong City,Hai An District,12,1,0,1,1
2022-01-31,Hai Phong City,Hai An District,13,4,1,3,2
2022-01-31,Hai Phong City,Hai An District,14,1,1,0,0
2022-01-31,Hai Phong City,Hai An District,15,2,2,0,0
2022-01-31,Hai Phong City,Hai An District,17,2,0,2,2
2022-01-31,Hai Phong City,Hai An District,18,1,0,1,1
2022-01-31,Hai Phong City,Hai An District,19,2,0,2,2
2022-01-31,Hai Phong City,Hai An District,20,3,0,3,3
2022-01-31,Hai Phong City,Hai An District,21,1,0,1,1
2022-01-31,Hai Phong City,Hong Bang District,7,1,0,1,1
2022-01-31,Hai Phong City,Hong Bang District,8,6,2,4,4
2022-01-31,Hai Phong City,Hong Bang District,9,10,8,2,1
2022-01-31,Hai Phong City,Hong Bang District,10,14,10,4,2
2022-01-31,Hai Phong City,Hong Bang District,11,4,2,2,1
2022-01-31,Hai Phong City,Hong Bang District,12,11,9,2,1
2022-01-31,Hai Phong City,Hong Bang District,13,8,7,1,1
2022-01-31,Hai Phong City,Hong Bang District,14,13,11,2,1
2022-01-31,Hai Phong City,Hong Bang District,15,15,11,4,4
2022-01-31,Hai Phong City,Hong Bang District,16,26,13,13,11
2022-01-31,Hai Phong City,Hong Bang District,17,22,10,12,12
2022-01-31,Hai Phong City,Hong Bang District,18,9,2,7,7
2022-01-31,Hai Phong City,Hong Bang District,19,16,3,13,12
2022-01-31,Hai Phong City,Hong Bang District,20,11,2,9,9
2022-01-31,Hai Phong City,Hong Bang District,21,10,0,10,10
2022-01-31,Hai Phong City,Kien An District,7,1,0,1,1
2022-01-31,Hai Phong City,Kien An District,9,2,1,1,1
2022-01-31,Hai Phong City,Kien An District,10,1,0,1,1
2022-01-31,Hai Phong City,Kien An District,11,1,0,1,0
2022-01-31,Hai Phong City,Kien An District,12,1,0,1,0
2022-01-31,Hai Phong City,Kien An District,13,5,0,5,5
2022-01-31,Hai Phong City,Kien An District,14,1,0,1,1
2022-01-31,Hai Phong City,Kien An District,16,1,0,1,1
2022-01-31,Hai Phong City,Kien An District,17,4,1,3,2
2022-01-31,Hai Phong City,Kien An District,18,5,2,3,1
2022-01-31,Hai Phong City,Kien An District,19,7,0,7,7
2022-01-31,Hai Phong City,Kien An District,20,4,0,4,4
2022-01-31,Hai Phong City,Kien An District,21,8,0,8,8
2022-01-31,Hai Phong City,Le Chan District,0,1,0,1,0
2022-01-31,Hai Phong City,Le Chan District,6,1,1,0,0
2022-01-31,Hai Phong City,Le Chan District,7,18,8,10,7
2022-01-31,Hai Phong City,Le Chan District,8,25,18,7,2
2022-01-31,Hai Phong City,Le Chan District,9,23,20,3,0
2022-01-31,Hai Phong City,Le Chan District,10,53,43,10,4
2022-01-31,Hai Phong City,Le Chan District,11,89,63,26,22
2022-01-31,Hai Phong City,Le Chan District,12,78,50,28,25
2022-01-31,Hai Phong City,Le Chan District,13,54,41,13,9
2022-01-31,Hai Phong City,Le Chan District,14,43,31,12,8
2022-01-31,Hai Phong City,Le Chan District,15,63,36,27,14
2022-01-31,Hai Phong City,Le Chan District,16,68,39,29,22
2022-01-31,Hai Phong City,Le Chan District,17,57,30,27,14
2022-01-31,Hai Phong City,Le Chan District,18,43,14,29,22
2022-01-31,Hai Phong City,Le Chan District,19,60,21,39,29
2022-01-31,Hai Phong City,Le Chan District,20,36,8,28,22
2022-01-31,Hai Phong City,Le Chan District,21,22,4,18,12
2022-01-31,Hai Phong City,Le Chan District,22,1,0,1,0
2022-01-31,Hai Phong City,Ngo Quyen District,0,1,0,1,0
2022-01-31,Hai Phong City,Ngo Quyen District,6,1,0,1,0
2022-01-31,Hai Phong City,Ngo Quyen District,7,9,6,3,3
2022-01-31,Hai Phong City,Ngo Quyen District,8,35,30,5,3
2022-01-31,Hai Phong City,Ngo Quyen District,9,36,30,6,2
2022-01-31,Hai Phong City,Ngo Quyen District,10,49,39,10,4
2022-01-31,Hai Phong City,Ngo Quyen District,11,66,49,17,11
2022-01-31,Hai Phong City,Ngo Quyen District,12,59,47,12,5
2022-01-31,Hai Phong City,Ngo Quyen District,13,33,30,3,0
2022-01-31,Hai Phong City,Ngo Quyen District,14,35,31,4,1
2022-01-31,Hai Phong City,Ngo Quyen District,15,63,50,13,8
2022-01-31,Hai Phong City,Ngo Quyen District,16,68,50,18,9
2022-01-31,Hai Phong City,Ngo Quyen District,17,43,30,13,5
2022-01-31,Hai Phong City,Ngo Quyen District,18,59,33,26,20
2022-01-31,Hai Phong City,Ngo Quyen District,19,73,21,52,38
2022-01-31,Hai Phong City,Ngo Quyen District,20,57,29,28,21
2022-01-31,Hai Phong City,Ngo Quyen District,21,46,10,36,31
2022-01-31,Hai Phong City,Ngo Quyen District,22,2,0,2,0
2022-01-31,Hai Phong City,Ngo Quyen District,23,1,0,1,0
2022-01-31,Hue City,Hue City,1,2,0,2,0
2022-01-31,Hue City,Hue City,4,1,0,1,0
2022-01-31,Hue City,Hue City,5,1,0,1,0
2022-01-31,Hue City,Hue City,6,13,10,3,0
2022-01-31,Hue City,Hue City,7,70,62,8,1
2022-01-31,Hue City,Hue City,8,142,133,9,1
2022-01-31,Hue City,Hue City,9,176,152,24,0
2022-01-31,Hue City,Hue City,10,142,123,19,0
2022-01-31,Hue City,Hue City,11,179,157,22,2
2022-01-31,Hue City,Hue City,12,126,112,14,2
2022-01-31,Hue City,Hue City,13,120,102,18,1
2022-01-31,Hue City,Hue City,14,96,80,16,1
2022-01-31,Hue City,Hue City,15,112,94,18,3
2022-01-31,Hue City,Hue City,16,147,128,19,1
2022-01-31,Hue City,Hue City,17,197,150,47,12
2022-01-31,Hue City,Hue City,18,171,137,34,9
2022-01-31,Hue City,Hue City,19,164,130,34,13
2022-01-31,Hue City,Hue City,20,149,89,60,32
2022-01-31,Hue City,Hue City,21,83,57,26,10
2022-01-31,Hue City,Hue City,22,3,0,3,0
2022-01-31,Hue City,Huong Thuy,17,1,1,0,0
2022-01-31,Hue City,Phu Vang,11,1,1,0,0
2022-01-31,Hue City,Phu Vang,12,2,0,2,0
2022-01-31,Hue City,Phu Vang,16,2,1,1,0
2022-01-31,Vung Tau,Ba Ria City,8,3,0,3,2
2022-01-31,Vung Tau,Ba Ria City,9,2,1,1,1
2022-01-31,Vung Tau,Ba Ria City,10,3,3,0,0
2022-01-31,Vung Tau,Ba Ria City,11,1,1,0,0
2022-01-31,Vung Tau,Ba Ria City,14,3,2,1,1
2022-01-31,Vung Tau,Ba Ria City,15,6,0,6,6
2022-01-31,Vung Tau,Ba Ria City,16,3,0,3,2
2022-01-31,Vung Tau,Ba Ria City,17,4,0,4,4
2022-01-31,Vung Tau,Ba Ria City,18,3,0,3,3
2022-01-31,Vung Tau,Ba Ria City,19,1,0,1,1
2022-01-31,Vung Tau,Ba Ria City,20,2,0,2,2
2022-01-31,Vung Tau,Ba Ria City,21,3,0,3,3
2022-01-31,Vung Tau,Vung Tau City,6,12,11,1,1
2022-01-31,Vung Tau,Vung Tau City,7,51,45,6,1
2022-01-31,Vung Tau,Vung Tau City,8,89,79,10,1
2022-01-31,Vung Tau,Vung Tau City,9,115,100,15,1
2022-01-31,Vung Tau,Vung Tau City,10,98,91,7,0
2022-01-31,Vung Tau,Vung Tau City,11,113,107,6,0
2022-01-31,Vung Tau,Vung Tau City,12,108,101,7,1
2022-01-31,Vung Tau,Vung Tau City,13,103,93,10,0
2022-01-31,Vung Tau,Vung Tau City,14,109,101,8,2
2022-01-31,Vung Tau,Vung Tau City,15,97,93,4,0
2022-01-31,Vung Tau,Vung Tau City,16,105,98,7,0
2022-01-31,Vung Tau,Vung Tau City,17,87,79,8,0
2022-01-31,Vung Tau,Vung Tau City,18,93,89,4,1
2022-01-31,Vung Tau,Vung Tau City,19,106,91,15,1
2022-01-31,Vung Tau,Vung Tau City,20,85,72,13,5
2022-01-31,Vung Tau,Vung Tau City,21,64,46,18,11
2022-01-31,Vung Tau,Vung Tau City,22,1,0,1,0
2022-02-01,Binh Duong,Di An,0,1,0,1,0
2022-02-01,Binh Duong,Di An,9,2,0,2,2
2022-02-01,Binh Duong,Di An,11,6,0,6,6
2022-02-01,Binh Duong,Di An,12,3,0,3,2
2022-02-01,Binh Duong,Di An,13,5,0,5,5
2022-02-01,Binh Duong,Di An,14,11,0,11,10
2022-02-01,Binh Duong,Di An,15,6,0,6,5
2022-02-01,Binh Duong,Di An,16,11,0,11,11
2022-02-01,Binh Duong,Di An,17,4,1,3,2
2022-02-01,Binh Duong,Di An,18,7,0,7,7
2022-02-01,Binh Duong,Di An,19,17,0,17,16
2022-02-01,Binh Duong,Di An,20,6,0,6,5
2022-02-01,Binh Duong,Di An,21,2,0,2,2
2022-02-01,Binh Duong,Tan Uyen,8,1,0,1,1
2022-02-01,Binh Duong,Tan Uyen,14,1,0,1,1
2022-02-01,Binh Duong,Tan Uyen,16,1,0,1,1
2022-02-01,Binh Duong,Thu Dau Mot Town,0,1,0,1,1
2022-02-01,Binh Duong,Thu Dau Mot Town,7,13,5,8,6
2022-02-01,Binh Duong,Thu Dau Mot Town,8,33,16,17,11
2022-02-01,Binh Duong,Thu Dau Mot Town,9,36,24,12,7
2022-02-01,Binh Duong,Thu Dau Mot Town,10,55,44,11,3
2022-02-01,Binh Duong,Thu Dau Mot Town,11,79,63,16,8
2022-02-01,Binh Duong,Thu Dau Mot Town,12,115,72,43,26
2022-02-01,Binh Duong,Thu Dau Mot Town,13,123,70,53,42
2022-02-01,Binh Duong,Thu Dau Mot Town,14,98,59,39,32
2022-02-01,Binh Duong,Thu Dau Mot Town,15,108,78,30,21
2022-02-01,Binh Duong,Thu Dau Mot Town,16,119,70,49,38
2022-02-01,Binh Duong,Thu Dau Mot Town,17,109,81,28,20
2022-02-01,Binh Duong,Thu Dau Mot Town,18,142,94,48,33
2022-02-01,Binh Duong,Thu Dau Mot Town,19,175,80,95,71
2022-02-01,Binh Duong,Thu Dau Mot Town,20,156,69,87,68
2022-02-01,Binh Duong,Thu Dau Mot Town,21,96,41,55,36
2022-02-01,Binh Duong,Thu Dau Mot Town,22,1,1,0,0
2022-02-01,Binh Duong,Thuan An,0,1,0,1,1
2022-02-01,Binh Duong,Thuan An,8,2,0,2,1
2022-02-01,Binh Duong,Thuan An,9,3,0,3,3
2022-02-01,Binh Duong,Thuan An,10,8,1,7,6
2022-02-01,Binh Duong,Thuan An,11,27,14,13,10
2022-02-01,Binh Duong,Thuan An,12,26,9,17,16
2022-02-01,Binh Duong,Thuan An,13,28,5,23,23
2022-02-01,Binh Duong,Thuan An,14,31,3,28,26
2022-02-01,Binh Duong,Thuan An,15,27,8,19,15
2022-02-01,Binh Duong,Thuan An,16,36,3,33,31
2022-02-01,Binh Duong,Thuan An,17,46,3,43,36
2022-02-01,Binh Duong,Thuan An,18,25,5,20,19
2022-02-01,Binh Duong,Thuan An,19,30,6,24,21
2022-02-01,Binh Duong,Thuan An,20,23,1,22,19
2022-02-01,Binh Duong,Thuan An,21,17,1,16,15
2022-02-01,Can Tho City,Binh Thuy District,9,1,1,0,0
2022-02-01,Can Tho City,Binh Thuy District,10,2,2,0,0
2022-02-01,Can Tho City,Binh Thuy District,11,6,6,0,0
2022-02-01,Can Tho City,Binh Thuy District,12,5,5,0,0
2022-02-01,Can Tho City,Binh Thuy District,13,6,6,0,0
2022-02-01,Can Tho City,Binh Thuy District,14,11,9,2,0
2022-02-01,Can Tho City,Binh Thuy District,15,7,7,0,0
2022-02-01,Can Tho City,Binh Thuy District,16,7,7,0,0
2022-02-01,Can Tho City,Binh Thuy District,17,5,5,0,0
2022-02-01,Can Tho City,Binh Thuy District,18,5,4,1,1
2022-02-01,Can Tho City,Binh Thuy District,19,6,4,2,0
2022-02-01,Can Tho City,Binh Thuy District,20,7,6,1,1
2022-02-01,Can Tho City,Binh Thuy District,21,2,2,0,0
2022-02-01,Can Tho City,Cai Rang District,7,3,1,2,0
2022-02-01,Can Tho City,Cai Rang District,8,1,1,0,0
2022-02-01,Can Tho City,Cai Rang District,10,1,0,1,0
2022-02-01,Can Tho City,Cai Rang District,12,4,3,1,0
2022-02-01,Can Tho City,Cai Rang District,14,1,1,0,0
2022-02-01,Can Tho City,Cai Rang District,15,2,2,0,0
2022-02-01,Can Tho City,Cai Rang District,16,1,1,0,0
2022-02-01,Can Tho City,Cai Rang District,18,1,1,0,0
2022-02-01,Can Tho City,Cai Rang District,19,4,2,2,1
2022-02-01,Can Tho City,Cai Rang District,20,1,1,0,0
2022-02-01,Can Tho City,Ninh Kieu District,6,6,4,2,1
2022-02-01,Can Tho City,Ninh Kieu District,7,21,17,4,0
2022-02-01,Can Tho City,Ninh Kieu District,8,20,17,3,1
2022-02-01,Can Tho City,Ninh Kieu District,9,38,36,2,0
2022-02-01,Can Tho City,Ninh Kieu District,10,58,54,4,0
2022-02-01,Can Tho City,Ninh Kieu District,11,89,80,9,0
2022-02-01,Can Tho City,Ninh Kieu District,12,99,90,9,0
2022-02-01,Can Tho City,Ninh Kieu District,13,86,81,5,0
2022-02-01,Can Tho City,Ninh Kieu District,14,72,69,3,0
2022-02-01,Can Tho City,Ninh Kieu District,15,69,62,7,0
2022-02-01,Can Tho City,Ninh Kieu District,16,90,82,8,1
2022-02-01,Can Tho City,Ninh Kieu District,17,96,89,7,1
2022-02-01,Can Tho City,Ninh Kieu District,18,119,109,10,0
2022-02-01,Can Tho City,Ninh Kieu District,19,138,127,11,3
2022-02-01,Can Tho City,Ninh Kieu District,20,91,83,8,6
2022-02-01,Can Tho City,Ninh Kieu District,21,50,45,5,0
2022-02-01,Can Tho City,Ninh Kieu District,22,1,1,0,0
2022-02-01,Can Tho City,Ninh Kieu District,23,2,2,0,0
2022-02-01,Dong Nai,Bien Hoa City,6,4,0,4,4
2022-02-01,Dong Nai,Bien Hoa City,7,13,4,9,6
2022-02-01,Dong Nai,Bien Hoa City,8,40,17,23,10
2022-02-01,Dong Nai,Bien Hoa City,9,65,48,17,11
2022-02-01,Dong Nai,Bien Hoa City,10,100,60,40,21
2022-02-01,Dong Nai,Bien Hoa City,11,170,102,68,45
2022-02-01,Dong Nai,Bien Hoa City,12,231,117,114,96
2022-02-01,Dong Nai,Bien Hoa City,13,304,149,155,133
2022-02-01,Dong Nai,Bien Hoa City,14,221,127,94,69
2022-02-01,Dong Nai,Bien Hoa City,15,216,133,83,62
2022-02-01,Dong Nai,Bien Hoa City,16,229,149,80,66
2022-02-01,Dong Nai,Bien Hoa City,17,230,150,80,65
2022-02-01,Dong Nai,Bien Hoa City,18,299,151,148,120
2022-02-01,Dong Nai,Bien Hoa City,19,439,140,299,237
2022-02-01,Dong Nai,Bien Hoa City,20,362,102,260,221
2022-02-01,Dong Nai,Bien Hoa City,21,229,57,172,149
2022-02-01,Dong Nai,Bien Hoa City,22,3,0,3,0
2022-02-01,Dong Nai,Long Thanh,9,2,0,2,2
2022-02-01,Dong Nai,Long Thanh,10,1,0,1,1
2022-02-01,Dong Nai,Long Thanh,11,5,0,5,4
2022-02-01,Dong Nai,Long Thanh,14,1,0,1,1
2022-02-01,Dong Nai,Long Thanh,18,1,0,1,1
2022-02-01,Dong Nai,Long Thanh,19,1,0,1,1
2022-02-01,Dong Nai,Long Thanh,20,2,0,2,2
2022-02-01,Dong Nai,Long Thanh,21,1,0,1,1
2022-02-01,Dong Nai,Thong Nhat,8,1,1,0,0
2022-02-01,Dong Nai,Thong Nhat,10,2,2,0,0
2022-02-01,Dong Nai,Thong Nhat,11,1,1,0,0
2022-02-01,Dong Nai,Thong Nhat,12,1,1,0,0
2022-02-01,Dong Nai,Thong Nhat,13,1,1,0,0
2022-02-01,Dong Nai,Thong Nhat,14,3,3,0,0
2022-02-01,Dong Nai,Thong Nhat,15,2,0,2,2
2022-02-01,Dong Nai,Thong Nhat,16,1,1,0,0
2022-02-01,Dong Nai,Thong Nhat,17,1,1,0,0
2022-02-01,Dong Nai,Thong Nhat,18,3,1,2,2
2022-02-01,Dong Nai,Thong Nhat,19,6,1,5,5
2022-02-01,Dong Nai,Thong Nhat,20,1,0,1,1
2022-02-01,Dong Nai,Thong Nhat,21,2,2,0,0
2022-02-01,Hai Phong City,An Duong,15,2,0,2,2
2022-02-01,Hai Phong City,An Duong,20,1,1,0,0
2022-02-01,Hai Phong City,Hai An District,20,2,0,2,2
2022-02-01,Hai Phong City,Hai An District,21,3,1,2,2
2022-02-01,Hai Phong City,Hong Bang District,9,2,0,2,2
2022-02-01,Hai Phong City,Hong Bang District,10,3,1,2,2
2022-02-01,Hai Phong City,Hong Bang District,11,2,1,1,1
2022-02-01,Hai Phong City,Hong Bang District,12,8,6,2,0
2022-02-01,Hai Phong City,Hong Bang District,13,4,2,2,2
2022-02-01,Hai Phong City,Hong Bang District,14,8,5,3,1
2022-02-01,Hai Phong City,Hong Bang District,15,5,3,2,2
2022-02-01,Hai Phong City,Hong Bang District,16,7,3,4,1
2022-02-01,Hai Phong City,Hong Bang District,17,10,4,6,3
2022-02-01,Hai Phong City,Hong Bang District,18,11,1,10,9
2022-02-01,Hai Phong City,Hong Bang District,19,13,3,10,9
2022-02-01,Hai Phong City,Hong Bang District,20,13,3,10,10
2022-02-01,Hai Phong City,Hong Bang District,21,5,0,5,5
2022-02-01,Hai Phong City,Kien An District,11,1,0,1,1
2022-02-01,Hai Phong City,Kien An District,12,5,0,5,5
2022-02-01,Hai Phong City,Kien An District,13,5,0,5,5
2022-02-01,Hai Phong City,Kien An District,14,8,1,7,7
2022-02-01,Hai Phong City,Kien An District,15,9,0,9,7
2022-02-01,Hai Phong City,Kien An District,16,3,0,3,3
2022-02-01,Hai Phong City,Kien An District,17,6,0,6,3
2022-02-01,Hai Phong City,Kien An District,18,4,0,4,3
2022-02-01,Hai Phong City,Kien An District,19,7,0,7,6
2022-02-01,Hai Phong City,Kien An District,20,7,0,7,7
2022-02-01,Hai Phong City,Kien An District,21,1,0,1,1
2022-02-01,Hai Phong City,Le Chan District,3,1,0,1,0
2022-02-01,Hai Phong City,Le Chan District,7,1,1,0,0
2022-02-01,Hai Phong City,Le Chan District,8,3,1,2,1
2022-02-01,Hai Phong City,Le Chan District,9,10,4,6,4
2022-02-01,Hai Phong City,Le Chan District,10,18,8,10,8
2022-02-01,Hai Phong City,Le Chan District,11,19,6,13,1
2022-02-01,Hai Phong City,Le Chan District,12,16,7,9,4
2022-02-01,Hai Phong City,Le Chan District,13,19,12,7,4
2022-02-01,Hai Phong City,Le Chan District,14,22,11,11,3
2022-02-01,Hai Phong City,Le Chan District,15,33,23,10,9
2022-02-01,Hai Phong City,Le Chan District,16,56,24,32,23
2022-02-01,Hai Phong City,Le Chan District,17,77,30,47,39
2022-02-01,Hai Phong City,Le Chan District,18,97,35,62,58
2022-02-01,Hai Phong City,Le Chan District,19,120,36,84,74
2022-02-01,Hai Phong City,Le Chan District,20,90,24,66,57
2022-02-01,Hai Phong City,Le Chan District,21,46,16,30,27
2022-02-01,Hai Phong City,Le Chan District,22,1,0,1,0
2022-02-01,Hai Phong City,Le Chan District,23,1,1,0,0
2022-02-01,Hai Phong City,Ngo Quyen District,8,4,1,3,1
2022-02-01,Hai Phong City,Ngo Quyen District,9,4,2,2,2
2022-02-01,Hai Phong City,Ngo Quyen District,10,17,6,11,5
2022-02-01,Hai Phong City,Ngo Quyen District,11,40,22,18,9
2022-02-01,Hai Phong City,Ngo Quyen District,12,19,9,10,4
2022-02-01,Hai Phong City,Ngo Quyen District,13,38,23,15,2
2022-02-01,Hai Phong City,Ngo Quyen District,14,31,26,5,2
2022-02-01,Hai Phong City,Ngo Quyen District,15,37,24,13,11
2022-02-01,Hai Phong City,Ngo Quyen District,16,54,30,24,17
2022-02-01,Hai Phong City,Ngo Quyen District,17,55,36,19,15
2022-02-01,Hai Phong City,Ngo Quyen District,18,69,41,28,21
2022-02-01,Hai Phong City,Ngo Quyen District,19,96,45,51,48
2022-02-01,Hai Phong City,Ngo Quyen District,20,118,44,74,57
2022-02-01,Hai Phong City,Ngo Quyen District,21,45,23,22,19
2022-02-01,Hai Phong City,Thuy Nguyen,21,1,0,1,1
2022-02-01,Hue City,Hue City,6,4,0,4,1
2022-02-01,Hue City,Hue City,7,14,10,4,1
2022-02-01,Hue City,Hue City,8,27,22,5,0
2022-02-01,Hue City,Hue City,9,31,25,6,1
2022-02-01,Hue City,Hue City,10,42,34,8,0
2022-02-01,Hue City,Hue City,11,57,49,8,0
2022-02-01,Hue City,Hue City,12,59,47,12,0
2022-02-01,Hue City,Hue City,13,58,49,9,1
2022-02-01,Hue City,Hue City,14,74,69,5,0
2022-02-01,Hue City,Hue City,15,74,67,7,1
2022-02-01,Hue City,Hue City,16,96,93,3,1
2022-02-01,Hue City,Hue City,17,153,137,16,3
2022-02-01,Hue City,Hue City,18,158,138,20,3
2022-02-01,Hue City,Hue City,19,156,133,23,8
2022-02-01,Hue City,Hue City,20,168,132,36,22
2022-02-01,Hue City,Hue City,21,64,56,8,3
2022-02-01,Hue City,Hue City,22,2,0,2,0
2022-02-01,Hue City,Phu Vang,12,1,0,1,0
2022-02-01,Hue City,Phu Vang,18,3,3,0,0
2022-02-01,Hue City,Phu Vang,20,1,1,0,0
2022-02-01,Hue City,Phu Vang,21,1,1,0,0
2022-02-01,Vung Tau,Ba Ria City,9,1,0,1,1
2022-02-01,Vung Tau,Ba Ria City,11,4,0,4,4
2022-02-01,Vung Tau,Ba Ria City,12,5,0,5,5
2022-02-01,Vung Tau,Ba Ria City,13,12,0,12,8
2022-02-01,Vung Tau,Ba Ria City,14,9,0,9,9
2022-02-01,Vung Tau,Ba Ria City,15,7,0,7,7
2022-02-01,Vung Tau,Ba Ria City,16,5,0,5,5
2022-02-01,Vung Tau,Ba Ria City,17,5,0,5,4
2022-02-01,Vung Tau,Ba Ria City,18,4,0,4,4
2022-02-01,Vung Tau,Ba Ria City,19,12,0,12,10
2022-02-01,Vung Tau,Ba Ria City,20,6,0,6,5
2022-02-01,Vung Tau,Ba Ria City,21,1,0,1,1
2022-02-01,Vung Tau,Vung Tau City,1,1,1,0,0
2022-02-01,Vung Tau,Vung Tau City,2,1,0,1,0
2022-02-01,Vung Tau,Vung Tau City,7,11,7,4,0
2022-02-01,Vung Tau,Vung Tau City,8,23,15,8,2
2022-02-01,Vung Tau,Vung Tau City,9,39,32,7,1
2022-02-01,Vung Tau,Vung Tau City,10,57,43,14,6
2022-02-01,Vung Tau,Vung Tau City,11,70,68,2,0
2022-02-01,Vung Tau,Vung Tau City,12,93,73,20,10
2022-02-01,Vung Tau,Vung Tau City,13,88,74,14,10
2022-02-01,Vung Tau,Vung Tau City,14,70,63,7,4
2022-02-01,Vung Tau,Vung Tau City,15,84,76,8,5
2022-02-01,Vung Tau,Vung Tau City,16,81,68,13,5
2022-02-01,Vung Tau,Vung Tau City,17,92,74,18,5
2022-02-01,Vung Tau,Vung Tau City,18,118,91,27,10
2022-02-01,Vung Tau,Vung Tau City,19,142,109,33,25
2022-02-01,Vung Tau,Vung Tau City,20,138,91,47,34
2022-02-01,Vung Tau,Vung Tau City,21,67,47,20,10
2022-02-01,Vung Tau,Vung Tau City,22,1,1,0,0
2022-02-02,Binh Duong,Di An,4,1,0,1,1
2022-02-02,Binh Duong,Di An,8,3,1,2,1
2022-02-02,Binh Duong,Di An,9,4,0,4,1
2022-02-02,Binh Duong,Di An,10,5,2,3,2
2022-02-02,Binh Duong,Di An,11,12,3,9,9
2022-02-02,Binh Duong,Di An,12,14,0,14,14
2022-02-02,Binh Duong,Di An,13,9,1,8,7
2022-02-02,Binh Duong,Di An,14,12,0,12,11
2022-02-02,Binh Duong,Di An,15,14,1,13,12
2022-02-02,Binh Duong,Di An,16,9,0,9,9
2022-02-02,Binh Duong,Di An,17,9,1,8,7
2022-02-02,Binh Duong,Di An,18,15,0,15,15
2022-02-02,Binh Duong,Di An,19,19,0,19,19
2022-02-02,Binh Duong,Di An,20,19,1,18,18
2022-02-02,Binh Duong,Di An,21,4,0,4,4
2022-02-02,Binh Duong,Tan Uyen,9,1,1,0,0
2022-02-02,Binh Duong,Tan Uyen,16,1,0,1,0
2022-02-02,Binh Duong,Thu Dau Mot Town,6,6,1,5,4
2022-02-02,Binh Duong,Thu Dau Mot Town,7,25,18,7,7
2022-02-02,Binh Duong,Thu Dau Mot Town,8,44,36,8,3
2022-02-02,Binh Duong,Thu Dau Mot Town,9,73,62,11,0
2022-02-02,Binh Duong,Thu Dau Mot Town,10,111,92,19,8
2022-02-02,Binh Duong,Thu Dau Mot Town,11,144,128,16,8
2022-02-02,Binh Duong,Thu Dau Mot Town,12,151,138,13,8
2022-02-02,Binh Duong,Thu Dau Mot Town,13,122,104,18,9
2022-02-02,Binh Duong,Thu Dau Mot Town,14,138,115,23,13
2022-02-02,Binh Duong,Thu Dau Mot Town,15,137,113,24,16
2022-02-02,Binh Duong,Thu Dau Mot Town,16,125,105,20,11
2022-02-02,Binh Duong,Thu Dau Mot Town,17,133,113,20,12
2022-02-02,Binh Duong,Thu Dau Mot Town,18,142,117,25,20
2022-02-02,Binh Duong,Thu Dau Mot Town,19,151,109,42,25
2022-02-02,Binh Duong,Thu Dau Mot Town,20,129,97,32,21
2022-02-02,Binh Duong,Thu Dau Mot Town,21,60,43,17,12
2022-02-02,Binh Duong,Thuan An,8,5,0,5,5
2022-02-02,Binh Duong,Thuan An,9,10,2,8,4
2022-02-02,Binh Duong,Thuan An,10,29,11,18,14
2022-02-02,Binh Duong,Thuan An,11,32,5,27,25
2022-02-02,Binh Duong,Thuan An,12,43,13,30,26
2022-02-02,Binh Duong,Thuan An,13,38,12,26,24
2022-02-02,Binh Duong,Thuan An,14,53,14,39,32
2022-02-02,Binh Duong,Thuan An,15,35,9,26,24
2022-02-02,Binh Duong,Thuan An,16,28,4,24,24
2022-02-02,Binh Duong,Thuan An,17,33,2,31,30
2022-02-02,Binh Duong,Thuan An,18,30,5,25,23
2022-02-02,Binh Duong,Thuan An,19,47,6,41,35
2022-02-02,Binh Duong,Thuan An,20,18,4,14,12
2022-02-02,Binh Duong,Thuan An,21,8,2,6,5
2022-02-02,Can Tho City,Binh Thuy District,8,3,2,1,0
2022-02-02,Can Tho City,Binh Thuy District,9,5,5,0,0
2022-02-02,Can Tho City,Binh Thuy District,10,8,6,2,2
2022-02-02,Can Tho City,Binh Thuy District,11,8,7,1,0
2022-02-02,Can Tho City,Binh Thuy District,12,6,6,0,0
2022-02-02,Can Tho City,Binh Thuy District,13,7,5,2,0
2022-02-02,Can Tho City,Binh Thuy District,14,4,3,1,0
2022-02-02,Can Tho City,Binh Thuy District,15,3,3,0,0
2022-02-02,Can Tho City,Binh Thuy District,16,6,6,0,0
2022-02-02,Can Tho City,Binh Thuy District,17,4,4,0,0
2022-02-02,Can Tho City,Binh Thuy District,18,8,7,1,0
2022-02-02,Can Tho City,Binh Thuy District,19,8,8,0,0
2022-02-02,Can Tho City,Binh Thuy District,20,5,5,0,0
2022-02-02,Can Tho City,Binh Thuy District,21,4,4,0,0
2022-02-02,Can Tho City,Cai Rang District,7,2,0,2,2
2022-02-02,Can Tho City,Cai Rang District,8,2,1,1,0
2022-02-02,Can Tho City,Cai Rang District,9,1,1,0,0
2022-02-02,Can Tho City,Cai Rang District,10,3,2,1,1
2022-02-02,Can Tho City,Cai Rang District,11,6,6,0,0
2022-02-02,Can Tho City,Cai Rang District,12,2,2,0,0
2022-02-02,Can Tho City,Cai Rang District,13,3,3,0,0
2022-02-02,Can Tho City,Cai Rang District,14,1,0,1,1
2022-02-02,Can Tho City,Cai Rang District,15,7,7,0,0
2022-02-02,Can Tho City,Cai Rang District,16,4,4,0,0
2022-02-02,Can Tho City,Cai Rang District,17,7,7,0,0
2022-02-02,Can Tho City,Cai Rang District,18,7,6,1,0
2022-02-02,Can Tho City,Cai Rang District,19,8,8,0,0
2022-02-02,Can Tho City,Cai Rang District,20,6,4,2,0
2022-02-02,Can Tho City,Cai Rang District,21,1,0,1,1
2022-02-02,Can Tho City,Ninh Kieu District,6,4,3,1,0
2022-02-02,Can Tho City,Ninh Kieu District,7,26,25,1,0
2022-02-02,Can Tho City,Ninh Kieu District,8,48,45,3,0
2022-02-02,Can Tho City,Ninh Kieu District,9,70,65,5,0
2022-02-02,Can Tho City,Ninh Kieu District,10,67,64,3,0
2022-02-02,Can Tho City,Ninh Kieu District,11,114,105,9,0
2022-02-02,Can Tho City,Ninh Kieu District,12,108,101,7,0
2022-02-02,Can Tho City,Ninh Kieu District,13,119,111,8,0
2022-02-02,Can Tho City,Ninh Kieu District,14,88,84,4,0
2022-02-02,Can Tho City,Ninh Kieu District,15,102,97,5,0
2022-02-02,Can Tho City,Ninh Kieu District,16,96,94,2,0
2022-02-02,Can Tho City,Ninh Kieu District,17,117,111,6,0
2022-02-02,Can Tho City,Ninh Kieu District,18,124,111,13,0
2022-02-02,Can Tho City,Ninh Kieu District,19,148,142,6,1
2022-02-02,Can Tho City,Ninh Kieu District,20,116,108,8,0
2022-02-02,Can Tho City,Ninh Kieu District,21,49,43,6,0
2022-02-02,Can Tho City,Ninh Kieu District,23,1,1,0,0
2022-02-02,Dong Nai,Bien Hoa City,0,2,0,2,0
2022-02-02,Dong Nai,Bien Hoa City,1,2,0,2,0
2022-02-02,Dong Nai,Bien Hoa City,2,2,0,2,0
2022-02-02,Dong Nai,Bien Hoa City,3,1,0,1,0
2022-02-02,Dong Nai,Bien Hoa City,6,9,3,6,4
2022-02-02,Dong Nai,Bien Hoa City,7,41,24,17,10
2022-02-02,Dong Nai,Bien Hoa City,8,86,67,19,7
2022-02-02,Dong Nai,Bien Hoa City,9,178,129,49,33
2022-02-02,Dong Nai,Bien Hoa City,10,305,212,93,59
2022-02-02,Dong Nai,Bien Hoa City,11,412,291,121,86
2022-02-02,Dong Nai,Bien Hoa City,12,509,326,183,148
2022-02-02,Dong Nai,Bien Hoa City,13,465,282,183,136
2022-02-02,Dong Nai,Bien Hoa City,14,354,244,110,72
2022-02-02,Dong Nai,Bien Hoa City,15,265,198,67,46
2022-02-02,Dong Nai,Bien Hoa City,16,275,191,84,62
2022-02-02,Dong Nai,Bien Hoa City,17,337,215,122,94
2022-02-02,Dong Nai,Bien Hoa City,18,390,233,157,117
2022-02-02,Dong Nai,Bien Hoa City,19,475,205,270,229
2022-02-02,Dong Nai,Bien Hoa City,20,441,151,290,250
2022-02-02,Dong Nai,Bien Hoa City,21,178,83,95,69
2022-02-02,Dong Nai,Bien Hoa City,23,3,1,2,0
2022-02-02,Dong Nai,Long Thanh,9,1,0,1,1
2022-02-02,Dong Nai,Long Thanh,11,2,0,2,2
2022-02-02,Dong Nai,Long Thanh,12,2,0,2,2
2022-02-02,Dong Nai,Long Thanh,13,3,0,3,3
2022-02-02,Dong Nai,Long Thanh,14,1,0,1,1
2022-02-02,Dong Nai,Long Thanh,16,3,0,3,3
2022-02-02,Dong Nai,Long Thanh,17,4,0,4,4
2022-02-02,Dong Nai,Long Thanh,18,1,0,1,1
2022-02-02,Dong Nai,Long Thanh,19,2,0,2,2
2022-02-02,Dong Nai,Thong Nhat,9,3,1,2,1
2022-02-02,Dong Nai,Thong Nhat,10,1,0,1,1
2022-02-02,Dong Nai,Thong Nhat,14,5,5,0,0
2022-02-02,Dong Nai,Thong Nhat,15,3,1,2,2
2022-02-02,Dong Nai,Thong Nhat,16,2,2,0,0
2022-02-02,Dong Nai,Thong Nhat,18,1,1,0,0
2022-02-02,Dong Nai,Thong Nhat,19,1,0,1,1
2022-02-02,Dong Nai,Thong Nhat,20,4,2,2,2
2022-02-02,Hai Phong City,An Duong,10,1,1,0,0
2022-02-02,Hai Phong City,An Duong,14,2,0,2,2
2022-02-02,Hai Phong City,An Duong,16,1,1,0,0
2022-02-02,Hai Phong City,An Duong,20,2,0,2,2
2022-02-02,Hai Phong City,Duong Kinh District,17,1,0,1,1
2022-02-02,Hai Phong City,Duong Kinh District,18,1,0,1,1
2022-02-02,Hai Phong City,Hai An District,7,2,0,2,2
2022-02-02,Hai Phong City,Hai An District,8,1,0,1,1
2022-02-02,Hai Phong City,Hai An District,9,1,1,0,0
2022-02-02,Hai Phong City,Hai An District,10,1,0,1,0
2022-02-02,Hai Phong City,Hai An District,11,2,0,2,1
2022-02-02,Hai Phong City,Hai An District,15,3,3,0,0
2022-02-02,Hai Phong City,Hai An District,16,3,1,2,0
2022-02-02,Hai Phong City,Hai An District,17,1,0,1,1
2022-02-02,Hai Phong City,Hai An District,18,2,0,2,1
2022-02-02,Hai Phong City,Hai An District,20,2,0,2,1
2022-02-02,Hai Phong City,Hai An District,21,5,1,4,4
2022-02-02,Hai Phong City,Hong Bang District,7,1,0,1,1
2022-02-02,Hai Phong City,Hong Bang District,8,2,1,1,1
2022-02-02,Hai Phong City,Hong Bang District,9,12,8,4,4
2022-02-02,Hai Phong City,Hong Bang District,10,8,2,6,5
2022-02-02,Hai Phong City,Hong Bang District,11,7,3,4,1
2022-02-02,Hai Phong City,Hong Bang District,12,16,8,8,6
2022-02-02,Hai Phong City,Hong Bang District,13,9,6,3,3
2022-02-02,Hai Phong City,Hong Bang District,14,16,8,8,6
2022-02-02,Hai Phong City,Hong Bang District,15,16,8,8,5
2022-02-02,Hai Phong City,Hong Bang District,16,16,9,7,3
2022-02-02,Hai Phong City,Hong Bang District,17,23,1,22,22
2022-02-02,Hai Phong City,Hong Bang District,18,49,12,37,30
2022-02-02,Hai Phong City,Hong Bang District,19,39,9,30,27
2022-02-02,Hai Phong City,Hong Bang District,20,52,9,43,36
2022-02-02,Hai Phong City,Hong Bang District,21,10,5,5,4
2022-02-02,Hai Phong City,Hong Bang District,22,1,0,1,1
2022-02-02,Hai Phong City,Kien An District,8,1,0,1,1
2022-02-02,Hai Phong City,Kien An District,9,5,0,5,4
2022-02-02,Hai Phong City,Kien An District,10,6,0,6,6
2022-02-02,Hai Phong City,Kien An District,11,6,0,6,5
2022-02-02,Hai Phong City,Kien An District,12,5,1,4,3
2022-02-02,Hai Phong City,Kien An District,13,9,0,9,7
2022-02-02,Hai Phong City,Kien An District,14,11,0,11,10
2022-02-02,Hai Phong City,Kien An District,15,7,0,7,7
2022-02-02,Hai Phong City,Kien An District,16,12,2,10,10
2022-02-02,Hai Phong City,Kien An District,17,11,0,11,10
2022-02-02,Hai Phong City,Kien An District,18,12,0,12,11
2022-02-02,Hai Phong City,Kien An District,19,9,0,9,9
2022-02-02,Hai Phong City,Kien An District,20,8,0,8,8
2022-02-02,Hai Phong City,Kien An District,21,8,0,8,4
2022-02-02,Hai Phong City,Le Chan District,7,5,2,3,2
2022-02-02,Hai Phong City,Le Chan District,8,19,7,12,11
2022-02-02,Hai Phong City,Le Chan District,9,32,13,19,13
2022-02-02,Hai Phong City,Le Chan District,10,62,33,29,23
2022-02-02,Hai Phong City,Le Chan District,11,61,39,22,16
2022-02-02,Hai Phong City,Le Chan District,12,63,51,12,8
2022-02-02,Hai Phong City,Le Chan District,13,58,39,19,16
2022-02-02,Hai Phong City,Le Chan District,14,54,37,17,9
2022-02-02,Hai Phong City,Le Chan District,15,51,29,22,19
2022-02-02,Hai Phong City,Le Chan District,16,85,44,41,33
2022-02-02,Hai Phong City,Le Chan District,17,151,44,107,93
2022-02-02,Hai Phong City,Le Chan District,18,205,50,155,134
2022-02-02,Hai Phong City,Le Chan District,19,177,50,127,115
2022-02-02,Hai Phong City,Le Chan District,20,144,37,107,95
2022-02-02,Hai Phong City,Le Chan District,21,63,16,47,40
2022-02-02,Hai Phong City,Le Chan District,22,1,0,1,0
2022-02-02,Hai Phong City,Le Chan District,23,3,2,1,0
2022-02-02,Hai Phong City,Ngo Quyen District,0,1,0,1,0
2022-02-02,Hai Phong City,Ngo Quyen District,7,4,1,3,3
2022-02-02,Hai Phong City,Ngo Quyen District,8,24,11,13,12
2022-02-02,Hai Phong City,Ngo Quyen District,9,28,15,13,4
2022-02-02,Hai Phong City,Ngo Quyen District,10,43,28,15,11
2022-02-02,Hai Phong City,Ngo Quyen District,11,64,43,21,7
2022-02-02,Hai Phong City,Ngo Quyen District,12,36,31,5,4
2022-02-02,Hai Phong City,Ngo Quyen District,13,49,38,11,6
2022-02-02,Hai Phong City,Ngo Quyen District,14,57,46,11,7
2022-02-02,Hai Phong City,Ngo Quyen District,15,60,44,16,9
2022-02-02,Hai Phong City,Ngo Quyen District,16,66,43,23,15
2022-02-02,Hai Phong City,Ngo Quyen District,17,93,36,57,47
2022-02-02,Hai Phong City,Ngo Quyen District,18,142,49,93,78
2022-02-02,Hai Phong City,Ngo Quyen District,19,132,67,65,53
2022-02-02,Hai Phong City,Ngo Quyen District,20,153,57,96,84
2022-02-02,Hai Phong City,Ngo Quyen District,21,70,32,38,32
2022-02-02,Hai Phong City,Thuy Nguyen,11,2,0,2,2
2022-02-02,Hai Phong City,Thuy Nguyen,12,2,0,2,1
2022-02-02,Hai Phong City,Thuy Nguyen,15,2,0,2,1
2022-02-02,Hai Phong City,Thuy Nguyen,19,1,0,1,1
2022-02-02,Hai Phong City,Thuy Nguyen,20,1,0,1,1
2022-02-02,Hue City,Hue City,0,1,1,0,0
2022-02-02,Hue City,Hue City,6,12,5,7,2
2022-02-02,Hue City,Hue City,7,35,32,3,1
2022-02-02,Hue City,Hue City,8,85,77,8,1
2022-02-02,Hue City,Hue City,9,80,71,9,0
2022-02-02,Hue City,Hue City,10,112,100,12,1
2022-02-02,Hue City,Hue City,11,147,129,18,1
2022-02-02,Hue City,Hue City,12,129,120,9,1
2022-02-02,Hue City,Hue City,13,104,99,5,0
2022-02-02,Hue City,Hue City,14,124,109,15,5
2022-02-02,Hue City,Hue City,15,160,135,25,5
2022-02-02,Hue City,Hue City,16,202,147,55,33
2022-02-02,Hue City,Hue City,17,301,172,129,92
2022-02-02,Hue City,Hue City,18,326,223,103,68
2022-02-02,Hue City,Hue City,19,296,190,106,70
2022-02-02,Hue City,Hue City,20,245,168,77,48
2022-02-02,Hue City,Hue City,21,98,78,20,8
2022-02-02,Hue City,Hue City,22,1,0,1,0
2022-02-02,Hue City,Huong Thuy,17,1,1,0,0
2022-02-02,Hue City,Huong Thuy,19,1,1,0,0
2022-02-02,Hue City,Huong Thuy,20,1,0,1,0
2022-02-02,Hue City,Huong Thuy,21,1,1,0,0
2022-02-02,Hue City,Huong Tra,12,1,1,0,0
2022-02-02,Hue City,Phu Vang,13,1,1,0,0
2022-02-02,Hue City,Phu Vang,17,1,0,1,1
2022-02-02,Hue City,Phu Vang,20,1,1,0,0
2022-02-02,Hue City,Phu Vang,21,1,1,0,0
2022-02-02,Vung Tau,Ba Ria City,8,4,0,4,3
2022-02-02,Vung Tau,Ba Ria City,9,2,1,1,1
2022-02-02,Vung Tau,Ba Ria City,10,5,3,2,1
2022-02-02,Vung Tau,Ba Ria City,11,7,3,4,4
2022-02-02,Vung Tau,Ba Ria City,12,9,4,5,5
2022-02-02,Vung Tau,Ba Ria City,13,13,3,10,8
2022-02-02,Vung Tau,Ba Ria City,14,7,3,4,3
2022-02-02,Vung Tau,Ba Ria City,15,4,2,2,2
2022-02-02,Vung Tau,Ba Ria City,16,7,4,3,3
2022-02-02,Vung Tau,Ba Ria City,17,10,0,10,10
2022-02-02,Vung Tau,Ba Ria City,18,4,0,4,4
2022-02-02,Vung Tau,Ba Ria City,19,15,0,15,10
2022-02-02,Vung Tau,Ba Ria City,20,10,0,10,9
2022-02-02,Vung Tau,Ba Ria City,21,11,0,11,11
2022-02-02,Vung Tau,Vung Tau City,5,2,0,2,1
2022-02-02,Vung Tau,Vung Tau City,6,11,9,2,1
2022-02-02,Vung Tau,Vung Tau City,7,36,33,3,1
2022-02-02,Vung Tau,Vung Tau City,8,60,56,4,0
2022-02-02,Vung Tau,Vung Tau City,9,84,75,9,1
2022-02-02,Vung Tau,Vung Tau City,10,120,106,14,1
2022-02-02,Vung Tau,Vung Tau City,11,146,128,18,6
2022-02-02,Vung Tau,Vung Tau City,12,151,139,12,4
2022-02-02,Vung Tau,Vung Tau City,13,140,128,12,0
2022-02-02,Vung Tau,Vung Tau City,14,134,122,12,2
2022-02-02,Vung Tau,Vung Tau City,15,130,123,7,2
2022-02-02,Vung Tau,Vung Tau City,16,132,119,13,3
2022-02-02,Vung Tau,Vung Tau City,17,134,118,16,7
2022-02-02,Vung Tau,Vung Tau City,18,182,162,20,10
2022-02-02,Vung Tau,Vung Tau City,19,180,150,30,20
2022-02-02,Vung Tau,Vung Tau City,20,180,121,59,42
2022-02-02,Vung Tau,Vung Tau City,21,94,68,26,13
2022-02-02,Vung Tau,Vung Tau City,23,1,1,0,0
2022-02-03,Binh Duong,Di An,8,4,0,4,3
2022-02-03,Binh Duong,Di An,9,5,1,4,4
2022-02-03,Binh Duong,Di An,10,8,1,7,6
2022-02-03,Binh Duong,Di An,11,18,0,18,17
2022-02-03,Binh Duong,Di An,12,13,0,13,13
2022-02-03,Binh Duong,Di An,13,14,1,13,13
2022-02-03,Binh Duong,Di An,14,20,3,17,10
2022-02-03,Binh Duong,Di An,15,11,2,9,7
2022-02-03,Binh Duong,Di An,16,12,4,8,5
2022-02-03,Binh Duong,Di An,17,8,0,8,6
2022-02-03,Binh Duong,Di An,18,13,2,11,10
2022-02-03,Binh Duong,Di An,19,10,0,10,10
2022-02-03,Binh Duong,Di An,20,8,1,7,5
2022-02-03,Binh Duong,Di An,21,2,0,2,2
2022-02-03,Binh Duong,Tan Uyen,12,2,0,2,1
2022-02-03,Binh Duong,Tan Uyen,15,1,0,1,1
2022-02-03,Binh Duong,Tan Uyen,19,1,0,1,1
2022-02-03,Binh Duong,Thu Dau Mot Town,3,1,0,1,1
2022-02-03,Binh Duong,Thu Dau Mot Town,6,7,6,1,1
2022-02-03,Binh Duong,Thu Dau Mot Town,7,33,23,10,6
2022-02-03,Binh Duong,Thu Dau Mot Town,8,61,50,11,4
2022-02-03,Binh Duong,Thu Dau Mot Town,9,74,63,11,4
2022-02-03,Binh Duong,Thu Dau Mot Town,10,133,114,19,9
2022-02-03,Binh Duong,Thu Dau Mot Town,11,185,149,36,17
2022-02-03,Binh Duong,Thu Dau Mot Town,12,184,152,32,16
2022-02-03,Binh Duong,Thu Dau Mot Town,13,140,117,23,14
2022-02-03,Binh Duong,Thu Dau Mot Town,14,144,121,23,19
2022-02-03,Binh Duong,Thu Dau Mot Town,15,145,111,34,22
2022-02-03,Binh Duong,Thu Dau Mot Town,16,111,90,21,14
2022-02-03,Binh Duong,Thu Dau Mot Town,17,163,117,46,36
2022-02-03,Binh Duong,Thu Dau Mot Town,18,197,109,88,74
2022-02-03,Binh Duong,Thu Dau Mot Town,19,247,124,123,112
2022-02-03,Binh Duong,Thu Dau Mot Town,20,168,94,74,61
2022-02-03,Binh Duong,Thu Dau Mot Town,21,59,40,19,8
2022-02-03,Binh Duong,Thu Dau Mot Town,23,2,1,1,0
2022-02-03,Binh Duong,Thuan An,7,2,0,2,2
2022-02-03,Binh Duong,Thuan An,8,2,0,2,2
2022-02-03,Binh Duong,Thuan An,9,14,2,12,11
2022-02-03,Binh Duong,Thuan An,10,24,7,17,14
2022-02-03,Binh Duong,Thuan An,11,44,21,23,19
2022-02-03,Binh Duong,Thuan An,12,57,14,43,37
2022-02-03,Binh Duong,Thuan An,13,31,10,21,18
2022-02-03,Binh Duong,Thuan An,14,43,10,33,27
2022-02-03,Binh Duong,Thuan An,15,33,10,23,22
2022-02-03,Binh Duong,Thuan An,16,45,10,35,33
2022-02-03,Binh Duong,Thuan An,17,34,10,24,24
2022-02-03,Binh Duong,Thuan An,18,31,7,24,18
2022-02-03,Binh Duong,Thuan An,19,31,5,26,21
2022-02-03,Binh Duong,Thuan An,20,18,4,14,14
2022-02-03,Binh Duong,Thuan An,21,12,0,12,11
2022-02-03,Can Tho City,Binh Thuy District,10,3,3,0,0
2022-02-03,Can Tho City,Binh Thuy District,11,12,12,0,0
2022-02-03,Can Tho City,Binh Thuy District,12,9,9,0,0
2022-02-03,Can Tho City,Binh Thuy District,13,3,3,0,0
2022-02-03,Can Tho City,Binh Thuy District,14,6,5,1,0
2022-02-03,Can Tho City,Binh Thuy District,15,9,9,0,0
2022-02-03,Can Tho City,Binh Thuy District,16,5,5,0,0
2022-02-03,Can Tho City,Binh Thuy District,17,6,6,0,0
2022-02-03,Can Tho City,Binh Thuy District,18,9,9,0,0
2022-02-03,Can Tho City,Binh Thuy District,19,13,11,2,1
2022-02-03,Can Tho City,Binh Thuy District,20,12,9,3,3
2022-02-03,Can Tho City,Binh Thuy District,21,1,0,1,1
2022-02-03,Can Tho City,Cai Rang District,7,2,2,0,0
2022-02-03,Can Tho City,Cai Rang District,8,1,0,1,0
2022-02-03,Can Tho City,Cai Rang District,9,3,3,0,0
2022-02-03,Can Tho City,Cai Rang District,10,9,8,1,1
2022-02-03,Can Tho City,Cai Rang District,11,6,6,0,0
2022-02-03,Can Tho City,Cai Rang District,12,10,10,0,0
2022-02-03,Can Tho City,Cai Rang District,13,3,2,1,1
2022-02-03,Can Tho City,Cai Rang District,14,8,7,1,1
2022-02-03,Can Tho City,Cai Rang District,15,7,7,0,0
2022-02-03,Can Tho City,Cai Rang District,16,8,7,1,0
2022-02-03,Can Tho City,Cai Rang District,17,11,11,0,0
2022-02-03,Can Tho City,Cai Rang District,18,6,6,0,0
2022-02-03,Can Tho City,Cai Rang District,19,12,12,0,0
2022-02-03,Can Tho City,Cai Rang District,20,4,4,0,0
2022-02-03,Can Tho City,Ninh Kieu District,6,10,10,0,0
2022-02-03,Can Tho City,Ninh Kieu District,7,24,22,2,0
2022-02-03,Can Tho City,Ninh Kieu District,8,55,51,4,0
2022-02-03,Can Tho City,Ninh Kieu District,9,95,91,4,0
2022-02-03,Can Tho City,Ninh Kieu District,10,105,101,4,0
2022-02-03,Can Tho City,Ninh Kieu District,11,107,105,2,0
2022-02-03,Can Tho City,Ninh Kieu District,12,106,104,2,0
2022-02-03,Can Tho City,Ninh Kieu District,13,105,100,5,0
2022-02-03,Can Tho City,Ninh Kieu District,14,120,114,6,0
2022-02-03,Can Tho City,Ninh Kieu District,15,97,91,6,0
2022-02-03,Can Tho City,Ninh Kieu District,16,115,109,6,0
2022-02-03,Can Tho City,Ninh Kieu District,17,143,140,3,0
2022-02-03,Can Tho City,Ninh Kieu District,18,149,140,9,0
2022-02-03,Can Tho City,Ninh Kieu District,19,155,139,16,2
2022-02-03,Can Tho City,Ninh Kieu District,20,133,111,22,7
2022-02-03,Can Tho City,Ninh Kieu District,21,52,49,3,0
2022-02-03,Can Tho City,Ninh Kieu District,22,2,2,0,0
2022-02-03,Can Tho City,Ninh Kieu District,23,1,1,0,0
2022-02-03,Dong Nai,Bien Hoa City,0,1,0,1,1
2022-02-03,Dong Nai,Bien Hoa City,6,13,1,12,9
2022-02-03,Dong Nai,Bien Hoa City,7,61,25,36,25
2022-02-03,Dong Nai,Bien Hoa City,8,104,66,38,20
2022-02-03,Dong Nai,Bien Hoa City,9,187,143,44,25
2022-02-03,Dong Nai,Bien Hoa City,10,327,261,66,30
2022-02-03,Dong Nai,Bien Hoa City,11,418,326,92,60
2022-02-03,Dong Nai,Bien Hoa City,12,512,367,145,90
2022-02-03,Dong Nai,Bien Hoa City,13,486,352,134,90
2022-02-03,Dong Nai,Bien Hoa City,14,388,272,116,80
2022-02-03,Dong Nai,Bien Hoa City,15,340,239,101,61
2022-02-03,Dong Nai,Bien Hoa City,16,301,221,80,48
2022-02-03,Dong Nai,Bien Hoa City,17,350,246,104,78
2022-02-03,Dong Nai,Bien Hoa City,18,482,276,206,164
2022-02-03,Dong Nai,Bien Hoa City,19,482,248,234,192
2022-02-03,Dong Nai,Bien Hoa City,20,451,188,263,222
2022-02-03,Dong Nai,Bien Hoa City,21,199,77,122,84
2022-02-03,Dong Nai,Bien Hoa City,22,4,1,3,1
2022-02-03,Dong Nai,Long Thanh,9,2,0,2,2
2022-02-03,Dong Nai,Long Thanh,10,3,0,3,3
2022-02-03,Dong Nai,Long Thanh,11,1,0,1,1
2022-02-03,Dong Nai,Long Thanh,12,2,0,2,2
2022-02-03,Dong Nai,Long Thanh,13,2,0,2,2
2022-02-03,Dong Nai,Long Thanh,14,1,0,1,1
2022-02-03,Dong Nai,Long Thanh,15,1,0,1,1
2022-02-03,Dong Nai,Long Thanh,18,8,0,8,8
2022-02-03,Dong Nai,Long Thanh,20,3,0,3,3
2022-02-03,Dong Nai,Long Thanh,21,4,0,4,3
2022-02-03,Dong Nai,Thong Nhat,8,2,1,1,0
2022-02-03,Dong Nai,Thong Nhat,9,3,3,0,0
2022-02-03,Dong Nai,Thong Nhat,10,5,5,0,0
2022-02-03,Dong Nai,Thong Nhat,11,3,3,0,0
2022-02-03,Dong Nai,Thong Nhat,12,2,1,1,1
2022-02-03,Dong Nai,Thong Nhat,13,2,2,0,0
2022-02-03,Dong Nai,Thong Nhat,14,1,1,0,0
2022-02-03,Dong Nai,Thong Nhat,15,2,2,0,0
2022-02-03,Dong Nai,Thong Nhat,18,4,3,1,1
2022-02-03,Dong Nai,Thong Nhat,19,3,3,0,0
2022-02-03,Dong Nai,Thong Nhat,20,2,0,2,2
2022-02-03,Hai Phong City,An Duong,12,1,1,0,0
2022-02-03,Hai Phong City,An Duong,17,1,0,1,0
2022-02-03,Hai Phong City,An Duong,18,1,0,1,1
2022-02-03,Hai Phong City,An Duong,21,1,0,1,1
2022-02-03,Hai Phong City,Duong Kinh District,14,1,0,1,1
2022-02-03,Hai Phong City,Hai An District,7,3,1,2,1
2022-02-03,Hai Phong City,Hai An District,9,2,0,2,1
2022-02-03,Hai Phong City,Hai An District,10,2,0,2,1
2022-02-03,Hai Phong City,Hai An District,11,4,1,3,3
2022-02-03,Hai Phong City,Hai An District,12,5,3,2,2
2022-02-03,Hai Phong City,Hai An District,13,4,3,1,1
2022-02-03,Hai Phong City,Hai An District,14,5,3,2,1
2022-02-03,Hai Phong City,Hai An District,15,3,3,0,0
2022-02-03,Hai Phong City,Hai An District,16,5,3,2,2
2022-02-03,Hai Phong City,Hai An District,17,4,3,1,1
2022-02-03,Hai Phong City,Hai An District,18,4,3,1,0
2022-02-03,Hai Phong City,Hai An District,19,1,1,0,0
2022-02-03,Hai Phong City,Hai An District,20,8,5,3,1
2022-02-03,Hai Phong City,Hai An District,21,10,5,5,4
2022-02-03,Hai Phong City,Hong Bang District,7,1,0,1,0
2022-02-03,Hai Phong City,Hong Bang District,8,5,3,2,2
2022-02-03,Hai Phong City,Hong Bang District,9,8,7,1,1
2022-02-03,Hai Phong City,Hong Bang District,10,15,8,7,5
2022-02-03,Hai Phong City,Hong Bang District,11,19,14,5,2
2022-02-03,Hai Phong City,Hong Bang District,12,19,9,10,9
2022-02-03,Hai Phong City,Hong Bang District,13,28,20,8,5
2022-02-03,Hai Phong City,Hong Bang District,14,17,8,9,9
2022-02-03,Hai Phong City,Hong Bang District,15,23,10,13,7
2022-02-03,Hai Phong City,Hong Bang District,16,24,10,14,11
2022-02-03,Hai Phong City,Hong Bang District,17,36,8,28,23
2022-02-03,Hai Phong City,Hong Bang District,18,41,8,33,30
2022-02-03,Hai Phong City,Hong Bang District,19,47,11,36,31
2022-02-03,Hai Phong City,Hong Bang District,20,38,12,26,21
2022-02-03,Hai Phong City,Hong Bang District,21,17,3,14,14
2022-02-03,Hai Phong City,Kien An District,8,4,0,4,3
2022-02-03,Hai Phong City,Kien An District,9,1,0,1,1
2022-02-03,Hai Phong City,Kien An District,10,4,0,4,4
2022-02-03,Hai Phong City,Kien An District,11,8,0,8,8
2022-02-03,Hai Phong City,Kien An District,12,6,0,6,5
2022-02-03,Hai Phong City,Kien An District,13,8,0,8,6
2022-02-03,Hai Phong City,Kien An District,14,9,0,9,9
2022-02-03,Hai Phong City,Kien An District,15,9,1,8,8
2022-02-03,Hai Phong City,Kien An District,16,5,0,5,5
2022-02-03,Hai Phong City,Kien An District,17,10,3,7,7
2022-02-03,Hai Phong City,Kien An District,18,5,0,5,4
2022-02-03,Hai Phong City,Kien An District,19,5,0,5,5
2022-02-03,Hai Phong City,Kien An District,20,12,0,12,10
2022-02-03,Hai Phong City,Kien An District,21,3,0,3,3
2022-02-03,Hai Phong City,Le Chan District,0,1,0,1,1
2022-02-03,Hai Phong City,Le Chan District,6,1,0,1,1
2022-02-03,Hai Phong City,Le Chan District,7,7,3,4,3
2022-02-03,Hai Phong City,Le Chan District,8,27,17,10,6
2022-02-03,Hai Phong City,Le Chan District,9,32,30,2,1
2022-02-03,Hai Phong City,Le Chan District,10,81,53,28,16
2022-02-03,Hai Phong City,Le Chan District,11,88,52,36,30
2022-02-03,Hai Phong City,Le Chan District,12,98,60,38,24
2022-02-03,Hai Phong City,Le Chan District,13,64,42,22,17
2022-02-03,Hai Phong City,Le Chan District,14,75,53,22,14
2022-02-03,Hai Phong City,Le Chan District,15,91,61,30,24
2022-02-03,Hai Phong City,Le Chan District,16,96,52,44,29
2022-02-03,Hai Phong City,Le Chan District,17,142,72,70,65
2022-02-03,Hai Phong City,Le Chan District,18,187,64,123,106
2022-02-03,Hai Phong City,Le Chan District,19,180,62,118,104
2022-02-03,Hai Phong City,Le Chan District,20,162,51,111,89
2022-02-03,Hai Phong City,Le Chan District,21,95,42,53,37
2022-02-03,Hai Phong City,Le Chan District,22,2,0,2,1
2022-02-03,Hai Phong City,Le Chan District,23,2,1,1,0
2022-02-03,Hai Phong City,Ngo Quyen District,5,2,1,1,0
2022-02-03,Hai Phong City,Ngo Quyen District,7,5,4,1,1
2022-02-03,Hai Phong City,Ngo Quyen District,8,17,11,6,3
2022-02-03,Hai Phong City,Ngo Quyen District,9,39,31,8,4
2022-02-03,Hai Phong City,Ngo Quyen District,10,62,41,21,10
2022-02-03,Hai Phong City,Ngo Quyen District,11,87,53,34,24
2022-02-03,Hai Phong City,Ngo Quyen District,12,70,54,16,11
2022-02-03,Hai Phong City,Ngo Quyen District,13,54,41,13,9
2022-02-03,Hai Phong City,Ngo Quyen District,14,75,55,20,12
2022-02-03,Hai Phong City,Ngo Quyen District,15,93,63,30,19
2022-02-03,Hai Phong City,Ngo Quyen District,16,113,63,50,43
2022-02-03,Hai Phong City,Ngo Quyen District,17,132,66,66,53
2022-02-03,Hai Phong City,Ngo Quyen District,18,148,70,78,62
2022-02-03,Hai Phong City,Ngo Quyen District,19,143,67,76,58
2022-02-03,Hai Phong City,Ngo Quyen District,20,167,67,100,72
2022-02-03,Hai Phong City,Ngo Quyen District,21,104,50,54,40
2022-02-03,Hai Phong City,Ngo Quyen District,22,1,0,1,0
2022-02-03,Hai Phong City,Thuy Nguyen,8,1,0,1,1
2022-02-03,Hai Phong City,Thuy Nguyen,10,3,1,2,2
2022-02-03,Hai Phong City,Thuy Nguyen,11,4,0,4,2
2022-02-03,Hai Phong City,Thuy Nguyen,13,1,0,1,1
2022-02-03,Hai Phong City,Thuy Nguyen,14,5,0,5,5
2022-02-03,Hai Phong City,Thuy Nguyen,15,7,0,7,7
2022-02-03,Hai Phong City,Thuy Nguyen,16,4,0,4,3
2022-02-03,Hai Phong City,Thuy Nguyen,17,3,0,3,3
2022-02-03,Hai Phong City,Thuy Nguyen,18,3,0,3,3
2022-02-03,Hai Phong City,Thuy Nguyen,19,1,0,1,1
2022-02-03,Hai Phong City,Thuy Nguyen,20,7,0,7,6
2022-02-03,Hue City,Hue City,0,1,0,1,0
2022-02-03,Hue City,Hue City,2,1,1,0,0
2022-02-03,Hue City,Hue City,6,11,8,3,1
2022-02-03,Hue City,Hue City,7,59,51,8,3
2022-02-03,Hue City,Hue City,8,126,107,19,8
2022-02-03,Hue City,Hue City,9,130,106,24,6
2022-02-03,Hue City,Hue City,10,147,128,19,4
2022-02-03,Hue City,Hue City,11,167,151,16,2
2022-02-03,Hue City,Hue City,12,172,154,18,1
2022-02-03,Hue City,Hue City,13,118,112,6,0
2022-02-03,Hue City,Hue City,14,171,156,15,4
2022-02-03,Hue City,Hue City,15,178,159,19,6
2022-02-03,Hue City,Hue City,16,273,215,58,45
2022-02-03,Hue City,Hue City,17,305,243,62,33
2022-02-03,Hue City,Hue City,18,343,223,120,91
2022-02-03,Hue City,Hue City,19,324,223,101,59
2022-02-03,Hue City,Hue City,20,310,195,115,80
2022-02-03,Hue City,Hue City,21,152,106,46,22
2022-02-03,Hue City,Hue City,22,2,1,1,0
2022-02-03,Hue City,Huong Thuy,8,1,1,0,0
2022-02-03,Hue City,Huong Tra,7,1,1,0,0
2022-02-03,Hue City,Huong Tra,10,1,0,1,1
2022-02-03,Hue City,Huong Tra,16,2,1,1,0
2022-02-03,Hue City,Huong Tra,17,2,2,0,0
2022-02-03,Hue City,Phu Vang,13,2,2,0,0
2022-02-03,Hue City,Phu Vang,15,1,1,0,0
2022-02-03,Hue City,Phu Vang,16,1,1,0,0
2022-02-03,Hue City,Phu Vang,17,4,2,2,1
2022-02-03,Hue City,Phu Vang,18,4,4,0,0
2022-02-03,Hue City,Phu Vang,19,1,1,0,0
2022-02-03,Hue City,Phu Vang,20,1,1,0,0
2022-02-03,Vung Tau,Ba Ria City,8,3,0,3,2
2022-02-03,Vung Tau,Ba Ria City,9,1,0,1,1
2022-02-03,Vung Tau,Ba Ria City,10,3,2,1,1
2022-02-03,Vung Tau,Ba Ria City,11,9,1,8,7
2022-02-03,Vung Tau,Ba Ria City,12,15,2,13,12
2022-02-03,Vung Tau,Ba Ria City,13,13,3,10,8
2022-02-03,Vung Tau,Ba Ria City,14,7,3,4,3
2022-02-03,Vung Tau,Ba Ria City,15,13,3,10,10
2022-02-03,Vung Tau,Ba Ria City,16,14,2,12,12
2022-02-03,Vung Tau,Ba Ria City,17,9,3,6,6
2022-02-03,Vung Tau,Ba Ria City,18,12,0,12,11
2022-02-03,Vung Tau,Ba Ria City,19,7,0,7,7
2022-02-03,Vung Tau,Ba Ria City,20,8,0,8,8
2022-02-03,Vung Tau,Ba Ria City,21,4,0,4,4
2022-02-03,Vung Tau,Vung Tau City,0,1,0,1,0
2022-02-03,Vung Tau,Vung Tau City,1,1,1,0,0
2022-02-03,Vung Tau,Vung Tau City,2,1,0,1,0
2022-02-03,Vung Tau,Vung Tau City,6,17,15,2,0
2022-02-03,Vung Tau,Vung Tau City,7,53,44,9,3
2022-02-03,Vung Tau,Vung Tau City,8,88,75,13,0
2022-02-03,Vung Tau,Vung Tau City,9,121,108,13,1
2022-02-03,Vung Tau,Vung Tau City,10,147,130,17,3
2022-02-03,Vung Tau,Vung Tau City,11,186,177,9,1
2022-02-03,Vung Tau,Vung Tau City,12,185,171,14,3
2022-02-03,Vung Tau,Vung Tau City,13,179,153,26,3
2022-02-03,Vung Tau,Vung Tau City,14,173,157,16,4
2022-02-03,Vung Tau,Vung Tau City,15,151,142,9,2
2022-02-03,Vung Tau,Vung Tau City,16,171,153,18,5
2022-02-03,Vung Tau,Vung Tau City,17,138,133,5,1
2022-02-03,Vung Tau,Vung Tau City,18,196,164,32,9
2022-02-03,Vung Tau,Vung Tau City,19,238,174,64,41
2022-02-03,Vung Tau,Vung Tau City,20,226,143,83,50
2022-02-03,Vung Tau,Vung Tau City,21,125,85,40,22
2022-02-03,Vung Tau,Vung Tau City,22,1,1,0,0
2022-02-04,Binh Duong,Di An,7,1,0,1,1
2022-02-04,Binh Duong,Di An,8,4,1,3,3
2022-02-04,Binh Duong,Di An,9,7,2,5,4
2022-02-04,Binh Duong,Di An,10,12,3,9,7
2022-02-04,Binh Duong,Di An,11,20,3,17,13
2022-02-04,Binh Duong,Di An,12,18,0,18,18
2022-02-04,Binh Duong,Di An,13,31,4,27,22
2022-02-04,Binh Duong,Di An,14,22,4,18,13
2022-02-04,Binh Duong,Di An,15,3,0,3,2
2022-02-04,Binh Duong,Di An,16,10,5,5,3
2022-02-04,Binh Duong,Di An,17,5,3,2,1
2022-02-04,Binh Duong,Di An,18,9,5,4,4
2022-02-04,Binh Duong,Di An,19,8,4,4,4
2022-02-04,Binh Duong,Di An,20,2,1,1,1
2022-02-04,Binh Duong,Di An,21,5,1,4,1
2022-02-04,Binh Duong,Tan Uyen,11,1,0,1,1
2022-02-04,Binh Duong,Tan Uyen,14,2,0,2,2
2022-02-04,Binh Duong,Tan Uyen,15,1,0,1,1
2022-02-04,Binh Duong,Tan Uyen,17,1,0,1,1
2022-02-04,Binh Duong,Tan Uyen,19,3,0,3,2
2022-02-04,Binh Duong,Thu Dau Mot Town,6,8,5,3,2
2022-02-04,Binh Duong,Thu Dau Mot Town,7,31,23,8,7
2022-02-04,Binh Duong,Thu Dau Mot Town,8,71,59,12,5
2022-02-04,Binh Duong,Thu Dau Mot Town,9,94,87,7,4
2022-02-04,Binh Duong,Thu Dau Mot Town,10,153,139,14,7
2022-02-04,Binh Duong,Thu Dau Mot Town,11,203,171,32,19
2022-02-04,Binh Duong,Thu Dau Mot Town,12,229,183,46,30
2022-02-04,Binh Duong,Thu Dau Mot Town,13,172,143,29,19
2022-02-04,Binh Duong,Thu Dau Mot Town,14,163,142,21,14
2022-02-04,Binh Duong,Thu Dau Mot Town,15,138,113,25,12
2022-02-04,Binh Duong,Thu Dau Mot Town,16,162,133,29,18
2022-02-04,Binh Duong,Thu Dau Mot Town,17,169,130,39,29
2022-02-04,Binh Duong,Thu Dau Mot Town,18,211,153,58,43
2022-02-04,Binh Duong,Thu Dau Mot Town,19,217,137,80,61
2022-02-04,Binh Duong,Thu Dau Mot Town,20,152,110,42,28
2022-02-04,Binh Duong,Thu Dau Mot Town,21,63,52,11,5
2022-02-04,Binh Duong,Thu Dau Mot Town,22,1,0,1,0
2022-02-04,Binh Duong,Thuan An,0,1,0,1,0
2022-02-04,Binh Duong,Thuan An,7,1,0,1,1
2022-02-04,Binh Duong,Thuan An,8,9,4,5,5
2022-02-04,Binh Duong,Thuan An,9,15,2,13,12
2022-02-04,Binh Duong,Thuan An,10,38,11,27,21
2022-02-04,Binh Duong,Thuan An,11,53,9,44,40
2022-02-04,Binh Duong,Thuan An,12,44,8,36,32
2022-02-04,Binh Duong,Thuan An,13,39,12,27,23
2022-02-04,Binh Duong,Thuan An,14,41,16,25,18
2022-02-04,Binh Duong,Thuan An,15,35,6,29,27
2022-02-04,Binh Duong,Thuan An,16,37,8,29,25
2022-02-04,Binh Duong,Thuan An,17,25,11,14,11
2022-02-04,Binh Duong,Thuan An,18,44,11,33,23
2022-02-04,Binh Duong,Thuan An,19,30,7,23,21
2022-02-04,Binh Duong,Thuan An,20,23,5,18,13
2022-02-04,Binh Duong,Thuan An,21,6,1,5,3
2022-02-04,Can Tho City,Binh Thuy District,7,1,1,0,0
2022-02-04,Can Tho City,Binh Thuy District,8,3,3,0,0
2022-02-04,Can Tho City,Binh Thuy District,9,4,4,0,0
2022-02-04,Can Tho City,Binh Thuy District,10,7,7,0,0
2022-02-04,Can Tho City,Binh Thuy District,11,9,9,0,0
2022-02-04,Can Tho City,Binh Thuy District,12,7,7,0,0
2022-02-04,Can Tho City,Binh Thuy District,13,6,6,0,0
2022-02-04,Can Tho City,Binh Thuy District,14,4,3,1,0
2022-02-04,Can Tho City,Binh Thuy District,15,7,7,0,0
2022-02-04,Can Tho City,Binh Thuy District,16,3,3,0,0
2022-02-04,Can Tho City,Binh Thuy District,17,6,5,1,0
2022-02-04,Can Tho City,Binh Thuy District,18,2,2,0,0
2022-02-04,Can Tho City,Binh Thuy District,19,6,6,0,0
2022-02-04,Can Tho City,Binh Thuy District,20,5,4,1,0
2022-02-04,Can Tho City,Binh Thuy District,21,3,3,0,0
2022-02-04,Can Tho City,Cai Rang District,7,1,1,0,0
2022-02-04,Can Tho City,Cai Rang District,9,3,3,0,0
2022-02-04,Can Tho City,Cai Rang District,10,8,7,1,0
2022-02-04,Can Tho City,Cai Rang District,11,6,5,1,0
2022-02-04,Can Tho City,Cai Rang District,12,6,6,0,0
2022-02-04,Can Tho City,Cai Rang District,13,1,1,0,0
2022-02-04,Can Tho City,Cai Rang District,14,2,2,0,0
2022-02-04,Can Tho City,Cai Rang District,15,7,7,0,0
2022-02-04,Can Tho City,Cai Rang District,16,11,10,1,0
2022-02-04,Can Tho City,Cai Rang District,17,10,8,2,0
2022-02-04,Can Tho City,Cai Rang District,18,12,10,2,1
2022-02-04,Can Tho City,Cai Rang District,19,10,9,1,1
2022-02-04,Can Tho City,Cai Rang District,20,10,7,3,1
2022-02-04,Can Tho City,Cai Rang District,21,5,5,0,0
2022-02-04,Can Tho City,Ninh Kieu District,6,9,8,1,0
2022-02-04,Can Tho City,Ninh Kieu District,7,50,49,1,0
2022-02-04,Can Tho City,Ninh Kieu District,8,77,65,12,1
2022-02-04,Can Tho City,Ninh Kieu District,9,90,86,4,0
2022-02-04,Can Tho City,Ninh Kieu District,10,114,106,8,0
2022-02-04,Can Tho City,Ninh Kieu District,11,170,164,6,0
2022-02-04,Can Tho City,Ninh Kieu District,12,140,131,9,0
2022-02-04,Can Tho City,Ninh Kieu District,13,156,138,18,1
2022-02-04,Can Tho City,Ninh Kieu District,14,130,120,10,0
2022-02-04,Can Tho City,Ninh Kieu District,15,140,134,6,0
2022-02-04,Can Tho City,Ninh Kieu District,16,141,140,1,0
2022-02-04,Can Tho City,Ninh Kieu District,17,139,137,2,0
2022-02-04,Can Tho City,Ninh Kieu District,18,180,176,4,0
2022-02-04,Can Tho City,Ninh Kieu District,19,173,162,11,2
2022-02-04,Can Tho City,Ninh Kieu District,20,130,114,16,1
2022-02-04,Can Tho City,Ninh Kieu District,21,65,53,12,1
2022-02-04,Can Tho City,Ninh Kieu District,22,3,1,2,0
2022-02-04,Can Tho City,Ninh Kieu District,23,3,1,2,0
2022-02-04,Dong Nai,Bien Hoa City,0,3,1,2,1
2022-02-04,Dong Nai,Bien Hoa City,4,2,1,1,0
2022-02-04,Dong Nai,Bien Hoa City,6,25,3,22,17
2022-02-04,Dong Nai,Bien Hoa City,7,61,32,29,19
2022-02-04,Dong Nai,Bien Hoa City,8,125,89,36,22
2022-02-04,Dong Nai,Bien Hoa City,9,217,170,47,21
2022-02-04,Dong Nai,Bien Hoa City,10,371,320,51,31
2022-02-04,Dong Nai,Bien Hoa City,11,527,423,104,56
2022-02-04,Dong Nai,Bien Hoa City,12,502,412,90,47
2022-02-04,Dong Nai,Bien Hoa City,13,432,357,75,38
2022-02-04,Dong Nai,Bien Hoa City,14,400,293,107,71
2022-02-04,Dong Nai,Bien Hoa City,15,310,265,45,19
2022-02-04,Dong Nai,Bien Hoa City,16,264,226,38,20
2022-02-04,Dong Nai,Bien Hoa City,17,411,260,151,123
2022-02-04,Dong Nai,Bien Hoa City,18,466,295,171,125
2022-02-04,Dong Nai,Bien Hoa City,19,497,270,227,172
2022-02-04,Dong Nai,Bien Hoa City,20,429,209,220,184
2022-02-04,Dong Nai,Bien Hoa City,21,194,80,114,79
2022-02-04,Dong Nai,Bien Hoa City,22,2,1,1,0
2022-02-04,Dong Nai,Bien Hoa City,23,1,1,0,0
2022-02-04,Dong Nai,Long Thanh,9,1,0,1,1
2022-02-04,Dong Nai,Long Thanh,10,3,0,3,3
2022-02-04,Dong Nai,Long Thanh,11,1,0,1,1
2022-02-04,Dong Nai,Long Thanh,12,1,0,1,1
2022-02-04,Dong Nai,Long Thanh,13,1,0,1,1
2022-02-04,Dong Nai,Long Thanh,14,2,0,2,2
2022-02-04,Dong Nai,Long Thanh,15,2,0,2,2
2022-02-04,Dong Nai,Long Thanh,16,6,0,6,5
2022-02-04,Dong Nai,Long Thanh,17,7,0,7,7
2022-02-04,Dong Nai,Long Thanh,18,1,0,1,1
2022-02-04,Dong Nai,Long Thanh,19,2,0,2,2
2022-02-04,Dong Nai,Long Thanh,20,1,0,1,1
2022-02-04,Dong Nai,Thong Nhat,9,1,1,0,0
2022-02-04,Dong Nai,Thong Nhat,10,1,1,0,0
2022-02-04,Dong Nai,Thong Nhat,11,4,2,2,2
2022-02-04,Dong Nai,Thong Nhat,12,4,2,2,0
2022-02-04,Dong Nai,Thong Nhat,13,1,1,0,0
2022-02-04,Dong Nai,Thong Nhat,14,3,3,0,0
2022-02-04,Dong Nai,Thong Nhat,15,2,2,0,0
2022-02-04,Dong Nai,Thong Nhat,17,2,2,0,0
2022-02-04,Dong Nai,Thong Nhat,18,1,1,0,0
2022-02-04,Dong Nai,Thong Nhat,19,1,0,1,1
2022-02-04,Dong Nai,Thong Nhat,20,2,2,0,0
2022-02-04,Hai Phong City,An Duong,7,1,0,1,1
2022-02-04,Hai Phong City,An Duong,8,1,0,1,1
2022-02-04,Hai Phong City,An Duong,9,1,0,1,1
2022-02-04,Hai Phong City,An Duong,10,2,2,0,0
2022-02-04,Hai Phong City,An Duong,11,1,0,1,1
2022-02-04,Hai Phong City,An Duong,12,1,1,0,0
2022-02-04,Hai Phong City,An Duong,13,1,0,1,1
2022-02-04,Hai Phong City,An Duong,15,1,0,1,1
2022-02-04,Hai Phong City,An Duong,18,1,0,1,0
2022-02-04,Hai Phong City,An Duong,19,1,1,0,0
2022-02-04,Hai Phong City,An Duong,20,1,0,1,1
2022-02-04,Hai Phong City,Hai An District,8,1,1,0,0
2022-02-04,Hai Phong City,Hai An District,9,3,3,0,0
2022-02-04,Hai Phong City,Hai An District,10,5,2,3,2
2022-02-04,Hai Phong City,Hai An District,11,8,6,2,1
2022-02-04,Hai Phong City,Hai An District,12,11,8,3,2
2022-02-04,Hai Phong City,Hai An District,13,5,5,0,0
2022-02-04,Hai Phong City,Hai An District,14,1,1,0,0
2022-02-04,Hai Phong City,Hai An District,15,5,2,3,3
2022-02-04,Hai Phong City,Hai An District,16,9,7,2,2
2022-02-04,Hai Phong City,Hai An District,17,15,5,10,6
2022-02-04,Hai Phong City,Hai An District,18,17,9,8,6
2022-02-04,Hai Phong City,Hai An District,19,11,6,5,5
2022-02-04,Hai Phong City,Hai An District,20,8,6,2,2
2022-02-04,Hai Phong City,Hai An District,21,10,4,6,5
2022-02-04,Hai Phong City,Hong Bang District,7,2,1,1,1
2022-02-04,Hai Phong City,Hong Bang District,8,4,4,0,0
2022-02-04,Hai Phong City,Hong Bang District,9,2,2,0,0
2022-02-04,Hai Phong City,Hong Bang District,10,17,12,5,1
2022-02-04,Hai Phong City,Hong Bang District,11,18,12,6,3
2022-02-04,Hai Phong City,Hong Bang District,12,32,20,12,9
2022-02-04,Hai Phong City,Hong Bang District,13,16,11,5,3
2022-02-04,Hai Phong City,Hong Bang District,14,19,15,4,3
2022-02-04,Hai Phong City,Hong Bang District,15,15,11,4,2
2022-02-04,Hai Phong City,Hong Bang District,16,22,6,16,14
2022-02-04,Hai Phong City,Hong Bang District,17,20,11,9,6
2022-02-04,Hai Phong City,Hong Bang District,18,19,9,10,9
2022-02-04,Hai Phong City,Hong Bang District,19,37,16,21,18
2022-02-04,Hai Phong City,Hong Bang District,20,42,8,34,30
2022-02-04,Hai Phong City,Hong Bang District,21,7,3,4,4
2022-02-04,Hai Phong City,Kien An District,8,1,0,1,1
2022-02-04,Hai Phong City,Kien An District,9,4,0,4,4
2022-02-04,Hai Phong City,Kien An District,10,8,0,8,7
2022-02-04,Hai Phong City,Kien An District,11,15,0,15,13
2022-02-04,Hai Phong City,Kien An District,12,11,3,8,8
2022-02-04,Hai Phong City,Kien An District,13,1,1,0,0
2022-02-04,Hai Phong City,Kien An District,14,8,0,8,7
2022-02-04,Hai Phong City,Kien An District,15,11,4,7,5
2022-02-04,Hai Phong City,Kien An District,16,11,4,7,7
2022-02-04,Hai Phong City,Kien An District,17,16,0,16,16
2022-02-04,Hai Phong City,Kien An District,18,17,0,17,15
2022-02-04,Hai Phong City,Kien An District,19,18,0,18,17
2022-02-04,Hai Phong City,Kien An District,20,15,0,15,13
2022-02-04,Hai Phong City,Le Chan District,7,11,9,2,1
2022-02-04,Hai Phong City,Le Chan District,8,35,25,10,6
2022-02-04,Hai Phong City,Le Chan District,9,59,46,13,3
2022-02-04,Hai Phong City,Le Chan District,10,104,75,29,22
2022-02-04,Hai Phong City,Le Chan District,11,143,92,51,40
2022-02-04,Hai Phong City,Le Chan District,12,158,102,56,45
2022-02-04,Hai Phong City,Le Chan District,13,100,69,31,20
2022-02-04,Hai Phong City,Le Chan District,14,88,55,33,23
2022-02-04,Hai Phong City,Le Chan District,15,99,69,30,23
2022-02-04,Hai Phong City,Le Chan District,16,106,67,39,25
2022-02-04,Hai Phong City,Le Chan District,17,146,87,59,41
2022-02-04,Hai Phong City,Le Chan District,18,178,90,88,74
2022-02-04,Hai Phong City,Le Chan District,19,170,83,87,69
2022-02-04,Hai Phong City,Le Chan District,20,124,68,56,47
2022-02-04,Hai Phong City,Le Chan District,21,62,29,33,21
2022-02-04,Hai Phong City,Le Chan District,22,2,1,1,0
2022-02-04,Hai Phong City,Le Chan District,23,1,0,1,0
2022-02-04,Hai Phong City,Ngo Quyen District,7,4,4,0,0
2022-02-04,Hai Phong City,Ngo Quyen District,8,23,16,7,3
2022-02-04,Hai Phong City,Ngo Quyen District,9,47,39,8,3
2022-02-04,Hai Phong City,Ngo Quyen District,10,86,60,26,15
2022-02-04,Hai Phong City,Ngo Quyen District,11,117,90,27,16
2022-02-04,Hai Phong City,Ngo Quyen District,12,106,75,31,12
2022-02-04,Hai Phong City,Ngo Quyen District,13,58,52,6,1
2022-02-04,Hai Phong City,Ngo Quyen District,14,74,62,12,5
2022-02-04,Hai Phong City,Ngo Quyen District,15,121,79,42,27
2022-02-04,Hai Phong City,Ngo Quyen District,16,114,78,36,21
2022-02-04,Hai Phong City,Ngo Quyen District,17,120,65,55,44
2022-02-04,Hai Phong City,Ngo Quyen District,18,212,94,118,94
2022-02-04,Hai Phong City,Ngo Quyen District,19,176,83,93,75
2022-02-04,Hai Phong City,Ngo Quyen District,20,141,75,66,50
2022-02-04,Hai Phong City,Ngo Quyen District,21,77,51,26,17
2022-02-04,Hai Phong City,Ngo Quyen District,23,2,2,0,0
2022-02-04,Hai Phong City,Thuy Nguyen,9,3,0,3,3
2022-02-04,Hai Phong City,Thuy Nguyen,10,2,0,2,2
2022-02-04,Hai Phong City,Thuy Nguyen,13,2,0,2,2
2022-02-04,Hai Phong City,Thuy Nguyen,14,4,0,4,4
2022-02-04,Hai Phong City,Thuy Nguyen,15,9,0,9,7
2022-02-04,Hai Phong City,Thuy Nguyen,16,2,0,2,2
2022-02-04,Hai Phong City,Thuy Nguyen,18,6,0,6,6
2022-02-04,Hai Phong City,Thuy Nguyen,19,5,0,5,5
2022-02-04,Hai Phong City,Thuy Nguyen,20,3,0,3,2
2022-02-04,Hai Phong City,Thuy Nguyen,21,1,0,1,0
2022-02-04,Hue City,Hue City,6,17,8,9,5
2022-02-04,Hue City,Hue City,7,58,48,10,4
2022-02-04,Hue City,Hue City,8,115,105,10,1
2022-02-04,Hue City,Hue City,9,169,154,15,4
2022-02-04,Hue City,Hue City,10,176,154,22,3
2022-02-04,Hue City,Hue City,11,212,191,21,3
2022-02-04,Hue City,Hue City,12,221,196,25,3
2022-02-04,Hue City,Hue City,13,171,154,17,7
2022-02-04,Hue City,Hue City,14,238,175,63,34
2022-02-04,Hue City,Hue City,15,301,208,93,56
2022-02-04,Hue City,Hue City,16,360,256,104,65
2022-02-04,Hue City,Hue City,17,392,288,104,65
2022-02-04,Hue City,Hue City,18,439,266,173,130
2022-02-04,Hue City,Hue City,19,389,260,129,86
2022-02-04,Hue City,Hue City,20,324,220,104,66
2022-02-04,Hue City,Hue City,21,158,93,65,30
2022-02-04,Hue City,Hue City,22,3,0,3,0
2022-02-04,Hue City,Hue City,23,1,1,0,0
2022-02-04,Hue City,Huong Thuy,11,1,0,1,1
2022-02-04,Hue City,Huong Thuy,17,1,0,1,1
2022-02-04,Hue City,Huong Thuy,19,1,1,0,0
2022-02-04,Hue City,Huong Tra,12,1,1,0,0
2022-02-04,Hue City,Huong Tra,13,1,1,0,0
2022-02-04,Hue City,Huong Tra,14,2,2,0,0
2022-02-04,Hue City,Huong Tra,15,1,1,0,0
2022-02-04,Hue City,Huong Tra,16,1,1,0,0
2022-02-04,Hue City,Huong Tra,18,1,1,0,0
2022-02-04,Hue City,Phu Loc,17,1,0,1,0
2022-02-04,Hue City,Phu Vang,11,1,1,0,0
2022-02-04,Hue City,Phu Vang,15,2,1,1,0
2022-02-04,Hue City,Phu Vang,17,2,2,0,0
2022-02-04,Hue City,Phu Vang,18,2,2,0,0
2022-02-04,Hue City,Phu Vang,20,3,2,1,1
2022-02-04,Hue City,Phu Vang,21,4,2,2,2
2022-02-04,Vung Tau,Ba Ria City,8,1,0,1,1
2022-02-04,Vung Tau,Ba Ria City,9,8,2,6,6
2022-02-04,Vung Tau,Ba Ria City,10,6,2,4,4
2022-02-04,Vung Tau,Ba Ria City,11,6,4,2,1
2022-02-04,Vung Tau,Ba Ria City,12,7,2,5,4
2022-02-04,Vung Tau,Ba Ria City,13,12,2,10,10
2022-02-04,Vung Tau,Ba Ria City,14,17,1,16,15
2022-02-04,Vung Tau,Ba Ria City,15,15,4,11,10
2022-02-04,Vung Tau,Ba Ria City,16,6,4,2,2
2022-02-04,Vung Tau,Ba Ria City,17,7,1,6,6
2022-02-04,Vung Tau,Ba Ria City,18,13,3,10,9
2022-02-04,Vung Tau,Ba Ria City,19,5,0,5,5
2022-02-04,Vung Tau,Ba Ria City,20,6,0,6,6
2022-02-04,Vung Tau,Ba Ria City,21,5,0,5,5
2022-02-04,Vung Tau,Vung Tau City,3,3,2,1,0
2022-02-04,Vung Tau,Vung Tau City,5,1,1,0,0
2022-02-04,Vung Tau,Vung Tau City,6,11,9,2,2
2022-02-04,Vung Tau,Vung Tau City,7,73,61,12,3
2022-02-04,Vung Tau,Vung Tau City,8,98,87,11,3
2022-02-04,Vung Tau,Vung Tau City,9,151,138,13,2
2022-02-04,Vung Tau,Vung Tau City,10,187,166,21,1
2022-02-04,Vung Tau,Vung Tau City,11,275,238,37,16
2022-02-04,Vung Tau,Vung Tau City,12,259,221,38,12
2022-02-04,Vung Tau,Vung Tau City,13,210,189,21,1
2022-02-04,Vung Tau,Vung Tau City,14,195,187,8,1
2022-02-04,Vung Tau,Vung Tau City,15,189,169,20,2
2022-02-04,Vung Tau,Vung Tau City,16,166,153,13,1
2022-02-04,Vung Tau,Vung Tau City,17,219,196,23,2
2022-02-04,Vung Tau,Vung Tau City,18,252,209,43,9
2022-02-04,Vung Tau,Vung Tau City,19,216,175,41,7
2022-02-04,Vung Tau,Vung Tau City,20,204,154,50,32
2022-02-04,Vung Tau,Vung Tau City,21,149,78,71,42
2022-02-04,Vung Tau,Vung Tau City,22,1,1,0,0
2022-02-05,Binh Duong,Di An,0,1,0,1,0
2022-02-05,Binh Duong,Di An,7,1,0,1,1
2022-02-05,Binh Duong,Di An,8,1,0,1,1
2022-02-05,Binh Duong,Di An,9,5,3,2,1
2022-02-05,Binh Duong,Di An,10,8,5,3,2
2022-02-05,Binh Duong,Di An,11,11,5,6,6
2022-02-05,Binh Duong,Di An,12,25,8,17,15
2022-02-05,Binh Duong,Di An,13,26,11,15,13
2022-02-05,Binh Duong,Di An,14,7,3,4,4
2022-02-05,Binh Duong,Di An,15,13,2,11,10
2022-02-05,Binh Duong,Di An,16,13,3,10,7
2022-02-05,Binh Duong,Di An,17,12,5,7,6
2022-02-05,Binh Duong,Di An,18,14,6,8,6
2022-02-05,Binh Duong,Di An,19,13,5,8,5
2022-02-05,Binh Duong,Di An,20,1,0,1,0
2022-02-05,Binh Duong,Di An,21,5,1,4,3
2022-02-05,Binh Duong,Di An,22,1,0,1,0
2022-02-05,Binh Duong,Tan Uyen,9,1,0,1,1
2022-02-05,Binh Duong,Tan Uyen,12,2,0,2,2
2022-02-05,Binh Duong,Tan Uyen,13,1,0,1,1
2022-02-05,Binh Duong,Tan Uyen,14,2,1,1,1
2022-02-05,Binh Duong,Tan Uyen,16,1,0,1,1
2022-02-05,Binh Duong,Tan Uyen,17,1,0,1,1
2022-02-05,Binh Duong,Tan Uyen,18,2,0,2,1
2022-02-05,Binh Duong,Tan Uyen,19,4,0,4,3
2022-02-05,Binh Duong,Tan Uyen,20,1,0,1,1
2022-02-05,Binh Duong,Thu Dau Mot Town,6,7,2,5,5
2022-02-05,Binh Duong,Thu Dau Mot Town,7,39,32,7,0
2022-02-05,Binh Duong,Thu Dau Mot Town,8,64,54,10,4
2022-02-05,Binh Duong,Thu Dau Mot Town,9,125,107,18,7
2022-02-05,Binh Duong,Thu Dau Mot Town,10,184,158,26,13
2022-02-05,Binh Duong,Thu Dau Mot Town,11,252,213,39,15
2022-02-05,Binh Duong,Thu Dau Mot Town,12,263,219,44,29
2022-02-05,Binh Duong,Thu Dau Mot Town,13,208,182,26,14
2022-02-05,Binh Duong,Thu Dau Mot Town,14,178,156,22,12
2022-02-05,Binh Duong,Thu Dau Mot Town,15,177,150,27,15
2022-02-05,Binh Duong,Thu Dau Mot Town,16,139,121,18,9
2022-02-05,Binh Duong,Thu Dau Mot Town,17,172,158,14,4
2022-02-05,Binh Duong,Thu Dau Mot Town,18,203,158,45,23
2022-02-05,Binh Duong,Thu Dau Mot Town,19,260,162,98,75
2022-02-05,Binh Duong,Thu Dau Mot Town,20,157,113,44,29
2022-02-05,Binh Duong,Thu Dau Mot Town,21,89,60,29,13
2022-02-05,Binh Duong,Thu Dau Mot Town,23,2,0,2,0
2022-02-05,Binh Duong,Thuan An,7,1,0,1,1
2022-02-05,Binh Duong,Thuan An,8,10,0,10,8
2022-02-05,Binh Duong,Thuan An,9,7,1,6,2
2022-02-05,Binh Duong,Thuan An,10,38,11,27,22
2022-02-05,Binh Duong,Thuan An,11,60,15,45,42
2022-02-05,Binh Duong,Thuan An,12,56,9,47,41
2022-02-05,Binh Duong,Thuan An,13,55,13,42,38
2022-02-05,Binh Duong,Thuan An,14,50,13,37,32
2022-02-05,Binh Duong,Thuan An,15,39,10,29,25
2022-02-05,Binh Duong,Thuan An,16,51,7,44,39
2022-02-05,Binh Duong,Thuan An,17,30,4,26,21
2022-02-05,Binh Duong,Thuan An,18,52,10,42,37
2022-02-05,Binh Duong,Thuan An,19,43,11,32,30
2022-02-05,Binh Duong,Thuan An,20,23,5,18,16
2022-02-05,Binh Duong,Thuan An,21,20,2,18,14
2022-02-05,Can Tho City,Binh Thuy District,7,1,1,0,0
2022-02-05,Can Tho City,Binh Thuy District,9,3,3,0,0
2022-02-05,Can Tho City,Binh Thuy District,10,8,7,1,0
2022-02-05,Can Tho City,Binh Thuy District,11,4,4,0,0
2022-02-05,Can Tho City,Binh Thuy District,12,8,7,1,0
2022-02-05,Can Tho City,Binh Thuy District,13,5,4,1,1
2022-02-05,Can Tho City,Binh Thuy District,14,4,4,0,0
2022-02-05,Can Tho City,Binh Thuy District,15,4,4,0,0
2022-02-05,Can Tho City,Binh Thuy District,16,14,12,2,1
2022-02-05,Can Tho City,Binh Thuy District,17,9,9,0,0
2022-02-05,Can Tho City,Binh Thuy District,18,6,5,1,0
2022-02-05,Can Tho City,Binh Thuy District,19,8,7,1,0
2022-02-05,Can Tho City,Binh Thuy District,20,5,5,0,0
2022-02-05,Can Tho City,Binh Thuy District,21,2,2,0,0
2022-02-05,Can Tho City,Cai Rang District,9,5,5,0,0
2022-02-05,Can Tho City,Cai Rang District,10,6,6,0,0
2022-02-05,Can Tho City,Cai Rang District,11,9,9,0,0
2022-02-05,Can Tho City,Cai Rang District,12,10,10,0,0
2022-02-05,Can Tho City,Cai Rang District,13,7,6,1,1
2022-02-05,Can Tho City,Cai Rang District,14,6,6,0,0
2022-02-05,Can Tho City,Cai Rang District,15,4,4,0,0
2022-02-05,Can Tho City,Cai Rang District,16,4,4,0,0
2022-02-05,Can Tho City,Cai Rang District,17,6,6,0,0
2022-02-05,Can Tho City,Cai Rang District,18,8,7,1,0
2022-02-05,Can Tho City,Cai Rang District,19,7,7,0,0
2022-02-05,Can Tho City,Cai Rang District,20,6,5,1,0
2022-02-05,Can Tho City,Cai Rang District,21,2,2,0,0
2022-02-05,Can Tho City,Cai Rang District,22,1,0,1,1
2022-02-05,Can Tho City,Ninh Kieu District,0,3,2,1,0
2022-02-05,Can Tho City,Ninh Kieu District,2,1,0,1,0
2022-02-05,Can Tho City,Ninh Kieu District,6,12,12,0,0
2022-02-05,Can Tho City,Ninh Kieu District,7,44,42,2,0
2022-02-05,Can Tho City,Ninh Kieu District,8,92,78,14,0
2022-02-05,Can Tho City,Ninh Kieu District,9,140,127,13,0
2022-02-05,Can Tho City,Ninh Kieu District,10,149,147,2,0
2022-02-05,Can Tho City,Ninh Kieu District,11,191,185,6,0
2022-02-05,Can Tho City,Ninh Kieu District,12,163,155,8,0
2022-02-05,Can Tho City,Ninh Kieu District,13,161,150,11,0
2022-02-05,Can Tho City,Ninh Kieu District,14,136,130,6,0
2022-02-05,Can Tho City,Ninh Kieu District,15,134,130,4,0
2022-02-05,Can Tho City,Ninh Kieu District,16,132,125,7,0
2022-02-05,Can Tho City,Ninh Kieu District,17,176,170,6,0
2022-02-05,Can Tho City,Ninh Kieu District,18,189,179,10,0
2022-02-05,Can Tho City,Ninh Kieu District,19,181,168,13,0
2022-02-05,Can Tho City,Ninh Kieu District,20,122,117,5,0
2022-02-05,Can Tho City,Ninh Kieu District,21,77,68,9,1
2022-02-05,Can Tho City,Ninh Kieu District,22,2,0,2,0
2022-02-05,Can Tho City,Ninh Kieu District,23,2,1,1,0
2022-02-05,Dong Nai,Bien Hoa City,0,3,0,3,3
2022-02-05,Dong Nai,Bien Hoa City,2,2,0,2,1
2022-02-05,Dong Nai,Bien Hoa City,4,1,1,0,0
2022-02-05,Dong Nai,Bien Hoa City,6,18,5,13,13
2022-02-05,Dong Nai,Bien Hoa City,7,63,42,21,15
2022-02-05,Dong Nai,Bien Hoa City,8,135,98,37,21
2022-02-05,Dong Nai,Bien Hoa City,9,233,197,36,12
2022-02-05,Dong Nai,Bien Hoa City,10,371,308,63,28
2022-02-05,Dong Nai,Bien Hoa City,11,546,465,81,44
2022-02-05,Dong Nai,Bien Hoa City,12,549,445,104,54
2022-02-05,Dong Nai,Bien Hoa City,13,433,351,82,54
2022-02-05,Dong Nai,Bien Hoa City,14,392,327,65,34
2022-02-05,Dong Nai,Bien Hoa City,15,344,278,66,38
2022-02-05,Dong Nai,Bien Hoa City,16,360,287,73,39
2022-02-05,Dong Nai,Bien Hoa City,17,358,287,71,41
2022-02-05,Dong Nai,Bien Hoa City,18,496,323,173,125
2022-02-05,Dong Nai,Bien Hoa City,19,528,271,257,219
2022-02-05,Dong Nai,Bien Hoa City,20,553,226,327,280
2022-02-05,Dong Nai,Bien Hoa City,21,219,102,117,84
2022-02-05,Dong Nai,Bien Hoa City,22,3,0,3,1
2022-02-05,Dong Nai,Bien Hoa City,23,2,0,2,1
2022-02-05,Dong Nai,Long Thanh,6,1,0,1,0
2022-02-05,Dong Nai,Long Thanh,7,1,0,1,1
2022-02-05,Dong Nai,Long Thanh,8,1,0,1,1
2022-02-05,Dong Nai,Long Thanh,9,1,0,1,1
2022-02-05,Dong Nai,Long Thanh,10,1,0,1,1
2022-02-05,Dong Nai,Long Thanh,11,5,0,5,3
2022-02-05,Dong Nai,Long Thanh,12,1,0,1,1
2022-02-05,Dong Nai,Long Thanh,13,4,0,4,4
2022-02-05,Dong Nai,Long Thanh,14,2,0,2,2
2022-02-05,Dong Nai,Long Thanh,15,1,0,1,1
2022-02-05,Dong Nai,Long Thanh,16,2,0,2,2
2022-02-05,Dong Nai,Long Thanh,17,1,0,1,1
2022-02-05,Dong Nai,Long Thanh,18,6,0,6,6
2022-02-05,Dong Nai,Long Thanh,19,1,0,1,1
2022-02-05,Dong Nai,Long Thanh,20,2,0,2,2
2022-02-05,Dong Nai,Thong Nhat,8,3,3,0,0
2022-02-05,Dong Nai,Thong Nhat,9,2,2,0,0
2022-02-05,Dong Nai,Thong Nhat,10,3,3,0,0
2022-02-05,Dong Nai,Thong Nhat,11,2,2,0,0
2022-02-05,Dong Nai,Thong Nhat,12,2,1,1,1
2022-02-05,Dong Nai,Thong Nhat,13,3,2,1,1
2022-02-05,Dong Nai,Thong Nhat,14,3,2,1,1
2022-02-05,Dong Nai,Thong Nhat,15,4,3,1,0
2022-02-05,Dong Nai,Thong Nhat,16,2,2,0,0
2022-02-05,Dong Nai,Thong Nhat,19,3,0,3,1
2022-02-05,Dong Nai,Thong Nhat,20,3,3,0,0
2022-02-05,Dong Nai,Thong Nhat,21,1,1,0,0
2022-02-05,Hai Phong City,An Duong,8,1,0,1,1
2022-02-05,Hai Phong City,An Duong,9,1,0,1,1
2022-02-05,Hai Phong City,An Duong,10,1,1,0,0
2022-02-05,Hai Phong City,An Duong,11,2,2,0,0
2022-02-05,Hai Phong City,An Duong,12,1,0,1,0
2022-02-05,Hai Phong City,An Duong,14,1,0,1,1
2022-02-05,Hai Phong City,An Duong,16,6,0,6,5
2022-02-05,Hai Phong City,An Duong,18,2,0,2,2
2022-02-05,Hai Phong City,An Duong,19,1,0,1,0
2022-02-05,Hai Phong City,An Duong,20,6,0,6,6
2022-02-05,Hai Phong City,Hai An District,8,1,0,1,1
2022-02-05,Hai Phong City,Hai An District,9,2,2,0,0
2022-02-05,Hai Phong City,Hai An District,10,10,6,4,2
2022-02-05,Hai Phong City,Hai An District,11,13,9,4,4
2022-02-05,Hai Phong City,Hai An District,12,7,3,4,3
2022-02-05,Hai Phong City,Hai An District,13,12,11,1,1
2022-02-05,Hai Phong City,Hai An District,14,4,4,0,0
2022-02-05,Hai Phong City,Hai An District,15,4,2,2,2
2022-02-05,Hai Phong City,Hai An District,16,9,8,1,1
2022-02-05,Hai Phong City,Hai An District,17,5,5,0,0
2022-02-05,Hai Phong City,Hai An District,18,18,10,8,5
2022-02-05,Hai Phong City,Hai An District,19,17,9,8,6
2022-02-05,Hai Phong City,Hai An District,20,17,6,11,9
2022-02-05,Hai Phong City,Hai An District,21,12,5,7,7
2022-02-05,Hai Phong City,Hong Bang District,7,1,1,0,0
2022-02-05,Hai Phong City,Hong Bang District,8,2,2,0,0
2022-02-05,Hai Phong City,Hong Bang District,9,2,1,1,1
2022-02-05,Hai Phong City,Hong Bang District,10,23,12,11,8
2022-02-05,Hai Phong City,Hong Bang District,11,45,27,18,13
2022-02-05,Hai Phong City,Hong Bang District,12,30,17,13,8
2022-02-05,Hai Phong City,Hong Bang District,13,13,9,4,2
2022-02-05,Hai Phong City,Hong Bang District,14,19,15,4,2
2022-02-05,Hai Phong City,Hong Bang District,15,16,10,6,4
2022-02-05,Hai Phong City,Hong Bang District,16,21,16,5,2
2022-02-05,Hai Phong City,Hong Bang District,17,27,16,11,7
2022-02-05,Hai Phong City,Hong Bang District,18,34,12,22,19
2022-02-05,Hai Phong City,Hong Bang District,19,32,14,18,14
2022-02-05,Hai Phong City,Hong Bang District,20,24,6,18,14
2022-02-05,Hai Phong City,Hong Bang District,21,8,3,5,4
2022-02-05,Hai Phong City,Kien An District,9,2,0,2,2
2022-02-05,Hai Phong City,Kien An District,10,7,2,5,5
2022-02-05,Hai Phong City,Kien An District,11,14,0,14,7
2022-02-05,Hai Phong City,Kien An District,12,11,0,11,8
2022-02-05,Hai Phong City,Kien An District,13,9,0,9,7
2022-02-05,Hai Phong City,Kien An District,14,15,0,15,13
2022-02-05,Hai Phong City,Kien An District,15,18,2,16,14
2022-02-05,Hai Phong City,Kien An District,16,8,1,7,6
2022-02-05,Hai Phong City,Kien An District,17,11,2,9,8
2022-02-05,Hai Phong City,Kien An District,18,14,3,11,8
2022-02-05,Hai Phong City,Kien An District,19,14,4,10,9
2022-02-05,Hai Phong City,Kien An District,20,8,0,8,8
2022-02-05,Hai Phong City,Kien An District,21,1,0,1,1
2022-02-05,Hai Phong City,Kien An District,23,1,0,1,1
2022-02-05,Hai Phong City,Le Chan District,0,1,0,1,0
2022-02-05,Hai Phong City,Le Chan District,6,1,0,1,1
2022-02-05,Hai Phong City,Le Chan District,7,11,9,2,2
2022-02-05,Hai Phong City,Le Chan District,8,39,27,12,5
2022-02-05,Hai Phong City,Le Chan District,9,49,41,8,3
2022-02-05,Hai Phong City,Le Chan District,10,117,82,35,28
2022-02-05,Hai Phong City,Le Chan District,11,188,123,65,49
2022-02-05,Hai Phong City,Le Chan District,12,150,107,43,33
2022-02-05,Hai Phong City,Le Chan District,13,103,76,27,17
2022-02-05,Hai Phong City,Le Chan District,14,92,71,21,14
2022-02-05,Hai Phong City,Le Chan District,15,109,82,27,22
2022-02-05,Hai Phong City,Le Chan District,16,129,102,27,19
2022-02-05,Hai Phong City,Le Chan District,17,158,108,50,40
2022-02-05,Hai Phong City,Le Chan District,18,189,100,89,73
2022-02-05,Hai Phong City,Le Chan District,19,218,74,144,118
2022-02-05,Hai Phong City,Le Chan District,20,203,74,129,109
2022-02-05,Hai Phong City,Le Chan District,21,122,39,83,63
2022-02-05,Hai Phong City,Le Chan District,23,2,1,1,1
2022-02-05,Hai Phong City,Ngo Quyen District,7,7,5,2,2
2022-02-05,Hai Phong City,Ngo Quyen District,8,25,21,4,1
2022-02-05,Hai Phong City,Ngo Quyen District,9,46,39,7,2
2022-02-05,Hai Phong City,Ngo Quyen District,10,78,61,17,10
2022-02-05,Hai Phong City,Ngo Quyen District,11,127,80,47,31
2022-02-05,Hai Phong City,Ngo Quyen District,12,116,83,33,18
2022-02-05,Hai Phong City,Ngo Quyen District,13,90,78,12,6
2022-02-05,Hai Phong City,Ngo Quyen District,14,109,85,24,13
2022-02-05,Hai Phong City,Ngo Quyen District,15,127,85,42,17
2022-02-05,Hai Phong City,Ngo Quyen District,16,104,65,39,21
2022-02-05,Hai Phong City,Ngo Quyen District,17,141,97,44,27
2022-02-05,Hai Phong City,Ngo Quyen District,18,143,85,58,41
2022-02-05,Hai Phong City,Ngo Quyen District,19,178,80,98,74
2022-02-05,Hai Phong City,Ngo Quyen District,20,226,94,132,114
2022-02-05,Hai Phong City,Ngo Quyen District,21,111,31,80,59
2022-02-05,Hai Phong City,Ngo Quyen District,22,1,0,1,0
2022-02-05,Hai Phong City,Thuy Nguyen,9,1,0,1,1
2022-02-05,Hai Phong City,Thuy Nguyen,10,2,0,2,2
2022-02-05,Hai Phong City,Thuy Nguyen,11,1,0,1,1
2022-02-05,Hai Phong City,Thuy Nguyen,12,1,0,1,1
2022-02-05,Hai Phong City,Thuy Nguyen,13,5,0,5,3
2022-02-05,Hai Phong City,Thuy Nguyen,15,7,0,7,7
2022-02-05,Hai Phong City,Thuy Nguyen,16,1,1,0,0
2022-02-05,Hai Phong City,Thuy Nguyen,17,1,0,1,1
2022-02-05,Hai Phong City,Thuy Nguyen,20,2,0,2,2
2022-02-05,Hai Phong City,Thuy Nguyen,21,1,0,1,0
2022-02-05,Hue City,Hue City,4,1,0,1,0
2022-02-05,Hue City,Hue City,6,15,12,3,2
2022-02-05,Hue City,Hue City,7,70,63,7,3
2022-02-05,Hue City,Hue City,8,127,108,19,3
2022-02-05,Hue City,Hue City,9,150,141,9,2
2022-02-05,Hue City,Hue City,10,179,159,20,0
2022-02-05,Hue City,Hue City,11,234,217,17,0
2022-02-05,Hue City,Hue City,12,246,214,32,4
2022-02-05,Hue City,Hue City,13,209,188,21,3
2022-02-05,Hue City,Hue City,14,218,185,33,10
2022-02-05,Hue City,Hue City,15,266,223,43,18
2022-02-05,Hue City,Hue City,16,327,264,63,33
2022-02-05,Hue City,Hue City,17,395,289,106,68
2022-02-05,Hue City,Hue City,18,411,276,135,81
2022-02-05,Hue City,Hue City,19,405,279,126,90
2022-02-05,Hue City,Hue City,20,370,237,133,97
2022-02-05,Hue City,Hue City,21,181,102,79,36
2022-02-05,Hue City,Hue City,22,2,0,2,0
2022-02-05,Hue City,Huong Thuy,11,1,0,1,1
2022-02-05,Hue City,Huong Thuy,12,1,0,1,0
2022-02-05,Hue City,Huong Thuy,14,1,0,1,1
2022-02-05,Hue City,Huong Thuy,17,1,1,0,0
2022-02-05,Hue City,Huong Thuy,18,2,0,2,2
2022-02-05,Hue City,Huong Thuy,20,2,0,2,2
2022-02-05,Hue City,Huong Tra,12,1,1,0,0
2022-02-05,Hue City,Huong Tra,16,1,1,0,0
2022-02-05,Hue City,Huong Tra,18,3,2,1,1
2022-02-05,Hue City,Huong Tra,20,2,0,2,2
2022-02-05,Hue City,Phong Dien,16,1,0,1,0
2022-02-05,Hue City,Phu Vang,9,1,1,0,0
2022-02-05,Hue City,Phu Vang,12,1,1,0,0
2022-02-05,Hue City,Phu Vang,14,1,1,0,0
2022-02-05,Hue City,Phu Vang,18,1,0,1,1
2022-02-05,Hue City,Phu Vang,19,1,1,0,0
2022-02-05,Vung Tau,Ba Ria City,6,1,0,1,1
2022-02-05,Vung Tau,Ba Ria City,9,2,2,0,0
2022-02-05,Vung Tau,Ba Ria City,10,7,4,3,3
2022-02-05,Vung Tau,Ba Ria City,11,4,3,1,1
2022-02-05,Vung Tau,Ba Ria City,12,8,2,6,6
2022-02-05,Vung Tau,Ba Ria City,13,8,2,6,6
2022-02-05,Vung Tau,Ba Ria City,14,7,3,4,4
2022-02-05,Vung Tau,Ba Ria City,15,10,0,10,9
2022-02-05,Vung Tau,Ba Ria City,16,12,3,9,6
2022-02-05,Vung Tau,Ba Ria City,17,9,3,6,6
2022-02-05,Vung Tau,Ba Ria City,18,12,3,9,9
2022-02-05,Vung Tau,Ba Ria City,19,10,1,9,9
2022-02-05,Vung Tau,Ba Ria City,20,11,0,11,11
2022-02-05,Vung Tau,Ba Ria City,21,9,0,9,9
2022-02-05,Vung Tau,Tan Thanh,15,1,0,1,0
2022-02-05,Vung Tau,Vung Tau City,0,1,1,0,0
2022-02-05,Vung Tau,Vung Tau City,3,1,0,1,0
2022-02-05,Vung Tau,Vung Tau City,5,2,0,2,2
2022-02-05,Vung Tau,Vung Tau City,6,25,12,13,8
2022-02-05,Vung Tau,Vung Tau City,7,79,68,11,4
2022-02-05,Vung Tau,Vung Tau City,8,138,131,7,1
2022-02-05,Vung Tau,Vung Tau City,9,156,140,16,2
2022-02-05,Vung Tau,Vung Tau City,10,195,177,18,3
2022-02-05,Vung Tau,Vung Tau City,11,230,199,31,7
2022-02-05,Vung Tau,Vung Tau City,12,256,220,36,3
2022-02-05,Vung Tau,Vung Tau City,13,198,181,17,3
2022-02-05,Vung Tau,Vung Tau City,14,202,182,20,2
2022-02-05,Vung Tau,Vung Tau City,15,187,175,12,2
2022-02-05,Vung Tau,Vung Tau City,16,137,124,13,0
2022-02-05,Vung Tau,Vung Tau City,17,168,147,21,3
2022-02-05,Vung Tau,Vung Tau City,18,200,180,20,7
2022-02-05,Vung Tau,Vung Tau City,19,233,166,67,44
2022-02-05,Vung Tau,Vung Tau City,20,211,129,82,58
2022-02-05,Vung Tau,Vung Tau City,21,145,68,77,56
2022-02-05,Vung Tau,Vung Tau City,22,2,0,2,0
2022-02-05,Vung Tau,Vung Tau City,23,2,0,2,0
2022-02-06,Binh Duong,Di An,7,1,0,1,0
2022-02-06,Binh Duong,Di An,8,3,2,1,0
2022-02-06,Binh Duong,Di An,9,5,1,4,2
2022-02-06,Binh Duong,Di An,10,25,5,20,16
2022-02-06,Binh Duong,Di An,11,30,8,22,21
2022-02-06,Binh Duong,Di An,12,18,7,11,10
2022-02-06,Binh Duong,Di An,13,17,8,9,8
2022-02-06,Binh Duong,Di An,14,14,3,11,11
2022-02-06,Binh Duong,Di An,15,5,2,3,1
2022-02-06,Binh Duong,Di An,16,8,3,5,4
2022-02-06,Binh Duong,Di An,17,13,0,13,13
2022-02-06,Binh Duong,Di An,18,16,3,13,13
2022-02-06,Binh Duong,Di An,19,17,0,17,15
2022-02-06,Binh Duong,Di An,20,13,3,10,10
2022-02-06,Binh Duong,Di An,21,11,2,9,7
2022-02-06,Binh Duong,Tan Uyen,10,2,0,2,0
2022-02-06,Binh Duong,Tan Uyen,12,1,0,1,1
2022-02-06,Binh Duong,Tan Uyen,14,1,0,1,1
2022-02-06,Binh Duong,Tan Uyen,15,1,0,1,1
2022-02-06,Binh Duong,Tan Uyen,17,2,0,2,2
2022-02-06,Binh Duong,Tan Uyen,18,5,0,5,5
2022-02-06,Binh Duong,Tan Uyen,19,4,0,4,4
2022-02-06,Binh Duong,Tan Uyen,20,1,0,1,1
2022-02-06,Binh Duong,Tan Uyen,21,3,0,3,2
2022-02-06,Binh Duong,Thu Dau Mot Town,6,9,4,5,5
2022-02-06,Binh Duong,Thu Dau Mot Town,7,61,49,12,6
2022-02-06,Binh Duong,Thu Dau Mot Town,8,104,84,20,9
2022-02-06,Binh Duong,Thu Dau Mot Town,9,156,125,31,22
2022-02-06,Binh Duong,Thu Dau Mot Town,10,224,191,33,14
2022-02-06,Binh Duong,Thu Dau Mot Town,11,352,271,81,57
2022-02-06,Binh Duong,Thu Dau Mot Town,12,340,264,76,52
2022-02-06,Binh Duong,Thu Dau Mot Town,13,232,200,32,14
2022-02-06,Binh Duong,Thu Dau Mot Town,14,234,200,34,14
2022-02-06,Binh Duong,Thu Dau Mot Town,15,199,172,27,16
2022-02-06,Binh Duong,Thu Dau Mot Town,16,181,154,27,16
2022-02-06,Binh Duong,Thu Dau Mot Town,17,239,205,34,22
2022-02-06,Binh Duong,Thu Dau Mot Town,18,277,212,65,48
2022-02-06,Binh Duong,Thu Dau Mot Town,19,240,148,92,71
2022-02-06,Binh Duong,Thu Dau Mot Town,20,208,118,90,58
2022-02-06,Binh Duong,Thu Dau Mot Town,21,93,52,41,23
2022-02-06,Binh Duong,Thu Dau Mot Town,22,1,0,1,0
2022-02-06,Binh Duong,Thuan An,7,3,2,1,1
2022-02-06,Binh Duong,Thuan An,8,13,2,11,10
2022-02-06,Binh Duong,Thuan An,9,25,2,23,20
2022-02-06,Binh Duong,Thuan An,10,46,14,32,25
2022-02-06,Binh Duong,Thuan An,11,70,18,52,42
2022-02-06,Binh Duong,Thuan An,12,61,23,38,35
2022-02-06,Binh Duong,Thuan An,13,51,18,33,32
2022-02-06,Binh Duong,Thuan An,14,46,17,29,20
2022-02-06,Binh Duong,Thuan An,15,40,17,23,18
2022-02-06,Binh Duong,Thuan An,16,35,13,22,17
2022-02-06,Binh Duong,Thuan An,17,35,10,25,24
2022-02-06,Binh Duong,Thuan An,18,39,11,28,23
2022-02-06,Binh Duong,Thuan An,19,48,5,43,38
2022-02-06,Binh Duong,Thuan An,20,22,4,18,16
2022-02-06,Binh Duong,Thuan An,21,16,0,16,14
2022-02-06,Can Tho City,Binh Thuy District,8,1,1,0,0
2022-02-06,Can Tho City,Binh Thuy District,9,6,6,0,0
2022-02-06,Can Tho City,Binh Thuy District,10,4,4,0,0
2022-02-06,Can Tho City,Binh Thuy District,11,6,5,1,0
2022-02-06,Can Tho City,Binh Thuy District,12,10,9,1,0
2022-02-06,Can Tho City,Binh Thuy District,13,6,6,0,0
2022-02-06,Can Tho City,Binh Thuy District,14,5,5,0,0
2022-02-06,Can Tho City,Binh Thuy District,15,6,5,1,0
2022-02-06,Can Tho City,Binh Thuy District,16,6,6,0,0
2022-02-06,Can Tho City,Binh Thuy District,17,12,12,0,0
2022-02-06,Can Tho City,Binh Thuy District,18,3,3,0,0
2022-02-06,Can Tho City,Binh Thuy District,19,8,7,1,0
2022-02-06,Can Tho City,Binh Thuy District,20,7,7,0,0
2022-02-06,Can Tho City,Binh Thuy District,21,3,3,0,0
2022-02-06,Can Tho City,Cai Rang District,6,1,1,0,0
2022-02-06,Can Tho City,Cai Rang District,7,2,1,1,1
2022-02-06,Can Tho City,Cai Rang District,8,1,1,0,0
2022-02-06,Can Tho City,Cai Rang District,9,6,6,0,0
2022-02-06,Can Tho City,Cai Rang District,10,7,6,1,0
2022-02-06,Can Tho City,Cai Rang District,11,4,4,0,0
2022-02-06,Can Tho City,Cai Rang District,12,6,5,1,0
2022-02-06,Can Tho City,Cai Rang District,13,11,11,0,0
2022-02-06,Can Tho City,Cai Rang District,14,5,4,1,0
2022-02-06,Can Tho City,Cai Rang District,15,3,3,0,0
2022-02-06,Can Tho City,Cai Rang District,16,10,10,0,0
2022-02-06,Can Tho City,Cai Rang District,17,7,7,0,0
2022-02-06,Can Tho City,Cai Rang District,18,6,6,0,0
2022-02-06,Can Tho City,Cai Rang District,19,7,7,0,0
2022-02-06,Can Tho City,Cai Rang District,20,2,2,0,0
2022-02-06,Can Tho City,Ninh Kieu District,6,13,10,3,1
2022-02-06,Can Tho City,Ninh Kieu District,7,48,41,7,0
2022-02-06,Can Tho City,Ninh Kieu District,8,95,92,3,0
2022-02-06,Can Tho City,Ninh Kieu District,9,142,134,8,0
2022-02-06,Can Tho City,Ninh Kieu District,10,172,164,8,0
2022-02-06,Can Tho City,Ninh Kieu District,11,271,260,11,0
2022-02-06,Can Tho City,Ninh Kieu District,12,276,257,19,0
2022-02-06,Can Tho City,Ninh Kieu District,13,234,223,11,1
2022-02-06,Can Tho City,Ninh Kieu District,14,207,195,12,0
2022-02-06,Can Tho City,Ninh Kieu District,15,196,186,10,0
2022-02-06,Can Tho City,Ninh Kieu District,16,201,191,10,0
2022-02-06,Can Tho City,Ninh Kieu District,17,232,227,5,0
2022-02-06,Can Tho City,Ninh Kieu District,18,256,235,21,2
2022-02-06,Can Tho City,Ninh Kieu District,19,271,250,21,3
2022-02-06,Can Tho City,Ninh Kieu District,20,223,189,34,2
2022-02-06,Can Tho City,Ninh Kieu District,21,84,80,4,0
2022-02-06,Can Tho City,Ninh Kieu District,22,2,2,0,0
2022-02-06,Can Tho City,Ninh Kieu District,23,3,1,2,1
2022-02-06,Dong Nai,Bien Hoa City,1,2,0,2,0
2022-02-06,Dong Nai,Bien Hoa City,3,1,0,1,0
2022-02-06,Dong Nai,Bien Hoa City,5,4,0,4,1
2022-02-06,Dong Nai,Bien Hoa City,6,22,7,15,12
2022-02-06,Dong Nai,Bien Hoa City,7,65,41,24,9
2022-02-06,Dong Nai,Bien Hoa City,8,159,126,33,14
2022-02-06,Dong Nai,Bien Hoa City,9,239,189,50,24
2022-02-06,Dong Nai,Bien Hoa City,10,506,390,116,85
2022-02-06,Dong Nai,Bien Hoa City,11,667,510,157,109
2022-02-06,Dong Nai,Bien Hoa City,12,679,490,189,126
2022-02-06,Dong Nai,Bien Hoa City,13,535,412,123,79
2022-02-06,Dong Nai,Bien Hoa City,14,433,330,103,71
2022-02-06,Dong Nai,Bien Hoa City,15,392,280,112,72
2022-02-06,Dong Nai,Bien Hoa City,16,344,268,76,45
2022-02-06,Dong Nai,Bien Hoa City,17,426,282,144,109
2022-02-06,Dong Nai,Bien Hoa City,18,589,285,304,247
2022-02-06,Dong Nai,Bien Hoa City,19,687,253,434,352
2022-02-06,Dong Nai,Bien Hoa City,20,564,197,367,288
2022-02-06,Dong Nai,Bien Hoa City,21,210,65,145,118
2022-02-06,Dong Nai,Bien Hoa City,22,4,0,4,0
2022-02-06,Dong Nai,Long Thanh,9,1,0,1,1
2022-02-06,Dong Nai,Long Thanh,11,1,0,1,1
2022-02-06,Dong Nai,Long Thanh,12,1,0,1,0
2022-02-06,Dong Nai,Long Thanh,13,5,0,5,4
2022-02-06,Dong Nai,Long Thanh,14,4,0,4,4
2022-02-06,Dong Nai,Long Thanh,17,3,0,3,3
2022-02-06,Dong Nai,Long Thanh,18,3,0,3,3
2022-02-06,Dong Nai,Thong Nhat,8,2,2,0,0
2022-02-06,Dong Nai,Thong Nhat,10,1,1,0,0
2022-02-06,Dong Nai,Thong Nhat,11,3,3,0,0
2022-02-06,Dong Nai,Thong Nhat,13,3,3,0,0
2022-02-06,Dong Nai,Thong Nhat,14,3,3,0,0
2022-02-06,Dong Nai,Thong Nhat,15,1,1,0,0
2022-02-06,Dong Nai,Thong Nhat,16,2,2,0,0
2022-02-06,Dong Nai,Thong Nhat,18,1,1,0,0
2022-02-06,Dong Nai,Thong Nhat,19,2,2,0,0
2022-02-06,Dong Nai,Thong Nhat,20,2,0,2,2
2022-02-06,Dong Nai,Thong Nhat,21,1,1,0,0
2022-02-06,Hai Phong City,An Duong,8,1,0,1,1
2022-02-06,Hai Phong City,An Duong,9,2,0,2,2
2022-02-06,Hai Phong City,An Duong,12,5,1,4,4
2022-02-06,Hai Phong City,An Duong,13,2,0,2,2
2022-02-06,Hai Phong City,An Duong,14,4,1,3,3
2022-02-06,Hai Phong City,An Duong,15,2,0,2,2
2022-02-06,Hai Phong City,An Duong,18,4,0,4,4
2022-02-06,Hai Phong City,An Duong,19,1,0,1,1
2022-02-06,Hai Phong City,An Duong,20,1,0,1,1
2022-02-06,Hai Phong City,Hai An District,7,2,0,2,2
2022-02-06,Hai Phong City,Hai An District,8,6,2,4,4
2022-02-06,Hai Phong City,Hai An District,9,7,4,3,1
2022-02-06,Hai Phong City,Hai An District,10,14,9,5,4
2022-02-06,Hai Phong City,Hai An District,11,25,10,15,14
2022-02-06,Hai Phong City,Hai An District,12,30,6,24,18
2022-02-06,Hai Phong City,Hai An District,13,20,10,10,7
2022-02-06,Hai Phong City,Hai An District,14,14,9,5,4
2022-02-06,Hai Phong City,Hai An District,15,12,9,3,0
2022-02-06,Hai Phong City,Hai An District,16,15,9,6,4
2022-02-06,Hai Phong City,Hai An District,17,18,10,8,5
2022-02-06,Hai Phong City,Hai An District,18,24,10,14,12
2022-02-06,Hai Phong City,Hai An District,19,25,11,14,7
2022-02-06,Hai Phong City,Hai An District,20,16,4,12,10
2022-02-06,Hai Phong City,Hai An District,21,7,5,2,2
2022-02-06,Hai Phong City,Hong Bang District,7,2,2,0,0
2022-02-06,Hai Phong City,Hong Bang District,8,9,4,5,2
2022-02-06,Hai Phong City,Hong Bang District,9,11,10,1,0
2022-02-06,Hai Phong City,Hong Bang District,10,22,13,9,6
2022-02-06,Hai Phong City,Hong Bang District,11,73,24,49,46
2022-02-06,Hai Phong City,Hong Bang District,12,71,23,48,42
2022-02-06,Hai Phong City,Hong Bang District,13,40,23,17,14
2022-02-06,Hai Phong City,Hong Bang District,14,36,15,21,16
2022-02-06,Hai Phong City,Hong Bang District,15,33,17,16,12
2022-02-06,Hai Phong City,Hong Bang District,16,26,15,11,6
2022-02-06,Hai Phong City,Hong Bang District,17,47,17,30,27
2022-02-06,Hai Phong City,Hong Bang District,18,61,11,50,40
2022-02-06,Hai Phong City,Hong Bang District,19,45,11,34,30
2022-02-06,Hai Phong City,Hong Bang District,20,48,9,39,34
2022-02-06,Hai Phong City,Hong Bang District,21,18,4,14,10
2022-02-06,Hai Phong City,Hong Bang District,22,1,0,1,0
2022-02-06,Hai Phong City,Kien An District,8,2,0,2,2
2022-02-06,Hai Phong City,Kien An District,9,4,0,4,4
2022-02-06,Hai Phong City,Kien An District,10,15,1,14,13
2022-02-06,Hai Phong City,Kien An District,11,18,0,18,15
2022-02-06,Hai Phong City,Kien An District,12,6,2,4,4
2022-02-06,Hai Phong City,Kien An District,13,13,2,11,9
2022-02-06,Hai Phong City,Kien An District,14,8,2,6,6
2022-02-06,Hai Phong City,Kien An District,15,16,4,12,12
2022-02-06,Hai Phong City,Kien An District,16,12,1,11,11
2022-02-06,Hai Phong City,Kien An District,17,11,1,10,10
2022-02-06,Hai Phong City,Kien An District,18,12,0,12,11
2022-02-06,Hai Phong City,Kien An District,19,11,0,11,10
2022-02-06,Hai Phong City,Kien An District,20,10,0,10,10
2022-02-06,Hai Phong City,Kien An District,21,10,0,10,6
2022-02-06,Hai Phong City,Le Chan District,0,2,0,2,2
2022-02-06,Hai Phong City,Le Chan District,2,1,1,0,0
2022-02-06,Hai Phong City,Le Chan District,6,1,0,1,0
2022-02-06,Hai Phong City,Le Chan District,7,22,13,9,7
2022-02-06,Hai Phong City,Le Chan District,8,54,37,17,12
2022-02-06,Hai Phong City,Le Chan District,9,87,63,24,16
2022-02-06,Hai Phong City,Le Chan District,10,153,75,78,64
2022-02-06,Hai Phong City,Le Chan District,11,345,90,255,223
2022-02-06,Hai Phong City,Le Chan District,12,287,86,201,189
2022-02-06,Hai Phong City,Le Chan District,13,201,78,123,101
2022-02-06,Hai Phong City,Le Chan District,14,148,84,64,54
2022-02-06,Hai Phong City,Le Chan District,15,174,99,75,63
2022-02-06,Hai Phong City,Le Chan District,16,188,114,74,54
2022-02-06,Hai Phong City,Le Chan District,17,249,102,147,126
2022-02-06,Hai Phong City,Le Chan District,18,365,93,272,238
2022-02-06,Hai Phong City,Le Chan District,19,305,91,214,183
2022-02-06,Hai Phong City,Le Chan District,20,236,77,159,130
2022-02-06,Hai Phong City,Le Chan District,21,116,33,83,71
2022-02-06,Hai Phong City,Le Chan District,22,3,0,3,0
2022-02-06,Hai Phong City,Ngo Quyen District,7,12,6,6,3
2022-02-06,Hai Phong City,Ngo Quyen District,8,38,22,16,14
2022-02-06,Hai Phong City,Ngo Quyen District,9,60,52,8,5
2022-02-06,Hai Phong City,Ngo Quyen District,10,126,65,61,47
2022-02-06,Hai Phong City,Ngo Quyen District,11,258,73,185,160
2022-02-06,Hai Phong City,Ngo Quyen District,12,241,81,160,129
2022-02-06,Hai Phong City,Ngo Quyen District,13,163,68,95,74
2022-02-06,Hai Phong City,Ngo Quyen District,14,159,82,77,52
2022-02-06,Hai Phong City,Ngo Quyen District,15,165,98,67,59
2022-02-06,Hai Phong City,Ngo Quyen District,16,142,87,55,42
2022-02-06,Hai Phong City,Ngo Quyen District,17,247,87,160,133
2022-02-06,Hai Phong City,Ngo Quyen District,18,254,92,162,137
2022-02-06,Hai Phong City,Ngo Quyen District,19,276,80,196,172
2022-02-06,Hai Phong City,Ngo Quyen District,20,226,75,151,125
2022-02-06,Hai Phong City,Ngo Quyen District,21,107,29,78,55
2022-02-06,Hai Phong City,Thuy Nguyen,9,2,0,2,1
2022-02-06,Hai Phong City,Thuy Nguyen,10,4,0,4,4
2022-02-06,Hai Phong City,Thuy Nguyen,11,2,0,2,2
2022-02-06,Hai Phong City,Thuy Nguyen,12,3,0,3,2
2022-02-06,Hai Phong City,Thuy Nguyen,14,3,0,3,3
2022-02-06,Hai Phong City,Thuy Nguyen,15,6,0,6,6
2022-02-06,Hai Phong City,Thuy Nguyen,16,5,0,5,5
2022-02-06,Hai Phong City,Thuy Nguyen,17,2,0,2,2
2022-02-06,Hai Phong City,Thuy Nguyen,18,1,0,1,1
2022-02-06,Hai Phong City,Thuy Nguyen,19,1,0,1,1
2022-02-06,Hai Phong City,Thuy Nguyen,20,4,0,4,3
2022-02-06,Hue City,Hue City,6,13,10,3,1
2022-02-06,Hue City,Hue City,7,60,56,4,0
2022-02-06,Hue City,Hue City,8,125,115,10,2
2022-02-06,Hue City,Hue City,9,154,138,16,0
2022-02-06,Hue City,Hue City,10,140,131,9,0
2022-02-06,Hue City,Hue City,11,222,197,25,0
2022-02-06,Hue City,Hue City,12,217,198,19,0
2022-02-06,Hue City,Hue City,13,177,158,19,2
2022-02-06,Hue City,Hue City,14,200,177,23,1
2022-02-06,Hue City,Hue City,15,170,156,14,1
2022-02-06,Hue City,Hue City,16,227,195,32,14
2022-02-06,Hue City,Hue City,17,295,246,49,11
2022-02-06,Hue City,Hue City,18,313,249,64,9
2022-02-06,Hue City,Hue City,19,321,214,107,44
2022-02-06,Hue City,Hue City,20,249,179,70,33
2022-02-06,Hue City,Hue City,21,153,96,57,26
2022-02-06,Hue City,Hue City,22,3,0,3,0
2022-02-06,Hue City,Hue City,23,1,0,1,0
2022-02-06,Hue City,Huong Thuy,18,1,1,0,0
2022-02-06,Hue City,Huong Thuy,20,1,0,1,1
2022-02-06,Hue City,Huong Tra,13,1,1,0,0
2022-02-06,Hue City,Huong Tra,15,2,1,1,0
2022-02-06,Hue City,Huong Tra,16,1,1,0,0
2022-02-06,Hue City,Phu Vang,7,1,1,0,0
2022-02-06,Hue City,Phu Vang,8,1,1,0,0
2022-02-06,Hue City,Phu Vang,16,1,1,0,0
2022-02-06,Hue City,Phu Vang,18,2,2,0,0
2022-02-06,Hue City,Phu Vang,19,3,1,2,0
2022-02-06,Hue City,Phu Vang,20,2,1,1,0
2022-02-06,Hue City,Phu Vang,21,1,0,1,1
2022-02-06,Vung Tau,Ba Ria City,6,2,0,2,1
2022-02-06,Vung Tau,Ba Ria City,8,1,0,1,1
2022-02-06,Vung Tau,Ba Ria City,9,2,1,1,1
2022-02-06,Vung Tau,Ba Ria City,10,11,3,8,8
2022-02-06,Vung Tau,Ba Ria City,11,11,2,9,9
2022-02-06,Vung Tau,Ba Ria City,12,9,1,8,8
2022-02-06,Vung Tau,Ba Ria City,13,12,5,7,6
2022-02-06,Vung Tau,Ba Ria City,14,2,2,0,0
2022-02-06,Vung Tau,Ba Ria City,15,5,2,3,3
2022-02-06,Vung Tau,Ba Ria City,16,3,1,2,2
2022-02-06,Vung Tau,Ba Ria City,17,5,2,3,2
2022-02-06,Vung Tau,Ba Ria City,18,7,2,5,5
2022-02-06,Vung Tau,Ba Ria City,19,7,0,7,7
2022-02-06,Vung Tau,Ba Ria City,20,1,0,1,1
2022-02-06,Vung Tau,Ba Ria City,21,4,0,4,3
2022-02-06,Vung Tau,Vung Tau City,5,3,0,3,2
2022-02-06,Vung Tau,Vung Tau City,6,24,14,10,2
2022-02-06,Vung Tau,Vung Tau City,7,71,65,6,0
2022-02-06,Vung Tau,Vung Tau City,8,107,99,8,0
2022-02-06,Vung Tau,Vung Tau City,9,129,115,14,3
2022-02-06,Vung Tau,Vung Tau City,10,141,135,6,0
2022-02-06,Vung Tau,Vung Tau City,11,267,249,18,2
2022-02-06,Vung Tau,Vung Tau City,12,241,218,23,1
2022-02-06,Vung Tau,Vung Tau City,13,159,152,7,0
2022-02-06,Vung Tau,Vung Tau City,14,175,162,13,0
2022-02-06,Vung Tau,Vung Tau City,15,153,146,7,0
2022-02-06,Vung Tau,Vung Tau City,16,135,127,8,1
2022-02-06,Vung Tau,Vung Tau City,17,180,157,23,7
2022-02-06,Vung Tau,Vung Tau City,18,209,182,27,4
2022-02-06,Vung Tau,Vung Tau City,19,203,176,27,8
2022-02-06,Vung Tau,Vung Tau City,20,149,116,33,14
2022-02-06,Vung Tau,Vung Tau City,21,99,55,44,24
2022-02-06,Vung Tau,Vung Tau City,22,4,1,3,1
2022-02-06,Vung Tau,Vung Tau City,23,2,1,1,0
2022-02-07,Binh Duong,Ben Cat,10,2,1,1,1
2022-02-07,Binh Duong,Ben Cat,14,1,0,1,1
2022-02-07,Binh Duong,Di An,6,1,0,1,1
2022-02-07,Binh Duong,Di An,7,3,0,3,3
2022-02-07,Binh Duong,Di An,8,8,1,7,7
2022-02-07,Binh Duong,Di An,9,13,6,7,6
2022-02-07,Binh Duong,Di An,10,22,6,16,15
2022-02-07,Binh Duong,Di An,11,32,5,27,24
2022-02-07,Binh Duong,Di An,12,41,5,36,28
2022-02-07,Binh Duong,Di An,13,38,9,29,24
2022-02-07,Binh Duong,Di An,14,25,7,18,17
2022-02-07,Binh Duong,Di An,15,27,5,22,19
2022-02-07,Binh Duong,Di An,16,18,3,15,13
2022-02-07,Binh Duong,Di An,17,15,5,10,7
2022-02-07,Binh Duong,Di An,18,17,9,8,6
2022-02-07,Binh Duong,Di An,19,20,3,17,12
2022-02-07,Binh Duong,Di An,20,7,2,5,4
2022-02-07,Binh Duong,Di An,21,8,2,6,6
2022-02-07,Binh Duong,Tan Uyen,7,1,1,0,0
2022-02-07,Binh Duong,Tan Uyen,8,1,1,0,0
2022-02-07,Binh Duong,Tan Uyen,11,2,1,1,1
2022-02-07,Binh Duong,Tan Uyen,12,3,0,3,1
2022-02-07,Binh Duong,Tan Uyen,13,1,1,0,0
2022-02-07,Binh Duong,Tan Uyen,14,1,0,1,1
2022-02-07,Binh Duong,Tan Uyen,16,1,0,1,1
2022-02-07,Binh Duong,Tan Uyen,18,1,0,1,1
2022-02-07,Binh Duong,Tan Uyen,19,1,1,0,0
2022-02-07,Binh Duong,Thu Dau Mot Town,5,1,0,1,1
2022-02-07,Binh Duong,Thu Dau Mot Town,6,14,5,9,1
2022-02-07,Binh Duong,Thu Dau Mot Town,7,76,50,26,5
2022-02-07,Binh Duong,Thu Dau Mot Town,8,138,104,34,11
2022-02-07,Binh Duong,Thu Dau Mot Town,9,215,160,55,20
2022-02-07,Binh Duong,Thu Dau Mot Town,10,319,236,83,42
2022-02-07,Binh Duong,Thu Dau Mot Town,11,574,330,244,185
2022-02-07,Binh Duong,Thu Dau Mot Town,12,501,311,190,129
2022-02-07,Binh Duong,Thu Dau Mot Town,13,354,243,111,78
2022-02-07,Binh Duong,Thu Dau Mot Town,14,254,199,55,37
2022-02-07,Binh Duong,Thu Dau Mot Town,15,210,177,33,13
2022-02-07,Binh Duong,Thu Dau Mot Town,16,187,148,39,18
2022-02-07,Binh Duong,Thu Dau Mot Town,17,262,214,48,20
2022-02-07,Binh Duong,Thu Dau Mot Town,18,351,223,128,82
2022-02-07,Binh Duong,Thu Dau Mot Town,19,290,174,116,85
2022-02-07,Binh Duong,Thu Dau Mot Town,20,212,142,70,40
2022-02-07,Binh Duong,Thu Dau Mot Town,21,87,51,36,17
2022-02-07,Binh Duong,Thuan An,4,1,0,1,1
2022-02-07,Binh Duong,Thuan An,7,5,0,5,3
2022-02-07,Binh Duong,Thuan An,8,17,1,16,13
2022-02-07,Binh Duong,Thuan An,9,33,7,26,22
2022-02-07,Binh Duong,Thuan An,10,79,23,56,47
2022-02-07,Binh Duong,Thuan An,11,107,34,73,54
2022-02-07,Binh Duong,Thuan An,12,92,22,70,55
2022-02-07,Binh Duong,Thuan An,13,98,25,73,61
2022-02-07,Binh Duong,Thuan An,14,49,14,35,29
2022-02-07,Binh Duong,Thuan An,15,38,16,22,15
2022-02-07,Binh Duong,Thuan An,16,26,6,20,13
2022-02-07,Binh Duong,Thuan An,17,28,7,21,17
2022-02-07,Binh Duong,Thuan An,18,43,9,34,28
2022-02-07,Binh Duong,Thuan An,19,62,3,59,55
2022-02-07,Binh Duong,Thuan An,20,54,5,49,45
2022-02-07,Binh Duong,Thuan An,21,19,0,19,18
2022-02-07,Can Tho City,Binh Thuy District,6,1,1,0,0
2022-02-07,Can Tho City,Binh Thuy District,7,1,1,0,0
2022-02-07,Can Tho City,Binh Thuy District,8,4,3,1,0
2022-02-07,Can Tho City,Binh Thuy District,9,5,4,1,0
2022-02-07,Can Tho City,Binh Thuy District,10,6,4,2,0
2022-02-07,Can Tho City,Binh Thuy District,11,9,7,2,1
2022-02-07,Can Tho City,Binh Thuy District,12,8,6,2,0
2022-02-07,Can Tho City,Binh Thuy District,13,7,7,0,0
2022-02-07,Can Tho City,Binh Thuy District,14,8,8,0,0
2022-02-07,Can Tho City,Binh Thuy District,15,11,8,3,0
2022-02-07,Can Tho City,Binh Thuy District,16,10,8,2,0
2022-02-07,Can Tho City,Binh Thuy District,17,6,5,1,0
2022-02-07,Can Tho City,Binh Thuy District,18,9,9,0,0
2022-02-07,Can Tho City,Binh Thuy District,19,11,10,1,1
2022-02-07,Can Tho City,Binh Thuy District,20,9,8,1,0
2022-02-07,Can Tho City,Binh Thuy District,21,2,1,1,0
2022-02-07,Can Tho City,Cai Rang District,1,1,0,1,0
2022-02-07,Can Tho City,Cai Rang District,7,2,0,2,0
2022-02-07,Can Tho City,Cai Rang District,8,4,4,0,0
2022-02-07,Can Tho City,Cai Rang District,9,2,2,0,0
2022-02-07,Can Tho City,Cai Rang District,10,4,4,0,0
2022-02-07,Can Tho City,Cai Rang District,11,12,11,1,0
2022-02-07,Can Tho City,Cai Rang District,12,4,3,1,0
2022-02-07,Can Tho City,Cai Rang District,13,11,9,2,1
2022-02-07,Can Tho City,Cai Rang District,14,7,6,1,0
2022-02-07,Can Tho City,Cai Rang District,15,6,6,0,0
2022-02-07,Can Tho City,Cai Rang District,16,10,8,2,0
2022-02-07,Can Tho City,Cai Rang District,17,8,7,1,1
2022-02-07,Can Tho City,Cai Rang District,18,4,4,0,0
2022-02-07,Can Tho City,Cai Rang District,19,7,7,0,0
2022-02-07,Can Tho City,Cai Rang District,20,5,4,1,1
2022-02-07,Can Tho City,Cai Rang District,21,4,3,1,0
2022-02-07,Can Tho City,Cai Rang District,22,1,1,0,0
2022-02-07,Can Tho City,Ninh Kieu District,1,1,0,1,0
2022-02-07,Can Tho City,Ninh Kieu District,3,1,1,0,0
2022-02-07,Can Tho City,Ninh Kieu District,4,1,1,0,0
2022-02-07,Can Tho City,Ninh Kieu District,5,1,0,1,0
2022-02-07,Can Tho City,Ninh Kieu District,6,21,18,3,0
2022-02-07,Can Tho City,Ninh Kieu District,7,90,78,12,0
2022-02-07,Can Tho City,Ninh Kieu District,8,154,127,27,0
2022-02-07,Can Tho City,Ninh Kieu District,9,179,150,29,1
2022-02-07,Can Tho City,Ninh Kieu District,10,290,252,38,1
2022-02-07,Can Tho City,Ninh Kieu District,11,492,448,44,5
2022-02-07,Can Tho City,Ninh Kieu District,12,333,297,36,3
2022-02-07,Can Tho City,Ninh Kieu District,13,299,272,27,4
2022-02-07,Can Tho City,Ninh Kieu District,14,283,250,33,1
2022-02-07,Can Tho City,Ninh Kieu District,15,233,206,27,1
2022-02-07,Can Tho City,Ninh Kieu District,16,235,213,22,1
2022-02-07,Can Tho City,Ninh Kieu District,17,261,243,18,0
2022-02-07,Can Tho City,Ninh Kieu District,18,318,283,35,0
2022-02-07,Can Tho City,Ninh Kieu District,19,322,277,45,1
2022-02-07,Can Tho City,Ninh Kieu District,20,233,202,31,0
2022-02-07,Can Tho City,Ninh Kieu District,21,130,110,20,0
2022-02-07,Can Tho City,Ninh Kieu District,22,8,3,5,0
2022-02-07,Can Tho City,Ninh Kieu District,23,4,3,1,0
2022-02-07,Dong Nai,Bien Hoa City,0,2,0,2,0
2022-02-07,Dong Nai,Bien Hoa City,2,1,0,1,0
2022-02-07,Dong Nai,Bien Hoa City,3,1,0,1,0
2022-02-07,Dong Nai,Bien Hoa City,6,43,16,27,19
2022-02-07,Dong Nai,Bien Hoa City,7,129,71,58,33
2022-02-07,Dong Nai,Bien Hoa City,8,299,163,136,64
2022-02-07,Dong Nai,Bien Hoa City,9,400,277,123,64
2022-02-07,Dong Nai,Bien Hoa City,10,693,434,259,165
2022-02-07,Dong Nai,Bien Hoa City,11,1205,588,617,495
2022-02-07,Dong Nai,Bien Hoa City,12,1003,579,424,312
2022-02-07,Dong Nai,Bien Hoa City,13,776,499,277,172
2022-02-07,Dong Nai,Bien Hoa City,14,566,416,150,81
2022-02-07,Dong Nai,Bien Hoa City,15,426,328,98,45
2022-02-07,Dong Nai,Bien Hoa City,16,400,303,97,43
2022-02-07,Dong Nai,Bien Hoa City,17,482,347,135,60
2022-02-07,Dong Nai,Bien Hoa City,18,571,393,178,122
2022-02-07,Dong Nai,Bien Hoa City,19,577,360,217,138
2022-02-07,Dong Nai,Bien Hoa City,20,478,252,226,159
2022-02-07,Dong Nai,Bien Hoa City,21,215,96,119,98
2022-02-07,Dong Nai,Bien Hoa City,22,4,1,3,2
2022-02-07,Dong Nai,Bien Hoa City,23,1,1,0,0
2022-02-07,Dong Nai,Long Khanh,13,1,0,1,1
2022-02-07,Dong Nai,Long Khanh,14,1,0,1,1
2022-02-07,Dong Nai,Long Thanh,9,1,0,1,1
2022-02-07,Dong Nai,Long Thanh,10,2,0,2,1
2022-02-07,Dong Nai,Long Thanh,11,4,0,4,4
2022-02-07,Dong Nai,Long Thanh,12,1,0,1,1
2022-02-07,Dong Nai,Long Thanh,13,1,0,1,1
2022-02-07,Dong Nai,Long Thanh,14,1,0,1,1
2022-02-07,Dong Nai,Long Thanh,16,1,0,1,1
2022-02-07,Dong Nai,Long Thanh,17,1,0,1,1
2022-02-07,Dong Nai,Long Thanh,18,1,0,1,1
2022-02-07,Dong Nai,Long Thanh,19,1,0,1,1
2022-02-07,Dong Nai,Long Thanh,20,1,0,1,1
2022-02-07,Dong Nai,Thong Nhat,8,2,1,1,1
2022-02-07,Dong Nai,Thong Nhat,9,2,2,0,0
2022-02-07,Dong Nai,Thong Nhat,10,3,3,0,0
2022-02-07,Dong Nai,Thong Nhat,11,1,1,0,0
2022-02-07,Dong Nai,Thong Nhat,12,5,2,3,3
2022-02-07,Dong Nai,Thong Nhat,13,1,1,0,0
2022-02-07,Dong Nai,Thong Nhat,14,3,3,0,0
2022-02-07,Dong Nai,Thong Nhat,15,1,1,0,0
2022-02-07,Dong Nai,Thong Nhat,18,1,1,0,0
2022-02-07,Dong Nai,Thong Nhat,20,2,1,1,1
2022-02-07,Dong Nai,Thong Nhat,21,2,2,0,0
2022-02-07,Dong Nai,Trang Bom,12,3,0,3,3
2022-02-07,Dong Nai,Trang Bom,13,2,0,2,2
2022-02-07,Dong Nai,Trang Bom,14,2,2,0,0
2022-02-07,Dong Nai,Trang Bom,19,1,0,1,1
2022-02-07,Hai Phong City,An Duong,8,1,0,1,1
2022-02-07,Hai Phong City,An Duong,9,2,0,2,2
2022-02-07,Hai Phong City,An Duong,10,7,3,4,2
2022-02-07,Hai Phong City,An Duong,11,2,1,1,1
2022-02-07,Hai Phong City,An Duong,12,11,1,10,10
2022-02-07,Hai Phong City,An Duong,13,4,0,4,4
2022-02-07,Hai Phong City,An Duong,14,10,0,10,9
2022-02-07,Hai Phong City,An Duong,15,11,1,10,9
2022-02-07,Hai Phong City,An Duong,16,4,1,3,3
2022-02-07,Hai Phong City,An Duong,17,4,1,3,1
2022-02-07,Hai Phong City,An Duong,18,3,0,3,3
2022-02-07,Hai Phong City,An Duong,19,5,1,4,3
2022-02-07,Hai Phong City,An Duong,20,5,0,5,5
2022-02-07,Hai Phong City,An Duong,21,1,0,1,1
2022-02-07,Hai Phong City,Duong Kinh District,15,1,0,1,1
2022-02-07,Hai Phong City,Duong Kinh District,16,1,0,1,1
2022-02-07,Hai Phong City,Duong Kinh District,17,4,0,4,3
2022-02-07,Hai Phong City,Duong Kinh District,18,3,0,3,2
2022-02-07,Hai Phong City,Hai An District,7,6,3,3,3
2022-02-07,Hai Phong City,Hai An District,8,25,11,14,9
2022-02-07,Hai Phong City,Hai An District,9,17,7,10,5
2022-02-07,Hai Phong City,Hai An District,10,26,16,10,1
2022-02-07,Hai Phong City,Hai An District,11,34,23,11,9
2022-02-07,Hai Phong City,Hai An District,12,26,18,8,4
2022-02-07,Hai Phong City,Hai An District,13,10,7,3,1
2022-02-07,Hai Phong City,Hai An District,14,13,6,7,6
2022-02-07,Hai Phong City,Hai An District,15,21,13,8,4
2022-02-07,Hai Phong City,Hai An District,16,18,9,9,2
2022-02-07,Hai Phong City,Hai An District,17,25,18,7,5
2022-02-07,Hai Phong City,Hai An District,18,25,16,9,6
2022-02-07,Hai Phong City,Hai An District,19,33,14,19,13
2022-02-07,Hai Phong City,Hai An District,20,18,6,12,11
2022-02-07,Hai Phong City,Hai An District,21,18,3,15,13
2022-02-07,Hai Phong City,Hai An District,22,1,0,1,1
2022-02-07,Hai Phong City,Hong Bang District,6,1,0,1,1
2022-02-07,Hai Phong City,Hong Bang District,7,11,7,4,3
2022-02-07,Hai Phong City,Hong Bang District,8,30,22,8,3
2022-02-07,Hai Phong City,Hong Bang District,9,30,20,10,6
2022-02-07,Hai Phong City,Hong Bang District,10,53,30,23,16
2022-02-07,Hai Phong City,Hong Bang District,11,89,47,42,28
2022-02-07,Hai Phong City,Hong Bang District,12,61,36,25,15
2022-02-07,Hai Phong City,Hong Bang District,13,28,23,5,4
2022-02-07,Hai Phong City,Hong Bang District,14,33,20,13,8
2022-02-07,Hai Phong City,Hong Bang District,15,38,27,11,8
2022-02-07,Hai Phong City,Hong Bang District,16,39,24,15,5
2022-02-07,Hai Phong City,Hong Bang District,17,48,31,17,5
2022-02-07,Hai Phong City,Hong Bang District,18,61,36,25,19
2022-02-07,Hai Phong City,Hong Bang District,19,66,29,37,28
2022-02-07,Hai Phong City,Hong Bang District,20,52,13,39,35
2022-02-07,Hai Phong City,Hong Bang District,21,15,2,13,12
2022-02-07,Hai Phong City,Hong Bang District,22,1,0,1,0
2022-02-07,Hai Phong City,Kien An District,2,1,0,1,1
2022-02-07,Hai Phong City,Kien An District,7,2,0,2,2
2022-02-07,Hai Phong City,Kien An District,8,7,0,7,5
2022-02-07,Hai Phong City,Kien An District,9,2,0,2,2
2022-02-07,Hai Phong City,Kien An District,10,10,4,6,6
2022-02-07,Hai Phong City,Kien An District,11,14,4,10,8
2022-02-07,Hai Phong City,Kien An District,12,16,4,12,11
2022-02-07,Hai Phong City,Kien An District,13,12,6,6,6
2022-02-07,Hai Phong City,Kien An District,14,8,2,6,4
2022-02-07,Hai Phong City,Kien An District,15,5,3,2,2
2022-02-07,Hai Phong City,Kien An District,16,4,4,0,0
2022-02-07,Hai Phong City,Kien An District,17,7,1,6,6
2022-02-07,Hai Phong City,Kien An District,18,12,3,9,8
2022-02-07,Hai Phong City,Kien An District,19,17,4,13,13
2022-02-07,Hai Phong City,Kien An District,20,13,1,12,10
2022-02-07,Hai Phong City,Kien An District,21,3,0,3,3
2022-02-07,Hai Phong City,Kien An District,22,1,0,1,1
2022-02-07,Hai Phong City,Le Chan District,0,2,1,1,0
2022-02-07,Hai Phong City,Le Chan District,1,1,1,0,0
2022-02-07,Hai Phong City,Le Chan District,6,3,1,2,0
2022-02-07,Hai Phong City,Le Chan District,7,23,15,8,4
2022-02-07,Hai Phong City,Le Chan District,8,59,38,21,12
2022-02-07,Hai Phong City,Le Chan District,9,87,55,32,14
2022-02-07,Hai Phong City,Le Chan District,10,172,97,75,52
2022-02-07,Hai Phong City,Le Chan District,11,267,162,105,77
2022-02-07,Hai Phong City,Le Chan District,12,219,116,103,61
2022-02-07,Hai Phong City,Le Chan District,13,136,90,46,30
2022-02-07,Hai Phong City,Le Chan District,14,133,88,45,29
2022-02-07,Hai Phong City,Le Chan District,15,148,101,47,28
2022-02-07,Hai Phong City,Le Chan District,16,162,114,48,17
2022-02-07,Hai Phong City,Le Chan District,17,161,112,49,21
2022-02-07,Hai Phong City,Le Chan District,18,236,134,102,68
2022-02-07,Hai Phong City,Le Chan District,19,243,118,125,91
2022-02-07,Hai Phong City,Le Chan District,20,194,66,128,98
2022-02-07,Hai Phong City,Le Chan District,21,129,29,100,76
2022-02-07,Hai Phong City,Le Chan District,22,1,1,0,0
2022-02-07,Hai Phong City,Le Chan District,23,1,0,1,0
2022-02-07,Hai Phong City,Ngo Quyen District,2,1,0,1,0
2022-02-07,Hai Phong City,Ngo Quyen District,6,1,0,1,1
2022-02-07,Hai Phong City,Ngo Quyen District,7,17,9,8,3
2022-02-07,Hai Phong City,Ngo Quyen District,8,77,40,37,13
2022-02-07,Hai Phong City,Ngo Quyen District,9,68,57,11,2
2022-02-07,Hai Phong City,Ngo Quyen District,10,128,90,38,16
2022-02-07,Hai Phong City,Ngo Quyen District,11,223,145,78,43
2022-02-07,Hai Phong City,Ngo Quyen District,12,177,113,64,32
2022-02-07,Hai Phong City,Ngo Quyen District,13,105,81,24,13
2022-02-07,Hai Phong City,Ngo Quyen District,14,113,82,31,17
2022-02-07,Hai Phong City,Ngo Quyen District,15,160,102,58,35
2022-02-07,Hai Phong City,Ngo Quyen District,16,124,91,33,16
2022-02-07,Hai Phong City,Ngo Quyen District,17,176,134,42,9
2022-02-07,Hai Phong City,Ngo Quyen District,18,199,113,86,60
2022-02-07,Hai Phong City,Ngo Quyen District,19,189,90,99,71
2022-02-07,Hai Phong City,Ngo Quyen District,20,212,75,137,109
2022-02-07,Hai Phong City,Ngo Quyen District,21,110,27,83,67
2022-02-07,Hai Phong City,Ngo Quyen District,22,1,0,1,0
2022-02-07,Hai Phong City,Thuy Nguyen,10,2,0,2,2
2022-02-07,Hai Phong City,Thuy Nguyen,13,2,0,2,2
2022-02-07,Hai Phong City,Thuy Nguyen,14,2,0,2,0
2022-02-07,Hai Phong City,Thuy Nguyen,15,2,0,2,2
2022-02-07,Hai Phong City,Thuy Nguyen,16,5,0,5,4
2022-02-07,Hai Phong City,Thuy Nguyen,17,4,0,4,3
2022-02-07,Hai Phong City,Thuy Nguyen,18,1,0,1,0
2022-02-07,Hai Phong City,Thuy Nguyen,19,5,0,5,3
2022-02-07,Hai Phong City,Thuy Nguyen,20,1,0,1,1
2022-02-07,Hue City,Hue City,0,3,3,0,0
2022-02-07,Hue City,Hue City,1,1,1,0,0
2022-02-07,Hue City,Hue City,4,1,1,0,0
2022-02-07,Hue City,Hue City,5,1,0,1,0
2022-02-07,Hue City,Hue City,6,39,11,28,25
2022-02-07,Hue City,Hue City,7,105,87,18,2
2022-02-07,Hue City,Hue City,8,177,149,28,4
2022-02-07,Hue City,Hue City,9,198,163,35,1
2022-02-07,Hue City,Hue City,10,196,162,34,3
2022-02-07,Hue City,Hue City,11,449,369,80,25
2022-02-07,Hue City,Hue City,12,304,253,51,8
2022-02-07,Hue City,Hue City,13,171,150,21,0
2022-02-07,Hue City,Hue City,14,228,185,43,6
2022-02-07,Hue City,Hue City,15,256,214,42,5
2022-02-07,Hue City,Hue City,16,274,230,44,7
2022-02-07,Hue City,Hue City,17,384,279,105,31
2022-02-07,Hue City,Hue City,18,461,328,133,43
2022-02-07,Hue City,Hue City,19,390,270,120,43
2022-02-07,Hue City,Hue City,20,353,208,145,71
2022-02-07,Hue City,Hue City,21,199,103,96,46
2022-02-07,Hue City,Hue City,22,5,2,3,1
2022-02-07,Hue City,Huong Thuy,11,4,1,3,3
2022-02-07,Hue City,Huong Thuy,12,2,0,2,0
2022-02-07,Hue City,Huong Thuy,15,1,1,0,0
2022-02-07,Hue City,Huong Thuy,16,1,0,1,0
2022-02-07,Hue City,Huong Thuy,17,2,1,1,0
2022-02-07,Hue City,Huong Thuy,19,1,1,0,0
2022-02-07,Hue City,Huong Thuy,20,3,0,3,2
2022-02-07,Hue City,Huong Thuy,21,1,0,1,1
2022-02-07,Hue City,Huong Tra,11,1,0,1,1
2022-02-07,Hue City,Huong Tra,15,1,1,0,0
2022-02-07,Hue City,Huong Tra,19,1,0,1,1
2022-02-07,Hue City,Huong Tra,20,2,0,2,2
2022-02-07,Hue City,Phu Vang,8,2,1,1,1
2022-02-07,Hue City,Phu Vang,11,6,5,1,0
2022-02-07,Hue City,Phu Vang,12,5,1,4,0
2022-02-07,Hue City,Phu Vang,13,3,1,2,0
2022-02-07,Hue City,Phu Vang,14,1,1,0,0
2022-02-07,Hue City,Phu Vang,15,2,2,0,0
2022-02-07,Hue City,Phu Vang,16,1,0,1,1
2022-02-07,Hue City,Phu Vang,17,9,4,5,4
2022-02-07,Hue City,Phu Vang,18,4,0,4,3
2022-02-07,Hue City,Phu Vang,19,5,0,5,2
2022-02-07,Hue City,Phu Vang,20,2,0,2,2
2022-02-07,Vung Tau,Ba Ria City,7,1,0,1,1
2022-02-07,Vung Tau,Ba Ria City,8,3,0,3,2
2022-02-07,Vung Tau,Ba Ria City,9,11,2,9,3
2022-02-07,Vung Tau,Ba Ria City,10,9,3,6,5
2022-02-07,Vung Tau,Ba Ria City,11,20,3,17,17
2022-02-07,Vung Tau,Ba Ria City,12,11,3,8,8
2022-02-07,Vung Tau,Ba Ria City,13,12,5,7,7
2022-02-07,Vung Tau,Ba Ria City,14,18,3,15,14
2022-02-07,Vung Tau,Ba Ria City,15,12,6,6,3
2022-02-07,Vung Tau,Ba Ria City,16,4,0,4,4
2022-02-07,Vung Tau,Ba Ria City,17,8,0,8,5
2022-02-07,Vung Tau,Ba Ria City,18,12,0,12,11
2022-02-07,Vung Tau,Ba Ria City,19,11,0,11,11
2022-02-07,Vung Tau,Ba Ria City,20,8,0,8,8
2022-02-07,Vung Tau,Ba Ria City,21,3,0,3,3
2022-02-07,Vung Tau,Tan Thanh,12,2,0,2,2
2022-02-07,Vung Tau,Tan Thanh,13,2,0,2,2
2022-02-07,Vung Tau,Tan Thanh,14,1,0,1,1
2022-02-07,Vung Tau,Tan Thanh,17,1,0,1,0
2022-02-07,Vung Tau,Tan Thanh,20,1,0,1,1
2022-02-07,Vung Tau,Vung Tau City,1,1,0,1,0
2022-02-07,Vung Tau,Vung Tau City,2,1,1,0,0
2022-02-07,Vung Tau,Vung Tau City,5,4,2,2,1
2022-02-07,Vung Tau,Vung Tau City,6,29,21,8,4
2022-02-07,Vung Tau,Vung Tau City,7,93,78,15,2
2022-02-07,Vung Tau,Vung Tau City,8,134,122,12,5
2022-02-07,Vung Tau,Vung Tau City,9,148,123,25,7
2022-02-07,Vung Tau,Vung Tau City,10,167,143,24,6
2022-02-07,Vung Tau,Vung Tau City,11,330,282,48,21
2022-02-07,Vung Tau,Vung Tau City,12,258,216,42,14
2022-02-07,Vung Tau,Vung Tau City,13,244,221,23,7
2022-02-07,Vung Tau,Vung Tau City,14,209,190,19,3
2022-02-07,Vung Tau,Vung Tau City,15,199,175,24,6
2022-02-07,Vung Tau,Vung Tau City,16,149,137,12,3
2022-02-07,Vung Tau,Vung Tau City,17,219,193,26,2
2022-02-07,Vung Tau,Vung Tau City,18,269,223,46,15
2022-02-07,Vung Tau,Vung Tau City,19,200,170,30,6
2022-02-07,Vung Tau,Vung Tau City,20,180,135,45,28
2022-02-07,Vung Tau,Vung Tau City,21,102,56,46,24
2022-02-07,Vung Tau,Vung Tau City,22,4,2,2,0
2022-02-08,Binh Duong,Ben Cat,15,1,0,1,1
2022-02-08,Binh Duong,Ben Cat,19,2,1,1,1
2022-02-08,Binh Duong,Ben Cat,20,1,1,0,0
2022-02-08,Binh Duong,Di An,7,5,1,4,3
2022-02-08,Binh Duong,Di An,8,14,5,9,6
2022-02-08,Binh Duong,Di An,9,13,4,9,8
2022-02-08,Binh Duong,Di An,10,18,11,7,5
2022-02-08,Binh Duong,Di An,11,28,9,19,17
2022-02-08,Binh Duong,Di An,12,36,8,28,24
2022-02-08,Binh Duong,Di An,13,43,8,35,31
2022-02-08,Binh Duong,Di An,14,21,8,13,13
2022-02-08,Binh Duong,Di An,15,20,7,13,12
2022-02-08,Binh Duong,Di An,16,16,9,7,6
2022-02-08,Binh Duong,Di An,17,20,8,12,8
2022-02-08,Binh Duong,Di An,18,22,5,17,10
2022-02-08,Binh Duong,Di An,19,27,8,19,18
2022-02-08,Binh Duong,Di An,20,12,4,8,6
2022-02-08,Binh Duong,Di An,21,8,1,7,6
2022-02-08,Binh Duong,Di An,22,2,0,2,1
2022-02-08,Binh Duong,Phu Giao,7,1,0,1,0
2022-02-08,Binh Duong,Tan Uyen,7,1,0,1,1
2022-02-08,Binh Duong,Tan Uyen,9,2,0,2,2
2022-02-08,Binh Duong,Tan Uyen,10,2,0,2,2
2022-02-08,Binh Duong,Tan Uyen,11,2,1,1,0
2022-02-08,Binh Duong,Tan Uyen,12,1,0,1,1
2022-02-08,Binh Duong,Tan Uyen,13,3,2,1,1
2022-02-08,Binh Duong,Tan Uyen,15,1,0,1,1
2022-02-08,Binh Duong,Tan Uyen,17,1,0,1,1
2022-02-08,Binh Duong,Tan Uyen,18,1,0,1,1
2022-02-08,Binh Duong,Tan Uyen,19,5,0,5,5
2022-02-08,Binh Duong,Tan Uyen,20,1,0,1,1
2022-02-08,Binh Duong,Thu Dau Mot Town,0,2,0,2,0
2022-02-08,Binh Duong,Thu Dau Mot Town,5,2,0,2,0
2022-02-08,Binh Duong,Thu Dau Mot Town,6,23,9,14,12
2022-02-08,Binh Duong,Thu Dau Mot Town,7,95,71,24,8
2022-02-08,Binh Duong,Thu Dau Mot Town,8,154,127,27,8
2022-02-08,Binh Duong,Thu Dau Mot Town,9,211,176,35,9
2022-02-08,Binh Duong,Thu Dau Mot Town,10,367,312,55,27
2022-02-08,Binh Duong,Thu Dau Mot Town,11,648,433,215,161
2022-02-08,Binh Duong,Thu Dau Mot Town,12,420,348,72,45
2022-02-08,Binh Duong,Thu Dau Mot Town,13,384,305,79,45
2022-02-08,Binh Duong,Thu Dau Mot Town,14,262,227,35,17
2022-02-08,Binh Duong,Thu Dau Mot Town,15,209,170,39,23
2022-02-08,Binh Duong,Thu Dau Mot Town,16,271,216,55,18
2022-02-08,Binh Duong,Thu Dau Mot Town,17,345,239,106,72
2022-02-08,Binh Duong,Thu Dau Mot Town,18,474,238,236,200
2022-02-08,Binh Duong,Thu Dau Mot Town,19,422,203,219,168
2022-02-08,Binh Duong,Thu Dau Mot Town,20,279,150,129,105
2022-02-08,Binh Duong,Thu Dau Mot Town,21,112,69,43,24
2022-02-08,Binh Duong,Thu Dau Mot Town,22,3,2,1,0
2022-02-08,Binh Duong,Thu Dau Mot Town,23,1,0,1,0
2022-02-08,Binh Duong,Thuan An,6,1,0,1,1
2022-02-08,Binh Duong,Thuan An,7,7,0,7,4
2022-02-08,Binh Duong,Thuan An,8,9,2,7,6
2022-02-08,Binh Duong,Thuan An,9,38,7,31,23
2022-02-08,Binh Duong,Thuan An,10,93,23,70,61
2022-02-08,Binh Duong,Thuan An,11,102,42,60,50
2022-02-08,Binh Duong,Thuan An,12,71,28,43,34
2022-02-08,Binh Duong,Thuan An,13,65,30,35,31
2022-02-08,Binh Duong,Thuan An,14,60,19,41,34
2022-02-08,Binh Duong,Thuan An,15,33,13,20,18
2022-02-08,Binh Duong,Thuan An,16,40,17,23,18
2022-02-08,Binh Duong,Thuan An,17,59,17,42,35
2022-02-08,Binh Duong,Thuan An,18,44,17,27,20
2022-02-08,Binh Duong,Thuan An,19,40,14,26,23
2022-02-08,Binh Duong,Thuan An,20,43,6,37,31
2022-02-08,Binh Duong,Thuan An,21,20,1,19,16
2022-02-08,Can Tho City,Binh Thuy District,8,2,2,0,0
2022-02-08,Can Tho City,Binh Thuy District,9,5,4,1,0
2022-02-08,Can Tho City,Binh Thuy District,10,10,7,3,0
2022-02-08,Can Tho City,Binh Thuy District,11,11,8,3,0
2022-02-08,Can Tho City,Binh Thuy District,12,10,10,0,0
2022-02-08,Can Tho City,Binh Thuy District,13,10,10,0,0
2022-02-08,Can Tho City,Binh Thuy District,14,14,13,1,1
2022-02-08,Can Tho City,Binh Thuy District,15,18,15,3,1
2022-02-08,Can Tho City,Binh Thuy District,16,8,6,2,0
2022-02-08,Can Tho City,Binh Thuy District,17,4,4,0,0
2022-02-08,Can Tho City,Binh Thuy District,18,7,4,3,0
2022-02-08,Can Tho City,Binh Thuy District,19,13,12,1,0
2022-02-08,Can Tho City,Binh Thuy District,20,10,8,2,0
2022-02-08,Can Tho City,Binh Thuy District,21,3,2,1,0
2022-02-08,Can Tho City,Cai Rang District,7,2,1,1,1
2022-02-08,Can Tho City,Cai Rang District,8,2,2,0,0
2022-02-08,Can Tho City,Cai Rang District,9,3,3,0,0
2022-02-08,Can Tho City,Cai Rang District,10,10,10,0,0
2022-02-08,Can Tho City,Cai Rang District,11,14,13,1,0
2022-02-08,Can Tho City,Cai Rang District,12,5,4,1,0
2022-02-08,Can Tho City,Cai Rang District,13,5,3,2,1
2022-02-08,Can Tho City,Cai Rang District,14,11,9,2,2
2022-02-08,Can Tho City,Cai Rang District,15,9,8,1,1
2022-02-08,Can Tho City,Cai Rang District,16,3,2,1,0
2022-02-08,Can Tho City,Cai Rang District,17,12,10,2,0
2022-02-08,Can Tho City,Cai Rang District,18,14,10,4,1
2022-02-08,Can Tho City,Cai Rang District,19,3,2,1,0
2022-02-08,Can Tho City,Cai Rang District,20,3,3,0,0
2022-02-08,Can Tho City,Cai Rang District,21,2,1,1,0
2022-02-08,Can Tho City,Ninh Kieu District,0,3,3,0,0
2022-02-08,Can Tho City,Ninh Kieu District,1,2,1,1,0
2022-02-08,Can Tho City,Ninh Kieu District,4,1,1,0,0
2022-02-08,Can Tho City,Ninh Kieu District,5,2,1,1,0
2022-02-08,Can Tho City,Ninh Kieu District,6,30,28,2,0
2022-02-08,Can Tho City,Ninh Kieu District,7,89,75,14,0
2022-02-08,Can Tho City,Ninh Kieu District,8,160,141,19,0
2022-02-08,Can Tho City,Ninh Kieu District,9,256,241,15,0
2022-02-08,Can Tho City,Ninh Kieu District,10,397,369,28,0
2022-02-08,Can Tho City,Ninh Kieu District,11,545,513,32,1
2022-02-08,Can Tho City,Ninh Kieu District,12,378,355,23,0
2022-02-08,Can Tho City,Ninh Kieu District,13,331,311,20,7
2022-02-08,Can Tho City,Ninh Kieu District,14,296,271,25,2
2022-02-08,Can Tho City,Ninh Kieu District,15,260,241,19,1
2022-02-08,Can Tho City,Ninh Kieu District,16,260,242,18,0
2022-02-08,Can Tho City,Ninh Kieu District,17,337,311,26,0
2022-02-08,Can Tho City,Ninh Kieu District,18,404,374,30,0
2022-02-08,Can Tho City,Ninh Kieu District,19,307,275,32,0
2022-02-08,Can Tho City,Ninh Kieu District,20,239,214,25,0
2022-02-08,Can Tho City,Ninh Kieu District,21,114,99,15,1
2022-02-08,Can Tho City,Ninh Kieu District,22,5,3,2,0
2022-02-08,Can Tho City,Ninh Kieu District,23,6,3,3,0
2022-02-08,Dong Nai,Bien Hoa City,0,2,0,2,0
2022-02-08,Dong Nai,Bien Hoa City,2,3,1,2,0
2022-02-08,Dong Nai,Bien Hoa City,3,1,0,1,0
2022-02-08,Dong Nai,Bien Hoa City,5,1,0,1,1
2022-02-08,Dong Nai,Bien Hoa City,6,31,14,17,12
2022-02-08,Dong Nai,Bien Hoa City,7,132,84,48,29
2022-02-08,Dong Nai,Bien Hoa City,8,311,221,90,44
2022-02-08,Dong Nai,Bien Hoa City,9,413,334,79,35
2022-02-08,Dong Nai,Bien Hoa City,10,758,545,213,135
2022-02-08,Dong Nai,Bien Hoa City,11,1012,798,214,117
2022-02-08,Dong Nai,Bien Hoa City,12,828,640,188,104
2022-02-08,Dong Nai,Bien Hoa City,13,732,567,165,94
2022-02-08,Dong Nai,Bien Hoa City,14,644,510,134,69
2022-02-08,Dong Nai,Bien Hoa City,15,435,354,81,41
2022-02-08,Dong Nai,Bien Hoa City,16,428,357,71,29
2022-02-08,Dong Nai,Bien Hoa City,17,564,421,143,88
2022-02-08,Dong Nai,Bien Hoa City,18,587,455,132,75
2022-02-08,Dong Nai,Bien Hoa City,19,562,404,158,101
2022-02-08,Dong Nai,Bien Hoa City,20,547,256,291,234
2022-02-08,Dong Nai,Bien Hoa City,21,268,88,180,145
2022-02-08,Dong Nai,Bien Hoa City,22,5,2,3,0
2022-02-08,Dong Nai,Bien Hoa City,23,2,1,1,1
2022-02-08,Dong Nai,Cam My,12,1,0,1,1
2022-02-08,Dong Nai,Long Thanh,9,1,0,1,1
2022-02-08,Dong Nai,Long Thanh,10,3,0,3,3
2022-02-08,Dong Nai,Long Thanh,12,2,0,2,2
2022-02-08,Dong Nai,Long Thanh,13,3,0,3,3
2022-02-08,Dong Nai,Long Thanh,14,2,0,2,2
2022-02-08,Dong Nai,Long Thanh,15,4,0,4,4
2022-02-08,Dong Nai,Long Thanh,20,1,0,1,0
2022-02-08,Dong Nai,Long Thanh,21,3,0,3,3
2022-02-08,Dong Nai,Thong Nhat,7,1,1,0,0
2022-02-08,Dong Nai,Thong Nhat,8,1,1,0,0
2022-02-08,Dong Nai,Thong Nhat,9,2,1,1,0
2022-02-08,Dong Nai,Thong Nhat,11,2,2,0,0
2022-02-08,Dong Nai,Thong Nhat,12,1,1,0,0
2022-02-08,Dong Nai,Thong Nhat,13,4,3,1,1
2022-02-08,Dong Nai,Thong Nhat,14,5,4,1,1
2022-02-08,Dong Nai,Thong Nhat,16,1,0,1,0
2022-02-08,Dong Nai,Thong Nhat,17,1,0,1,0
2022-02-08,Dong Nai,Thong Nhat,18,4,2,2,1
2022-02-08,Dong Nai,Thong Nhat,20,1,0,1,1
2022-02-08,Dong Nai,Thong Nhat,21,1,0,1,1
2022-02-08,Dong Nai,Trang Bom,11,3,0,3,3
2022-02-08,Dong Nai,Trang Bom,12,4,0,4,3
2022-02-08,Dong Nai,Trang Bom,13,6,0,6,5
2022-02-08,Dong Nai,Trang Bom,14,3,0,3,1
2022-02-08,Dong Nai,Trang Bom,15,1,0,1,1
2022-02-08,Dong Nai,Trang Bom,20,2,0,2,2
2022-02-08,Hai Phong City,An Duong,7,1,0,1,1
2022-02-08,Hai Phong City,An Duong,8,5,1,4,4
2022-02-08,Hai Phong City,An Duong,9,4,0,4,4
2022-02-08,Hai Phong City,An Duong,10,11,3,8,8
2022-02-08,Hai Phong City,An Duong,11,3,0,3,2
2022-02-08,Hai Phong City,An Duong,12,4,0,4,4
2022-02-08,Hai Phong City,An Duong,13,2,0,2,2
2022-02-08,Hai Phong City,An Duong,14,1,0,1,1
2022-02-08,Hai Phong City,An Duong,15,5,1,4,4
2022-02-08,Hai Phong City,An Duong,16,4,0,4,2
2022-02-08,Hai Phong City,An Duong,17,8,2,6,4
2022-02-08,Hai Phong City,An Duong,18,7,1,6,6
2022-02-08,Hai Phong City,An Duong,19,1,1,0,0
2022-02-08,Hai Phong City,An Duong,20,1,0,1,1
2022-02-08,Hai Phong City,An Duong,21,2,1,1,0
2022-02-08,Hai Phong City,Do Son District,21,1,0,1,1
2022-02-08,Hai Phong City,Duong Kinh District,12,2,0,2,2
2022-02-08,Hai Phong City,Hai An District,7,10,6,4,2
2022-02-08,Hai Phong City,Hai An District,8,22,15,7,5
2022-02-08,Hai Phong City,Hai An District,9,15,9,6,1
2022-02-08,Hai Phong City,Hai An District,10,29,18,11,4
2022-02-08,Hai Phong City,Hai An District,11,45,29,16,10
2022-02-08,Hai Phong City,Hai An District,12,26,15,11,5
2022-02-08,Hai Phong City,Hai An District,13,14,13,1,0
2022-02-08,Hai Phong City,Hai An District,14,17,8,9,7
2022-02-08,Hai Phong City,Hai An District,15,15,9,6,5
2022-02-08,Hai Phong City,Hai An District,16,30,22,8,6
2022-02-08,Hai Phong City,Hai An District,17,30,19,11,9
2022-02-08,Hai Phong City,Hai An District,18,31,21,10,9
2022-02-08,Hai Phong City,Hai An District,19,41,19,22,12
2022-02-08,Hai Phong City,Hai An District,20,26,12,14,10
2022-02-08,Hai Phong City,Hai An District,21,21,11,10,10
2022-02-08,Hai Phong City,Hai An District,22,1,0,1,0
2022-02-08,Hai Phong City,Hong Bang District,1,2,0,2,1
2022-02-08,Hai Phong City,Hong Bang District,2,1,0,1,1
2022-02-08,Hai Phong City,Hong Bang District,6,2,1,1,0
2022-02-08,Hai Phong City,Hong Bang District,7,22,8,14,12
2022-02-08,Hai Phong City,Hong Bang District,8,45,29,16,9
2022-02-08,Hai Phong City,Hong Bang District,9,31,26,5,3
2022-02-08,Hai Phong City,Hong Bang District,10,65,39,26,19
2022-02-08,Hai Phong City,Hong Bang District,11,132,67,65,48
2022-02-08,Hai Phong City,Hong Bang District,12,95,56,39,24
2022-02-08,Hai Phong City,Hong Bang District,13,52,38,14,9
2022-02-08,Hai Phong City,Hong Bang District,14,51,26,25,20
2022-02-08,Hai Phong City,Hong Bang District,15,62,33,29,24
2022-02-08,Hai Phong City,Hong Bang District,16,74,31,43,36
2022-02-08,Hai Phong City,Hong Bang District,17,55,22,33,24
2022-02-08,Hai Phong City,Hong Bang District,18,94,47,47,34
2022-02-08,Hai Phong City,Hong Bang District,19,57,33,24,19
2022-02-08,Hai Phong City,Hong Bang District,20,51,30,21,14
2022-02-08,Hai Phong City,Hong Bang District,21,22,15,7,5
2022-02-08,Hai Phong City,Hong Bang District,22,2,1,1,1
2022-02-08,Hai Phong City,Hong Bang District,23,1,0,1,0
2022-02-08,Hai Phong City,Kien An District,7,1,0,1,1
2022-02-08,Hai Phong City,Kien An District,8,7,1,6,5
2022-02-08,Hai Phong City,Kien An District,9,4,1,3,2
2022-02-08,Hai Phong City,Kien An District,10,3,2,1,1
2022-02-08,Hai Phong City,Kien An District,11,13,1,12,11
2022-02-08,Hai Phong City,Kien An District,12,13,6,7,5
2022-02-08,Hai Phong City,Kien An District,13,5,1,4,4
2022-02-08,Hai Phong City,Kien An District,14,15,4,11,10
2022-02-08,Hai Phong City,Kien An District,15,9,4,5,2
2022-02-08,Hai Phong City,Kien An District,16,8,3,5,5
2022-02-08,Hai Phong City,Kien An District,17,17,0,17,15
2022-02-08,Hai Phong City,Kien An District,18,18,1,17,15
2022-02-08,Hai Phong City,Kien An District,19,16,2,14,12
2022-02-08,Hai Phong City,Kien An District,20,13,2,11,8
2022-02-08,Hai Phong City,Kien An District,21,4,0,4,3
2022-02-08,Hai Phong City,Le Chan District,0,1,0,1,0
2022-02-08,Hai Phong City,Le Chan District,1,2,1,1,0
2022-02-08,Hai Phong City,Le Chan District,2,2,1,1,0
2022-02-08,Hai Phong City,Le Chan District,3,2,1,1,1
2022-02-08,Hai Phong City,Le Chan District,5,1,1,0,0
2022-02-08,Hai Phong City,Le Chan District,6,1,1,0,0
2022-02-08,Hai Phong City,Le Chan District,7,53,23,30,17
2022-02-08,Hai Phong City,Le Chan District,8,81,61,20,5
2022-02-08,Hai Phong City,Le Chan District,9,68,55,13,7
2022-02-08,Hai Phong City,Le Chan District,10,174,129,45,20
2022-02-08,Hai Phong City,Le Chan District,11,416,248,168,120
2022-02-08,Hai Phong City,Le Chan District,12,270,141,129,98
2022-02-08,Hai Phong City,Le Chan District,13,150,83,67,46
2022-02-08,Hai Phong City,Le Chan District,14,172,101,71,43
2022-02-08,Hai Phong City,Le Chan District,15,201,117,84,67
2022-02-08,Hai Phong City,Le Chan District,16,274,153,121,84
2022-02-08,Hai Phong City,Le Chan District,17,318,152,166,127
2022-02-08,Hai Phong City,Le Chan District,18,423,183,240,186
2022-02-08,Hai Phong City,Le Chan District,19,242,136,106,69
2022-02-08,Hai Phong City,Le Chan District,20,208,114,94,67
2022-02-08,Hai Phong City,Le Chan District,21,106,44,62,40
2022-02-08,Hai Phong City,Le Chan District,22,2,1,1,1
2022-02-08,Hai Phong City,Le Chan District,23,2,1,1,0
2022-02-08,Hai Phong City,Ngo Quyen District,0,2,0,2,0
2022-02-08,Hai Phong City,Ngo Quyen District,1,2,0,2,0
2022-02-08,Hai Phong City,Ngo Quyen District,6,1,1,0,0
2022-02-08,Hai Phong City,Ngo Quyen District,7,30,11,19,13
2022-02-08,Hai Phong City,Ngo Quyen District,8,87,63,24,10
2022-02-08,Hai Phong City,Ngo Quyen District,9,91,72,19,3
2022-02-08,Hai Phong City,Ngo Quyen District,10,154,116,38,14
2022-02-08,Hai Phong City,Ngo Quyen District,11,280,178,102,77
2022-02-08,Hai Phong City,Ngo Quyen District,12,207,142,65,39
2022-02-08,Hai Phong City,Ngo Quyen District,13,134,97,37,22
2022-02-08,Hai Phong City,Ngo Quyen District,14,150,105,45,27
2022-02-08,Hai Phong City,Ngo Quyen District,15,180,123,57,39
2022-02-08,Hai Phong City,Ngo Quyen District,16,202,130,72,55
2022-02-08,Hai Phong City,Ngo Quyen District,17,217,123,94,67
2022-02-08,Hai Phong City,Ngo Quyen District,18,298,146,152,128
2022-02-08,Hai Phong City,Ngo Quyen District,19,232,137,95,64
2022-02-08,Hai Phong City,Ngo Quyen District,20,170,99,71,48
2022-02-08,Hai Phong City,Ngo Quyen District,21,84,41,43,32
2022-02-08,Hai Phong City,Ngo Quyen District,22,2,1,1,0
2022-02-08,Hai Phong City,Thuy Nguyen,13,2,0,2,2
2022-02-08,Hai Phong City,Thuy Nguyen,14,1,0,1,1
2022-02-08,Hai Phong City,Thuy Nguyen,15,2,0,2,2
2022-02-08,Hai Phong City,Thuy Nguyen,17,2,0,2,2
2022-02-08,Hai Phong City,Thuy Nguyen,18,5,0,5,5
2022-02-08,Hai Phong City,Thuy Nguyen,19,4,0,4,4
2022-02-08,Hai Phong City,Thuy Nguyen,20,4,0,4,4
2022-02-08,Hue City,Hue City,0,2,1,1,0
2022-02-08,Hue City,Hue City,1,1,0,1,0
2022-02-08,Hue City,Hue City,4,1,1,0,0
2022-02-08,Hue City,Hue City,6,41,18,23,12
2022-02-08,Hue City,Hue City,7,142,120,22,2
2022-02-08,Hue City,Hue City,8,256,221,35,3
2022-02-08,Hue City,Hue City,9,224,197,27,2
2022-02-08,Hue City,Hue City,10,256,224,32,2
2022-02-08,Hue City,Hue City,11,527,480,47,7
2022-02-08,Hue City,Hue City,12,347,309,38,3
2022-02-08,Hue City,Hue City,13,255,234,21,3
2022-02-08,Hue City,Hue City,14,305,260,45,18
2022-02-08,Hue City,Hue City,15,303,267,36,5
2022-02-08,Hue City,Hue City,16,342,297,45,8
2022-02-08,Hue City,Hue City,17,419,381,38,3
2022-02-08,Hue City,Hue City,18,488,418,70,11
2022-02-08,Hue City,Hue City,19,493,375,118,39
2022-02-08,Hue City,Hue City,20,450,329,121,52
2022-02-08,Hue City,Hue City,21,212,150,62,21
2022-02-08,Hue City,Hue City,22,5,1,4,0
2022-02-08,Hue City,Huong Thuy,10,1,1,0,0
2022-02-08,Hue City,Huong Thuy,11,2,0,2,0
2022-02-08,Hue City,Huong Thuy,12,2,0,2,1
2022-02-08,Hue City,Huong Thuy,14,1,1,0,0
2022-02-08,Hue City,Huong Thuy,15,1,0,1,0
2022-02-08,Hue City,Huong Thuy,17,1,0,1,1
2022-02-08,Hue City,Huong Thuy,18,3,1,2,0
2022-02-08,Hue City,Huong Thuy,19,1,1,0,0
2022-02-08,Hue City,Huong Thuy,20,2,0,2,1
2022-02-08,Hue City,Huong Thuy,21,1,1,0,0
2022-02-08,Hue City,Huong Tra,17,1,1,0,0
2022-02-08,Hue City,Huong Tra,19,1,1,0,0
2022-02-08,Hue City,Huong Tra,21,1,1,0,0
2022-02-08,Hue City,Phu Vang,8,3,1,2,0
2022-02-08,Hue City,Phu Vang,10,1,0,1,0
2022-02-08,Hue City,Phu Vang,11,1,0,1,1
2022-02-08,Hue City,Phu Vang,16,2,2,0,0
2022-02-08,Hue City,Phu Vang,17,2,1,1,1
2022-02-08,Hue City,Phu Vang,18,4,1,3,1
2022-02-08,Hue City,Phu Vang,19,1,1,0,0
2022-02-08,Hue City,Phu Vang,20,1,0,1,0
2022-02-08,Vung Tau,Ba Ria City,8,3,0,3,3
2022-02-08,Vung Tau,Ba Ria City,9,8,2,6,5
2022-02-08,Vung Tau,Ba Ria City,10,7,3,4,4
2022-02-08,Vung Tau,Ba Ria City,11,9,6,3,3
2022-02-08,Vung Tau,Ba Ria City,12,13,4,9,9
2022-02-08,Vung Tau,Ba Ria City,13,11,3,8,6
2022-02-08,Vung Tau,Ba Ria City,14,8,0,8,5
2022-02-08,Vung Tau,Ba Ria City,15,4,2,2,1
2022-02-08,Vung Tau,Ba Ria City,16,7,5,2,1
2022-02-08,Vung Tau,Ba Ria City,17,10,2,8,5
2022-02-08,Vung Tau,Ba Ria City,18,9,1,8,7
2022-02-08,Vung Tau,Ba Ria City,19,6,0,6,6
2022-02-08,Vung Tau,Ba Ria City,20,3,0,3,3
2022-02-08,Vung Tau,Ba Ria City,21,3,0,3,3
2022-02-08,Vung Tau,Tan Thanh,11,2,0,2,2
2022-02-08,Vung Tau,Tan Thanh,12,1,0,1,1
2022-02-08,Vung Tau,Vung Tau City,0,1,0,1,0
2022-02-08,Vung Tau,Vung Tau City,1,1,0,1,0
2022-02-08,Vung Tau,Vung Tau City,6,30,24,6,3
2022-02-08,Vung Tau,Vung Tau City,7,104,97,7,1
2022-02-08,Vung Tau,Vung Tau City,8,168,147,21,4
2022-02-08,Vung Tau,Vung Tau City,9,161,147,14,0
2022-02-08,Vung Tau,Vung Tau City,10,171,153,18,3
2022-02-08,Vung Tau,Vung Tau City,11,337,305,32,8
2022-02-08,Vung Tau,Vung Tau City,12,248,222,26,4
2022-02-08,Vung Tau,Vung Tau City,13,247,225,22,4
2022-02-08,Vung Tau,Vung Tau City,14,263,218,45,18
2022-02-08,Vung Tau,Vung Tau City,15,239,199,40,16
2022-02-08,Vung Tau,Vung Tau City,16,202,180,22,2
2022-02-08,Vung Tau,Vung Tau City,17,213,186,27,3
2022-02-08,Vung Tau,Vung Tau City,18,268,232,36,9
2022-02-08,Vung Tau,Vung Tau City,19,234,199,35,8
2022-02-08,Vung Tau,Vung Tau City,20,180,152,28,7
2022-02-08,Vung Tau,Vung Tau City,21,94,64,30,13
2022-02-08,Vung Tau,Vung Tau City,22,1,1,0,0
2022-02-09,Binh Duong,Ben Cat,20,1,0,1,1
2022-02-09,Binh Duong,Di An,6,1,0,1,1
2022-02-09,Binh Duong,Di An,7,2,0,2,2
2022-02-09,Binh Duong,Di An,8,9,4,5,4
2022-02-09,Binh Duong,Di An,9,10,7,3,2
2022-02-09,Binh Duong,Di An,10,21,8,13,9
2022-02-09,Binh Duong,Di An,11,27,8,19,17
2022-02-09,Binh Duong,Di An,12,37,8,29,25
2022-02-09,Binh Duong,Di An,13,26,10,16,15
2022-02-09,Binh Duong,Di An,14,29,10,19,16
2022-02-09,Binh Duong,Di An,15,26,3,23,21
2022-02-09,Binh Duong,Di An,16,12,3,9,7
2022-02-09,Binh Duong,Di An,17,9,3,6,6
2022-02-09,Binh Duong,Di An,18,15,8,7,6
2022-02-09,Binh Duong,Di An,19,8,4,4,3
2022-02-09,Binh Duong,Di An,20,12,4,8,5
2022-02-09,Binh Duong,Di An,21,6,0,6,3
2022-02-09,Binh Duong,Tan Uyen,9,1,0,1,1
2022-02-09,Binh Duong,Tan Uyen,10,2,0,2,2
2022-02-09,Binh Duong,Tan Uyen,11,3,0,3,3
2022-02-09,Binh Duong,Tan Uyen,12,3,1,2,2
2022-02-09,Binh Duong,Tan Uyen,13,2,1,1,1
2022-02-09,Binh Duong,Tan Uyen,14,2,1,1,1
2022-02-09,Binh Duong,Tan Uyen,15,3,0,3,2
2022-02-09,Binh Duong,Tan Uyen,22,1,0,1,1
2022-02-09,Binh Duong,Thu Dau Mot Town,0,2,1,1,0
2022-02-09,Binh Duong,Thu Dau Mot Town,1,4,2,2,0
2022-02-09,Binh Duong,Thu Dau Mot Town,2,3,2,1,0
2022-02-09,Binh Duong,Thu Dau Mot Town,5,1,0,1,1
2022-02-09,Binh Duong,Thu Dau Mot Town,6,20,14,6,3
2022-02-09,Binh Duong,Thu Dau Mot Town,7,102,80,22,4
2022-02-09,Binh Duong,Thu Dau Mot Town,8,184,140,44,13
2022-02-09,Binh Duong,Thu Dau Mot Town,9,205,181,24,14
2022-02-09,Binh Duong,Thu Dau Mot Town,10,296,253,43,9
2022-02-09,Binh Duong,Thu Dau Mot Town,11,501,413,88,54
2022-02-09,Binh Duong,Thu Dau Mot Town,12,425,340,85,45
2022-02-09,Binh Duong,Thu Dau Mot Town,13,360,297,63,40
2022-02-09,Binh Duong,Thu Dau Mot Town,14,324,258,66,42
2022-02-09,Binh Duong,Thu Dau Mot Town,15,205,175,30,13
2022-02-09,Binh Duong,Thu Dau Mot Town,16,210,174,36,15
2022-02-09,Binh Duong,Thu Dau Mot Town,17,273,235,38,23
2022-02-09,Binh Duong,Thu Dau Mot Town,18,328,270,58,25
2022-02-09,Binh Duong,Thu Dau Mot Town,19,287,236,51,29
2022-02-09,Binh Duong,Thu Dau Mot Town,20,185,137,48,20
2022-02-09,Binh Duong,Thu Dau Mot Town,21,81,68,13,8
2022-02-09,Binh Duong,Thu Dau Mot Town,22,3,0,3,0
2022-02-09,Binh Duong,Thu Dau Mot Town,23,2,2,0,0
2022-02-09,Binh Duong,Thuan An,6,1,0,1,1
2022-02-09,Binh Duong,Thuan An,7,4,0,4,3
2022-02-09,Binh Duong,Thuan An,8,25,0,25,24
2022-02-09,Binh Duong,Thuan An,9,42,10,32,25
2022-02-09,Binh Duong,Thuan An,10,76,27,49,37
2022-02-09,Binh Duong,Thuan An,11,97,36,61,47
2022-02-09,Binh Duong,Thuan An,12,73,25,48,39
2022-02-09,Binh Duong,Thuan An,13,82,17,65,55
2022-02-09,Binh Duong,Thuan An,14,52,24,28,23
2022-02-09,Binh Duong,Thuan An,15,24,15,9,6
2022-02-09,Binh Duong,Thuan An,16,28,12,16,12
2022-02-09,Binh Duong,Thuan An,17,28,14,14,12
2022-02-09,Binh Duong,Thuan An,18,50,24,26,19
2022-02-09,Binh Duong,Thuan An,19,35,13,22,17
2022-02-09,Binh Duong,Thuan An,20,21,11,10,9
2022-02-09,Binh Duong,Thuan An,21,12,0,12,10
2022-02-09,Can Tho City,Binh Thuy District,6,1,1,0,0
2022-02-09,Can Tho City,Binh Thuy District,7,1,1,0,0
2022-02-09,Can Tho City,Binh Thuy District,8,2,2,0,0
2022-02-09,Can Tho City,Binh Thuy District,9,2,1,1,0
2022-02-09,Can Tho City,Binh Thuy District,10,13,11,2,0
2022-02-09,Can Tho City,Binh Thuy District,11,13,9,4,2
2022-02-09,Can Tho City,Binh Thuy District,12,5,5,0,0
2022-02-09,Can Tho City,Binh Thuy District,13,13,10,3,0
2022-02-09,Can Tho City,Binh Thuy District,14,11,10,1,0
2022-02-09,Can Tho City,Binh Thuy District,15,11,8,3,2
2022-02-09,Can Tho City,Binh Thuy District,16,6,5,1,0
2022-02-09,Can Tho City,Binh Thuy District,17,2,2,0,0
2022-02-09,Can Tho City,Binh Thuy District,18,7,5,2,0
2022-02-09,Can Tho City,Binh Thuy District,19,8,8,0,0
2022-02-09,Can Tho City,Binh Thuy District,20,7,6,1,0
2022-02-09,Can Tho City,Binh Thuy District,21,5,1,4,1
2022-02-09,Can Tho City,Cai Rang District,0,1,0,1,0
2022-02-09,Can Tho City,Cai Rang District,6,6,4,2,1
2022-02-09,Can Tho City,Cai Rang District,7,2,2,0,0
2022-02-09,Can Tho City,Cai Rang District,9,5,3,2,0
2022-02-09,Can Tho City,Cai Rang District,10,8,7,1,0
2022-02-09,Can Tho City,Cai Rang District,11,11,8,3,1
2022-02-09,Can Tho City,Cai Rang District,12,6,5,1,0
2022-02-09,Can Tho City,Cai Rang District,13,9,7,2,2
2022-02-09,Can Tho City,Cai Rang District,14,8,7,1,0
2022-02-09,Can Tho City,Cai Rang District,15,14,14,0,0
2022-02-09,Can Tho City,Cai Rang District,16,6,5,1,1
2022-02-09,Can Tho City,Cai Rang District,17,12,10,2,0
2022-02-09,Can Tho City,Cai Rang District,18,9,6,3,1
2022-02-09,Can Tho City,Cai Rang District,19,7,7,0,0
2022-02-09,Can Tho City,Cai Rang District,20,8,7,1,0
2022-02-09,Can Tho City,Cai Rang District,21,2,1,1,1
2022-02-09,Can Tho City,Ninh Kieu District,1,1,1,0,0
2022-02-09,Can Tho City,Ninh Kieu District,3,1,1,0,0
2022-02-09,Can Tho City,Ninh Kieu District,4,1,1,0,0
2022-02-09,Can Tho City,Ninh Kieu District,6,29,27,2,0
2022-02-09,Can Tho City,Ninh Kieu District,7,97,80,17,0
2022-02-09,Can Tho City,Ninh Kieu District,8,157,148,9,0
2022-02-09,Can Tho City,Ninh Kieu District,9,245,228,17,0
2022-02-09,Can Tho City,Ninh Kieu District,10,359,344,15,0
2022-02-09,Can Tho City,Ninh Kieu District,11,612,572,40,7
2022-02-09,Can Tho City,Ninh Kieu District,12,365,356,9,0
2022-02-09,Can Tho City,Ninh Kieu District,13,300,284,16,0
2022-02-09,Can Tho City,Ninh Kieu District,14,292,281,11,0
2022-02-09,Can Tho City,Ninh Kieu District,15,271,258,13,0
2022-02-09,Can Tho City,Ninh Kieu District,16,290,267,23,0
2022-02-09,Can Tho City,Ninh Kieu District,17,350,335,15,1
2022-02-09,Can Tho City,Ninh Kieu District,18,412,388,24,0
2022-02-09,Can Tho City,Ninh Kieu District,19,320,301,19,1
2022-02-09,Can Tho City,Ninh Kieu District,20,234,216,18,0
2022-02-09,Can Tho City,Ninh Kieu District,21,127,114,13,0
2022-02-09,Can Tho City,Ninh Kieu District,22,6,5,1,0
2022-02-09,Can Tho City,Ninh Kieu District,23,5,3,2,0
2022-02-09,Dong Nai,Bien Hoa City,1,2,0,2,1
2022-02-09,Dong Nai,Bien Hoa City,2,1,0,1,0
2022-02-09,Dong Nai,Bien Hoa City,4,1,0,1,0
2022-02-09,Dong Nai,Bien Hoa City,5,1,0,1,0
2022-02-09,Dong Nai,Bien Hoa City,6,50,25,25,19
2022-02-09,Dong Nai,Bien Hoa City,7,159,114,45,22
2022-02-09,Dong Nai,Bien Hoa City,8,329,239,90,45
2022-02-09,Dong Nai,Bien Hoa City,9,374,309,65,15
2022-02-09,Dong Nai,Bien Hoa City,10,753,591,162,81
2022-02-09,Dong Nai,Bien Hoa City,11,1070,806,264,173
2022-02-09,Dong Nai,Bien Hoa City,12,725,617,108,47
2022-02-09,Dong Nai,Bien Hoa City,13,745,622,123,58
2022-02-09,Dong Nai,Bien Hoa City,14,645,505,140,95
2022-02-09,Dong Nai,Bien Hoa City,15,498,417,81,38
2022-02-09,Dong Nai,Bien Hoa City,16,458,389,69,24
2022-02-09,Dong Nai,Bien Hoa City,17,438,398,40,15
2022-02-09,Dong Nai,Bien Hoa City,18,589,507,82,32
2022-02-09,Dong Nai,Bien Hoa City,19,550,438,112,46
2022-02-09,Dong Nai,Bien Hoa City,20,445,315,130,71
2022-02-09,Dong Nai,Bien Hoa City,21,202,111,91,60
2022-02-09,Dong Nai,Bien Hoa City,22,8,2,6,0
2022-02-09,Dong Nai,Bien Hoa City,23,4,1,3,1
2022-02-09,Dong Nai,Cam My,13,1,0,1,1
2022-02-09,Dong Nai,Cam My,14,1,0,1,1
2022-02-09,Dong Nai,Cam My,15,1,0,1,1
2022-02-09,Dong Nai,Cam My,19,1,0,1,1
2022-02-09,Dong Nai,Cam My,20,1,0,1,1
2022-02-09,Dong Nai,Long Thanh,9,1,0,1,1
2022-02-09,Dong Nai,Long Thanh,11,1,0,1,1
2022-02-09,Dong Nai,Long Thanh,13,1,0,1,1
2022-02-09,Dong Nai,Long Thanh,14,1,0,1,1
2022-02-09,Dong Nai,Long Thanh,17,1,0,1,1
2022-02-09,Dong Nai,Long Thanh,21,1,0,1,1
2022-02-09,Dong Nai,Thong Nhat,8,2,2,0,0
2022-02-09,Dong Nai,Thong Nhat,9,1,1,0,0
2022-02-09,Dong Nai,Thong Nhat,13,2,1,1,0
2022-02-09,Dong Nai,Thong Nhat,14,2,1,1,1
2022-02-09,Dong Nai,Thong Nhat,15,2,1,1,1
2022-02-09,Dong Nai,Thong Nhat,17,1,1,0,0
2022-02-09,Dong Nai,Thong Nhat,20,1,1,0,0
2022-02-09,Dong Nai,Thong Nhat,21,2,2,0,0
2022-02-09,Dong Nai,Trang Bom,8,1,0,1,1
2022-02-09,Dong Nai,Trang Bom,11,1,0,1,1
2022-02-09,Dong Nai,Trang Bom,18,1,0,1,1
2022-02-09,Dong Nai,Trang Bom,19,1,1,0,0
2022-02-09,Dong Nai,Trang Bom,20,1,0,1,1
2022-02-09,Dong Nai,Trang Bom,21,2,1,1,1
2022-02-09,Dong Nai,Vinh Cuu,11,1,1,0,0
2022-02-09,Hai Phong City,An Duong,7,5,0,5,3
2022-02-09,Hai Phong City,An Duong,8,2,0,2,2
2022-02-09,Hai Phong City,An Duong,9,8,0,8,7
2022-02-09,Hai Phong City,An Duong,10,2,1,1,0
2022-02-09,Hai Phong City,An Duong,11,3,0,3,3
2022-02-09,Hai Phong City,An Duong,12,4,0,4,3
2022-02-09,Hai Phong City,An Duong,13,3,0,3,3
2022-02-09,Hai Phong City,An Duong,14,3,0,3,2
2022-02-09,Hai Phong City,An Duong,15,5,1,4,2
2022-02-09,Hai Phong City,An Duong,16,11,3,8,2
2022-02-09,Hai Phong City,An Duong,17,3,0,3,2
2022-02-09,Hai Phong City,An Duong,18,1,0,1,1
2022-02-09,Hai Phong City,An Duong,20,1,0,1,1
2022-02-09,Hai Phong City,An Duong,21,2,1,1,0
2022-02-09,Hai Phong City,Duong Kinh District,18,1,0,1,1
2022-02-09,Hai Phong City,Hai An District,6,1,0,1,0
2022-02-09,Hai Phong City,Hai An District,7,5,5,0,0
2022-02-09,Hai Phong City,Hai An District,8,17,7,10,10
2022-02-09,Hai Phong City,Hai An District,9,12,8,4,0
2022-02-09,Hai Phong City,Hai An District,10,22,17,5,1
2022-02-09,Hai Phong City,Hai An District,11,48,19,29,22
2022-02-09,Hai Phong City,Hai An District,12,26,18,8,5
2022-02-09,Hai Phong City,Hai An District,13,13,9,4,3
2022-02-09,Hai Phong City,Hai An District,14,18,9,9,4
2022-02-09,Hai Phong City,Hai An District,15,27,24,3,1
2022-02-09,Hai Phong City,Hai An District,16,26,22,4,0
2022-02-09,Hai Phong City,Hai An District,17,32,21,11,6
2022-02-09,Hai Phong City,Hai An District,18,34,29,5,3
2022-02-09,Hai Phong City,Hai An District,19,27,19,8,3
2022-02-09,Hai Phong City,Hai An District,20,24,16,8,5
2022-02-09,Hai Phong City,Hai An District,21,9,6,3,3
2022-02-09,Hai Phong City,Hai An District,23,1,0,1,0
2022-02-09,Hai Phong City,Hong Bang District,4,1,0,1,1
2022-02-09,Hai Phong City,Hong Bang District,5,1,1,0,0
2022-02-09,Hai Phong City,Hong Bang District,6,2,1,1,0
2022-02-09,Hai Phong City,Hong Bang District,7,10,8,2,2
2022-02-09,Hai Phong City,Hong Bang District,8,39,26,13,8
2022-02-09,Hai Phong City,Hong Bang District,9,38,23,15,9
2022-02-09,Hai Phong City,Hong Bang District,10,56,44,12,5
2022-02-09,Hai Phong City,Hong Bang District,11,118,64,54,42
2022-02-09,Hai Phong City,Hong Bang District,12,65,50,15,6
2022-02-09,Hai Phong City,Hong Bang District,13,40,32,8,3
2022-02-09,Hai Phong City,Hong Bang District,14,52,32,20,11
2022-02-09,Hai Phong City,Hong Bang District,15,58,39,19,9
2022-02-09,Hai Phong City,Hong Bang District,16,45,24,21,17
2022-02-09,Hai Phong City,Hong Bang District,17,75,47,28,19
2022-02-09,Hai Phong City,Hong Bang District,18,62,41,21,19
2022-02-09,Hai Phong City,Hong Bang District,19,63,47,16,5
2022-02-09,Hai Phong City,Hong Bang District,20,35,28,7,4
2022-02-09,Hai Phong City,Hong Bang District,21,20,7,13,9
2022-02-09,Hai Phong City,Kien An District,7,1,0,1,1
2022-02-09,Hai Phong City,Kien An District,8,4,2,2,0
2022-02-09,Hai Phong City,Kien An District,9,9,2,7,7
2022-02-09,Hai Phong City,Kien An District,10,12,2,10,7
2022-02-09,Hai Phong City,Kien An District,11,27,7,20,17
2022-02-09,Hai Phong City,Kien An District,12,13,1,12,11
2022-02-09,Hai Phong City,Kien An District,13,13,2,11,8
2022-02-09,Hai Phong City,Kien An District,14,7,2,5,5
2022-02-09,Hai Phong City,Kien An District,15,17,4,13,7
2022-02-09,Hai Phong City,Kien An District,16,12,4,8,8
2022-02-09,Hai Phong City,Kien An District,17,7,2,5,3
2022-02-09,Hai Phong City,Kien An District,18,9,3,6,5
2022-02-09,Hai Phong City,Kien An District,19,10,3,7,7
2022-02-09,Hai Phong City,Kien An District,20,8,1,7,6
2022-02-09,Hai Phong City,Kien An District,21,4,0,4,4
2022-02-09,Hai Phong City,Kien An District,22,3,0,3,1
2022-02-09,Hai Phong City,Le Chan District,0,5,0,5,1
2022-02-09,Hai Phong City,Le Chan District,1,3,3,0,0
2022-02-09,Hai Phong City,Le Chan District,4,2,0,2,1
2022-02-09,Hai Phong City,Le Chan District,5,2,1,1,1
2022-02-09,Hai Phong City,Le Chan District,6,1,0,1,0
2022-02-09,Hai Phong City,Le Chan District,7,35,25,10,6
2022-02-09,Hai Phong City,Le Chan District,8,98,66,32,24
2022-02-09,Hai Phong City,Le Chan District,9,83,60,23,13
2022-02-09,Hai Phong City,Le Chan District,10,193,155,38,17
2022-02-09,Hai Phong City,Le Chan District,11,356,231,125,89
2022-02-09,Hai Phong City,Le Chan District,12,240,161,79,45
2022-02-09,Hai Phong City,Le Chan District,13,147,113,34,20
2022-02-09,Hai Phong City,Le Chan District,14,190,122,68,35
2022-02-09,Hai Phong City,Le Chan District,15,243,150,93,69
2022-02-09,Hai Phong City,Le Chan District,16,239,160,79,50
2022-02-09,Hai Phong City,Le Chan District,17,235,170,65,37
2022-02-09,Hai Phong City,Le Chan District,18,276,189,87,47
2022-02-09,Hai Phong City,Le Chan District,19,227,175,52,30
2022-02-09,Hai Phong City,Le Chan District,20,189,114,75,48
2022-02-09,Hai Phong City,Le Chan District,21,85,42,43,22
2022-02-09,Hai Phong City,Le Chan District,22,1,0,1,0
2022-02-09,Hai Phong City,Ngo Quyen District,1,1,1,0,0
2022-02-09,Hai Phong City,Ngo Quyen District,3,1,1,0,0
2022-02-09,Hai Phong City,Ngo Quyen District,7,25,12,13,4
2022-02-09,Hai Phong City,Ngo Quyen District,8,75,53,22,12
2022-02-09,Hai Phong City,Ngo Quyen District,9,71,55,16,10
2022-02-09,Hai Phong City,Ngo Quyen District,10,96,78,18,6
2022-02-09,Hai Phong City,Ngo Quyen District,11,236,147,89,59
2022-02-09,Hai Phong City,Ngo Quyen District,12,150,109,41,22
2022-02-09,Hai Phong City,Ngo Quyen District,13,124,91,33,16
2022-02-09,Hai Phong City,Ngo Quyen District,14,133,93,40,20
2022-02-09,Hai Phong City,Ngo Quyen District,15,170,113,57,39
2022-02-09,Hai Phong City,Ngo Quyen District,16,158,113,45,21
2022-02-09,Hai Phong City,Ngo Quyen District,17,192,134,58,32
2022-02-09,Hai Phong City,Ngo Quyen District,18,194,140,54,29
2022-02-09,Hai Phong City,Ngo Quyen District,19,167,124,43,27
2022-02-09,Hai Phong City,Ngo Quyen District,20,117,87,30,14
2022-02-09,Hai Phong City,Ngo Quyen District,21,94,38,56,40
2022-02-09,Hai Phong City,Ngo Quyen District,22,3,1,2,0
2022-02-09,Hai Phong City,Thuy Nguyen,8,2,0,2,2
2022-02-09,Hai Phong City,Thuy Nguyen,10,1,0,1,0
2022-02-09,Hai Phong City,Thuy Nguyen,13,4,0,4,3
2022-02-09,Hai Phong City,Thuy Nguyen,14,2,0,2,2
2022-02-09,Hai Phong City,Thuy Nguyen,15,2,0,2,2
2022-02-09,Hai Phong City,Thuy Nguyen,16,1,0,1,1
2022-02-09,Hai Phong City,Thuy Nguyen,17,2,0,2,2
2022-02-09,Hai Phong City,Thuy Nguyen,19,2,0,2,2
2022-02-09,Hue City,Hue City,0,5,4,1,1
2022-02-09,Hue City,Hue City,5,1,1,0,0
2022-02-09,Hue City,Hue City,6,23,18,5,2
2022-02-09,Hue City,Hue City,7,155,134,21,5
2022-02-09,Hue City,Hue City,8,241,219,22,3
2022-02-09,Hue City,Hue City,9,220,198,22,0
2022-02-09,Hue City,Hue City,10,247,227,20,0
2022-02-09,Hue City,Hue City,11,509,472,37,4
2022-02-09,Hue City,Hue City,12,323,292,31,5
2022-02-09,Hue City,Hue City,13,234,211,23,1
2022-02-09,Hue City,Hue City,14,298,265,33,5
2022-02-09,Hue City,Hue City,15,354,312,42,2
2022-02-09,Hue City,Hue City,16,356,319,37,0
2022-02-09,Hue City,Hue City,17,424,370,54,5
2022-02-09,Hue City,Hue City,18,561,476,85,30
2022-02-09,Hue City,Hue City,19,502,391,111,62
2022-02-09,Hue City,Hue City,20,371,270,101,52
2022-02-09,Hue City,Hue City,21,160,125,35,22
2022-02-09,Hue City,Hue City,23,2,1,1,0
2022-02-09,Hue City,Huong Thuy,10,1,0,1,0
2022-02-09,Hue City,Huong Thuy,15,3,2,1,0
2022-02-09,Hue City,Huong Thuy,16,2,0,2,0
2022-02-09,Hue City,Huong Thuy,17,1,1,0,0
2022-02-09,Hue City,Huong Thuy,20,1,0,1,1
2022-02-09,Hue City,Huong Thuy,21,1,0,1,1
2022-02-09,Hue City,Huong Tra,21,1,0,1,0
2022-02-09,Hue City,Phu Vang,7,1,0,1,1
2022-02-09,Hue City,Phu Vang,12,3,2,1,0
2022-02-09,Hue City,Phu Vang,13,3,2,1,0
2022-02-09,Hue City,Phu Vang,15,1,1,0,0
2022-02-09,Hue City,Phu Vang,16,1,1,0,0
2022-02-09,Hue City,Phu Vang,19,3,2,1,1
2022-02-09,Hue City,Phu Vang,20,2,1,1,1
2022-02-09,Vung Tau,Ba Ria City,7,1,0,1,1
2022-02-09,Vung Tau,Ba Ria City,8,5,0,5,5
2022-02-09,Vung Tau,Ba Ria City,9,14,4,10,10
2022-02-09,Vung Tau,Ba Ria City,10,20,5,15,12
2022-02-09,Vung Tau,Ba Ria City,11,8,4,4,2
2022-02-09,Vung Tau,Ba Ria City,12,12,1,11,10
2022-02-09,Vung Tau,Ba Ria City,13,11,4,7,7
2022-02-09,Vung Tau,Ba Ria City,14,5,3,2,2
2022-02-09,Vung Tau,Ba Ria City,15,5,1,4,4
2022-02-09,Vung Tau,Ba Ria City,16,8,3,5,5
2022-02-09,Vung Tau,Ba Ria City,17,9,3,6,5
2022-02-09,Vung Tau,Ba Ria City,18,1,0,1,0
2022-02-09,Vung Tau,Ba Ria City,19,8,0,8,7
2022-02-09,Vung Tau,Ba Ria City,20,1,0,1,1
2022-02-09,Vung Tau,Ba Ria City,21,2,0,2,1
2022-02-09,Vung Tau,Tan Thanh,11,1,0,1,1
2022-02-09,Vung Tau,Tan Thanh,19,1,0,1,1
2022-02-09,Vung Tau,Vung Tau City,0,1,1,0,0
2022-02-09,Vung Tau,Vung Tau City,4,1,0,1,1
2022-02-09,Vung Tau,Vung Tau City,5,1,1,0,0
2022-02-09,Vung Tau,Vung Tau City,6,31,29,2,1
2022-02-09,Vung Tau,Vung Tau City,7,87,74,13,0
2022-02-09,Vung Tau,Vung Tau City,8,151,135,16,2
2022-02-09,Vung Tau,Vung Tau City,9,167,144,23,1
2022-02-09,Vung Tau,Vung Tau City,10,193,174,19,2
2022-02-09,Vung Tau,Vung Tau City,11,324,277,47,18
2022-02-09,Vung Tau,Vung Tau City,12,245,220,25,4
2022-02-09,Vung Tau,Vung Tau City,13,219,190,29,8
2022-02-09,Vung Tau,Vung Tau City,14,222,207,15,6
2022-02-09,Vung Tau,Vung Tau City,15,229,208,21,5
2022-02-09,Vung Tau,Vung Tau City,16,221,195,26,4
2022-02-09,Vung Tau,Vung Tau City,17,210,192,18,2
2022-02-09,Vung Tau,Vung Tau City,18,267,237,30,8
2022-02-09,Vung Tau,Vung Tau City,19,208,173,35,7
2022-02-09,Vung Tau,Vung Tau City,20,167,137,30,10
2022-02-09,Vung Tau,Vung Tau City,21,120,62,58,37
2022-02-09,Vung Tau,Vung Tau City,22,3,2,1,0
2022-02-10,Binh Duong,Ben Cat,10,2,0,2,1
2022-02-10,Binh Duong,Di An,7,3,1,2,2
2022-02-10,Binh Duong,Di An,8,11,3,8,7
2022-02-10,Binh Duong,Di An,9,7,1,6,5
2022-02-10,Binh Duong,Di An,10,15,7,8,7
2022-02-10,Binh Duong,Di An,11,25,15,10,8
2022-02-10,Binh Duong,Di An,12,22,11,11,10
2022-02-10,Binh Duong,Di An,13,29,9,20,16
2022-02-10,Binh Duong,Di An,14,24,9,15,12
2022-02-10,Binh Duong,Di An,15,14,5,9,7
2022-02-10,Binh Duong,Di An,16,7,3,4,3
2022-02-10,Binh Duong,Di An,17,13,7,6,5
2022-02-10,Binh Duong,Di An,18,20,7,13,8
2022-02-10,Binh Duong,Di An,19,19,7,12,9
2022-02-10,Binh Duong,Di An,20,10,2,8,5
2022-02-10,Binh Duong,Di An,21,3,0,3,3
2022-02-10,Binh Duong,Di An,22,1,0,1,0
2022-02-10,Binh Duong,Tan Uyen,7,1,0,1,1
2022-02-10,Binh Duong,Tan Uyen,9,1,0,1,1
2022-02-10,Binh Duong,Tan Uyen,10,2,0,2,2
2022-02-10,Binh Duong,Tan Uyen,11,2,1,1,0
2022-02-10,Binh Duong,Tan Uyen,13,1,0,1,1
2022-02-10,Binh Duong,Tan Uyen,14,1,0,1,0
2022-02-10,Binh Duong,Tan Uyen,17,1,1,0,0
2022-02-10,Binh Duong,Tan Uyen,20,1,0,1,1
2022-02-10,Binh Duong,Thu Dau Mot Town,0,2,1,1,0
2022-02-10,Binh Duong,Thu Dau Mot Town,6,26,19,7,4
2022-02-10,Binh Duong,Thu Dau Mot Town,7,88,77,11,3
2022-02-10,Binh Duong,Thu Dau Mot Town,8,184,159,25,7
2022-02-10,Binh Duong,Thu Dau Mot Town,9,217,193,24,5
2022-02-10,Binh Duong,Thu Dau Mot Town,10,305,270,35,11
2022-02-10,Binh Duong,Thu Dau Mot Town,11,493,422,71,31
2022-02-10,Binh Duong,Thu Dau Mot Town,12,347,326,21,5
2022-02-10,Binh Duong,Thu Dau Mot Town,13,327,280,47,20
2022-02-10,Binh Duong,Thu Dau Mot Town,14,288,243,45,26
2022-02-10,Binh Duong,Thu Dau Mot Town,15,219,198,21,9
2022-02-10,Binh Duong,Thu Dau Mot Town,16,199,176,23,6
2022-02-10,Binh Duong,Thu Dau Mot Town,17,290,270,20,3
2022-02-10,Binh Duong,Thu Dau Mot Town,18,306,267,39,11
2022-02-10,Binh Duong,Thu Dau Mot Town,19,278,238,40,9
2022-02-10,Binh Duong,Thu Dau Mot Town,20,163,131,32,9
2022-02-10,Binh Duong,Thu Dau Mot Town,21,68,49,19,9
2022-02-10,Binh Duong,Thuan An,6,1,0,1,1
2022-02-10,Binh Duong,Thuan An,7,3,0,3,2
2022-02-10,Binh Duong,Thuan An,8,13,4,9,5
2022-02-10,Binh Duong,Thuan An,9,20,12,8,5
2022-02-10,Binh Duong,Thuan An,10,61,23,38,33
2022-02-10,Binh Duong,Thuan An,11,81,37,44,38
2022-02-10,Binh Duong,Thuan An,12,56,25,31,21
2022-02-10,Binh Duong,Thuan An,13,108,26,82,69
2022-02-10,Binh Duong,Thuan An,14,69,32,37,34
2022-02-10,Binh Duong,Thuan An,15,43,22,21,17
2022-02-10,Binh Duong,Thuan An,16,22,12,10,9
2022-02-10,Binh Duong,Thuan An,17,38,22,16,11
2022-02-10,Binh Duong,Thuan An,18,32,19,13,6
2022-02-10,Binh Duong,Thuan An,19,20,10,10,8
2022-02-10,Binh Duong,Thuan An,20,32,8,24,22
2022-02-10,Binh Duong,Thuan An,21,5,0,5,5
2022-02-10,Can Tho City,Binh Thuy District,8,2,1,1,0
2022-02-10,Can Tho City,Binh Thuy District,9,4,3,1,1
2022-02-10,Can Tho City,Binh Thuy District,10,1,1,0,0
2022-02-10,Can Tho City,Binh Thuy District,11,5,4,1,0
2022-02-10,Can Tho City,Binh Thuy District,12,5,5,0,0
2022-02-10,Can Tho City,Binh Thuy District,13,8,7,1,0
2022-02-10,Can Tho City,Binh Thuy District,14,8,8,0,0
2022-02-10,Can Tho City,Binh Thuy District,15,6,6,0,0
2022-02-10,Can Tho City,Binh Thuy District,16,8,5,3,3
2022-02-10,Can Tho City,Binh Thuy District,17,8,8,0,0
2022-02-10,Can Tho City,Binh Thuy District,18,7,7,0,0
2022-02-10,Can Tho City,Binh Thuy District,19,4,3,1,0
2022-02-10,Can Tho City,Binh Thuy District,20,8,8,0,0
2022-02-10,Can Tho City,Binh Thuy District,21,2,1,1,1
2022-02-10,Can Tho City,Cai Rang District,6,1,0,1,1
2022-02-10,Can Tho City,Cai Rang District,7,2,2,0,0
2022-02-10,Can Tho City,Cai Rang District,8,1,1,0,0
2022-02-10,Can Tho City,Cai Rang District,9,4,4,0,0
2022-02-10,Can Tho City,Cai Rang District,10,7,7,0,0
2022-02-10,Can Tho City,Cai Rang District,11,7,4,3,2
2022-02-10,Can Tho City,Cai Rang District,12,8,5,3,0
2022-02-10,Can Tho City,Cai Rang District,13,2,2,0,0
2022-02-10,Can Tho City,Cai Rang District,14,6,4,2,2
2022-02-10,Can Tho City,Cai Rang District,15,4,4,0,0
2022-02-10,Can Tho City,Cai Rang District,16,10,10,0,0
2022-02-10,Can Tho City,Cai Rang District,17,12,11,1,0
2022-02-10,Can Tho City,Cai Rang District,18,10,10,0,0
2022-02-10,Can Tho City,Cai Rang District,19,4,3,1,0
2022-02-10,Can Tho City,Cai Rang District,20,5,3,2,0
2022-02-10,Can Tho City,Cai Rang District,21,3,1,2,1
2022-02-10,Can Tho City,Ninh Kieu District,0,2,2,0,0
2022-02-10,Can Tho City,Ninh Kieu District,1,3,2,1,0
2022-02-10,Can Tho City,Ninh Kieu District,2,1,1,0,0
2022-02-10,Can Tho City,Ninh Kieu District,4,1,1,0,0
2022-02-10,Can Tho City,Ninh Kieu District,5,2,1,1,0
2022-02-10,Can Tho City,Ninh Kieu District,6,38,32,6,0
2022-02-10,Can Tho City,Ninh Kieu District,7,87,77,10,0
2022-02-10,Can Tho City,Ninh Kieu District,8,169,160,9,0
2022-02-10,Can Tho City,Ninh Kieu District,9,247,231,16,4
2022-02-10,Can Tho City,Ninh Kieu District,10,406,369,37,1
2022-02-10,Can Tho City,Ninh Kieu District,11,587,560,27,1
2022-02-10,Can Tho City,Ninh Kieu District,12,392,380,12,2
2022-02-10,Can Tho City,Ninh Kieu District,13,324,309,15,0
2022-02-10,Can Tho City,Ninh Kieu District,14,258,245,13,0
2022-02-10,Can Tho City,Ninh Kieu District,15,238,230,8,0
2022-02-10,Can Tho City,Ninh Kieu District,16,288,272,16,1
2022-02-10,Can Tho City,Ninh Kieu District,17,330,316,14,0
2022-02-10,Can Tho City,Ninh Kieu District,18,367,346,21,0
2022-02-10,Can Tho City,Ninh Kieu District,19,276,266,10,0
2022-02-10,Can Tho City,Ninh Kieu District,20,231,219,12,0
2022-02-10,Can Tho City,Ninh Kieu District,21,130,108,22,0
2022-02-10,Can Tho City,Ninh Kieu District,22,6,5,1,0
2022-02-10,Can Tho City,Ninh Kieu District,23,3,2,1,0
2022-02-10,Dong Nai,Bien Hoa City,0,1,0,1,0
2022-02-10,Dong Nai,Bien Hoa City,2,3,2,1,0
2022-02-10,Dong Nai,Bien Hoa City,3,2,1,1,0
2022-02-10,Dong Nai,Bien Hoa City,5,1,1,0,0
2022-02-10,Dong Nai,Bien Hoa City,6,41,22,19,13
2022-02-10,Dong Nai,Bien Hoa City,7,157,119,38,25
2022-02-10,Dong Nai,Bien Hoa City,8,259,210,49,15
2022-02-10,Dong Nai,Bien Hoa City,9,406,336,70,19
2022-02-10,Dong Nai,Bien Hoa City,10,720,592,128,51
2022-02-10,Dong Nai,Bien Hoa City,11,996,844,152,58
2022-02-10,Dong Nai,Bien Hoa City,12,756,651,105,47
2022-02-10,Dong Nai,Bien Hoa City,13,703,612,91,45
2022-02-10,Dong Nai,Bien Hoa City,14,638,538,100,39
2022-02-10,Dong Nai,Bien Hoa City,15,488,432,56,13
2022-02-10,Dong Nai,Bien Hoa City,16,444,379,65,18
2022-02-10,Dong Nai,Bien Hoa City,17,473,396,77,17
2022-02-10,Dong Nai,Bien Hoa City,18,523,466,57,9
2022-02-10,Dong Nai,Bien Hoa City,19,501,436,65,24
2022-02-10,Dong Nai,Bien Hoa City,20,423,302,121,53
2022-02-10,Dong Nai,Bien Hoa City,21,171,101,70,38
2022-02-10,Dong Nai,Bien Hoa City,22,4,3,1,0
2022-02-10,Dong Nai,Bien Hoa City,23,3,2,1,0
2022-02-10,Dong Nai,Long Khanh,17,1,0,1,1
2022-02-10,Dong Nai,Long Khanh,19,1,0,1,1
2022-02-10,Dong Nai,Long Thanh,10,3,1,2,2
2022-02-10,Dong Nai,Long Thanh,11,4,0,4,2
2022-02-10,Dong Nai,Long Thanh,12,2,0,2,2
2022-02-10,Dong Nai,Long Thanh,14,3,0,3,2
2022-02-10,Dong Nai,Long Thanh,16,2,0,2,2
2022-02-10,Dong Nai,Long Thanh,17,1,0,1,1
2022-02-10,Dong Nai,Long Thanh,18,2,0,2,2
2022-02-10,Dong Nai,Long Thanh,20,1,0,1,1
2022-02-10,Dong Nai,Thong Nhat,7,2,2,0,0
2022-02-10,Dong Nai,Thong Nhat,8,1,1,0,0
2022-02-10,Dong Nai,Thong Nhat,9,1,1,0,0
2022-02-10,Dong Nai,Thong Nhat,10,1,1,0,0
2022-02-10,Dong Nai,Thong Nhat,11,2,2,0,0
2022-02-10,Dong Nai,Thong Nhat,12,1,1,0,0
2022-02-10,Dong Nai,Thong Nhat,13,3,3,0,0
2022-02-10,Dong Nai,Thong Nhat,19,1,1,0,0
2022-02-10,Dong Nai,Thong Nhat,20,1,1,0,0
2022-02-10,Dong Nai,Trang Bom,13,1,1,0,0
2022-02-10,Dong Nai,Vinh Cuu,10,1,0,1,1
2022-02-10,Dong Nai,Vinh Cuu,13,1,0,1,0
2022-02-10,Hai Phong City,An Duong,7,2,0,2,2
2022-02-10,Hai Phong City,An Duong,8,1,0,1,1
2022-02-10,Hai Phong City,An Duong,9,4,1,3,2
2022-02-10,Hai Phong City,An Duong,10,2,0,2,1
2022-02-10,Hai Phong City,An Duong,11,5,2,3,3
2022-02-10,Hai Phong City,An Duong,12,4,1,3,3
2022-02-10,Hai Phong City,An Duong,13,2,1,1,1
2022-02-10,Hai Phong City,An Duong,14,3,0,3,1
2022-02-10,Hai Phong City,An Duong,15,4,2,2,2
2022-02-10,Hai Phong City,An Duong,16,7,4,3,1
2022-02-10,Hai Phong City,An Duong,17,2,1,1,1
2022-02-10,Hai Phong City,An Duong,18,7,2,5,4
2022-02-10,Hai Phong City,An Duong,19,2,0,2,1
2022-02-10,Hai Phong City,An Duong,20,4,0,4,3
2022-02-10,Hai Phong City,An Duong,21,1,0,1,1
2022-02-10,Hai Phong City,An Lao,9,1,0,1,1
2022-02-10,Hai Phong City,Do Son District,18,1,0,1,1
2022-02-10,Hai Phong City,Duong Kinh District,13,1,0,1,1
2022-02-10,Hai Phong City,Duong Kinh District,14,2,2,0,0
2022-02-10,Hai Phong City,Hai An District,2,1,0,1,1
2022-02-10,Hai Phong City,Hai An District,7,11,9,2,1
2022-02-10,Hai Phong City,Hai An District,8,11,8,3,3
2022-02-10,Hai Phong City,Hai An District,9,17,13,4,0
2022-02-10,Hai Phong City,Hai An District,10,31,28,3,0
2022-02-10,Hai Phong City,Hai An District,11,28,21,7,4
2022-02-10,Hai Phong City,Hai An District,12,29,21,8,0
2022-02-10,Hai Phong City,Hai An District,13,17,15,2,1
2022-02-10,Hai Phong City,Hai An District,14,14,8,6,1
2022-02-10,Hai Phong City,Hai An District,15,31,26,5,1
2022-02-10,Hai Phong City,Hai An District,16,19,18,1,0
2022-02-10,Hai Phong City,Hai An District,17,39,31,8,1
2022-02-10,Hai Phong City,Hai An District,18,30,22,8,1
2022-02-10,Hai Phong City,Hai An District,19,22,16,6,0
2022-02-10,Hai Phong City,Hai An District,20,24,15,9,6
2022-02-10,Hai Phong City,Hai An District,21,7,2,5,1
2022-02-10,Hai Phong City,Hong Bang District,0,1,1,0,0
2022-02-10,Hai Phong City,Hong Bang District,7,21,12,9,7
2022-02-10,Hai Phong City,Hong Bang District,8,41,30,11,8
2022-02-10,Hai Phong City,Hong Bang District,9,37,30,7,4
2022-02-10,Hai Phong City,Hong Bang District,10,49,43,6,1
2022-02-10,Hai Phong City,Hong Bang District,11,103,85,18,13
2022-02-10,Hai Phong City,Hong Bang District,12,51,42,9,3
2022-02-10,Hai Phong City,Hong Bang District,13,34,29,5,3
2022-02-10,Hai Phong City,Hong Bang District,14,51,43,8,3
2022-02-10,Hai Phong City,Hong Bang District,15,40,34,6,3
2022-02-10,Hai Phong City,Hong Bang District,16,51,42,9,4
2022-02-10,Hai Phong City,Hong Bang District,17,54,42,12,5
2022-02-10,Hai Phong City,Hong Bang District,18,70,58,12,6
2022-02-10,Hai Phong City,Hong Bang District,19,56,40,16,6
2022-02-10,Hai Phong City,Hong Bang District,20,37,18,19,11
2022-02-10,Hai Phong City,Hong Bang District,21,25,15,10,7
2022-02-10,Hai Phong City,Hong Bang District,22,1,0,1,0
2022-02-10,Hai Phong City,Hong Bang District,23,1,0,1,0
2022-02-10,Hai Phong City,Kien An District,7,2,0,2,0
2022-02-10,Hai Phong City,Kien An District,8,1,0,1,0
2022-02-10,Hai Phong City,Kien An District,9,4,4,0,0
2022-02-10,Hai Phong City,Kien An District,10,4,4,0,0
2022-02-10,Hai Phong City,Kien An District,11,11,3,8,7
2022-02-10,Hai Phong City,Kien An District,12,13,6,7,2
2022-02-10,Hai Phong City,Kien An District,13,8,8,0,0
2022-02-10,Hai Phong City,Kien An District,14,9,1,8,3
2022-02-10,Hai Phong City,Kien An District,15,19,12,7,3
2022-02-10,Hai Phong City,Kien An District,16,12,7,5,4
2022-02-10,Hai Phong City,Kien An District,17,8,7,1,1
2022-02-10,Hai Phong City,Kien An District,18,7,6,1,0
2022-02-10,Hai Phong City,Kien An District,19,11,6,5,4
2022-02-10,Hai Phong City,Kien An District,20,8,4,4,2
2022-02-10,Hai Phong City,Kien An District,21,1,0,1,1
2022-02-10,Hai Phong City,Le Chan District,0,1,1,0,0
2022-02-10,Hai Phong City,Le Chan District,1,1,0,1,0
2022-02-10,Hai Phong City,Le Chan District,4,1,0,1,0
2022-02-10,Hai Phong City,Le Chan District,5,1,1,0,0
2022-02-10,Hai Phong City,Le Chan District,7,39,27,12,6
2022-02-10,Hai Phong City,Le Chan District,8,88,66,22,8
2022-02-10,Hai Phong City,Le Chan District,9,91,75,16,3
2022-02-10,Hai Phong City,Le Chan District,10,167,143,24,7
2022-02-10,Hai Phong City,Le Chan District,11,317,237,80,44
2022-02-10,Hai Phong City,Le Chan District,12,206,165,41,13
2022-02-10,Hai Phong City,Le Chan District,13,130,113,17,4
2022-02-10,Hai Phong City,Le Chan District,14,178,127,51,25
2022-02-10,Hai Phong City,Le Chan District,15,206,161,45,8
2022-02-10,Hai Phong City,Le Chan District,16,214,173,41,12
2022-02-10,Hai Phong City,Le Chan District,17,240,191,49,15
2022-02-10,Hai Phong City,Le Chan District,18,242,190,52,19
2022-02-10,Hai Phong City,Le Chan District,19,219,185,34,9
2022-02-10,Hai Phong City,Le Chan District,20,176,123,53,22
2022-02-10,Hai Phong City,Le Chan District,21,80,48,32,22
2022-02-10,Hai Phong City,Le Chan District,22,4,2,2,1
2022-02-10,Hai Phong City,Le Chan District,23,2,2,0,0
2022-02-10,Hai Phong City,Ngo Quyen District,1,1,1,0,0
2022-02-10,Hai Phong City,Ngo Quyen District,4,1,1,0,0
2022-02-10,Hai Phong City,Ngo Quyen District,7,36,23,13,3
2022-02-10,Hai Phong City,Ngo Quyen District,8,75,59,16,9
2022-02-10,Hai Phong City,Ngo Quyen District,9,91,79,12,1
2022-02-10,Hai Phong City,Ngo Quyen District,10,109,82,27,6
2022-02-10,Hai Phong City,Ngo Quyen District,11,236,182,54,28
2022-02-10,Hai Phong City,Ngo Quyen District,12,130,111,19,3
2022-02-10,Hai Phong City,Ngo Quyen District,13,106,84,22,7
2022-02-10,Hai Phong City,Ngo Quyen District,14,118,94,24,7
2022-02-10,Hai Phong City,Ngo Quyen District,15,152,116,36,9
2022-02-10,Hai Phong City,Ngo Quyen District,16,182,146,36,13
2022-02-10,Hai Phong City,Ngo Quyen District,17,154,127,27,6
2022-02-10,Hai Phong City,Ngo Quyen District,18,197,163,34,15
2022-02-10,Hai Phong City,Ngo Quyen District,19,140,116,24,6
2022-02-10,Hai Phong City,Ngo Quyen District,20,171,112,59,30
2022-02-10,Hai Phong City,Ngo Quyen District,21,96,48,48,27
2022-02-10,Hai Phong City,Ngo Quyen District,22,1,0,1,1
2022-02-10,Hai Phong City,Ngo Quyen District,23,1,1,0,0
2022-02-10,Hai Phong City,Thuy Nguyen,10,1,0,1,1
2022-02-10,Hai Phong City,Thuy Nguyen,11,1,0,1,1
2022-02-10,Hai Phong City,Thuy Nguyen,14,4,0,4,3
2022-02-10,Hai Phong City,Thuy Nguyen,16,1,0,1,1
2022-02-10,Hai Phong City,Thuy Nguyen,17,1,0,1,1
2022-02-10,Hai Phong City,Thuy Nguyen,19,1,0,1,1
2022-02-10,Hai Phong City,Thuy Nguyen,20,1,0,1,1
2022-02-10,Hue City,Hue City,0,1,1,0,0
2022-02-10,Hue City,Hue City,2,1,1,0,0
2022-02-10,Hue City,Hue City,3,1,1,0,0
2022-02-10,Hue City,Hue City,5,1,1,0,0
2022-02-10,Hue City,Hue City,6,44,34,10,3
2022-02-10,Hue City,Hue City,7,160,142,18,5
2022-02-10,Hue City,Hue City,8,248,233,15,1
2022-02-10,Hue City,Hue City,9,201,184,17,2
2022-02-10,Hue City,Hue City,10,254,242,12,0
2022-02-10,Hue City,Hue City,11,522,492,30,5
2022-02-10,Hue City,Hue City,12,331,306,25,0
2022-02-10,Hue City,Hue City,13,240,226,14,0
2022-02-10,Hue City,Hue City,14,254,230,24,1
2022-02-10,Hue City,Hue City,15,332,302,30,1
2022-02-10,Hue City,Hue City,16,348,317,31,0
2022-02-10,Hue City,Hue City,17,431,390,41,5
2022-02-10,Hue City,Hue City,18,501,443,58,10
2022-02-10,Hue City,Hue City,19,388,341,47,5
2022-02-10,Hue City,Hue City,20,287,258,29,4
2022-02-10,Hue City,Hue City,21,170,137,33,2
2022-02-10,Hue City,Hue City,22,3,3,0,0
2022-02-10,Hue City,Huong Thuy,9,1,0,1,1
2022-02-10,Hue City,Huong Thuy,10,1,0,1,0
2022-02-10,Hue City,Huong Thuy,11,1,1,0,0
2022-02-10,Hue City,Huong Thuy,12,1,1,0,0
2022-02-10,Hue City,Huong Thuy,14,1,1,0,0
2022-02-10,Hue City,Huong Thuy,16,1,0,1,0
2022-02-10,Hue City,Huong Thuy,18,1,1,0,0
2022-02-10,Hue City,Huong Thuy,19,1,1,0,0
2022-02-10,Hue City,Huong Thuy,20,1,1,0,0
2022-02-10,Hue City,Huong Thuy,21,4,2,2,2
2022-02-10,Hue City,Huong Tra,12,1,1,0,0
2022-02-10,Hue City,Huong Tra,15,1,1,0,0
2022-02-10,Hue City,Huong Tra,17,2,1,1,0
2022-02-10,Hue City,Phu Vang,9,1,0,1,0
2022-02-10,Hue City,Phu Vang,15,1,0,1,0
2022-02-10,Hue City,Phu Vang,17,1,0,1,1
2022-02-10,Hue City,Phu Vang,18,4,3,1,1
2022-02-10,Hue City,Phu Vang,19,3,2,1,1
2022-02-10,Hue City,Phu Vang,20,2,1,1,1
2022-02-10,Vung Tau,Ba Ria City,8,2,0,2,2
2022-02-10,Vung Tau,Ba Ria City,9,6,4,2,2
2022-02-10,Vung Tau,Ba Ria City,10,6,4,2,1
2022-02-10,Vung Tau,Ba Ria City,11,9,0,9,9
2022-02-10,Vung Tau,Ba Ria City,12,10,3,7,5
2022-02-10,Vung Tau,Ba Ria City,13,7,2,5,3
2022-02-10,Vung Tau,Ba Ria City,14,3,2,1,0
2022-02-10,Vung Tau,Ba Ria City,15,7,1,6,5
2022-02-10,Vung Tau,Ba Ria City,16,2,1,1,1
2022-02-10,Vung Tau,Ba Ria City,17,8,6,2,2
2022-02-10,Vung Tau,Ba Ria City,18,3,1,2,0
2022-02-10,Vung Tau,Ba Ria City,19,2,1,1,1
2022-02-10,Vung Tau,Ba Ria City,20,4,0,4,3
2022-02-10,Vung Tau,Ba Ria City,21,1,0,1,1
2022-02-10,Vung Tau,Tan Thanh,21,2,0,2,2
2022-02-10,Vung Tau,Vung Tau City,0,1,0,1,1
2022-02-10,Vung Tau,Vung Tau City,1,1,1,0,0
2022-02-10,Vung Tau,Vung Tau City,6,32,25,7,3
2022-02-10,Vung Tau,Vung Tau City,7,108,86,22,4
2022-02-10,Vung Tau,Vung Tau City,8,129,121,8,0
2022-02-10,Vung Tau,Vung Tau City,9,142,123,19,5
2022-02-10,Vung Tau,Vung Tau City,10,174,154,20,5
2022-02-10,Vung Tau,Vung Tau City,11,296,272,24,7
2022-02-10,Vung Tau,Vung Tau City,12,230,206,24,3
2022-02-10,Vung Tau,Vung Tau City,13,197,185,12,0
2022-02-10,Vung Tau,Vung Tau City,14,215,193,22,7
2022-02-10,Vung Tau,Vung Tau City,15,204,181,23,4
2022-02-10,Vung Tau,Vung Tau City,16,221,206,15,5
2022-02-10,Vung Tau,Vung Tau City,17,187,165,22,5
2022-02-10,Vung Tau,Vung Tau City,18,259,228,31,4
2022-02-10,Vung Tau,Vung Tau City,19,217,190,27,10
2022-02-10,Vung Tau,Vung Tau City,20,190,147,43,23
2022-02-10,Vung Tau,Vung Tau City,21,102,62,40,14
2022-02-10,Vung Tau,Vung Tau City,22,2,0,2,0
2022-02-10,Vung Tau,Vung Tau City,23,2,1,1,0
2022-02-11,Binh Duong,Ben Cat,14,1,0,1,0
2022-02-11,Binh Duong,Di An,0,1,0,1,1
2022-02-11,Binh Duong,Di An,6,1,0,1,1
2022-02-11,Binh Duong,Di An,7,6,1,5,5
2022-02-11,Binh Duong,Di An,8,10,2,8,6
2022-02-11,Binh Duong,Di An,9,13,3,10,8
2022-02-11,Binh Duong,Di An,10,22,7,15,12
2022-02-11,Binh Duong,Di An,11,38,13,25,16
2022-02-11,Binh Duong,Di An,12,25,10,15,13
2022-02-11,Binh Duong,Di An,13,39,10,29,24
2022-02-11,Binh Duong,Di An,14,16,7,9,6
2022-02-11,Binh Duong,Di An,15,16,6,10,9
2022-02-11,Binh Duong,Di An,16,8,4,4,3
2022-02-11,Binh Duong,Di An,17,10,6,4,2
2022-02-11,Binh Duong,Di An,18,9,6,3,2
2022-02-11,Binh Duong,Di An,19,15,3,12,10
2022-02-11,Binh Duong,Di An,20,15,6,9,4
2022-02-11,Binh Duong,Di An,21,3,2,1,1
2022-02-11,Binh Duong,Tan Uyen,8,1,0,1,1
2022-02-11,Binh Duong,Tan Uyen,9,2,0,2,1
2022-02-11,Binh Duong,Tan Uyen,10,2,1,1,1
2022-02-11,Binh Duong,Tan Uyen,11,2,0,2,2
2022-02-11,Binh Duong,Tan Uyen,12,6,0,6,3
2022-02-11,Binh Duong,Tan Uyen,13,3,1,2,2
2022-02-11,Binh Duong,Tan Uyen,14,2,1,1,1
2022-02-11,Binh Duong,Tan Uyen,16,1,0,1,1
2022-02-11,Binh Duong,Tan Uyen,17,4,0,4,3
2022-02-11,Binh Duong,Tan Uyen,18,2,2,0,0
2022-02-11,Binh Duong,Thu Dau Mot Town,0,3,0,3,0
2022-02-11,Binh Duong,Thu Dau Mot Town,1,2,0,2,0
2022-02-11,Binh Duong,Thu Dau Mot Town,2,2,1,1,0
2022-02-11,Binh Duong,Thu Dau Mot Town,5,1,1,0,0
2022-02-11,Binh Duong,Thu Dau Mot Town,6,32,24,8,5
2022-02-11,Binh Duong,Thu Dau Mot Town,7,65,59,6,4
2022-02-11,Binh Duong,Thu Dau Mot Town,8,169,152,17,1
2022-02-11,Binh Duong,Thu Dau Mot Town,9,224,198,26,2
2022-02-11,Binh Duong,Thu Dau Mot Town,10,324,285,39,3
2022-02-11,Binh Duong,Thu Dau Mot Town,11,548,477,71,24
2022-02-11,Binh Duong,Thu Dau Mot Town,12,393,365,28,9
2022-02-11,Binh Duong,Thu Dau Mot Town,13,339,303,36,7
2022-02-11,Binh Duong,Thu Dau Mot Town,14,266,247,19,6
2022-02-11,Binh Duong,Thu Dau Mot Town,15,209,193,16,1
2022-02-11,Binh Duong,Thu Dau Mot Town,16,200,113,87,61
2022-02-11,Binh Duong,Thu Dau Mot Town,17,390,240,150,107
2022-02-11,Binh Duong,Thu Dau Mot Town,18,420,286,134,98
2022-02-11,Binh Duong,Thu Dau Mot Town,19,304,235,69,46
2022-02-11,Binh Duong,Thu Dau Mot Town,20,186,150,36,12
2022-02-11,Binh Duong,Thu Dau Mot Town,21,90,67,23,7
2022-02-11,Binh Duong,Thu Dau Mot Town,22,2,0,2,0
2022-02-11,Binh Duong,Thu Dau Mot Town,23,1,0,1,0
2022-02-11,Binh Duong,Thuan An,6,1,0,1,1
2022-02-11,Binh Duong,Thuan An,7,4,2,2,2
2022-02-11,Binh Duong,Thuan An,8,9,4,5,3
2022-02-11,Binh Duong,Thuan An,9,27,18,9,7
2022-02-11,Binh Duong,Thuan An,10,62,34,28,22
2022-02-11,Binh Duong,Thuan An,11,72,32,40,36
2022-02-11,Binh Duong,Thuan An,12,77,40,37,26
2022-02-11,Binh Duong,Thuan An,13,64,27,37,30
2022-02-11,Binh Duong,Thuan An,14,47,28,19,16
2022-02-11,Binh Duong,Thuan An,15,38,18,20,14
2022-02-11,Binh Duong,Thuan An,16,25,15,10,9
2022-02-11,Binh Duong,Thuan An,17,34,18,16,9
2022-02-11,Binh Duong,Thuan An,18,56,28,28,21
2022-02-11,Binh Duong,Thuan An,19,36,14,22,16
2022-02-11,Binh Duong,Thuan An,20,30,12,18,11
2022-02-11,Binh Duong,Thuan An,21,17,4,13,6
2022-02-11,Can Tho City,Binh Thuy District,8,4,3,1,0
2022-02-11,Can Tho City,Binh Thuy District,9,1,1,0,0
2022-02-11,Can Tho City,Binh Thuy District,10,6,6,0,0
2022-02-11,Can Tho City,Binh Thuy District,11,11,9,2,0
2022-02-11,Can Tho City,Binh Thuy District,12,10,9,1,0
2022-02-11,Can Tho City,Binh Thuy District,13,13,12,1,0
2022-02-11,Can Tho City,Binh Thuy District,14,7,5,2,0
2022-02-11,Can Tho City,Binh Thuy District,15,7,6,1,0
2022-02-11,Can Tho City,Binh Thuy District,16,6,3,3,0
2022-02-11,Can Tho City,Binh Thuy District,17,10,10,0,0
2022-02-11,Can Tho City,Binh Thuy District,18,9,8,1,0
2022-02-11,Can Tho City,Binh Thuy District,19,6,6,0,0
2022-02-11,Can Tho City,Binh Thuy District,20,4,4,0,0
2022-02-11,Can Tho City,Binh Thuy District,21,4,2,2,0
2022-02-11,Can Tho City,Cai Rang District,6,1,1,0,0
2022-02-11,Can Tho City,Cai Rang District,7,1,1,0,0
2022-02-11,Can Tho City,Cai Rang District,8,4,3,1,0
2022-02-11,Can Tho City,Cai Rang District,9,2,2,0,0
2022-02-11,Can Tho City,Cai Rang District,10,10,10,0,0
2022-02-11,Can Tho City,Cai Rang District,11,7,6,1,1
2022-02-11,Can Tho City,Cai Rang District,12,9,7,2,0
2022-02-11,Can Tho City,Cai Rang District,13,6,6,0,0
2022-02-11,Can Tho City,Cai Rang District,14,6,6,0,0
2022-02-11,Can Tho City,Cai Rang District,15,10,6,4,3
2022-02-11,Can Tho City,Cai Rang District,16,6,3,3,0
2022-02-11,Can Tho City,Cai Rang District,17,6,4,2,0
2022-02-11,Can Tho City,Cai Rang District,18,12,10,2,1
2022-02-11,Can Tho City,Cai Rang District,19,7,7,0,0
2022-02-11,Can Tho City,Cai Rang District,20,8,8,0,0
2022-02-11,Can Tho City,Cai Rang District,21,3,2,1,1
2022-02-11,Can Tho City,Ninh Kieu District,0,3,3,0,0
2022-02-11,Can Tho City,Ninh Kieu District,2,1,1,0,0
2022-02-11,Can Tho City,Ninh Kieu District,3,1,1,0,0
2022-02-11,Can Tho City,Ninh Kieu District,5,2,1,1,0
2022-02-11,Can Tho City,Ninh Kieu District,6,41,40,1,0
2022-02-11,Can Tho City,Ninh Kieu District,7,97,88,9,0
2022-02-11,Can Tho City,Ninh Kieu District,8,175,165,10,0
2022-02-11,Can Tho City,Ninh Kieu District,9,250,226,24,0
2022-02-11,Can Tho City,Ninh Kieu District,10,435,416,19,0
2022-02-11,Can Tho City,Ninh Kieu District,11,661,634,27,0
2022-02-11,Can Tho City,Ninh Kieu District,12,443,430,13,0
2022-02-11,Can Tho City,Ninh Kieu District,13,342,328,14,0
2022-02-11,Can Tho City,Ninh Kieu District,14,302,290,12,0
2022-02-11,Can Tho City,Ninh Kieu District,15,255,241,14,0
2022-02-11,Can Tho City,Ninh Kieu District,16,302,280,22,0
2022-02-11,Can Tho City,Ninh Kieu District,17,318,304,14,0
2022-02-11,Can Tho City,Ninh Kieu District,18,412,392,20,0
2022-02-11,Can Tho City,Ninh Kieu District,19,334,312,22,0
2022-02-11,Can Tho City,Ninh Kieu District,20,266,237,29,0
2022-02-11,Can Tho City,Ninh Kieu District,21,145,135,10,0
2022-02-11,Can Tho City,Ninh Kieu District,22,4,3,1,0
2022-02-11,Dong Nai,Bien Hoa City,0,2,1,1,0
2022-02-11,Dong Nai,Bien Hoa City,2,3,1,2,0
2022-02-11,Dong Nai,Bien Hoa City,3,2,1,1,0
2022-02-11,Dong Nai,Bien Hoa City,4,1,1,0,0
2022-02-11,Dong Nai,Bien Hoa City,6,32,22,10,9
2022-02-11,Dong Nai,Bien Hoa City,7,142,112,30,14
2022-02-11,Dong Nai,Bien Hoa City,8,316,250,66,29
2022-02-11,Dong Nai,Bien Hoa City,9,380,310,70,22
2022-02-11,Dong Nai,Bien Hoa City,10,715,617,98,31
2022-02-11,Dong Nai,Bien Hoa City,11,1003,829,174,77
2022-02-11,Dong Nai,Bien Hoa City,12,791,711,80,26
2022-02-11,Dong Nai,Bien Hoa City,13,728,639,89,26
2022-02-11,Dong Nai,Bien Hoa City,14,596,529,67,18
2022-02-11,Dong Nai,Bien Hoa City,15,458,409,49,9
2022-02-11,Dong Nai,Bien Hoa City,16,445,393,52,7
2022-02-11,Dong Nai,Bien Hoa City,17,488,434,54,12
2022-02-11,Dong Nai,Bien Hoa City,18,558,490,68,17
2022-02-11,Dong Nai,Bien Hoa City,19,540,457,83,40
2022-02-11,Dong Nai,Bien Hoa City,20,419,314,105,51
2022-02-11,Dong Nai,Bien Hoa City,21,238,136,102,70
2022-02-11,Dong Nai,Bien Hoa City,22,3,0,3,0
2022-02-11,Dong Nai,Cam My,13,1,0,1,1
2022-02-11,Dong Nai,Long Khanh,11,1,0,1,1
2022-02-11,Dong Nai,Long Thanh,9,2,0,2,2
2022-02-11,Dong Nai,Long Thanh,12,3,0,3,3
2022-02-11,Dong Nai,Long Thanh,13,4,0,4,4
2022-02-11,Dong Nai,Long Thanh,14,1,0,1,1
2022-02-11,Dong Nai,Long Thanh,15,2,0,2,2
2022-02-11,Dong Nai,Long Thanh,21,1,0,1,0
2022-02-11,Dong Nai,Thong Nhat,8,2,2,0,0
2022-02-11,Dong Nai,Thong Nhat,9,1,1,0,0
2022-02-11,Dong Nai,Thong Nhat,10,3,3,0,0
2022-02-11,Dong Nai,Thong Nhat,12,2,2,0,0
2022-02-11,Dong Nai,Thong Nhat,13,2,2,0,0
2022-02-11,Dong Nai,Thong Nhat,15,1,1,0,0
2022-02-11,Dong Nai,Thong Nhat,17,1,1,0,0
2022-02-11,Dong Nai,Trang Bom,14,1,0,1,1
2022-02-11,Dong Nai,Trang Bom,16,1,1,0,0
2022-02-11,Dong Nai,Trang Bom,17,1,0,1,1
2022-02-11,Dong Nai,Trang Bom,18,2,0,2,2
2022-02-11,Dong Nai,Trang Bom,19,1,0,1,1
2022-02-11,Dong Nai,Trang Bom,21,1,0,1,1
2022-02-11,Dong Nai,Vinh Cuu,19,1,0,1,1
2022-02-11,Hai Phong City,An Duong,7,3,0,3,3
2022-02-11,Hai Phong City,An Duong,8,5,1,4,4
2022-02-11,Hai Phong City,An Duong,9,6,3,3,2
2022-02-11,Hai Phong City,An Duong,10,11,7,4,4
2022-02-11,Hai Phong City,An Duong,11,4,1,3,2
2022-02-11,Hai Phong City,An Duong,12,3,0,3,2
2022-02-11,Hai Phong City,An Duong,13,3,1,2,2
2022-02-11,Hai Phong City,An Duong,14,4,1,3,1
2022-02-11,Hai Phong City,An Duong,15,7,2,5,3
2022-02-11,Hai Phong City,An Duong,16,3,0,3,3
2022-02-11,Hai Phong City,An Duong,17,1,1,0,0
2022-02-11,Hai Phong City,An Duong,18,7,1,6,4
2022-02-11,Hai Phong City,An Duong,19,5,1,4,4
2022-02-11,Hai Phong City,An Duong,20,5,0,5,3
2022-02-11,Hai Phong City,An Duong,21,2,1,1,1
2022-02-11,Hai Phong City,Do Son District,9,1,0,1,0
2022-02-11,Hai Phong City,Do Son District,10,1,0,1,1
2022-02-11,Hai Phong City,Hai An District,7,17,8,9,4
2022-02-11,Hai Phong City,Hai An District,8,9,4,5,1
2022-02-11,Hai Phong City,Hai An District,9,17,12,5,3
2022-02-11,Hai Phong City,Hai An District,10,37,30,7,0
2022-02-11,Hai Phong City,Hai An District,11,61,43,18,8
2022-02-11,Hai Phong City,Hai An District,12,23,19,4,1
2022-02-11,Hai Phong City,Hai An District,13,16,15,1,0
2022-02-11,Hai Phong City,Hai An District,14,10,7,3,0
2022-02-11,Hai Phong City,Hai An District,15,34,26,8,1
2022-02-11,Hai Phong City,Hai An District,16,17,13,4,1
2022-02-11,Hai Phong City,Hai An District,17,37,29,8,2
2022-02-11,Hai Phong City,Hai An District,18,40,29,11,6
2022-02-11,Hai Phong City,Hai An District,19,31,29,2,0
2022-02-11,Hai Phong City,Hai An District,20,22,16,6,0
2022-02-11,Hai Phong City,Hai An District,21,11,7,4,1
2022-02-11,Hai Phong City,Hai An District,22,1,1,0,0
2022-02-11,Hai Phong City,Hong Bang District,0,1,1,0,0
2022-02-11,Hai Phong City,Hong Bang District,6,1,0,1,0
2022-02-11,Hai Phong City,Hong Bang District,7,17,10,7,5
2022-02-11,Hai Phong City,Hong Bang District,8,33,23,10,5
2022-02-11,Hai Phong City,Hong Bang District,9,46,34,12,6
2022-02-11,Hai Phong City,Hong Bang District,10,92,54,38,22
2022-02-11,Hai Phong City,Hong Bang District,11,154,101,53,41
2022-02-11,Hai Phong City,Hong Bang District,12,82,65,17,9
2022-02-11,Hai Phong City,Hong Bang District,13,45,35,10,2
2022-02-11,Hai Phong City,Hong Bang District,14,50,34,16,8
2022-02-11,Hai Phong City,Hong Bang District,15,50,34,16,9
2022-02-11,Hai Phong City,Hong Bang District,16,53,44,9,6
2022-02-11,Hai Phong City,Hong Bang District,17,75,66,9,3
2022-02-11,Hai Phong City,Hong Bang District,18,75,49,26,16
2022-02-11,Hai Phong City,Hong Bang District,19,56,44,12,6
2022-02-11,Hai Phong City,Hong Bang District,20,39,31,8,1
2022-02-11,Hai Phong City,Hong Bang District,21,20,15,5,1
2022-02-11,Hai Phong City,Kien An District,0,1,0,1,1
2022-02-11,Hai Phong City,Kien An District,7,2,0,2,2
2022-02-11,Hai Phong City,Kien An District,8,7,1,6,4
2022-02-11,Hai Phong City,Kien An District,9,7,4,3,3
2022-02-11,Hai Phong City,Kien An District,10,8,3,5,5
2022-02-11,Hai Phong City,Kien An District,11,10,7,3,1
2022-02-11,Hai Phong City,Kien An District,12,8,7,1,1
2022-02-11,Hai Phong City,Kien An District,13,12,4,8,8
2022-02-11,Hai Phong City,Kien An District,14,6,4,2,1
2022-02-11,Hai Phong City,Kien An District,15,9,5,4,3
2022-02-11,Hai Phong City,Kien An District,16,11,5,6,1
2022-02-11,Hai Phong City,Kien An District,17,12,8,4,3
2022-02-11,Hai Phong City,Kien An District,18,13,7,6,2
2022-02-11,Hai Phong City,Kien An District,19,7,3,4,1
2022-02-11,Hai Phong City,Kien An District,20,14,8,6,3
2022-02-11,Hai Phong City,Kien An District,21,4,1,3,1
2022-02-11,Hai Phong City,Le Chan District,0,2,1,1,1
2022-02-11,Hai Phong City,Le Chan District,2,2,2,0,0
2022-02-11,Hai Phong City,Le Chan District,3,1,1,0,0
2022-02-11,Hai Phong City,Le Chan District,6,1,1,0,0
2022-02-11,Hai Phong City,Le Chan District,7,49,28,21,15
2022-02-11,Hai Phong City,Le Chan District,8,126,87,39,17
2022-02-11,Hai Phong City,Le Chan District,9,123,89,34,17
2022-02-11,Hai Phong City,Le Chan District,10,233,168,65,26
2022-02-11,Hai Phong City,Le Chan District,11,376,254,122,82
2022-02-11,Hai Phong City,Le Chan District,12,208,165,43,17
2022-02-11,Hai Phong City,Le Chan District,13,145,122,23,7
2022-02-11,Hai Phong City,Le Chan District,14,171,132,39,13
2022-02-11,Hai Phong City,Le Chan District,15,245,195,50,19
2022-02-11,Hai Phong City,Le Chan District,16,205,172,33,10
2022-02-11,Hai Phong City,Le Chan District,17,261,202,59,17
2022-02-11,Hai Phong City,Le Chan District,18,301,215,86,43
2022-02-11,Hai Phong City,Le Chan District,19,244,174,70,30
2022-02-11,Hai Phong City,Le Chan District,20,144,109,35,11
2022-02-11,Hai Phong City,Le Chan District,21,67,45,22,8
2022-02-11,Hai Phong City,Le Chan District,22,1,1,0,0
2022-02-11,Hai Phong City,Le Chan District,23,1,1,0,0
2022-02-11,Hai Phong City,Ngo Quyen District,0,2,2,0,0
2022-02-11,Hai Phong City,Ngo Quyen District,1,1,1,0,0
2022-02-11,Hai Phong City,Ngo Quyen District,6,2,1,1,0
2022-02-11,Hai Phong City,Ngo Quyen District,7,59,32,27,16
2022-02-11,Hai Phong City,Ngo Quyen District,8,84,49,35,17
2022-02-11,Hai Phong City,Ngo Quyen District,9,94,78,16,5
2022-02-11,Hai Phong City,Ngo Quyen District,10,139,112,27,12
2022-02-11,Hai Phong City,Ngo Quyen District,11,241,166,75,38
2022-02-11,Hai Phong City,Ngo Quyen District,12,159,125,34,13
2022-02-11,Hai Phong City,Ngo Quyen District,13,105,91,14,3
2022-02-11,Hai Phong City,Ngo Quyen District,14,136,115,21,8
2022-02-11,Hai Phong City,Ngo Quyen District,15,212,166,46,26
2022-02-11,Hai Phong City,Ngo Quyen District,16,166,146,20,3
2022-02-11,Hai Phong City,Ngo Quyen District,17,190,147,43,18
2022-02-11,Hai Phong City,Ngo Quyen District,18,269,166,103,56
2022-02-11,Hai Phong City,Ngo Quyen District,19,174,124,50,24
2022-02-11,Hai Phong City,Ngo Quyen District,20,135,113,22,5
2022-02-11,Hai Phong City,Ngo Quyen District,21,69,51,18,7
2022-02-11,Hai Phong City,Ngo Quyen District,23,2,2,0,0
2022-02-11,Hai Phong City,Thuy Nguyen,8,1,0,1,1
2022-02-11,Hai Phong City,Thuy Nguyen,12,3,0,3,2
2022-02-11,Hai Phong City,Thuy Nguyen,13,1,0,1,0
2022-02-11,Hai Phong City,Thuy Nguyen,14,3,0,3,2
2022-02-11,Hai Phong City,Thuy Nguyen,15,5,0,5,5
2022-02-11,Hai Phong City,Thuy Nguyen,16,3,0,3,1
2022-02-11,Hai Phong City,Thuy Nguyen,17,1,0,1,0
2022-02-11,Hai Phong City,Thuy Nguyen,19,1,0,1,0
2022-02-11,Hue City,Hue City,0,9,7,2,1
2022-02-11,Hue City,Hue City,1,1,1,0,0
2022-02-11,Hue City,Hue City,6,43,36,7,1
2022-02-11,Hue City,Hue City,7,148,134,14,0
2022-02-11,Hue City,Hue City,8,266,245,21,0
2022-02-11,Hue City,Hue City,9,205,198,7,0
2022-02-11,Hue City,Hue City,10,290,271,19,0
2022-02-11,Hue City,Hue City,11,582,542,40,1
2022-02-11,Hue City,Hue City,12,389,368,21,0
2022-02-11,Hue City,Hue City,13,235,223,12,0
2022-02-11,Hue City,Hue City,14,299,268,31,0
2022-02-11,Hue City,Hue City,15,297,279,18,0
2022-02-11,Hue City,Hue City,16,319,297,22,0
2022-02-11,Hue City,Hue City,17,455,411,44,0
2022-02-11,Hue City,Hue City,18,519,478,41,3
2022-02-11,Hue City,Hue City,19,442,392,50,3
2022-02-11,Hue City,Hue City,20,314,272,42,3
2022-02-11,Hue City,Hue City,21,186,150,36,8
2022-02-11,Hue City,Hue City,23,1,1,0,0
2022-02-11,Hue City,Huong Thuy,7,1,1,0,0
2022-02-11,Hue City,Huong Thuy,9,1,1,0,0
2022-02-11,Hue City,Huong Thuy,11,1,1,0,0
2022-02-11,Hue City,Huong Thuy,12,1,1,0,0
2022-02-11,Hue City,Huong Thuy,18,2,2,0,0
2022-02-11,Hue City,Huong Thuy,19,1,0,1,0
2022-02-11,Hue City,Huong Tra,18,1,0,1,0
2022-02-11,Hue City,Phu Vang,11,1,1,0,0
2022-02-11,Hue City,Phu Vang,12,1,0,1,1
2022-02-11,Hue City,Phu Vang,13,2,1,1,0
2022-02-11,Hue City,Phu Vang,16,2,2,0,0
2022-02-11,Hue City,Phu Vang,17,1,1,0,0
2022-02-11,Hue City,Phu Vang,18,2,2,0,0
2022-02-11,Hue City,Phu Vang,19,1,1,0,0
2022-02-11,Hue City,Phu Vang,20,4,2,2,2
2022-02-11,Hue City,Phu Vang,21,1,0,1,0
2022-02-11,Vung Tau,Ba Ria City,0,1,0,1,1
2022-02-11,Vung Tau,Ba Ria City,6,1,0,1,1
2022-02-11,Vung Tau,Ba Ria City,7,1,0,1,1
2022-02-11,Vung Tau,Ba Ria City,8,1,0,1,1
2022-02-11,Vung Tau,Ba Ria City,9,6,2,4,3
2022-02-11,Vung Tau,Ba Ria City,10,11,3,8,7
2022-02-11,Vung Tau,Ba Ria City,11,13,3,10,10
2022-02-11,Vung Tau,Ba Ria City,12,10,1,9,8
2022-02-11,Vung Tau,Ba Ria City,13,4,3,1,1
2022-02-11,Vung Tau,Ba Ria City,14,12,4,8,8
2022-02-11,Vung Tau,Ba Ria City,15,6,1,5,5
2022-02-11,Vung Tau,Ba Ria City,16,6,2,4,4
2022-02-11,Vung Tau,Ba Ria City,17,7,4,3,2
2022-02-11,Vung Tau,Ba Ria City,18,2,0,2,2
2022-02-11,Vung Tau,Ba Ria City,19,3,1,2,2
2022-02-11,Vung Tau,Ba Ria City,20,2,0,2,2
2022-02-11,Vung Tau,Tan Thanh,20,1,0,1,1
2022-02-11,Vung Tau,Tan Thanh,21,1,0,1,1
2022-02-11,Vung Tau,Vung Tau City,2,1,1,0,0
2022-02-11,Vung Tau,Vung Tau City,5,1,1,0,0
2022-02-11,Vung Tau,Vung Tau City,6,25,22,3,0
2022-02-11,Vung Tau,Vung Tau City,7,102,93,9,3
2022-02-11,Vung Tau,Vung Tau City,8,144,132,12,1
2022-02-11,Vung Tau,Vung Tau City,9,127,112,15,1
2022-02-11,Vung Tau,Vung Tau City,10,174,159,15,5
2022-02-11,Vung Tau,Vung Tau City,11,312,283,29,8
2022-02-11,Vung Tau,Vung Tau City,12,246,226,20,2
2022-02-11,Vung Tau,Vung Tau City,13,194,175,19,3
2022-02-11,Vung Tau,Vung Tau City,14,228,213,15,3
2022-02-11,Vung Tau,Vung Tau City,15,215,194,21,1
2022-02-11,Vung Tau,Vung Tau City,16,208,192,16,5
2022-02-11,Vung Tau,Vung Tau City,17,255,232,23,5
2022-02-11,Vung Tau,Vung Tau City,18,264,238,26,6
2022-02-11,Vung Tau,Vung Tau City,19,257,214,43,13
2022-02-11,Vung Tau,Vung Tau City,20,180,147,33,8
2022-02-11,Vung Tau,Vung Tau City,21,100,64,36,22
2022-02-11,Vung Tau,Vung Tau City,22,1,0,1,0
2022-02-11,Vung Tau,Vung Tau City,23,5,2,3,0
2022-02-12,Binh Duong,Ben Cat,9,1,1,0,0
2022-02-12,Binh Duong,Ben Cat,13,1,1,0,0
2022-02-12,Binh Duong,Ben Cat,15,1,1,0,0
2022-02-12,Binh Duong,Di An,7,2,0,2,2
2022-02-12,Binh Duong,Di An,8,12,4,8,4
2022-02-12,Binh Duong,Di An,9,15,7,8,7
2022-02-12,Binh Duong,Di An,10,18,10,8,4
2022-02-12,Binh Duong,Di An,11,25,6,19,14
2022-02-12,Binh Duong,Di An,12,19,7,12,6
2022-02-12,Binh Duong,Di An,13,20,8,12,9
2022-02-12,Binh Duong,Di An,14,12,6,6,5
2022-02-12,Binh Duong,Di An,15,10,9,1,1
2022-02-12,Binh Duong,Di An,16,16,9,7,1
2022-02-12,Binh Duong,Di An,17,11,8,3,3
2022-02-12,Binh Duong,Di An,18,16,7,9,6
2022-02-12,Binh Duong,Di An,19,24,9,15,10
2022-02-12,Binh Duong,Di An,20,17,4,13,7
2022-02-12,Binh Duong,Di An,21,7,1,6,5
2022-02-12,Binh Duong,Tan Uyen,9,1,1,0,0
2022-02-12,Binh Duong,Tan Uyen,11,2,1,1,1
2022-02-12,Binh Duong,Tan Uyen,13,1,0,1,0
2022-02-12,Binh Duong,Tan Uyen,16,1,0,1,1
2022-02-12,Binh Duong,Thu Dau Mot Town,0,1,1,0,0
2022-02-12,Binh Duong,Thu Dau Mot Town,1,1,0,1,0
2022-02-12,Binh Duong,Thu Dau Mot Town,2,1,0,1,0
2022-02-12,Binh Duong,Thu Dau Mot Town,3,1,1,0,0
2022-02-12,Binh Duong,Thu Dau Mot Town,4,1,1,0,0
2022-02-12,Binh Duong,Thu Dau Mot Town,6,24,15,9,8
2022-02-12,Binh Duong,Thu Dau Mot Town,7,82,74,8,2
2022-02-12,Binh Duong,Thu Dau Mot Town,8,182,164,18,1
2022-02-12,Binh Duong,Thu Dau Mot Town,9,208,189,19,1
2022-02-12,Binh Duong,Thu Dau Mot Town,10,316,286,30,4
2022-02-12,Binh Duong,Thu Dau Mot Town,11,492,434,58,24
2022-02-12,Binh Duong,Thu Dau Mot Town,12,435,397,38,18
2022-02-12,Binh Duong,Thu Dau Mot Town,13,335,305,30,3
2022-02-12,Binh Duong,Thu Dau Mot Town,14,274,248,26,6
2022-02-12,Binh Duong,Thu Dau Mot Town,15,239,216,23,4
2022-02-12,Binh Duong,Thu Dau Mot Town,16,225,208,17,4
2022-02-12,Binh Duong,Thu Dau Mot Town,17,262,243,19,3
2022-02-12,Binh Duong,Thu Dau Mot Town,18,327,302,25,8
2022-02-12,Binh Duong,Thu Dau Mot Town,19,268,229,39,21
2022-02-12,Binh Duong,Thu Dau Mot Town,20,252,167,85,55
2022-02-12,Binh Duong,Thu Dau Mot Town,21,103,71,32,11
2022-02-12,Binh Duong,Thu Dau Mot Town,22,1,0,1,0
2022-02-12,Binh Duong,Thuan An,6,1,0,1,0
2022-02-12,Binh Duong,Thuan An,7,6,1,5,5
2022-02-12,Binh Duong,Thuan An,8,10,4,6,3
2022-02-12,Binh Duong,Thuan An,9,35,13,22,18
2022-02-12,Binh Duong,Thuan An,10,55,31,24,14
2022-02-12,Binh Duong,Thuan An,11,76,31,45,35
2022-02-12,Binh Duong,Thuan An,12,49,26,23,21
2022-02-12,Binh Duong,Thuan An,13,45,23,22,12
2022-02-12,Binh Duong,Thuan An,14,45,23,22,11
2022-02-12,Binh Duong,Thuan An,15,48,25,23,19
2022-02-12,Binh Duong,Thuan An,16,28,20,8,3
2022-02-12,Binh Duong,Thuan An,17,28,17,11,5
2022-02-12,Binh Duong,Thuan An,18,34,22,12,7
2022-02-12,Binh Duong,Thuan An,19,36,10,26,23
2022-02-12,Binh Duong,Thuan An,20,30,10,20,19
2022-02-12,Binh Duong,Thuan An,21,14,1,13,10
2022-02-12,Can Tho City,Binh Thuy District,7,1,1,0,0
2022-02-12,Can Tho City,Binh Thuy District,8,2,2,0,0
2022-02-12,Can Tho City,Binh Thuy District,9,5,4,1,0
2022-02-12,Can Tho City,Binh Thuy District,10,3,2,1,0
2022-02-12,Can Tho City,Binh Thuy District,11,7,7,0,0
2022-02-12,Can Tho City,Binh Thuy District,12,6,5,1,0
2022-02-12,Can Tho City,Binh Thuy District,13,3,3,0,0
2022-02-12,Can Tho City,Binh Thuy District,14,15,13,2,0
2022-02-12,Can Tho City,Binh Thuy District,15,10,10,0,0
2022-02-12,Can Tho City,Binh Thuy District,16,10,9,1,0
2022-02-12,Can Tho City,Binh Thuy District,17,11,11,0,0
2022-02-12,Can Tho City,Binh Thuy District,18,12,12,0,0
2022-02-12,Can Tho City,Binh Thuy District,19,11,10,1,0
2022-02-12,Can Tho City,Binh Thuy District,20,7,5,2,0
2022-02-12,Can Tho City,Binh Thuy District,21,2,2,0,0
2022-02-12,Can Tho City,Cai Rang District,7,2,2,0,0
2022-02-12,Can Tho City,Cai Rang District,8,7,7,0,0
2022-02-12,Can Tho City,Cai Rang District,9,3,3,0,0
2022-02-12,Can Tho City,Cai Rang District,10,5,4,1,0
2022-02-12,Can Tho City,Cai Rang District,11,13,12,1,0
2022-02-12,Can Tho City,Cai Rang District,12,5,5,0,0
2022-02-12,Can Tho City,Cai Rang District,13,8,8,0,0
2022-02-12,Can Tho City,Cai Rang District,14,7,6,1,0
2022-02-12,Can Tho City,Cai Rang District,15,4,4,0,0
2022-02-12,Can Tho City,Cai Rang District,16,10,8,2,1
2022-02-12,Can Tho City,Cai Rang District,17,10,10,0,0
2022-02-12,Can Tho City,Cai Rang District,18,8,8,0,0
2022-02-12,Can Tho City,Cai Rang District,19,13,13,0,0
2022-02-12,Can Tho City,Cai Rang District,20,7,5,2,2
2022-02-12,Can Tho City,Cai Rang District,21,2,1,1,0
2022-02-12,Can Tho City,Cai Rang District,22,1,0,1,0
2022-02-12,Can Tho City,Ninh Kieu District,0,9,5,4,0
2022-02-12,Can Tho City,Ninh Kieu District,1,2,2,0,0
2022-02-12,Can Tho City,Ninh Kieu District,2,2,2,0,0
2022-02-12,Can Tho City,Ninh Kieu District,5,1,1,0,0
2022-02-12,Can Tho City,Ninh Kieu District,6,26,24,2,0
2022-02-12,Can Tho City,Ninh Kieu District,7,87,84,3,0
2022-02-12,Can Tho City,Ninh Kieu District,8,185,177,8,0
2022-02-12,Can Tho City,Ninh Kieu District,9,242,230,12,0
2022-02-12,Can Tho City,Ninh Kieu District,10,388,369,19,0
2022-02-12,Can Tho City,Ninh Kieu District,11,605,587,18,0
2022-02-12,Can Tho City,Ninh Kieu District,12,506,480,26,1
2022-02-12,Can Tho City,Ninh Kieu District,13,325,313,12,1
2022-02-12,Can Tho City,Ninh Kieu District,14,295,287,8,0
2022-02-12,Can Tho City,Ninh Kieu District,15,257,245,12,0
2022-02-12,Can Tho City,Ninh Kieu District,16,287,274,13,0
2022-02-12,Can Tho City,Ninh Kieu District,17,351,332,19,0
2022-02-12,Can Tho City,Ninh Kieu District,18,380,361,19,0
2022-02-12,Can Tho City,Ninh Kieu District,19,330,314,16,0
2022-02-12,Can Tho City,Ninh Kieu District,20,277,246,31,0
2022-02-12,Can Tho City,Ninh Kieu District,21,126,114,12,0
2022-02-12,Can Tho City,Ninh Kieu District,22,6,5,1,0
2022-02-12,Can Tho City,Ninh Kieu District,23,1,1,0,0
2022-02-12,Dong Nai,Bien Hoa City,0,3,1,2,0
2022-02-12,Dong Nai,Bien Hoa City,1,2,2,0,0
2022-02-12,Dong Nai,Bien Hoa City,5,1,1,0,0
2022-02-12,Dong Nai,Bien Hoa City,6,27,15,12,8
2022-02-12,Dong Nai,Bien Hoa City,7,138,113,25,13
2022-02-12,Dong Nai,Bien Hoa City,8,250,209,41,9
2022-02-12,Dong Nai,Bien Hoa City,9,365,315,50,12
2022-02-12,Dong Nai,Bien Hoa City,10,637,558,79,18
2022-02-12,Dong Nai,Bien Hoa City,11,856,765,91,21
2022-02-12,Dong Nai,Bien Hoa City,12,771,688,83,17
2022-02-12,Dong Nai,Bien Hoa City,13,645,590,55,12
2022-02-12,Dong Nai,Bien Hoa City,14,500,456,44,7
2022-02-12,Dong Nai,Bien Hoa City,15,448,415,33,4
2022-02-12,Dong Nai,Bien Hoa City,16,449,401,48,13
2022-02-12,Dong Nai,Bien Hoa City,17,555,459,96,50
2022-02-12,Dong Nai,Bien Hoa City,18,683,562,121,59
2022-02-12,Dong Nai,Bien Hoa City,19,623,481,142,89
2022-02-12,Dong Nai,Bien Hoa City,20,499,313,186,132
2022-02-12,Dong Nai,Bien Hoa City,21,283,130,153,119
2022-02-12,Dong Nai,Bien Hoa City,22,2,0,2,0
2022-02-12,Dong Nai,Bien Hoa City,23,1,1,0,0
2022-02-12,Dong Nai,Cam My,15,1,0,1,0
2022-02-12,Dong Nai,Long Khanh,14,1,0,1,1
2022-02-12,Dong Nai,Long Khanh,20,1,0,1,1
2022-02-12,Dong Nai,Long Thanh,10,1,0,1,1
2022-02-12,Dong Nai,Long Thanh,12,2,0,2,1
2022-02-12,Dong Nai,Long Thanh,14,2,0,2,2
2022-02-12,Dong Nai,Long Thanh,16,2,0,2,2
2022-02-12,Dong Nai,Long Thanh,17,1,0,1,1
2022-02-12,Dong Nai,Long Thanh,19,2,0,2,1
2022-02-12,Dong Nai,Long Thanh,20,3,0,3,3
2022-02-12,Dong Nai,Thong Nhat,9,1,1,0,0
2022-02-12,Dong Nai,Thong Nhat,10,1,1,0,0
2022-02-12,Dong Nai,Thong Nhat,11,2,2,0,0
2022-02-12,Dong Nai,Thong Nhat,12,2,2,0,0
2022-02-12,Dong Nai,Thong Nhat,13,1,1,0,0
2022-02-12,Dong Nai,Thong Nhat,14,2,1,1,0
2022-02-12,Dong Nai,Thong Nhat,18,1,1,0,0
2022-02-12,Dong Nai,Thong Nhat,19,2,2,0,0
2022-02-12,Dong Nai,Thong Nhat,20,1,1,0,0
2022-02-12,Dong Nai,Trang Bom,9,1,0,1,1
2022-02-12,Dong Nai,Trang Bom,12,1,0,1,1
2022-02-12,Dong Nai,Trang Bom,13,1,0,1,1
2022-02-12,Dong Nai,Trang Bom,14,1,0,1,1
2022-02-12,Dong Nai,Trang Bom,16,1,1,0,0
2022-02-12,Hai Phong City,An Duong,8,4,1,3,2
2022-02-12,Hai Phong City,An Duong,9,2,1,1,1
2022-02-12,Hai Phong City,An Duong,10,7,3,4,3
2022-02-12,Hai Phong City,An Duong,11,6,1,5,3
2022-02-12,Hai Phong City,An Duong,12,7,3,4,3
2022-02-12,Hai Phong City,An Duong,13,3,3,0,0
2022-02-12,Hai Phong City,An Duong,14,3,1,2,1
2022-02-12,Hai Phong City,An Duong,15,4,1,3,1
2022-02-12,Hai Phong City,An Duong,16,2,0,2,2
2022-02-12,Hai Phong City,An Duong,17,6,1,5,5
2022-02-12,Hai Phong City,An Duong,18,5,0,5,4
2022-02-12,Hai Phong City,An Duong,19,6,1,5,2
2022-02-12,Hai Phong City,An Duong,22,1,1,0,0
2022-02-12,Hai Phong City,Do Son District,18,1,0,1,1
2022-02-12,Hai Phong City,Hai An District,7,5,3,2,1
2022-02-12,Hai Phong City,Hai An District,8,10,9,1,0
2022-02-12,Hai Phong City,Hai An District,9,13,13,0,0
2022-02-12,Hai Phong City,Hai An District,10,23,18,5,1
2022-02-12,Hai Phong City,Hai An District,11,38,31,7,6
2022-02-12,Hai Phong City,Hai An District,12,27,21,6,3
2022-02-12,Hai Phong City,Hai An District,13,22,15,7,1
2022-02-12,Hai Phong City,Hai An District,14,18,13,5,0
2022-02-12,Hai Phong City,Hai An District,15,20,14,6,3
2022-02-12,Hai Phong City,Hai An District,16,38,23,15,7
2022-02-12,Hai Phong City,Hai An District,17,41,25,16,9
2022-02-12,Hai Phong City,Hai An District,18,56,16,40,29
2022-02-12,Hai Phong City,Hai An District,19,55,14,41,31
2022-02-12,Hai Phong City,Hai An District,20,46,14,32,24
2022-02-12,Hai Phong City,Hai An District,21,19,9,10,7
2022-02-12,Hai Phong City,Hong Bang District,1,1,0,1,0
2022-02-12,Hai Phong City,Hong Bang District,2,2,0,2,0
2022-02-12,Hai Phong City,Hong Bang District,7,8,5,3,3
2022-02-12,Hai Phong City,Hong Bang District,8,33,26,7,3
2022-02-12,Hai Phong City,Hong Bang District,9,30,22,8,2
2022-02-12,Hai Phong City,Hong Bang District,10,60,52,8,1
2022-02-12,Hai Phong City,Hong Bang District,11,121,85,36,22
2022-02-12,Hai Phong City,Hong Bang District,12,67,49,18,15
2022-02-12,Hai Phong City,Hong Bang District,13,39,31,8,2
2022-02-12,Hai Phong City,Hong Bang District,14,36,30,6,2
2022-02-12,Hai Phong City,Hong Bang District,15,49,28,21,11
2022-02-12,Hai Phong City,Hong Bang District,16,76,31,45,33
2022-02-12,Hai Phong City,Hong Bang District,17,94,41,53,38
2022-02-12,Hai Phong City,Hong Bang District,18,98,22,76,63
2022-02-12,Hai Phong City,Hong Bang District,19,100,31,69,61
2022-02-12,Hai Phong City,Hong Bang District,20,70,30,40,30
2022-02-12,Hai Phong City,Hong Bang District,21,14,6,8,8
2022-02-12,Hai Phong City,Hong Bang District,23,1,1,0,0
2022-02-12,Hai Phong City,Kien An District,9,8,4,4,4
2022-02-12,Hai Phong City,Kien An District,10,9,8,1,1
2022-02-12,Hai Phong City,Kien An District,11,8,4,4,3
2022-02-12,Hai Phong City,Kien An District,12,16,3,13,12
2022-02-12,Hai Phong City,Kien An District,13,11,6,5,3
2022-02-12,Hai Phong City,Kien An District,14,15,9,6,4
2022-02-12,Hai Phong City,Kien An District,15,6,5,1,0
2022-02-12,Hai Phong City,Kien An District,16,13,3,10,8
2022-02-12,Hai Phong City,Kien An District,17,16,5,11,6
2022-02-12,Hai Phong City,Kien An District,18,9,3,6,5
2022-02-12,Hai Phong City,Kien An District,19,12,2,10,7
2022-02-12,Hai Phong City,Kien An District,20,12,3,9,7
2022-02-12,Hai Phong City,Kien An District,21,3,0,3,3
2022-02-12,Hai Phong City,Le Chan District,0,1,1,0,0
2022-02-12,Hai Phong City,Le Chan District,1,1,1,0,0
2022-02-12,Hai Phong City,Le Chan District,7,46,22,24,14
2022-02-12,Hai Phong City,Le Chan District,8,85,67,18,5
2022-02-12,Hai Phong City,Le Chan District,9,125,94,31,5
2022-02-12,Hai Phong City,Le Chan District,10,191,150,41,9
2022-02-12,Hai Phong City,Le Chan District,11,401,266,135,83
2022-02-12,Hai Phong City,Le Chan District,12,278,199,79,42
2022-02-12,Hai Phong City,Le Chan District,13,141,119,22,2
2022-02-12,Hai Phong City,Le Chan District,14,176,138,38,13
2022-02-12,Hai Phong City,Le Chan District,15,220,135,85,52
2022-02-12,Hai Phong City,Le Chan District,16,294,162,132,97
2022-02-12,Hai Phong City,Le Chan District,17,383,156,227,181
2022-02-12,Hai Phong City,Le Chan District,18,555,168,387,329
2022-02-12,Hai Phong City,Le Chan District,19,432,132,300,243
2022-02-12,Hai Phong City,Le Chan District,20,275,106,169,123
2022-02-12,Hai Phong City,Le Chan District,21,120,52,68,46
2022-02-12,Hai Phong City,Le Chan District,22,2,0,2,0
2022-02-12,Hai Phong City,Le Chan District,23,4,2,2,1
2022-02-12,Hai Phong City,Ngo Quyen District,0,1,1,0,0
2022-02-12,Hai Phong City,Ngo Quyen District,2,1,1,0,0
2022-02-12,Hai Phong City,Ngo Quyen District,3,1,0,1,0
2022-02-12,Hai Phong City,Ngo Quyen District,6,1,1,0,0
2022-02-12,Hai Phong City,Ngo Quyen District,7,29,20,9,3
2022-02-12,Hai Phong City,Ngo Quyen District,8,84,70,14,8
2022-02-12,Hai Phong City,Ngo Quyen District,9,93,69,24,6
2022-02-12,Hai Phong City,Ngo Quyen District,10,142,118,24,4
2022-02-12,Hai Phong City,Ngo Quyen District,11,218,164,54,21
2022-02-12,Hai Phong City,Ngo Quyen District,12,174,135,39,22
2022-02-12,Hai Phong City,Ngo Quyen District,13,112,99,13,3
2022-02-12,Hai Phong City,Ngo Quyen District,14,119,99,20,6
2022-02-12,Hai Phong City,Ngo Quyen District,15,196,138,58,37
2022-02-12,Hai Phong City,Ngo Quyen District,16,198,115,83,61
2022-02-12,Hai Phong City,Ngo Quyen District,17,246,113,133,94
2022-02-12,Hai Phong City,Ngo Quyen District,18,386,127,259,209
2022-02-12,Hai Phong City,Ngo Quyen District,19,388,134,254,205
2022-02-12,Hai Phong City,Ngo Quyen District,20,266,101,165,134
2022-02-12,Hai Phong City,Ngo Quyen District,21,117,53,64,40
2022-02-12,Hai Phong City,Ngo Quyen District,22,1,1,0,0
2022-02-12,Hai Phong City,Thuy Nguyen,10,1,1,0,0
2022-02-12,Hai Phong City,Thuy Nguyen,11,1,0,1,1
2022-02-12,Hai Phong City,Thuy Nguyen,13,4,0,4,1
2022-02-12,Hai Phong City,Thuy Nguyen,14,2,0,2,2
2022-02-12,Hai Phong City,Thuy Nguyen,15,1,0,1,1
2022-02-12,Hai Phong City,Thuy Nguyen,16,7,0,7,2
2022-02-12,Hai Phong City,Thuy Nguyen,18,3,0,3,2
2022-02-12,Hai Phong City,Thuy Nguyen,20,1,0,1,1
2022-02-12,Hai Phong City,Thuy Nguyen,21,1,0,1,1
2022-02-12,Hue City,Hue City,0,8,5,3,1
2022-02-12,Hue City,Hue City,3,1,1,0,0
2022-02-12,Hue City,Hue City,4,1,1,0,0
2022-02-12,Hue City,Hue City,5,4,3,1,0
2022-02-12,Hue City,Hue City,6,43,37,6,3
2022-02-12,Hue City,Hue City,7,153,128,25,0
2022-02-12,Hue City,Hue City,8,254,237,17,1
2022-02-12,Hue City,Hue City,9,234,219,15,1
2022-02-12,Hue City,Hue City,10,300,285,15,0
2022-02-12,Hue City,Hue City,11,575,544,31,0
2022-02-12,Hue City,Hue City,12,347,321,26,0
2022-02-12,Hue City,Hue City,13,246,233,13,0
2022-02-12,Hue City,Hue City,14,227,216,11,0
2022-02-12,Hue City,Hue City,15,325,299,26,0
2022-02-12,Hue City,Hue City,16,379,356,23,2
2022-02-12,Hue City,Hue City,17,419,392,27,0
2022-02-12,Hue City,Hue City,18,526,474,52,3
2022-02-12,Hue City,Hue City,19,446,396,50,3
2022-02-12,Hue City,Hue City,20,371,301,70,12
2022-02-12,Hue City,Hue City,21,241,175,66,26
2022-02-12,Hue City,Hue City,22,4,2,2,0
2022-02-12,Hue City,Hue City,23,4,1,3,1
2022-02-12,Hue City,Huong Thuy,9,1,0,1,1
2022-02-12,Hue City,Huong Thuy,18,2,1,1,1
2022-02-12,Hue City,Huong Thuy,21,1,0,1,0
2022-02-12,Hue City,Huong Tra,17,1,1,0,0
2022-02-12,Hue City,Phu Loc,9,1,0,1,0
2022-02-12,Hue City,Phu Vang,6,1,0,1,0
2022-02-12,Hue City,Phu Vang,11,2,2,0,0
2022-02-12,Hue City,Phu Vang,12,5,5,0,0
2022-02-12,Hue City,Phu Vang,13,1,1,0,0
2022-02-12,Hue City,Phu Vang,14,1,1,0,0
2022-02-12,Hue City,Phu Vang,15,2,2,0,0
2022-02-12,Hue City,Phu Vang,16,1,1,0,0
2022-02-12,Hue City,Phu Vang,17,2,1,1,1
2022-02-12,Hue City,Phu Vang,18,1,1,0,0
2022-02-12,Hue City,Phu Vang,19,1,1,0,0
2022-02-12,Hue City,Phu Vang,20,2,2,0,0
2022-02-12,Hue City,Phu Vang,21,1,1,0,0
2022-02-12,Vung Tau,Ba Ria City,8,1,0,1,1
2022-02-12,Vung Tau,Ba Ria City,9,4,0,4,3
2022-02-12,Vung Tau,Ba Ria City,10,3,2,1,1
2022-02-12,Vung Tau,Ba Ria City,11,6,4,2,2
2022-02-12,Vung Tau,Ba Ria City,12,14,0,14,13
2022-02-12,Vung Tau,Ba Ria City,13,18,7,11,10
2022-02-12,Vung Tau,Ba Ria City,14,2,0,2,2
2022-02-12,Vung Tau,Ba Ria City,15,6,3,3,3
2022-02-12,Vung Tau,Ba Ria City,16,6,1,5,4
2022-02-12,Vung Tau,Ba Ria City,17,4,0,4,4
2022-02-12,Vung Tau,Ba Ria City,18,6,0,6,6
2022-02-12,Vung Tau,Ba Ria City,19,8,0,8,7
2022-02-12,Vung Tau,Ba Ria City,20,5,0,5,5
2022-02-12,Vung Tau,Ba Ria City,21,3,0,3,1
2022-02-12,Vung Tau,Tan Thanh,9,1,0,1,1
2022-02-12,Vung Tau,Tan Thanh,10,1,0,1,1
2022-02-12,Vung Tau,Tan Thanh,12,2,0,2,2
2022-02-12,Vung Tau,Tan Thanh,15,1,0,1,1
2022-02-12,Vung Tau,Vung Tau City,0,1,0,1,1
2022-02-12,Vung Tau,Vung Tau City,1,2,0,2,0
2022-02-12,Vung Tau,Vung Tau City,3,1,0,1,0
2022-02-12,Vung Tau,Vung Tau City,6,28,21,7,3
2022-02-12,Vung Tau,Vung Tau City,7,101,75,26,12
2022-02-12,Vung Tau,Vung Tau City,8,174,151,23,4
2022-02-12,Vung Tau,Vung Tau City,9,166,139,27,0
2022-02-12,Vung Tau,Vung Tau City,10,202,182,20,5
2022-02-12,Vung Tau,Vung Tau City,11,333,306,27,5
2022-02-12,Vung Tau,Vung Tau City,12,301,270,31,6
2022-02-12,Vung Tau,Vung Tau City,13,243,202,41,15
2022-02-12,Vung Tau,Vung Tau City,14,237,205,32,9
2022-02-12,Vung Tau,Vung Tau City,15,217,192,25,1
2022-02-12,Vung Tau,Vung Tau City,16,208,191,17,3
2022-02-12,Vung Tau,Vung Tau City,17,265,238,27,4
2022-02-12,Vung Tau,Vung Tau City,18,364,254,110,80
2022-02-12,Vung Tau,Vung Tau City,19,344,170,174,133
2022-02-12,Vung Tau,Vung Tau City,20,314,115,199,152
2022-02-12,Vung Tau,Vung Tau City,21,177,57,120,88
2022-02-12,Vung Tau,Vung Tau City,22,4,2,2,0
2022-02-12,Vung Tau,Vung Tau City,23,3,1,2,0
2022-02-13,Binh Duong,Ben Cat,12,1,1,0,0
2022-02-13,Binh Duong,Ben Cat,14,1,0,1,1
2022-02-13,Binh Duong,Ben Cat,17,2,0,2,0
2022-02-13,Binh Duong,Ben Cat,18,1,0,1,0
2022-02-13,Binh Duong,Ben Cat,21,2,0,2,2
2022-02-13,Binh Duong,Di An,6,1,0,1,1
2022-02-13,Binh Duong,Di An,7,6,2,4,2
2022-02-13,Binh Duong,Di An,8,1,1,0,0
2022-02-13,Binh Duong,Di An,9,13,9,4,2
2022-02-13,Binh Duong,Di An,10,20,5,15,12
2022-02-13,Binh Duong,Di An,11,23,16,7,6
2022-02-13,Binh Duong,Di An,12,26,8,18,14
2022-02-13,Binh Duong,Di An,13,17,7,10,7
2022-02-13,Binh Duong,Di An,14,21,6,15,12
2022-02-13,Binh Duong,Di An,15,14,6,8,8
2022-02-13,Binh Duong,Di An,16,12,8,4,4
2022-02-13,Binh Duong,Di An,17,10,5,5,3
2022-02-13,Binh Duong,Di An,18,16,11,5,3
2022-02-13,Binh Duong,Di An,19,20,5,15,14
2022-02-13,Binh Duong,Di An,20,12,1,11,4
2022-02-13,Binh Duong,Di An,21,8,1,7,6
2022-02-13,Binh Duong,Tan Uyen,7,1,1,0,0
2022-02-13,Binh Duong,Tan Uyen,8,1,0,1,0
2022-02-13,Binh Duong,Tan Uyen,11,3,2,1,1
2022-02-13,Binh Duong,Tan Uyen,13,1,1,0,0
2022-02-13,Binh Duong,Tan Uyen,14,2,1,1,1
2022-02-13,Binh Duong,Tan Uyen,15,1,1,0,0
2022-02-13,Binh Duong,Tan Uyen,17,2,1,1,1
2022-02-13,Binh Duong,Tan Uyen,19,1,0,1,1
2022-02-13,Binh Duong,Tan Uyen,20,2,0,2,2
2022-02-13,Binh Duong,Thu Dau Mot Town,0,1,0,1,0
2022-02-13,Binh Duong,Thu Dau Mot Town,6,22,13,9,7
2022-02-13,Binh Duong,Thu Dau Mot Town,7,96,71,25,19
2022-02-13,Binh Duong,Thu Dau Mot Town,8,183,151,32,16
2022-02-13,Binh Duong,Thu Dau Mot Town,9,206,190,16,4
2022-02-13,Binh Duong,Thu Dau Mot Town,10,333,299,34,14
2022-02-13,Binh Duong,Thu Dau Mot Town,11,597,382,215,164
2022-02-13,Binh Duong,Thu Dau Mot Town,12,533,332,201,158
2022-02-13,Binh Duong,Thu Dau Mot Town,13,364,332,32,12
2022-02-13,Binh Duong,Thu Dau Mot Town,14,254,233,21,5
2022-02-13,Binh Duong,Thu Dau Mot Town,15,276,233,43,22
2022-02-13,Binh Duong,Thu Dau Mot Town,16,264,193,71,50
2022-02-13,Binh Duong,Thu Dau Mot Town,17,351,234,117,70
2022-02-13,Binh Duong,Thu Dau Mot Town,18,349,254,95,66
2022-02-13,Binh Duong,Thu Dau Mot Town,19,347,220,127,95
2022-02-13,Binh Duong,Thu Dau Mot Town,20,268,143,125,94
2022-02-13,Binh Duong,Thu Dau Mot Town,21,126,67,59,35
2022-02-13,Binh Duong,Thu Dau Mot Town,22,1,0,1,0
2022-02-13,Binh Duong,Thuan An,7,2,1,1,1
2022-02-13,Binh Duong,Thuan An,8,17,8,9,7
2022-02-13,Binh Duong,Thuan An,9,25,15,10,7
2022-02-13,Binh Duong,Thuan An,10,50,26,24,16
2022-02-13,Binh Duong,Thuan An,11,60,38,22,15
2022-02-13,Binh Duong,Thuan An,12,65,30,35,33
2022-02-13,Binh Duong,Thuan An,13,61,35,26,22
2022-02-13,Binh Duong,Thuan An,14,58,18,40,31
2022-02-13,Binh Duong,Thuan An,15,44,22,22,16
2022-02-13,Binh Duong,Thuan An,16,43,26,17,14
2022-02-13,Binh Duong,Thuan An,17,39,21,18,10
2022-02-13,Binh Duong,Thuan An,18,36,18,18,12
2022-02-13,Binh Duong,Thuan An,19,46,20,26,19
2022-02-13,Binh Duong,Thuan An,20,21,9,12,9
2022-02-13,Binh Duong,Thuan An,21,22,2,20,18
2022-02-13,Can Tho City,Binh Thuy District,8,3,2,1,0
2022-02-13,Can Tho City,Binh Thuy District,9,6,6,0,0
2022-02-13,Can Tho City,Binh Thuy District,10,14,14,0,0
2022-02-13,Can Tho City,Binh Thuy District,11,17,16,1,1
2022-02-13,Can Tho City,Binh Thuy District,12,13,12,1,0
2022-02-13,Can Tho City,Binh Thuy District,13,14,12,2,0
2022-02-13,Can Tho City,Binh Thuy District,14,6,6,0,0
2022-02-13,Can Tho City,Binh Thuy District,15,15,13,2,1
2022-02-13,Can Tho City,Binh Thuy District,16,7,6,1,0
2022-02-13,Can Tho City,Binh Thuy District,17,13,13,0,0
2022-02-13,Can Tho City,Binh Thuy District,18,13,13,0,0
2022-02-13,Can Tho City,Binh Thuy District,19,6,6,0,0
2022-02-13,Can Tho City,Binh Thuy District,20,9,9,0,0
2022-02-13,Can Tho City,Binh Thuy District,21,3,2,1,0
2022-02-13,Can Tho City,Cai Rang District,0,2,1,1,0
2022-02-13,Can Tho City,Cai Rang District,6,3,3,0,0
2022-02-13,Can Tho City,Cai Rang District,7,2,1,1,0
2022-02-13,Can Tho City,Cai Rang District,8,6,5,1,0
2022-02-13,Can Tho City,Cai Rang District,9,7,6,1,0
2022-02-13,Can Tho City,Cai Rang District,10,10,9,1,0
2022-02-13,Can Tho City,Cai Rang District,11,11,10,1,0
2022-02-13,Can Tho City,Cai Rang District,12,8,7,1,0
2022-02-13,Can Tho City,Cai Rang District,13,5,4,1,0
2022-02-13,Can Tho City,Cai Rang District,14,3,3,0,0
2022-02-13,Can Tho City,Cai Rang District,15,11,10,1,0
2022-02-13,Can Tho City,Cai Rang District,16,6,6,0,0
2022-02-13,Can Tho City,Cai Rang District,17,6,5,1,0
2022-02-13,Can Tho City,Cai Rang District,18,15,10,5,1
2022-02-13,Can Tho City,Cai Rang District,19,7,7,0,0
2022-02-13,Can Tho City,Cai Rang District,20,10,8,2,0
2022-02-13,Can Tho City,Cai Rang District,21,1,1,0,0
2022-02-13,Can Tho City,Ninh Kieu District,0,3,3,0,0
2022-02-13,Can Tho City,Ninh Kieu District,1,2,1,1,0
2022-02-13,Can Tho City,Ninh Kieu District,3,2,2,0,0
2022-02-13,Can Tho City,Ninh Kieu District,6,32,29,3,0
2022-02-13,Can Tho City,Ninh Kieu District,7,122,118,4,0
2022-02-13,Can Tho City,Ninh Kieu District,8,183,167,16,0
2022-02-13,Can Tho City,Ninh Kieu District,9,265,256,9,0
2022-02-13,Can Tho City,Ninh Kieu District,10,376,350,26,0
2022-02-13,Can Tho City,Ninh Kieu District,11,557,527,30,0
2022-02-13,Can Tho City,Ninh Kieu District,12,516,490,26,0
2022-02-13,Can Tho City,Ninh Kieu District,13,359,345,14,0
2022-02-13,Can Tho City,Ninh Kieu District,14,282,273,9,0
2022-02-13,Can Tho City,Ninh Kieu District,15,294,272,22,0
2022-02-13,Can Tho City,Ninh Kieu District,16,327,306,21,0
2022-02-13,Can Tho City,Ninh Kieu District,17,327,312,15,0
2022-02-13,Can Tho City,Ninh Kieu District,18,373,345,28,0
2022-02-13,Can Tho City,Ninh Kieu District,19,353,327,26,0
2022-02-13,Can Tho City,Ninh Kieu District,20,275,247,28,0
2022-02-13,Can Tho City,Ninh Kieu District,21,137,118,19,0
2022-02-13,Can Tho City,Ninh Kieu District,22,8,3,5,0
2022-02-13,Can Tho City,Ninh Kieu District,23,2,1,1,0
2022-02-13,Dong Nai,Bien Hoa City,0,2,2,0,0
2022-02-13,Dong Nai,Bien Hoa City,1,3,2,1,0
2022-02-13,Dong Nai,Bien Hoa City,2,3,1,2,0
2022-02-13,Dong Nai,Bien Hoa City,6,29,7,22,18
2022-02-13,Dong Nai,Bien Hoa City,7,131,108,23,16
2022-02-13,Dong Nai,Bien Hoa City,8,238,200,38,8
2022-02-13,Dong Nai,Bien Hoa City,9,360,308,52,10
2022-02-13,Dong Nai,Bien Hoa City,10,656,542,114,46
2022-02-13,Dong Nai,Bien Hoa City,11,1032,753,279,179
2022-02-13,Dong Nai,Bien Hoa City,12,887,677,210,148
2022-02-13,Dong Nai,Bien Hoa City,13,615,506,109,52
2022-02-13,Dong Nai,Bien Hoa City,14,524,415,109,63
2022-02-13,Dong Nai,Bien Hoa City,15,489,337,152,101
2022-02-13,Dong Nai,Bien Hoa City,16,549,367,182,128
2022-02-13,Dong Nai,Bien Hoa City,17,538,384,154,91
2022-02-13,Dong Nai,Bien Hoa City,18,666,467,199,138
2022-02-13,Dong Nai,Bien Hoa City,19,627,410,217,161
2022-02-13,Dong Nai,Bien Hoa City,20,447,291,156,96
2022-02-13,Dong Nai,Bien Hoa City,21,214,118,96,63
2022-02-13,Dong Nai,Bien Hoa City,22,4,1,3,1
2022-02-13,Dong Nai,Long Khanh,16,1,0,1,1
2022-02-13,Dong Nai,Long Thanh,10,1,0,1,1
2022-02-13,Dong Nai,Long Thanh,13,2,0,2,2
2022-02-13,Dong Nai,Long Thanh,14,2,0,2,2
2022-02-13,Dong Nai,Long Thanh,15,2,0,2,2
2022-02-13,Dong Nai,Long Thanh,16,1,0,1,1
2022-02-13,Dong Nai,Long Thanh,18,1,0,1,1
2022-02-13,Dong Nai,Long Thanh,20,3,0,3,3
2022-02-13,Dong Nai,Long Thanh,21,1,0,1,1
2022-02-13,Dong Nai,Thong Nhat,8,2,2,0,0
2022-02-13,Dong Nai,Thong Nhat,9,1,1,0,0
2022-02-13,Dong Nai,Thong Nhat,10,3,3,0,0
2022-02-13,Dong Nai,Thong Nhat,11,1,0,1,1
2022-02-13,Dong Nai,Thong Nhat,12,4,4,0,0
2022-02-13,Dong Nai,Thong Nhat,13,1,1,0,0
2022-02-13,Dong Nai,Thong Nhat,17,1,1,0,0
2022-02-13,Dong Nai,Thong Nhat,18,1,1,0,0
2022-02-13,Dong Nai,Thong Nhat,19,2,1,1,1
2022-02-13,Dong Nai,Thong Nhat,20,3,3,0,0
2022-02-13,Dong Nai,Trang Bom,14,1,0,1,1
2022-02-13,Dong Nai,Trang Bom,21,1,0,1,1
2022-02-13,Dong Nai,Vinh Cuu,17,1,0,1,1
2022-02-13,Hai Phong City,An Duong,4,1,0,1,1
2022-02-13,Hai Phong City,An Duong,8,2,1,1,1
2022-02-13,Hai Phong City,An Duong,9,2,1,1,0
2022-02-13,Hai Phong City,An Duong,10,4,1,3,3
2022-02-13,Hai Phong City,An Duong,11,4,1,3,2
2022-02-13,Hai Phong City,An Duong,12,4,2,2,2
2022-02-13,Hai Phong City,An Duong,13,6,2,4,3
2022-02-13,Hai Phong City,An Duong,14,8,1,7,3
2022-02-13,Hai Phong City,An Duong,15,5,1,4,3
2022-02-13,Hai Phong City,An Duong,16,5,2,3,1
2022-02-13,Hai Phong City,An Duong,17,3,1,2,2
2022-02-13,Hai Phong City,An Duong,18,4,0,4,1
2022-02-13,Hai Phong City,An Duong,19,2,0,2,2
2022-02-13,Hai Phong City,An Duong,20,3,1,2,2
2022-02-13,Hai Phong City,An Duong,21,1,0,1,1
2022-02-13,Hai Phong City,An Duong,23,1,0,1,1
2022-02-13,Hai Phong City,Do Son District,11,1,0,1,0
2022-02-13,Hai Phong City,Do Son District,14,1,0,1,0
2022-02-13,Hai Phong City,Duong Kinh District,18,1,0,1,1
2022-02-13,Hai Phong City,Hai An District,6,1,0,1,0
2022-02-13,Hai Phong City,Hai An District,7,6,4,2,2
2022-02-13,Hai Phong City,Hai An District,8,10,8,2,1
2022-02-13,Hai Phong City,Hai An District,9,17,8,9,5
2022-02-13,Hai Phong City,Hai An District,10,29,21,8,6
2022-02-13,Hai Phong City,Hai An District,11,34,16,18,13
2022-02-13,Hai Phong City,Hai An District,12,36,20,16,9
2022-02-13,Hai Phong City,Hai An District,13,25,22,3,2
2022-02-13,Hai Phong City,Hai An District,14,10,6,4,1
2022-02-13,Hai Phong City,Hai An District,15,18,13,5,1
2022-02-13,Hai Phong City,Hai An District,16,31,22,9,3
2022-02-13,Hai Phong City,Hai An District,17,21,17,4,2
2022-02-13,Hai Phong City,Hai An District,18,27,17,10,6
2022-02-13,Hai Phong City,Hai An District,19,36,17,19,14
2022-02-13,Hai Phong City,Hai An District,20,17,10,7,5
2022-02-13,Hai Phong City,Hai An District,21,6,4,2,2
2022-02-13,Hai Phong City,Hai An District,22,2,0,2,0
2022-02-13,Hai Phong City,Hai An District,23,3,2,1,0
2022-02-13,Hai Phong City,Hong Bang District,0,1,1,0,0
2022-02-13,Hai Phong City,Hong Bang District,5,1,0,1,1
2022-02-13,Hai Phong City,Hong Bang District,7,12,10,2,0
2022-02-13,Hai Phong City,Hong Bang District,8,29,17,12,8
2022-02-13,Hai Phong City,Hong Bang District,9,47,34,13,6
2022-02-13,Hai Phong City,Hong Bang District,10,62,39,23,12
2022-02-13,Hai Phong City,Hong Bang District,11,106,58,48,31
2022-02-13,Hai Phong City,Hong Bang District,12,82,47,35,27
2022-02-13,Hai Phong City,Hong Bang District,13,36,29,7,5
2022-02-13,Hai Phong City,Hong Bang District,14,35,22,13,6
2022-02-13,Hai Phong City,Hong Bang District,15,43,32,11,6
2022-02-13,Hai Phong City,Hong Bang District,16,56,35,21,12
2022-02-13,Hai Phong City,Hong Bang District,17,57,33,24,18
2022-02-13,Hai Phong City,Hong Bang District,18,87,41,46,29
2022-02-13,Hai Phong City,Hong Bang District,19,82,38,44,36
2022-02-13,Hai Phong City,Hong Bang District,20,55,13,42,29
2022-02-13,Hai Phong City,Hong Bang District,21,18,6,12,6
2022-02-13,Hai Phong City,Hong Bang District,23,2,0,2,1
2022-02-13,Hai Phong City,Kien An District,8,5,0,5,5
2022-02-13,Hai Phong City,Kien An District,9,8,4,4,3
2022-02-13,Hai Phong City,Kien An District,10,8,4,4,3
2022-02-13,Hai Phong City,Kien An District,11,24,8,16,15
2022-02-13,Hai Phong City,Kien An District,12,9,7,2,1
2022-02-13,Hai Phong City,Kien An District,13,18,10,8,7
2022-02-13,Hai Phong City,Kien An District,14,10,7,3,2
2022-02-13,Hai Phong City,Kien An District,15,14,7,7,3
2022-02-13,Hai Phong City,Kien An District,16,15,5,10,6
2022-02-13,Hai Phong City,Kien An District,17,10,4,6,4
2022-02-13,Hai Phong City,Kien An District,18,15,9,6,4
2022-02-13,Hai Phong City,Kien An District,19,12,2,10,7
2022-02-13,Hai Phong City,Kien An District,20,11,3,8,5
2022-02-13,Hai Phong City,Kien An District,21,7,1,6,2
2022-02-13,Hai Phong City,Le Chan District,0,4,3,1,0
2022-02-13,Hai Phong City,Le Chan District,1,2,1,1,0
2022-02-13,Hai Phong City,Le Chan District,3,3,1,2,0
2022-02-13,Hai Phong City,Le Chan District,6,5,2,3,0
2022-02-13,Hai Phong City,Le Chan District,7,25,11,14,3
2022-02-13,Hai Phong City,Le Chan District,8,76,53,23,13
2022-02-13,Hai Phong City,Le Chan District,9,101,74,27,10
2022-02-13,Hai Phong City,Le Chan District,10,224,156,68,44
2022-02-13,Hai Phong City,Le Chan District,11,396,220,176,127
2022-02-13,Hai Phong City,Le Chan District,12,324,184,140,97
2022-02-13,Hai Phong City,Le Chan District,13,216,149,67,39
2022-02-13,Hai Phong City,Le Chan District,14,137,111,26,7
2022-02-13,Hai Phong City,Le Chan District,15,209,152,57,26
2022-02-13,Hai Phong City,Le Chan District,16,235,157,78,54
2022-02-13,Hai Phong City,Le Chan District,17,287,171,116,68
2022-02-13,Hai Phong City,Le Chan District,18,378,186,192,148
2022-02-13,Hai Phong City,Le Chan District,19,339,151,188,147
2022-02-13,Hai Phong City,Le Chan District,20,209,107,102,64
2022-02-13,Hai Phong City,Le Chan District,21,105,55,50,26
2022-02-13,Hai Phong City,Le Chan District,22,5,3,2,0
2022-02-13,Hai Phong City,Le Chan District,23,2,0,2,0
2022-02-13,Hai Phong City,Ngo Quyen District,0,1,1,0,0
2022-02-13,Hai Phong City,Ngo Quyen District,1,1,0,1,0
2022-02-13,Hai Phong City,Ngo Quyen District,2,2,0,2,1
2022-02-13,Hai Phong City,Ngo Quyen District,6,5,4,1,1
2022-02-13,Hai Phong City,Ngo Quyen District,7,26,16,10,5
2022-02-13,Hai Phong City,Ngo Quyen District,8,90,55,35,20
2022-02-13,Hai Phong City,Ngo Quyen District,9,117,78,39,17
2022-02-13,Hai Phong City,Ngo Quyen District,10,166,122,44,21
2022-02-13,Hai Phong City,Ngo Quyen District,11,260,158,102,69
2022-02-13,Hai Phong City,Ngo Quyen District,12,212,126,86,68
2022-02-13,Hai Phong City,Ngo Quyen District,13,141,108,33,13
2022-02-13,Hai Phong City,Ngo Quyen District,14,110,86,24,9
2022-02-13,Hai Phong City,Ngo Quyen District,15,166,128,38,20
2022-02-13,Hai Phong City,Ngo Quyen District,16,201,147,54,26
2022-02-13,Hai Phong City,Ngo Quyen District,17,242,151,91,54
2022-02-13,Hai Phong City,Ngo Quyen District,18,307,149,158,113
2022-02-13,Hai Phong City,Ngo Quyen District,19,253,124,129,87
2022-02-13,Hai Phong City,Ngo Quyen District,20,187,94,93,63
2022-02-13,Hai Phong City,Ngo Quyen District,21,78,37,41,13
2022-02-13,Hai Phong City,Ngo Quyen District,22,6,4,2,0
2022-02-13,Hai Phong City,Ngo Quyen District,23,3,1,2,0
2022-02-13,Hai Phong City,Thuy Nguyen,7,1,0,1,1
2022-02-13,Hai Phong City,Thuy Nguyen,9,1,0,1,1
2022-02-13,Hai Phong City,Thuy Nguyen,10,1,0,1,1
2022-02-13,Hai Phong City,Thuy Nguyen,11,1,0,1,1
2022-02-13,Hai Phong City,Thuy Nguyen,12,2,0,2,2
2022-02-13,Hai Phong City,Thuy Nguyen,13,2,0,2,2
2022-02-13,Hai Phong City,Thuy Nguyen,14,1,0,1,1
2022-02-13,Hai Phong City,Thuy Nguyen,15,2,1,1,1
2022-02-13,Hai Phong City,Thuy Nguyen,16,1,0,1,0
2022-02-13,Hai Phong City,Thuy Nguyen,17,1,0,1,1
2022-02-13,Hai Phong City,Thuy Nguyen,19,2,0,2,1
2022-02-13,Hai Phong City,Thuy Nguyen,21,2,0,2,1
2022-02-13,Hue City,Hue City,0,1,1,0,0
2022-02-13,Hue City,Hue City,1,1,1,0,0
2022-02-13,Hue City,Hue City,2,1,1,0,0
2022-02-13,Hue City,Hue City,3,1,1,0,0
2022-02-13,Hue City,Hue City,4,4,4,0,0
2022-02-13,Hue City,Hue City,5,1,0,1,1
2022-02-13,Hue City,Hue City,6,32,31,1,1
2022-02-13,Hue City,Hue City,7,161,135,26,3
2022-02-13,Hue City,Hue City,8,269,252,17,0
2022-02-13,Hue City,Hue City,9,245,221,24,0
2022-02-13,Hue City,Hue City,10,273,254,19,0
2022-02-13,Hue City,Hue City,11,534,501,33,2
2022-02-13,Hue City,Hue City,12,447,411,36,0
2022-02-13,Hue City,Hue City,13,250,237,13,0
2022-02-13,Hue City,Hue City,14,268,251,17,0
2022-02-13,Hue City,Hue City,15,321,297,24,3
2022-02-13,Hue City,Hue City,16,346,316,30,0
2022-02-13,Hue City,Hue City,17,488,427,61,3
2022-02-13,Hue City,Hue City,18,536,466,70,14
2022-02-13,Hue City,Hue City,19,631,436,195,113
2022-02-13,Hue City,Hue City,20,572,363,209,143
2022-02-13,Hue City,Hue City,21,257,160,97,38
2022-02-13,Hue City,Hue City,22,7,0,7,0
2022-02-13,Hue City,Hue City,23,6,3,3,1
2022-02-13,Hue City,Huong Thuy,10,1,0,1,0
2022-02-13,Hue City,Huong Thuy,11,1,0,1,0
2022-02-13,Hue City,Huong Thuy,18,1,0,1,0
2022-02-13,Hue City,Huong Thuy,19,3,2,1,1
2022-02-13,Hue City,Huong Thuy,20,2,0,2,2
2022-02-13,Hue City,Huong Thuy,21,1,1,0,0
2022-02-13,Hue City,Huong Tra,13,1,1,0,0
2022-02-13,Hue City,Phu Vang,7,2,1,1,0
2022-02-13,Hue City,Phu Vang,8,2,1,1,0
2022-02-13,Hue City,Phu Vang,11,1,1,0,0
2022-02-13,Hue City,Phu Vang,13,1,1,0,0
2022-02-13,Hue City,Phu Vang,16,1,0,1,1
2022-02-13,Hue City,Phu Vang,18,1,1,0,0
2022-02-13,Hue City,Phu Vang,19,4,1,3,3
2022-02-13,Hue City,Phu Vang,20,3,1,2,1
2022-02-13,Hue City,Phu Vang,21,4,1,3,3
2022-02-13,Vung Tau,Ba Ria City,7,2,0,2,2
2022-02-13,Vung Tau,Ba Ria City,8,5,1,4,4
2022-02-13,Vung Tau,Ba Ria City,9,1,0,1,0
2022-02-13,Vung Tau,Ba Ria City,10,12,2,10,9
2022-02-13,Vung Tau,Ba Ria City,11,7,1,6,4
2022-02-13,Vung Tau,Ba Ria City,12,6,3,3,2
2022-02-13,Vung Tau,Ba Ria City,13,9,4,5,5
2022-02-13,Vung Tau,Ba Ria City,14,4,4,0,0
2022-02-13,Vung Tau,Ba Ria City,15,5,2,3,3
2022-02-13,Vung Tau,Ba Ria City,16,8,3,5,4
2022-02-13,Vung Tau,Ba Ria City,17,6,2,4,4
2022-02-13,Vung Tau,Ba Ria City,18,3,1,2,2
2022-02-13,Vung Tau,Ba Ria City,19,10,0,10,8
2022-02-13,Vung Tau,Ba Ria City,20,1,0,1,1
2022-02-13,Vung Tau,Ba Ria City,21,1,0,1,1
2022-02-13,Vung Tau,Tan Thanh,10,2,0,2,1
2022-02-13,Vung Tau,Tan Thanh,11,1,0,1,1
2022-02-13,Vung Tau,Tan Thanh,14,1,0,1,0
2022-02-13,Vung Tau,Tan Thanh,16,1,0,1,1
2022-02-13,Vung Tau,Tan Thanh,19,1,0,1,1
2022-02-13,Vung Tau,Vung Tau City,0,6,3,3,0
2022-02-13,Vung Tau,Vung Tau City,2,1,1,0,0
2022-02-13,Vung Tau,Vung Tau City,4,1,1,0,0
2022-02-13,Vung Tau,Vung Tau City,6,25,18,7,3
2022-02-13,Vung Tau,Vung Tau City,7,116,94,22,8
2022-02-13,Vung Tau,Vung Tau City,8,167,138,29,8
2022-02-13,Vung Tau,Vung Tau City,9,195,155,40,4
2022-02-13,Vung Tau,Vung Tau City,10,229,193,36,6
2022-02-13,Vung Tau,Vung Tau City,11,331,273,58,24
2022-02-13,Vung Tau,Vung Tau City,12,301,247,54,23
2022-02-13,Vung Tau,Vung Tau City,13,238,207,31,2
2022-02-13,Vung Tau,Vung Tau City,14,198,181,17,1
2022-02-13,Vung Tau,Vung Tau City,15,225,207,18,2
2022-02-13,Vung Tau,Vung Tau City,16,202,172,30,9
2022-02-13,Vung Tau,Vung Tau City,17,277,222,55,22
2022-02-13,Vung Tau,Vung Tau City,18,314,243,71,40
2022-02-13,Vung Tau,Vung Tau City,19,287,215,72,46
2022-02-13,Vung Tau,Vung Tau City,20,167,127,40,22
2022-02-13,Vung Tau,Vung Tau City,21,102,71,31,14
2022-02-13,Vung Tau,Vung Tau City,22,2,0,2,0
2022-02-14,Binh Duong,Ben Cat,12,2,1,1,1
2022-02-14,Binh Duong,Ben Cat,15,1,0,1,1
2022-02-14,Binh Duong,Ben Cat,17,2,0,2,2
2022-02-14,Binh Duong,Di An,7,6,1,5,5
2022-02-14,Binh Duong,Di An,8,9,4,5,5
2022-02-14,Binh Duong,Di An,9,18,5,13,11
2022-02-14,Binh Duong,Di An,10,30,6,24,24
2022-02-14,Binh Duong,Di An,11,45,10,35,28
2022-02-14,Binh Duong,Di An,12,37,9,28,20
2022-02-14,Binh Duong,Di An,13,29,9,20,17
2022-02-14,Binh Duong,Di An,14,20,10,10,8
2022-02-14,Binh Duong,Di An,15,17,11,6,6
2022-02-14,Binh Duong,Di An,16,8,1,7,6
2022-02-14,Binh Duong,Di An,17,16,4,12,10
2022-02-14,Binh Duong,Di An,18,31,8,23,21
2022-02-14,Binh Duong,Di An,19,26,11,15,14
2022-02-14,Binh Duong,Di An,20,16,3,13,11
2022-02-14,Binh Duong,Di An,21,11,5,6,4
2022-02-14,Binh Duong,Tan Uyen,10,1,1,0,0
2022-02-14,Binh Duong,Tan Uyen,11,1,0,1,1
2022-02-14,Binh Duong,Tan Uyen,12,2,2,0,0
2022-02-14,Binh Duong,Tan Uyen,15,1,1,0,0
2022-02-14,Binh Duong,Tan Uyen,16,1,1,0,0
2022-02-14,Binh Duong,Tan Uyen,18,2,1,1,1
2022-02-14,Binh Duong,Tan Uyen,19,1,0,1,1
2022-02-14,Binh Duong,Tan Uyen,20,1,0,1,1
2022-02-14,Binh Duong,Thu Dau Mot Town,1,1,1,0,0
2022-02-14,Binh Duong,Thu Dau Mot Town,3,1,1,0,0
2022-02-14,Binh Duong,Thu Dau Mot Town,6,24,20,4,3
2022-02-14,Binh Duong,Thu Dau Mot Town,7,75,69,6,0
2022-02-14,Binh Duong,Thu Dau Mot Town,8,176,157,19,3
2022-02-14,Binh Duong,Thu Dau Mot Town,9,210,195,15,2
2022-02-14,Binh Duong,Thu Dau Mot Town,10,370,313,57,21
2022-02-14,Binh Duong,Thu Dau Mot Town,11,686,509,177,135
2022-02-14,Binh Duong,Thu Dau Mot Town,12,470,368,102,61
2022-02-14,Binh Duong,Thu Dau Mot Town,13,352,293,59,21
2022-02-14,Binh Duong,Thu Dau Mot Town,14,307,241,66,39
2022-02-14,Binh Duong,Thu Dau Mot Town,15,179,145,34,13
2022-02-14,Binh Duong,Thu Dau Mot Town,16,255,153,102,72
2022-02-14,Binh Duong,Thu Dau Mot Town,17,365,217,148,110
2022-02-14,Binh Duong,Thu Dau Mot Town,18,485,243,242,187
2022-02-14,Binh Duong,Thu Dau Mot Town,19,456,214,242,201
2022-02-14,Binh Duong,Thu Dau Mot Town,20,321,162,159,112
2022-02-14,Binh Duong,Thu Dau Mot Town,21,153,89,64,34
2022-02-14,Binh Duong,Thu Dau Mot Town,22,3,1,2,0
2022-02-14,Binh Duong,Thuan An,6,1,0,1,1
2022-02-14,Binh Duong,Thuan An,7,5,2,3,2
2022-02-14,Binh Duong,Thuan An,8,13,5,8,7
2022-02-14,Binh Duong,Thuan An,9,36,9,27,24
2022-02-14,Binh Duong,Thuan An,10,83,26,57,44
2022-02-14,Binh Duong,Thuan An,11,106,34,72,60
2022-02-14,Binh Duong,Thuan An,12,96,26,70,55
2022-02-14,Binh Duong,Thuan An,13,81,26,55,43
2022-02-14,Binh Duong,Thuan An,14,56,19,37,27
2022-02-14,Binh Duong,Thuan An,15,26,17,9,8
2022-02-14,Binh Duong,Thuan An,16,31,15,16,12
2022-02-14,Binh Duong,Thuan An,17,37,12,25,19
2022-02-14,Binh Duong,Thuan An,18,67,19,48,35
2022-02-14,Binh Duong,Thuan An,19,54,17,37,31
2022-02-14,Binh Duong,Thuan An,20,25,7,18,15
2022-02-14,Binh Duong,Thuan An,21,19,3,16,11
2022-02-14,Can Tho City,Binh Thuy District,6,2,2,0,0
2022-02-14,Can Tho City,Binh Thuy District,8,1,1,0,0
2022-02-14,Can Tho City,Binh Thuy District,9,2,2,0,0
2022-02-14,Can Tho City,Binh Thuy District,10,9,7,2,0
2022-02-14,Can Tho City,Binh Thuy District,11,17,16,1,0
2022-02-14,Can Tho City,Binh Thuy District,12,9,9,0,0
2022-02-14,Can Tho City,Binh Thuy District,13,7,5,2,1
2022-02-14,Can Tho City,Binh Thuy District,14,5,5,0,0
2022-02-14,Can Tho City,Binh Thuy District,15,14,14,0,0
2022-02-14,Can Tho City,Binh Thuy District,16,8,8,0,0
2022-02-14,Can Tho City,Binh Thuy District,17,10,8,2,0
2022-02-14,Can Tho City,Binh Thuy District,18,8,8,0,0
2022-02-14,Can Tho City,Binh Thuy District,19,20,15,5,2
2022-02-14,Can Tho City,Binh Thuy District,20,4,4,0,0
2022-02-14,Can Tho City,Binh Thuy District,21,3,1,2,2
2022-02-14,Can Tho City,Cai Rang District,6,1,1,0,0
2022-02-14,Can Tho City,Cai Rang District,7,1,1,0,0
2022-02-14,Can Tho City,Cai Rang District,8,3,2,1,1
2022-02-14,Can Tho City,Cai Rang District,9,2,1,1,1
2022-02-14,Can Tho City,Cai Rang District,10,9,6,3,0
2022-02-14,Can Tho City,Cai Rang District,11,13,9,4,1
2022-02-14,Can Tho City,Cai Rang District,12,8,6,2,0
2022-02-14,Can Tho City,Cai Rang District,13,7,6,1,1
2022-02-14,Can Tho City,Cai Rang District,14,10,8,2,0
2022-02-14,Can Tho City,Cai Rang District,15,12,9,3,0
2022-02-14,Can Tho City,Cai Rang District,16,8,6,2,0
2022-02-14,Can Tho City,Cai Rang District,17,14,10,4,1
2022-02-14,Can Tho City,Cai Rang District,18,12,11,1,0
2022-02-14,Can Tho City,Cai Rang District,19,8,7,1,1
2022-02-14,Can Tho City,Cai Rang District,20,6,5,1,0
2022-02-14,Can Tho City,Cai Rang District,21,3,2,1,0
2022-02-14,Can Tho City,Ninh Kieu District,0,1,1,0,0
2022-02-14,Can Tho City,Ninh Kieu District,2,3,0,3,0
2022-02-14,Can Tho City,Ninh Kieu District,3,3,2,1,0
2022-02-14,Can Tho City,Ninh Kieu District,4,1,1,0,0
2022-02-14,Can Tho City,Ninh Kieu District,5,1,1,0,0
2022-02-14,Can Tho City,Ninh Kieu District,6,23,21,2,0
2022-02-14,Can Tho City,Ninh Kieu District,7,97,90,7,0
2022-02-14,Can Tho City,Ninh Kieu District,8,201,187,14,0
2022-02-14,Can Tho City,Ninh Kieu District,9,267,256,11,0
2022-02-14,Can Tho City,Ninh Kieu District,10,526,492,34,0
2022-02-14,Can Tho City,Ninh Kieu District,11,876,806,70,20
2022-02-14,Can Tho City,Ninh Kieu District,12,534,514,20,1
2022-02-14,Can Tho City,Ninh Kieu District,13,393,372,21,0
2022-02-14,Can Tho City,Ninh Kieu District,14,349,322,27,0
2022-02-14,Can Tho City,Ninh Kieu District,15,306,286,20,0
2022-02-14,Can Tho City,Ninh Kieu District,16,329,316,13,0
2022-02-14,Can Tho City,Ninh Kieu District,17,350,329,21,0
2022-02-14,Can Tho City,Ninh Kieu District,18,486,451,35,3
2022-02-14,Can Tho City,Ninh Kieu District,19,424,384,40,2
2022-02-14,Can Tho City,Ninh Kieu District,20,333,286,47,4
2022-02-14,Can Tho City,Ninh Kieu District,21,163,138,25,3
2022-02-14,Can Tho City,Ninh Kieu District,22,3,1,2,0
2022-02-14,Can Tho City,Ninh Kieu District,23,2,1,1,0
2022-02-14,Dong Nai,Bien Hoa City,0,5,2,3,0
2022-02-14,Dong Nai,Bien Hoa City,1,2,0,2,0
2022-02-14,Dong Nai,Bien Hoa City,2,1,0,1,0
2022-02-14,Dong Nai,Bien Hoa City,4,1,0,1,0
2022-02-14,Dong Nai,Bien Hoa City,5,5,1,4,2
2022-02-14,Dong Nai,Bien Hoa City,6,33,17,16,8
2022-02-14,Dong Nai,Bien Hoa City,7,137,117,20,13
2022-02-14,Dong Nai,Bien Hoa City,8,243,205,38,6
2022-02-14,Dong Nai,Bien Hoa City,9,300,281,19,1
2022-02-14,Dong Nai,Bien Hoa City,10,649,566,83,14
2022-02-14,Dong Nai,Bien Hoa City,11,1028,856,172,71
2022-02-14,Dong Nai,Bien Hoa City,12,700,634,66,13
2022-02-14,Dong Nai,Bien Hoa City,13,691,612,79,23
2022-02-14,Dong Nai,Bien Hoa City,14,562,486,76,29
2022-02-14,Dong Nai,Bien Hoa City,15,389,342,47,9
2022-02-14,Dong Nai,Bien Hoa City,16,437,375,62,31
2022-02-14,Dong Nai,Bien Hoa City,17,628,479,149,95
2022-02-14,Dong Nai,Bien Hoa City,18,719,511,208,143
2022-02-14,Dong Nai,Bien Hoa City,19,740,457,283,201
2022-02-14,Dong Nai,Bien Hoa City,20,608,307,301,202
2022-02-14,Dong Nai,Bien Hoa City,21,269,115,154,100
2022-02-14,Dong Nai,Bien Hoa City,22,1,0,1,0
2022-02-14,Dong Nai,Bien Hoa City,23,2,1,1,0
2022-02-14,Dong Nai,Cam My,13,2,0,2,1
2022-02-14,Dong Nai,Long Thanh,17,2,0,2,1
2022-02-14,Dong Nai,Long Thanh,18,3,0,3,3
2022-02-14,Dong Nai,Long Thanh,19,2,0,2,2
2022-02-14,Dong Nai,Thong Nhat,8,2,2,0,0
2022-02-14,Dong Nai,Thong Nhat,9,2,2,0,0
2022-02-14,Dong Nai,Thong Nhat,10,3,2,1,0
2022-02-14,Dong Nai,Thong Nhat,12,2,1,1,1
2022-02-14,Dong Nai,Thong Nhat,13,5,4,1,1
2022-02-14,Dong Nai,Thong Nhat,14,3,3,0,0
2022-02-14,Dong Nai,Thong Nhat,15,2,2,0,0
2022-02-14,Dong Nai,Thong Nhat,19,1,1,0,0
2022-02-14,Dong Nai,Thong Nhat,20,1,1,0,0
2022-02-14,Dong Nai,Trang Bom,10,2,0,2,2
2022-02-14,Dong Nai,Trang Bom,11,1,0,1,1
2022-02-14,Dong Nai,Trang Bom,17,2,1,1,1
2022-02-14,Dong Nai,Trang Bom,18,1,0,1,1
2022-02-14,Dong Nai,Trang Bom,19,1,0,1,1
2022-02-14,Dong Nai,Trang Bom,21,1,0,1,1
2022-02-14,Hai Phong City,An Duong,8,6,1,5,3
2022-02-14,Hai Phong City,An Duong,9,1,1,0,0
2022-02-14,Hai Phong City,An Duong,10,4,2,2,1
2022-02-14,Hai Phong City,An Duong,11,3,2,1,1
2022-02-14,Hai Phong City,An Duong,12,4,1,3,3
2022-02-14,Hai Phong City,An Duong,13,5,2,3,3
2022-02-14,Hai Phong City,An Duong,14,2,2,0,0
2022-02-14,Hai Phong City,An Duong,15,7,0,7,7
2022-02-14,Hai Phong City,An Duong,16,8,2,6,3
2022-02-14,Hai Phong City,An Duong,17,1,0,1,1
2022-02-14,Hai Phong City,An Duong,18,3,0,3,2
2022-02-14,Hai Phong City,An Duong,19,1,0,1,0
2022-02-14,Hai Phong City,An Duong,20,3,0,3,1
2022-02-14,Hai Phong City,An Duong,21,1,0,1,1
2022-02-14,Hai Phong City,Duong Kinh District,14,1,0,1,1
2022-02-14,Hai Phong City,Duong Kinh District,16,1,1,0,0
2022-02-14,Hai Phong City,Hai An District,7,10,7,3,2
2022-02-14,Hai Phong City,Hai An District,8,16,8,8,3
2022-02-14,Hai Phong City,Hai An District,9,23,12,11,2
2022-02-14,Hai Phong City,Hai An District,10,20,17,3,2
2022-02-14,Hai Phong City,Hai An District,11,41,31,10,5
2022-02-14,Hai Phong City,Hai An District,12,33,28,5,4
2022-02-14,Hai Phong City,Hai An District,13,14,11,3,0
2022-02-14,Hai Phong City,Hai An District,14,18,14,4,0
2022-02-14,Hai Phong City,Hai An District,15,21,18,3,1
2022-02-14,Hai Phong City,Hai An District,16,25,18,7,1
2022-02-14,Hai Phong City,Hai An District,17,26,21,5,1
2022-02-14,Hai Phong City,Hai An District,18,45,28,17,7
2022-02-14,Hai Phong City,Hai An District,19,43,27,16,8
2022-02-14,Hai Phong City,Hai An District,20,28,17,11,8
2022-02-14,Hai Phong City,Hai An District,21,16,11,5,2
2022-02-14,Hai Phong City,Hong Bang District,0,3,2,1,0
2022-02-14,Hai Phong City,Hong Bang District,6,1,1,0,0
2022-02-14,Hai Phong City,Hong Bang District,7,25,10,15,10
2022-02-14,Hai Phong City,Hong Bang District,8,44,22,22,15
2022-02-14,Hai Phong City,Hong Bang District,9,61,36,25,17
2022-02-14,Hai Phong City,Hong Bang District,10,80,55,25,19
2022-02-14,Hai Phong City,Hong Bang District,11,132,81,51,33
2022-02-14,Hai Phong City,Hong Bang District,12,76,53,23,15
2022-02-14,Hai Phong City,Hong Bang District,13,54,45,9,4
2022-02-14,Hai Phong City,Hong Bang District,14,43,27,16,8
2022-02-14,Hai Phong City,Hong Bang District,15,56,35,21,12
2022-02-14,Hai Phong City,Hong Bang District,16,42,25,17,8
2022-02-14,Hai Phong City,Hong Bang District,17,61,38,23,14
2022-02-14,Hai Phong City,Hong Bang District,18,91,44,47,37
2022-02-14,Hai Phong City,Hong Bang District,19,92,43,49,28
2022-02-14,Hai Phong City,Hong Bang District,20,51,24,27,20
2022-02-14,Hai Phong City,Hong Bang District,21,15,5,10,9
2022-02-14,Hai Phong City,Kien An District,8,6,3,3,1
2022-02-14,Hai Phong City,Kien An District,9,3,2,1,0
2022-02-14,Hai Phong City,Kien An District,10,14,11,3,0
2022-02-14,Hai Phong City,Kien An District,11,22,18,4,0
2022-02-14,Hai Phong City,Kien An District,12,6,4,2,1
2022-02-14,Hai Phong City,Kien An District,13,10,7,3,2
2022-02-14,Hai Phong City,Kien An District,14,12,4,8,7
2022-02-14,Hai Phong City,Kien An District,15,11,5,6,5
2022-02-14,Hai Phong City,Kien An District,16,9,7,2,1
2022-02-14,Hai Phong City,Kien An District,17,8,6,2,1
2022-02-14,Hai Phong City,Kien An District,18,14,7,7,6
2022-02-14,Hai Phong City,Kien An District,19,12,8,4,4
2022-02-14,Hai Phong City,Kien An District,20,8,3,5,4
2022-02-14,Hai Phong City,Kien An District,21,2,0,2,1
2022-02-14,Hai Phong City,Le Chan District,0,4,2,2,1
2022-02-14,Hai Phong City,Le Chan District,1,1,0,1,0
2022-02-14,Hai Phong City,Le Chan District,3,2,1,1,0
2022-02-14,Hai Phong City,Le Chan District,4,1,1,0,0
2022-02-14,Hai Phong City,Le Chan District,5,2,1,1,0
2022-02-14,Hai Phong City,Le Chan District,6,3,2,1,0
2022-02-14,Hai Phong City,Le Chan District,7,66,36,30,19
2022-02-14,Hai Phong City,Le Chan District,8,122,76,46,31
2022-02-14,Hai Phong City,Le Chan District,9,129,75,54,32
2022-02-14,Hai Phong City,Le Chan District,10,182,137,45,28
2022-02-14,Hai Phong City,Le Chan District,11,425,269,156,86
2022-02-14,Hai Phong City,Le Chan District,12,271,199,72,32
2022-02-14,Hai Phong City,Le Chan District,13,148,117,31,10
2022-02-14,Hai Phong City,Le Chan District,14,193,144,49,22
2022-02-14,Hai Phong City,Le Chan District,15,226,166,60,27
2022-02-14,Hai Phong City,Le Chan District,16,230,156,74,46
2022-02-14,Hai Phong City,Le Chan District,17,343,191,152,102
2022-02-14,Hai Phong City,Le Chan District,18,360,178,182,123
2022-02-14,Hai Phong City,Le Chan District,19,251,149,102,64
2022-02-14,Hai Phong City,Le Chan District,20,210,118,92,61
2022-02-14,Hai Phong City,Le Chan District,21,115,45,70,40
2022-02-14,Hai Phong City,Le Chan District,22,2,0,2,0
2022-02-14,Hai Phong City,Le Chan District,23,1,0,1,0
2022-02-14,Hai Phong City,Ngo Quyen District,0,3,2,1,1
2022-02-14,Hai Phong City,Ngo Quyen District,1,2,2,0,0
2022-02-14,Hai Phong City,Ngo Quyen District,2,5,3,2,0
2022-02-14,Hai Phong City,Ngo Quyen District,5,1,1,0,0
2022-02-14,Hai Phong City,Ngo Quyen District,7,47,27,20,12
2022-02-14,Hai Phong City,Ngo Quyen District,8,120,63,57,35
2022-02-14,Hai Phong City,Ngo Quyen District,9,160,103,57,34
2022-02-14,Hai Phong City,Ngo Quyen District,10,169,136,33,12
2022-02-14,Hai Phong City,Ngo Quyen District,11,326,242,84,55
2022-02-14,Hai Phong City,Ngo Quyen District,12,168,135,33,11
2022-02-14,Hai Phong City,Ngo Quyen District,13,117,101,16,6
2022-02-14,Hai Phong City,Ngo Quyen District,14,159,125,34,14
2022-02-14,Hai Phong City,Ngo Quyen District,15,178,139,39,10
2022-02-14,Hai Phong City,Ngo Quyen District,16,208,158,50,20
2022-02-14,Hai Phong City,Ngo Quyen District,17,271,152,119,77
2022-02-14,Hai Phong City,Ngo Quyen District,18,310,168,142,110
2022-02-14,Hai Phong City,Ngo Quyen District,19,294,153,141,108
2022-02-14,Hai Phong City,Ngo Quyen District,20,206,133,73,45
2022-02-14,Hai Phong City,Ngo Quyen District,21,87,52,35,22
2022-02-14,Hai Phong City,Ngo Quyen District,22,2,0,2,1
2022-02-14,Hai Phong City,Thuy Nguyen,10,3,0,3,2
2022-02-14,Hai Phong City,Thuy Nguyen,11,4,1,3,2
2022-02-14,Hai Phong City,Thuy Nguyen,12,1,0,1,1
2022-02-14,Hai Phong City,Thuy Nguyen,14,1,0,1,1
2022-02-14,Hai Phong City,Thuy Nguyen,15,2,0,2,2
2022-02-14,Hue City,Hue City,0,7,3,4,1
2022-02-14,Hue City,Hue City,1,3,3,0,0
2022-02-14,Hue City,Hue City,2,2,2,0,0
2022-02-14,Hue City,Hue City,3,4,3,1,0
2022-02-14,Hue City,Hue City,4,3,1,2,0
2022-02-14,Hue City,Hue City,5,2,1,1,0
2022-02-14,Hue City,Hue City,6,36,32,4,1
2022-02-14,Hue City,Hue City,7,198,173,25,12
2022-02-14,Hue City,Hue City,8,321,295,26,7
2022-02-14,Hue City,Hue City,9,267,244,23,0
2022-02-14,Hue City,Hue City,10,348,324,24,1
2022-02-14,Hue City,Hue City,11,887,760,127,51
2022-02-14,Hue City,Hue City,12,407,360,47,8
2022-02-14,Hue City,Hue City,13,273,254,19,1
2022-02-14,Hue City,Hue City,14,310,279,31,1
2022-02-14,Hue City,Hue City,15,393,352,41,4
2022-02-14,Hue City,Hue City,16,406,370,36,2
2022-02-14,Hue City,Hue City,17,548,492,56,6
2022-02-14,Hue City,Hue City,18,612,528,84,22
2022-02-14,Hue City,Hue City,19,551,451,100,33
2022-02-14,Hue City,Hue City,20,474,342,132,60
2022-02-14,Hue City,Hue City,21,218,175,43,14
2022-02-14,Hue City,Hue City,22,3,2,1,0
2022-02-14,Hue City,Hue City,23,2,1,1,0
2022-02-14,Hue City,Huong Thuy,6,1,0,1,1
2022-02-14,Hue City,Huong Thuy,8,1,0,1,1
2022-02-14,Hue City,Huong Thuy,9,3,1,2,1
2022-02-14,Hue City,Huong Thuy,11,1,1,0,0
2022-02-14,Hue City,Huong Thuy,12,1,1,0,0
2022-02-14,Hue City,Huong Thuy,15,1,1,0,0
2022-02-14,Hue City,Huong Thuy,17,2,1,1,0
2022-02-14,Hue City,Huong Thuy,20,2,1,1,1
2022-02-14,Hue City,Huong Thuy,21,2,1,1,1
2022-02-14,Hue City,Huong Tra,21,1,1,0,0
2022-02-14,Hue City,Phu Vang,6,1,0,1,1
2022-02-14,Hue City,Phu Vang,9,1,1,0,0
2022-02-14,Hue City,Phu Vang,10,1,0,1,0
2022-02-14,Hue City,Phu Vang,11,2,2,0,0
2022-02-14,Hue City,Phu Vang,12,2,2,0,0
2022-02-14,Hue City,Phu Vang,13,2,1,1,1
2022-02-14,Hue City,Phu Vang,14,1,0,1,1
2022-02-14,Hue City,Phu Vang,15,1,0,1,0
2022-02-14,Hue City,Phu Vang,16,2,0,2,1
2022-02-14,Hue City,Phu Vang,18,2,2,0,0
2022-02-14,Hue City,Phu Vang,19,1,1,0,0
2022-02-14,Hue City,Phu Vang,20,1,1,0,0
2022-02-14,Vung Tau,Ba Ria City,6,1,0,1,0
2022-02-14,Vung Tau,Ba Ria City,7,2,0,2,2
2022-02-14,Vung Tau,Ba Ria City,8,13,0,13,12
2022-02-14,Vung Tau,Ba Ria City,9,9,0,9,8
2022-02-14,Vung Tau,Ba Ria City,10,9,2,7,6
2022-02-14,Vung Tau,Ba Ria City,11,15,9,6,4
2022-02-14,Vung Tau,Ba Ria City,12,9,2,7,3
2022-02-14,Vung Tau,Ba Ria City,13,12,6,6,5
2022-02-14,Vung Tau,Ba Ria City,14,6,2,4,3
2022-02-14,Vung Tau,Ba Ria City,15,3,1,2,1
2022-02-14,Vung Tau,Ba Ria City,16,4,3,1,1
2022-02-14,Vung Tau,Ba Ria City,17,5,3,2,2
2022-02-14,Vung Tau,Ba Ria City,18,5,1,4,3
2022-02-14,Vung Tau,Ba Ria City,19,10,0,10,7
2022-02-14,Vung Tau,Ba Ria City,20,3,0,3,3
2022-02-14,Vung Tau,Ba Ria City,21,2,0,2,1
2022-02-14,Vung Tau,Tan Thanh,10,1,0,1,1
2022-02-14,Vung Tau,Tan Thanh,11,1,0,1,1
2022-02-14,Vung Tau,Tan Thanh,14,1,0,1,1
2022-02-14,Vung Tau,Tan Thanh,15,1,0,1,1
2022-02-14,Vung Tau,Tan Thanh,20,2,0,2,2
2022-02-14,Vung Tau,Vung Tau City,0,2,1,1,0
2022-02-14,Vung Tau,Vung Tau City,1,1,1,0,0
2022-02-14,Vung Tau,Vung Tau City,6,26,22,4,1
2022-02-14,Vung Tau,Vung Tau City,7,87,74,13,5
2022-02-14,Vung Tau,Vung Tau City,8,132,118,14,3
2022-02-14,Vung Tau,Vung Tau City,9,142,126,16,1
2022-02-14,Vung Tau,Vung Tau City,10,178,164,14,2
2022-02-14,Vung Tau,Vung Tau City,11,339,309,30,7
2022-02-14,Vung Tau,Vung Tau City,12,222,202,20,1
2022-02-14,Vung Tau,Vung Tau City,13,205,181,24,8
2022-02-14,Vung Tau,Vung Tau City,14,215,190,25,9
2022-02-14,Vung Tau,Vung Tau City,15,209,192,17,2
2022-02-14,Vung Tau,Vung Tau City,16,168,157,11,1
2022-02-14,Vung Tau,Vung Tau City,17,228,198,30,8
2022-02-14,Vung Tau,Vung Tau City,18,332,231,101,58
2022-02-14,Vung Tau,Vung Tau City,19,350,176,174,126
2022-02-14,Vung Tau,Vung Tau City,20,209,117,92,73
2022-02-14,Vung Tau,Vung Tau City,21,110,51,59,40
2022-02-14,Vung Tau,Vung Tau City,22,3,1,2,1
2022-02-14,Vung Tau,Vung Tau City,23,1,0,1,0
2022-02-15,Binh Duong,Ben Cat,20,1,0,1,1
2022-02-15,Binh Duong,Di An,7,1,0,1,0
2022-02-15,Binh Duong,Di An,8,7,2,5,4
2022-02-15,Binh Duong,Di An,9,14,8,6,5
2022-02-15,Binh Duong,Di An,10,12,6,6,4
2022-02-15,Binh Duong,Di An,11,25,8,17,15
2022-02-15,Binh Duong,Di An,12,25,7,18,14
2022-02-15,Binh Duong,Di An,13,20,8,12,10
2022-02-15,Binh Duong,Di An,14,13,6,7,7
2022-02-15,Binh Duong,Di An,15,18,4,14,10
2022-02-15,Binh Duong,Di An,16,11,2,9,9
2022-02-15,Binh Duong,Di An,17,12,4,8,8
2022-02-15,Binh Duong,Di An,18,10,4,6,5
2022-02-15,Binh Duong,Di An,19,7,4,3,3
2022-02-15,Binh Duong,Di An,20,18,5,13,8
2022-02-15,Binh Duong,Di An,21,6,0,6,5
2022-02-15,Binh Duong,Tan Uyen,9,1,1,0,0
2022-02-15,Binh Duong,Tan Uyen,10,2,2,0,0
2022-02-15,Binh Duong,Tan Uyen,11,3,1,2,2
2022-02-15,Binh Duong,Tan Uyen,12,1,1,0,0
2022-02-15,Binh Duong,Tan Uyen,13,2,1,1,1
2022-02-15,Binh Duong,Tan Uyen,14,1,0,1,1
2022-02-15,Binh Duong,Tan Uyen,16,2,1,1,1
2022-02-15,Binh Duong,Tan Uyen,17,3,1,2,2
2022-02-15,Binh Duong,Tan Uyen,18,1,0,1,1
2022-02-15,Binh Duong,Tan Uyen,20,2,0,2,1
2022-02-15,Binh Duong,Thu Dau Mot Town,0,1,1,0,0
2022-02-15,Binh Duong,Thu Dau Mot Town,2,2,2,0,0
2022-02-15,Binh Duong,Thu Dau Mot Town,3,1,1,0,0
2022-02-15,Binh Duong,Thu Dau Mot Town,6,23,13,10,8
2022-02-15,Binh Duong,Thu Dau Mot Town,7,133,94,39,29
2022-02-15,Binh Duong,Thu Dau Mot Town,8,198,133,65,36
2022-02-15,Binh Duong,Thu Dau Mot Town,9,228,197,31,10
2022-02-15,Binh Duong,Thu Dau Mot Town,10,439,340,99,43
2022-02-15,Binh Duong,Thu Dau Mot Town,11,634,457,177,114
2022-02-15,Binh Duong,Thu Dau Mot Town,12,371,302,69,38
2022-02-15,Binh Duong,Thu Dau Mot Town,13,339,311,28,9
2022-02-15,Binh Duong,Thu Dau Mot Town,14,312,261,51,28
2022-02-15,Binh Duong,Thu Dau Mot Town,15,224,197,27,9
2022-02-15,Binh Duong,Thu Dau Mot Town,16,225,206,19,6
2022-02-15,Binh Duong,Thu Dau Mot Town,17,302,264,38,6
2022-02-15,Binh Duong,Thu Dau Mot Town,18,314,284,30,4
2022-02-15,Binh Duong,Thu Dau Mot Town,19,261,236,25,5
2022-02-15,Binh Duong,Thu Dau Mot Town,20,202,178,24,4
2022-02-15,Binh Duong,Thu Dau Mot Town,21,89,62,27,8
2022-02-15,Binh Duong,Thu Dau Mot Town,22,2,1,1,0
2022-02-15,Binh Duong,Thuan An,6,3,1,2,1
2022-02-15,Binh Duong,Thuan An,7,1,0,1,0
2022-02-15,Binh Duong,Thuan An,8,17,7,10,7
2022-02-15,Binh Duong,Thuan An,9,36,14,22,19
2022-02-15,Binh Duong,Thuan An,10,71,23,48,41
2022-02-15,Binh Duong,Thuan An,11,92,39,53,43
2022-02-15,Binh Duong,Thuan An,12,62,22,40,33
2022-02-15,Binh Duong,Thuan An,13,70,24,46,39
2022-02-15,Binh Duong,Thuan An,14,53,21,32,25
2022-02-15,Binh Duong,Thuan An,15,34,13,21,14
2022-02-15,Binh Duong,Thuan An,16,47,19,28,25
2022-02-15,Binh Duong,Thuan An,17,28,14,14,12
2022-02-15,Binh Duong,Thuan An,18,28,14,14,12
2022-02-15,Binh Duong,Thuan An,19,41,21,20,17
2022-02-15,Binh Duong,Thuan An,20,17,6,11,7
2022-02-15,Binh Duong,Thuan An,21,11,1,10,9
2022-02-15,Can Tho City,Binh Thuy District,8,4,1,3,0
2022-02-15,Can Tho City,Binh Thuy District,9,3,3,0,0
2022-02-15,Can Tho City,Binh Thuy District,10,8,6,2,0
2022-02-15,Can Tho City,Binh Thuy District,11,7,4,3,0
2022-02-15,Can Tho City,Binh Thuy District,12,9,9,0,0
2022-02-15,Can Tho City,Binh Thuy District,13,11,9,2,0
2022-02-15,Can Tho City,Binh Thuy District,14,7,6,1,0
2022-02-15,Can Tho City,Binh Thuy District,15,12,8,4,0
2022-02-15,Can Tho City,Binh Thuy District,16,8,7,1,0
2022-02-15,Can Tho City,Binh Thuy District,17,11,10,1,0
2022-02-15,Can Tho City,Binh Thuy District,18,13,10,3,0
2022-02-15,Can Tho City,Binh Thuy District,19,8,5,3,0
2022-02-15,Can Tho City,Binh Thuy District,20,7,5,2,2
2022-02-15,Can Tho City,Cai Rang District,7,1,1,0,0
2022-02-15,Can Tho City,Cai Rang District,8,3,3,0,0
2022-02-15,Can Tho City,Cai Rang District,9,6,4,2,0
2022-02-15,Can Tho City,Cai Rang District,10,12,12,0,0
2022-02-15,Can Tho City,Cai Rang District,11,8,7,1,0
2022-02-15,Can Tho City,Cai Rang District,12,13,12,1,0
2022-02-15,Can Tho City,Cai Rang District,13,6,5,1,0
2022-02-15,Can Tho City,Cai Rang District,14,2,2,0,0
2022-02-15,Can Tho City,Cai Rang District,15,3,3,0,0
2022-02-15,Can Tho City,Cai Rang District,16,7,5,2,1
2022-02-15,Can Tho City,Cai Rang District,17,8,8,0,0
2022-02-15,Can Tho City,Cai Rang District,18,6,5,1,0
2022-02-15,Can Tho City,Cai Rang District,19,8,7,1,0
2022-02-15,Can Tho City,Cai Rang District,20,7,7,0,0
2022-02-15,Can Tho City,Cai Rang District,21,2,1,1,0
2022-02-15,Can Tho City,Ninh Kieu District,0,3,3,0,0
2022-02-15,Can Tho City,Ninh Kieu District,1,4,1,3,0
2022-02-15,Can Tho City,Ninh Kieu District,2,2,1,1,0
2022-02-15,Can Tho City,Ninh Kieu District,3,2,1,1,0
2022-02-15,Can Tho City,Ninh Kieu District,4,2,2,0,0
2022-02-15,Can Tho City,Ninh Kieu District,5,1,0,1,0
2022-02-15,Can Tho City,Ninh Kieu District,6,38,32,6,0
2022-02-15,Can Tho City,Ninh Kieu District,7,125,109,16,0
2022-02-15,Can Tho City,Ninh Kieu District,8,223,197,26,0
2022-02-15,Can Tho City,Ninh Kieu District,9,293,272,21,0
2022-02-15,Can Tho City,Ninh Kieu District,10,557,511,46,0
2022-02-15,Can Tho City,Ninh Kieu District,11,774,682,92,4
2022-02-15,Can Tho City,Ninh Kieu District,12,443,415,28,0
2022-02-15,Can Tho City,Ninh Kieu District,13,386,363,23,0
2022-02-15,Can Tho City,Ninh Kieu District,14,323,302,21,0
2022-02-15,Can Tho City,Ninh Kieu District,15,299,279,20,1
2022-02-15,Can Tho City,Ninh Kieu District,16,330,314,16,0
2022-02-15,Can Tho City,Ninh Kieu District,17,414,377,37,1
2022-02-15,Can Tho City,Ninh Kieu District,18,469,433,36,0
2022-02-15,Can Tho City,Ninh Kieu District,19,425,393,32,0
2022-02-15,Can Tho City,Ninh Kieu District,20,322,292,30,0
2022-02-15,Can Tho City,Ninh Kieu District,21,170,146,24,0
2022-02-15,Can Tho City,Ninh Kieu District,22,4,4,0,0
2022-02-15,Can Tho City,Ninh Kieu District,23,3,2,1,0
2022-02-15,Dong Nai,Bien Hoa City,0,3,1,2,0
2022-02-15,Dong Nai,Bien Hoa City,1,2,0,2,0
2022-02-15,Dong Nai,Bien Hoa City,4,1,1,0,0
2022-02-15,Dong Nai,Bien Hoa City,5,1,0,1,0
2022-02-15,Dong Nai,Bien Hoa City,6,28,18,10,7
2022-02-15,Dong Nai,Bien Hoa City,7,136,113,23,15
2022-02-15,Dong Nai,Bien Hoa City,8,254,221,33,5
2022-02-15,Dong Nai,Bien Hoa City,9,320,269,51,4
2022-02-15,Dong Nai,Bien Hoa City,10,663,590,73,9
2022-02-15,Dong Nai,Bien Hoa City,11,981,859,122,28
2022-02-15,Dong Nai,Bien Hoa City,12,686,618,68,5
2022-02-15,Dong Nai,Bien Hoa City,13,661,603,58,14
2022-02-15,Dong Nai,Bien Hoa City,14,539,497,42,8
2022-02-15,Dong Nai,Bien Hoa City,15,368,330,38,7
2022-02-15,Dong Nai,Bien Hoa City,16,403,357,46,9
2022-02-15,Dong Nai,Bien Hoa City,17,449,399,50,7
2022-02-15,Dong Nai,Bien Hoa City,18,598,528,70,18
2022-02-15,Dong Nai,Bien Hoa City,19,539,479,60,16
2022-02-15,Dong Nai,Bien Hoa City,20,405,332,73,35
2022-02-15,Dong Nai,Bien Hoa City,21,175,111,64,32
2022-02-15,Dong Nai,Bien Hoa City,22,3,1,2,0
2022-02-15,Dong Nai,Bien Hoa City,23,2,2,0,0
2022-02-15,Dong Nai,Long Khanh,20,1,0,1,1
2022-02-15,Dong Nai,Long Thanh,9,1,0,1,1
2022-02-15,Dong Nai,Long Thanh,10,4,0,4,2
2022-02-15,Dong Nai,Long Thanh,11,1,0,1,1
2022-02-15,Dong Nai,Long Thanh,12,1,0,1,1
2022-02-15,Dong Nai,Long Thanh,13,1,0,1,1
2022-02-15,Dong Nai,Long Thanh,14,1,0,1,1
2022-02-15,Dong Nai,Long Thanh,16,1,1,0,0
2022-02-15,Dong Nai,Long Thanh,20,1,0,1,1
2022-02-15,Dong Nai,Long Thanh,21,1,0,1,1
2022-02-15,Dong Nai,Thong Nhat,7,1,1,0,0
2022-02-15,Dong Nai,Thong Nhat,9,1,1,0,0
2022-02-15,Dong Nai,Thong Nhat,11,3,3,0,0
2022-02-15,Dong Nai,Thong Nhat,12,3,2,1,1
2022-02-15,Dong Nai,Thong Nhat,14,2,2,0,0
2022-02-15,Dong Nai,Trang Bom,9,1,0,1,1
2022-02-15,Dong Nai,Trang Bom,13,4,0,4,3
2022-02-15,Dong Nai,Trang Bom,16,1,0,1,1
2022-02-15,Dong Nai,Trang Bom,17,3,0,3,2
2022-02-15,Dong Nai,Trang Bom,18,1,0,1,1
2022-02-15,Dong Nai,Trang Bom,19,1,1,0,0
2022-02-15,Hai Phong City,An Duong,7,1,0,1,1
2022-02-15,Hai Phong City,An Duong,8,4,3,1,0
2022-02-15,Hai Phong City,An Duong,9,6,2,4,2
2022-02-15,Hai Phong City,An Duong,10,1,0,1,1
2022-02-15,Hai Phong City,An Duong,11,2,1,1,0
2022-02-15,Hai Phong City,An Duong,13,3,2,1,1
2022-02-15,Hai Phong City,An Duong,14,2,0,2,2
2022-02-15,Hai Phong City,An Duong,15,3,2,1,1
2022-02-15,Hai Phong City,An Duong,16,2,1,1,0
2022-02-15,Hai Phong City,An Duong,17,1,1,0,0
2022-02-15,Hai Phong City,An Duong,18,3,1,2,2
2022-02-15,Hai Phong City,An Duong,19,3,1,2,0
2022-02-15,Hai Phong City,An Duong,20,1,1,0,0
2022-02-15,Hai Phong City,An Duong,21,1,0,1,1
2022-02-15,Hai Phong City,Do Son District,13,1,0,1,1
2022-02-15,Hai Phong City,Duong Kinh District,10,1,0,1,1
2022-02-15,Hai Phong City,Duong Kinh District,12,2,0,2,1
2022-02-15,Hai Phong City,Duong Kinh District,15,1,0,1,0
2022-02-15,Hai Phong City,Duong Kinh District,16,1,0,1,0
2022-02-15,Hai Phong City,Hai An District,1,1,0,1,0
2022-02-15,Hai Phong City,Hai An District,6,1,1,0,0
2022-02-15,Hai Phong City,Hai An District,7,9,8,1,1
2022-02-15,Hai Phong City,Hai An District,8,18,13,5,3
2022-02-15,Hai Phong City,Hai An District,9,10,9,1,0
2022-02-15,Hai Phong City,Hai An District,10,9,7,2,2
2022-02-15,Hai Phong City,Hai An District,11,30,21,9,6
2022-02-15,Hai Phong City,Hai An District,12,22,16,6,2
2022-02-15,Hai Phong City,Hai An District,13,14,8,6,0
2022-02-15,Hai Phong City,Hai An District,14,21,16,5,0
2022-02-15,Hai Phong City,Hai An District,15,19,16,3,0
2022-02-15,Hai Phong City,Hai An District,16,15,8,7,2
2022-02-15,Hai Phong City,Hai An District,17,35,20,15,9
2022-02-15,Hai Phong City,Hai An District,18,29,14,15,11
2022-02-15,Hai Phong City,Hai An District,19,23,14,9,5
2022-02-15,Hai Phong City,Hai An District,20,17,6,11,4
2022-02-15,Hai Phong City,Hai An District,21,12,7,5,3
2022-02-15,Hai Phong City,Hong Bang District,0,4,0,4,0
2022-02-15,Hai Phong City,Hong Bang District,5,1,0,1,0
2022-02-15,Hai Phong City,Hong Bang District,7,14,5,9,6
2022-02-15,Hai Phong City,Hong Bang District,8,39,27,12,5
2022-02-15,Hai Phong City,Hong Bang District,9,45,29,16,4
2022-02-15,Hai Phong City,Hong Bang District,10,67,52,15,8
2022-02-15,Hai Phong City,Hong Bang District,11,117,81,36,27
2022-02-15,Hai Phong City,Hong Bang District,12,69,58,11,4
2022-02-15,Hai Phong City,Hong Bang District,13,33,31,2,1
2022-02-15,Hai Phong City,Hong Bang District,14,41,26,15,3
2022-02-15,Hai Phong City,Hong Bang District,15,42,29,13,7
2022-02-15,Hai Phong City,Hong Bang District,16,51,40,11,7
2022-02-15,Hai Phong City,Hong Bang District,17,83,46,37,20
2022-02-15,Hai Phong City,Hong Bang District,18,73,34,39,30
2022-02-15,Hai Phong City,Hong Bang District,19,70,34,36,21
2022-02-15,Hai Phong City,Hong Bang District,20,43,20,23,15
2022-02-15,Hai Phong City,Hong Bang District,21,16,11,5,3
2022-02-15,Hai Phong City,Kien An District,0,1,1,0,0
2022-02-15,Hai Phong City,Kien An District,6,1,0,1,1
2022-02-15,Hai Phong City,Kien An District,7,5,0,5,3
2022-02-15,Hai Phong City,Kien An District,8,3,3,0,0
2022-02-15,Hai Phong City,Kien An District,9,9,5,4,0
2022-02-15,Hai Phong City,Kien An District,10,10,8,2,0
2022-02-15,Hai Phong City,Kien An District,11,22,14,8,7
2022-02-15,Hai Phong City,Kien An District,12,7,7,0,0
2022-02-15,Hai Phong City,Kien An District,13,7,0,7,4
2022-02-15,Hai Phong City,Kien An District,14,6,2,4,4
2022-02-15,Hai Phong City,Kien An District,15,11,9,2,0
2022-02-15,Hai Phong City,Kien An District,16,15,8,7,6
2022-02-15,Hai Phong City,Kien An District,17,7,4,3,1
2022-02-15,Hai Phong City,Kien An District,18,14,8,6,5
2022-02-15,Hai Phong City,Kien An District,19,14,9,5,0
2022-02-15,Hai Phong City,Kien An District,20,9,5,4,0
2022-02-15,Hai Phong City,Kien An District,21,8,2,6,3
2022-02-15,Hai Phong City,Le Chan District,0,2,2,0,0
2022-02-15,Hai Phong City,Le Chan District,1,3,0,3,0
2022-02-15,Hai Phong City,Le Chan District,4,1,1,0,0
2022-02-15,Hai Phong City,Le Chan District,5,1,0,1,0
2022-02-15,Hai Phong City,Le Chan District,6,4,2,2,0
2022-02-15,Hai Phong City,Le Chan District,7,46,29,17,4
2022-02-15,Hai Phong City,Le Chan District,8,96,78,18,6
2022-02-15,Hai Phong City,Le Chan District,9,97,81,16,4
2022-02-15,Hai Phong City,Le Chan District,10,196,161,35,6
2022-02-15,Hai Phong City,Le Chan District,11,332,257,75,39
2022-02-15,Hai Phong City,Le Chan District,12,215,176,39,15
2022-02-15,Hai Phong City,Le Chan District,13,141,113,28,5
2022-02-15,Hai Phong City,Le Chan District,14,153,113,40,18
2022-02-15,Hai Phong City,Le Chan District,15,224,149,75,46
2022-02-15,Hai Phong City,Le Chan District,16,271,176,95,54
2022-02-15,Hai Phong City,Le Chan District,17,294,160,134,76
2022-02-15,Hai Phong City,Le Chan District,18,384,206,178,130
2022-02-15,Hai Phong City,Le Chan District,19,288,161,127,80
2022-02-15,Hai Phong City,Le Chan District,20,200,104,96,64
2022-02-15,Hai Phong City,Le Chan District,21,79,40,39,18
2022-02-15,Hai Phong City,Le Chan District,22,3,0,3,0
2022-02-15,Hai Phong City,Ngo Quyen District,0,2,2,0,0
2022-02-15,Hai Phong City,Ngo Quyen District,1,2,1,1,0
2022-02-15,Hai Phong City,Ngo Quyen District,2,2,2,0,0
2022-02-15,Hai Phong City,Ngo Quyen District,6,3,2,1,0
2022-02-15,Hai Phong City,Ngo Quyen District,7,37,24,13,5
2022-02-15,Hai Phong City,Ngo Quyen District,8,97,70,27,13
2022-02-15,Hai Phong City,Ngo Quyen District,9,99,67,32,12
2022-02-15,Hai Phong City,Ngo Quyen District,10,160,123,37,9
2022-02-15,Hai Phong City,Ngo Quyen District,11,244,184,60,34
2022-02-15,Hai Phong City,Ngo Quyen District,12,143,124,19,7
2022-02-15,Hai Phong City,Ngo Quyen District,13,106,98,8,2
2022-02-15,Hai Phong City,Ngo Quyen District,14,151,129,22,6
2022-02-15,Hai Phong City,Ngo Quyen District,15,191,143,48,17
2022-02-15,Hai Phong City,Ngo Quyen District,16,205,142,63,31
2022-02-15,Hai Phong City,Ngo Quyen District,17,284,167,117,81
2022-02-15,Hai Phong City,Ngo Quyen District,18,282,152,130,84
2022-02-15,Hai Phong City,Ngo Quyen District,19,233,140,93,63
2022-02-15,Hai Phong City,Ngo Quyen District,20,183,104,79,40
2022-02-15,Hai Phong City,Ngo Quyen District,21,100,49,51,30
2022-02-15,Hai Phong City,Ngo Quyen District,22,7,1,6,0
2022-02-15,Hai Phong City,Thuy Nguyen,11,2,2,0,0
2022-02-15,Hai Phong City,Thuy Nguyen,15,1,0,1,1
2022-02-15,Hai Phong City,Thuy Nguyen,19,1,0,1,1
2022-02-15,Hai Phong City,Thuy Nguyen,20,2,0,2,2
2022-02-15,Hue City,Hue City,0,4,3,1,0
2022-02-15,Hue City,Hue City,1,5,3,2,2
2022-02-15,Hue City,Hue City,2,4,2,2,0
2022-02-15,Hue City,Hue City,3,2,1,1,0
2022-02-15,Hue City,Hue City,4,1,1,0,0
2022-02-15,Hue City,Hue City,5,1,1,0,0
2022-02-15,Hue City,Hue City,6,36,32,4,0
2022-02-15,Hue City,Hue City,7,162,134,28,0
2022-02-15,Hue City,Hue City,8,292,266,26,0
2022-02-15,Hue City,Hue City,9,236,216,20,1
2022-02-15,Hue City,Hue City,10,376,338,38,2
2022-02-15,Hue City,Hue City,11,713,655,58,8
2022-02-15,Hue City,Hue City,12,379,351,28,4
2022-02-15,Hue City,Hue City,13,243,234,9,0
2022-02-15,Hue City,Hue City,14,301,279,22,0
2022-02-15,Hue City,Hue City,15,379,340,39,0
2022-02-15,Hue City,Hue City,16,393,358,35,0
2022-02-15,Hue City,Hue City,17,518,466,52,4
2022-02-15,Hue City,Hue City,18,583,510,73,3
2022-02-15,Hue City,Hue City,19,559,499,60,14
2022-02-15,Hue City,Hue City,20,431,343,88,33
2022-02-15,Hue City,Hue City,21,269,185,84,35
2022-02-15,Hue City,Hue City,22,3,1,2,0
2022-02-15,Hue City,Hue City,23,2,2,0,0
2022-02-15,Hue City,Huong Thuy,12,2,2,0,0
2022-02-15,Hue City,Huong Thuy,13,1,0,1,0
2022-02-15,Hue City,Huong Thuy,18,1,1,0,0
2022-02-15,Hue City,Huong Thuy,19,2,1,1,0
2022-02-15,Hue City,Huong Thuy,21,2,1,1,0
2022-02-15,Hue City,Huong Tra,12,2,0,2,2
2022-02-15,Hue City,Phu Vang,7,2,1,1,0
2022-02-15,Hue City,Phu Vang,8,2,2,0,0
2022-02-15,Hue City,Phu Vang,9,3,1,2,0
2022-02-15,Hue City,Phu Vang,10,1,1,0,0
2022-02-15,Hue City,Phu Vang,11,5,3,2,2
2022-02-15,Hue City,Phu Vang,12,1,1,0,0
2022-02-15,Hue City,Phu Vang,14,1,1,0,0
2022-02-15,Hue City,Phu Vang,15,1,1,0,0
2022-02-15,Hue City,Phu Vang,16,1,1,0,0
2022-02-15,Hue City,Phu Vang,17,3,2,1,1
2022-02-15,Hue City,Phu Vang,18,1,1,0,0
2022-02-15,Hue City,Phu Vang,19,1,0,1,0
2022-02-15,Hue City,Phu Vang,20,3,2,1,1
2022-02-15,Hue City,Phu Vang,21,1,0,1,0
2022-02-15,Vung Tau,Ba Ria City,7,2,0,2,2
2022-02-15,Vung Tau,Ba Ria City,8,5,0,5,5
2022-02-15,Vung Tau,Ba Ria City,9,5,1,4,3
2022-02-15,Vung Tau,Ba Ria City,10,12,7,5,2
2022-02-15,Vung Tau,Ba Ria City,11,16,8,8,7
2022-02-15,Vung Tau,Ba Ria City,12,7,3,4,3
2022-02-15,Vung Tau,Ba Ria City,13,4,1,3,2
2022-02-15,Vung Tau,Ba Ria City,14,10,3,7,6
2022-02-15,Vung Tau,Ba Ria City,15,8,4,4,4
2022-02-15,Vung Tau,Ba Ria City,16,11,3,8,8
2022-02-15,Vung Tau,Ba Ria City,17,11,3,8,8
2022-02-15,Vung Tau,Ba Ria City,18,7,0,7,7
2022-02-15,Vung Tau,Ba Ria City,19,8,0,8,8
2022-02-15,Vung Tau,Ba Ria City,20,4,0,4,3
2022-02-15,Vung Tau,Ba Ria City,21,1,0,1,0
2022-02-15,Vung Tau,Ba Ria City,22,1,0,1,0
2022-02-15,Vung Tau,Tan Thanh,14,1,0,1,1
2022-02-15,Vung Tau,Tan Thanh,20,1,0,1,1
2022-02-15,Vung Tau,Vung Tau City,0,1,0,1,1
2022-02-15,Vung Tau,Vung Tau City,1,1,1,0,0
2022-02-15,Vung Tau,Vung Tau City,2,1,0,1,0
2022-02-15,Vung Tau,Vung Tau City,3,2,2,0,0
2022-02-15,Vung Tau,Vung Tau City,6,43,24,19,9
2022-02-15,Vung Tau,Vung Tau City,7,96,86,10,1
2022-02-15,Vung Tau,Vung Tau City,8,128,113,15,1
2022-02-15,Vung Tau,Vung Tau City,9,169,145,24,6
2022-02-15,Vung Tau,Vung Tau City,10,190,173,17,5
2022-02-15,Vung Tau,Vung Tau City,11,326,265,61,42
2022-02-15,Vung Tau,Vung Tau City,12,236,203,33,8
2022-02-15,Vung Tau,Vung Tau City,13,182,160,22,2
2022-02-15,Vung Tau,Vung Tau City,14,213,190,23,8
2022-02-15,Vung Tau,Vung Tau City,15,195,177,18,3
2022-02-15,Vung Tau,Vung Tau City,16,169,149,20,0
2022-02-15,Vung Tau,Vung Tau City,17,279,249,30,5
2022-02-15,Vung Tau,Vung Tau City,18,269,249,20,3
2022-02-15,Vung Tau,Vung Tau City,19,252,226,26,5
2022-02-15,Vung Tau,Vung Tau City,20,164,129,35,13
2022-02-15,Vung Tau,Vung Tau City,21,88,65,23,9
2022-02-16,Binh Duong,Ben Cat,12,1,1,0,0
2022-02-16,Binh Duong,Ben Cat,17,1,0,1,1
2022-02-16,Binh Duong,Ben Cat,18,1,1,0,0
2022-02-16,Binh Duong,Di An,6,3,0,3,3
2022-02-16,Binh Duong,Di An,7,7,1,6,6
2022-02-16,Binh Duong,Di An,8,11,5,6,5
2022-02-16,Binh Duong,Di An,9,14,3,11,8
2022-02-16,Binh Duong,Di An,10,27,10,17,15
2022-02-16,Binh Duong,Di An,11,25,2,23,21
2022-02-16,Binh Duong,Di An,12,22,2,20,14
2022-02-16,Binh Duong,Di An,13,35,10,25,22
2022-02-16,Binh Duong,Di An,14,15,7,8,7
2022-02-16,Binh Duong,Di An,15,12,7,5,1
2022-02-16,Binh Duong,Di An,16,14,8,6,4
2022-02-16,Binh Duong,Di An,17,15,5,10,8
2022-02-16,Binh Duong,Di An,18,14,6,8,7
2022-02-16,Binh Duong,Di An,19,15,9,6,2
2022-02-16,Binh Duong,Di An,20,6,3,3,3
2022-02-16,Binh Duong,Di An,21,5,1,4,3
2022-02-16,Binh Duong,Phu Giao,19,1,0,1,1
2022-02-16,Binh Duong,Tan Uyen,8,2,0,2,2
2022-02-16,Binh Duong,Tan Uyen,10,2,1,1,1
2022-02-16,Binh Duong,Tan Uyen,11,4,2,2,1
2022-02-16,Binh Duong,Tan Uyen,12,4,0,4,3
2022-02-16,Binh Duong,Tan Uyen,14,3,1,2,2
2022-02-16,Binh Duong,Tan Uyen,16,1,0,1,1
2022-02-16,Binh Duong,Tan Uyen,17,1,0,1,1
2022-02-16,Binh Duong,Tan Uyen,19,1,0,1,1
2022-02-16,Binh Duong,Thu Dau Mot Town,4,1,1,0,0
2022-02-16,Binh Duong,Thu Dau Mot Town,5,2,0,2,0
2022-02-16,Binh Duong,Thu Dau Mot Town,6,29,16,13,10
2022-02-16,Binh Duong,Thu Dau Mot Town,7,86,78,8,1
2022-02-16,Binh Duong,Thu Dau Mot Town,8,154,142,12,3
2022-02-16,Binh Duong,Thu Dau Mot Town,9,207,190,17,1
2022-02-16,Binh Duong,Thu Dau Mot Town,10,348,319,29,8
2022-02-16,Binh Duong,Thu Dau Mot Town,11,572,480,92,60
2022-02-16,Binh Duong,Thu Dau Mot Town,12,355,309,46,7
2022-02-16,Binh Duong,Thu Dau Mot Town,13,337,314,23,7
2022-02-16,Binh Duong,Thu Dau Mot Town,14,271,251,20,3
2022-02-16,Binh Duong,Thu Dau Mot Town,15,244,222,22,1
2022-02-16,Binh Duong,Thu Dau Mot Town,16,223,205,18,4
2022-02-16,Binh Duong,Thu Dau Mot Town,17,294,270,24,4
2022-02-16,Binh Duong,Thu Dau Mot Town,18,325,302,23,5
2022-02-16,Binh Duong,Thu Dau Mot Town,19,265,245,20,6
2022-02-16,Binh Duong,Thu Dau Mot Town,20,210,185,25,3
2022-02-16,Binh Duong,Thu Dau Mot Town,21,87,72,15,2
2022-02-16,Binh Duong,Thu Dau Mot Town,22,2,2,0,0
2022-02-16,Binh Duong,Thu Dau Mot Town,23,2,2,0,0
2022-02-16,Binh Duong,Thuan An,7,1,0,1,1
2022-02-16,Binh Duong,Thuan An,8,8,1,7,7
2022-02-16,Binh Duong,Thuan An,9,18,10,8,6
2022-02-16,Binh Duong,Thuan An,10,51,22,29,17
2022-02-16,Binh Duong,Thuan An,11,93,40,53,37
2022-02-16,Binh Duong,Thuan An,12,46,27,19,14
2022-02-16,Binh Duong,Thuan An,13,50,28,22,15
2022-02-16,Binh Duong,Thuan An,14,59,33,26,18
2022-02-16,Binh Duong,Thuan An,15,37,25,12,10
2022-02-16,Binh Duong,Thuan An,16,23,18,5,3
2022-02-16,Binh Duong,Thuan An,17,28,22,6,1
2022-02-16,Binh Duong,Thuan An,18,31,18,13,10
2022-02-16,Binh Duong,Thuan An,19,40,20,20,11
2022-02-16,Binh Duong,Thuan An,20,41,11,30,21
2022-02-16,Binh Duong,Thuan An,21,10,3,7,4
2022-02-16,Can Tho City,Binh Thuy District,7,1,1,0,0
2022-02-16,Can Tho City,Binh Thuy District,8,1,1,0,0
2022-02-16,Can Tho City,Binh Thuy District,9,3,2,1,1
2022-02-16,Can Tho City,Binh Thuy District,10,7,7,0,0
2022-02-16,Can Tho City,Binh Thuy District,11,16,15,1,0
2022-02-16,Can Tho City,Binh Thuy District,12,7,6,1,0
2022-02-16,Can Tho City,Binh Thuy District,13,8,8,0,0
2022-02-16,Can Tho City,Binh Thuy District,14,8,6,2,0
2022-02-16,Can Tho City,Binh Thuy District,15,11,8,3,0
2022-02-16,Can Tho City,Binh Thuy District,16,6,6,0,0
2022-02-16,Can Tho City,Binh Thuy District,17,10,9,1,0
2022-02-16,Can Tho City,Binh Thuy District,18,8,8,0,0
2022-02-16,Can Tho City,Binh Thuy District,19,7,6,1,0
2022-02-16,Can Tho City,Binh Thuy District,20,5,4,1,0
2022-02-16,Can Tho City,Binh Thuy District,21,2,1,1,1
2022-02-16,Can Tho City,Cai Rang District,6,1,0,1,0
2022-02-16,Can Tho City,Cai Rang District,8,2,2,0,0
2022-02-16,Can Tho City,Cai Rang District,9,4,4,0,0
2022-02-16,Can Tho City,Cai Rang District,10,6,5,1,0
2022-02-16,Can Tho City,Cai Rang District,11,2,2,0,0
2022-02-16,Can Tho City,Cai Rang District,12,11,11,0,0
2022-02-16,Can Tho City,Cai Rang District,13,5,4,1,1
2022-02-16,Can Tho City,Cai Rang District,14,5,5,0,0
2022-02-16,Can Tho City,Cai Rang District,15,7,6,1,0
2022-02-16,Can Tho City,Cai Rang District,16,12,11,1,0
2022-02-16,Can Tho City,Cai Rang District,17,7,6,1,1
2022-02-16,Can Tho City,Cai Rang District,18,11,10,1,0
2022-02-16,Can Tho City,Cai Rang District,19,3,3,0,0
2022-02-16,Can Tho City,Cai Rang District,20,7,6,1,0
2022-02-16,Can Tho City,Cai Rang District,21,6,4,2,1
2022-02-16,Can Tho City,Ninh Kieu District,0,2,2,0,0
2022-02-16,Can Tho City,Ninh Kieu District,4,1,0,1,0
2022-02-16,Can Tho City,Ninh Kieu District,5,2,2,0,0
2022-02-16,Can Tho City,Ninh Kieu District,6,32,29,3,0
2022-02-16,Can Tho City,Ninh Kieu District,7,119,109,10,0
2022-02-16,Can Tho City,Ninh Kieu District,8,189,176,13,0
2022-02-16,Can Tho City,Ninh Kieu District,9,201,193,8,0
2022-02-16,Can Tho City,Ninh Kieu District,10,484,452,32,0
2022-02-16,Can Tho City,Ninh Kieu District,11,676,639,37,0
2022-02-16,Can Tho City,Ninh Kieu District,12,452,435,17,0
2022-02-16,Can Tho City,Ninh Kieu District,13,344,321,23,0
2022-02-16,Can Tho City,Ninh Kieu District,14,303,287,16,0
2022-02-16,Can Tho City,Ninh Kieu District,15,290,277,13,0
2022-02-16,Can Tho City,Ninh Kieu District,16,360,345,15,0
2022-02-16,Can Tho City,Ninh Kieu District,17,379,362,17,0
2022-02-16,Can Tho City,Ninh Kieu District,18,428,398,30,0
2022-02-16,Can Tho City,Ninh Kieu District,19,398,368,30,0
2022-02-16,Can Tho City,Ninh Kieu District,20,287,264,23,0
2022-02-16,Can Tho City,Ninh Kieu District,21,154,138,16,0
2022-02-16,Can Tho City,Ninh Kieu District,22,1,1,0,0
2022-02-16,Can Tho City,Ninh Kieu District,23,2,2,0,0
2022-02-16,Dong Nai,Bien Hoa City,0,4,4,0,0
2022-02-16,Dong Nai,Bien Hoa City,5,2,1,1,0
2022-02-16,Dong Nai,Bien Hoa City,6,16,12,4,2
2022-02-16,Dong Nai,Bien Hoa City,7,138,114,24,11
2022-02-16,Dong Nai,Bien Hoa City,8,235,206,29,4
2022-02-16,Dong Nai,Bien Hoa City,9,320,283,37,6
2022-02-16,Dong Nai,Bien Hoa City,10,611,544,67,15
2022-02-16,Dong Nai,Bien Hoa City,11,891,783,108,43
2022-02-16,Dong Nai,Bien Hoa City,12,623,567,56,12
2022-02-16,Dong Nai,Bien Hoa City,13,690,637,53,4
2022-02-16,Dong Nai,Bien Hoa City,14,536,493,43,4
2022-02-16,Dong Nai,Bien Hoa City,15,407,377,30,5
2022-02-16,Dong Nai,Bien Hoa City,16,433,380,53,11
2022-02-16,Dong Nai,Bien Hoa City,17,485,424,61,14
2022-02-16,Dong Nai,Bien Hoa City,18,605,523,82,17
2022-02-16,Dong Nai,Bien Hoa City,19,521,470,51,7
2022-02-16,Dong Nai,Bien Hoa City,20,376,336,40,11
2022-02-16,Dong Nai,Bien Hoa City,21,162,123,39,15
2022-02-16,Dong Nai,Bien Hoa City,22,4,1,3,0
2022-02-16,Dong Nai,Bien Hoa City,23,2,0,2,0
2022-02-16,Dong Nai,Long Khanh,20,1,0,1,1
2022-02-16,Dong Nai,Long Thanh,13,1,0,1,1
2022-02-16,Dong Nai,Long Thanh,15,1,0,1,0
2022-02-16,Dong Nai,Long Thanh,16,1,0,1,1
2022-02-16,Dong Nai,Long Thanh,18,2,0,2,1
2022-02-16,Dong Nai,Thong Nhat,7,1,1,0,0
2022-02-16,Dong Nai,Thong Nhat,8,1,1,0,0
2022-02-16,Dong Nai,Thong Nhat,9,1,1,0,0
2022-02-16,Dong Nai,Thong Nhat,11,3,3,0,0
2022-02-16,Dong Nai,Thong Nhat,12,2,2,0,0
2022-02-16,Dong Nai,Thong Nhat,13,4,4,0,0
2022-02-16,Dong Nai,Thong Nhat,14,1,1,0,0
2022-02-16,Dong Nai,Thong Nhat,15,1,1,0,0
2022-02-16,Dong Nai,Thong Nhat,17,2,1,1,0
2022-02-16,Dong Nai,Thong Nhat,19,1,1,0,0
2022-02-16,Dong Nai,Trang Bom,9,1,0,1,1
2022-02-16,Dong Nai,Trang Bom,10,2,0,2,2
2022-02-16,Dong Nai,Trang Bom,11,2,1,1,1
2022-02-16,Dong Nai,Trang Bom,13,1,0,1,1
2022-02-16,Dong Nai,Trang Bom,16,1,0,1,1
2022-02-16,Hai Phong City,An Duong,5,1,0,1,1
2022-02-16,Hai Phong City,An Duong,7,4,1,3,2
2022-02-16,Hai Phong City,An Duong,8,3,1,2,2
2022-02-16,Hai Phong City,An Duong,9,4,1,3,3
2022-02-16,Hai Phong City,An Duong,10,6,2,4,3
2022-02-16,Hai Phong City,An Duong,11,9,0,9,7
2022-02-16,Hai Phong City,An Duong,12,6,0,6,5
2022-02-16,Hai Phong City,An Duong,13,3,1,2,2
2022-02-16,Hai Phong City,An Duong,14,7,3,4,2
2022-02-16,Hai Phong City,An Duong,15,7,1,6,4
2022-02-16,Hai Phong City,An Duong,16,5,2,3,3
2022-02-16,Hai Phong City,An Duong,17,1,0,1,0
2022-02-16,Hai Phong City,An Duong,19,1,1,0,0
2022-02-16,Hai Phong City,An Duong,22,1,0,1,0
2022-02-16,Hai Phong City,Do Son District,11,1,0,1,1
2022-02-16,Hai Phong City,Duong Kinh District,9,1,0,1,1
2022-02-16,Hai Phong City,Duong Kinh District,16,2,0,2,1
2022-02-16,Hai Phong City,Duong Kinh District,18,1,0,1,1
2022-02-16,Hai Phong City,Hai An District,7,13,4,9,9
2022-02-16,Hai Phong City,Hai An District,8,22,10,12,8
2022-02-16,Hai Phong City,Hai An District,9,30,17,13,7
2022-02-16,Hai Phong City,Hai An District,10,38,15,23,17
2022-02-16,Hai Phong City,Hai An District,11,82,24,58,43
2022-02-16,Hai Phong City,Hai An District,12,40,18,22,16
2022-02-16,Hai Phong City,Hai An District,13,28,16,12,9
2022-02-16,Hai Phong City,Hai An District,14,22,13,9,8
2022-02-16,Hai Phong City,Hai An District,15,25,14,11,9
2022-02-16,Hai Phong City,Hai An District,16,42,27,15,8
2022-02-16,Hai Phong City,Hai An District,17,54,28,26,14
2022-02-16,Hai Phong City,Hai An District,18,50,29,21,15
2022-02-16,Hai Phong City,Hai An District,19,32,15,17,7
2022-02-16,Hai Phong City,Hai An District,20,24,13,11,2
2022-02-16,Hai Phong City,Hai An District,21,9,6,3,3
2022-02-16,Hai Phong City,Hong Bang District,1,1,1,0,0
2022-02-16,Hai Phong City,Hong Bang District,4,1,1,0,0
2022-02-16,Hai Phong City,Hong Bang District,6,1,0,1,1
2022-02-16,Hai Phong City,Hong Bang District,7,24,11,13,9
2022-02-16,Hai Phong City,Hong Bang District,8,68,24,44,26
2022-02-16,Hai Phong City,Hong Bang District,9,72,37,35,28
2022-02-16,Hai Phong City,Hong Bang District,10,95,29,66,52
2022-02-16,Hai Phong City,Hong Bang District,11,245,63,182,158
2022-02-16,Hai Phong City,Hong Bang District,12,168,56,112,97
2022-02-16,Hai Phong City,Hong Bang District,13,71,41,30,22
2022-02-16,Hai Phong City,Hong Bang District,14,57,24,33,26
2022-02-16,Hai Phong City,Hong Bang District,15,83,30,53,47
2022-02-16,Hai Phong City,Hong Bang District,16,90,25,65,54
2022-02-16,Hai Phong City,Hong Bang District,17,113,36,77,64
2022-02-16,Hai Phong City,Hong Bang District,18,113,42,71,60
2022-02-16,Hai Phong City,Hong Bang District,19,101,59,42,32
2022-02-16,Hai Phong City,Hong Bang District,20,48,30,18,8
2022-02-16,Hai Phong City,Hong Bang District,21,14,9,5,1
2022-02-16,Hai Phong City,Hong Bang District,22,1,0,1,0
2022-02-16,Hai Phong City,Kien An District,7,2,1,1,1
2022-02-16,Hai Phong City,Kien An District,8,3,0,3,2
2022-02-16,Hai Phong City,Kien An District,9,7,2,5,3
2022-02-16,Hai Phong City,Kien An District,10,16,1,15,9
2022-02-16,Hai Phong City,Kien An District,11,27,7,20,18
2022-02-16,Hai Phong City,Kien An District,12,8,5,3,3
2022-02-16,Hai Phong City,Kien An District,13,3,2,1,1
2022-02-16,Hai Phong City,Kien An District,14,7,3,4,1
2022-02-16,Hai Phong City,Kien An District,15,19,11,8,6
2022-02-16,Hai Phong City,Kien An District,16,22,10,12,4
2022-02-16,Hai Phong City,Kien An District,17,12,8,4,3
2022-02-16,Hai Phong City,Kien An District,18,15,7,8,6
2022-02-16,Hai Phong City,Kien An District,19,11,6,5,4
2022-02-16,Hai Phong City,Kien An District,20,18,4,14,12
2022-02-16,Hai Phong City,Kien An District,21,5,1,4,3
2022-02-16,Hai Phong City,Le Chan District,0,3,2,1,1
2022-02-16,Hai Phong City,Le Chan District,2,2,0,2,1
2022-02-16,Hai Phong City,Le Chan District,3,1,0,1,1
2022-02-16,Hai Phong City,Le Chan District,5,1,1,0,0
2022-02-16,Hai Phong City,Le Chan District,6,2,2,0,0
2022-02-16,Hai Phong City,Le Chan District,7,45,19,26,15
2022-02-16,Hai Phong City,Le Chan District,8,133,60,73,52
2022-02-16,Hai Phong City,Le Chan District,9,120,69,51,25
2022-02-16,Hai Phong City,Le Chan District,10,271,130,141,118
2022-02-16,Hai Phong City,Le Chan District,11,575,165,410,339
2022-02-16,Hai Phong City,Le Chan District,12,394,167,227,188
2022-02-16,Hai Phong City,Le Chan District,13,202,121,81,59
2022-02-16,Hai Phong City,Le Chan District,14,238,115,123,89
2022-02-16,Hai Phong City,Le Chan District,15,358,141,217,179
2022-02-16,Hai Phong City,Le Chan District,16,353,155,198,158
2022-02-16,Hai Phong City,Le Chan District,17,467,188,279,230
2022-02-16,Hai Phong City,Le Chan District,18,472,191,281,221
2022-02-16,Hai Phong City,Le Chan District,19,318,194,124,82
2022-02-16,Hai Phong City,Le Chan District,20,183,137,46,26
2022-02-16,Hai Phong City,Le Chan District,21,80,49,31,15
2022-02-16,Hai Phong City,Le Chan District,22,1,0,1,0
2022-02-16,Hai Phong City,Le Chan District,23,5,1,4,1
2022-02-16,Hai Phong City,Ngo Quyen District,0,3,1,2,1
2022-02-16,Hai Phong City,Ngo Quyen District,1,1,0,1,0
2022-02-16,Hai Phong City,Ngo Quyen District,6,1,1,0,0
2022-02-16,Hai Phong City,Ngo Quyen District,7,53,16,37,24
2022-02-16,Hai Phong City,Ngo Quyen District,8,141,65,76,54
2022-02-16,Hai Phong City,Ngo Quyen District,9,130,77,53,36
2022-02-16,Hai Phong City,Ngo Quyen District,10,224,100,124,98
2022-02-16,Hai Phong City,Ngo Quyen District,11,431,141,290,237
2022-02-16,Hai Phong City,Ngo Quyen District,12,288,123,165,145
2022-02-16,Hai Phong City,Ngo Quyen District,13,160,100,60,33
2022-02-16,Hai Phong City,Ngo Quyen District,14,190,111,79,58
2022-02-16,Hai Phong City,Ngo Quyen District,15,296,111,185,143
2022-02-16,Hai Phong City,Ngo Quyen District,16,269,127,142,118
2022-02-16,Hai Phong City,Ngo Quyen District,17,297,149,148,107
2022-02-16,Hai Phong City,Ngo Quyen District,18,327,155,172,130
2022-02-16,Hai Phong City,Ngo Quyen District,19,242,158,84,60
2022-02-16,Hai Phong City,Ngo Quyen District,20,172,118,54,28
2022-02-16,Hai Phong City,Ngo Quyen District,21,54,40,14,6
2022-02-16,Hai Phong City,Ngo Quyen District,22,3,3,0,0
2022-02-16,Hai Phong City,Thuy Nguyen,9,4,0,4,4
2022-02-16,Hai Phong City,Thuy Nguyen,10,1,0,1,1
2022-02-16,Hai Phong City,Thuy Nguyen,11,2,0,2,2
2022-02-16,Hai Phong City,Thuy Nguyen,12,4,0,4,3
2022-02-16,Hai Phong City,Thuy Nguyen,13,1,0,1,1
2022-02-16,Hai Phong City,Thuy Nguyen,14,2,0,2,1
2022-02-16,Hai Phong City,Thuy Nguyen,15,1,0,1,1
2022-02-16,Hai Phong City,Thuy Nguyen,17,2,0,2,2
2022-02-16,Hai Phong City,Thuy Nguyen,18,3,0,3,3
2022-02-16,Hai Phong City,Thuy Nguyen,19,1,0,1,1
2022-02-16,Hue City,Hue City,0,1,0,1,1
2022-02-16,Hue City,Hue City,1,3,2,1,1
2022-02-16,Hue City,Hue City,2,2,0,2,0
2022-02-16,Hue City,Hue City,5,2,2,0,0
2022-02-16,Hue City,Hue City,6,54,40,14,4
2022-02-16,Hue City,Hue City,7,161,148,13,0
2022-02-16,Hue City,Hue City,8,295,275,20,1
2022-02-16,Hue City,Hue City,9,245,229,16,1
2022-02-16,Hue City,Hue City,10,408,377,31,1
2022-02-16,Hue City,Hue City,11,709,656,53,6
2022-02-16,Hue City,Hue City,12,426,398,28,2
2022-02-16,Hue City,Hue City,13,294,262,32,1
2022-02-16,Hue City,Hue City,14,318,303,15,0
2022-02-16,Hue City,Hue City,15,327,304,23,0
2022-02-16,Hue City,Hue City,16,374,350,24,0
2022-02-16,Hue City,Hue City,17,496,457,39,4
2022-02-16,Hue City,Hue City,18,536,484,52,5
2022-02-16,Hue City,Hue City,19,538,498,40,6
2022-02-16,Hue City,Hue City,20,399,356,43,9
2022-02-16,Hue City,Hue City,21,227,168,59,14
2022-02-16,Hue City,Hue City,22,3,0,3,1
2022-02-16,Hue City,Huong Thuy,8,1,0,1,1
2022-02-16,Hue City,Huong Thuy,12,1,1,0,0
2022-02-16,Hue City,Huong Thuy,15,1,1,0,0
2022-02-16,Hue City,Huong Thuy,17,1,1,0,0
2022-02-16,Hue City,Huong Thuy,18,1,0,1,0
2022-02-16,Hue City,Huong Thuy,21,3,1,2,2
2022-02-16,Hue City,Huong Tra,7,1,1,0,0
2022-02-16,Hue City,Huong Tra,8,1,1,0,0
2022-02-16,Hue City,Huong Tra,17,1,0,1,1
2022-02-16,Hue City,Phu Vang,6,1,1,0,0
2022-02-16,Hue City,Phu Vang,7,3,3,0,0
2022-02-16,Hue City,Phu Vang,8,1,1,0,0
2022-02-16,Hue City,Phu Vang,10,1,1,0,0
2022-02-16,Hue City,Phu Vang,11,2,2,0,0
2022-02-16,Hue City,Phu Vang,13,3,1,2,1
2022-02-16,Hue City,Phu Vang,16,3,2,1,0
2022-02-16,Hue City,Phu Vang,17,3,2,1,0
2022-02-16,Hue City,Phu Vang,18,1,0,1,0
2022-02-16,Hue City,Phu Vang,19,4,2,2,1
2022-02-16,Hue City,Phu Vang,20,4,4,0,0
2022-02-16,Vung Tau,Ba Ria City,7,2,0,2,2
2022-02-16,Vung Tau,Ba Ria City,8,2,0,2,2
2022-02-16,Vung Tau,Ba Ria City,9,2,0,2,2
2022-02-16,Vung Tau,Ba Ria City,10,13,0,13,12
2022-02-16,Vung Tau,Ba Ria City,11,9,0,9,9
2022-02-16,Vung Tau,Ba Ria City,12,17,0,17,14
2022-02-16,Vung Tau,Ba Ria City,13,14,0,14,13
2022-02-16,Vung Tau,Ba Ria City,14,12,0,12,12
2022-02-16,Vung Tau,Ba Ria City,15,8,0,8,8
2022-02-16,Vung Tau,Ba Ria City,16,11,0,11,11
2022-02-16,Vung Tau,Ba Ria City,17,10,0,10,10
2022-02-16,Vung Tau,Ba Ria City,18,8,0,8,8
2022-02-16,Vung Tau,Ba Ria City,19,11,0,11,11
2022-02-16,Vung Tau,Ba Ria City,20,8,0,8,7
2022-02-16,Vung Tau,Tan Thanh,11,1,0,1,1
2022-02-16,Vung Tau,Tan Thanh,19,1,0,1,1
2022-02-16,Vung Tau,Vung Tau City,0,2,1,1,0
2022-02-16,Vung Tau,Vung Tau City,2,1,1,0,0
2022-02-16,Vung Tau,Vung Tau City,5,1,1,0,0
2022-02-16,Vung Tau,Vung Tau City,6,22,17,5,1
2022-02-16,Vung Tau,Vung Tau City,7,89,80,9,0
2022-02-16,Vung Tau,Vung Tau City,8,135,124,11,2
2022-02-16,Vung Tau,Vung Tau City,9,121,104,17,2
2022-02-16,Vung Tau,Vung Tau City,10,166,158,8,2
2022-02-16,Vung Tau,Vung Tau City,11,272,262,10,2
2022-02-16,Vung Tau,Vung Tau City,12,200,185,15,1
2022-02-16,Vung Tau,Vung Tau City,13,175,163,12,2
2022-02-16,Vung Tau,Vung Tau City,14,198,177,21,3
2022-02-16,Vung Tau,Vung Tau City,15,210,189,21,2
2022-02-16,Vung Tau,Vung Tau City,16,150,136,14,0
2022-02-16,Vung Tau,Vung Tau City,17,231,210,21,8
2022-02-16,Vung Tau,Vung Tau City,18,278,248,30,3
2022-02-16,Vung Tau,Vung Tau City,19,248,224,24,5
2022-02-16,Vung Tau,Vung Tau City,20,160,134,26,5
2022-02-16,Vung Tau,Vung Tau City,21,66,44,22,6
2022-02-16,Vung Tau,Vung Tau City,23,2,1,1,0
2022-02-17,Binh Duong,Ben Cat,11,1,0,1,1
2022-02-17,Binh Duong,Ben Cat,12,3,0,3,3
2022-02-17,Binh Duong,Ben Cat,13,1,0,1,1
2022-02-17,Binh Duong,Ben Cat,18,2,0,2,2
2022-02-17,Binh Duong,Di An,6,2,0,2,2
2022-02-17,Binh Duong,Di An,7,4,1,3,2
2022-02-17,Binh Duong,Di An,8,5,4,1,1
2022-02-17,Binh Duong,Di An,9,9,4,5,3
2022-02-17,Binh Duong,Di An,10,28,10,18,12
2022-02-17,Binh Duong,Di An,11,22,11,11,5
2022-02-17,Binh Duong,Di An,12,22,10,12,9
2022-02-17,Binh Duong,Di An,13,22,9,13,12
2022-02-17,Binh Duong,Di An,14,20,7,13,11
2022-02-17,Binh Duong,Di An,15,15,6,9,8
2022-02-17,Binh Duong,Di An,16,19,6,13,7
2022-02-17,Binh Duong,Di An,17,12,6,6,5
2022-02-17,Binh Duong,Di An,18,20,8,12,4
2022-02-17,Binh Duong,Di An,19,6,3,3,3
2022-02-17,Binh Duong,Di An,20,4,0,4,4
2022-02-17,Binh Duong,Di An,21,4,0,4,2
2022-02-17,Binh Duong,Tan Uyen,8,1,0,1,1
2022-02-17,Binh Duong,Tan Uyen,9,1,0,1,0
2022-02-17,Binh Duong,Tan Uyen,11,3,2,1,0
2022-02-17,Binh Duong,Tan Uyen,12,1,0,1,0
2022-02-17,Binh Duong,Tan Uyen,13,3,1,2,2
2022-02-17,Binh Duong,Tan Uyen,15,2,1,1,0
2022-02-17,Binh Duong,Tan Uyen,18,1,0,1,1
2022-02-17,Binh Duong,Tan Uyen,19,3,0,3,2
2022-02-17,Binh Duong,Tan Uyen,20,1,1,0,0
2022-02-17,Binh Duong,Thu Dau Mot Town,0,2,1,1,0
2022-02-17,Binh Duong,Thu Dau Mot Town,3,1,1,0,0
2022-02-17,Binh Duong,Thu Dau Mot Town,5,1,1,0,0
2022-02-17,Binh Duong,Thu Dau Mot Town,6,21,17,4,3
2022-02-17,Binh Duong,Thu Dau Mot Town,7,97,84,13,1
2022-02-17,Binh Duong,Thu Dau Mot Town,8,185,174,11,1
2022-02-17,Binh Duong,Thu Dau Mot Town,9,222,204,18,1
2022-02-17,Binh Duong,Thu Dau Mot Town,10,320,303,17,1
2022-02-17,Binh Duong,Thu Dau Mot Town,11,612,547,65,31
2022-02-17,Binh Duong,Thu Dau Mot Town,12,371,341,30,5
2022-02-17,Binh Duong,Thu Dau Mot Town,13,344,319,25,7
2022-02-17,Binh Duong,Thu Dau Mot Town,14,269,243,26,4
2022-02-17,Binh Duong,Thu Dau Mot Town,15,196,182,14,4
2022-02-17,Binh Duong,Thu Dau Mot Town,16,211,198,13,1
2022-02-17,Binh Duong,Thu Dau Mot Town,17,282,253,29,4
2022-02-17,Binh Duong,Thu Dau Mot Town,18,316,275,41,6
2022-02-17,Binh Duong,Thu Dau Mot Town,19,260,239,21,3
2022-02-17,Binh Duong,Thu Dau Mot Town,20,159,136,23,4
2022-02-17,Binh Duong,Thu Dau Mot Town,21,88,71,17,0
2022-02-17,Binh Duong,Thu Dau Mot Town,22,1,1,0,0
2022-02-17,Binh Duong,Thuan An,3,1,0,1,0
2022-02-17,Binh Duong,Thuan An,6,1,0,1,0
2022-02-17,Binh Duong,Thuan An,7,8,3,5,3
2022-02-17,Binh Duong,Thuan An,8,14,4,10,7
2022-02-17,Binh Duong,Thuan An,9,37,22,15,13
2022-02-17,Binh Duong,Thuan An,10,52,29,23,17
2022-02-17,Binh Duong,Thuan An,11,81,46,35,27
2022-02-17,Binh Duong,Thuan An,12,54,30,24,15
2022-02-17,Binh Duong,Thuan An,13,67,34,33,25
2022-02-17,Binh Duong,Thuan An,14,34,20,14,10
2022-02-17,Binh Duong,Thuan An,15,36,23,13,8
2022-02-17,Binh Duong,Thuan An,16,35,20,15,11
2022-02-17,Binh Duong,Thuan An,17,42,22,20,11
2022-02-17,Binh Duong,Thuan An,18,39,26,13,10
2022-02-17,Binh Duong,Thuan An,19,26,12,14,8
2022-02-17,Binh Duong,Thuan An,20,15,9,6,3
2022-02-17,Binh Duong,Thuan An,21,11,5,6,5
2022-02-17,Can Tho City,Binh Thuy District,7,1,0,1,0
2022-02-17,Can Tho City,Binh Thuy District,8,2,2,0,0
2022-02-17,Can Tho City,Binh Thuy District,9,4,3,1,0
2022-02-17,Can Tho City,Binh Thuy District,10,10,6,4,0
2022-02-17,Can Tho City,Binh Thuy District,11,9,6,3,0
2022-02-17,Can Tho City,Binh Thuy District,12,4,3,1,0
2022-02-17,Can Tho City,Binh Thuy District,13,7,6,1,0
2022-02-17,Can Tho City,Binh Thuy District,14,11,11,0,0
2022-02-17,Can Tho City,Binh Thuy District,15,7,6,1,0
2022-02-17,Can Tho City,Binh Thuy District,16,8,8,0,0
2022-02-17,Can Tho City,Binh Thuy District,17,10,7,3,0
2022-02-17,Can Tho City,Binh Thuy District,18,13,12,1,0
2022-02-17,Can Tho City,Binh Thuy District,19,5,5,0,0
2022-02-17,Can Tho City,Binh Thuy District,20,4,4,0,0
2022-02-17,Can Tho City,Binh Thuy District,21,4,3,1,0
2022-02-17,Can Tho City,Cai Rang District,6,1,0,1,0
2022-02-17,Can Tho City,Cai Rang District,7,1,1,0,0
2022-02-17,Can Tho City,Cai Rang District,8,5,5,0,0
2022-02-17,Can Tho City,Cai Rang District,9,2,1,1,0
2022-02-17,Can Tho City,Cai Rang District,10,8,8,0,0
2022-02-17,Can Tho City,Cai Rang District,11,8,8,0,0
2022-02-17,Can Tho City,Cai Rang District,12,6,5,1,1
2022-02-17,Can Tho City,Cai Rang District,13,9,5,4,1
2022-02-17,Can Tho City,Cai Rang District,14,5,5,0,0
2022-02-17,Can Tho City,Cai Rang District,15,8,8,0,0
2022-02-17,Can Tho City,Cai Rang District,16,10,9,1,0
2022-02-17,Can Tho City,Cai Rang District,17,7,6,1,0
2022-02-17,Can Tho City,Cai Rang District,18,14,11,3,0
2022-02-17,Can Tho City,Cai Rang District,19,8,8,0,0
2022-02-17,Can Tho City,Cai Rang District,20,2,1,1,0
2022-02-17,Can Tho City,Cai Rang District,21,2,2,0,0
2022-02-17,Can Tho City,Ninh Kieu District,0,1,1,0,0
2022-02-17,Can Tho City,Ninh Kieu District,1,4,2,2,0
2022-02-17,Can Tho City,Ninh Kieu District,2,2,2,0,0
2022-02-17,Can Tho City,Ninh Kieu District,5,4,3,1,1
2022-02-17,Can Tho City,Ninh Kieu District,6,27,23,4,0
2022-02-17,Can Tho City,Ninh Kieu District,7,104,100,4,0
2022-02-17,Can Tho City,Ninh Kieu District,8,193,185,8,0
2022-02-17,Can Tho City,Ninh Kieu District,9,262,242,20,0
2022-02-17,Can Tho City,Ninh Kieu District,10,462,443,19,0
2022-02-17,Can Tho City,Ninh Kieu District,11,777,729,48,7
2022-02-17,Can Tho City,Ninh Kieu District,12,460,428,32,0
2022-02-17,Can Tho City,Ninh Kieu District,13,328,312,16,0
2022-02-17,Can Tho City,Ninh Kieu District,14,309,289,20,0
2022-02-17,Can Tho City,Ninh Kieu District,15,276,256,20,0
2022-02-17,Can Tho City,Ninh Kieu District,16,343,331,12,0
2022-02-17,Can Tho City,Ninh Kieu District,17,389,370,19,0
2022-02-17,Can Tho City,Ninh Kieu District,18,393,366,27,0
2022-02-17,Can Tho City,Ninh Kieu District,19,319,295,24,0
2022-02-17,Can Tho City,Ninh Kieu District,20,200,185,15,0
2022-02-17,Can Tho City,Ninh Kieu District,21,84,75,9,0
2022-02-17,Can Tho City,Ninh Kieu District,22,2,1,1,0
2022-02-17,Can Tho City,Ninh Kieu District,23,3,3,0,0
2022-02-17,Can Tho City,Phong Dien,12,1,0,1,1
2022-02-17,Can Tho City,Phong Dien,13,1,0,1,1
2022-02-17,Dong Nai,Bien Hoa City,0,2,0,2,0
2022-02-17,Dong Nai,Bien Hoa City,4,1,0,1,1
2022-02-17,Dong Nai,Bien Hoa City,5,2,2,0,0
2022-02-17,Dong Nai,Bien Hoa City,6,35,24,11,4
2022-02-17,Dong Nai,Bien Hoa City,7,140,116,24,11
2022-02-17,Dong Nai,Bien Hoa City,8,225,189,36,8
2022-02-17,Dong Nai,Bien Hoa City,9,334,292,42,2
2022-02-17,Dong Nai,Bien Hoa City,10,619,571,48,12
2022-02-17,Dong Nai,Bien Hoa City,11,923,850,73,23
2022-02-17,Dong Nai,Bien Hoa City,12,655,600,55,8
2022-02-17,Dong Nai,Bien Hoa City,13,573,530,43,4
2022-02-17,Dong Nai,Bien Hoa City,14,485,458,27,3
2022-02-17,Dong Nai,Bien Hoa City,15,375,338,37,8
2022-02-17,Dong Nai,Bien Hoa City,16,428,388,40,7
2022-02-17,Dong Nai,Bien Hoa City,17,504,455,49,4
2022-02-17,Dong Nai,Bien Hoa City,18,535,487,48,3
2022-02-17,Dong Nai,Bien Hoa City,19,466,424,42,0
2022-02-17,Dong Nai,Bien Hoa City,20,311,284,27,12
2022-02-17,Dong Nai,Bien Hoa City,21,122,84,38,9
2022-02-17,Dong Nai,Bien Hoa City,22,2,0,2,2
2022-02-17,Dong Nai,Long Thanh,11,2,0,2,1
2022-02-17,Dong Nai,Long Thanh,14,1,0,1,0
2022-02-17,Dong Nai,Long Thanh,16,2,0,2,2
2022-02-17,Dong Nai,Long Thanh,17,1,0,1,1
2022-02-17,Dong Nai,Long Thanh,18,3,0,3,2
2022-02-17,Dong Nai,Long Thanh,19,1,0,1,1
2022-02-17,Dong Nai,Thong Nhat,9,1,1,0,0
2022-02-17,Dong Nai,Thong Nhat,10,1,1,0,0
2022-02-17,Dong Nai,Thong Nhat,11,1,0,1,0
2022-02-17,Dong Nai,Thong Nhat,12,1,1,0,0
2022-02-17,Dong Nai,Thong Nhat,16,1,1,0,0
2022-02-17,Dong Nai,Thong Nhat,17,2,2,0,0
2022-02-17,Dong Nai,Thong Nhat,18,1,1,0,0
2022-02-17,Dong Nai,Thong Nhat,19,1,1,0,0
2022-02-17,Dong Nai,Thong Nhat,20,1,1,0,0
2022-02-17,Dong Nai,Thong Nhat,21,1,1,0,0
2022-02-17,Dong Nai,Trang Bom,13,1,0,1,1
2022-02-17,Dong Nai,Trang Bom,19,1,0,1,0
2022-02-17,Hai Phong City,An Duong,0,1,1,0,0
2022-02-17,Hai Phong City,An Duong,7,1,0,1,1
2022-02-17,Hai Phong City,An Duong,8,3,0,3,1
2022-02-17,Hai Phong City,An Duong,9,6,1,5,4
2022-02-17,Hai Phong City,An Duong,10,9,4,5,5
2022-02-17,Hai Phong City,An Duong,11,5,2,3,2
2022-02-17,Hai Phong City,An Duong,12,2,1,1,1
2022-02-17,Hai Phong City,An Duong,13,4,0,4,4
2022-02-17,Hai Phong City,An Duong,14,6,1,5,3
2022-02-17,Hai Phong City,An Duong,15,6,2,4,4
2022-02-17,Hai Phong City,An Duong,16,11,3,8,6
2022-02-17,Hai Phong City,An Duong,17,6,3,3,2
2022-02-17,Hai Phong City,An Duong,18,7,3,4,0
2022-02-17,Hai Phong City,An Duong,19,3,2,1,0
2022-02-17,Hai Phong City,An Duong,23,1,0,1,1
2022-02-17,Hai Phong City,Do Son District,17,2,0,2,2
2022-02-17,Hai Phong City,Duong Kinh District,11,1,0,1,1
2022-02-17,Hai Phong City,Duong Kinh District,13,1,0,1,1
2022-02-17,Hai Phong City,Duong Kinh District,14,1,0,1,1
2022-02-17,Hai Phong City,Hai An District,7,9,4,5,5
2022-02-17,Hai Phong City,Hai An District,8,24,19,5,2
2022-02-17,Hai Phong City,Hai An District,9,10,8,2,1
2022-02-17,Hai Phong City,Hai An District,10,27,23,4,0
2022-02-17,Hai Phong City,Hai An District,11,48,36,12,7
2022-02-17,Hai Phong City,Hai An District,12,27,24,3,3
2022-02-17,Hai Phong City,Hai An District,13,16,14,2,0
2022-02-17,Hai Phong City,Hai An District,14,17,14,3,1
2022-02-17,Hai Phong City,Hai An District,15,20,12,8,3
2022-02-17,Hai Phong City,Hai An District,16,34,26,8,0
2022-02-17,Hai Phong City,Hai An District,17,32,26,6,4
2022-02-17,Hai Phong City,Hai An District,18,41,27,14,6
2022-02-17,Hai Phong City,Hai An District,19,23,15,8,2
2022-02-17,Hai Phong City,Hai An District,20,13,12,1,0
2022-02-17,Hai Phong City,Hai An District,21,8,5,3,1
2022-02-17,Hai Phong City,Hai An District,23,1,1,0,0
2022-02-17,Hai Phong City,Hong Bang District,2,1,0,1,0
2022-02-17,Hai Phong City,Hong Bang District,6,2,0,2,1
2022-02-17,Hai Phong City,Hong Bang District,7,17,10,7,5
2022-02-17,Hai Phong City,Hong Bang District,8,62,40,22,17
2022-02-17,Hai Phong City,Hong Bang District,9,46,35,11,6
2022-02-17,Hai Phong City,Hong Bang District,10,71,53,18,13
2022-02-17,Hai Phong City,Hong Bang District,11,120,80,40,28
2022-02-17,Hai Phong City,Hong Bang District,12,59,45,14,9
2022-02-17,Hai Phong City,Hong Bang District,13,34,27,7,3
2022-02-17,Hai Phong City,Hong Bang District,14,43,37,6,3
2022-02-17,Hai Phong City,Hong Bang District,15,58,42,16,9
2022-02-17,Hai Phong City,Hong Bang District,16,81,48,33,14
2022-02-17,Hai Phong City,Hong Bang District,17,74,46,28,17
2022-02-17,Hai Phong City,Hong Bang District,18,92,53,39,24
2022-02-17,Hai Phong City,Hong Bang District,19,69,53,16,8
2022-02-17,Hai Phong City,Hong Bang District,20,22,16,6,1
2022-02-17,Hai Phong City,Hong Bang District,21,20,11,9,4
2022-02-17,Hai Phong City,Hong Bang District,23,2,1,1,0
2022-02-17,Hai Phong City,Kien An District,7,1,0,1,0
2022-02-17,Hai Phong City,Kien An District,8,5,0,5,5
2022-02-17,Hai Phong City,Kien An District,9,8,5,3,3
2022-02-17,Hai Phong City,Kien An District,10,7,3,4,3
2022-02-17,Hai Phong City,Kien An District,11,17,15,2,1
2022-02-17,Hai Phong City,Kien An District,12,7,3,4,2
2022-02-17,Hai Phong City,Kien An District,13,8,8,0,0
2022-02-17,Hai Phong City,Kien An District,14,6,4,2,0
2022-02-17,Hai Phong City,Kien An District,15,8,6,2,1
2022-02-17,Hai Phong City,Kien An District,16,6,5,1,1
2022-02-17,Hai Phong City,Kien An District,17,9,5,4,2
2022-02-17,Hai Phong City,Kien An District,18,20,15,5,1
2022-02-17,Hai Phong City,Kien An District,19,5,3,2,1
2022-02-17,Hai Phong City,Le Chan District,0,5,2,3,0
2022-02-17,Hai Phong City,Le Chan District,1,2,0,2,1
2022-02-17,Hai Phong City,Le Chan District,5,1,0,1,0
2022-02-17,Hai Phong City,Le Chan District,6,3,2,1,0
2022-02-17,Hai Phong City,Le Chan District,7,53,31,22,15
2022-02-17,Hai Phong City,Le Chan District,8,111,69,42,27
2022-02-17,Hai Phong City,Le Chan District,9,116,89,27,12
2022-02-17,Hai Phong City,Le Chan District,10,229,171,58,26
2022-02-17,Hai Phong City,Le Chan District,11,323,237,86,47
2022-02-17,Hai Phong City,Le Chan District,12,223,168,55,18
2022-02-17,Hai Phong City,Le Chan District,13,124,101,23,4
2022-02-17,Hai Phong City,Le Chan District,14,179,144,35,12
2022-02-17,Hai Phong City,Le Chan District,15,248,180,68,34
2022-02-17,Hai Phong City,Le Chan District,16,309,202,107,59
2022-02-17,Hai Phong City,Le Chan District,17,327,225,102,41
2022-02-17,Hai Phong City,Le Chan District,18,376,265,111,66
2022-02-17,Hai Phong City,Le Chan District,19,207,146,61,26
2022-02-17,Hai Phong City,Le Chan District,20,114,88,26,4
2022-02-17,Hai Phong City,Le Chan District,21,62,37,25,10
2022-02-17,Hai Phong City,Le Chan District,22,1,1,0,0
2022-02-17,Hai Phong City,Ngo Quyen District,0,2,1,1,0
2022-02-17,Hai Phong City,Ngo Quyen District,1,1,0,1,0
2022-02-17,Hai Phong City,Ngo Quyen District,3,2,1,1,0
2022-02-17,Hai Phong City,Ngo Quyen District,6,1,1,0,0
2022-02-17,Hai Phong City,Ngo Quyen District,7,55,28,27,22
2022-02-17,Hai Phong City,Ngo Quyen District,8,123,66,57,35
2022-02-17,Hai Phong City,Ngo Quyen District,9,107,80,27,7
2022-02-17,Hai Phong City,Ngo Quyen District,10,182,140,42,19
2022-02-17,Hai Phong City,Ngo Quyen District,11,285,223,62,38
2022-02-17,Hai Phong City,Ngo Quyen District,12,171,138,33,9
2022-02-17,Hai Phong City,Ngo Quyen District,13,111,94,17,5
2022-02-17,Hai Phong City,Ngo Quyen District,14,162,134,28,13
2022-02-17,Hai Phong City,Ngo Quyen District,15,177,128,49,26
2022-02-17,Hai Phong City,Ngo Quyen District,16,231,170,61,24
2022-02-17,Hai Phong City,Ngo Quyen District,17,223,146,77,35
2022-02-17,Hai Phong City,Ngo Quyen District,18,207,145,62,26
2022-02-17,Hai Phong City,Ngo Quyen District,19,140,103,37,12
2022-02-17,Hai Phong City,Ngo Quyen District,20,99,78,21,6
2022-02-17,Hai Phong City,Ngo Quyen District,21,49,30,19,9
2022-02-17,Hai Phong City,Ngo Quyen District,22,2,1,1,0
2022-02-17,Hai Phong City,Ngo Quyen District,23,1,0,1,1
2022-02-17,Hai Phong City,Thuy Nguyen,10,2,1,1,1
2022-02-17,Hai Phong City,Thuy Nguyen,12,1,0,1,1
2022-02-17,Hai Phong City,Thuy Nguyen,13,2,0,2,1
2022-02-17,Hai Phong City,Thuy Nguyen,14,2,0,2,2
2022-02-17,Hai Phong City,Thuy Nguyen,15,1,0,1,1
2022-02-17,Hai Phong City,Thuy Nguyen,16,3,0,3,3
2022-02-17,Hai Phong City,Thuy Nguyen,18,1,1,0,0
2022-02-17,Hai Phong City,Thuy Nguyen,19,1,0,1,1
2022-02-17,Hue City,Hue City,0,6,5,1,0
2022-02-17,Hue City,Hue City,1,4,4,0,0
2022-02-17,Hue City,Hue City,5,4,3,1,1
2022-02-17,Hue City,Hue City,6,65,55,10,5
2022-02-17,Hue City,Hue City,7,155,148,7,0
2022-02-17,Hue City,Hue City,8,249,236,13,0
2022-02-17,Hue City,Hue City,9,221,203,18,0
2022-02-17,Hue City,Hue City,10,324,309,15,0
2022-02-17,Hue City,Hue City,11,678,641,37,2
2022-02-17,Hue City,Hue City,12,411,386,25,0
2022-02-17,Hue City,Hue City,13,261,244,17,1
2022-02-17,Hue City,Hue City,14,283,254,29,0
2022-02-17,Hue City,Hue City,15,335,320,15,0
2022-02-17,Hue City,Hue City,16,349,329,20,1
2022-02-17,Hue City,Hue City,17,434,395,39,0
2022-02-17,Hue City,Hue City,18,532,483,49,6
2022-02-17,Hue City,Hue City,19,379,354,25,1
2022-02-17,Hue City,Hue City,20,274,237,37,4
2022-02-17,Hue City,Hue City,21,145,121,24,7
2022-02-17,Hue City,Hue City,22,1,0,1,0
2022-02-17,Hue City,Hue City,23,2,1,1,0
2022-02-17,Hue City,Huong Thuy,6,1,0,1,1
2022-02-17,Hue City,Huong Thuy,8,2,1,1,0
2022-02-17,Hue City,Huong Thuy,11,4,2,2,1
2022-02-17,Hue City,Huong Thuy,12,1,1,0,0
2022-02-17,Hue City,Huong Thuy,13,1,0,1,0
2022-02-17,Hue City,Huong Thuy,16,1,0,1,0
2022-02-17,Hue City,Huong Thuy,19,4,1,3,1
2022-02-17,Hue City,Huong Tra,17,1,0,1,1
2022-02-17,Hue City,Phu Vang,7,1,1,0,0
2022-02-17,Hue City,Phu Vang,8,2,2,0,0
2022-02-17,Hue City,Phu Vang,9,2,2,0,0
2022-02-17,Hue City,Phu Vang,11,2,2,0,0
2022-02-17,Hue City,Phu Vang,13,2,0,2,0
2022-02-17,Hue City,Phu Vang,14,1,1,0,0
2022-02-17,Hue City,Phu Vang,15,2,1,1,1
2022-02-17,Hue City,Phu Vang,18,2,2,0,0
2022-02-17,Vung Tau,Ba Ria City,7,1,0,1,1
2022-02-17,Vung Tau,Ba Ria City,8,2,0,2,2
2022-02-17,Vung Tau,Ba Ria City,9,15,0,15,12
2022-02-17,Vung Tau,Ba Ria City,10,9,0,9,7
2022-02-17,Vung Tau,Ba Ria City,11,16,1,15,14
2022-02-17,Vung Tau,Ba Ria City,12,16,0,16,15
2022-02-17,Vung Tau,Ba Ria City,13,10,0,10,10
2022-02-17,Vung Tau,Ba Ria City,14,13,0,13,11
2022-02-17,Vung Tau,Ba Ria City,15,5,0,5,5
2022-02-17,Vung Tau,Ba Ria City,16,7,0,7,7
2022-02-17,Vung Tau,Ba Ria City,17,12,0,12,12
2022-02-17,Vung Tau,Ba Ria City,18,10,0,10,9
2022-02-17,Vung Tau,Ba Ria City,19,6,0,6,6
2022-02-17,Vung Tau,Ba Ria City,20,3,0,3,3
2022-02-17,Vung Tau,Tan Thanh,11,1,0,1,1
2022-02-17,Vung Tau,Tan Thanh,12,1,0,1,1
2022-02-17,Vung Tau,Vung Tau City,0,1,1,0,0
2022-02-17,Vung Tau,Vung Tau City,1,1,0,1,0
2022-02-17,Vung Tau,Vung Tau City,3,1,1,0,0
2022-02-17,Vung Tau,Vung Tau City,5,1,1,0,0
2022-02-17,Vung Tau,Vung Tau City,6,21,14,7,3
2022-02-17,Vung Tau,Vung Tau City,7,98,91,7,3
2022-02-17,Vung Tau,Vung Tau City,8,122,108,14,1
2022-02-17,Vung Tau,Vung Tau City,9,177,147,30,8
2022-02-17,Vung Tau,Vung Tau City,10,168,139,29,6
2022-02-17,Vung Tau,Vung Tau City,11,295,267,28,5
2022-02-17,Vung Tau,Vung Tau City,12,221,206,15,0
2022-02-17,Vung Tau,Vung Tau City,13,187,165,22,2
2022-02-17,Vung Tau,Vung Tau City,14,226,210,16,3
2022-02-17,Vung Tau,Vung Tau City,15,185,176,9,0
2022-02-17,Vung Tau,Vung Tau City,16,190,180,10,0
2022-02-17,Vung Tau,Vung Tau City,17,213,193,20,3
2022-02-17,Vung Tau,Vung Tau City,18,252,224,28,3
2022-02-17,Vung Tau,Vung Tau City,19,197,179,18,7
2022-02-17,Vung Tau,Vung Tau City,20,128,105,23,6
2022-02-17,Vung Tau,Vung Tau City,21,75,44,31,20
2022-02-17,Vung Tau,Vung Tau City,22,1,1,0,0
2022-02-17,Vung Tau,Vung Tau City,23,2,2,0,0
2022-02-18,Binh Duong,Ben Cat,12,1,0,1,1
2022-02-18,Binh Duong,Di An,4,1,1,0,0
2022-02-18,Binh Duong,Di An,7,7,0,7,5
2022-02-18,Binh Duong,Di An,8,15,4,11,7
2022-02-18,Binh Duong,Di An,9,23,7,16,15
2022-02-18,Binh Duong,Di An,10,28,5,23,18
2022-02-18,Binh Duong,Di An,11,41,10,31,24
2022-02-18,Binh Duong,Di An,12,34,8,26,21
2022-02-18,Binh Duong,Di An,13,23,9,14,11
2022-02-18,Binh Duong,Di An,14,22,11,11,6
2022-02-18,Binh Duong,Di An,15,8,2,6,5
2022-02-18,Binh Duong,Di An,16,19,5,14,12
2022-02-18,Binh Duong,Di An,17,37,4,33,30
2022-02-18,Binh Duong,Di An,18,17,9,8,7
2022-02-18,Binh Duong,Di An,19,11,7,4,3
2022-02-18,Binh Duong,Di An,20,12,4,8,6
2022-02-18,Binh Duong,Di An,21,12,0,12,11
2022-02-18,Binh Duong,Di An,22,1,1,0,0
2022-02-18,Binh Duong,Tan Uyen,8,2,0,2,1
2022-02-18,Binh Duong,Tan Uyen,9,3,1,2,1
2022-02-18,Binh Duong,Tan Uyen,11,5,5,0,0
2022-02-18,Binh Duong,Tan Uyen,12,2,0,2,2
2022-02-18,Binh Duong,Tan Uyen,13,1,0,1,1
2022-02-18,Binh Duong,Tan Uyen,16,1,1,0,0
2022-02-18,Binh Duong,Tan Uyen,17,1,1,0,0
2022-02-18,Binh Duong,Thu Dau Mot Town,4,1,1,0,0
2022-02-18,Binh Duong,Thu Dau Mot Town,6,20,16,4,3
2022-02-18,Binh Duong,Thu Dau Mot Town,7,93,83,10,2
2022-02-18,Binh Duong,Thu Dau Mot Town,8,173,160,13,0
2022-02-18,Binh Duong,Thu Dau Mot Town,9,201,188,13,1
2022-02-18,Binh Duong,Thu Dau Mot Town,10,355,314,41,11
2022-02-18,Binh Duong,Thu Dau Mot Town,11,623,529,94,44
2022-02-18,Binh Duong,Thu Dau Mot Town,12,382,348,34,7
2022-02-18,Binh Duong,Thu Dau Mot Town,13,312,282,30,2
2022-02-18,Binh Duong,Thu Dau Mot Town,14,270,260,10,0
2022-02-18,Binh Duong,Thu Dau Mot Town,15,210,186,24,0
2022-02-18,Binh Duong,Thu Dau Mot Town,16,212,194,18,2
2022-02-18,Binh Duong,Thu Dau Mot Town,17,270,247,23,4
2022-02-18,Binh Duong,Thu Dau Mot Town,18,345,315,30,4
2022-02-18,Binh Duong,Thu Dau Mot Town,19,259,233,26,7
2022-02-18,Binh Duong,Thu Dau Mot Town,20,193,173,20,6
2022-02-18,Binh Duong,Thu Dau Mot Town,21,110,92,18,4
2022-02-18,Binh Duong,Thu Dau Mot Town,22,1,0,1,0
2022-02-18,Binh Duong,Thu Dau Mot Town,23,1,0,1,0
2022-02-18,Binh Duong,Thuan An,0,1,1,0,0
2022-02-18,Binh Duong,Thuan An,5,1,0,1,1
2022-02-18,Binh Duong,Thuan An,6,4,0,4,3
2022-02-18,Binh Duong,Thuan An,7,1,0,1,0
2022-02-18,Binh Duong,Thuan An,8,10,7,3,1
2022-02-18,Binh Duong,Thuan An,9,32,15,17,11
2022-02-18,Binh Duong,Thuan An,10,59,31,28,25
2022-02-18,Binh Duong,Thuan An,11,70,38,32,27
2022-02-18,Binh Duong,Thuan An,12,68,33,35,29
2022-02-18,Binh Duong,Thuan An,13,45,24,21,18
2022-02-18,Binh Duong,Thuan An,14,47,29,18,15
2022-02-18,Binh Duong,Thuan An,15,24,19,5,3
2022-02-18,Binh Duong,Thuan An,16,40,23,17,12
2022-02-18,Binh Duong,Thuan An,17,37,19,18,9
2022-02-18,Binh Duong,Thuan An,18,30,17,13,9
2022-02-18,Binh Duong,Thuan An,19,29,24,5,4
2022-02-18,Binh Duong,Thuan An,20,23,12,11,5
2022-02-18,Binh Duong,Thuan An,21,22,10,12,8
2022-02-18,Can Tho City,Binh Thuy District,7,3,3,0,0
2022-02-18,Can Tho City,Binh Thuy District,8,4,1,3,0
2022-02-18,Can Tho City,Binh Thuy District,9,5,4,1,0
2022-02-18,Can Tho City,Binh Thuy District,10,11,9,2,0
2022-02-18,Can Tho City,Binh Thuy District,11,7,7,0,0
2022-02-18,Can Tho City,Binh Thuy District,12,13,12,1,0
2022-02-18,Can Tho City,Binh Thuy District,13,6,6,0,0
2022-02-18,Can Tho City,Binh Thuy District,14,13,10,3,1
2022-02-18,Can Tho City,Binh Thuy District,15,3,2,1,0
2022-02-18,Can Tho City,Binh Thuy District,16,7,7,0,0
2022-02-18,Can Tho City,Binh Thuy District,17,8,8,0,0
2022-02-18,Can Tho City,Binh Thuy District,18,9,8,1,0
2022-02-18,Can Tho City,Binh Thuy District,19,5,5,0,0
2022-02-18,Can Tho City,Binh Thuy District,20,7,4,3,0
2022-02-18,Can Tho City,Binh Thuy District,21,1,1,0,0
2022-02-18,Can Tho City,Cai Rang District,7,1,0,1,0
2022-02-18,Can Tho City,Cai Rang District,8,2,2,0,0
2022-02-18,Can Tho City,Cai Rang District,9,2,2,0,0
2022-02-18,Can Tho City,Cai Rang District,10,3,3,0,0
2022-02-18,Can Tho City,Cai Rang District,11,12,7,5,1
2022-02-18,Can Tho City,Cai Rang District,12,7,7,0,0
2022-02-18,Can Tho City,Cai Rang District,13,3,3,0,0
2022-02-18,Can Tho City,Cai Rang District,14,5,4,1,1
2022-02-18,Can Tho City,Cai Rang District,15,10,8,2,0
2022-02-18,Can Tho City,Cai Rang District,16,7,7,0,0
2022-02-18,Can Tho City,Cai Rang District,17,14,14,0,0
2022-02-18,Can Tho City,Cai Rang District,18,10,7,3,0
2022-02-18,Can Tho City,Cai Rang District,19,12,10,2,0
2022-02-18,Can Tho City,Cai Rang District,20,6,6,0,0
2022-02-18,Can Tho City,Cai Rang District,21,3,3,0,0
2022-02-18,Can Tho City,Ninh Kieu District,0,5,3,2,0
2022-02-18,Can Tho City,Ninh Kieu District,2,2,2,0,0
2022-02-18,Can Tho City,Ninh Kieu District,5,3,3,0,0
2022-02-18,Can Tho City,Ninh Kieu District,6,35,31,4,0
2022-02-18,Can Tho City,Ninh Kieu District,7,121,110,11,0
2022-02-18,Can Tho City,Ninh Kieu District,8,209,193,16,0
2022-02-18,Can Tho City,Ninh Kieu District,9,239,230,9,1
2022-02-18,Can Tho City,Ninh Kieu District,10,468,445,23,1
2022-02-18,Can Tho City,Ninh Kieu District,11,769,734,35,3
2022-02-18,Can Tho City,Ninh Kieu District,12,445,414,31,0
2022-02-18,Can Tho City,Ninh Kieu District,13,389,375,14,0
2022-02-18,Can Tho City,Ninh Kieu District,14,333,317,16,0
2022-02-18,Can Tho City,Ninh Kieu District,15,310,292,18,1
2022-02-18,Can Tho City,Ninh Kieu District,16,344,326,18,0
2022-02-18,Can Tho City,Ninh Kieu District,17,397,379,18,0
2022-02-18,Can Tho City,Ninh Kieu District,18,401,381,20,0
2022-02-18,Can Tho City,Ninh Kieu District,19,356,333,23,0
2022-02-18,Can Tho City,Ninh Kieu District,20,294,275,19,0
2022-02-18,Can Tho City,Ninh Kieu District,21,169,144,25,0
2022-02-18,Can Tho City,Ninh Kieu District,22,1,0,1,0
2022-02-18,Can Tho City,Ninh Kieu District,23,3,1,2,0
2022-02-18,Dong Nai,Bien Hoa City,1,4,1,3,0
2022-02-18,Dong Nai,Bien Hoa City,2,2,0,2,0
2022-02-18,Dong Nai,Bien Hoa City,4,3,3,0,0
2022-02-18,Dong Nai,Bien Hoa City,5,2,0,2,1
2022-02-18,Dong Nai,Bien Hoa City,6,23,13,10,6
2022-02-18,Dong Nai,Bien Hoa City,7,118,108,10,2
2022-02-18,Dong Nai,Bien Hoa City,8,213,190,23,3
2022-02-18,Dong Nai,Bien Hoa City,9,310,275,35,3
2022-02-18,Dong Nai,Bien Hoa City,10,676,595,81,13
2022-02-18,Dong Nai,Bien Hoa City,11,899,803,96,31
2022-02-18,Dong Nai,Bien Hoa City,12,671,622,49,13
2022-02-18,Dong Nai,Bien Hoa City,13,619,572,47,8
2022-02-18,Dong Nai,Bien Hoa City,14,561,510,51,10
2022-02-18,Dong Nai,Bien Hoa City,15,411,379,32,3
2022-02-18,Dong Nai,Bien Hoa City,16,400,376,24,0
2022-02-18,Dong Nai,Bien Hoa City,17,467,437,30,4
2022-02-18,Dong Nai,Bien Hoa City,18,639,572,67,3
2022-02-18,Dong Nai,Bien Hoa City,19,578,513,65,21
2022-02-18,Dong Nai,Bien Hoa City,20,440,365,75,36
2022-02-18,Dong Nai,Bien Hoa City,21,180,119,61,20
2022-02-18,Dong Nai,Bien Hoa City,22,2,1,1,0
2022-02-18,Dong Nai,Bien Hoa City,23,2,1,1,1
2022-02-18,Dong Nai,Long Khanh,14,1,0,1,1
2022-02-18,Dong Nai,Long Thanh,8,1,0,1,1
2022-02-18,Dong Nai,Long Thanh,11,2,0,2,2
2022-02-18,Dong Nai,Long Thanh,13,1,0,1,1
2022-02-18,Dong Nai,Long Thanh,15,1,0,1,1
2022-02-18,Dong Nai,Long Thanh,16,1,0,1,1
2022-02-18,Dong Nai,Long Thanh,17,1,0,1,1
2022-02-18,Dong Nai,Long Thanh,18,1,0,1,1
2022-02-18,Dong Nai,Long Thanh,19,1,0,1,1
2022-02-18,Dong Nai,Long Thanh,20,2,0,2,2
2022-02-18,Dong Nai,Thong Nhat,9,1,1,0,0
2022-02-18,Dong Nai,Thong Nhat,10,1,1,0,0
2022-02-18,Dong Nai,Thong Nhat,11,2,2,0,0
2022-02-18,Dong Nai,Thong Nhat,13,2,2,0,0
2022-02-18,Dong Nai,Thong Nhat,14,1,1,0,0
2022-02-18,Dong Nai,Thong Nhat,19,3,3,0,0
2022-02-18,Dong Nai,Thong Nhat,20,1,1,0,0
2022-02-18,Dong Nai,Thong Nhat,21,1,1,0,0
2022-02-18,Dong Nai,Trang Bom,12,1,0,1,0
2022-02-18,Dong Nai,Trang Bom,14,1,0,1,1
2022-02-18,Dong Nai,Trang Bom,15,1,0,1,1
2022-02-18,Dong Nai,Trang Bom,17,1,0,1,1
2022-02-18,Hai Phong City,An Duong,2,1,0,1,0
2022-02-18,Hai Phong City,An Duong,7,1,0,1,1
2022-02-18,Hai Phong City,An Duong,9,7,3,4,3
2022-02-18,Hai Phong City,An Duong,10,7,3,4,2
2022-02-18,Hai Phong City,An Duong,11,7,1,6,4
2022-02-18,Hai Phong City,An Duong,12,7,0,7,6
2022-02-18,Hai Phong City,An Duong,13,4,2,2,1
2022-02-18,Hai Phong City,An Duong,14,7,2,5,3
2022-02-18,Hai Phong City,An Duong,15,6,2,4,3
2022-02-18,Hai Phong City,An Duong,16,4,1,3,3
2022-02-18,Hai Phong City,An Duong,17,2,0,2,1
2022-02-18,Hai Phong City,An Duong,18,2,0,2,1
2022-02-18,Hai Phong City,An Duong,19,8,2,6,4
2022-02-18,Hai Phong City,An Duong,20,3,0,3,3
2022-02-18,Hai Phong City,Do Son District,10,1,0,1,1
2022-02-18,Hai Phong City,Hai An District,7,12,7,5,4
2022-02-18,Hai Phong City,Hai An District,8,22,10,12,8
2022-02-18,Hai Phong City,Hai An District,9,14,9,5,4
2022-02-18,Hai Phong City,Hai An District,10,21,17,4,2
2022-02-18,Hai Phong City,Hai An District,11,55,37,18,11
2022-02-18,Hai Phong City,Hai An District,12,33,23,10,5
2022-02-18,Hai Phong City,Hai An District,13,9,8,1,0
2022-02-18,Hai Phong City,Hai An District,14,18,10,8,2
2022-02-18,Hai Phong City,Hai An District,15,32,21,11,6
2022-02-18,Hai Phong City,Hai An District,16,32,17,15,3
2022-02-18,Hai Phong City,Hai An District,17,32,21,11,5
2022-02-18,Hai Phong City,Hai An District,18,53,33,20,6
2022-02-18,Hai Phong City,Hai An District,19,26,14,12,6
2022-02-18,Hai Phong City,Hai An District,20,27,16,11,9
2022-02-18,Hai Phong City,Hai An District,21,16,7,9,7
2022-02-18,Hai Phong City,Hong Bang District,6,1,0,1,1
2022-02-18,Hai Phong City,Hong Bang District,7,27,12,15,11
2022-02-18,Hai Phong City,Hong Bang District,8,41,29,12,9
2022-02-18,Hai Phong City,Hong Bang District,9,50,35,15,9
2022-02-18,Hai Phong City,Hong Bang District,10,73,50,23,8
2022-02-18,Hai Phong City,Hong Bang District,11,132,86,46,32
2022-02-18,Hai Phong City,Hong Bang District,12,81,63,18,14
2022-02-18,Hai Phong City,Hong Bang District,13,45,34,11,2
2022-02-18,Hai Phong City,Hong Bang District,14,43,34,9,3
2022-02-18,Hai Phong City,Hong Bang District,15,66,42,24,15
2022-02-18,Hai Phong City,Hong Bang District,16,67,35,32,25
2022-02-18,Hai Phong City,Hong Bang District,17,86,44,42,29
2022-02-18,Hai Phong City,Hong Bang District,18,104,44,60,47
2022-02-18,Hai Phong City,Hong Bang District,19,73,30,43,37
2022-02-18,Hai Phong City,Hong Bang District,20,54,17,37,29
2022-02-18,Hai Phong City,Hong Bang District,21,14,7,7,5
2022-02-18,Hai Phong City,Hong Bang District,22,1,0,1,0
2022-02-18,Hai Phong City,Kien An District,7,9,1,8,7
2022-02-18,Hai Phong City,Kien An District,8,9,1,8,3
2022-02-18,Hai Phong City,Kien An District,9,7,2,5,4
2022-02-18,Hai Phong City,Kien An District,10,7,6,1,1
2022-02-18,Hai Phong City,Kien An District,11,17,11,6,4
2022-02-18,Hai Phong City,Kien An District,12,10,4,6,1
2022-02-18,Hai Phong City,Kien An District,13,9,6,3,0
2022-02-18,Hai Phong City,Kien An District,14,14,8,6,3
2022-02-18,Hai Phong City,Kien An District,15,15,9,6,3
2022-02-18,Hai Phong City,Kien An District,16,16,9,7,4
2022-02-18,Hai Phong City,Kien An District,17,18,5,13,10
2022-02-18,Hai Phong City,Kien An District,18,6,1,5,1
2022-02-18,Hai Phong City,Kien An District,19,15,6,9,7
2022-02-18,Hai Phong City,Kien An District,20,14,5,9,7
2022-02-18,Hai Phong City,Kien An District,21,2,0,2,2
2022-02-18,Hai Phong City,Kien An District,22,2,0,2,1
2022-02-18,Hai Phong City,Kien An District,23,1,1,0,0
2022-02-18,Hai Phong City,Le Chan District,1,4,1,3,0
2022-02-18,Hai Phong City,Le Chan District,2,3,0,3,1
2022-02-18,Hai Phong City,Le Chan District,6,1,0,1,1
2022-02-18,Hai Phong City,Le Chan District,7,59,25,34,20
2022-02-18,Hai Phong City,Le Chan District,8,130,83,47,29
2022-02-18,Hai Phong City,Le Chan District,9,128,84,44,16
2022-02-18,Hai Phong City,Le Chan District,10,220,158,62,34
2022-02-18,Hai Phong City,Le Chan District,11,409,220,189,126
2022-02-18,Hai Phong City,Le Chan District,12,254,180,74,45
2022-02-18,Hai Phong City,Le Chan District,13,113,95,18,2
2022-02-18,Hai Phong City,Le Chan District,14,195,145,50,24
2022-02-18,Hai Phong City,Le Chan District,15,289,171,118,78
2022-02-18,Hai Phong City,Le Chan District,16,304,173,131,89
2022-02-18,Hai Phong City,Le Chan District,17,333,205,128,83
2022-02-18,Hai Phong City,Le Chan District,18,387,209,178,132
2022-02-18,Hai Phong City,Le Chan District,19,325,162,163,120
2022-02-18,Hai Phong City,Le Chan District,20,222,92,130,84
2022-02-18,Hai Phong City,Le Chan District,21,108,33,75,48
2022-02-18,Hai Phong City,Le Chan District,22,2,0,2,1
2022-02-18,Hai Phong City,Le Chan District,23,1,0,1,1
2022-02-18,Hai Phong City,Ngo Quyen District,0,1,0,1,0
2022-02-18,Hai Phong City,Ngo Quyen District,2,1,0,1,0
2022-02-18,Hai Phong City,Ngo Quyen District,3,3,2,1,0
2022-02-18,Hai Phong City,Ngo Quyen District,5,2,0,2,0
2022-02-18,Hai Phong City,Ngo Quyen District,6,3,0,3,0
2022-02-18,Hai Phong City,Ngo Quyen District,7,48,25,23,16
2022-02-18,Hai Phong City,Ngo Quyen District,8,104,70,34,19
2022-02-18,Hai Phong City,Ngo Quyen District,9,102,85,17,6
2022-02-18,Hai Phong City,Ngo Quyen District,10,168,125,43,22
2022-02-18,Hai Phong City,Ngo Quyen District,11,323,227,96,56
2022-02-18,Hai Phong City,Ngo Quyen District,12,195,162,33,12
2022-02-18,Hai Phong City,Ngo Quyen District,13,112,94,18,6
2022-02-18,Hai Phong City,Ngo Quyen District,14,148,112,36,14
2022-02-18,Hai Phong City,Ngo Quyen District,15,230,148,82,47
2022-02-18,Hai Phong City,Ngo Quyen District,16,233,157,76,45
2022-02-18,Hai Phong City,Ngo Quyen District,17,283,168,115,79
2022-02-18,Hai Phong City,Ngo Quyen District,18,274,156,118,76
2022-02-18,Hai Phong City,Ngo Quyen District,19,251,137,114,81
2022-02-18,Hai Phong City,Ngo Quyen District,20,186,92,94,58
2022-02-18,Hai Phong City,Ngo Quyen District,21,98,33,65,41
2022-02-18,Hai Phong City,Ngo Quyen District,22,2,0,2,1
2022-02-18,Hai Phong City,Thuy Nguyen,8,1,0,1,1
2022-02-18,Hai Phong City,Thuy Nguyen,10,2,0,2,1
2022-02-18,Hai Phong City,Thuy Nguyen,11,6,2,4,4
2022-02-18,Hai Phong City,Thuy Nguyen,13,1,0,1,1
2022-02-18,Hai Phong City,Thuy Nguyen,14,2,0,2,2
2022-02-18,Hai Phong City,Thuy Nguyen,16,2,0,2,2
2022-02-18,Hai Phong City,Thuy Nguyen,17,2,0,2,1
2022-02-18,Hue City,Hue City,0,9,9,0,0
2022-02-18,Hue City,Hue City,1,1,0,1,0
2022-02-18,Hue City,Hue City,3,2,2,0,0
2022-02-18,Hue City,Hue City,5,2,1,1,0
2022-02-18,Hue City,Hue City,6,46,44,2,0
2022-02-18,Hue City,Hue City,7,184,170,14,1
2022-02-18,Hue City,Hue City,8,265,248,17,0
2022-02-18,Hue City,Hue City,9,197,179,18,2
2022-02-18,Hue City,Hue City,10,408,388,20,0
2022-02-18,Hue City,Hue City,11,753,693,60,10
2022-02-18,Hue City,Hue City,12,477,457,20,1
2022-02-18,Hue City,Hue City,13,289,276,13,0
2022-02-18,Hue City,Hue City,14,313,295,18,0
2022-02-18,Hue City,Hue City,15,361,339,22,1
2022-02-18,Hue City,Hue City,16,348,329,19,0
2022-02-18,Hue City,Hue City,17,496,456,40,0
2022-02-18,Hue City,Hue City,18,551,511,40,3
2022-02-18,Hue City,Hue City,19,505,455,50,8
2022-02-18,Hue City,Hue City,20,395,347,48,4
2022-02-18,Hue City,Hue City,21,234,193,41,11
2022-02-18,Hue City,Hue City,22,4,3,1,0
2022-02-18,Hue City,Hue City,23,5,3,2,0
2022-02-18,Hue City,Huong Thuy,10,1,0,1,1
2022-02-18,Hue City,Huong Thuy,11,1,0,1,0
2022-02-18,Hue City,Huong Thuy,17,2,1,1,0
2022-02-18,Hue City,Huong Tra,11,1,0,1,0
2022-02-18,Hue City,Huong Tra,15,1,0,1,1
2022-02-18,Hue City,Huong Tra,18,1,1,0,0
2022-02-18,Hue City,Phu Vang,6,1,1,0,0
2022-02-18,Hue City,Phu Vang,7,1,1,0,0
2022-02-18,Hue City,Phu Vang,8,3,3,0,0
2022-02-18,Hue City,Phu Vang,10,3,3,0,0
2022-02-18,Hue City,Phu Vang,12,3,3,0,0
2022-02-18,Hue City,Phu Vang,15,1,1,0,0
2022-02-18,Hue City,Phu Vang,18,3,1,2,0
2022-02-18,Hue City,Phu Vang,19,3,3,0,0
2022-02-18,Hue City,Phu Vang,21,2,2,0,0
2022-02-18,Vung Tau,Ba Ria City,8,3,0,3,2
2022-02-18,Vung Tau,Ba Ria City,9,3,0,3,3
2022-02-18,Vung Tau,Ba Ria City,10,7,2,5,4
2022-02-18,Vung Tau,Ba Ria City,11,11,1,10,10
2022-02-18,Vung Tau,Ba Ria City,12,3,1,2,2
2022-02-18,Vung Tau,Ba Ria City,13,8,0,8,8
2022-02-18,Vung Tau,Ba Ria City,14,4,0,4,4
2022-02-18,Vung Tau,Ba Ria City,15,4,0,4,4
2022-02-18,Vung Tau,Ba Ria City,16,10,0,10,10
2022-02-18,Vung Tau,Ba Ria City,17,7,0,7,7
2022-02-18,Vung Tau,Ba Ria City,18,2,0,2,2
2022-02-18,Vung Tau,Ba Ria City,19,11,0,11,11
2022-02-18,Vung Tau,Ba Ria City,20,9,0,9,9
2022-02-18,Vung Tau,Ba Ria City,21,2,0,2,2
2022-02-18,Vung Tau,Tan Thanh,17,2,0,2,2
2022-02-18,Vung Tau,Vung Tau City,0,1,0,1,0
2022-02-18,Vung Tau,Vung Tau City,1,1,0,1,0
2022-02-18,Vung Tau,Vung Tau City,2,3,1,2,0
2022-02-18,Vung Tau,Vung Tau City,4,2,1,1,0
2022-02-18,Vung Tau,Vung Tau City,5,2,2,0,0
2022-02-18,Vung Tau,Vung Tau City,6,32,22,10,5
2022-02-18,Vung Tau,Vung Tau City,7,91,85,6,0
2022-02-18,Vung Tau,Vung Tau City,8,131,120,11,2
2022-02-18,Vung Tau,Vung Tau City,9,122,112,10,0
2022-02-18,Vung Tau,Vung Tau City,10,190,173,17,2
2022-02-18,Vung Tau,Vung Tau City,11,311,288,23,6
2022-02-18,Vung Tau,Vung Tau City,12,235,221,14,0
2022-02-18,Vung Tau,Vung Tau City,13,173,155,18,4
2022-02-18,Vung Tau,Vung Tau City,14,191,171,20,2
2022-02-18,Vung Tau,Vung Tau City,15,233,204,29,0
2022-02-18,Vung Tau,Vung Tau City,16,189,172,17,1
2022-02-18,Vung Tau,Vung Tau City,17,211,196,15,3
2022-02-18,Vung Tau,Vung Tau City,18,267,244,23,5
2022-02-18,Vung Tau,Vung Tau City,19,269,233,36,8
2022-02-18,Vung Tau,Vung Tau City,20,180,149,31,13
2022-02-18,Vung Tau,Vung Tau City,21,101,67,34,14
2022-02-18,Vung Tau,Vung Tau City,22,1,1,0,0
2022-02-19,Binh Duong,Di An,7,7,0,7,7
2022-02-19,Binh Duong,Di An,8,4,2,2,2
2022-02-19,Binh Duong,Di An,9,18,7,11,10
2022-02-19,Binh Duong,Di An,10,16,5,11,7
2022-02-19,Binh Duong,Di An,11,37,14,23,18
2022-02-19,Binh Duong,Di An,12,19,8,11,6
2022-02-19,Binh Duong,Di An,13,28,15,13,9
2022-02-19,Binh Duong,Di An,14,16,7,9,8
2022-02-19,Binh Duong,Di An,15,14,11,3,1
2022-02-19,Binh Duong,Di An,16,8,4,4,3
2022-02-19,Binh Duong,Di An,17,9,6,3,0
2022-02-19,Binh Duong,Di An,18,14,6,8,6
2022-02-19,Binh Duong,Di An,19,15,9,6,4
2022-02-19,Binh Duong,Di An,20,8,4,4,2
2022-02-19,Binh Duong,Di An,21,7,0,7,5
2022-02-19,Binh Duong,Tan Uyen,9,1,1,0,0
2022-02-19,Binh Duong,Tan Uyen,10,4,1,3,2
2022-02-19,Binh Duong,Tan Uyen,11,2,1,1,0
2022-02-19,Binh Duong,Tan Uyen,15,1,0,1,1
2022-02-19,Binh Duong,Tan Uyen,17,1,1,0,0
2022-02-19,Binh Duong,Tan Uyen,18,1,0,1,1
2022-02-19,Binh Duong,Tan Uyen,20,1,1,0,0
2022-02-19,Binh Duong,Thu Dau Mot Town,6,26,22,4,3
2022-02-19,Binh Duong,Thu Dau Mot Town,7,84,78,6,0
2022-02-19,Binh Duong,Thu Dau Mot Town,8,188,178,10,1
2022-02-19,Binh Duong,Thu Dau Mot Town,9,247,220,27,3
2022-02-19,Binh Duong,Thu Dau Mot Town,10,375,346,29,8
2022-02-19,Binh Duong,Thu Dau Mot Town,11,532,500,32,3
2022-02-19,Binh Duong,Thu Dau Mot Town,12,399,372,27,5
2022-02-19,Binh Duong,Thu Dau Mot Town,13,319,298,21,3
2022-02-19,Binh Duong,Thu Dau Mot Town,14,272,258,14,1
2022-02-19,Binh Duong,Thu Dau Mot Town,15,228,220,8,1
2022-02-19,Binh Duong,Thu Dau Mot Town,16,199,180,19,3
2022-02-19,Binh Duong,Thu Dau Mot Town,17,286,263,23,6
2022-02-19,Binh Duong,Thu Dau Mot Town,18,348,291,57,33
2022-02-19,Binh Duong,Thu Dau Mot Town,19,295,233,62,30
2022-02-19,Binh Duong,Thu Dau Mot Town,20,229,177,52,25
2022-02-19,Binh Duong,Thu Dau Mot Town,21,106,82,24,12
2022-02-19,Binh Duong,Thu Dau Mot Town,22,5,2,3,0
2022-02-19,Binh Duong,Thuan An,6,1,1,0,0
2022-02-19,Binh Duong,Thuan An,7,11,6,5,4
2022-02-19,Binh Duong,Thuan An,8,14,7,7,3
2022-02-19,Binh Duong,Thuan An,9,36,25,11,8
2022-02-19,Binh Duong,Thuan An,10,43,31,12,6
2022-02-19,Binh Duong,Thuan An,11,68,44,24,22
2022-02-19,Binh Duong,Thuan An,12,64,36,28,17
2022-02-19,Binh Duong,Thuan An,13,42,28,14,10
2022-02-19,Binh Duong,Thuan An,14,28,15,13,10
2022-02-19,Binh Duong,Thuan An,15,18,14,4,0
2022-02-19,Binh Duong,Thuan An,16,27,16,11,8
2022-02-19,Binh Duong,Thuan An,17,26,18,8,4
2022-02-19,Binh Duong,Thuan An,18,39,23,16,12
2022-02-19,Binh Duong,Thuan An,19,49,22,27,21
2022-02-19,Binh Duong,Thuan An,20,19,8,11,8
2022-02-19,Binh Duong,Thuan An,21,14,4,10,4
2022-02-19,Binh Duong,Thuan An,23,1,0,1,0
2022-02-19,Can Tho City,Binh Thuy District,7,1,0,1,0
2022-02-19,Can Tho City,Binh Thuy District,8,4,2,2,0
2022-02-19,Can Tho City,Binh Thuy District,9,7,7,0,0
2022-02-19,Can Tho City,Binh Thuy District,10,12,10,2,0
2022-02-19,Can Tho City,Binh Thuy District,11,11,10,1,0
2022-02-19,Can Tho City,Binh Thuy District,12,7,6,1,0
2022-02-19,Can Tho City,Binh Thuy District,13,7,7,0,0
2022-02-19,Can Tho City,Binh Thuy District,14,9,9,0,0
2022-02-19,Can Tho City,Binh Thuy District,15,8,7,1,0
2022-02-19,Can Tho City,Binh Thuy District,16,16,14,2,0
2022-02-19,Can Tho City,Binh Thuy District,17,7,7,0,0
2022-02-19,Can Tho City,Binh Thuy District,18,10,9,1,0
2022-02-19,Can Tho City,Binh Thuy District,19,4,4,0,0
2022-02-19,Can Tho City,Binh Thuy District,20,9,7,2,0
2022-02-19,Can Tho City,Cai Rang District,6,1,1,0,0
2022-02-19,Can Tho City,Cai Rang District,7,3,3,0,0
2022-02-19,Can Tho City,Cai Rang District,8,9,7,2,0
2022-02-19,Can Tho City,Cai Rang District,9,9,4,5,3
2022-02-19,Can Tho City,Cai Rang District,10,6,4,2,0
2022-02-19,Can Tho City,Cai Rang District,11,17,17,0,0
2022-02-19,Can Tho City,Cai Rang District,12,9,9,0,0
2022-02-19,Can Tho City,Cai Rang District,13,3,3,0,0
2022-02-19,Can Tho City,Cai Rang District,14,8,8,0,0
2022-02-19,Can Tho City,Cai Rang District,15,3,3,0,0
2022-02-19,Can Tho City,Cai Rang District,16,4,4,0,0
2022-02-19,Can Tho City,Cai Rang District,17,11,10,1,0
2022-02-19,Can Tho City,Cai Rang District,18,14,12,2,0
2022-02-19,Can Tho City,Cai Rang District,19,10,9,1,0
2022-02-19,Can Tho City,Cai Rang District,20,6,6,0,0
2022-02-19,Can Tho City,Cai Rang District,21,2,2,0,0
2022-02-19,Can Tho City,Ninh Kieu District,0,1,1,0,0
2022-02-19,Can Tho City,Ninh Kieu District,1,1,1,0,0
2022-02-19,Can Tho City,Ninh Kieu District,3,1,0,1,0
2022-02-19,Can Tho City,Ninh Kieu District,5,3,3,0,0
2022-02-19,Can Tho City,Ninh Kieu District,6,41,39,2,1
2022-02-19,Can Tho City,Ninh Kieu District,7,118,109,9,0
2022-02-19,Can Tho City,Ninh Kieu District,8,218,209,9,0
2022-02-19,Can Tho City,Ninh Kieu District,9,282,265,17,0
2022-02-19,Can Tho City,Ninh Kieu District,10,450,426,24,0
2022-02-19,Can Tho City,Ninh Kieu District,11,693,649,44,4
2022-02-19,Can Tho City,Ninh Kieu District,12,516,489,27,0
2022-02-19,Can Tho City,Ninh Kieu District,13,364,344,20,0
2022-02-19,Can Tho City,Ninh Kieu District,14,307,297,10,0
2022-02-19,Can Tho City,Ninh Kieu District,15,298,283,15,0
2022-02-19,Can Tho City,Ninh Kieu District,16,342,327,15,0
2022-02-19,Can Tho City,Ninh Kieu District,17,390,374,16,0
2022-02-19,Can Tho City,Ninh Kieu District,18,383,358,25,0
2022-02-19,Can Tho City,Ninh Kieu District,19,390,371,19,1
2022-02-19,Can Tho City,Ninh Kieu District,20,296,281,15,0
2022-02-19,Can Tho City,Ninh Kieu District,21,153,134,19,1
2022-02-19,Can Tho City,Ninh Kieu District,22,1,1,0,0
2022-02-19,Can Tho City,Ninh Kieu District,23,6,6,0,0
2022-02-19,Dong Nai,Bien Hoa City,2,3,1,2,0
2022-02-19,Dong Nai,Bien Hoa City,4,1,0,1,0
2022-02-19,Dong Nai,Bien Hoa City,5,2,1,1,1
2022-02-19,Dong Nai,Bien Hoa City,6,35,23,12,10
2022-02-19,Dong Nai,Bien Hoa City,7,131,109,22,11
2022-02-19,Dong Nai,Bien Hoa City,8,243,224,19,3
2022-02-19,Dong Nai,Bien Hoa City,9,391,363,28,5
2022-02-19,Dong Nai,Bien Hoa City,10,632,576,56,10
2022-02-19,Dong Nai,Bien Hoa City,11,980,843,137,51
2022-02-19,Dong Nai,Bien Hoa City,12,803,739,64,16
2022-02-19,Dong Nai,Bien Hoa City,13,604,556,48,5
2022-02-19,Dong Nai,Bien Hoa City,14,453,406,47,5
2022-02-19,Dong Nai,Bien Hoa City,15,461,423,38,8
2022-02-19,Dong Nai,Bien Hoa City,16,464,418,46,8
2022-02-19,Dong Nai,Bien Hoa City,17,588,507,81,20
2022-02-19,Dong Nai,Bien Hoa City,18,680,551,129,64
2022-02-19,Dong Nai,Bien Hoa City,19,606,464,142,77
2022-02-19,Dong Nai,Bien Hoa City,20,542,371,171,99
2022-02-19,Dong Nai,Bien Hoa City,21,241,126,115,61
2022-02-19,Dong Nai,Bien Hoa City,22,4,0,4,0
2022-02-19,Dong Nai,Long Khanh,12,1,0,1,1
2022-02-19,Dong Nai,Long Khanh,13,1,0,1,1
2022-02-19,Dong Nai,Long Thanh,8,2,0,2,1
2022-02-19,Dong Nai,Long Thanh,9,1,0,1,1
2022-02-19,Dong Nai,Long Thanh,11,1,0,1,0
2022-02-19,Dong Nai,Long Thanh,15,3,1,2,2
2022-02-19,Dong Nai,Long Thanh,16,1,1,0,0
2022-02-19,Dong Nai,Long Thanh,19,3,0,3,1
2022-02-19,Dong Nai,Thong Nhat,7,1,1,0,0
2022-02-19,Dong Nai,Thong Nhat,9,1,1,0,0
2022-02-19,Dong Nai,Thong Nhat,10,2,2,0,0
2022-02-19,Dong Nai,Thong Nhat,11,1,1,0,0
2022-02-19,Dong Nai,Thong Nhat,12,2,2,0,0
2022-02-19,Dong Nai,Thong Nhat,14,3,3,0,0
2022-02-19,Dong Nai,Thong Nhat,17,1,1,0,0
2022-02-19,Dong Nai,Thong Nhat,18,3,3,0,0
2022-02-19,Dong Nai,Thong Nhat,19,1,1,0,0
2022-02-19,Dong Nai,Trang Bom,12,2,0,2,2
2022-02-19,Dong Nai,Trang Bom,13,3,1,2,1
2022-02-19,Dong Nai,Trang Bom,14,1,1,0,0
2022-02-19,Hai Phong City,An Duong,0,2,0,2,0
2022-02-19,Hai Phong City,An Duong,7,1,0,1,1
2022-02-19,Hai Phong City,An Duong,8,4,0,4,3
2022-02-19,Hai Phong City,An Duong,9,3,0,3,3
2022-02-19,Hai Phong City,An Duong,10,2,1,1,1
2022-02-19,Hai Phong City,An Duong,11,10,1,9,8
2022-02-19,Hai Phong City,An Duong,12,4,0,4,4
2022-02-19,Hai Phong City,An Duong,13,3,0,3,3
2022-02-19,Hai Phong City,An Duong,14,5,1,4,3
2022-02-19,Hai Phong City,An Duong,15,6,0,6,4
2022-02-19,Hai Phong City,An Duong,16,2,1,1,1
2022-02-19,Hai Phong City,An Duong,17,7,0,7,5
2022-02-19,Hai Phong City,An Duong,18,6,0,6,5
2022-02-19,Hai Phong City,An Duong,19,3,0,3,2
2022-02-19,Hai Phong City,An Duong,20,2,0,2,1
2022-02-19,Hai Phong City,An Duong,21,1,0,1,1
2022-02-19,Hai Phong City,Do Son District,18,1,0,1,1
2022-02-19,Hai Phong City,Do Son District,20,1,0,1,1
2022-02-19,Hai Phong City,Duong Kinh District,9,1,0,1,1
2022-02-19,Hai Phong City,Duong Kinh District,10,2,0,2,2
2022-02-19,Hai Phong City,Hai An District,5,2,2,0,0
2022-02-19,Hai Phong City,Hai An District,7,12,1,11,9
2022-02-19,Hai Phong City,Hai An District,8,23,9,14,8
2022-02-19,Hai Phong City,Hai An District,9,14,7,7,1
2022-02-19,Hai Phong City,Hai An District,10,36,15,21,13
2022-02-19,Hai Phong City,Hai An District,11,52,26,26,22
2022-02-19,Hai Phong City,Hai An District,12,39,14,25,22
2022-02-19,Hai Phong City,Hai An District,13,23,12,11,8
2022-02-19,Hai Phong City,Hai An District,14,24,11,13,8
2022-02-19,Hai Phong City,Hai An District,15,32,13,19,14
2022-02-19,Hai Phong City,Hai An District,16,35,11,24,19
2022-02-19,Hai Phong City,Hai An District,17,53,13,40,31
2022-02-19,Hai Phong City,Hai An District,18,53,6,47,43
2022-02-19,Hai Phong City,Hai An District,19,77,16,61,48
2022-02-19,Hai Phong City,Hai An District,20,25,12,13,11
2022-02-19,Hai Phong City,Hai An District,21,13,1,12,8
2022-02-19,Hai Phong City,Hong Bang District,0,2,1,1,0
2022-02-19,Hai Phong City,Hong Bang District,6,1,0,1,1
2022-02-19,Hai Phong City,Hong Bang District,7,27,4,23,20
2022-02-19,Hai Phong City,Hong Bang District,8,36,10,26,21
2022-02-19,Hai Phong City,Hong Bang District,9,51,22,29,20
2022-02-19,Hai Phong City,Hong Bang District,10,93,48,45,36
2022-02-19,Hai Phong City,Hong Bang District,11,158,55,103,76
2022-02-19,Hai Phong City,Hong Bang District,12,130,46,84,69
2022-02-19,Hai Phong City,Hong Bang District,13,63,24,39,31
2022-02-19,Hai Phong City,Hong Bang District,14,57,34,23,20
2022-02-19,Hai Phong City,Hong Bang District,15,56,12,44,39
2022-02-19,Hai Phong City,Hong Bang District,16,104,27,77,64
2022-02-19,Hai Phong City,Hong Bang District,17,114,18,96,82
2022-02-19,Hai Phong City,Hong Bang District,18,123,20,103,93
2022-02-19,Hai Phong City,Hong Bang District,19,119,24,95,78
2022-02-19,Hai Phong City,Hong Bang District,20,72,18,54,45
2022-02-19,Hai Phong City,Hong Bang District,21,32,5,27,25
2022-02-19,Hai Phong City,Hong Bang District,22,3,0,3,2
2022-02-19,Hai Phong City,Hong Bang District,23,2,0,2,2
2022-02-19,Hai Phong City,Kien An District,4,1,0,1,1
2022-02-19,Hai Phong City,Kien An District,7,4,0,4,4
2022-02-19,Hai Phong City,Kien An District,8,5,1,4,4
2022-02-19,Hai Phong City,Kien An District,9,10,1,9,8
2022-02-19,Hai Phong City,Kien An District,10,14,6,8,8
2022-02-19,Hai Phong City,Kien An District,11,17,7,10,8
2022-02-19,Hai Phong City,Kien An District,12,20,9,11,7
2022-02-19,Hai Phong City,Kien An District,13,6,3,3,2
2022-02-19,Hai Phong City,Kien An District,14,6,2,4,4
2022-02-19,Hai Phong City,Kien An District,15,14,8,6,1
2022-02-19,Hai Phong City,Kien An District,16,18,5,13,12
2022-02-19,Hai Phong City,Kien An District,17,11,4,7,5
2022-02-19,Hai Phong City,Kien An District,18,21,13,8,6
2022-02-19,Hai Phong City,Kien An District,19,12,6,6,4
2022-02-19,Hai Phong City,Kien An District,20,22,0,22,13
2022-02-19,Hai Phong City,Kien An District,21,5,0,5,4
2022-02-19,Hai Phong City,Le Chan District,1,1,0,1,0
2022-02-19,Hai Phong City,Le Chan District,2,1,0,1,1
2022-02-19,Hai Phong City,Le Chan District,4,2,2,0,0
2022-02-19,Hai Phong City,Le Chan District,6,5,1,4,3
2022-02-19,Hai Phong City,Le Chan District,7,44,9,35,27
2022-02-19,Hai Phong City,Le Chan District,8,118,59,59,38
2022-02-19,Hai Phong City,Le Chan District,9,117,67,50,30
2022-02-19,Hai Phong City,Le Chan District,10,284,130,154,110
2022-02-19,Hai Phong City,Le Chan District,11,496,199,297,251
2022-02-19,Hai Phong City,Le Chan District,12,391,138,253,209
2022-02-19,Hai Phong City,Le Chan District,13,208,78,130,97
2022-02-19,Hai Phong City,Le Chan District,14,227,103,124,93
2022-02-19,Hai Phong City,Le Chan District,15,339,117,222,183
2022-02-19,Hai Phong City,Le Chan District,16,402,124,278,228
2022-02-19,Hai Phong City,Le Chan District,17,556,122,434,366
2022-02-19,Hai Phong City,Le Chan District,18,598,154,444,371
2022-02-19,Hai Phong City,Le Chan District,19,431,106,325,286
2022-02-19,Hai Phong City,Le Chan District,20,303,66,237,191
2022-02-19,Hai Phong City,Le Chan District,21,160,36,124,83
2022-02-19,Hai Phong City,Le Chan District,22,3,0,3,2
2022-02-19,Hai Phong City,Le Chan District,23,4,0,4,4
2022-02-19,Hai Phong City,Ngo Quyen District,1,2,1,1,0
2022-02-19,Hai Phong City,Ngo Quyen District,4,2,0,2,0
2022-02-19,Hai Phong City,Ngo Quyen District,5,3,2,1,1
2022-02-19,Hai Phong City,Ngo Quyen District,6,2,0,2,2
2022-02-19,Hai Phong City,Ngo Quyen District,7,66,17,49,43
2022-02-19,Hai Phong City,Ngo Quyen District,8,144,61,83,69
2022-02-19,Hai Phong City,Ngo Quyen District,9,142,85,57,37
2022-02-19,Hai Phong City,Ngo Quyen District,10,185,102,83,61
2022-02-19,Hai Phong City,Ngo Quyen District,11,338,139,199,166
2022-02-19,Hai Phong City,Ngo Quyen District,12,265,126,139,113
2022-02-19,Hai Phong City,Ngo Quyen District,13,137,77,60,39
2022-02-19,Hai Phong City,Ngo Quyen District,14,189,83,106,76
2022-02-19,Hai Phong City,Ngo Quyen District,15,261,92,169,138
2022-02-19,Hai Phong City,Ngo Quyen District,16,386,132,254,208
2022-02-19,Hai Phong City,Ngo Quyen District,17,429,118,311,271
2022-02-19,Hai Phong City,Ngo Quyen District,18,494,96,398,342
2022-02-19,Hai Phong City,Ngo Quyen District,19,398,89,309,272
2022-02-19,Hai Phong City,Ngo Quyen District,20,323,66,257,212
2022-02-19,Hai Phong City,Ngo Quyen District,21,117,25,92,69
2022-02-19,Hai Phong City,Ngo Quyen District,23,2,0,2,1
2022-02-19,Hai Phong City,Thuy Nguyen,6,1,0,1,1
2022-02-19,Hai Phong City,Thuy Nguyen,7,2,0,2,1
2022-02-19,Hai Phong City,Thuy Nguyen,10,1,0,1,1
2022-02-19,Hai Phong City,Thuy Nguyen,11,6,0,6,6
2022-02-19,Hai Phong City,Thuy Nguyen,12,2,0,2,2
2022-02-19,Hai Phong City,Thuy Nguyen,13,3,0,3,2
2022-02-19,Hai Phong City,Thuy Nguyen,14,1,0,1,0
2022-02-19,Hai Phong City,Thuy Nguyen,15,4,0,4,3
2022-02-19,Hai Phong City,Thuy Nguyen,17,1,0,1,1
2022-02-19,Hai Phong City,Thuy Nguyen,21,1,0,1,0
2022-02-19,Hue City,Hue City,0,2,2,0,0
2022-02-19,Hue City,Hue City,5,1,1,0,0
2022-02-19,Hue City,Hue City,6,52,45,7,0
2022-02-19,Hue City,Hue City,7,161,156,5,0
2022-02-19,Hue City,Hue City,8,280,263,17,1
2022-02-19,Hue City,Hue City,9,243,220,23,1
2022-02-19,Hue City,Hue City,10,384,361,23,0
2022-02-19,Hue City,Hue City,11,713,658,55,8
2022-02-19,Hue City,Hue City,12,487,466,21,1
2022-02-19,Hue City,Hue City,13,299,274,25,3
2022-02-19,Hue City,Hue City,14,293,277,16,1
2022-02-19,Hue City,Hue City,15,372,348,24,1
2022-02-19,Hue City,Hue City,16,484,437,47,20
2022-02-19,Hue City,Hue City,17,724,611,113,52
2022-02-19,Hue City,Hue City,18,782,579,203,110
2022-02-19,Hue City,Hue City,19,634,460,174,92
2022-02-19,Hue City,Hue City,20,558,384,174,100
2022-02-19,Hue City,Hue City,21,231,167,64,30
2022-02-19,Hue City,Hue City,22,1,1,0,0
2022-02-19,Hue City,Huong Thuy,7,1,0,1,1
2022-02-19,Hue City,Huong Thuy,14,1,0,1,0
2022-02-19,Hue City,Huong Thuy,15,1,0,1,0
2022-02-19,Hue City,Huong Thuy,17,1,0,1,0
2022-02-19,Hue City,Huong Thuy,18,2,1,1,0
2022-02-19,Hue City,Huong Thuy,19,5,1,4,1
2022-02-19,Hue City,Huong Thuy,21,2,0,2,0
2022-02-19,Hue City,Huong Tra,8,1,1,0,0
2022-02-19,Hue City,Huong Tra,11,1,1,0,0
2022-02-19,Hue City,Huong Tra,20,2,0,2,2
2022-02-19,Hue City,Phu Vang,6,1,1,0,0
2022-02-19,Hue City,Phu Vang,11,6,6,0,0
2022-02-19,Hue City,Phu Vang,15,1,1,0,0
2022-02-19,Hue City,Phu Vang,16,2,2,0,0
2022-02-19,Hue City,Phu Vang,17,4,2,2,0
2022-02-19,Hue City,Phu Vang,18,4,3,1,0
2022-02-19,Hue City,Phu Vang,19,1,0,1,1
2022-02-19,Hue City,Phu Vang,20,3,2,1,1
2022-02-19,Hue City,Phu Vang,21,2,0,2,2
2022-02-19,Vung Tau,Ba Ria City,7,2,0,2,2
2022-02-19,Vung Tau,Ba Ria City,8,3,0,3,3
2022-02-19,Vung Tau,Ba Ria City,9,8,0,8,8
2022-02-19,Vung Tau,Ba Ria City,10,5,0,5,5
2022-02-19,Vung Tau,Ba Ria City,11,15,0,15,14
2022-02-19,Vung Tau,Ba Ria City,12,13,2,11,10
2022-02-19,Vung Tau,Ba Ria City,13,9,2,7,6
2022-02-19,Vung Tau,Ba Ria City,14,9,2,7,6
2022-02-19,Vung Tau,Ba Ria City,15,7,0,7,7
2022-02-19,Vung Tau,Ba Ria City,16,3,0,3,3
2022-02-19,Vung Tau,Ba Ria City,17,11,0,11,10
2022-02-19,Vung Tau,Ba Ria City,18,12,0,12,12
2022-02-19,Vung Tau,Ba Ria City,19,12,0,12,12
2022-02-19,Vung Tau,Ba Ria City,20,4,0,4,3
2022-02-19,Vung Tau,Tan Thanh,12,2,0,2,2
2022-02-19,Vung Tau,Vung Tau City,0,2,1,1,0
2022-02-19,Vung Tau,Vung Tau City,4,1,1,0,0
2022-02-19,Vung Tau,Vung Tau City,5,1,0,1,0
2022-02-19,Vung Tau,Vung Tau City,6,22,21,1,0
2022-02-19,Vung Tau,Vung Tau City,7,66,57,9,3
2022-02-19,Vung Tau,Vung Tau City,8,144,135,9,1
2022-02-19,Vung Tau,Vung Tau City,9,144,137,7,1
2022-02-19,Vung Tau,Vung Tau City,10,209,198,11,0
2022-02-19,Vung Tau,Vung Tau City,11,321,289,32,5
2022-02-19,Vung Tau,Vung Tau City,12,268,250,18,2
2022-02-19,Vung Tau,Vung Tau City,13,183,159,24,2
2022-02-19,Vung Tau,Vung Tau City,14,194,177,17,5
2022-02-19,Vung Tau,Vung Tau City,15,206,192,14,2
2022-02-19,Vung Tau,Vung Tau City,16,201,178,23,6
2022-02-19,Vung Tau,Vung Tau City,17,258,231,27,3
2022-02-19,Vung Tau,Vung Tau City,18,363,289,74,35
2022-02-19,Vung Tau,Vung Tau City,19,257,207,50,29
2022-02-19,Vung Tau,Vung Tau City,20,234,158,76,39
2022-02-19,Vung Tau,Vung Tau City,21,132,77,55,39
2022-02-19,Vung Tau,Vung Tau City,22,3,1,2,1
2022-02-19,Vung Tau,Vung Tau City,23,1,1,0,0
2022-02-20,Binh Duong,Ben Cat,12,2,0,2,1
2022-02-20,Binh Duong,Ben Cat,18,1,0,1,0
2022-02-20,Binh Duong,Di An,7,1,1,0,0
2022-02-20,Binh Duong,Di An,8,1,1,0,0
2022-02-20,Binh Duong,Di An,9,10,8,2,1
2022-02-20,Binh Duong,Di An,10,23,9,14,7
2022-02-20,Binh Duong,Di An,11,34,16,18,15
2022-02-20,Binh Duong,Di An,12,31,13,18,14
2022-02-20,Binh Duong,Di An,13,22,11,11,8
2022-02-20,Binh Duong,Di An,14,27,11,16,10
2022-02-20,Binh Duong,Di An,15,13,6,7,2
2022-02-20,Binh Duong,Di An,16,19,4,15,10
2022-02-20,Binh Duong,Di An,17,31,10,21,14
2022-02-20,Binh Duong,Di An,18,25,3,22,19
2022-02-20,Binh Duong,Di An,19,20,0,20,18
2022-02-20,Binh Duong,Di An,20,23,1,22,18
2022-02-20,Binh Duong,Di An,21,7,1,6,6
2022-02-20,Binh Duong,Tan Uyen,10,1,1,0,0
2022-02-20,Binh Duong,Tan Uyen,12,2,1,1,0
2022-02-20,Binh Duong,Tan Uyen,13,2,1,1,0
2022-02-20,Binh Duong,Tan Uyen,14,1,1,0,0
2022-02-20,Binh Duong,Tan Uyen,15,1,0,1,1
2022-02-20,Binh Duong,Tan Uyen,16,3,0,3,3
2022-02-20,Binh Duong,Tan Uyen,17,2,0,2,2
2022-02-20,Binh Duong,Tan Uyen,18,1,1,0,0
2022-02-20,Binh Duong,Tan Uyen,19,2,0,2,2
2022-02-20,Binh Duong,Thu Dau Mot Town,0,2,2,0,0
2022-02-20,Binh Duong,Thu Dau Mot Town,5,1,0,1,0
2022-02-20,Binh Duong,Thu Dau Mot Town,6,32,25,7,1
2022-02-20,Binh Duong,Thu Dau Mot Town,7,105,87,18,8
2022-02-20,Binh Duong,Thu Dau Mot Town,8,176,147,29,6
2022-02-20,Binh Duong,Thu Dau Mot Town,9,257,233,24,1
2022-02-20,Binh Duong,Thu Dau Mot Town,10,340,312,28,2
2022-02-20,Binh Duong,Thu Dau Mot Town,11,496,438,58,15
2022-02-20,Binh Duong,Thu Dau Mot Town,12,454,405,49,16
2022-02-20,Binh Duong,Thu Dau Mot Town,13,341,316,25,6
2022-02-20,Binh Duong,Thu Dau Mot Town,14,262,237,25,6
2022-02-20,Binh Duong,Thu Dau Mot Town,15,261,239,22,6
2022-02-20,Binh Duong,Thu Dau Mot Town,16,260,232,28,5
2022-02-20,Binh Duong,Thu Dau Mot Town,17,316,251,65,41
2022-02-20,Binh Duong,Thu Dau Mot Town,18,361,270,91,58
2022-02-20,Binh Duong,Thu Dau Mot Town,19,376,273,103,75
2022-02-20,Binh Duong,Thu Dau Mot Town,20,253,174,79,45
2022-02-20,Binh Duong,Thu Dau Mot Town,21,84,63,21,5
2022-02-20,Binh Duong,Thu Dau Mot Town,22,1,0,1,0
2022-02-20,Binh Duong,Thuan An,5,2,2,0,0
2022-02-20,Binh Duong,Thuan An,6,1,0,1,1
2022-02-20,Binh Duong,Thuan An,7,1,0,1,0
2022-02-20,Binh Duong,Thuan An,8,19,10,9,1
2022-02-20,Binh Duong,Thuan An,9,25,19,6,3
2022-02-20,Binh Duong,Thuan An,10,53,37,16,13
2022-02-20,Binh Duong,Thuan An,11,87,51,36,24
2022-02-20,Binh Duong,Thuan An,12,57,37,20,15
2022-02-20,Binh Duong,Thuan An,13,64,32,32,23
2022-02-20,Binh Duong,Thuan An,14,52,28,24,19
2022-02-20,Binh Duong,Thuan An,15,42,19,23,21
2022-02-20,Binh Duong,Thuan An,16,33,19,14,11
2022-02-20,Binh Duong,Thuan An,17,30,17,13,8
2022-02-20,Binh Duong,Thuan An,18,53,18,35,22
2022-02-20,Binh Duong,Thuan An,19,59,18,41,33
2022-02-20,Binh Duong,Thuan An,20,22,9,13,12
2022-02-20,Binh Duong,Thuan An,21,15,5,10,7
2022-02-20,Can Tho City,Binh Thuy District,6,2,1,1,0
2022-02-20,Can Tho City,Binh Thuy District,7,2,1,1,0
2022-02-20,Can Tho City,Binh Thuy District,8,3,2,1,0
2022-02-20,Can Tho City,Binh Thuy District,9,5,5,0,0
2022-02-20,Can Tho City,Binh Thuy District,10,14,13,1,0
2022-02-20,Can Tho City,Binh Thuy District,11,8,8,0,0
2022-02-20,Can Tho City,Binh Thuy District,12,7,6,1,0
2022-02-20,Can Tho City,Binh Thuy District,13,7,4,3,1
2022-02-20,Can Tho City,Binh Thuy District,14,9,8,1,0
2022-02-20,Can Tho City,Binh Thuy District,15,6,5,1,0
2022-02-20,Can Tho City,Binh Thuy District,16,14,14,0,0
2022-02-20,Can Tho City,Binh Thuy District,17,9,9,0,0
2022-02-20,Can Tho City,Binh Thuy District,18,13,13,0,0
2022-02-20,Can Tho City,Binh Thuy District,19,8,6,2,0
2022-02-20,Can Tho City,Binh Thuy District,20,12,10,2,0
2022-02-20,Can Tho City,Binh Thuy District,21,6,6,0,0
2022-02-20,Can Tho City,Cai Rang District,6,4,1,3,0
2022-02-20,Can Tho City,Cai Rang District,8,5,4,1,0
2022-02-20,Can Tho City,Cai Rang District,9,8,6,2,2
2022-02-20,Can Tho City,Cai Rang District,10,10,10,0,0
2022-02-20,Can Tho City,Cai Rang District,11,15,15,0,0
2022-02-20,Can Tho City,Cai Rang District,12,10,9,1,0
2022-02-20,Can Tho City,Cai Rang District,13,13,13,0,0
2022-02-20,Can Tho City,Cai Rang District,14,7,7,0,0
2022-02-20,Can Tho City,Cai Rang District,15,9,9,0,0
2022-02-20,Can Tho City,Cai Rang District,16,12,11,1,1
2022-02-20,Can Tho City,Cai Rang District,17,6,5,1,0
2022-02-20,Can Tho City,Cai Rang District,18,12,11,1,0
2022-02-20,Can Tho City,Cai Rang District,19,3,2,1,0
2022-02-20,Can Tho City,Cai Rang District,20,9,8,1,1
2022-02-20,Can Tho City,Cai Rang District,21,5,3,2,0
2022-02-20,Can Tho City,Cai Rang District,22,1,0,1,0
2022-02-20,Can Tho City,Ninh Kieu District,0,3,3,0,0
2022-02-20,Can Tho City,Ninh Kieu District,1,5,3,2,0
2022-02-20,Can Tho City,Ninh Kieu District,2,3,1,2,0
2022-02-20,Can Tho City,Ninh Kieu District,3,1,1,0,0
2022-02-20,Can Tho City,Ninh Kieu District,4,1,1,0,0
2022-02-20,Can Tho City,Ninh Kieu District,5,3,3,0,0
2022-02-20,Can Tho City,Ninh Kieu District,6,39,34,5,0
2022-02-20,Can Tho City,Ninh Kieu District,7,132,125,7,0
2022-02-20,Can Tho City,Ninh Kieu District,8,224,205,19,0
2022-02-20,Can Tho City,Ninh Kieu District,9,267,252,15,0
2022-02-20,Can Tho City,Ninh Kieu District,10,451,429,22,0
2022-02-20,Can Tho City,Ninh Kieu District,11,629,596,33,7
2022-02-20,Can Tho City,Ninh Kieu District,12,486,468,18,0
2022-02-20,Can Tho City,Ninh Kieu District,13,366,346,20,0
2022-02-20,Can Tho City,Ninh Kieu District,14,310,294,16,1
2022-02-20,Can Tho City,Ninh Kieu District,15,322,301,21,0
2022-02-20,Can Tho City,Ninh Kieu District,16,371,360,11,0
2022-02-20,Can Tho City,Ninh Kieu District,17,428,407,21,0
2022-02-20,Can Tho City,Ninh Kieu District,18,406,386,20,0
2022-02-20,Can Tho City,Ninh Kieu District,19,416,393,23,0
2022-02-20,Can Tho City,Ninh Kieu District,20,257,242,15,1
2022-02-20,Can Tho City,Ninh Kieu District,21,151,129,22,1
2022-02-20,Can Tho City,Ninh Kieu District,22,1,0,1,0
2022-02-20,Can Tho City,Ninh Kieu District,23,3,2,1,0
2022-02-20,Dong Nai,Bien Hoa City,0,1,1,0,0
2022-02-20,Dong Nai,Bien Hoa City,2,1,1,0,0
2022-02-20,Dong Nai,Bien Hoa City,4,2,1,1,1
2022-02-20,Dong Nai,Bien Hoa City,5,1,1,0,0
2022-02-20,Dong Nai,Bien Hoa City,6,19,13,6,4
2022-02-20,Dong Nai,Bien Hoa City,7,145,118,27,16
2022-02-20,Dong Nai,Bien Hoa City,8,246,202,44,21
2022-02-20,Dong Nai,Bien Hoa City,9,415,353,62,9
2022-02-20,Dong Nai,Bien Hoa City,10,664,569,95,37
2022-02-20,Dong Nai,Bien Hoa City,11,1065,896,169,89
2022-02-20,Dong Nai,Bien Hoa City,12,904,770,134,59
2022-02-20,Dong Nai,Bien Hoa City,13,703,627,76,22
2022-02-20,Dong Nai,Bien Hoa City,14,534,479,55,14
2022-02-20,Dong Nai,Bien Hoa City,15,496,432,64,30
2022-02-20,Dong Nai,Bien Hoa City,16,492,421,71,27
2022-02-20,Dong Nai,Bien Hoa City,17,525,407,118,63
2022-02-20,Dong Nai,Bien Hoa City,18,755,531,224,158
2022-02-20,Dong Nai,Bien Hoa City,19,692,465,227,164
2022-02-20,Dong Nai,Bien Hoa City,20,505,315,190,125
2022-02-20,Dong Nai,Bien Hoa City,21,170,109,61,30
2022-02-20,Dong Nai,Bien Hoa City,22,1,1,0,0
2022-02-20,Dong Nai,Bien Hoa City,23,1,0,1,1
2022-02-20,Dong Nai,Long Khanh,14,1,0,1,1
2022-02-20,Dong Nai,Long Thanh,9,2,0,2,2
2022-02-20,Dong Nai,Long Thanh,10,3,0,3,1
2022-02-20,Dong Nai,Long Thanh,16,2,0,2,2
2022-02-20,Dong Nai,Long Thanh,17,2,0,2,2
2022-02-20,Dong Nai,Long Thanh,19,1,0,1,1
2022-02-20,Dong Nai,Thong Nhat,8,1,1,0,0
2022-02-20,Dong Nai,Thong Nhat,9,2,2,0,0
2022-02-20,Dong Nai,Thong Nhat,10,1,1,0,0
2022-02-20,Dong Nai,Thong Nhat,11,2,2,0,0
2022-02-20,Dong Nai,Thong Nhat,12,1,1,0,0
2022-02-20,Dong Nai,Thong Nhat,13,2,2,0,0
2022-02-20,Dong Nai,Thong Nhat,14,2,2,0,0
2022-02-20,Dong Nai,Thong Nhat,15,1,1,0,0
2022-02-20,Dong Nai,Thong Nhat,19,1,1,0,0
2022-02-20,Dong Nai,Thong Nhat,20,1,1,0,0
2022-02-20,Dong Nai,Trang Bom,9,1,0,1,1
2022-02-20,Dong Nai,Trang Bom,13,1,1,0,0
2022-02-20,Dong Nai,Trang Bom,16,1,1,0,0
2022-02-20,Dong Nai,Trang Bom,17,1,0,1,1
2022-02-20,Dong Nai,Trang Bom,20,1,0,1,1
2022-02-20,Dong Nai,Vinh Cuu,9,1,0,1,0
2022-02-20,Hai Phong City,An Duong,7,5,1,4,2
2022-02-20,Hai Phong City,An Duong,8,3,0,3,3
2022-02-20,Hai Phong City,An Duong,9,9,0,9,8
2022-02-20,Hai Phong City,An Duong,10,6,0,6,5
2022-02-20,Hai Phong City,An Duong,11,6,0,6,6
2022-02-20,Hai Phong City,An Duong,12,8,0,8,7
2022-02-20,Hai Phong City,An Duong,13,3,0,3,2
2022-02-20,Hai Phong City,An Duong,14,7,0,7,5
2022-02-20,Hai Phong City,An Duong,15,8,0,8,6
2022-02-20,Hai Phong City,An Duong,16,8,0,8,5
2022-02-20,Hai Phong City,An Duong,17,6,0,6,6
2022-02-20,Hai Phong City,An Duong,18,2,0,2,2
2022-02-20,Hai Phong City,An Duong,19,8,0,8,8
2022-02-20,Hai Phong City,An Duong,20,8,0,8,8
2022-02-20,Hai Phong City,An Duong,23,1,0,1,1
2022-02-20,Hai Phong City,Do Son District,11,1,0,1,1
2022-02-20,Hai Phong City,Do Son District,14,2,0,2,2
2022-02-20,Hai Phong City,Duong Kinh District,21,1,0,1,1
2022-02-20,Hai Phong City,Hai An District,7,13,0,13,12
2022-02-20,Hai Phong City,Hai An District,8,31,6,25,21
2022-02-20,Hai Phong City,Hai An District,9,18,2,16,16
2022-02-20,Hai Phong City,Hai An District,10,65,5,60,52
2022-02-20,Hai Phong City,Hai An District,11,106,5,101,97
2022-02-20,Hai Phong City,Hai An District,12,64,5,59,53
2022-02-20,Hai Phong City,Hai An District,13,25,4,21,14
2022-02-20,Hai Phong City,Hai An District,14,24,2,22,19
2022-02-20,Hai Phong City,Hai An District,15,51,6,45,42
2022-02-20,Hai Phong City,Hai An District,16,75,13,62,51
2022-02-20,Hai Phong City,Hai An District,17,90,11,79,70
2022-02-20,Hai Phong City,Hai An District,18,69,1,68,61
2022-02-20,Hai Phong City,Hai An District,19,48,3,45,43
2022-02-20,Hai Phong City,Hai An District,20,37,5,32,29
2022-02-20,Hai Phong City,Hai An District,21,11,0,11,10
2022-02-20,Hai Phong City,Hong Bang District,4,1,0,1,0
2022-02-20,Hai Phong City,Hong Bang District,6,1,0,1,1
2022-02-20,Hai Phong City,Hong Bang District,7,6,2,4,3
2022-02-20,Hai Phong City,Hong Bang District,8,34,5,29,23
2022-02-20,Hai Phong City,Hong Bang District,9,59,7,52,46
2022-02-20,Hai Phong City,Hong Bang District,10,150,13,137,123
2022-02-20,Hai Phong City,Hong Bang District,11,203,27,176,146
2022-02-20,Hai Phong City,Hong Bang District,12,137,14,123,108
2022-02-20,Hai Phong City,Hong Bang District,13,75,12,63,57
2022-02-20,Hai Phong City,Hong Bang District,14,65,6,59,49
2022-02-20,Hai Phong City,Hong Bang District,15,100,15,85,70
2022-02-20,Hai Phong City,Hong Bang District,16,98,6,92,78
2022-02-20,Hai Phong City,Hong Bang District,17,124,12,112,104
2022-02-20,Hai Phong City,Hong Bang District,18,126,13,113,97
2022-02-20,Hai Phong City,Hong Bang District,19,111,9,102,90
2022-02-20,Hai Phong City,Hong Bang District,20,73,3,70,62
2022-02-20,Hai Phong City,Hong Bang District,21,22,1,21,17
2022-02-20,Hai Phong City,Hong Bang District,23,3,2,1,0
2022-02-20,Hai Phong City,Kien An District,0,1,0,1,1
2022-02-20,Hai Phong City,Kien An District,3,1,0,1,1
2022-02-20,Hai Phong City,Kien An District,6,1,0,1,1
2022-02-20,Hai Phong City,Kien An District,7,2,0,2,2
2022-02-20,Hai Phong City,Kien An District,8,5,0,5,5
2022-02-20,Hai Phong City,Kien An District,9,16,0,16,14
2022-02-20,Hai Phong City,Kien An District,10,26,3,23,21
2022-02-20,Hai Phong City,Kien An District,11,30,4,26,22
2022-02-20,Hai Phong City,Kien An District,12,26,4,22,18
2022-02-20,Hai Phong City,Kien An District,13,20,2,18,15
2022-02-20,Hai Phong City,Kien An District,14,21,3,18,15
2022-02-20,Hai Phong City,Kien An District,15,22,1,21,19
2022-02-20,Hai Phong City,Kien An District,16,20,1,19,16
2022-02-20,Hai Phong City,Kien An District,17,33,0,33,30
2022-02-20,Hai Phong City,Kien An District,18,32,0,32,30
2022-02-20,Hai Phong City,Kien An District,19,20,0,20,17
2022-02-20,Hai Phong City,Kien An District,20,16,0,16,14
2022-02-20,Hai Phong City,Kien An District,21,4,0,4,4
2022-02-20,Hai Phong City,Le Chan District,0,2,0,2,1
2022-02-20,Hai Phong City,Le Chan District,1,2,0,2,2
2022-02-20,Hai Phong City,Le Chan District,4,1,1,0,0
2022-02-20,Hai Phong City,Le Chan District,6,5,1,4,3
2022-02-20,Hai Phong City,Le Chan District,7,47,9,38,32
2022-02-20,Hai Phong City,Le Chan District,8,112,17,95,81
2022-02-20,Hai Phong City,Le Chan District,9,176,27,149,133
2022-02-20,Hai Phong City,Le Chan District,10,409,52,357,326
2022-02-20,Hai Phong City,Le Chan District,11,579,74,505,445
2022-02-20,Hai Phong City,Le Chan District,12,408,81,327,290
2022-02-20,Hai Phong City,Le Chan District,13,288,55,233,203
2022-02-20,Hai Phong City,Le Chan District,14,262,45,217,181
2022-02-20,Hai Phong City,Le Chan District,15,444,59,385,319
2022-02-20,Hai Phong City,Le Chan District,16,534,60,474,434
2022-02-20,Hai Phong City,Le Chan District,17,669,66,603,520
2022-02-20,Hai Phong City,Le Chan District,18,654,59,595,510
2022-02-20,Hai Phong City,Le Chan District,19,502,38,464,406
2022-02-20,Hai Phong City,Le Chan District,20,304,23,281,241
2022-02-20,Hai Phong City,Le Chan District,21,133,21,112,80
2022-02-20,Hai Phong City,Le Chan District,22,3,2,1,0
2022-02-20,Hai Phong City,Le Chan District,23,3,0,3,0
2022-02-20,Hai Phong City,Ngo Quyen District,0,1,0,1,0
2022-02-20,Hai Phong City,Ngo Quyen District,1,4,1,3,3
2022-02-20,Hai Phong City,Ngo Quyen District,5,1,0,1,1
2022-02-20,Hai Phong City,Ngo Quyen District,6,2,0,2,1
2022-02-20,Hai Phong City,Ngo Quyen District,7,37,3,34,27
2022-02-20,Hai Phong City,Ngo Quyen District,8,126,17,109,97
2022-02-20,Hai Phong City,Ngo Quyen District,9,140,32,108,99
2022-02-20,Hai Phong City,Ngo Quyen District,10,285,29,256,228
2022-02-20,Hai Phong City,Ngo Quyen District,11,435,55,380,332
2022-02-20,Hai Phong City,Ngo Quyen District,12,306,44,262,240
2022-02-20,Hai Phong City,Ngo Quyen District,13,205,48,157,140
2022-02-20,Hai Phong City,Ngo Quyen District,14,228,49,179,151
2022-02-20,Hai Phong City,Ngo Quyen District,15,325,56,269,238
2022-02-20,Hai Phong City,Ngo Quyen District,16,436,64,372,332
2022-02-20,Hai Phong City,Ngo Quyen District,17,496,50,446,401
2022-02-20,Hai Phong City,Ngo Quyen District,18,463,56,407,368
2022-02-20,Hai Phong City,Ngo Quyen District,19,332,33,299,268
2022-02-20,Hai Phong City,Ngo Quyen District,20,247,27,220,185
2022-02-20,Hai Phong City,Ngo Quyen District,21,93,13,80,64
2022-02-20,Hai Phong City,Ngo Quyen District,22,4,0,4,2
2022-02-20,Hai Phong City,Thuy Nguyen,8,1,0,1,0
2022-02-20,Hai Phong City,Thuy Nguyen,11,3,0,3,3
2022-02-20,Hai Phong City,Thuy Nguyen,12,2,0,2,2
2022-02-20,Hai Phong City,Thuy Nguyen,13,1,0,1,1
2022-02-20,Hai Phong City,Thuy Nguyen,14,7,0,7,7
2022-02-20,Hai Phong City,Thuy Nguyen,15,1,0,1,1
2022-02-20,Hai Phong City,Thuy Nguyen,16,1,0,1,1
2022-02-20,Hai Phong City,Thuy Nguyen,17,2,0,2,1
2022-02-20,Hai Phong City,Thuy Nguyen,18,4,0,4,4
2022-02-20,Hai Phong City,Thuy Nguyen,19,2,0,2,2
2022-02-20,Hai Phong City,Thuy Nguyen,20,1,0,1,1
2022-02-20,Hue City,Hue City,0,2,2,0,0
2022-02-20,Hue City,Hue City,1,1,1,0,0
2022-02-20,Hue City,Hue City,2,2,1,1,0
2022-02-20,Hue City,Hue City,4,2,1,1,1
2022-02-20,Hue City,Hue City,5,2,2,0,0
2022-02-20,Hue City,Hue City,6,34,29,5,1
2022-02-20,Hue City,Hue City,7,182,168,14,0
2022-02-20,Hue City,Hue City,8,291,276,15,0
2022-02-20,Hue City,Hue City,9,301,275,26,1
2022-02-20,Hue City,Hue City,10,431,398,33,3
2022-02-20,Hue City,Hue City,11,627,587,40,6
2022-02-20,Hue City,Hue City,12,459,439,20,0
2022-02-20,Hue City,Hue City,13,303,287,16,0
2022-02-20,Hue City,Hue City,14,312,296,16,0
2022-02-20,Hue City,Hue City,15,365,342,23,0
2022-02-20,Hue City,Hue City,16,476,436,40,2
2022-02-20,Hue City,Hue City,17,570,525,45,5
2022-02-20,Hue City,Hue City,18,641,550,91,28
2022-02-20,Hue City,Hue City,19,524,454,70,15
2022-02-20,Hue City,Hue City,20,349,302,47,10
2022-02-20,Hue City,Hue City,21,172,131,41,7
2022-02-20,Hue City,Hue City,22,3,3,0,0
2022-02-20,Hue City,Hue City,23,2,0,2,1
2022-02-20,Hue City,Huong Thuy,13,2,0,2,0
2022-02-20,Hue City,Huong Thuy,15,1,1,0,0
2022-02-20,Hue City,Huong Thuy,16,1,1,0,0
2022-02-20,Hue City,Huong Thuy,18,1,0,1,0
2022-02-20,Hue City,Huong Tra,12,1,1,0,0
2022-02-20,Hue City,Huong Tra,17,2,1,1,1
2022-02-20,Hue City,Huong Tra,20,1,0,1,0
2022-02-20,Hue City,Phu Vang,7,2,2,0,0
2022-02-20,Hue City,Phu Vang,8,1,1,0,0
2022-02-20,Hue City,Phu Vang,9,3,3,0,0
2022-02-20,Hue City,Phu Vang,11,4,4,0,0
2022-02-20,Hue City,Phu Vang,12,1,0,1,1
2022-02-20,Hue City,Phu Vang,13,1,1,0,0
2022-02-20,Hue City,Phu Vang,14,2,1,1,1
2022-02-20,Hue City,Phu Vang,15,5,5,0,0
2022-02-20,Hue City,Phu Vang,16,4,3,1,0
2022-02-20,Hue City,Phu Vang,17,3,3,0,0
2022-02-20,Hue City,Phu Vang,19,1,0,1,1
2022-02-20,Hue City,Phu Vang,20,1,0,1,0
2022-02-20,Vung Tau,Ba Ria City,7,3,0,3,2
2022-02-20,Vung Tau,Ba Ria City,8,2,1,1,1
2022-02-20,Vung Tau,Ba Ria City,9,8,1,7,6
2022-02-20,Vung Tau,Ba Ria City,10,7,1,6,5
2022-02-20,Vung Tau,Ba Ria City,11,16,0,16,14
2022-02-20,Vung Tau,Ba Ria City,12,19,0,19,17
2022-02-20,Vung Tau,Ba Ria City,13,12,0,12,11
2022-02-20,Vung Tau,Ba Ria City,14,12,0,12,12
2022-02-20,Vung Tau,Ba Ria City,15,14,0,14,13
2022-02-20,Vung Tau,Ba Ria City,16,7,0,7,4
2022-02-20,Vung Tau,Ba Ria City,17,12,0,12,8
2022-02-20,Vung Tau,Ba Ria City,18,15,0,15,15
2022-02-20,Vung Tau,Ba Ria City,19,9,0,9,9
2022-02-20,Vung Tau,Ba Ria City,20,3,0,3,3
2022-02-20,Vung Tau,Ba Ria City,21,5,0,5,5
2022-02-20,Vung Tau,Vung Tau City,0,1,1,0,0
2022-02-20,Vung Tau,Vung Tau City,2,1,0,1,1
2022-02-20,Vung Tau,Vung Tau City,5,1,0,1,0
2022-02-20,Vung Tau,Vung Tau City,6,25,19,6,3
2022-02-20,Vung Tau,Vung Tau City,7,113,97,16,6
2022-02-20,Vung Tau,Vung Tau City,8,159,136,23,8
2022-02-20,Vung Tau,Vung Tau City,9,267,231,36,7
2022-02-20,Vung Tau,Vung Tau City,10,272,228,44,15
2022-02-20,Vung Tau,Vung Tau City,11,324,282,42,11
2022-02-20,Vung Tau,Vung Tau City,12,287,255,32,9
2022-02-20,Vung Tau,Vung Tau City,13,241,209,32,10
2022-02-20,Vung Tau,Vung Tau City,14,218,196,22,3
2022-02-20,Vung Tau,Vung Tau City,15,198,181,17,1
2022-02-20,Vung Tau,Vung Tau City,16,198,186,12,1
2022-02-20,Vung Tau,Vung Tau City,17,252,225,27,6
2022-02-20,Vung Tau,Vung Tau City,18,324,249,75,46
2022-02-20,Vung Tau,Vung Tau City,19,300,219,81,52
2022-02-20,Vung Tau,Vung Tau City,20,171,143,28,5
2022-02-20,Vung Tau,Vung Tau City,21,84,64,20,5
2022-02-20,Vung Tau,Vung Tau City,22,4,2,2,0
2022-02-21,Binh Duong,Di An,0,1,1,0,0
2022-02-21,Binh Duong,Di An,7,4,1,3,3
2022-02-21,Binh Duong,Di An,8,9,2,7,3
2022-02-21,Binh Duong,Di An,9,11,5,6,4
2022-02-21,Binh Duong,Di An,10,12,7,5,4
2022-02-21,Binh Duong,Di An,11,21,10,11,6
2022-02-21,Binh Duong,Di An,12,25,15,10,6
2022-02-21,Binh Duong,Di An,13,14,9,5,4
2022-02-21,Binh Duong,Di An,14,10,6,4,1
2022-02-21,Binh Duong,Di An,15,15,3,12,7
2022-02-21,Binh Duong,Di An,16,6,5,1,0
2022-02-21,Binh Duong,Di An,17,10,5,5,3
2022-02-21,Binh Duong,Di An,18,11,6,5,5
2022-02-21,Binh Duong,Di An,19,17,6,11,8
2022-02-21,Binh Duong,Di An,20,14,4,10,7
2022-02-21,Binh Duong,Di An,21,3,1,2,1
2022-02-21,Binh Duong,Tan Uyen,8,1,0,1,1
2022-02-21,Binh Duong,Tan Uyen,11,2,1,1,1
2022-02-21,Binh Duong,Tan Uyen,12,1,1,0,0
2022-02-21,Binh Duong,Tan Uyen,13,1,1,0,0
2022-02-21,Binh Duong,Tan Uyen,14,2,1,1,1
2022-02-21,Binh Duong,Tan Uyen,16,1,0,1,0
2022-02-21,Binh Duong,Tan Uyen,17,1,0,1,1
2022-02-21,Binh Duong,Tan Uyen,18,2,0,2,2
2022-02-21,Binh Duong,Tan Uyen,19,2,1,1,1
2022-02-21,Binh Duong,Tan Uyen,20,1,0,1,1
2022-02-21,Binh Duong,Thu Dau Mot Town,0,1,1,0,0
2022-02-21,Binh Duong,Thu Dau Mot Town,6,25,19,6,4
2022-02-21,Binh Duong,Thu Dau Mot Town,7,85,71,14,6
2022-02-21,Binh Duong,Thu Dau Mot Town,8,146,133,13,1
2022-02-21,Binh Duong,Thu Dau Mot Town,9,199,184,15,2
2022-02-21,Binh Duong,Thu Dau Mot Town,10,323,292,31,5
2022-02-21,Binh Duong,Thu Dau Mot Town,11,537,500,37,15
2022-02-21,Binh Duong,Thu Dau Mot Town,12,351,338,13,3
2022-02-21,Binh Duong,Thu Dau Mot Town,13,300,269,31,9
2022-02-21,Binh Duong,Thu Dau Mot Town,14,272,246,26,2
2022-02-21,Binh Duong,Thu Dau Mot Town,15,201,189,12,4
2022-02-21,Binh Duong,Thu Dau Mot Town,16,211,199,12,0
2022-02-21,Binh Duong,Thu Dau Mot Town,17,289,270,19,3
2022-02-21,Binh Duong,Thu Dau Mot Town,18,330,271,59,40
2022-02-21,Binh Duong,Thu Dau Mot Town,19,384,229,155,118
2022-02-21,Binh Duong,Thu Dau Mot Town,20,344,193,151,126
2022-02-21,Binh Duong,Thu Dau Mot Town,21,116,76,40,23
2022-02-21,Binh Duong,Thu Dau Mot Town,22,5,1,4,0
2022-02-21,Binh Duong,Thu Dau Mot Town,23,1,0,1,1
2022-02-21,Binh Duong,Thuan An,6,1,1,0,0
2022-02-21,Binh Duong,Thuan An,7,4,2,2,1
2022-02-21,Binh Duong,Thuan An,8,8,4,4,1
2022-02-21,Binh Duong,Thuan An,9,30,12,18,16
2022-02-21,Binh Duong,Thuan An,10,63,35,28,20
2022-02-21,Binh Duong,Thuan An,11,73,43,30,24
2022-02-21,Binh Duong,Thuan An,12,49,28,21,15
2022-02-21,Binh Duong,Thuan An,13,52,32,20,15
2022-02-21,Binh Duong,Thuan An,14,29,21,8,5
2022-02-21,Binh Duong,Thuan An,15,29,12,17,12
2022-02-21,Binh Duong,Thuan An,16,20,15,5,4
2022-02-21,Binh Duong,Thuan An,17,30,20,10,8
2022-02-21,Binh Duong,Thuan An,18,27,8,19,18
2022-02-21,Binh Duong,Thuan An,19,41,14,27,22
2022-02-21,Binh Duong,Thuan An,20,29,2,27,22
2022-02-21,Binh Duong,Thuan An,21,17,1,16,12
2022-02-21,Can Tho City,Binh Thuy District,6,1,1,0,0
2022-02-21,Can Tho City,Binh Thuy District,7,1,1,0,0
2022-02-21,Can Tho City,Binh Thuy District,8,1,1,0,0
2022-02-21,Can Tho City,Binh Thuy District,9,6,6,0,0
2022-02-21,Can Tho City,Binh Thuy District,10,10,9,1,0
2022-02-21,Can Tho City,Binh Thuy District,11,9,9,0,0
2022-02-21,Can Tho City,Binh Thuy District,12,6,5,1,0
2022-02-21,Can Tho City,Binh Thuy District,13,8,7,1,0
2022-02-21,Can Tho City,Binh Thuy District,14,10,10,0,0
2022-02-21,Can Tho City,Binh Thuy District,15,8,5,3,0
2022-02-21,Can Tho City,Binh Thuy District,16,7,4,3,0
2022-02-21,Can Tho City,Binh Thuy District,17,9,8,1,0
2022-02-21,Can Tho City,Binh Thuy District,18,6,6,0,0
2022-02-21,Can Tho City,Binh Thuy District,19,8,6,2,0
2022-02-21,Can Tho City,Binh Thuy District,20,5,4,1,0
2022-02-21,Can Tho City,Binh Thuy District,21,5,5,0,0
2022-02-21,Can Tho City,Cai Rang District,7,4,4,0,0
2022-02-21,Can Tho City,Cai Rang District,8,3,3,0,0
2022-02-21,Can Tho City,Cai Rang District,9,2,2,0,0
2022-02-21,Can Tho City,Cai Rang District,10,9,8,1,0
2022-02-21,Can Tho City,Cai Rang District,11,9,8,1,0
2022-02-21,Can Tho City,Cai Rang District,12,11,11,0,0
2022-02-21,Can Tho City,Cai Rang District,13,6,6,0,0
2022-02-21,Can Tho City,Cai Rang District,14,7,5,2,2
2022-02-21,Can Tho City,Cai Rang District,15,8,7,1,0
2022-02-21,Can Tho City,Cai Rang District,16,7,7,0,0
2022-02-21,Can Tho City,Cai Rang District,17,13,12,1,0
2022-02-21,Can Tho City,Cai Rang District,18,9,9,0,0
2022-02-21,Can Tho City,Cai Rang District,19,6,6,0,0
2022-02-21,Can Tho City,Cai Rang District,20,8,7,1,0
2022-02-21,Can Tho City,Cai Rang District,21,3,2,1,1
2022-02-21,Can Tho City,Ninh Kieu District,0,2,1,1,0
2022-02-21,Can Tho City,Ninh Kieu District,1,2,1,1,0
2022-02-21,Can Tho City,Ninh Kieu District,2,2,2,0,0
2022-02-21,Can Tho City,Ninh Kieu District,5,1,1,0,0
2022-02-21,Can Tho City,Ninh Kieu District,6,26,25,1,0
2022-02-21,Can Tho City,Ninh Kieu District,7,118,112,6,0
2022-02-21,Can Tho City,Ninh Kieu District,8,168,161,7,0
2022-02-21,Can Tho City,Ninh Kieu District,9,235,226,9,0
2022-02-21,Can Tho City,Ninh Kieu District,10,481,446,35,0
2022-02-21,Can Tho City,Ninh Kieu District,11,743,675,68,16
2022-02-21,Can Tho City,Ninh Kieu District,12,492,466,26,0
2022-02-21,Can Tho City,Ninh Kieu District,13,346,329,17,0
2022-02-21,Can Tho City,Ninh Kieu District,14,295,281,14,2
2022-02-21,Can Tho City,Ninh Kieu District,15,247,235,12,0
2022-02-21,Can Tho City,Ninh Kieu District,16,267,259,8,0
2022-02-21,Can Tho City,Ninh Kieu District,17,429,411,18,0
2022-02-21,Can Tho City,Ninh Kieu District,18,438,414,24,0
2022-02-21,Can Tho City,Ninh Kieu District,19,364,349,15,0
2022-02-21,Can Tho City,Ninh Kieu District,20,268,247,21,0
2022-02-21,Can Tho City,Ninh Kieu District,21,151,140,11,0
2022-02-21,Can Tho City,Ninh Kieu District,22,2,2,0,0
2022-02-21,Can Tho City,Ninh Kieu District,23,1,0,1,0
2022-02-21,Dong Nai,Bien Hoa City,0,1,1,0,0
2022-02-21,Dong Nai,Bien Hoa City,1,2,1,1,0
2022-02-21,Dong Nai,Bien Hoa City,2,1,1,0,0
2022-02-21,Dong Nai,Bien Hoa City,5,1,1,0,0
2022-02-21,Dong Nai,Bien Hoa City,6,29,18,11,5
2022-02-21,Dong Nai,Bien Hoa City,7,115,102,13,6
2022-02-21,Dong Nai,Bien Hoa City,8,227,191,36,8
2022-02-21,Dong Nai,Bien Hoa City,9,294,269,25,5
2022-02-21,Dong Nai,Bien Hoa City,10,553,501,52,13
2022-02-21,Dong Nai,Bien Hoa City,11,921,808,113,48
2022-02-21,Dong Nai,Bien Hoa City,12,751,677,74,17
2022-02-21,Dong Nai,Bien Hoa City,13,608,551,57,7
2022-02-21,Dong Nai,Bien Hoa City,14,482,440,42,4
2022-02-21,Dong Nai,Bien Hoa City,15,386,343,43,5
2022-02-21,Dong Nai,Bien Hoa City,16,355,321,34,7
2022-02-21,Dong Nai,Bien Hoa City,17,471,361,110,66
2022-02-21,Dong Nai,Bien Hoa City,18,718,565,153,90
2022-02-21,Dong Nai,Bien Hoa City,19,651,497,154,72
2022-02-21,Dong Nai,Bien Hoa City,20,447,343,104,60
2022-02-21,Dong Nai,Bien Hoa City,21,183,128,55,26
2022-02-21,Dong Nai,Bien Hoa City,22,2,0,2,1
2022-02-21,Dong Nai,Bien Hoa City,23,3,2,1,1
2022-02-21,Dong Nai,Long Thanh,12,1,0,1,1
2022-02-21,Dong Nai,Long Thanh,13,1,0,1,1
2022-02-21,Dong Nai,Long Thanh,17,2,0,2,1
2022-02-21,Dong Nai,Long Thanh,19,1,0,1,1
2022-02-21,Dong Nai,Trang Bom,9,1,0,1,1
2022-02-21,Dong Nai,Trang Bom,11,1,0,1,1
2022-02-21,Dong Nai,Trang Bom,12,1,0,1,1
2022-02-21,Dong Nai,Trang Bom,15,2,1,1,1
2022-02-21,Dong Nai,Trang Bom,17,2,0,2,2
2022-02-21,Hai Phong City,An Duong,7,2,0,2,2
2022-02-21,Hai Phong City,An Duong,8,4,2,2,1
2022-02-21,Hai Phong City,An Duong,9,1,1,0,0
2022-02-21,Hai Phong City,An Duong,10,6,4,2,2
2022-02-21,Hai Phong City,An Duong,11,11,1,10,9
2022-02-21,Hai Phong City,An Duong,12,5,0,5,5
2022-02-21,Hai Phong City,An Duong,13,8,4,4,2
2022-02-21,Hai Phong City,An Duong,14,3,1,2,0
2022-02-21,Hai Phong City,An Duong,15,5,3,2,2
2022-02-21,Hai Phong City,An Duong,16,1,1,0,0
2022-02-21,Hai Phong City,An Duong,17,3,1,2,1
2022-02-21,Hai Phong City,An Duong,18,2,0,2,2
2022-02-21,Hai Phong City,An Duong,19,3,1,2,1
2022-02-21,Hai Phong City,An Duong,20,1,0,1,1
2022-02-21,Hai Phong City,Do Son District,19,1,0,1,1
2022-02-21,Hai Phong City,Duong Kinh District,8,2,0,2,2
2022-02-21,Hai Phong City,Hai An District,6,3,0,3,3
2022-02-21,Hai Phong City,Hai An District,7,16,7,9,8
2022-02-21,Hai Phong City,Hai An District,8,22,5,17,10
2022-02-21,Hai Phong City,Hai An District,9,13,9,4,1
2022-02-21,Hai Phong City,Hai An District,10,36,18,18,13
2022-02-21,Hai Phong City,Hai An District,11,39,25,14,7
2022-02-21,Hai Phong City,Hai An District,12,18,14,4,1
2022-02-21,Hai Phong City,Hai An District,13,19,14,5,0
2022-02-21,Hai Phong City,Hai An District,14,11,9,2,1
2022-02-21,Hai Phong City,Hai An District,15,25,20,5,1
2022-02-21,Hai Phong City,Hai An District,16,24,17,7,4
2022-02-21,Hai Phong City,Hai An District,17,36,30,6,1
2022-02-21,Hai Phong City,Hai An District,18,35,23,12,6
2022-02-21,Hai Phong City,Hai An District,19,16,10,6,2
2022-02-21,Hai Phong City,Hai An District,20,14,8,6,2
2022-02-21,Hai Phong City,Hai An District,21,6,4,2,2
2022-02-21,Hai Phong City,Hong Bang District,1,1,0,1,1
2022-02-21,Hai Phong City,Hong Bang District,5,1,0,1,0
2022-02-21,Hai Phong City,Hong Bang District,7,20,9,11,8
2022-02-21,Hai Phong City,Hong Bang District,8,45,26,19,12
2022-02-21,Hai Phong City,Hong Bang District,9,44,35,9,2
2022-02-21,Hai Phong City,Hong Bang District,10,87,53,34,22
2022-02-21,Hai Phong City,Hong Bang District,11,136,78,58,36
2022-02-21,Hai Phong City,Hong Bang District,12,68,48,20,7
2022-02-21,Hai Phong City,Hong Bang District,13,35,26,9,5
2022-02-21,Hai Phong City,Hong Bang District,14,48,41,7,2
2022-02-21,Hai Phong City,Hong Bang District,15,60,47,13,6
2022-02-21,Hai Phong City,Hong Bang District,16,60,43,17,7
2022-02-21,Hai Phong City,Hong Bang District,17,84,53,31,17
2022-02-21,Hai Phong City,Hong Bang District,18,83,65,18,5
2022-02-21,Hai Phong City,Hong Bang District,19,61,49,12,6
2022-02-21,Hai Phong City,Hong Bang District,20,56,35,21,7
2022-02-21,Hai Phong City,Hong Bang District,21,13,6,7,1
2022-02-21,Hai Phong City,Hong Bang District,22,2,1,1,0
2022-02-21,Hai Phong City,Kien An District,5,1,0,1,1
2022-02-21,Hai Phong City,Kien An District,7,2,0,2,2
2022-02-21,Hai Phong City,Kien An District,8,6,4,2,2
2022-02-21,Hai Phong City,Kien An District,9,10,6,4,1
2022-02-21,Hai Phong City,Kien An District,10,12,8,4,4
2022-02-21,Hai Phong City,Kien An District,11,14,7,7,7
2022-02-21,Hai Phong City,Kien An District,12,19,11,8,3
2022-02-21,Hai Phong City,Kien An District,13,18,9,9,5
2022-02-21,Hai Phong City,Kien An District,14,11,6,5,3
2022-02-21,Hai Phong City,Kien An District,15,12,7,5,3
2022-02-21,Hai Phong City,Kien An District,16,8,5,3,2
2022-02-21,Hai Phong City,Kien An District,17,22,13,9,6
2022-02-21,Hai Phong City,Kien An District,18,13,9,4,3
2022-02-21,Hai Phong City,Kien An District,19,7,6,1,0
2022-02-21,Hai Phong City,Kien An District,20,4,3,1,0
2022-02-21,Hai Phong City,Kien An District,21,2,1,1,1
2022-02-21,Hai Phong City,Kien An District,22,1,0,1,0
2022-02-21,Hai Phong City,Le Chan District,1,3,1,2,1
2022-02-21,Hai Phong City,Le Chan District,2,4,0,4,1
2022-02-21,Hai Phong City,Le Chan District,3,2,1,1,0
2022-02-21,Hai Phong City,Le Chan District,4,1,1,0,0
2022-02-21,Hai Phong City,Le Chan District,5,2,1,1,0
2022-02-21,Hai Phong City,Le Chan District,6,1,1,0,0
2022-02-21,Hai Phong City,Le Chan District,7,68,30,38,24
2022-02-21,Hai Phong City,Le Chan District,8,104,55,49,29
2022-02-21,Hai Phong City,Le Chan District,9,115,84,31,10
2022-02-21,Hai Phong City,Le Chan District,10,257,169,88,43
2022-02-21,Hai Phong City,Le Chan District,11,390,238,152,96
2022-02-21,Hai Phong City,Le Chan District,12,203,157,46,22
2022-02-21,Hai Phong City,Le Chan District,13,116,100,16,0
2022-02-21,Hai Phong City,Le Chan District,14,176,138,38,10
2022-02-21,Hai Phong City,Le Chan District,15,227,169,58,26
2022-02-21,Hai Phong City,Le Chan District,16,276,192,84,30
2022-02-21,Hai Phong City,Le Chan District,17,316,216,100,45
2022-02-21,Hai Phong City,Le Chan District,18,281,212,69,27
2022-02-21,Hai Phong City,Le Chan District,19,207,161,46,17
2022-02-21,Hai Phong City,Le Chan District,20,159,104,55,28
2022-02-21,Hai Phong City,Le Chan District,21,76,42,34,11
2022-02-21,Hai Phong City,Le Chan District,22,3,1,2,0
2022-02-21,Hai Phong City,Ngo Quyen District,0,4,1,3,0
2022-02-21,Hai Phong City,Ngo Quyen District,1,2,1,1,0
2022-02-21,Hai Phong City,Ngo Quyen District,4,1,0,1,0
2022-02-21,Hai Phong City,Ngo Quyen District,6,1,0,1,0
2022-02-21,Hai Phong City,Ngo Quyen District,7,46,21,25,21
2022-02-21,Hai Phong City,Ngo Quyen District,8,113,62,51,36
2022-02-21,Hai Phong City,Ngo Quyen District,9,94,77,17,4
2022-02-21,Hai Phong City,Ngo Quyen District,10,197,136,61,37
2022-02-21,Hai Phong City,Ngo Quyen District,11,285,188,97,68
2022-02-21,Hai Phong City,Ngo Quyen District,12,155,129,26,10
2022-02-21,Hai Phong City,Ngo Quyen District,13,108,97,11,0
2022-02-21,Hai Phong City,Ngo Quyen District,14,157,133,24,7
2022-02-21,Hai Phong City,Ngo Quyen District,15,194,158,36,20
2022-02-21,Hai Phong City,Ngo Quyen District,16,229,157,72,31
2022-02-21,Hai Phong City,Ngo Quyen District,17,204,143,61,23
2022-02-21,Hai Phong City,Ngo Quyen District,18,211,144,67,30
2022-02-21,Hai Phong City,Ngo Quyen District,19,189,150,39,12
2022-02-21,Hai Phong City,Ngo Quyen District,20,122,94,28,9
2022-02-21,Hai Phong City,Ngo Quyen District,21,53,35,18,8
2022-02-21,Hai Phong City,Ngo Quyen District,22,1,1,0,0
2022-02-21,Hai Phong City,Thuy Nguyen,7,1,0,1,1
2022-02-21,Hai Phong City,Thuy Nguyen,8,1,0,1,1
2022-02-21,Hai Phong City,Thuy Nguyen,9,2,0,2,2
2022-02-21,Hai Phong City,Thuy Nguyen,10,3,1,2,2
2022-02-21,Hai Phong City,Thuy Nguyen,11,4,1,3,2
2022-02-21,Hai Phong City,Thuy Nguyen,12,3,0,3,3
2022-02-21,Hai Phong City,Thuy Nguyen,13,1,1,0,0
2022-02-21,Hai Phong City,Thuy Nguyen,14,1,1,0,0
2022-02-21,Hai Phong City,Thuy Nguyen,15,3,0,3,1
2022-02-21,Hai Phong City,Thuy Nguyen,17,4,0,4,3
2022-02-21,Hai Phong City,Thuy Nguyen,18,1,0,1,1
2022-02-21,Hai Phong City,Thuy Nguyen,21,1,0,1,1
2022-02-21,Hue City,Hue City,0,11,8,3,1
2022-02-21,Hue City,Hue City,1,1,0,1,0
2022-02-21,Hue City,Hue City,2,1,0,1,0
2022-02-21,Hue City,Hue City,4,1,0,1,0
2022-02-21,Hue City,Hue City,5,3,2,1,0
2022-02-21,Hue City,Hue City,6,42,36,6,2
2022-02-21,Hue City,Hue City,7,151,147,4,0
2022-02-21,Hue City,Hue City,8,308,282,26,0
2022-02-21,Hue City,Hue City,9,190,173,17,0
2022-02-21,Hue City,Hue City,10,320,294,26,1
2022-02-21,Hue City,Hue City,11,657,583,74,22
2022-02-21,Hue City,Hue City,12,376,352,24,1
2022-02-21,Hue City,Hue City,13,253,235,18,1
2022-02-21,Hue City,Hue City,14,320,292,28,3
2022-02-21,Hue City,Hue City,15,360,324,36,0
2022-02-21,Hue City,Hue City,16,413,379,34,1
2022-02-21,Hue City,Hue City,17,568,512,56,7
2022-02-21,Hue City,Hue City,18,631,554,77,5
2022-02-21,Hue City,Hue City,19,530,472,58,5
2022-02-21,Hue City,Hue City,20,371,323,48,4
2022-02-21,Hue City,Hue City,21,216,157,59,16
2022-02-21,Hue City,Hue City,22,6,2,4,0
2022-02-21,Hue City,Huong Thuy,9,1,1,0,0
2022-02-21,Hue City,Huong Thuy,10,1,0,1,0
2022-02-21,Hue City,Huong Thuy,11,1,0,1,0
2022-02-21,Hue City,Huong Thuy,16,1,1,0,0
2022-02-21,Hue City,Huong Thuy,18,2,1,1,0
2022-02-21,Hue City,Huong Thuy,19,6,2,4,0
2022-02-21,Hue City,Huong Thuy,20,2,1,1,1
2022-02-21,Hue City,Huong Thuy,21,2,0,2,1
2022-02-21,Hue City,Huong Tra,9,1,1,0,0
2022-02-21,Hue City,Huong Tra,16,2,0,2,1
2022-02-21,Hue City,Huong Tra,17,1,1,0,0
2022-02-21,Hue City,Huong Tra,19,1,1,0,0
2022-02-21,Hue City,Phu Vang,6,1,1,0,0
2022-02-21,Hue City,Phu Vang,7,1,1,0,0
2022-02-21,Hue City,Phu Vang,8,1,1,0,0
2022-02-21,Hue City,Phu Vang,9,2,2,0,0
2022-02-21,Hue City,Phu Vang,11,1,1,0,0
2022-02-21,Hue City,Phu Vang,12,1,0,1,0
2022-02-21,Hue City,Phu Vang,13,1,1,0,0
2022-02-21,Hue City,Phu Vang,15,1,1,0,0
2022-02-21,Hue City,Phu Vang,16,2,2,0,0
2022-02-21,Hue City,Phu Vang,17,3,3,0,0
2022-02-21,Hue City,Phu Vang,18,2,2,0,0
2022-02-21,Hue City,Phu Vang,19,3,2,1,1
2022-02-21,Hue City,Phu Vang,20,4,1,3,1
2022-02-21,Hue City,Phu Vang,21,1,1,0,0
2022-02-21,Vung Tau,Ba Ria City,8,6,0,6,6
2022-02-21,Vung Tau,Ba Ria City,9,11,3,8,7
2022-02-21,Vung Tau,Ba Ria City,10,6,2,4,4
2022-02-21,Vung Tau,Ba Ria City,11,12,4,8,8
2022-02-21,Vung Tau,Ba Ria City,12,9,3,6,4
2022-02-21,Vung Tau,Ba Ria City,13,7,3,4,3
2022-02-21,Vung Tau,Ba Ria City,14,1,0,1,0
2022-02-21,Vung Tau,Ba Ria City,15,5,4,1,0
2022-02-21,Vung Tau,Ba Ria City,16,6,3,3,2
2022-02-21,Vung Tau,Ba Ria City,17,11,5,6,5
2022-02-21,Vung Tau,Ba Ria City,18,11,1,10,8
2022-02-21,Vung Tau,Ba Ria City,19,9,2,7,6
2022-02-21,Vung Tau,Ba Ria City,20,4,0,4,4
2022-02-21,Vung Tau,Ba Ria City,21,4,0,4,3
2022-02-21,Vung Tau,Tan Thanh,13,1,0,1,1
2022-02-21,Vung Tau,Tan Thanh,14,2,0,2,2
2022-02-21,Vung Tau,Tan Thanh,16,1,0,1,0
2022-02-21,Vung Tau,Tan Thanh,18,1,0,1,1
2022-02-21,Vung Tau,Vung Tau City,0,3,1,2,0
2022-02-21,Vung Tau,Vung Tau City,1,2,1,1,0
2022-02-21,Vung Tau,Vung Tau City,3,1,0,1,0
2022-02-21,Vung Tau,Vung Tau City,5,1,1,0,0
2022-02-21,Vung Tau,Vung Tau City,6,25,22,3,0
2022-02-21,Vung Tau,Vung Tau City,7,86,75,11,2
2022-02-21,Vung Tau,Vung Tau City,8,121,111,10,1
2022-02-21,Vung Tau,Vung Tau City,9,124,120,4,0
2022-02-21,Vung Tau,Vung Tau City,10,168,157,11,1
2022-02-21,Vung Tau,Vung Tau City,11,306,286,20,7
2022-02-21,Vung Tau,Vung Tau City,12,234,213,21,2
2022-02-21,Vung Tau,Vung Tau City,13,193,178,15,2
2022-02-21,Vung Tau,Vung Tau City,14,224,200,24,3
2022-02-21,Vung Tau,Vung Tau City,15,180,167,13,2
2022-02-21,Vung Tau,Vung Tau City,16,174,164,10,2
2022-02-21,Vung Tau,Vung Tau City,17,208,195,13,1
2022-02-21,Vung Tau,Vung Tau City,18,278,257,21,1
2022-02-21,Vung Tau,Vung Tau City,19,221,200,21,2
2022-02-21,Vung Tau,Vung Tau City,20,165,142,23,2
2022-02-21,Vung Tau,Vung Tau City,21,81,65,16,6
2022-02-21,Vung Tau,Vung Tau City,22,2,1,1,0
2022-02-21,Vung Tau,Vung Tau City,23,2,2,0,0
2022-02-22,Binh Duong,Di An,6,1,0,1,1
2022-02-22,Binh Duong,Di An,7,6,1,5,4
2022-02-22,Binh Duong,Di An,8,18,3,15,13
2022-02-22,Binh Duong,Di An,9,20,7,13,12
2022-02-22,Binh Duong,Di An,10,29,7,22,17
2022-02-22,Binh Duong,Di An,11,39,5,34,31
2022-02-22,Binh Duong,Di An,12,33,9,24,19
2022-02-22,Binh Duong,Di An,13,35,9,26,25
2022-02-22,Binh Duong,Di An,14,18,7,11,11
2022-02-22,Binh Duong,Di An,15,10,3,7,4
2022-02-22,Binh Duong,Di An,16,19,1,18,16
2022-02-22,Binh Duong,Di An,17,22,9,13,12
2022-02-22,Binh Duong,Di An,18,18,7,11,9
2022-02-22,Binh Duong,Di An,19,12,7,5,2
2022-02-22,Binh Duong,Di An,20,9,5,4,2
2022-02-22,Binh Duong,Di An,21,9,1,8,6
2022-02-22,Binh Duong,Tan Uyen,9,1,0,1,1
2022-02-22,Binh Duong,Tan Uyen,11,1,1,0,0
2022-02-22,Binh Duong,Tan Uyen,12,3,1,2,2
2022-02-22,Binh Duong,Tan Uyen,13,2,2,0,0
2022-02-22,Binh Duong,Tan Uyen,18,4,1,3,3
2022-02-22,Binh Duong,Thu Dau Mot Town,1,1,0,1,0
2022-02-22,Binh Duong,Thu Dau Mot Town,5,1,0,1,1
2022-02-22,Binh Duong,Thu Dau Mot Town,6,23,16,7,6
2022-02-22,Binh Duong,Thu Dau Mot Town,7,88,78,10,1
2022-02-22,Binh Duong,Thu Dau Mot Town,8,186,161,25,6
2022-02-22,Binh Duong,Thu Dau Mot Town,9,197,175,22,4
2022-02-22,Binh Duong,Thu Dau Mot Town,10,321,300,21,5
2022-02-22,Binh Duong,Thu Dau Mot Town,11,571,509,62,24
2022-02-22,Binh Duong,Thu Dau Mot Town,12,369,336,33,8
2022-02-22,Binh Duong,Thu Dau Mot Town,13,325,307,18,3
2022-02-22,Binh Duong,Thu Dau Mot Town,14,285,255,30,8
2022-02-22,Binh Duong,Thu Dau Mot Town,15,232,212,20,6
2022-02-22,Binh Duong,Thu Dau Mot Town,16,267,192,75,54
2022-02-22,Binh Duong,Thu Dau Mot Town,17,480,303,177,141
2022-02-22,Binh Duong,Thu Dau Mot Town,18,484,297,187,149
2022-02-22,Binh Duong,Thu Dau Mot Town,19,326,264,62,36
2022-02-22,Binh Duong,Thu Dau Mot Town,20,226,186,40,12
2022-02-22,Binh Duong,Thu Dau Mot Town,21,79,62,17,5
2022-02-22,Binh Duong,Thu Dau Mot Town,23,1,1,0,0
2022-02-22,Binh Duong,Thuan An,0,1,0,1,0
2022-02-22,Binh Duong,Thuan An,1,1,0,1,1
2022-02-22,Binh Duong,Thuan An,6,1,1,0,0
2022-02-22,Binh Duong,Thuan An,7,3,1,2,2
2022-02-22,Binh Duong,Thuan An,8,21,10,11,9
2022-02-22,Binh Duong,Thuan An,9,28,15,13,11
2022-02-22,Binh Duong,Thuan An,10,57,30,27,22
2022-02-22,Binh Duong,Thuan An,11,49,31,18,16
2022-02-22,Binh Duong,Thuan An,12,45,30,15,12
2022-02-22,Binh Duong,Thuan An,13,43,32,11,10
2022-02-22,Binh Duong,Thuan An,14,39,18,21,17
2022-02-22,Binh Duong,Thuan An,15,27,12,15,12
2022-02-22,Binh Duong,Thuan An,16,39,9,30,28
2022-02-22,Binh Duong,Thuan An,17,47,13,34,29
2022-02-22,Binh Duong,Thuan An,18,44,23,21,15
2022-02-22,Binh Duong,Thuan An,19,26,13,13,9
2022-02-22,Binh Duong,Thuan An,20,25,13,12,7
2022-02-22,Binh Duong,Thuan An,21,12,6,6,3
2022-02-22,Binh Duong,Thuan An,23,1,0,1,0
2022-02-22,Can Tho City,Binh Thuy District,0,1,1,0,0
2022-02-22,Can Tho City,Binh Thuy District,6,1,1,0,0
2022-02-22,Can Tho City,Binh Thuy District,7,1,1,0,0
2022-02-22,Can Tho City,Binh Thuy District,8,3,3,0,0
2022-02-22,Can Tho City,Binh Thuy District,9,8,6,2,0
2022-02-22,Can Tho City,Binh Thuy District,10,10,10,0,0
2022-02-22,Can Tho City,Binh Thuy District,11,4,4,0,0
2022-02-22,Can Tho City,Binh Thuy District,12,10,10,0,0
2022-02-22,Can Tho City,Binh Thuy District,13,6,6,0,0
2022-02-22,Can Tho City,Binh Thuy District,14,10,10,0,0
2022-02-22,Can Tho City,Binh Thuy District,15,2,2,0,0
2022-02-22,Can Tho City,Binh Thuy District,16,7,7,0,0
2022-02-22,Can Tho City,Binh Thuy District,17,9,9,0,0
2022-02-22,Can Tho City,Binh Thuy District,18,8,8,0,0
2022-02-22,Can Tho City,Binh Thuy District,19,10,8,2,0
2022-02-22,Can Tho City,Binh Thuy District,20,7,7,0,0
2022-02-22,Can Tho City,Binh Thuy District,21,4,4,0,0
2022-02-22,Can Tho City,Cai Rang District,2,1,1,0,0
2022-02-22,Can Tho City,Cai Rang District,6,1,1,0,0
2022-02-22,Can Tho City,Cai Rang District,7,4,3,1,0
2022-02-22,Can Tho City,Cai Rang District,8,1,1,0,0
2022-02-22,Can Tho City,Cai Rang District,9,5,5,0,0
2022-02-22,Can Tho City,Cai Rang District,10,2,2,0,0
2022-02-22,Can Tho City,Cai Rang District,11,8,8,0,0
2022-02-22,Can Tho City,Cai Rang District,12,5,5,0,0
2022-02-22,Can Tho City,Cai Rang District,13,9,7,2,0
2022-02-22,Can Tho City,Cai Rang District,14,9,8,1,0
2022-02-22,Can Tho City,Cai Rang District,15,7,6,1,1
2022-02-22,Can Tho City,Cai Rang District,16,4,4,0,0
2022-02-22,Can Tho City,Cai Rang District,17,8,8,0,0
2022-02-22,Can Tho City,Cai Rang District,18,10,9,1,0
2022-02-22,Can Tho City,Cai Rang District,19,10,9,1,0
2022-02-22,Can Tho City,Cai Rang District,20,6,5,1,1
2022-02-22,Can Tho City,Cai Rang District,21,3,3,0,0
2022-02-22,Can Tho City,Ninh Kieu District,1,1,1,0,0
2022-02-22,Can Tho City,Ninh Kieu District,2,4,2,2,0
2022-02-22,Can Tho City,Ninh Kieu District,3,2,2,0,0
2022-02-22,Can Tho City,Ninh Kieu District,5,2,2,0,0
2022-02-22,Can Tho City,Ninh Kieu District,6,39,36,3,0
2022-02-22,Can Tho City,Ninh Kieu District,7,108,101,7,0
2022-02-22,Can Tho City,Ninh Kieu District,8,171,160,11,0
2022-02-22,Can Tho City,Ninh Kieu District,9,243,230,13,0
2022-02-22,Can Tho City,Ninh Kieu District,10,459,442,17,0
2022-02-22,Can Tho City,Ninh Kieu District,11,676,649,27,2
2022-02-22,Can Tho City,Ninh Kieu District,12,480,461,19,0
2022-02-22,Can Tho City,Ninh Kieu District,13,395,376,19,0
2022-02-22,Can Tho City,Ninh Kieu District,14,274,257,17,0
2022-02-22,Can Tho City,Ninh Kieu District,15,277,257,20,0
2022-02-22,Can Tho City,Ninh Kieu District,16,333,317,16,0
2022-02-22,Can Tho City,Ninh Kieu District,17,456,433,23,0
2022-02-22,Can Tho City,Ninh Kieu District,18,422,400,22,0
2022-02-22,Can Tho City,Ninh Kieu District,19,396,383,13,3
2022-02-22,Can Tho City,Ninh Kieu District,20,297,272,25,1
2022-02-22,Can Tho City,Ninh Kieu District,21,170,151,19,1
2022-02-22,Can Tho City,Ninh Kieu District,23,2,1,1,0
2022-02-22,Dong Nai,Bien Hoa City,0,2,0,2,2
2022-02-22,Dong Nai,Bien Hoa City,2,3,2,1,0
2022-02-22,Dong Nai,Bien Hoa City,6,33,22,11,8
2022-02-22,Dong Nai,Bien Hoa City,7,121,97,24,15
2022-02-22,Dong Nai,Bien Hoa City,8,253,225,28,4
2022-02-22,Dong Nai,Bien Hoa City,9,323,280,43,6
2022-02-22,Dong Nai,Bien Hoa City,10,608,543,65,12
2022-02-22,Dong Nai,Bien Hoa City,11,839,763,76,15
2022-02-22,Dong Nai,Bien Hoa City,12,682,633,49,12
2022-02-22,Dong Nai,Bien Hoa City,13,616,572,44,5
2022-02-22,Dong Nai,Bien Hoa City,14,538,498,40,9
2022-02-22,Dong Nai,Bien Hoa City,15,381,352,29,13
2022-02-22,Dong Nai,Bien Hoa City,16,421,351,70,42
2022-02-22,Dong Nai,Bien Hoa City,17,576,501,75,30
2022-02-22,Dong Nai,Bien Hoa City,18,593,541,52,15
2022-02-22,Dong Nai,Bien Hoa City,19,550,491,59,18
2022-02-22,Dong Nai,Bien Hoa City,20,417,343,74,8
2022-02-22,Dong Nai,Bien Hoa City,21,170,113,57,16
2022-02-22,Dong Nai,Bien Hoa City,22,4,2,2,0
2022-02-22,Dong Nai,Bien Hoa City,23,1,0,1,0
2022-02-22,Dong Nai,Long Thanh,11,1,0,1,1
2022-02-22,Dong Nai,Long Thanh,15,1,0,1,1
2022-02-22,Dong Nai,Long Thanh,17,4,0,4,2
2022-02-22,Dong Nai,Long Thanh,18,1,0,1,0
2022-02-22,Dong Nai,Long Thanh,19,1,0,1,1
2022-02-22,Dong Nai,Long Thanh,20,1,0,1,1
2022-02-22,Dong Nai,Trang Bom,11,1,0,1,1
2022-02-22,Dong Nai,Trang Bom,17,1,1,0,0
2022-02-22,Hai Phong City,An Duong,7,1,0,1,0
2022-02-22,Hai Phong City,An Duong,8,6,2,4,2
2022-02-22,Hai Phong City,An Duong,9,7,2,5,5
2022-02-22,Hai Phong City,An Duong,10,7,2,5,4
2022-02-22,Hai Phong City,An Duong,11,8,3,5,5
2022-02-22,Hai Phong City,An Duong,12,7,0,7,6
2022-02-22,Hai Phong City,An Duong,13,5,3,2,0
2022-02-22,Hai Phong City,An Duong,14,9,4,5,4
2022-02-22,Hai Phong City,An Duong,15,11,4,7,2
2022-02-22,Hai Phong City,An Duong,16,6,3,3,2
2022-02-22,Hai Phong City,An Duong,17,4,0,4,3
2022-02-22,Hai Phong City,An Duong,18,7,1,6,4
2022-02-22,Hai Phong City,An Duong,19,4,3,1,0
2022-02-22,Hai Phong City,An Duong,20,2,0,2,2
2022-02-22,Hai Phong City,An Duong,21,4,1,3,3
2022-02-22,Hai Phong City,Do Son District,12,1,0,1,1
2022-02-22,Hai Phong City,Do Son District,13,1,0,1,1
2022-02-22,Hai Phong City,Duong Kinh District,14,3,1,2,1
2022-02-22,Hai Phong City,Hai An District,1,1,1,0,0
2022-02-22,Hai Phong City,Hai An District,4,1,0,1,1
2022-02-22,Hai Phong City,Hai An District,7,8,5,3,2
2022-02-22,Hai Phong City,Hai An District,8,21,15,6,1
2022-02-22,Hai Phong City,Hai An District,9,14,12,2,0
2022-02-22,Hai Phong City,Hai An District,10,27,23,4,0
2022-02-22,Hai Phong City,Hai An District,11,35,29,6,1
2022-02-22,Hai Phong City,Hai An District,12,12,8,4,1
2022-02-22,Hai Phong City,Hai An District,13,5,3,2,0
2022-02-22,Hai Phong City,Hai An District,14,19,16,3,1
2022-02-22,Hai Phong City,Hai An District,15,21,16,5,0
2022-02-22,Hai Phong City,Hai An District,16,23,19,4,0
2022-02-22,Hai Phong City,Hai An District,17,19,13,6,2
2022-02-22,Hai Phong City,Hai An District,18,28,21,7,4
2022-02-22,Hai Phong City,Hai An District,19,21,17,4,2
2022-02-22,Hai Phong City,Hai An District,20,13,11,2,1
2022-02-22,Hai Phong City,Hai An District,21,5,4,1,0
2022-02-22,Hai Phong City,Hong Bang District,0,1,1,0,0
2022-02-22,Hai Phong City,Hong Bang District,4,1,0,1,0
2022-02-22,Hai Phong City,Hong Bang District,7,15,6,9,7
2022-02-22,Hai Phong City,Hong Bang District,8,34,20,14,8
2022-02-22,Hai Phong City,Hong Bang District,9,37,30,7,2
2022-02-22,Hai Phong City,Hong Bang District,10,60,49,11,8
2022-02-22,Hai Phong City,Hong Bang District,11,110,81,29,20
2022-02-22,Hai Phong City,Hong Bang District,12,68,64,4,2
2022-02-22,Hai Phong City,Hong Bang District,13,34,30,4,1
2022-02-22,Hai Phong City,Hong Bang District,14,46,41,5,3
2022-02-22,Hai Phong City,Hong Bang District,15,51,44,7,2
2022-02-22,Hai Phong City,Hong Bang District,16,67,42,25,12
2022-02-22,Hai Phong City,Hong Bang District,17,70,55,15,10
2022-02-22,Hai Phong City,Hong Bang District,18,77,52,25,14
2022-02-22,Hai Phong City,Hong Bang District,19,61,43,18,8
2022-02-22,Hai Phong City,Hong Bang District,20,26,17,9,3
2022-02-22,Hai Phong City,Hong Bang District,21,15,5,10,2
2022-02-22,Hai Phong City,Hong Bang District,23,2,0,2,2
2022-02-22,Hai Phong City,Kien An District,0,1,0,1,0
2022-02-22,Hai Phong City,Kien An District,7,7,2,5,4
2022-02-22,Hai Phong City,Kien An District,8,2,2,0,0
2022-02-22,Hai Phong City,Kien An District,9,5,4,1,1
2022-02-22,Hai Phong City,Kien An District,10,9,7,2,2
2022-02-22,Hai Phong City,Kien An District,11,22,14,8,5
2022-02-22,Hai Phong City,Kien An District,12,5,2,3,2
2022-02-22,Hai Phong City,Kien An District,13,14,11,3,1
2022-02-22,Hai Phong City,Kien An District,14,17,9,8,5
2022-02-22,Hai Phong City,Kien An District,15,9,8,1,1
2022-02-22,Hai Phong City,Kien An District,16,11,8,3,2
2022-02-22,Hai Phong City,Kien An District,17,16,12,4,1
2022-02-22,Hai Phong City,Kien An District,18,7,3,4,0
2022-02-22,Hai Phong City,Kien An District,19,12,9,3,1
2022-02-22,Hai Phong City,Kien An District,20,6,1,5,4
2022-02-22,Hai Phong City,Kien An District,21,9,4,5,4
2022-02-22,Hai Phong City,Le Chan District,1,1,0,1,0
2022-02-22,Hai Phong City,Le Chan District,2,1,0,1,0
2022-02-22,Hai Phong City,Le Chan District,3,1,1,0,0
2022-02-22,Hai Phong City,Le Chan District,7,57,37,20,16
2022-02-22,Hai Phong City,Le Chan District,8,92,67,25,11
2022-02-22,Hai Phong City,Le Chan District,9,88,69,19,3
2022-02-22,Hai Phong City,Le Chan District,10,187,144,43,15
2022-02-22,Hai Phong City,Le Chan District,11,317,241,76,39
2022-02-22,Hai Phong City,Le Chan District,12,166,147,19,6
2022-02-22,Hai Phong City,Le Chan District,13,98,84,14,0
2022-02-22,Hai Phong City,Le Chan District,14,166,143,23,6
2022-02-22,Hai Phong City,Le Chan District,15,238,174,64,18
2022-02-22,Hai Phong City,Le Chan District,16,241,199,42,18
2022-02-22,Hai Phong City,Le Chan District,17,294,224,70,32
2022-02-22,Hai Phong City,Le Chan District,18,264,208,56,24
2022-02-22,Hai Phong City,Le Chan District,19,192,150,42,14
2022-02-22,Hai Phong City,Le Chan District,20,137,110,27,4
2022-02-22,Hai Phong City,Le Chan District,21,61,39,22,1
2022-02-22,Hai Phong City,Le Chan District,22,4,2,2,0
2022-02-22,Hai Phong City,Le Chan District,23,4,1,3,0
2022-02-22,Hai Phong City,Ngo Quyen District,0,1,1,0,0
2022-02-22,Hai Phong City,Ngo Quyen District,1,1,1,0,0
2022-02-22,Hai Phong City,Ngo Quyen District,2,1,0,1,1
2022-02-22,Hai Phong City,Ngo Quyen District,3,2,1,1,0
2022-02-22,Hai Phong City,Ngo Quyen District,6,2,2,0,0
2022-02-22,Hai Phong City,Ngo Quyen District,7,48,25,23,12
2022-02-22,Hai Phong City,Ngo Quyen District,8,103,75,28,8
2022-02-22,Hai Phong City,Ngo Quyen District,9,96,77,19,6
2022-02-22,Hai Phong City,Ngo Quyen District,10,141,117,24,5
2022-02-22,Hai Phong City,Ngo Quyen District,11,213,176,37,16
2022-02-22,Hai Phong City,Ngo Quyen District,12,133,104,29,5
2022-02-22,Hai Phong City,Ngo Quyen District,13,111,98,13,3
2022-02-22,Hai Phong City,Ngo Quyen District,14,152,134,18,5
2022-02-22,Hai Phong City,Ngo Quyen District,15,162,137,25,13
2022-02-22,Hai Phong City,Ngo Quyen District,16,199,141,58,28
2022-02-22,Hai Phong City,Ngo Quyen District,17,198,154,44,19
2022-02-22,Hai Phong City,Ngo Quyen District,18,181,136,45,15
2022-02-22,Hai Phong City,Ngo Quyen District,19,176,138,38,15
2022-02-22,Hai Phong City,Ngo Quyen District,20,126,103,23,7
2022-02-22,Hai Phong City,Ngo Quyen District,21,53,36,17,6
2022-02-22,Hai Phong City,Ngo Quyen District,22,1,0,1,0
2022-02-22,Hai Phong City,Ngo Quyen District,23,2,1,1,0
2022-02-22,Hai Phong City,Thuy Nguyen,10,1,1,0,0
2022-02-22,Hai Phong City,Thuy Nguyen,11,2,0,2,1
2022-02-22,Hai Phong City,Thuy Nguyen,13,1,0,1,1
2022-02-22,Hai Phong City,Thuy Nguyen,15,1,0,1,1
2022-02-22,Hai Phong City,Thuy Nguyen,16,2,0,2,2
2022-02-22,Hai Phong City,Thuy Nguyen,18,2,0,2,2
2022-02-22,Hai Phong City,Thuy Nguyen,19,1,0,1,1
2022-02-22,Hai Phong City,Thuy Nguyen,20,1,0,1,0
2022-02-22,Hue City,Hue City,0,2,1,1,0
2022-02-22,Hue City,Hue City,1,3,2,1,0
2022-02-22,Hue City,Hue City,3,2,2,0,0
2022-02-22,Hue City,Hue City,4,1,1,0,0
2022-02-22,Hue City,Hue City,5,3,2,1,0
2022-02-22,Hue City,Hue City,6,62,53,9,7
2022-02-22,Hue City,Hue City,7,158,139,19,2
2022-02-22,Hue City,Hue City,8,303,277,26,1
2022-02-22,Hue City,Hue City,9,236,222,14,1
2022-02-22,Hue City,Hue City,10,343,322,21,0
2022-02-22,Hue City,Hue City,11,628,585,43,5
2022-02-22,Hue City,Hue City,12,398,380,18,0
2022-02-22,Hue City,Hue City,13,271,252,19,2
2022-02-22,Hue City,Hue City,14,300,277,23,0
2022-02-22,Hue City,Hue City,15,344,313,31,0
2022-02-22,Hue City,Hue City,16,390,360,30,3
2022-02-22,Hue City,Hue City,17,526,492,34,1
2022-02-22,Hue City,Hue City,18,635,573,62,10
2022-02-22,Hue City,Hue City,19,522,465,57,7
2022-02-22,Hue City,Hue City,20,368,317,51,6
2022-02-22,Hue City,Hue City,21,217,180,37,3
2022-02-22,Hue City,Hue City,22,5,1,4,0
2022-02-22,Hue City,Hue City,23,3,2,1,0
2022-02-22,Hue City,Huong Thuy,12,1,0,1,0
2022-02-22,Hue City,Huong Thuy,13,1,0,1,0
2022-02-22,Hue City,Huong Thuy,15,1,0,1,1
2022-02-22,Hue City,Huong Thuy,16,1,0,1,1
2022-02-22,Hue City,Huong Thuy,17,3,3,0,0
2022-02-22,Hue City,Huong Thuy,20,1,1,0,0
2022-02-22,Hue City,Huong Tra,19,1,0,1,0
2022-02-22,Hue City,Phu Vang,8,1,1,0,0
2022-02-22,Hue City,Phu Vang,9,2,1,1,0
2022-02-22,Hue City,Phu Vang,10,1,1,0,0
2022-02-22,Hue City,Phu Vang,11,2,2,0,0
2022-02-22,Hue City,Phu Vang,12,1,0,1,0
2022-02-22,Hue City,Phu Vang,13,1,1,0,0
2022-02-22,Hue City,Phu Vang,15,1,0,1,0
2022-02-22,Hue City,Phu Vang,16,1,1,0,0
2022-02-22,Hue City,Phu Vang,17,1,1,0,0
2022-02-22,Hue City,Phu Vang,18,1,0,1,0
2022-02-22,Hue City,Phu Vang,20,2,1,1,1
2022-02-22,Hue City,Phu Vang,21,2,1,1,1
2022-02-22,Vung Tau,Ba Ria City,7,1,1,0,0
2022-02-22,Vung Tau,Ba Ria City,8,3,2,1,1
2022-02-22,Vung Tau,Ba Ria City,9,6,2,4,4
2022-02-22,Vung Tau,Ba Ria City,10,7,3,4,3
2022-02-22,Vung Tau,Ba Ria City,11,5,2,3,2
2022-02-22,Vung Tau,Ba Ria City,12,6,2,4,3
2022-02-22,Vung Tau,Ba Ria City,13,5,0,5,4
2022-02-22,Vung Tau,Ba Ria City,14,8,0,8,6
2022-02-22,Vung Tau,Ba Ria City,15,9,0,9,9
2022-02-22,Vung Tau,Ba Ria City,16,13,1,12,9
2022-02-22,Vung Tau,Ba Ria City,17,6,0,6,6
2022-02-22,Vung Tau,Ba Ria City,18,7,2,5,4
2022-02-22,Vung Tau,Ba Ria City,19,1,0,1,1
2022-02-22,Vung Tau,Ba Ria City,20,1,0,1,1
2022-02-22,Vung Tau,Long Dien,9,1,0,1,1
2022-02-22,Vung Tau,Tan Thanh,13,1,0,1,1
2022-02-22,Vung Tau,Tan Thanh,20,1,0,1,1
2022-02-22,Vung Tau,Vung Tau City,0,1,1,0,0
2022-02-22,Vung Tau,Vung Tau City,4,2,2,0,0
2022-02-22,Vung Tau,Vung Tau City,5,1,0,1,0
2022-02-22,Vung Tau,Vung Tau City,6,32,29,3,1
2022-02-22,Vung Tau,Vung Tau City,7,102,87,15,5
2022-02-22,Vung Tau,Vung Tau City,8,142,138,4,0
2022-02-22,Vung Tau,Vung Tau City,9,110,103,7,0
2022-02-22,Vung Tau,Vung Tau City,10,132,122,10,0
2022-02-22,Vung Tau,Vung Tau City,11,263,244,19,3
2022-02-22,Vung Tau,Vung Tau City,12,221,204,17,0
2022-02-22,Vung Tau,Vung Tau City,13,185,174,11,2
2022-02-22,Vung Tau,Vung Tau City,14,218,201,17,2
2022-02-22,Vung Tau,Vung Tau City,15,206,190,16,1
2022-02-22,Vung Tau,Vung Tau City,16,162,152,10,4
2022-02-22,Vung Tau,Vung Tau City,17,217,203,14,0
2022-02-22,Vung Tau,Vung Tau City,18,267,246,21,1
2022-02-22,Vung Tau,Vung Tau City,19,232,213,19,2
2022-02-22,Vung Tau,Vung Tau City,20,159,143,16,3
2022-02-22,Vung Tau,Vung Tau City,21,95,68,27,6
2022-02-22,Vung Tau,Vung Tau City,22,1,0,1,0
2022-02-22,Vung Tau,Vung Tau City,23,1,1,0,0
2022-02-23,Binh Duong,Ben Cat,18,1,1,0,0
2022-02-23,Binh Duong,Ben Cat,20,1,0,1,1
2022-02-23,Binh Duong,Di An,0,2,1,1,1
2022-02-23,Binh Duong,Di An,7,2,0,2,2
2022-02-23,Binh Duong,Di An,8,7,0,7,7
2022-02-23,Binh Duong,Di An,9,14,3,11,6
2022-02-23,Binh Duong,Di An,10,26,5,21,17
2022-02-23,Binh Duong,Di An,11,24,6,18,10
2022-02-23,Binh Duong,Di An,12,30,9,21,14
2022-02-23,Binh Duong,Di An,13,38,14,24,17
2022-02-23,Binh Duong,Di An,14,18,10,8,5
2022-02-23,Binh Duong,Di An,15,10,6,4,3
2022-02-23,Binh Duong,Di An,16,14,8,6,4
2022-02-23,Binh Duong,Di An,17,9,5,4,4
2022-02-23,Binh Duong,Di An,18,13,8,5,3
2022-02-23,Binh Duong,Di An,19,9,4,5,5
2022-02-23,Binh Duong,Di An,20,7,4,3,2
2022-02-23,Binh Duong,Di An,21,8,2,6,5
2022-02-23,Binh Duong,Tan Uyen,10,3,2,1,0
2022-02-23,Binh Duong,Tan Uyen,11,2,2,0,0
2022-02-23,Binh Duong,Tan Uyen,12,3,3,0,0
2022-02-23,Binh Duong,Tan Uyen,13,1,0,1,1
2022-02-23,Binh Duong,Tan Uyen,15,3,2,1,1
2022-02-23,Binh Duong,Tan Uyen,16,1,0,1,1
2022-02-23,Binh Duong,Tan Uyen,17,2,1,1,1
2022-02-23,Binh Duong,Tan Uyen,19,3,1,2,1
2022-02-23,Binh Duong,Tan Uyen,20,1,0,1,1
2022-02-23,Binh Duong,Tan Uyen,21,1,0,1,1
2022-02-23,Binh Duong,Thu Dau Mot Town,2,2,1,1,0
2022-02-23,Binh Duong,Thu Dau Mot Town,6,26,17,9,6
2022-02-23,Binh Duong,Thu Dau Mot Town,7,79,74,5,2
2022-02-23,Binh Duong,Thu Dau Mot Town,8,167,154,13,3
2022-02-23,Binh Duong,Thu Dau Mot Town,9,189,173,16,0
2022-02-23,Binh Duong,Thu Dau Mot Town,10,316,290,26,2
2022-02-23,Binh Duong,Thu Dau Mot Town,11,526,492,34,6
2022-02-23,Binh Duong,Thu Dau Mot Town,12,383,362,21,4
2022-02-23,Binh Duong,Thu Dau Mot Town,13,343,325,18,4
2022-02-23,Binh Duong,Thu Dau Mot Town,14,271,255,16,0
2022-02-23,Binh Duong,Thu Dau Mot Town,15,235,217,18,4
2022-02-23,Binh Duong,Thu Dau Mot Town,16,273,250,23,7
2022-02-23,Binh Duong,Thu Dau Mot Town,17,365,287,78,46
2022-02-23,Binh Duong,Thu Dau Mot Town,18,411,322,89,40
2022-02-23,Binh Duong,Thu Dau Mot Town,19,310,281,29,12
2022-02-23,Binh Duong,Thu Dau Mot Town,20,206,185,21,5
2022-02-23,Binh Duong,Thu Dau Mot Town,21,91,63,28,4
2022-02-23,Binh Duong,Thu Dau Mot Town,22,3,1,2,1
2022-02-23,Binh Duong,Thu Dau Mot Town,23,1,0,1,1
2022-02-23,Binh Duong,Thuan An,4,1,0,1,0
2022-02-23,Binh Duong,Thuan An,6,1,0,1,1
2022-02-23,Binh Duong,Thuan An,7,8,2,6,4
2022-02-23,Binh Duong,Thuan An,8,20,10,10,8
2022-02-23,Binh Duong,Thuan An,9,24,13,11,7
2022-02-23,Binh Duong,Thuan An,10,42,31,11,9
2022-02-23,Binh Duong,Thuan An,11,60,40,20,11
2022-02-23,Binh Duong,Thuan An,12,52,33,19,13
2022-02-23,Binh Duong,Thuan An,13,43,26,17,12
2022-02-23,Binh Duong,Thuan An,14,37,29,8,4
2022-02-23,Binh Duong,Thuan An,15,33,23,10,5
2022-02-23,Binh Duong,Thuan An,16,29,14,15,9
2022-02-23,Binh Duong,Thuan An,17,29,14,15,13
2022-02-23,Binh Duong,Thuan An,18,39,14,25,18
2022-02-23,Binh Duong,Thuan An,19,39,15,24,16
2022-02-23,Binh Duong,Thuan An,20,22,12,10,8
2022-02-23,Binh Duong,Thuan An,21,6,1,5,4
2022-02-23,Can Tho City,Binh Thuy District,8,4,3,1,0
2022-02-23,Can Tho City,Binh Thuy District,9,6,6,0,0
2022-02-23,Can Tho City,Binh Thuy District,10,5,5,0,0
2022-02-23,Can Tho City,Binh Thuy District,11,9,8,1,0
2022-02-23,Can Tho City,Binh Thuy District,12,9,7,2,0
2022-02-23,Can Tho City,Binh Thuy District,13,5,5,0,0
2022-02-23,Can Tho City,Binh Thuy District,14,11,10,1,0
2022-02-23,Can Tho City,Binh Thuy District,15,9,9,0,0
2022-02-23,Can Tho City,Binh Thuy District,16,9,8,1,1
2022-02-23,Can Tho City,Binh Thuy District,17,10,8,2,0
2022-02-23,Can Tho City,Binh Thuy District,18,7,6,1,0
2022-02-23,Can Tho City,Binh Thuy District,19,9,9,0,0
2022-02-23,Can Tho City,Binh Thuy District,20,3,2,1,0
2022-02-23,Can Tho City,Binh Thuy District,21,6,5,1,0
2022-02-23,Can Tho City,Cai Rang District,6,3,1,2,2
2022-02-23,Can Tho City,Cai Rang District,7,3,2,1,0
2022-02-23,Can Tho City,Cai Rang District,9,5,3,2,0
2022-02-23,Can Tho City,Cai Rang District,10,12,11,1,0
2022-02-23,Can Tho City,Cai Rang District,11,10,8,2,0
2022-02-23,Can Tho City,Cai Rang District,12,4,3,1,0
2022-02-23,Can Tho City,Cai Rang District,13,5,4,1,0
2022-02-23,Can Tho City,Cai Rang District,14,8,8,0,0
2022-02-23,Can Tho City,Cai Rang District,15,6,5,1,1
2022-02-23,Can Tho City,Cai Rang District,16,9,8,1,0
2022-02-23,Can Tho City,Cai Rang District,17,8,8,0,0
2022-02-23,Can Tho City,Cai Rang District,18,8,6,2,0
2022-02-23,Can Tho City,Cai Rang District,19,5,2,3,0
2022-02-23,Can Tho City,Cai Rang District,20,6,6,0,0
2022-02-23,Can Tho City,Cai Rang District,21,6,4,2,0
2022-02-23,Can Tho City,Ninh Kieu District,1,1,0,1,0
2022-02-23,Can Tho City,Ninh Kieu District,3,4,1,3,0
2022-02-23,Can Tho City,Ninh Kieu District,5,1,1,0,0
2022-02-23,Can Tho City,Ninh Kieu District,6,43,42,1,0
2022-02-23,Can Tho City,Ninh Kieu District,7,117,114,3,0
2022-02-23,Can Tho City,Ninh Kieu District,8,201,185,16,0
2022-02-23,Can Tho City,Ninh Kieu District,9,235,219,16,0
2022-02-23,Can Tho City,Ninh Kieu District,10,486,466,20,0
2022-02-23,Can Tho City,Ninh Kieu District,11,769,725,44,6
2022-02-23,Can Tho City,Ninh Kieu District,12,451,421,30,0
2022-02-23,Can Tho City,Ninh Kieu District,13,370,353,17,0
2022-02-23,Can Tho City,Ninh Kieu District,14,347,328,19,0
2022-02-23,Can Tho City,Ninh Kieu District,15,274,261,13,0
2022-02-23,Can Tho City,Ninh Kieu District,16,342,331,11,0
2022-02-23,Can Tho City,Ninh Kieu District,17,410,389,21,0
2022-02-23,Can Tho City,Ninh Kieu District,18,425,394,31,0
2022-02-23,Can Tho City,Ninh Kieu District,19,395,376,19,2
2022-02-23,Can Tho City,Ninh Kieu District,20,293,271,22,3
2022-02-23,Can Tho City,Ninh Kieu District,21,167,149,18,1
2022-02-23,Can Tho City,Ninh Kieu District,22,4,2,2,0
2022-02-23,Can Tho City,Ninh Kieu District,23,1,1,0,0
2022-02-23,Dong Nai,Bien Hoa City,0,3,2,1,0
2022-02-23,Dong Nai,Bien Hoa City,3,3,2,1,0
2022-02-23,Dong Nai,Bien Hoa City,5,1,1,0,0
2022-02-23,Dong Nai,Bien Hoa City,6,35,20,15,15
2022-02-23,Dong Nai,Bien Hoa City,7,139,110,29,17
2022-02-23,Dong Nai,Bien Hoa City,8,234,210,24,6
2022-02-23,Dong Nai,Bien Hoa City,9,333,296,37,4
2022-02-23,Dong Nai,Bien Hoa City,10,627,564,63,14
2022-02-23,Dong Nai,Bien Hoa City,11,907,830,77,22
2022-02-23,Dong Nai,Bien Hoa City,12,634,594,40,10
2022-02-23,Dong Nai,Bien Hoa City,13,607,562,45,8
2022-02-23,Dong Nai,Bien Hoa City,14,542,501,41,8
2022-02-23,Dong Nai,Bien Hoa City,15,425,394,31,5
2022-02-23,Dong Nai,Bien Hoa City,16,413,377,36,8
2022-02-23,Dong Nai,Bien Hoa City,17,502,459,43,12
2022-02-23,Dong Nai,Bien Hoa City,18,669,554,115,62
2022-02-23,Dong Nai,Bien Hoa City,19,543,476,67,14
2022-02-23,Dong Nai,Bien Hoa City,20,412,317,95,43
2022-02-23,Dong Nai,Bien Hoa City,21,218,127,91,46
2022-02-23,Dong Nai,Bien Hoa City,22,5,1,4,0
2022-02-23,Dong Nai,Long Khanh,19,1,0,1,0
2022-02-23,Dong Nai,Long Khanh,20,1,0,1,0
2022-02-23,Dong Nai,Long Thanh,9,5,0,5,4
2022-02-23,Dong Nai,Long Thanh,11,3,0,3,2
2022-02-23,Dong Nai,Long Thanh,12,3,0,3,2
2022-02-23,Dong Nai,Long Thanh,16,1,0,1,1
2022-02-23,Dong Nai,Long Thanh,18,2,0,2,2
2022-02-23,Dong Nai,Long Thanh,19,1,0,1,1
2022-02-23,Dong Nai,Long Thanh,20,1,0,1,1
2022-02-23,Dong Nai,Nhon trach,19,1,0,1,1
2022-02-23,Dong Nai,Thong Nhat,5,1,1,0,0
2022-02-23,Dong Nai,Thong Nhat,7,3,2,1,1
2022-02-23,Dong Nai,Thong Nhat,8,1,1,0,0
2022-02-23,Dong Nai,Thong Nhat,9,1,1,0,0
2022-02-23,Dong Nai,Thong Nhat,10,2,2,0,0
2022-02-23,Dong Nai,Thong Nhat,12,2,2,0,0
2022-02-23,Dong Nai,Thong Nhat,13,3,3,0,0
2022-02-23,Dong Nai,Thong Nhat,16,2,2,0,0
2022-02-23,Dong Nai,Thong Nhat,20,1,1,0,0
2022-02-23,Dong Nai,Trang Bom,15,1,1,0,0
2022-02-23,Hai Phong City,An Duong,7,1,0,1,1
2022-02-23,Hai Phong City,An Duong,8,6,2,4,4
2022-02-23,Hai Phong City,An Duong,9,6,4,2,2
2022-02-23,Hai Phong City,An Duong,10,2,1,1,1
2022-02-23,Hai Phong City,An Duong,11,12,5,7,7
2022-02-23,Hai Phong City,An Duong,12,2,1,1,1
2022-02-23,Hai Phong City,An Duong,13,6,0,6,3
2022-02-23,Hai Phong City,An Duong,14,14,2,12,11
2022-02-23,Hai Phong City,An Duong,15,11,10,1,1
2022-02-23,Hai Phong City,An Duong,16,12,6,6,3
2022-02-23,Hai Phong City,An Duong,17,4,1,3,3
2022-02-23,Hai Phong City,An Duong,18,2,0,2,0
2022-02-23,Hai Phong City,An Duong,19,4,1,3,1
2022-02-23,Hai Phong City,An Duong,20,2,0,2,0
2022-02-23,Hai Phong City,Duong Kinh District,14,1,0,1,1
2022-02-23,Hai Phong City,Hai An District,0,2,1,1,0
2022-02-23,Hai Phong City,Hai An District,7,10,7,3,1
2022-02-23,Hai Phong City,Hai An District,8,16,12,4,2
2022-02-23,Hai Phong City,Hai An District,9,12,10,2,0
2022-02-23,Hai Phong City,Hai An District,10,22,18,4,1
2022-02-23,Hai Phong City,Hai An District,11,28,26,2,0
2022-02-23,Hai Phong City,Hai An District,12,26,17,9,0
2022-02-23,Hai Phong City,Hai An District,13,22,15,7,1
2022-02-23,Hai Phong City,Hai An District,14,14,14,0,0
2022-02-23,Hai Phong City,Hai An District,15,26,16,10,5
2022-02-23,Hai Phong City,Hai An District,16,22,18,4,0
2022-02-23,Hai Phong City,Hai An District,17,32,25,7,1
2022-02-23,Hai Phong City,Hai An District,18,31,20,11,4
2022-02-23,Hai Phong City,Hai An District,19,29,22,7,1
2022-02-23,Hai Phong City,Hai An District,20,15,11,4,0
2022-02-23,Hai Phong City,Hai An District,21,13,4,9,2
2022-02-23,Hai Phong City,Hai An District,23,1,1,0,0
2022-02-23,Hai Phong City,Hong Bang District,1,1,0,1,0
2022-02-23,Hai Phong City,Hong Bang District,6,1,1,0,0
2022-02-23,Hai Phong City,Hong Bang District,7,14,11,3,1
2022-02-23,Hai Phong City,Hong Bang District,8,52,37,15,5
2022-02-23,Hai Phong City,Hong Bang District,9,32,28,4,0
2022-02-23,Hai Phong City,Hong Bang District,10,65,56,9,4
2022-02-23,Hai Phong City,Hong Bang District,11,128,102,26,20
2022-02-23,Hai Phong City,Hong Bang District,12,76,67,9,2
2022-02-23,Hai Phong City,Hong Bang District,13,34,29,5,0
2022-02-23,Hai Phong City,Hong Bang District,14,48,39,9,3
2022-02-23,Hai Phong City,Hong Bang District,15,40,30,10,2
2022-02-23,Hai Phong City,Hong Bang District,16,54,44,10,2
2022-02-23,Hai Phong City,Hong Bang District,17,48,43,5,0
2022-02-23,Hai Phong City,Hong Bang District,18,72,54,18,6
2022-02-23,Hai Phong City,Hong Bang District,19,61,49,12,5
2022-02-23,Hai Phong City,Hong Bang District,20,35,24,11,5
2022-02-23,Hai Phong City,Hong Bang District,21,16,11,5,1
2022-02-23,Hai Phong City,Hong Bang District,22,3,2,1,0
2022-02-23,Hai Phong City,Kien An District,7,3,0,3,2
2022-02-23,Hai Phong City,Kien An District,8,3,0,3,2
2022-02-23,Hai Phong City,Kien An District,9,4,2,2,1
2022-02-23,Hai Phong City,Kien An District,10,8,7,1,0
2022-02-23,Hai Phong City,Kien An District,11,12,9,3,0
2022-02-23,Hai Phong City,Kien An District,12,9,7,2,1
2022-02-23,Hai Phong City,Kien An District,13,9,8,1,0
2022-02-23,Hai Phong City,Kien An District,14,14,7,7,2
2022-02-23,Hai Phong City,Kien An District,15,17,8,9,3
2022-02-23,Hai Phong City,Kien An District,16,9,7,2,0
2022-02-23,Hai Phong City,Kien An District,17,11,9,2,2
2022-02-23,Hai Phong City,Kien An District,18,8,4,4,1
2022-02-23,Hai Phong City,Kien An District,19,12,8,4,2
2022-02-23,Hai Phong City,Kien An District,20,8,4,4,4
2022-02-23,Hai Phong City,Kien An District,21,5,0,5,4
2022-02-23,Hai Phong City,Le Chan District,0,2,1,1,0
2022-02-23,Hai Phong City,Le Chan District,1,2,2,0,0
2022-02-23,Hai Phong City,Le Chan District,7,49,33,16,8
2022-02-23,Hai Phong City,Le Chan District,8,91,71,20,8
2022-02-23,Hai Phong City,Le Chan District,9,70,53,17,0
2022-02-23,Hai Phong City,Le Chan District,10,166,141,25,7
2022-02-23,Hai Phong City,Le Chan District,11,308,243,65,37
2022-02-23,Hai Phong City,Le Chan District,12,181,155,26,3
2022-02-23,Hai Phong City,Le Chan District,13,107,92,15,1
2022-02-23,Hai Phong City,Le Chan District,14,155,134,21,4
2022-02-23,Hai Phong City,Le Chan District,15,229,180,49,18
2022-02-23,Hai Phong City,Le Chan District,16,232,191,41,7
2022-02-23,Hai Phong City,Le Chan District,17,251,213,38,11
2022-02-23,Hai Phong City,Le Chan District,18,278,227,51,10
2022-02-23,Hai Phong City,Le Chan District,19,214,181,33,7
2022-02-23,Hai Phong City,Le Chan District,20,159,123,36,6
2022-02-23,Hai Phong City,Le Chan District,21,61,41,20,6
2022-02-23,Hai Phong City,Le Chan District,22,1,1,0,0
2022-02-23,Hai Phong City,Le Chan District,23,4,2,2,1
2022-02-23,Hai Phong City,Ngo Quyen District,0,2,1,1,0
2022-02-23,Hai Phong City,Ngo Quyen District,1,1,0,1,0
2022-02-23,Hai Phong City,Ngo Quyen District,6,4,1,3,0
2022-02-23,Hai Phong City,Ngo Quyen District,7,34,24,10,3
2022-02-23,Hai Phong City,Ngo Quyen District,8,84,65,19,8
2022-02-23,Hai Phong City,Ngo Quyen District,9,87,70,17,0
2022-02-23,Hai Phong City,Ngo Quyen District,10,119,106,13,4
2022-02-23,Hai Phong City,Ngo Quyen District,11,242,205,37,19
2022-02-23,Hai Phong City,Ngo Quyen District,12,111,97,14,0
2022-02-23,Hai Phong City,Ngo Quyen District,13,97,90,7,1
2022-02-23,Hai Phong City,Ngo Quyen District,14,130,108,22,1
2022-02-23,Hai Phong City,Ngo Quyen District,15,187,155,32,16
2022-02-23,Hai Phong City,Ngo Quyen District,16,191,168,23,3
2022-02-23,Hai Phong City,Ngo Quyen District,17,172,147,25,2
2022-02-23,Hai Phong City,Ngo Quyen District,18,199,154,45,8
2022-02-23,Hai Phong City,Ngo Quyen District,19,117,96,21,5
2022-02-23,Hai Phong City,Ngo Quyen District,20,114,89,25,8
2022-02-23,Hai Phong City,Ngo Quyen District,21,56,37,19,5
2022-02-23,Hai Phong City,Ngo Quyen District,22,1,0,1,0
2022-02-23,Hai Phong City,Ngo Quyen District,23,2,1,1,0
2022-02-23,Hai Phong City,Thuy Nguyen,9,1,0,1,1
2022-02-23,Hai Phong City,Thuy Nguyen,10,3,0,3,1
2022-02-23,Hai Phong City,Thuy Nguyen,11,2,1,1,0
2022-02-23,Hai Phong City,Thuy Nguyen,14,2,0,2,2
2022-02-23,Hai Phong City,Thuy Nguyen,16,1,0,1,1
2022-02-23,Hai Phong City,Thuy Nguyen,17,1,0,1,1
2022-02-23,Hai Phong City,Thuy Nguyen,19,1,0,1,1
2022-02-23,Hai Phong City,Thuy Nguyen,21,1,0,1,0
2022-02-23,Hai Phong City,Thuy Nguyen,23,1,0,1,0
2022-02-23,Hue City,Hue City,0,13,6,7,2
2022-02-23,Hue City,Hue City,1,4,2,2,0
2022-02-23,Hue City,Hue City,2,2,1,1,0
2022-02-23,Hue City,Hue City,5,1,1,0,0
2022-02-23,Hue City,Hue City,6,54,51,3,2
2022-02-23,Hue City,Hue City,7,166,154,12,0
2022-02-23,Hue City,Hue City,8,345,307,38,4
2022-02-23,Hue City,Hue City,9,248,230,18,0
2022-02-23,Hue City,Hue City,10,394,375,19,2
2022-02-23,Hue City,Hue City,11,814,723,91,44
2022-02-23,Hue City,Hue City,12,434,397,37,2
2022-02-23,Hue City,Hue City,13,203,192,11,0
2022-02-23,Hue City,Hue City,14,298,279,19,0
2022-02-23,Hue City,Hue City,15,382,351,31,5
2022-02-23,Hue City,Hue City,16,392,362,30,3
2022-02-23,Hue City,Hue City,17,568,514,54,9
2022-02-23,Hue City,Hue City,18,595,535,60,7
2022-02-23,Hue City,Hue City,19,506,432,74,13
2022-02-23,Hue City,Hue City,20,382,335,47,11
2022-02-23,Hue City,Hue City,21,210,162,48,11
2022-02-23,Hue City,Hue City,22,3,1,2,0
2022-02-23,Hue City,Hue City,23,4,3,1,1
2022-02-23,Hue City,Huong Thuy,9,1,1,0,0
2022-02-23,Hue City,Huong Thuy,10,2,0,2,2
2022-02-23,Hue City,Huong Thuy,18,1,1,0,0
2022-02-23,Hue City,Huong Thuy,19,1,0,1,0
2022-02-23,Hue City,Huong Thuy,21,1,0,1,1
2022-02-23,Hue City,Huong Tra,8,1,1,0,0
2022-02-23,Hue City,Huong Tra,9,1,0,1,0
2022-02-23,Hue City,Huong Tra,10,1,0,1,0
2022-02-23,Hue City,Huong Tra,17,2,1,1,0
2022-02-23,Hue City,Huong Tra,19,1,0,1,0
2022-02-23,Hue City,Phu Vang,6,1,1,0,0
2022-02-23,Hue City,Phu Vang,7,2,2,0,0
2022-02-23,Hue City,Phu Vang,8,1,1,0,0
2022-02-23,Hue City,Phu Vang,10,2,2,0,0
2022-02-23,Hue City,Phu Vang,11,3,2,1,0
2022-02-23,Hue City,Phu Vang,12,4,3,1,0
2022-02-23,Hue City,Phu Vang,13,2,1,1,0
2022-02-23,Hue City,Phu Vang,15,1,1,0,0
2022-02-23,Hue City,Phu Vang,16,1,1,0,0
2022-02-23,Hue City,Phu Vang,17,4,3,1,0
2022-02-23,Hue City,Phu Vang,18,3,2,1,0
2022-02-23,Hue City,Phu Vang,19,1,1,0,0
2022-02-23,Hue City,Phu Vang,21,3,2,1,1
2022-02-23,Vung Tau,Ba Ria City,6,1,0,1,1
2022-02-23,Vung Tau,Ba Ria City,8,2,0,2,0
2022-02-23,Vung Tau,Ba Ria City,9,8,5,3,2
2022-02-23,Vung Tau,Ba Ria City,10,5,4,1,1
2022-02-23,Vung Tau,Ba Ria City,11,5,2,3,2
2022-02-23,Vung Tau,Ba Ria City,12,4,3,1,1
2022-02-23,Vung Tau,Ba Ria City,13,2,2,0,0
2022-02-23,Vung Tau,Ba Ria City,14,5,3,2,1
2022-02-23,Vung Tau,Ba Ria City,16,4,2,2,2
2022-02-23,Vung Tau,Ba Ria City,17,7,2,5,5
2022-02-23,Vung Tau,Ba Ria City,18,6,4,2,2
2022-02-23,Vung Tau,Ba Ria City,19,3,2,1,1
2022-02-23,Vung Tau,Ba Ria City,20,6,2,4,2
2022-02-23,Vung Tau,Ba Ria City,21,3,1,2,1
2022-02-23,Vung Tau,Tan Thanh,18,1,0,1,1
2022-02-23,Vung Tau,Vung Tau City,6,36,33,3,0
2022-02-23,Vung Tau,Vung Tau City,7,97,88,9,0
2022-02-23,Vung Tau,Vung Tau City,8,144,134,10,0
2022-02-23,Vung Tau,Vung Tau City,9,134,120,14,0
2022-02-23,Vung Tau,Vung Tau City,10,151,137,14,1
2022-02-23,Vung Tau,Vung Tau City,11,288,266,22,1
2022-02-23,Vung Tau,Vung Tau City,12,218,209,9,0
2022-02-23,Vung Tau,Vung Tau City,13,180,170,10,0
2022-02-23,Vung Tau,Vung Tau City,14,203,188,15,0
2022-02-23,Vung Tau,Vung Tau City,15,190,179,11,1
2022-02-23,Vung Tau,Vung Tau City,16,169,162,7,0
2022-02-23,Vung Tau,Vung Tau City,17,202,186,16,0
2022-02-23,Vung Tau,Vung Tau City,18,276,258,18,1
2022-02-23,Vung Tau,Vung Tau City,19,214,192,22,2
2022-02-23,Vung Tau,Vung Tau City,20,150,135,15,4
2022-02-23,Vung Tau,Vung Tau City,21,82,65,17,3
2022-02-23,Vung Tau,Vung Tau City,22,1,1,0,0
2022-02-23,Vung Tau,Vung Tau City,23,2,1,1,0
2022-02-24,Binh Duong,Ben Cat,11,2,0,2,2
2022-02-24,Binh Duong,Ben Cat,16,1,0,1,0
2022-02-24,Binh Duong,Ben Cat,19,2,0,2,2
2022-02-24,Binh Duong,Ben Cat,20,1,0,1,1
2022-02-24,Binh Duong,Di An,7,3,1,2,2
2022-02-24,Binh Duong,Di An,8,11,2,9,6
2022-02-24,Binh Duong,Di An,9,8,5,3,2
2022-02-24,Binh Duong,Di An,10,17,13,4,3
2022-02-24,Binh Duong,Di An,11,30,14,16,12
2022-02-24,Binh Duong,Di An,12,36,12,24,17
2022-02-24,Binh Duong,Di An,13,18,8,10,10
2022-02-24,Binh Duong,Di An,14,19,13,6,5
2022-02-24,Binh Duong,Di An,15,9,4,5,4
2022-02-24,Binh Duong,Di An,16,15,8,7,7
2022-02-24,Binh Duong,Di An,17,16,7,9,5
2022-02-24,Binh Duong,Di An,18,16,9,7,4
2022-02-24,Binh Duong,Di An,19,9,4,5,4
2022-02-24,Binh Duong,Di An,20,5,2,3,2
2022-02-24,Binh Duong,Di An,21,7,0,7,7
2022-02-24,Binh Duong,Tan Uyen,8,1,0,1,1
2022-02-24,Binh Duong,Tan Uyen,10,1,1,0,0
2022-02-24,Binh Duong,Tan Uyen,11,3,1,2,2
2022-02-24,Binh Duong,Tan Uyen,12,3,1,2,2
2022-02-24,Binh Duong,Tan Uyen,18,4,2,2,1
2022-02-24,Binh Duong,Tan Uyen,19,1,0,1,1
2022-02-24,Binh Duong,Tan Uyen,20,1,0,1,1
2022-02-24,Binh Duong,Thu Dau Mot Town,5,2,0,2,1
2022-02-24,Binh Duong,Thu Dau Mot Town,6,30,19,11,7
2022-02-24,Binh Duong,Thu Dau Mot Town,7,96,90,6,1
2022-02-24,Binh Duong,Thu Dau Mot Town,8,146,138,8,2
2022-02-24,Binh Duong,Thu Dau Mot Town,9,198,187,11,2
2022-02-24,Binh Duong,Thu Dau Mot Town,10,289,269,20,3
2022-02-24,Binh Duong,Thu Dau Mot Town,11,564,514,50,10
2022-02-24,Binh Duong,Thu Dau Mot Town,12,335,319,16,2
2022-02-24,Binh Duong,Thu Dau Mot Town,13,319,303,16,2
2022-02-24,Binh Duong,Thu Dau Mot Town,14,256,243,13,3
2022-02-24,Binh Duong,Thu Dau Mot Town,15,199,184,15,2
2022-02-24,Binh Duong,Thu Dau Mot Town,16,232,227,5,1
2022-02-24,Binh Duong,Thu Dau Mot Town,17,301,279,22,4
2022-02-24,Binh Duong,Thu Dau Mot Town,18,304,281,23,6
2022-02-24,Binh Duong,Thu Dau Mot Town,19,257,237,20,1
2022-02-24,Binh Duong,Thu Dau Mot Town,20,185,165,20,2
2022-02-24,Binh Duong,Thu Dau Mot Town,21,82,65,17,3
2022-02-24,Binh Duong,Thu Dau Mot Town,23,1,1,0,0
2022-02-24,Binh Duong,Thuan An,0,1,0,1,0
2022-02-24,Binh Duong,Thuan An,7,12,2,10,9
2022-02-24,Binh Duong,Thuan An,8,10,4,6,4
2022-02-24,Binh Duong,Thuan An,9,55,21,34,30
2022-02-24,Binh Duong,Thuan An,10,54,30,24,17
2022-02-24,Binh Duong,Thuan An,11,54,37,17,11
2022-02-24,Binh Duong,Thuan An,12,64,38,26,20
2022-02-24,Binh Duong,Thuan An,13,52,25,27,23
2022-02-24,Binh Duong,Thuan An,14,36,21,15,12
2022-02-24,Binh Duong,Thuan An,15,41,22,19,14
2022-02-24,Binh Duong,Thuan An,16,36,16,20,19
2022-02-24,Binh Duong,Thuan An,17,45,29,16,15
2022-02-24,Binh Duong,Thuan An,18,42,30,12,6
2022-02-24,Binh Duong,Thuan An,19,25,17,8,7
2022-02-24,Binh Duong,Thuan An,20,18,13,5,5
2022-02-24,Binh Duong,Thuan An,21,12,6,6,3
2022-02-24,Can Tho City,Binh Thuy District,8,3,2,1,0
2022-02-24,Can Tho City,Binh Thuy District,9,4,4,0,0
2022-02-24,Can Tho City,Binh Thuy District,10,9,7,2,0
2022-02-24,Can Tho City,Binh Thuy District,11,11,10,1,0
2022-02-24,Can Tho City,Binh Thuy District,12,10,8,2,1
2022-02-24,Can Tho City,Binh Thuy District,13,9,8,1,0
2022-02-24,Can Tho City,Binh Thuy District,14,5,5,0,0
2022-02-24,Can Tho City,Binh Thuy District,15,7,6,1,0
2022-02-24,Can Tho City,Binh Thuy District,16,6,6,0,0
2022-02-24,Can Tho City,Binh Thuy District,17,11,11,0,0
2022-02-24,Can Tho City,Binh Thuy District,18,11,9,2,1
2022-02-24,Can Tho City,Binh Thuy District,19,9,9,0,0
2022-02-24,Can Tho City,Binh Thuy District,20,4,4,0,0
2022-02-24,Can Tho City,Binh Thuy District,21,5,4,1,0
2022-02-24,Can Tho City,Cai Rang District,7,2,2,0,0
2022-02-24,Can Tho City,Cai Rang District,8,6,5,1,0
2022-02-24,Can Tho City,Cai Rang District,9,3,3,0,0
2022-02-24,Can Tho City,Cai Rang District,10,6,6,0,0
2022-02-24,Can Tho City,Cai Rang District,11,15,14,1,0
2022-02-24,Can Tho City,Cai Rang District,12,5,4,1,0
2022-02-24,Can Tho City,Cai Rang District,13,7,7,0,0
2022-02-24,Can Tho City,Cai Rang District,14,6,6,0,0
2022-02-24,Can Tho City,Cai Rang District,15,7,7,0,0
2022-02-24,Can Tho City,Cai Rang District,16,8,7,1,0
2022-02-24,Can Tho City,Cai Rang District,17,10,9,1,0
2022-02-24,Can Tho City,Cai Rang District,18,11,10,1,0
2022-02-24,Can Tho City,Cai Rang District,19,12,10,2,0
2022-02-24,Can Tho City,Cai Rang District,20,7,7,0,0
2022-02-24,Can Tho City,Cai Rang District,21,3,1,2,1
2022-02-24,Can Tho City,Ninh Kieu District,0,1,1,0,0
2022-02-24,Can Tho City,Ninh Kieu District,4,1,0,1,0
2022-02-24,Can Tho City,Ninh Kieu District,5,2,2,0,0
2022-02-24,Can Tho City,Ninh Kieu District,6,47,44,3,0
2022-02-24,Can Tho City,Ninh Kieu District,7,118,108,10,0
2022-02-24,Can Tho City,Ninh Kieu District,8,187,177,10,0
2022-02-24,Can Tho City,Ninh Kieu District,9,235,222,13,0
2022-02-24,Can Tho City,Ninh Kieu District,10,498,477,21,0
2022-02-24,Can Tho City,Ninh Kieu District,11,693,656,37,7
2022-02-24,Can Tho City,Ninh Kieu District,12,454,435,19,0
2022-02-24,Can Tho City,Ninh Kieu District,13,345,337,8,0
2022-02-24,Can Tho City,Ninh Kieu District,14,313,297,16,0
2022-02-24,Can Tho City,Ninh Kieu District,15,240,224,16,0
2022-02-24,Can Tho City,Ninh Kieu District,16,317,304,13,0
2022-02-24,Can Tho City,Ninh Kieu District,17,393,377,16,0
2022-02-24,Can Tho City,Ninh Kieu District,18,424,405,19,0
2022-02-24,Can Tho City,Ninh Kieu District,19,332,313,19,0
2022-02-24,Can Tho City,Ninh Kieu District,20,290,259,31,1
2022-02-24,Can Tho City,Ninh Kieu District,21,172,156,16,1
2022-02-24,Can Tho City,Ninh Kieu District,22,4,3,1,0
2022-02-24,Can Tho City,Ninh Kieu District,23,1,1,0,0
2022-02-24,Dong Nai,Bien Hoa City,0,1,0,1,0
2022-02-24,Dong Nai,Bien Hoa City,1,2,2,0,0
2022-02-24,Dong Nai,Bien Hoa City,2,2,1,1,0
2022-02-24,Dong Nai,Bien Hoa City,3,1,1,0,0
2022-02-24,Dong Nai,Bien Hoa City,5,1,1,0,0
2022-02-24,Dong Nai,Bien Hoa City,6,42,16,26,18
2022-02-24,Dong Nai,Bien Hoa City,7,150,125,25,16
2022-02-24,Dong Nai,Bien Hoa City,8,229,202,27,8
2022-02-24,Dong Nai,Bien Hoa City,9,322,290,32,5
2022-02-24,Dong Nai,Bien Hoa City,10,580,513,67,10
2022-02-24,Dong Nai,Bien Hoa City,11,901,821,80,19
2022-02-24,Dong Nai,Bien Hoa City,12,675,616,59,14
2022-02-24,Dong Nai,Bien Hoa City,13,664,623,41,8
2022-02-24,Dong Nai,Bien Hoa City,14,511,481,30,8
2022-02-24,Dong Nai,Bien Hoa City,15,414,371,43,7
2022-02-24,Dong Nai,Bien Hoa City,16,459,417,42,14
2022-02-24,Dong Nai,Bien Hoa City,17,461,427,34,6
2022-02-24,Dong Nai,Bien Hoa City,18,594,541,53,12
2022-02-24,Dong Nai,Bien Hoa City,19,509,453,56,18
2022-02-24,Dong Nai,Bien Hoa City,20,408,336,72,23
2022-02-24,Dong Nai,Bien Hoa City,21,208,131,77,41
2022-02-24,Dong Nai,Bien Hoa City,22,5,3,2,0
2022-02-24,Dong Nai,Bien Hoa City,23,1,0,1,0
2022-02-24,Dong Nai,Cam My,12,1,0,1,1
2022-02-24,Dong Nai,Long Khanh,18,2,0,2,2
2022-02-24,Dong Nai,Long Thanh,11,5,0,5,5
2022-02-24,Dong Nai,Long Thanh,12,4,0,4,4
2022-02-24,Dong Nai,Long Thanh,14,1,0,1,1
2022-02-24,Dong Nai,Long Thanh,15,1,0,1,1
2022-02-24,Dong Nai,Long Thanh,16,1,0,1,1
2022-02-24,Dong Nai,Long Thanh,17,2,0,2,2
2022-02-24,Dong Nai,Long Thanh,20,1,0,1,0
2022-02-24,Dong Nai,Thong Nhat,8,1,1,0,0
2022-02-24,Dong Nai,Thong Nhat,9,1,1,0,0
2022-02-24,Dong Nai,Thong Nhat,11,3,2,1,0
2022-02-24,Dong Nai,Thong Nhat,12,1,1,0,0
2022-02-24,Dong Nai,Thong Nhat,13,2,2,0,0
2022-02-24,Dong Nai,Thong Nhat,17,1,1,0,0
2022-02-24,Dong Nai,Thong Nhat,18,1,1,0,0
2022-02-24,Dong Nai,Thong Nhat,22,1,0,1,0
2022-02-24,Dong Nai,Trang Bom,10,1,1,0,0
2022-02-24,Dong Nai,Trang Bom,11,1,1,0,0
2022-02-24,Dong Nai,Trang Bom,12,1,0,1,1
2022-02-24,Dong Nai,Trang Bom,13,3,0,3,3
2022-02-24,Dong Nai,Trang Bom,16,1,0,1,1
2022-02-24,Dong Nai,Trang Bom,17,2,1,1,1
2022-02-24,Dong Nai,Trang Bom,21,1,0,1,1
2022-02-24,Hai Phong City,An Duong,7,2,0,2,1
2022-02-24,Hai Phong City,An Duong,8,6,3,3,2
2022-02-24,Hai Phong City,An Duong,9,4,1,3,3
2022-02-24,Hai Phong City,An Duong,10,4,3,1,1
2022-02-24,Hai Phong City,An Duong,11,5,4,1,1
2022-02-24,Hai Phong City,An Duong,12,3,3,0,0
2022-02-24,Hai Phong City,An Duong,13,9,2,7,6
2022-02-24,Hai Phong City,An Duong,14,5,3,2,2
2022-02-24,Hai Phong City,An Duong,15,12,3,9,4
2022-02-24,Hai Phong City,An Duong,16,13,6,7,3
2022-02-24,Hai Phong City,An Duong,17,7,0,7,3
2022-02-24,Hai Phong City,An Duong,18,5,2,3,1
2022-02-24,Hai Phong City,An Duong,19,2,1,1,1
2022-02-24,Hai Phong City,An Duong,20,3,0,3,1
2022-02-24,Hai Phong City,An Duong,21,3,0,3,1
2022-02-24,Hai Phong City,Do Son District,14,1,0,1,1
2022-02-24,Hai Phong City,Duong Kinh District,10,1,0,1,1
2022-02-24,Hai Phong City,Duong Kinh District,14,1,0,1,1
2022-02-24,Hai Phong City,Duong Kinh District,15,1,0,1,1
2022-02-24,Hai Phong City,Hai An District,2,1,0,1,1
2022-02-24,Hai Phong City,Hai An District,7,11,7,4,4
2022-02-24,Hai Phong City,Hai An District,8,15,10,5,2
2022-02-24,Hai Phong City,Hai An District,9,17,13,4,0
2022-02-24,Hai Phong City,Hai An District,10,26,22,4,1
2022-02-24,Hai Phong City,Hai An District,11,37,30,7,3
2022-02-24,Hai Phong City,Hai An District,12,17,15,2,0
2022-02-24,Hai Phong City,Hai An District,13,17,16,1,0
2022-02-24,Hai Phong City,Hai An District,14,15,10,5,2
2022-02-24,Hai Phong City,Hai An District,15,19,11,8,1
2022-02-24,Hai Phong City,Hai An District,16,21,17,4,1
2022-02-24,Hai Phong City,Hai An District,17,26,20,6,1
2022-02-24,Hai Phong City,Hai An District,18,35,28,7,0
2022-02-24,Hai Phong City,Hai An District,19,15,15,0,0
2022-02-24,Hai Phong City,Hai An District,20,18,14,4,1
2022-02-24,Hai Phong City,Hai An District,21,4,1,3,1
2022-02-24,Hai Phong City,Hong Bang District,0,1,1,0,0
2022-02-24,Hai Phong City,Hong Bang District,4,1,1,0,0
2022-02-24,Hai Phong City,Hong Bang District,5,1,0,1,1
2022-02-24,Hai Phong City,Hong Bang District,6,1,0,1,0
2022-02-24,Hai Phong City,Hong Bang District,7,19,13,6,4
2022-02-24,Hai Phong City,Hong Bang District,8,36,30,6,5
2022-02-24,Hai Phong City,Hong Bang District,9,34,30,4,0
2022-02-24,Hai Phong City,Hong Bang District,10,74,65,9,4
2022-02-24,Hai Phong City,Hong Bang District,11,101,84,17,9
2022-02-24,Hai Phong City,Hong Bang District,12,38,31,7,4
2022-02-24,Hai Phong City,Hong Bang District,13,31,27,4,1
2022-02-24,Hai Phong City,Hong Bang District,14,37,31,6,2
2022-02-24,Hai Phong City,Hong Bang District,15,62,48,14,6
2022-02-24,Hai Phong City,Hong Bang District,16,51,46,5,0
2022-02-24,Hai Phong City,Hong Bang District,17,65,54,11,1
2022-02-24,Hai Phong City,Hong Bang District,18,76,61,15,7
2022-02-24,Hai Phong City,Hong Bang District,19,44,32,12,0
2022-02-24,Hai Phong City,Hong Bang District,20,38,28,10,5
2022-02-24,Hai Phong City,Hong Bang District,21,8,5,3,1
2022-02-24,Hai Phong City,Kien An District,6,2,0,2,0
2022-02-24,Hai Phong City,Kien An District,7,3,0,3,2
2022-02-24,Hai Phong City,Kien An District,8,4,2,2,1
2022-02-24,Hai Phong City,Kien An District,9,10,10,0,0
2022-02-24,Hai Phong City,Kien An District,10,6,4,2,0
2022-02-24,Hai Phong City,Kien An District,11,10,8,2,2
2022-02-24,Hai Phong City,Kien An District,12,3,2,1,0
2022-02-24,Hai Phong City,Kien An District,13,13,7,6,5
2022-02-24,Hai Phong City,Kien An District,14,13,9,4,1
2022-02-24,Hai Phong City,Kien An District,15,9,8,1,0
2022-02-24,Hai Phong City,Kien An District,16,8,6,2,1
2022-02-24,Hai Phong City,Kien An District,17,14,8,6,1
2022-02-24,Hai Phong City,Kien An District,18,8,8,0,0
2022-02-24,Hai Phong City,Kien An District,19,13,9,4,4
2022-02-24,Hai Phong City,Kien An District,20,6,4,2,1
2022-02-24,Hai Phong City,Kien An District,21,4,1,3,1
2022-02-24,Hai Phong City,Le Chan District,0,2,1,1,0
2022-02-24,Hai Phong City,Le Chan District,1,1,0,1,0
2022-02-24,Hai Phong City,Le Chan District,2,1,0,1,0
2022-02-24,Hai Phong City,Le Chan District,5,2,1,1,0
2022-02-24,Hai Phong City,Le Chan District,6,5,2,3,1
2022-02-24,Hai Phong City,Le Chan District,7,61,40,21,9
2022-02-24,Hai Phong City,Le Chan District,8,83,62,21,8
2022-02-24,Hai Phong City,Le Chan District,9,77,64,13,4
2022-02-24,Hai Phong City,Le Chan District,10,185,153,32,3
2022-02-24,Hai Phong City,Le Chan District,11,313,247,66,25
2022-02-24,Hai Phong City,Le Chan District,12,184,156,28,9
2022-02-24,Hai Phong City,Le Chan District,13,132,112,20,5
2022-02-24,Hai Phong City,Le Chan District,14,189,147,42,13
2022-02-24,Hai Phong City,Le Chan District,15,233,183,50,21
2022-02-24,Hai Phong City,Le Chan District,16,238,189,49,7
2022-02-24,Hai Phong City,Le Chan District,17,258,224,34,4
2022-02-24,Hai Phong City,Le Chan District,18,274,218,56,19
2022-02-24,Hai Phong City,Le Chan District,19,186,157,29,9
2022-02-24,Hai Phong City,Le Chan District,20,140,113,27,10
2022-02-24,Hai Phong City,Le Chan District,21,69,45,24,5
2022-02-24,Hai Phong City,Le Chan District,22,1,0,1,1
2022-02-24,Hai Phong City,Le Chan District,23,2,1,1,0
2022-02-24,Hai Phong City,Ngo Quyen District,3,1,0,1,0
2022-02-24,Hai Phong City,Ngo Quyen District,4,3,3,0,0
2022-02-24,Hai Phong City,Ngo Quyen District,6,3,2,1,0
2022-02-24,Hai Phong City,Ngo Quyen District,7,46,27,19,16
2022-02-24,Hai Phong City,Ngo Quyen District,8,88,71,17,7
2022-02-24,Hai Phong City,Ngo Quyen District,9,65,58,7,0
2022-02-24,Hai Phong City,Ngo Quyen District,10,139,115,24,3
2022-02-24,Hai Phong City,Ngo Quyen District,11,225,197,28,14
2022-02-24,Hai Phong City,Ngo Quyen District,12,125,113,12,4
2022-02-24,Hai Phong City,Ngo Quyen District,13,92,83,9,1
2022-02-24,Hai Phong City,Ngo Quyen District,14,128,112,16,5
2022-02-24,Hai Phong City,Ngo Quyen District,15,162,136,26,6
2022-02-24,Hai Phong City,Ngo Quyen District,16,136,124,12,1
2022-02-24,Hai Phong City,Ngo Quyen District,17,152,128,24,6
2022-02-24,Hai Phong City,Ngo Quyen District,18,198,157,41,14
2022-02-24,Hai Phong City,Ngo Quyen District,19,169,140,29,12
2022-02-24,Hai Phong City,Ngo Quyen District,20,110,92,18,5
2022-02-24,Hai Phong City,Ngo Quyen District,21,60,41,19,7
2022-02-24,Hai Phong City,Ngo Quyen District,22,1,0,1,0
2022-02-24,Hai Phong City,Ngo Quyen District,23,1,1,0,0
2022-02-24,Hai Phong City,Thuy Nguyen,9,1,0,1,0
2022-02-24,Hai Phong City,Thuy Nguyen,10,2,0,2,2
2022-02-24,Hai Phong City,Thuy Nguyen,11,1,1,0,0
2022-02-24,Hai Phong City,Thuy Nguyen,15,8,0,8,7
2022-02-24,Hai Phong City,Thuy Nguyen,16,1,0,1,1
2022-02-24,Hai Phong City,Thuy Nguyen,17,3,1,2,2
2022-02-24,Hai Phong City,Thuy Nguyen,19,1,0,1,1
2022-02-24,Hue City,Hue City,0,7,6,1,0
2022-02-24,Hue City,Hue City,1,1,1,0,0
2022-02-24,Hue City,Hue City,2,2,2,0,0
2022-02-24,Hue City,Hue City,4,2,1,1,0
2022-02-24,Hue City,Hue City,5,1,1,0,0
2022-02-24,Hue City,Hue City,6,51,48,3,1
2022-02-24,Hue City,Hue City,7,162,147,15,0
2022-02-24,Hue City,Hue City,8,295,265,30,0
2022-02-24,Hue City,Hue City,9,264,233,31,3
2022-02-24,Hue City,Hue City,10,335,314,21,0
2022-02-24,Hue City,Hue City,11,709,661,48,3
2022-02-24,Hue City,Hue City,12,382,366,16,0
2022-02-24,Hue City,Hue City,13,274,258,16,0
2022-02-24,Hue City,Hue City,14,267,247,20,3
2022-02-24,Hue City,Hue City,15,369,352,17,0
2022-02-24,Hue City,Hue City,16,398,379,19,1
2022-02-24,Hue City,Hue City,17,579,524,55,1
2022-02-24,Hue City,Hue City,18,603,547,56,5
2022-02-24,Hue City,Hue City,19,526,467,59,9
2022-02-24,Hue City,Hue City,20,362,323,39,6
2022-02-24,Hue City,Hue City,21,213,164,49,17
2022-02-24,Hue City,Hue City,22,6,3,3,2
2022-02-24,Hue City,Hue City,23,3,2,1,0
2022-02-24,Hue City,Huong Thuy,9,1,0,1,0
2022-02-24,Hue City,Huong Thuy,10,4,1,3,3
2022-02-24,Hue City,Huong Thuy,11,1,0,1,1
2022-02-24,Hue City,Huong Thuy,12,4,3,1,1
2022-02-24,Hue City,Huong Thuy,13,1,0,1,1
2022-02-24,Hue City,Huong Thuy,16,1,0,1,0
2022-02-24,Hue City,Huong Thuy,19,2,1,1,1
2022-02-24,Hue City,Huong Thuy,20,2,1,1,0
2022-02-24,Hue City,Huong Tra,8,1,0,1,0
2022-02-24,Hue City,Huong Tra,10,1,1,0,0
2022-02-24,Hue City,Huong Tra,19,1,0,1,0
2022-02-24,Hue City,Phu Vang,7,1,1,0,0
2022-02-24,Hue City,Phu Vang,8,1,1,0,0
2022-02-24,Hue City,Phu Vang,11,2,2,0,0
2022-02-24,Hue City,Phu Vang,12,1,1,0,0
2022-02-24,Hue City,Phu Vang,13,2,2,0,0
2022-02-24,Hue City,Phu Vang,14,4,1,3,3
2022-02-24,Hue City,Phu Vang,15,2,2,0,0
2022-02-24,Hue City,Phu Vang,16,1,0,1,1
2022-02-24,Hue City,Phu Vang,17,3,2,1,0
2022-02-24,Hue City,Phu Vang,18,5,4,1,1
2022-02-24,Hue City,Phu Vang,20,2,2,0,0
2022-02-24,Vung Tau,Ba Ria City,8,2,1,1,0
2022-02-24,Vung Tau,Ba Ria City,9,3,1,2,1
2022-02-24,Vung Tau,Ba Ria City,10,9,7,2,1
2022-02-24,Vung Tau,Ba Ria City,11,14,11,3,3
2022-02-24,Vung Tau,Ba Ria City,12,8,3,5,3
2022-02-24,Vung Tau,Ba Ria City,13,2,1,1,0
2022-02-24,Vung Tau,Ba Ria City,14,9,6,3,2
2022-02-24,Vung Tau,Ba Ria City,15,4,2,2,1
2022-02-24,Vung Tau,Ba Ria City,16,2,1,1,1
2022-02-24,Vung Tau,Ba Ria City,17,2,2,0,0
2022-02-24,Vung Tau,Ba Ria City,18,1,1,0,0
2022-02-24,Vung Tau,Ba Ria City,19,6,3,3,2
2022-02-24,Vung Tau,Ba Ria City,20,3,1,2,2
2022-02-24,Vung Tau,Ba Ria City,21,1,0,1,1
2022-02-24,Vung Tau,Tan Thanh,9,1,0,1,1
2022-02-24,Vung Tau,Vung Tau City,4,1,0,1,0
2022-02-24,Vung Tau,Vung Tau City,5,2,2,0,0
2022-02-24,Vung Tau,Vung Tau City,6,28,24,4,0
2022-02-24,Vung Tau,Vung Tau City,7,93,80,13,4
2022-02-24,Vung Tau,Vung Tau City,8,144,124,20,0
2022-02-24,Vung Tau,Vung Tau City,9,94,91,3,1
2022-02-24,Vung Tau,Vung Tau City,10,160,153,7,0
2022-02-24,Vung Tau,Vung Tau City,11,305,281,24,3
2022-02-24,Vung Tau,Vung Tau City,12,213,197,16,0
2022-02-24,Vung Tau,Vung Tau City,13,164,152,12,2
2022-02-24,Vung Tau,Vung Tau City,14,177,166,11,1
2022-02-24,Vung Tau,Vung Tau City,15,195,186,9,0
2022-02-24,Vung Tau,Vung Tau City,16,167,157,10,0
2022-02-24,Vung Tau,Vung Tau City,17,190,184,6,0
2022-02-24,Vung Tau,Vung Tau City,18,268,252,16,0
2022-02-24,Vung Tau,Vung Tau City,19,196,187,9,2
2022-02-24,Vung Tau,Vung Tau City,20,142,131,11,1
2022-02-24,Vung Tau,Vung Tau City,21,78,58,20,12
2022-02-24,Vung Tau,Vung Tau City,22,2,1,1,0
2022-02-25,Binh Duong,Ben Cat,17,1,0,1,1
2022-02-25,Binh Duong,Ben Cat,18,1,0,1,1
2022-02-25,Binh Duong,Di An,7,14,0,14,11
2022-02-25,Binh Duong,Di An,8,15,5,10,10
2022-02-25,Binh Duong,Di An,9,12,8,4,4
2022-02-25,Binh Duong,Di An,10,19,8,11,9
2022-02-25,Binh Duong,Di An,11,33,12,21,17
2022-02-25,Binh Duong,Di An,12,43,13,30,25
2022-02-25,Binh Duong,Di An,13,21,12,9,6
2022-02-25,Binh Duong,Di An,14,12,8,4,4
2022-02-25,Binh Duong,Di An,15,13,2,11,10
2022-02-25,Binh Duong,Di An,16,9,6,3,3
2022-02-25,Binh Duong,Di An,17,11,7,4,2
2022-02-25,Binh Duong,Di An,18,13,7,6,4
2022-02-25,Binh Duong,Di An,19,11,3,8,4
2022-02-25,Binh Duong,Di An,20,10,1,9,7
2022-02-25,Binh Duong,Di An,21,7,1,6,5
2022-02-25,Binh Duong,Tan Uyen,8,1,0,1,1
2022-02-25,Binh Duong,Tan Uyen,9,1,1,0,0
2022-02-25,Binh Duong,Tan Uyen,10,1,1,0,0
2022-02-25,Binh Duong,Tan Uyen,11,2,1,1,0
2022-02-25,Binh Duong,Tan Uyen,12,4,0,4,3
2022-02-25,Binh Duong,Tan Uyen,13,1,0,1,1
2022-02-25,Binh Duong,Tan Uyen,17,1,0,1,0
2022-02-25,Binh Duong,Tan Uyen,18,2,2,0,0
2022-02-25,Binh Duong,Tan Uyen,19,1,1,0,0
2022-02-25,Binh Duong,Thu Dau Mot Town,0,1,1,0,0
2022-02-25,Binh Duong,Thu Dau Mot Town,1,3,1,2,0
2022-02-25,Binh Duong,Thu Dau Mot Town,5,1,1,0,0
2022-02-25,Binh Duong,Thu Dau Mot Town,6,22,15,7,7
2022-02-25,Binh Duong,Thu Dau Mot Town,7,86,78,8,3
2022-02-25,Binh Duong,Thu Dau Mot Town,8,176,161,15,3
2022-02-25,Binh Duong,Thu Dau Mot Town,9,202,186,16,7
2022-02-25,Binh Duong,Thu Dau Mot Town,10,351,321,30,4
2022-02-25,Binh Duong,Thu Dau Mot Town,11,545,510,35,5
2022-02-25,Binh Duong,Thu Dau Mot Town,12,374,360,14,1
2022-02-25,Binh Duong,Thu Dau Mot Town,13,306,287,19,5
2022-02-25,Binh Duong,Thu Dau Mot Town,14,255,234,21,3
2022-02-25,Binh Duong,Thu Dau Mot Town,15,256,237,19,0
2022-02-25,Binh Duong,Thu Dau Mot Town,16,238,223,15,2
2022-02-25,Binh Duong,Thu Dau Mot Town,17,325,302,23,5
2022-02-25,Binh Duong,Thu Dau Mot Town,18,345,309,36,9
2022-02-25,Binh Duong,Thu Dau Mot Town,19,270,240,30,13
2022-02-25,Binh Duong,Thu Dau Mot Town,20,196,174,22,4
2022-02-25,Binh Duong,Thu Dau Mot Town,21,68,61,7,1
2022-02-25,Binh Duong,Thu Dau Mot Town,22,3,1,2,0
2022-02-25,Binh Duong,Thu Dau Mot Town,23,1,0,1,0
2022-02-25,Binh Duong,Thuan An,6,1,0,1,1
2022-02-25,Binh Duong,Thuan An,7,5,1,4,2
2022-02-25,Binh Duong,Thuan An,8,18,8,10,8
2022-02-25,Binh Duong,Thuan An,9,37,13,24,17
2022-02-25,Binh Duong,Thuan An,10,44,26,18,10
2022-02-25,Binh Duong,Thuan An,11,60,28,32,28
2022-02-25,Binh Duong,Thuan An,12,47,22,25,22
2022-02-25,Binh Duong,Thuan An,13,49,28,21,19
2022-02-25,Binh Duong,Thuan An,14,52,23,29,23
2022-02-25,Binh Duong,Thuan An,15,42,20,22,18
2022-02-25,Binh Duong,Thuan An,16,34,13,21,17
2022-02-25,Binh Duong,Thuan An,17,34,16,18,12
2022-02-25,Binh Duong,Thuan An,18,42,26,16,14
2022-02-25,Binh Duong,Thuan An,19,36,24,12,8
2022-02-25,Binh Duong,Thuan An,20,31,15,16,11
2022-02-25,Binh Duong,Thuan An,21,10,5,5,5
2022-02-25,Binh Duong,Thuan An,22,2,0,2,0
2022-02-25,Can Tho City,Binh Thuy District,6,3,1,2,0
2022-02-25,Can Tho City,Binh Thuy District,7,1,0,1,0
2022-02-25,Can Tho City,Binh Thuy District,8,2,0,2,1
2022-02-25,Can Tho City,Binh Thuy District,9,3,3,0,0
2022-02-25,Can Tho City,Binh Thuy District,10,4,2,2,0
2022-02-25,Can Tho City,Binh Thuy District,11,13,13,0,0
2022-02-25,Can Tho City,Binh Thuy District,12,13,12,1,1
2022-02-25,Can Tho City,Binh Thuy District,13,4,4,0,0
2022-02-25,Can Tho City,Binh Thuy District,14,10,10,0,0
2022-02-25,Can Tho City,Binh Thuy District,15,8,8,0,0
2022-02-25,Can Tho City,Binh Thuy District,16,8,8,0,0
2022-02-25,Can Tho City,Binh Thuy District,17,11,10,1,0
2022-02-25,Can Tho City,Binh Thuy District,18,14,13,1,0
2022-02-25,Can Tho City,Binh Thuy District,19,9,8,1,0
2022-02-25,Can Tho City,Binh Thuy District,20,4,2,2,0
2022-02-25,Can Tho City,Binh Thuy District,21,4,3,1,0
2022-02-25,Can Tho City,Cai Rang District,6,1,1,0,0
2022-02-25,Can Tho City,Cai Rang District,7,2,2,0,0
2022-02-25,Can Tho City,Cai Rang District,8,1,1,0,0
2022-02-25,Can Tho City,Cai Rang District,9,2,1,1,0
2022-02-25,Can Tho City,Cai Rang District,10,5,4,1,0
2022-02-25,Can Tho City,Cai Rang District,11,12,10,2,0
2022-02-25,Can Tho City,Cai Rang District,12,9,9,0,0
2022-02-25,Can Tho City,Cai Rang District,13,8,7,1,0
2022-02-25,Can Tho City,Cai Rang District,14,8,3,5,4
2022-02-25,Can Tho City,Cai Rang District,15,4,4,0,0
2022-02-25,Can Tho City,Cai Rang District,16,10,9,1,0
2022-02-25,Can Tho City,Cai Rang District,17,4,4,0,0
2022-02-25,Can Tho City,Cai Rang District,18,13,9,4,0
2022-02-25,Can Tho City,Cai Rang District,19,8,6,2,0
2022-02-25,Can Tho City,Cai Rang District,20,8,6,2,0
2022-02-25,Can Tho City,Cai Rang District,21,3,3,0,0
2022-02-25,Can Tho City,Cai Rang District,22,1,1,0,0
2022-02-25,Can Tho City,Ninh Kieu District,0,5,4,1,0
2022-02-25,Can Tho City,Ninh Kieu District,1,2,2,0,0
2022-02-25,Can Tho City,Ninh Kieu District,3,1,1,0,0
2022-02-25,Can Tho City,Ninh Kieu District,5,2,1,1,0
2022-02-25,Can Tho City,Ninh Kieu District,6,37,32,5,0
2022-02-25,Can Tho City,Ninh Kieu District,7,128,118,10,0
2022-02-25,Can Tho City,Ninh Kieu District,8,182,172,10,1
2022-02-25,Can Tho City,Ninh Kieu District,9,242,226,16,0
2022-02-25,Can Tho City,Ninh Kieu District,10,463,449,14,0
2022-02-25,Can Tho City,Ninh Kieu District,11,739,696,43,2
2022-02-25,Can Tho City,Ninh Kieu District,12,489,468,21,0
2022-02-25,Can Tho City,Ninh Kieu District,13,397,378,19,0
2022-02-25,Can Tho City,Ninh Kieu District,14,341,324,17,0
2022-02-25,Can Tho City,Ninh Kieu District,15,293,275,18,0
2022-02-25,Can Tho City,Ninh Kieu District,16,305,292,13,0
2022-02-25,Can Tho City,Ninh Kieu District,17,415,391,24,0
2022-02-25,Can Tho City,Ninh Kieu District,18,437,412,25,0
2022-02-25,Can Tho City,Ninh Kieu District,19,411,385,26,0
2022-02-25,Can Tho City,Ninh Kieu District,20,312,286,26,0
2022-02-25,Can Tho City,Ninh Kieu District,21,147,121,26,0
2022-02-25,Can Tho City,Ninh Kieu District,22,2,2,0,0
2022-02-25,Can Tho City,Ninh Kieu District,23,3,1,2,0
2022-02-25,Dong Nai,Bien Hoa City,0,10,3,7,2
2022-02-25,Dong Nai,Bien Hoa City,1,1,0,1,0
2022-02-25,Dong Nai,Bien Hoa City,3,1,0,1,0
2022-02-25,Dong Nai,Bien Hoa City,6,39,22,17,16
2022-02-25,Dong Nai,Bien Hoa City,7,146,122,24,16
2022-02-25,Dong Nai,Bien Hoa City,8,255,222,33,6
2022-02-25,Dong Nai,Bien Hoa City,9,342,316,26,7
2022-02-25,Dong Nai,Bien Hoa City,10,640,579,61,20
2022-02-25,Dong Nai,Bien Hoa City,11,950,841,109,26
2022-02-25,Dong Nai,Bien Hoa City,12,662,604,58,6
2022-02-25,Dong Nai,Bien Hoa City,13,634,581,53,10
2022-02-25,Dong Nai,Bien Hoa City,14,509,476,33,4
2022-02-25,Dong Nai,Bien Hoa City,15,409,374,35,6
2022-02-25,Dong Nai,Bien Hoa City,16,490,438,52,10
2022-02-25,Dong Nai,Bien Hoa City,17,555,475,80,25
2022-02-25,Dong Nai,Bien Hoa City,18,610,558,52,8
2022-02-25,Dong Nai,Bien Hoa City,19,615,542,73,23
2022-02-25,Dong Nai,Bien Hoa City,20,449,369,80,34
2022-02-25,Dong Nai,Bien Hoa City,21,219,141,78,35
2022-02-25,Dong Nai,Bien Hoa City,22,1,0,1,0
2022-02-25,Dong Nai,Bien Hoa City,23,1,1,0,0
2022-02-25,Dong Nai,Long Thanh,9,2,0,2,2
2022-02-25,Dong Nai,Long Thanh,10,1,0,1,1
2022-02-25,Dong Nai,Long Thanh,14,1,0,1,1
2022-02-25,Dong Nai,Long Thanh,20,2,0,2,2
2022-02-25,Dong Nai,Thong Nhat,9,3,3,0,0
2022-02-25,Dong Nai,Thong Nhat,10,2,2,0,0
2022-02-25,Dong Nai,Thong Nhat,12,1,1,0,0
2022-02-25,Dong Nai,Thong Nhat,13,3,3,0,0
2022-02-25,Dong Nai,Thong Nhat,14,1,1,0,0
2022-02-25,Dong Nai,Thong Nhat,17,1,1,0,0
2022-02-25,Dong Nai,Thong Nhat,18,3,3,0,0
2022-02-25,Dong Nai,Trang Bom,11,1,0,1,1
2022-02-25,Dong Nai,Trang Bom,12,5,0,5,5
2022-02-25,Dong Nai,Trang Bom,15,1,0,1,1
2022-02-25,Hai Phong City,An Duong,8,3,3,0,0
2022-02-25,Hai Phong City,An Duong,9,1,1,0,0
2022-02-25,Hai Phong City,An Duong,10,4,2,2,1
2022-02-25,Hai Phong City,An Duong,11,9,5,4,3
2022-02-25,Hai Phong City,An Duong,12,3,2,1,0
2022-02-25,Hai Phong City,An Duong,13,5,3,2,2
2022-02-25,Hai Phong City,An Duong,14,5,4,1,1
2022-02-25,Hai Phong City,An Duong,15,8,1,7,6
2022-02-25,Hai Phong City,An Duong,16,8,4,4,0
2022-02-25,Hai Phong City,An Duong,17,2,1,1,0
2022-02-25,Hai Phong City,An Duong,18,3,0,3,1
2022-02-25,Hai Phong City,An Duong,19,7,1,6,4
2022-02-25,Hai Phong City,An Duong,20,5,1,4,4
2022-02-25,Hai Phong City,An Duong,21,1,1,0,0
2022-02-25,Hai Phong City,Do Son District,18,1,0,1,1
2022-02-25,Hai Phong City,Hai An District,0,1,0,1,0
2022-02-25,Hai Phong City,Hai An District,6,1,0,1,0
2022-02-25,Hai Phong City,Hai An District,7,10,8,2,2
2022-02-25,Hai Phong City,Hai An District,8,19,12,7,2
2022-02-25,Hai Phong City,Hai An District,9,12,11,1,1
2022-02-25,Hai Phong City,Hai An District,10,18,13,5,2
2022-02-25,Hai Phong City,Hai An District,11,45,34,11,1
2022-02-25,Hai Phong City,Hai An District,12,25,21,4,1
2022-02-25,Hai Phong City,Hai An District,13,12,12,0,0
2022-02-25,Hai Phong City,Hai An District,14,18,15,3,0
2022-02-25,Hai Phong City,Hai An District,15,15,10,5,1
2022-02-25,Hai Phong City,Hai An District,16,29,24,5,1
2022-02-25,Hai Phong City,Hai An District,17,23,17,6,0
2022-02-25,Hai Phong City,Hai An District,18,40,24,16,5
2022-02-25,Hai Phong City,Hai An District,19,23,20,3,1
2022-02-25,Hai Phong City,Hai An District,20,5,3,2,1
2022-02-25,Hai Phong City,Hai An District,21,13,9,4,2
2022-02-25,Hai Phong City,Hong Bang District,0,1,1,0,0
2022-02-25,Hai Phong City,Hong Bang District,6,2,1,1,1
2022-02-25,Hai Phong City,Hong Bang District,7,16,11,5,2
2022-02-25,Hai Phong City,Hong Bang District,8,35,24,11,5
2022-02-25,Hai Phong City,Hong Bang District,9,35,31,4,1
2022-02-25,Hai Phong City,Hong Bang District,10,94,72,22,11
2022-02-25,Hai Phong City,Hong Bang District,11,101,88,13,4
2022-02-25,Hai Phong City,Hong Bang District,12,46,41,5,0
2022-02-25,Hai Phong City,Hong Bang District,13,41,36,5,1
2022-02-25,Hai Phong City,Hong Bang District,14,51,39,12,5
2022-02-25,Hai Phong City,Hong Bang District,15,55,41,14,2
2022-02-25,Hai Phong City,Hong Bang District,16,71,52,19,10
2022-02-25,Hai Phong City,Hong Bang District,17,60,44,16,7
2022-02-25,Hai Phong City,Hong Bang District,18,70,59,11,2
2022-02-25,Hai Phong City,Hong Bang District,19,61,47,14,4
2022-02-25,Hai Phong City,Hong Bang District,20,25,21,4,0
2022-02-25,Hai Phong City,Hong Bang District,21,16,12,4,0
2022-02-25,Hai Phong City,Hong Bang District,23,1,1,0,0
2022-02-25,Hai Phong City,Kien An District,7,1,0,1,1
2022-02-25,Hai Phong City,Kien An District,8,5,3,2,0
2022-02-25,Hai Phong City,Kien An District,9,5,4,1,1
2022-02-25,Hai Phong City,Kien An District,10,5,5,0,0
2022-02-25,Hai Phong City,Kien An District,11,28,10,18,13
2022-02-25,Hai Phong City,Kien An District,12,6,5,1,0
2022-02-25,Hai Phong City,Kien An District,13,7,6,1,1
2022-02-25,Hai Phong City,Kien An District,14,19,12,7,4
2022-02-25,Hai Phong City,Kien An District,15,13,11,2,0
2022-02-25,Hai Phong City,Kien An District,16,9,7,2,0
2022-02-25,Hai Phong City,Kien An District,17,12,9,3,1
2022-02-25,Hai Phong City,Kien An District,18,13,8,5,1
2022-02-25,Hai Phong City,Kien An District,19,5,4,1,0
2022-02-25,Hai Phong City,Kien An District,20,16,8,8,3
2022-02-25,Hai Phong City,Kien An District,21,3,3,0,0
2022-02-25,Hai Phong City,Le Chan District,0,5,1,4,1
2022-02-25,Hai Phong City,Le Chan District,1,2,1,1,0
2022-02-25,Hai Phong City,Le Chan District,3,2,2,0,0
2022-02-25,Hai Phong City,Le Chan District,5,1,1,0,0
2022-02-25,Hai Phong City,Le Chan District,6,2,0,2,0
2022-02-25,Hai Phong City,Le Chan District,7,54,43,11,3
2022-02-25,Hai Phong City,Le Chan District,8,92,67,25,11
2022-02-25,Hai Phong City,Le Chan District,9,82,72,10,3
2022-02-25,Hai Phong City,Le Chan District,10,181,155,26,9
2022-02-25,Hai Phong City,Le Chan District,11,294,255,39,20
2022-02-25,Hai Phong City,Le Chan District,12,182,160,22,1
2022-02-25,Hai Phong City,Le Chan District,13,122,107,15,4
2022-02-25,Hai Phong City,Le Chan District,14,200,153,47,14
2022-02-25,Hai Phong City,Le Chan District,15,248,192,56,27
2022-02-25,Hai Phong City,Le Chan District,16,238,191,47,14
2022-02-25,Hai Phong City,Le Chan District,17,269,218,51,14
2022-02-25,Hai Phong City,Le Chan District,18,249,202,47,14
2022-02-25,Hai Phong City,Le Chan District,19,218,175,43,10
2022-02-25,Hai Phong City,Le Chan District,20,140,118,22,4
2022-02-25,Hai Phong City,Le Chan District,21,51,37,14,1
2022-02-25,Hai Phong City,Le Chan District,22,4,1,3,1
2022-02-25,Hai Phong City,Le Chan District,23,1,1,0,0
2022-02-25,Hai Phong City,Ngo Quyen District,0,4,3,1,0
2022-02-25,Hai Phong City,Ngo Quyen District,1,1,1,0,0
2022-02-25,Hai Phong City,Ngo Quyen District,4,1,1,0,0
2022-02-25,Hai Phong City,Ngo Quyen District,6,2,1,1,0
2022-02-25,Hai Phong City,Ngo Quyen District,7,33,28,5,3
2022-02-25,Hai Phong City,Ngo Quyen District,8,79,68,11,2
2022-02-25,Hai Phong City,Ngo Quyen District,9,73,63,10,4
2022-02-25,Hai Phong City,Ngo Quyen District,10,135,108,27,2
2022-02-25,Hai Phong City,Ngo Quyen District,11,208,191,17,3
2022-02-25,Hai Phong City,Ngo Quyen District,12,127,113,14,3
2022-02-25,Hai Phong City,Ngo Quyen District,13,99,81,18,0
2022-02-25,Hai Phong City,Ngo Quyen District,14,122,99,23,7
2022-02-25,Hai Phong City,Ngo Quyen District,15,193,158,35,10
2022-02-25,Hai Phong City,Ngo Quyen District,16,178,144,34,19
2022-02-25,Hai Phong City,Ngo Quyen District,17,188,157,31,10
2022-02-25,Hai Phong City,Ngo Quyen District,18,182,151,31,8
2022-02-25,Hai Phong City,Ngo Quyen District,19,150,127,23,2
2022-02-25,Hai Phong City,Ngo Quyen District,20,97,80,17,2
2022-02-25,Hai Phong City,Ngo Quyen District,21,60,46,14,3
2022-02-25,Hai Phong City,Ngo Quyen District,22,3,1,2,0
2022-02-25,Hai Phong City,Thuy Nguyen,12,3,0,3,3
2022-02-25,Hai Phong City,Thuy Nguyen,13,3,0,3,3
2022-02-25,Hai Phong City,Thuy Nguyen,15,1,0,1,1
2022-02-25,Hai Phong City,Thuy Nguyen,17,1,0,1,0
2022-02-25,Hai Phong City,Thuy Nguyen,20,2,0,2,0
2022-02-25,Hue City,Hue City,0,8,5,3,0
2022-02-25,Hue City,Hue City,1,2,2,0,0
2022-02-25,Hue City,Hue City,3,5,5,0,0
2022-02-25,Hue City,Hue City,4,4,4,0,0
2022-02-25,Hue City,Hue City,5,2,2,0,0
2022-02-25,Hue City,Hue City,6,50,48,2,0
2022-02-25,Hue City,Hue City,7,144,137,7,0
2022-02-25,Hue City,Hue City,8,302,275,27,3
2022-02-25,Hue City,Hue City,9,219,202,17,0
2022-02-25,Hue City,Hue City,10,437,408,29,2
2022-02-25,Hue City,Hue City,11,774,698,76,10
2022-02-25,Hue City,Hue City,12,468,436,32,3
2022-02-25,Hue City,Hue City,13,281,272,9,0
2022-02-25,Hue City,Hue City,14,316,298,18,1
2022-02-25,Hue City,Hue City,15,404,377,27,1
2022-02-25,Hue City,Hue City,16,442,408,34,5
2022-02-25,Hue City,Hue City,17,646,575,71,14
2022-02-25,Hue City,Hue City,18,836,676,160,72
2022-02-25,Hue City,Hue City,19,630,556,74,20
2022-02-25,Hue City,Hue City,20,434,369,65,16
2022-02-25,Hue City,Hue City,21,213,169,44,7
2022-02-25,Hue City,Hue City,22,5,3,2,0
2022-02-25,Hue City,Hue City,23,1,1,0,0
2022-02-25,Hue City,Huong Thuy,7,1,0,1,1
2022-02-25,Hue City,Huong Thuy,8,2,0,2,1
2022-02-25,Hue City,Huong Thuy,13,1,1,0,0
2022-02-25,Hue City,Huong Thuy,15,1,0,1,1
2022-02-25,Hue City,Huong Thuy,17,1,0,1,0
2022-02-25,Hue City,Huong Thuy,19,1,1,0,0
2022-02-25,Hue City,Huong Tra,17,1,1,0,0
2022-02-25,Hue City,Phu Vang,7,2,1,1,0
2022-02-25,Hue City,Phu Vang,8,1,1,0,0
2022-02-25,Hue City,Phu Vang,10,1,1,0,0
2022-02-25,Hue City,Phu Vang,11,1,1,0,0
2022-02-25,Hue City,Phu Vang,12,1,1,0,0
2022-02-25,Hue City,Phu Vang,15,1,0,1,0
2022-02-25,Hue City,Phu Vang,16,4,4,0,0
2022-02-25,Hue City,Phu Vang,17,4,4,0,0
2022-02-25,Hue City,Phu Vang,18,5,4,1,1
2022-02-25,Hue City,Phu Vang,19,3,1,2,2
2022-02-25,Hue City,Phu Vang,20,2,1,1,1
2022-02-25,Hue City,Phu Vang,21,2,2,0,0
2022-02-25,Vung Tau,Ba Ria City,7,1,0,1,1
2022-02-25,Vung Tau,Ba Ria City,8,8,0,8,7
2022-02-25,Vung Tau,Ba Ria City,9,1,1,0,0
2022-02-25,Vung Tau,Ba Ria City,10,4,4,0,0
2022-02-25,Vung Tau,Ba Ria City,11,10,6,4,2
2022-02-25,Vung Tau,Ba Ria City,12,2,1,1,1
2022-02-25,Vung Tau,Ba Ria City,13,2,1,1,1
2022-02-25,Vung Tau,Ba Ria City,14,10,4,6,4
2022-02-25,Vung Tau,Ba Ria City,15,6,4,2,1
2022-02-25,Vung Tau,Ba Ria City,16,4,1,3,2
2022-02-25,Vung Tau,Ba Ria City,17,11,4,7,7
2022-02-25,Vung Tau,Ba Ria City,18,8,2,6,6
2022-02-25,Vung Tau,Ba Ria City,19,12,3,9,5
2022-02-25,Vung Tau,Ba Ria City,20,3,0,3,3
2022-02-25,Vung Tau,Ba Ria City,21,3,0,3,2
2022-02-25,Vung Tau,Tan Thanh,14,1,0,1,0
2022-02-25,Vung Tau,Vung Tau City,1,1,1,0,0
2022-02-25,Vung Tau,Vung Tau City,2,1,1,0,0
2022-02-25,Vung Tau,Vung Tau City,3,1,0,1,0
2022-02-25,Vung Tau,Vung Tau City,6,25,23,2,0
2022-02-25,Vung Tau,Vung Tau City,7,96,91,5,1
2022-02-25,Vung Tau,Vung Tau City,8,134,125,9,0
2022-02-25,Vung Tau,Vung Tau City,9,125,119,6,0
2022-02-25,Vung Tau,Vung Tau City,10,153,139,14,0
2022-02-25,Vung Tau,Vung Tau City,11,269,253,16,1
2022-02-25,Vung Tau,Vung Tau City,12,226,216,10,1
2022-02-25,Vung Tau,Vung Tau City,13,175,158,17,2
2022-02-25,Vung Tau,Vung Tau City,14,201,188,13,2
2022-02-25,Vung Tau,Vung Tau City,15,216,191,25,0
2022-02-25,Vung Tau,Vung Tau City,16,174,159,15,2
2022-02-25,Vung Tau,Vung Tau City,17,258,234,24,0
2022-02-25,Vung Tau,Vung Tau City,18,289,261,28,2
2022-02-25,Vung Tau,Vung Tau City,19,236,210,26,2
2022-02-25,Vung Tau,Vung Tau City,20,160,143,17,2
2022-02-25,Vung Tau,Vung Tau City,21,72,59,13,2
2022-02-25,Vung Tau,Vung Tau City,22,2,2,0,0
2022-02-26,Binh Duong,Ben Cat,12,1,0,1,1
2022-02-26,Binh Duong,Di An,6,3,0,3,3
2022-02-26,Binh Duong,Di An,7,5,0,5,5
2022-02-26,Binh Duong,Di An,8,11,1,10,10
2022-02-26,Binh Duong,Di An,9,21,6,15,14
2022-02-26,Binh Duong,Di An,10,34,6,28,23
2022-02-26,Binh Duong,Di An,11,37,3,34,30
2022-02-26,Binh Duong,Di An,12,22,8,14,14
2022-02-26,Binh Duong,Di An,13,32,11,21,19
2022-02-26,Binh Duong,Di An,14,12,7,5,5
2022-02-26,Binh Duong,Di An,15,14,6,8,7
2022-02-26,Binh Duong,Di An,16,15,5,10,6
2022-02-26,Binh Duong,Di An,17,30,9,21,17
2022-02-26,Binh Duong,Di An,18,23,7,16,12
2022-02-26,Binh Duong,Di An,19,24,4,20,16
2022-02-26,Binh Duong,Di An,20,9,3,6,4
2022-02-26,Binh Duong,Di An,21,8,0,8,7
2022-02-26,Binh Duong,Tan Uyen,7,4,1,3,3
2022-02-26,Binh Duong,Tan Uyen,8,1,1,0,0
2022-02-26,Binh Duong,Tan Uyen,10,1,0,1,1
2022-02-26,Binh Duong,Tan Uyen,11,3,1,2,2
2022-02-26,Binh Duong,Tan Uyen,12,1,0,1,1
2022-02-26,Binh Duong,Tan Uyen,13,1,1,0,0
2022-02-26,Binh Duong,Tan Uyen,17,1,1,0,0
2022-02-26,Binh Duong,Tan Uyen,19,1,1,0,0
2022-02-26,Binh Duong,Thu Dau Mot Town,0,1,0,1,0
2022-02-26,Binh Duong,Thu Dau Mot Town,1,1,1,0,0
2022-02-26,Binh Duong,Thu Dau Mot Town,5,1,1,0,0
2022-02-26,Binh Duong,Thu Dau Mot Town,6,45,21,24,20
2022-02-26,Binh Duong,Thu Dau Mot Town,7,120,110,10,3
2022-02-26,Binh Duong,Thu Dau Mot Town,8,201,184,17,3
2022-02-26,Binh Duong,Thu Dau Mot Town,9,247,229,18,6
2022-02-26,Binh Duong,Thu Dau Mot Town,10,415,385,30,4
2022-02-26,Binh Duong,Thu Dau Mot Town,11,587,544,43,6
2022-02-26,Binh Duong,Thu Dau Mot Town,12,431,394,37,12
2022-02-26,Binh Duong,Thu Dau Mot Town,13,343,308,35,7
2022-02-26,Binh Duong,Thu Dau Mot Town,14,284,262,22,2
2022-02-26,Binh Duong,Thu Dau Mot Town,15,249,232,17,2
2022-02-26,Binh Duong,Thu Dau Mot Town,16,279,261,18,1
2022-02-26,Binh Duong,Thu Dau Mot Town,17,294,269,25,2
2022-02-26,Binh Duong,Thu Dau Mot Town,18,364,306,58,31
2022-02-26,Binh Duong,Thu Dau Mot Town,19,295,267,28,9
2022-02-26,Binh Duong,Thu Dau Mot Town,20,208,169,39,20
2022-02-26,Binh Duong,Thu Dau Mot Town,21,115,75,40,22
2022-02-26,Binh Duong,Thu Dau Mot Town,22,1,0,1,0
2022-02-26,Binh Duong,Thuan An,0,1,0,1,0
2022-02-26,Binh Duong,Thuan An,7,3,1,2,2
2022-02-26,Binh Duong,Thuan An,8,9,5,4,4
2022-02-26,Binh Duong,Thuan An,9,40,24,16,14
2022-02-26,Binh Duong,Thuan An,10,51,28,23,21
2022-02-26,Binh Duong,Thuan An,11,93,34,59,52
2022-02-26,Binh Duong,Thuan An,12,62,31,31,24
2022-02-26,Binh Duong,Thuan An,13,52,24,28,24
2022-02-26,Binh Duong,Thuan An,14,49,17,32,26
2022-02-26,Binh Duong,Thuan An,15,40,17,23,19
2022-02-26,Binh Duong,Thuan An,16,37,17,20,15
2022-02-26,Binh Duong,Thuan An,17,50,26,24,21
2022-02-26,Binh Duong,Thuan An,18,25,19,6,4
2022-02-26,Binh Duong,Thuan An,19,50,21,29,22
2022-02-26,Binh Duong,Thuan An,20,31,15,16,14
2022-02-26,Binh Duong,Thuan An,21,14,6,8,6
2022-02-26,Binh Duong,Thuan An,22,1,0,1,1
2022-02-26,Can Tho City,Binh Thuy District,6,1,1,0,0
2022-02-26,Can Tho City,Binh Thuy District,7,1,1,0,0
2022-02-26,Can Tho City,Binh Thuy District,8,2,2,0,0
2022-02-26,Can Tho City,Binh Thuy District,9,5,5,0,0
2022-02-26,Can Tho City,Binh Thuy District,10,14,14,0,0
2022-02-26,Can Tho City,Binh Thuy District,11,10,10,0,0
2022-02-26,Can Tho City,Binh Thuy District,12,19,17,2,0
2022-02-26,Can Tho City,Binh Thuy District,13,9,8,1,1
2022-02-26,Can Tho City,Binh Thuy District,14,8,7,1,1
2022-02-26,Can Tho City,Binh Thuy District,15,11,11,0,0
2022-02-26,Can Tho City,Binh Thuy District,16,11,10,1,0
2022-02-26,Can Tho City,Binh Thuy District,17,7,6,1,0
2022-02-26,Can Tho City,Binh Thuy District,18,16,16,0,0
2022-02-26,Can Tho City,Binh Thuy District,19,6,6,0,0
2022-02-26,Can Tho City,Binh Thuy District,20,8,5,3,0
2022-02-26,Can Tho City,Binh Thuy District,21,3,3,0,0
2022-02-26,Can Tho City,Cai Rang District,7,2,1,1,1
2022-02-26,Can Tho City,Cai Rang District,8,4,3,1,1
2022-02-26,Can Tho City,Cai Rang District,9,5,4,1,0
2022-02-26,Can Tho City,Cai Rang District,10,12,10,2,0
2022-02-26,Can Tho City,Cai Rang District,11,14,13,1,0
2022-02-26,Can Tho City,Cai Rang District,12,14,13,1,0
2022-02-26,Can Tho City,Cai Rang District,13,6,6,0,0
2022-02-26,Can Tho City,Cai Rang District,14,4,4,0,0
2022-02-26,Can Tho City,Cai Rang District,15,11,10,1,1
2022-02-26,Can Tho City,Cai Rang District,16,7,6,1,1
2022-02-26,Can Tho City,Cai Rang District,17,12,10,2,0
2022-02-26,Can Tho City,Cai Rang District,18,7,7,0,0
2022-02-26,Can Tho City,Cai Rang District,19,6,3,3,1
2022-02-26,Can Tho City,Cai Rang District,20,8,6,2,0
2022-02-26,Can Tho City,Cai Rang District,21,8,3,5,4
2022-02-26,Can Tho City,Cai Rang District,23,1,1,0,0
2022-02-26,Can Tho City,Ninh Kieu District,0,5,4,1,0
2022-02-26,Can Tho City,Ninh Kieu District,2,1,1,0,0
2022-02-26,Can Tho City,Ninh Kieu District,6,47,42,5,0
2022-02-26,Can Tho City,Ninh Kieu District,7,130,124,6,0
2022-02-26,Can Tho City,Ninh Kieu District,8,231,223,8,0
2022-02-26,Can Tho City,Ninh Kieu District,9,249,234,15,0
2022-02-26,Can Tho City,Ninh Kieu District,10,474,448,26,0
2022-02-26,Can Tho City,Ninh Kieu District,11,670,630,40,3
2022-02-26,Can Tho City,Ninh Kieu District,12,561,531,30,0
2022-02-26,Can Tho City,Ninh Kieu District,13,365,356,9,0
2022-02-26,Can Tho City,Ninh Kieu District,14,325,315,10,0
2022-02-26,Can Tho City,Ninh Kieu District,15,331,320,11,1
2022-02-26,Can Tho City,Ninh Kieu District,16,368,354,14,0
2022-02-26,Can Tho City,Ninh Kieu District,17,461,437,24,0
2022-02-26,Can Tho City,Ninh Kieu District,18,485,461,24,0
2022-02-26,Can Tho City,Ninh Kieu District,19,428,400,28,0
2022-02-26,Can Tho City,Ninh Kieu District,20,314,289,25,0
2022-02-26,Can Tho City,Ninh Kieu District,21,145,134,11,1
2022-02-26,Can Tho City,Ninh Kieu District,22,3,2,1,0
2022-02-26,Can Tho City,Ninh Kieu District,23,4,3,1,0
2022-02-26,Dong Nai,Bien Hoa City,0,10,5,5,2
2022-02-26,Dong Nai,Bien Hoa City,5,1,1,0,0
2022-02-26,Dong Nai,Bien Hoa City,6,38,24,14,12
2022-02-26,Dong Nai,Bien Hoa City,7,167,145,22,7
2022-02-26,Dong Nai,Bien Hoa City,8,279,232,47,20
2022-02-26,Dong Nai,Bien Hoa City,9,391,339,52,13
2022-02-26,Dong Nai,Bien Hoa City,10,771,670,101,34
2022-02-26,Dong Nai,Bien Hoa City,11,1042,883,159,48
2022-02-26,Dong Nai,Bien Hoa City,12,851,764,87,16
2022-02-26,Dong Nai,Bien Hoa City,13,667,627,40,14
2022-02-26,Dong Nai,Bien Hoa City,14,554,507,47,13
2022-02-26,Dong Nai,Bien Hoa City,15,521,469,52,20
2022-02-26,Dong Nai,Bien Hoa City,16,515,453,62,32
2022-02-26,Dong Nai,Bien Hoa City,17,571,509,62,16
2022-02-26,Dong Nai,Bien Hoa City,18,775,650,125,61
2022-02-26,Dong Nai,Bien Hoa City,19,732,564,168,95
2022-02-26,Dong Nai,Bien Hoa City,20,538,383,155,93
2022-02-26,Dong Nai,Bien Hoa City,21,257,164,93,42
2022-02-26,Dong Nai,Bien Hoa City,22,4,0,4,1
2022-02-26,Dong Nai,Bien Hoa City,23,6,1,5,0
2022-02-26,Dong Nai,Long Khanh,12,1,0,1,1
2022-02-26,Dong Nai,Long Khanh,19,2,0,2,2
2022-02-26,Dong Nai,Long Thanh,15,1,0,1,1
2022-02-26,Dong Nai,Long Thanh,20,1,0,1,1
2022-02-26,Dong Nai,Long Thanh,21,1,0,1,1
2022-02-26,Dong Nai,Thong Nhat,8,1,1,0,0
2022-02-26,Dong Nai,Thong Nhat,9,1,1,0,0
2022-02-26,Dong Nai,Thong Nhat,10,2,2,0,0
2022-02-26,Dong Nai,Thong Nhat,11,2,2,0,0
2022-02-26,Dong Nai,Thong Nhat,15,2,2,0,0
2022-02-26,Dong Nai,Thong Nhat,16,1,1,0,0
2022-02-26,Dong Nai,Thong Nhat,18,3,3,0,0
2022-02-26,Dong Nai,Thong Nhat,19,3,3,0,0
2022-02-26,Dong Nai,Trang Bom,12,1,0,1,1
2022-02-26,Dong Nai,Trang Bom,13,2,1,1,1
2022-02-26,Dong Nai,Trang Bom,14,1,0,1,1
2022-02-26,Dong Nai,Trang Bom,18,1,1,0,0
2022-02-26,Hai Phong City,An Duong,7,2,0,2,1
2022-02-26,Hai Phong City,An Duong,8,6,3,3,3
2022-02-26,Hai Phong City,An Duong,9,3,0,3,1
2022-02-26,Hai Phong City,An Duong,10,5,3,2,1
2022-02-26,Hai Phong City,An Duong,11,4,2,2,0
2022-02-26,Hai Phong City,An Duong,12,3,2,1,0
2022-02-26,Hai Phong City,An Duong,14,2,0,2,2
2022-02-26,Hai Phong City,An Duong,15,3,2,1,1
2022-02-26,Hai Phong City,An Duong,16,6,5,1,0
2022-02-26,Hai Phong City,An Duong,17,6,3,3,2
2022-02-26,Hai Phong City,An Duong,18,1,1,0,0
2022-02-26,Hai Phong City,An Duong,19,1,0,1,1
2022-02-26,Hai Phong City,An Duong,20,1,1,0,0
2022-02-26,Hai Phong City,Duong Kinh District,10,1,1,0,0
2022-02-26,Hai Phong City,Duong Kinh District,19,1,0,1,1
2022-02-26,Hai Phong City,Hai An District,7,10,8,2,0
2022-02-26,Hai Phong City,Hai An District,8,12,10,2,2
2022-02-26,Hai Phong City,Hai An District,9,16,12,4,2
2022-02-26,Hai Phong City,Hai An District,10,13,12,1,0
2022-02-26,Hai Phong City,Hai An District,11,38,35,3,1
2022-02-26,Hai Phong City,Hai An District,12,20,17,3,0
2022-02-26,Hai Phong City,Hai An District,13,18,14,4,1
2022-02-26,Hai Phong City,Hai An District,14,19,17,2,1
2022-02-26,Hai Phong City,Hai An District,15,31,26,5,1
2022-02-26,Hai Phong City,Hai An District,16,21,17,4,0
2022-02-26,Hai Phong City,Hai An District,17,27,26,1,1
2022-02-26,Hai Phong City,Hai An District,18,37,31,6,2
2022-02-26,Hai Phong City,Hai An District,19,17,13,4,0
2022-02-26,Hai Phong City,Hai An District,20,14,10,4,1
2022-02-26,Hai Phong City,Hai An District,21,8,6,2,2
2022-02-26,Hai Phong City,Hai An District,22,1,0,1,0
2022-02-26,Hai Phong City,Hai An District,23,2,1,1,0
2022-02-26,Hai Phong City,Hong Bang District,3,1,0,1,0
2022-02-26,Hai Phong City,Hong Bang District,7,11,7,4,1
2022-02-26,Hai Phong City,Hong Bang District,8,29,21,8,0
2022-02-26,Hai Phong City,Hong Bang District,9,36,30,6,0
2022-02-26,Hai Phong City,Hong Bang District,10,57,48,9,3
2022-02-26,Hai Phong City,Hong Bang District,11,114,101,13,8
2022-02-26,Hai Phong City,Hong Bang District,12,58,55,3,0
2022-02-26,Hai Phong City,Hong Bang District,13,36,34,2,0
2022-02-26,Hai Phong City,Hong Bang District,14,34,26,8,0
2022-02-26,Hai Phong City,Hong Bang District,15,39,31,8,2
2022-02-26,Hai Phong City,Hong Bang District,16,41,33,8,2
2022-02-26,Hai Phong City,Hong Bang District,17,53,45,8,4
2022-02-26,Hai Phong City,Hong Bang District,18,85,69,16,8
2022-02-26,Hai Phong City,Hong Bang District,19,55,44,11,8
2022-02-26,Hai Phong City,Hong Bang District,20,28,22,6,0
2022-02-26,Hai Phong City,Hong Bang District,21,21,14,7,3
2022-02-26,Hai Phong City,Hong Bang District,22,2,0,2,0
2022-02-26,Hai Phong City,Kien An District,7,2,2,0,0
2022-02-26,Hai Phong City,Kien An District,8,4,2,2,1
2022-02-26,Hai Phong City,Kien An District,9,2,2,0,0
2022-02-26,Hai Phong City,Kien An District,10,10,7,3,2
2022-02-26,Hai Phong City,Kien An District,11,15,11,4,1
2022-02-26,Hai Phong City,Kien An District,12,10,10,0,0
2022-02-26,Hai Phong City,Kien An District,13,17,13,4,2
2022-02-26,Hai Phong City,Kien An District,14,10,8,2,1
2022-02-26,Hai Phong City,Kien An District,15,8,6,2,0
2022-02-26,Hai Phong City,Kien An District,16,9,7,2,0
2022-02-26,Hai Phong City,Kien An District,17,14,11,3,0
2022-02-26,Hai Phong City,Kien An District,18,10,6,4,0
2022-02-26,Hai Phong City,Kien An District,19,19,9,10,4
2022-02-26,Hai Phong City,Kien An District,20,11,7,4,1
2022-02-26,Hai Phong City,Kien An District,21,2,1,1,1
2022-02-26,Hai Phong City,Le Chan District,0,3,2,1,0
2022-02-26,Hai Phong City,Le Chan District,1,1,1,0,0
2022-02-26,Hai Phong City,Le Chan District,3,6,1,5,0
2022-02-26,Hai Phong City,Le Chan District,5,2,0,2,0
2022-02-26,Hai Phong City,Le Chan District,6,1,1,0,0
2022-02-26,Hai Phong City,Le Chan District,7,44,34,10,3
2022-02-26,Hai Phong City,Le Chan District,8,54,48,6,0
2022-02-26,Hai Phong City,Le Chan District,9,94,73,21,0
2022-02-26,Hai Phong City,Le Chan District,10,186,162,24,2
2022-02-26,Hai Phong City,Le Chan District,11,290,264,26,5
2022-02-26,Hai Phong City,Le Chan District,12,220,198,22,1
2022-02-26,Hai Phong City,Le Chan District,13,130,110,20,1
2022-02-26,Hai Phong City,Le Chan District,14,150,132,18,0
2022-02-26,Hai Phong City,Le Chan District,15,212,185,27,3
2022-02-26,Hai Phong City,Le Chan District,16,234,201,33,5
2022-02-26,Hai Phong City,Le Chan District,17,254,219,35,18
2022-02-26,Hai Phong City,Le Chan District,18,265,206,59,31
2022-02-26,Hai Phong City,Le Chan District,19,210,176,34,2
2022-02-26,Hai Phong City,Le Chan District,20,156,124,32,7
2022-02-26,Hai Phong City,Le Chan District,21,64,37,27,6
2022-02-26,Hai Phong City,Le Chan District,23,2,2,0,0
2022-02-26,Hai Phong City,Ngo Quyen District,0,2,1,1,0
2022-02-26,Hai Phong City,Ngo Quyen District,1,2,1,1,0
2022-02-26,Hai Phong City,Ngo Quyen District,4,1,0,1,0
2022-02-26,Hai Phong City,Ngo Quyen District,7,33,22,11,1
2022-02-26,Hai Phong City,Ngo Quyen District,8,71,60,11,3
2022-02-26,Hai Phong City,Ngo Quyen District,9,74,66,8,1
2022-02-26,Hai Phong City,Ngo Quyen District,10,146,128,18,2
2022-02-26,Hai Phong City,Ngo Quyen District,11,208,183,25,5
2022-02-26,Hai Phong City,Ngo Quyen District,12,168,151,17,1
2022-02-26,Hai Phong City,Ngo Quyen District,13,81,71,10,2
2022-02-26,Hai Phong City,Ngo Quyen District,14,124,111,13,1
2022-02-26,Hai Phong City,Ngo Quyen District,15,170,146,24,3
2022-02-26,Hai Phong City,Ngo Quyen District,16,184,161,23,3
2022-02-26,Hai Phong City,Ngo Quyen District,17,204,165,39,13
2022-02-26,Hai Phong City,Ngo Quyen District,18,225,191,34,15
2022-02-26,Hai Phong City,Ngo Quyen District,19,159,130,29,7
2022-02-26,Hai Phong City,Ngo Quyen District,20,109,90,19,4
2022-02-26,Hai Phong City,Ngo Quyen District,21,60,45,15,3
2022-02-26,Hai Phong City,Thuy Nguyen,9,1,0,1,1
2022-02-26,Hai Phong City,Thuy Nguyen,10,2,1,1,1
2022-02-26,Hai Phong City,Thuy Nguyen,11,2,0,2,1
2022-02-26,Hai Phong City,Thuy Nguyen,14,2,0,2,2
2022-02-26,Hai Phong City,Thuy Nguyen,15,3,0,3,3
2022-02-26,Hai Phong City,Thuy Nguyen,16,1,0,1,1
2022-02-26,Hai Phong City,Thuy Nguyen,17,2,1,1,1
2022-02-26,Hai Phong City,Thuy Nguyen,18,2,0,2,2
2022-02-26,Hai Phong City,Thuy Nguyen,19,1,0,1,0
2022-02-26,Hue City,Hue City,0,3,2,1,0
2022-02-26,Hue City,Hue City,1,8,7,1,0
2022-02-26,Hue City,Hue City,2,1,0,1,0
2022-02-26,Hue City,Hue City,3,2,1,1,1
2022-02-26,Hue City,Hue City,5,1,0,1,0
2022-02-26,Hue City,Hue City,6,49,41,8,2
2022-02-26,Hue City,Hue City,7,206,189,17,2
2022-02-26,Hue City,Hue City,8,327,297,30,4
2022-02-26,Hue City,Hue City,9,271,256,15,1
2022-02-26,Hue City,Hue City,10,449,424,25,0
2022-02-26,Hue City,Hue City,11,683,640,43,4
2022-02-26,Hue City,Hue City,12,498,473,25,1
2022-02-26,Hue City,Hue City,13,285,270,15,1
2022-02-26,Hue City,Hue City,14,363,333,30,4
2022-02-26,Hue City,Hue City,15,477,415,62,19
2022-02-26,Hue City,Hue City,16,625,492,133,74
2022-02-26,Hue City,Hue City,17,765,625,140,65
2022-02-26,Hue City,Hue City,18,764,617,147,73
2022-02-26,Hue City,Hue City,19,616,515,101,20
2022-02-26,Hue City,Hue City,20,504,390,114,49
2022-02-26,Hue City,Hue City,21,246,169,77,26
2022-02-26,Hue City,Hue City,22,8,4,4,0
2022-02-26,Hue City,Hue City,23,4,3,1,0
2022-02-26,Hue City,Huong Thuy,9,1,0,1,1
2022-02-26,Hue City,Huong Thuy,13,2,0,2,2
2022-02-26,Hue City,Huong Thuy,14,1,0,1,0
2022-02-26,Hue City,Huong Thuy,15,1,0,1,1
2022-02-26,Hue City,Huong Thuy,16,1,1,0,0
2022-02-26,Hue City,Huong Thuy,17,2,2,0,0
2022-02-26,Hue City,Huong Thuy,18,3,0,3,3
2022-02-26,Hue City,Huong Thuy,21,1,0,1,0
2022-02-26,Hue City,Huong Tra,8,1,0,1,0
2022-02-26,Hue City,Huong Tra,13,1,1,0,0
2022-02-26,Hue City,Huong Tra,14,2,2,0,0
2022-02-26,Hue City,Huong Tra,16,1,1,0,0
2022-02-26,Hue City,Phu Vang,8,1,1,0,0
2022-02-26,Hue City,Phu Vang,10,2,2,0,0
2022-02-26,Hue City,Phu Vang,11,3,3,0,0
2022-02-26,Hue City,Phu Vang,12,2,2,0,0
2022-02-26,Hue City,Phu Vang,13,4,3,1,0
2022-02-26,Hue City,Phu Vang,14,1,0,1,1
2022-02-26,Hue City,Phu Vang,15,4,3,1,0
2022-02-26,Hue City,Phu Vang,16,5,4,1,0
2022-02-26,Hue City,Phu Vang,17,1,1,0,0
2022-02-26,Hue City,Phu Vang,18,3,2,1,0
2022-02-26,Hue City,Phu Vang,19,1,0,1,0
2022-02-26,Hue City,Phu Vang,20,2,0,2,0
2022-02-26,Vung Tau,Ba Ria City,7,1,0,1,1
2022-02-26,Vung Tau,Ba Ria City,8,1,0,1,1
2022-02-26,Vung Tau,Ba Ria City,9,2,0,2,2
2022-02-26,Vung Tau,Ba Ria City,10,3,2,1,1
2022-02-26,Vung Tau,Ba Ria City,11,10,2,8,8
2022-02-26,Vung Tau,Ba Ria City,12,2,1,1,1
2022-02-26,Vung Tau,Ba Ria City,13,4,3,1,1
2022-02-26,Vung Tau,Ba Ria City,14,8,2,6,4
2022-02-26,Vung Tau,Ba Ria City,15,6,2,4,3
2022-02-26,Vung Tau,Ba Ria City,16,5,1,4,4
2022-02-26,Vung Tau,Ba Ria City,17,7,3,4,4
2022-02-26,Vung Tau,Ba Ria City,18,6,1,5,5
2022-02-26,Vung Tau,Ba Ria City,19,7,1,6,4
2022-02-26,Vung Tau,Ba Ria City,21,3,0,3,3
2022-02-26,Vung Tau,Vung Tau City,0,2,1,1,0
2022-02-26,Vung Tau,Vung Tau City,1,1,1,0,0
2022-02-26,Vung Tau,Vung Tau City,2,1,0,1,0
2022-02-26,Vung Tau,Vung Tau City,4,1,1,0,0
2022-02-26,Vung Tau,Vung Tau City,6,35,29,6,2
2022-02-26,Vung Tau,Vung Tau City,7,92,82,10,2
2022-02-26,Vung Tau,Vung Tau City,8,180,164,16,0
2022-02-26,Vung Tau,Vung Tau City,9,151,142,9,1
2022-02-26,Vung Tau,Vung Tau City,10,212,190,22,1
2022-02-26,Vung Tau,Vung Tau City,11,332,301,31,2
2022-02-26,Vung Tau,Vung Tau City,12,268,256,12,0
2022-02-26,Vung Tau,Vung Tau City,13,196,183,13,1
2022-02-26,Vung Tau,Vung Tau City,14,230,207,23,3
2022-02-26,Vung Tau,Vung Tau City,15,211,191,20,6
2022-02-26,Vung Tau,Vung Tau City,16,201,190,11,0
2022-02-26,Vung Tau,Vung Tau City,17,258,233,25,1
2022-02-26,Vung Tau,Vung Tau City,18,325,292,33,3
2022-02-26,Vung Tau,Vung Tau City,19,315,261,54,21
2022-02-26,Vung Tau,Vung Tau City,20,262,195,67,22
2022-02-26,Vung Tau,Vung Tau City,21,129,95,34,19
2022-02-27,Binh Duong,Ben Cat,18,1,1,0,0
2022-02-27,Binh Duong,Bàu Bàng,21,1,0,1,0
2022-02-27,Binh Duong,Di An,6,3,0,3,1
2022-02-27,Binh Duong,Di An,7,1,0,1,1
2022-02-27,Binh Duong,Di An,8,4,2,2,1
2022-02-27,Binh Duong,Di An,9,28,12,16,11
2022-02-27,Binh Duong,Di An,10,25,8,17,14
2022-02-27,Binh Duong,Di An,11,54,10,44,42
2022-02-27,Binh Duong,Di An,12,48,13,35,33
2022-02-27,Binh Duong,Di An,13,22,10,12,12
2022-02-27,Binh Duong,Di An,14,16,8,8,7
2022-02-27,Binh Duong,Di An,15,22,8,14,9
2022-02-27,Binh Duong,Di An,16,21,15,6,4
2022-02-27,Binh Duong,Di An,17,29,6,23,16
2022-02-27,Binh Duong,Di An,18,26,7,19,16
2022-02-27,Binh Duong,Di An,19,31,8,23,21
2022-02-27,Binh Duong,Di An,20,22,2,20,19
2022-02-27,Binh Duong,Di An,21,4,0,4,4
2022-02-27,Binh Duong,Tan Uyen,8,1,1,0,0
2022-02-27,Binh Duong,Tan Uyen,10,1,1,0,0
2022-02-27,Binh Duong,Tan Uyen,11,2,1,1,0
2022-02-27,Binh Duong,Tan Uyen,12,1,0,1,1
2022-02-27,Binh Duong,Tan Uyen,13,2,1,1,1
2022-02-27,Binh Duong,Tan Uyen,15,4,0,4,4
2022-02-27,Binh Duong,Tan Uyen,18,2,0,2,1
2022-02-27,Binh Duong,Tan Uyen,19,2,0,2,2
2022-02-27,Binh Duong,Tan Uyen,20,2,0,2,2
2022-02-27,Binh Duong,Tan Uyen,21,1,0,1,1
2022-02-27,Binh Duong,Thu Dau Mot Town,1,2,2,0,0
2022-02-27,Binh Duong,Thu Dau Mot Town,5,3,0,3,2
2022-02-27,Binh Duong,Thu Dau Mot Town,6,29,16,13,11
2022-02-27,Binh Duong,Thu Dau Mot Town,7,128,99,29,16
2022-02-27,Binh Duong,Thu Dau Mot Town,8,209,184,25,11
2022-02-27,Binh Duong,Thu Dau Mot Town,9,246,225,21,4
2022-02-27,Binh Duong,Thu Dau Mot Town,10,405,371,34,5
2022-02-27,Binh Duong,Thu Dau Mot Town,11,588,512,76,29
2022-02-27,Binh Duong,Thu Dau Mot Town,12,495,453,42,12
2022-02-27,Binh Duong,Thu Dau Mot Town,13,324,302,22,5
2022-02-27,Binh Duong,Thu Dau Mot Town,14,308,280,28,11
2022-02-27,Binh Duong,Thu Dau Mot Town,15,299,280,19,6
2022-02-27,Binh Duong,Thu Dau Mot Town,16,266,197,69,48
2022-02-27,Binh Duong,Thu Dau Mot Town,17,455,275,180,152
2022-02-27,Binh Duong,Thu Dau Mot Town,18,484,317,167,134
2022-02-27,Binh Duong,Thu Dau Mot Town,19,338,275,63,24
2022-02-27,Binh Duong,Thu Dau Mot Town,20,228,198,30,11
2022-02-27,Binh Duong,Thu Dau Mot Town,21,89,68,21,5
2022-02-27,Binh Duong,Thu Dau Mot Town,22,1,0,1,0
2022-02-27,Binh Duong,Thu Dau Mot Town,23,1,0,1,0
2022-02-27,Binh Duong,Thuan An,7,7,2,5,4
2022-02-27,Binh Duong,Thuan An,8,14,8,6,6
2022-02-27,Binh Duong,Thuan An,9,36,18,18,13
2022-02-27,Binh Duong,Thuan An,10,46,28,18,13
2022-02-27,Binh Duong,Thuan An,11,60,31,29,25
2022-02-27,Binh Duong,Thuan An,12,65,34,31,28
2022-02-27,Binh Duong,Thuan An,13,60,23,37,31
2022-02-27,Binh Duong,Thuan An,14,35,14,21,16
2022-02-27,Binh Duong,Thuan An,15,45,13,32,26
2022-02-27,Binh Duong,Thuan An,16,44,4,40,33
2022-02-27,Binh Duong,Thuan An,17,59,11,48,41
2022-02-27,Binh Duong,Thuan An,18,82,19,63,54
2022-02-27,Binh Duong,Thuan An,19,41,16,25,22
2022-02-27,Binh Duong,Thuan An,20,33,11,22,16
2022-02-27,Binh Duong,Thuan An,21,18,3,15,12
2022-02-27,Can Tho City,Binh Thuy District,6,1,0,1,1
2022-02-27,Can Tho City,Binh Thuy District,7,2,1,1,1
2022-02-27,Can Tho City,Binh Thuy District,8,8,6,2,0
2022-02-27,Can Tho City,Binh Thuy District,9,7,4,3,1
2022-02-27,Can Tho City,Binh Thuy District,10,9,9,0,0
2022-02-27,Can Tho City,Binh Thuy District,11,10,9,1,0
2022-02-27,Can Tho City,Binh Thuy District,12,14,14,0,0
2022-02-27,Can Tho City,Binh Thuy District,13,15,14,1,1
2022-02-27,Can Tho City,Binh Thuy District,14,6,6,0,0
2022-02-27,Can Tho City,Binh Thuy District,15,14,12,2,0
2022-02-27,Can Tho City,Binh Thuy District,16,9,8,1,0
2022-02-27,Can Tho City,Binh Thuy District,17,8,7,1,0
2022-02-27,Can Tho City,Binh Thuy District,18,12,11,1,0
2022-02-27,Can Tho City,Binh Thuy District,19,15,14,1,1
2022-02-27,Can Tho City,Binh Thuy District,20,13,8,5,3
2022-02-27,Can Tho City,Binh Thuy District,21,3,3,0,0
2022-02-27,Can Tho City,Cai Rang District,7,8,6,2,2
2022-02-27,Can Tho City,Cai Rang District,8,4,3,1,1
2022-02-27,Can Tho City,Cai Rang District,9,7,5,2,0
2022-02-27,Can Tho City,Cai Rang District,10,10,9,1,1
2022-02-27,Can Tho City,Cai Rang District,11,15,15,0,0
2022-02-27,Can Tho City,Cai Rang District,12,12,12,0,0
2022-02-27,Can Tho City,Cai Rang District,13,10,10,0,0
2022-02-27,Can Tho City,Cai Rang District,14,12,11,1,0
2022-02-27,Can Tho City,Cai Rang District,15,8,8,0,0
2022-02-27,Can Tho City,Cai Rang District,16,13,11,2,0
2022-02-27,Can Tho City,Cai Rang District,17,7,6,1,0
2022-02-27,Can Tho City,Cai Rang District,18,8,7,1,0
2022-02-27,Can Tho City,Cai Rang District,19,8,8,0,0
2022-02-27,Can Tho City,Cai Rang District,20,6,5,1,0
2022-02-27,Can Tho City,Cai Rang District,21,4,4,0,0
2022-02-27,Can Tho City,Ninh Kieu District,0,1,1,0,0
2022-02-27,Can Tho City,Ninh Kieu District,3,2,2,0,0
2022-02-27,Can Tho City,Ninh Kieu District,6,40,36,4,1
2022-02-27,Can Tho City,Ninh Kieu District,7,121,108,13,0
2022-02-27,Can Tho City,Ninh Kieu District,8,230,219,11,1
2022-02-27,Can Tho City,Ninh Kieu District,9,295,278,17,0
2022-02-27,Can Tho City,Ninh Kieu District,10,508,486,22,0
2022-02-27,Can Tho City,Ninh Kieu District,11,688,648,40,2
2022-02-27,Can Tho City,Ninh Kieu District,12,597,560,37,0
2022-02-27,Can Tho City,Ninh Kieu District,13,405,387,18,1
2022-02-27,Can Tho City,Ninh Kieu District,14,346,324,22,0
2022-02-27,Can Tho City,Ninh Kieu District,15,300,287,13,0
2022-02-27,Can Tho City,Ninh Kieu District,16,357,338,19,0
2022-02-27,Can Tho City,Ninh Kieu District,17,403,384,19,0
2022-02-27,Can Tho City,Ninh Kieu District,18,432,403,29,0
2022-02-27,Can Tho City,Ninh Kieu District,19,402,378,24,0
2022-02-27,Can Tho City,Ninh Kieu District,20,256,236,20,0
2022-02-27,Can Tho City,Ninh Kieu District,21,129,120,9,0
2022-02-27,Can Tho City,Ninh Kieu District,22,5,1,4,0
2022-02-27,Dong Nai,Bien Hoa City,0,1,0,1,0
2022-02-27,Dong Nai,Bien Hoa City,1,4,3,1,0
2022-02-27,Dong Nai,Bien Hoa City,2,1,1,0,0
2022-02-27,Dong Nai,Bien Hoa City,6,51,22,29,24
2022-02-27,Dong Nai,Bien Hoa City,7,175,122,53,26
2022-02-27,Dong Nai,Bien Hoa City,8,296,231,65,36
2022-02-27,Dong Nai,Bien Hoa City,9,427,365,62,15
2022-02-27,Dong Nai,Bien Hoa City,10,782,637,145,69
2022-02-27,Dong Nai,Bien Hoa City,11,1119,916,203,118
2022-02-27,Dong Nai,Bien Hoa City,12,938,767,171,85
2022-02-27,Dong Nai,Bien Hoa City,13,696,618,78,24
2022-02-27,Dong Nai,Bien Hoa City,14,590,466,124,81
2022-02-27,Dong Nai,Bien Hoa City,15,611,430,181,136
2022-02-27,Dong Nai,Bien Hoa City,16,579,438,141,100
2022-02-27,Dong Nai,Bien Hoa City,17,629,520,109,68
2022-02-27,Dong Nai,Bien Hoa City,18,737,535,202,137
2022-02-27,Dong Nai,Bien Hoa City,19,679,474,205,136
2022-02-27,Dong Nai,Bien Hoa City,20,577,336,241,160
2022-02-27,Dong Nai,Bien Hoa City,21,181,102,79,33
2022-02-27,Dong Nai,Bien Hoa City,22,4,1,3,2
2022-02-27,Dong Nai,Bien Hoa City,23,1,1,0,0
2022-02-27,Dong Nai,Long Khanh,13,1,0,1,1
2022-02-27,Dong Nai,Long Khanh,14,4,0,4,4
2022-02-27,Dong Nai,Long Khanh,17,2,0,2,2
2022-02-27,Dong Nai,Long Thanh,9,1,0,1,0
2022-02-27,Dong Nai,Long Thanh,10,3,0,3,3
2022-02-27,Dong Nai,Long Thanh,11,5,0,5,5
2022-02-27,Dong Nai,Long Thanh,13,1,0,1,1
2022-02-27,Dong Nai,Long Thanh,14,1,0,1,1
2022-02-27,Dong Nai,Long Thanh,17,1,0,1,1
2022-02-27,Dong Nai,Long Thanh,18,1,0,1,1
2022-02-27,Dong Nai,Long Thanh,19,1,0,1,1
2022-02-27,Dong Nai,Long Thanh,21,1,0,1,0
2022-02-27,Dong Nai,Nhon trach,15,1,0,1,0
2022-02-27,Dong Nai,Nhon trach,17,1,0,1,1
2022-02-27,Dong Nai,Thong Nhat,8,1,1,0,0
2022-02-27,Dong Nai,Thong Nhat,9,1,1,0,0
2022-02-27,Dong Nai,Thong Nhat,10,1,1,0,0
2022-02-27,Dong Nai,Thong Nhat,11,2,1,1,1
2022-02-27,Dong Nai,Thong Nhat,12,1,1,0,0
2022-02-27,Dong Nai,Thong Nhat,13,3,3,0,0
2022-02-27,Dong Nai,Thong Nhat,14,1,1,0,0
2022-02-27,Dong Nai,Thong Nhat,15,3,2,1,1
2022-02-27,Dong Nai,Thong Nhat,16,1,1,0,0
2022-02-27,Dong Nai,Thong Nhat,17,1,1,0,0
2022-02-27,Dong Nai,Thong Nhat,18,1,0,1,1
2022-02-27,Dong Nai,Thong Nhat,19,2,1,1,1
2022-02-27,Dong Nai,Trang Bom,10,3,2,1,0
2022-02-27,Dong Nai,Trang Bom,15,1,0,1,0
2022-02-27,Dong Nai,Trang Bom,16,2,0,2,1
2022-02-27,Dong Nai,Trang Bom,17,1,0,1,1
2022-02-27,Dong Nai,Trang Bom,19,1,0,1,1
2022-02-27,Dong Nai,Trang Bom,21,2,0,2,2
2022-02-27,Hai Phong City,An Duong,7,3,1,2,2
2022-02-27,Hai Phong City,An Duong,9,2,1,1,1
2022-02-27,Hai Phong City,An Duong,10,2,1,1,1
2022-02-27,Hai Phong City,An Duong,11,4,2,2,1
2022-02-27,Hai Phong City,An Duong,13,5,3,2,2
2022-02-27,Hai Phong City,An Duong,14,7,5,2,2
2022-02-27,Hai Phong City,An Duong,15,8,3,5,2
2022-02-27,Hai Phong City,An Duong,16,3,2,1,1
2022-02-27,Hai Phong City,An Duong,17,12,3,9,4
2022-02-27,Hai Phong City,An Duong,18,2,1,1,1
2022-02-27,Hai Phong City,An Duong,19,1,1,0,0
2022-02-27,Hai Phong City,An Duong,20,4,0,4,3
2022-02-27,Hai Phong City,An Duong,21,2,0,2,1
2022-02-27,Hai Phong City,Do Son District,12,1,0,1,1
2022-02-27,Hai Phong City,Duong Kinh District,8,1,0,1,1
2022-02-27,Hai Phong City,Hai An District,6,3,1,2,0
2022-02-27,Hai Phong City,Hai An District,7,2,2,0,0
2022-02-27,Hai Phong City,Hai An District,8,9,7,2,1
2022-02-27,Hai Phong City,Hai An District,9,14,6,8,1
2022-02-27,Hai Phong City,Hai An District,10,17,16,1,0
2022-02-27,Hai Phong City,Hai An District,11,33,26,7,1
2022-02-27,Hai Phong City,Hai An District,12,29,21,8,0
2022-02-27,Hai Phong City,Hai An District,13,18,16,2,0
2022-02-27,Hai Phong City,Hai An District,14,16,13,3,1
2022-02-27,Hai Phong City,Hai An District,15,22,17,5,1
2022-02-27,Hai Phong City,Hai An District,16,20,14,6,2
2022-02-27,Hai Phong City,Hai An District,17,25,19,6,1
2022-02-27,Hai Phong City,Hai An District,18,37,30,7,1
2022-02-27,Hai Phong City,Hai An District,19,17,9,8,1
2022-02-27,Hai Phong City,Hai An District,20,4,3,1,0
2022-02-27,Hai Phong City,Hai An District,21,4,2,2,0
2022-02-27,Hai Phong City,Hong Bang District,1,1,1,0,0
2022-02-27,Hai Phong City,Hong Bang District,6,5,3,2,0
2022-02-27,Hai Phong City,Hong Bang District,7,11,7,4,4
2022-02-27,Hai Phong City,Hong Bang District,8,22,21,1,0
2022-02-27,Hai Phong City,Hong Bang District,9,27,23,4,0
2022-02-27,Hai Phong City,Hong Bang District,10,65,59,6,1
2022-02-27,Hai Phong City,Hong Bang District,11,108,94,14,8
2022-02-27,Hai Phong City,Hong Bang District,12,63,53,10,2
2022-02-27,Hai Phong City,Hong Bang District,13,44,43,1,0
2022-02-27,Hai Phong City,Hong Bang District,14,38,38,0,0
2022-02-27,Hai Phong City,Hong Bang District,15,49,41,8,3
2022-02-27,Hai Phong City,Hong Bang District,16,31,28,3,0
2022-02-27,Hai Phong City,Hong Bang District,17,54,45,9,1
2022-02-27,Hai Phong City,Hong Bang District,18,59,48,11,6
2022-02-27,Hai Phong City,Hong Bang District,19,43,35,8,4
2022-02-27,Hai Phong City,Hong Bang District,20,47,31,16,6
2022-02-27,Hai Phong City,Hong Bang District,21,11,7,4,3
2022-02-27,Hai Phong City,Hong Bang District,23,2,1,1,1
2022-02-27,Hai Phong City,Kien An District,6,1,0,1,1
2022-02-27,Hai Phong City,Kien An District,7,2,1,1,1
2022-02-27,Hai Phong City,Kien An District,8,1,1,0,0
2022-02-27,Hai Phong City,Kien An District,9,4,4,0,0
2022-02-27,Hai Phong City,Kien An District,10,7,6,1,0
2022-02-27,Hai Phong City,Kien An District,11,16,13,3,1
2022-02-27,Hai Phong City,Kien An District,12,11,8,3,2
2022-02-27,Hai Phong City,Kien An District,13,6,5,1,0
2022-02-27,Hai Phong City,Kien An District,14,7,5,2,2
2022-02-27,Hai Phong City,Kien An District,15,12,9,3,1
2022-02-27,Hai Phong City,Kien An District,16,17,13,4,4
2022-02-27,Hai Phong City,Kien An District,17,14,11,3,2
2022-02-27,Hai Phong City,Kien An District,18,14,11,3,0
2022-02-27,Hai Phong City,Kien An District,19,12,10,2,0
2022-02-27,Hai Phong City,Kien An District,20,11,6,5,2
2022-02-27,Hai Phong City,Kien An District,21,5,0,5,3
2022-02-27,Hai Phong City,Le Chan District,0,1,0,1,0
2022-02-27,Hai Phong City,Le Chan District,1,3,2,1,0
2022-02-27,Hai Phong City,Le Chan District,2,1,1,0,0
2022-02-27,Hai Phong City,Le Chan District,7,36,28,8,3
2022-02-27,Hai Phong City,Le Chan District,8,65,57,8,0
2022-02-27,Hai Phong City,Le Chan District,9,78,68,10,0
2022-02-27,Hai Phong City,Le Chan District,10,194,163,31,3
2022-02-27,Hai Phong City,Le Chan District,11,286,238,48,16
2022-02-27,Hai Phong City,Le Chan District,12,192,179,13,2
2022-02-27,Hai Phong City,Le Chan District,13,111,97,14,2
2022-02-27,Hai Phong City,Le Chan District,14,154,131,23,5
2022-02-27,Hai Phong City,Le Chan District,15,229,184,45,12
2022-02-27,Hai Phong City,Le Chan District,16,220,183,37,11
2022-02-27,Hai Phong City,Le Chan District,17,272,219,53,19
2022-02-27,Hai Phong City,Le Chan District,18,265,215,50,27
2022-02-27,Hai Phong City,Le Chan District,19,173,149,24,13
2022-02-27,Hai Phong City,Le Chan District,20,138,111,27,6
2022-02-27,Hai Phong City,Le Chan District,21,74,50,24,7
2022-02-27,Hai Phong City,Le Chan District,22,3,2,1,0
2022-02-27,Hai Phong City,Le Chan District,23,4,2,2,0
2022-02-27,Hai Phong City,Ngo Quyen District,1,1,1,0,0
2022-02-27,Hai Phong City,Ngo Quyen District,5,1,0,1,1
2022-02-27,Hai Phong City,Ngo Quyen District,6,3,1,2,0
2022-02-27,Hai Phong City,Ngo Quyen District,7,26,23,3,1
2022-02-27,Hai Phong City,Ngo Quyen District,8,56,49,7,0
2022-02-27,Hai Phong City,Ngo Quyen District,9,91,77,14,2
2022-02-27,Hai Phong City,Ngo Quyen District,10,133,112,21,4
2022-02-27,Hai Phong City,Ngo Quyen District,11,198,177,21,6
2022-02-27,Hai Phong City,Ngo Quyen District,12,129,113,16,4
2022-02-27,Hai Phong City,Ngo Quyen District,13,106,84,22,2
2022-02-27,Hai Phong City,Ngo Quyen District,14,121,102,19,3
2022-02-27,Hai Phong City,Ngo Quyen District,15,176,136,40,25
2022-02-27,Hai Phong City,Ngo Quyen District,16,168,142,26,9
2022-02-27,Hai Phong City,Ngo Quyen District,17,180,143,37,16
2022-02-27,Hai Phong City,Ngo Quyen District,18,203,160,43,23
2022-02-27,Hai Phong City,Ngo Quyen District,19,152,126,26,10
2022-02-27,Hai Phong City,Ngo Quyen District,20,117,95,22,4
2022-02-27,Hai Phong City,Ngo Quyen District,21,59,43,16,6
2022-02-27,Hai Phong City,Ngo Quyen District,22,1,1,0,0
2022-02-27,Hai Phong City,Thuy Nguyen,10,1,0,1,0
2022-02-27,Hai Phong City,Thuy Nguyen,11,3,1,2,1
2022-02-27,Hai Phong City,Thuy Nguyen,13,2,0,2,2
2022-02-27,Hai Phong City,Thuy Nguyen,14,1,0,1,0
2022-02-27,Hai Phong City,Thuy Nguyen,15,3,1,2,2
2022-02-27,Hai Phong City,Thuy Nguyen,16,3,1,2,2
2022-02-27,Hai Phong City,Thuy Nguyen,17,1,0,1,1
2022-02-27,Hai Phong City,Thuy Nguyen,18,1,0,1,1
2022-02-27,Hue City,Hue City,0,2,1,1,0
2022-02-27,Hue City,Hue City,1,4,2,2,0
2022-02-27,Hue City,Hue City,2,6,3,3,0
2022-02-27,Hue City,Hue City,4,4,2,2,0
2022-02-27,Hue City,Hue City,6,46,35,11,1
2022-02-27,Hue City,Hue City,7,205,189,16,3
2022-02-27,Hue City,Hue City,8,390,320,70,45
2022-02-27,Hue City,Hue City,9,340,303,37,5
2022-02-27,Hue City,Hue City,10,447,414,33,2
2022-02-27,Hue City,Hue City,11,703,655,48,12
2022-02-27,Hue City,Hue City,12,537,512,25,4
2022-02-27,Hue City,Hue City,13,293,274,19,1
2022-02-27,Hue City,Hue City,14,297,274,23,1
2022-02-27,Hue City,Hue City,15,391,355,36,3
2022-02-27,Hue City,Hue City,16,516,472,44,9
2022-02-27,Hue City,Hue City,17,656,588,68,15
2022-02-27,Hue City,Hue City,18,693,577,116,45
2022-02-27,Hue City,Hue City,19,547,450,97,29
2022-02-27,Hue City,Hue City,20,401,313,88,25
2022-02-27,Hue City,Hue City,21,261,175,86,36
2022-02-27,Hue City,Hue City,22,3,1,2,1
2022-02-27,Hue City,Hue City,23,2,1,1,0
2022-02-27,Hue City,Huong Thuy,7,1,0,1,1
2022-02-27,Hue City,Huong Thuy,8,3,1,2,2
2022-02-27,Hue City,Huong Thuy,11,1,1,0,0
2022-02-27,Hue City,Huong Thuy,17,1,0,1,1
2022-02-27,Hue City,Huong Tra,12,1,1,0,0
2022-02-27,Hue City,Huong Tra,14,1,1,0,0
2022-02-27,Hue City,Huong Tra,17,1,0,1,0
2022-02-27,Hue City,Phu Vang,7,2,2,0,0
2022-02-27,Hue City,Phu Vang,8,1,1,0,0
2022-02-27,Hue City,Phu Vang,10,2,2,0,0
2022-02-27,Hue City,Phu Vang,11,1,1,0,0
2022-02-27,Hue City,Phu Vang,12,1,1,0,0
2022-02-27,Hue City,Phu Vang,13,2,2,0,0
2022-02-27,Hue City,Phu Vang,14,2,2,0,0
2022-02-27,Hue City,Phu Vang,15,5,3,2,1
2022-02-27,Hue City,Phu Vang,16,1,1,0,0
2022-02-27,Hue City,Phu Vang,17,1,1,0,0
2022-02-27,Hue City,Phu Vang,18,4,3,1,0
2022-02-27,Hue City,Phu Vang,19,3,1,2,0
2022-02-27,Hue City,Phu Vang,20,2,1,1,1
2022-02-27,Hue City,Phu Vang,21,1,1,0,0
2022-02-27,Vung Tau,Ba Ria City,7,3,0,3,2
2022-02-27,Vung Tau,Ba Ria City,8,4,1,3,3
2022-02-27,Vung Tau,Ba Ria City,9,2,1,1,1
2022-02-27,Vung Tau,Ba Ria City,10,8,4,4,3
2022-02-27,Vung Tau,Ba Ria City,11,12,2,10,8
2022-02-27,Vung Tau,Ba Ria City,12,7,5,2,1
2022-02-27,Vung Tau,Ba Ria City,13,12,6,6,5
2022-02-27,Vung Tau,Ba Ria City,14,4,3,1,1
2022-02-27,Vung Tau,Ba Ria City,15,3,2,1,1
2022-02-27,Vung Tau,Ba Ria City,16,3,2,1,1
2022-02-27,Vung Tau,Ba Ria City,17,5,0,5,5
2022-02-27,Vung Tau,Ba Ria City,18,9,3,6,4
2022-02-27,Vung Tau,Ba Ria City,19,1,0,1,1
2022-02-27,Vung Tau,Ba Ria City,20,8,0,8,7
2022-02-27,Vung Tau,Ba Ria City,21,5,0,5,5
2022-02-27,Vung Tau,Tan Thanh,12,1,0,1,0
2022-02-27,Vung Tau,Tan Thanh,19,1,0,1,1
2022-02-27,Vung Tau,Tan Thanh,21,1,0,1,1
2022-02-27,Vung Tau,Vung Tau City,0,1,1,0,0
2022-02-27,Vung Tau,Vung Tau City,2,1,0,1,0
2022-02-27,Vung Tau,Vung Tau City,5,2,0,2,2
2022-02-27,Vung Tau,Vung Tau City,6,31,28,3,2
2022-02-27,Vung Tau,Vung Tau City,7,127,108,19,6
2022-02-27,Vung Tau,Vung Tau City,8,194,163,31,10
2022-02-27,Vung Tau,Vung Tau City,9,217,206,11,1
2022-02-27,Vung Tau,Vung Tau City,10,246,231,15,2
2022-02-27,Vung Tau,Vung Tau City,11,355,316,39,9
2022-02-27,Vung Tau,Vung Tau City,12,295,273,22,4
2022-02-27,Vung Tau,Vung Tau City,13,232,220,12,2
2022-02-27,Vung Tau,Vung Tau City,14,224,206,18,5
2022-02-27,Vung Tau,Vung Tau City,15,209,190,19,2
2022-02-27,Vung Tau,Vung Tau City,16,221,213,8,3
2022-02-27,Vung Tau,Vung Tau City,17,237,211,26,2
2022-02-27,Vung Tau,Vung Tau City,18,322,267,55,22
2022-02-27,Vung Tau,Vung Tau City,19,258,219,39,10
2022-02-27,Vung Tau,Vung Tau City,20,209,170,39,14
2022-02-27,Vung Tau,Vung Tau City,21,82,55,27,9
2022-02-27,Vung Tau,Vung Tau City,22,1,0,1,0
2022-02-27,Vung Tau,Vung Tau City,23,1,1,0,0
2022-02-28,Binh Duong,Ben Cat,15,1,0,1,0
2022-02-28,Binh Duong,Ben Cat,19,1,0,1,1
2022-02-28,Binh Duong,Di An,7,1,0,1,1
2022-02-28,Binh Duong,Di An,8,3,0,3,2
2022-02-28,Binh Duong,Di An,9,9,2,7,7
2022-02-28,Binh Duong,Di An,10,10,3,7,7
2022-02-28,Binh Duong,Di An,11,35,11,24,21
2022-02-28,Binh Duong,Di An,12,27,8,19,16
2022-02-28,Binh Duong,Di An,13,26,6,20,19
2022-02-28,Binh Duong,Di An,14,21,3,18,14
2022-02-28,Binh Duong,Di An,15,15,7,8,6
2022-02-28,Binh Duong,Di An,16,21,10,11,9
2022-02-28,Binh Duong,Di An,17,21,10,11,10
2022-02-28,Binh Duong,Di An,18,11,4,7,3
2022-02-28,Binh Duong,Di An,19,11,6,5,4
2022-02-28,Binh Duong,Di An,20,12,2,10,4
2022-02-28,Binh Duong,Di An,21,10,0,10,9
2022-02-28,Binh Duong,Tan Uyen,11,1,1,0,0
2022-02-28,Binh Duong,Tan Uyen,13,3,1,2,1
2022-02-28,Binh Duong,Tan Uyen,16,1,1,0,0
2022-02-28,Binh Duong,Tan Uyen,18,3,2,1,1
2022-02-28,Binh Duong,Thu Dau Mot Town,0,1,0,1,0
2022-02-28,Binh Duong,Thu Dau Mot Town,3,1,1,0,0
2022-02-28,Binh Duong,Thu Dau Mot Town,6,17,12,5,4
2022-02-28,Binh Duong,Thu Dau Mot Town,7,55,48,7,4
2022-02-28,Binh Duong,Thu Dau Mot Town,8,90,85,5,1
2022-02-28,Binh Duong,Thu Dau Mot Town,9,136,127,9,1
2022-02-28,Binh Duong,Thu Dau Mot Town,10,343,320,23,5
2022-02-28,Binh Duong,Thu Dau Mot Town,11,515,484,31,7
2022-02-28,Binh Duong,Thu Dau Mot Town,12,382,355,27,6
2022-02-28,Binh Duong,Thu Dau Mot Town,13,341,321,20,8
2022-02-28,Binh Duong,Thu Dau Mot Town,14,266,255,11,1
2022-02-28,Binh Duong,Thu Dau Mot Town,15,228,208,20,1
2022-02-28,Binh Duong,Thu Dau Mot Town,16,247,237,10,5
2022-02-28,Binh Duong,Thu Dau Mot Town,17,298,286,12,1
2022-02-28,Binh Duong,Thu Dau Mot Town,18,328,302,26,4
2022-02-28,Binh Duong,Thu Dau Mot Town,19,294,268,26,4
2022-02-28,Binh Duong,Thu Dau Mot Town,20,202,182,20,4
2022-02-28,Binh Duong,Thu Dau Mot Town,21,94,78,16,7
2022-02-28,Binh Duong,Thu Dau Mot Town,23,3,2,1,0
2022-02-28,Binh Duong,Thuan An,8,7,1,6,4
2022-02-28,Binh Duong,Thuan An,9,25,12,13,8
2022-02-28,Binh Duong,Thuan An,10,49,28,21,17
2022-02-28,Binh Duong,Thuan An,11,60,28,32,27
2022-02-28,Binh Duong,Thuan An,12,52,29,23,23
2022-02-28,Binh Duong,Thuan An,13,60,31,29,24
2022-02-28,Binh Duong,Thuan An,14,51,25,26,17
2022-02-28,Binh Duong,Thuan An,15,28,14,14,11
2022-02-28,Binh Duong,Thuan An,16,46,19,27,17
2022-02-28,Binh Duong,Thuan An,17,35,19,16,14
2022-02-28,Binh Duong,Thuan An,18,38,25,13,13
2022-02-28,Binh Duong,Thuan An,19,25,13,12,7
2022-02-28,Binh Duong,Thuan An,20,15,13,2,2
2022-02-28,Binh Duong,Thuan An,21,19,6,13,10
2022-02-28,Can Tho City,Binh Thuy District,6,1,1,0,0
2022-02-28,Can Tho City,Binh Thuy District,8,1,1,0,0
2022-02-28,Can Tho City,Binh Thuy District,9,4,2,2,0
2022-02-28,Can Tho City,Binh Thuy District,10,7,7,0,0
2022-02-28,Can Tho City,Binh Thuy District,11,13,13,0,0
2022-02-28,Can Tho City,Binh Thuy District,12,10,10,0,0
2022-02-28,Can Tho City,Binh Thuy District,13,18,15,3,0
2022-02-28,Can Tho City,Binh Thuy District,14,8,7,1,0
2022-02-28,Can Tho City,Binh Thuy District,15,7,6,1,1
2022-02-28,Can Tho City,Binh Thuy District,16,9,9,0,0
2022-02-28,Can Tho City,Binh Thuy District,17,10,9,1,0
2022-02-28,Can Tho City,Binh Thuy District,18,4,3,1,0
2022-02-28,Can Tho City,Binh Thuy District,19,7,7,0,0
2022-02-28,Can Tho City,Binh Thuy District,20,4,3,1,0
2022-02-28,Can Tho City,Binh Thuy District,21,2,2,0,0
2022-02-28,Can Tho City,Cai Rang District,6,2,1,1,1
2022-02-28,Can Tho City,Cai Rang District,7,1,1,0,0
2022-02-28,Can Tho City,Cai Rang District,8,2,2,0,0
2022-02-28,Can Tho City,Cai Rang District,9,1,1,0,0
2022-02-28,Can Tho City,Cai Rang District,10,8,8,0,0
2022-02-28,Can Tho City,Cai Rang District,11,13,10,3,0
2022-02-28,Can Tho City,Cai Rang District,12,9,9,0,0
2022-02-28,Can Tho City,Cai Rang District,13,6,6,0,0
2022-02-28,Can Tho City,Cai Rang District,14,7,6,1,1
2022-02-28,Can Tho City,Cai Rang District,15,5,5,0,0
2022-02-28,Can Tho City,Cai Rang District,16,7,5,2,0
2022-02-28,Can Tho City,Cai Rang District,17,5,5,0,0
2022-02-28,Can Tho City,Cai Rang District,18,9,9,0,0
2022-02-28,Can Tho City,Cai Rang District,19,6,5,1,0
2022-02-28,Can Tho City,Cai Rang District,20,5,5,0,0
2022-02-28,Can Tho City,Cai Rang District,21,3,3,0,0
2022-02-28,Can Tho City,Ninh Kieu District,1,3,3,0,0
2022-02-28,Can Tho City,Ninh Kieu District,3,1,1,0,0
2022-02-28,Can Tho City,Ninh Kieu District,5,3,1,2,0
2022-02-28,Can Tho City,Ninh Kieu District,6,35,31,4,0
2022-02-28,Can Tho City,Ninh Kieu District,7,81,78,3,0
2022-02-28,Can Tho City,Ninh Kieu District,8,131,129,2,0
2022-02-28,Can Tho City,Ninh Kieu District,9,160,154,6,0
2022-02-28,Can Tho City,Ninh Kieu District,10,439,408,31,0
2022-02-28,Can Tho City,Ninh Kieu District,11,762,718,44,4
2022-02-28,Can Tho City,Ninh Kieu District,12,536,514,22,0
2022-02-28,Can Tho City,Ninh Kieu District,13,365,349,16,0
2022-02-28,Can Tho City,Ninh Kieu District,14,286,275,11,0
2022-02-28,Can Tho City,Ninh Kieu District,15,282,267,15,0
2022-02-28,Can Tho City,Ninh Kieu District,16,343,318,25,0
2022-02-28,Can Tho City,Ninh Kieu District,17,390,374,16,0
2022-02-28,Can Tho City,Ninh Kieu District,18,477,454,23,0
2022-02-28,Can Tho City,Ninh Kieu District,19,384,363,21,0
2022-02-28,Can Tho City,Ninh Kieu District,20,280,265,15,1
2022-02-28,Can Tho City,Ninh Kieu District,21,158,140,18,0
2022-02-28,Can Tho City,Ninh Kieu District,22,1,0,1,0
2022-02-28,Can Tho City,Ninh Kieu District,23,1,0,1,0
2022-02-28,Dong Nai,Bien Hoa City,1,2,2,0,0
2022-02-28,Dong Nai,Bien Hoa City,2,1,1,0,0
2022-02-28,Dong Nai,Bien Hoa City,3,1,1,0,0
2022-02-28,Dong Nai,Bien Hoa City,4,1,1,0,0
2022-02-28,Dong Nai,Bien Hoa City,6,26,9,17,11
2022-02-28,Dong Nai,Bien Hoa City,7,94,81,13,6
2022-02-28,Dong Nai,Bien Hoa City,8,180,151,29,12
2022-02-28,Dong Nai,Bien Hoa City,9,232,208,24,3
2022-02-28,Dong Nai,Bien Hoa City,10,621,539,82,31
2022-02-28,Dong Nai,Bien Hoa City,11,941,800,141,70
2022-02-28,Dong Nai,Bien Hoa City,12,751,664,87,24
2022-02-28,Dong Nai,Bien Hoa City,13,602,553,49,16
2022-02-28,Dong Nai,Bien Hoa City,14,505,446,59,25
2022-02-28,Dong Nai,Bien Hoa City,15,430,393,37,10
2022-02-28,Dong Nai,Bien Hoa City,16,397,347,50,15
2022-02-28,Dong Nai,Bien Hoa City,17,520,463,57,8
2022-02-28,Dong Nai,Bien Hoa City,18,581,522,59,18
2022-02-28,Dong Nai,Bien Hoa City,19,547,482,65,23
2022-02-28,Dong Nai,Bien Hoa City,20,406,342,64,22
2022-02-28,Dong Nai,Bien Hoa City,21,194,110,84,52
2022-02-28,Dong Nai,Bien Hoa City,22,2,1,1,0
2022-02-28,Dong Nai,Bien Hoa City,23,3,2,1,0
2022-02-28,Dong Nai,Long Khanh,12,1,0,1,0
2022-02-28,Dong Nai,Long Khanh,13,2,0,2,2
2022-02-28,Dong Nai,Long Khanh,14,3,0,3,3
2022-02-28,Dong Nai,Long Khanh,15,2,0,2,2
2022-02-28,Dong Nai,Long Thanh,13,1,0,1,1
2022-02-28,Dong Nai,Long Thanh,15,1,0,1,1
2022-02-28,Dong Nai,Long Thanh,19,1,0,1,1
2022-02-28,Dong Nai,Long Thanh,20,2,0,2,1
2022-02-28,Dong Nai,Nhon trach,13,2,0,2,2
2022-02-28,Dong Nai,Nhon trach,14,1,0,1,1
2022-02-28,Dong Nai,Nhon trach,15,1,0,1,1
2022-02-28,Dong Nai,Thong Nhat,9,1,1,0,0
2022-02-28,Dong Nai,Thong Nhat,10,3,3,0,0
2022-02-28,Dong Nai,Thong Nhat,11,1,1,0,0
2022-02-28,Dong Nai,Thong Nhat,12,3,3,0,0
2022-02-28,Dong Nai,Thong Nhat,14,3,2,1,0
2022-02-28,Dong Nai,Thong Nhat,15,1,1,0,0
2022-02-28,Dong Nai,Thong Nhat,18,3,3,0,0
2022-02-28,Dong Nai,Thong Nhat,20,1,1,0,0
2022-02-28,Dong Nai,Thong Nhat,21,1,1,0,0
2022-02-28,Dong Nai,Trang Bom,11,1,1,0,0
2022-02-28,Dong Nai,Trang Bom,13,1,0,1,1
2022-02-28,Dong Nai,Trang Bom,15,1,0,1,1
2022-02-28,Dong Nai,Trang Bom,16,2,2,0,0
2022-02-28,Dong Nai,Trang Bom,19,2,0,2,2
2022-02-28,Hai Phong City,An Duong,7,1,1,0,0
2022-02-28,Hai Phong City,An Duong,8,2,2,0,0
2022-02-28,Hai Phong City,An Duong,9,2,2,0,0
2022-02-28,Hai Phong City,An Duong,10,1,1,0,0
2022-02-28,Hai Phong City,An Duong,11,2,1,1,1
2022-02-28,Hai Phong City,An Duong,12,4,2,2,2
2022-02-28,Hai Phong City,An Duong,13,5,4,1,0
2022-02-28,Hai Phong City,An Duong,14,3,1,2,1
2022-02-28,Hai Phong City,An Duong,15,8,5,3,2
2022-02-28,Hai Phong City,An Duong,16,3,2,1,0
2022-02-28,Hai Phong City,An Duong,17,1,1,0,0
2022-02-28,Hai Phong City,An Duong,18,2,2,0,0
2022-02-28,Hai Phong City,An Duong,19,2,0,2,2
2022-02-28,Hai Phong City,An Duong,20,1,0,1,1
2022-02-28,Hai Phong City,Do Son District,14,1,0,1,1
2022-02-28,Hai Phong City,Hai An District,7,1,0,1,0
2022-02-28,Hai Phong City,Hai An District,8,8,8,0,0
2022-02-28,Hai Phong City,Hai An District,9,3,2,1,0
2022-02-28,Hai Phong City,Hai An District,10,23,21,2,0
2022-02-28,Hai Phong City,Hai An District,11,33,30,3,1
2022-02-28,Hai Phong City,Hai An District,12,26,22,4,1
2022-02-28,Hai Phong City,Hai An District,13,16,13,3,1
2022-02-28,Hai Phong City,Hai An District,14,17,16,1,1
2022-02-28,Hai Phong City,Hai An District,15,19,15,4,1
2022-02-28,Hai Phong City,Hai An District,16,23,21,2,0
2022-02-28,Hai Phong City,Hai An District,17,18,17,1,0
2022-02-28,Hai Phong City,Hai An District,18,38,30,8,1
2022-02-28,Hai Phong City,Hai An District,19,22,19,3,0
2022-02-28,Hai Phong City,Hai An District,20,14,11,3,1
2022-02-28,Hai Phong City,Hai An District,21,12,9,3,1
2022-02-28,Hai Phong City,Hong Bang District,7,14,10,4,2
2022-02-28,Hai Phong City,Hong Bang District,8,11,10,1,0
2022-02-28,Hai Phong City,Hong Bang District,9,14,14,0,0
2022-02-28,Hai Phong City,Hong Bang District,10,64,55,9,1
2022-02-28,Hai Phong City,Hong Bang District,11,113,94,19,11
2022-02-28,Hai Phong City,Hong Bang District,12,58,48,10,3
2022-02-28,Hai Phong City,Hong Bang District,13,28,22,6,2
2022-02-28,Hai Phong City,Hong Bang District,14,42,38,4,3
2022-02-28,Hai Phong City,Hong Bang District,15,31,28,3,2
2022-02-28,Hai Phong City,Hong Bang District,16,39,37,2,2
2022-02-28,Hai Phong City,Hong Bang District,17,59,50,9,0
2022-02-28,Hai Phong City,Hong Bang District,18,60,51,9,2
2022-02-28,Hai Phong City,Hong Bang District,19,49,39,10,2
2022-02-28,Hai Phong City,Hong Bang District,20,31,27,4,2
2022-02-28,Hai Phong City,Hong Bang District,21,12,10,2,1
2022-02-28,Hai Phong City,Kien An District,8,1,0,1,1
2022-02-28,Hai Phong City,Kien An District,9,1,1,0,0
2022-02-28,Hai Phong City,Kien An District,10,3,2,1,0
2022-02-28,Hai Phong City,Kien An District,11,15,10,5,3
2022-02-28,Hai Phong City,Kien An District,12,5,5,0,0
2022-02-28,Hai Phong City,Kien An District,13,14,6,8,6
2022-02-28,Hai Phong City,Kien An District,14,8,4,4,0
2022-02-28,Hai Phong City,Kien An District,15,7,7,0,0
2022-02-28,Hai Phong City,Kien An District,16,11,8,3,0
2022-02-28,Hai Phong City,Kien An District,17,8,6,2,2
2022-02-28,Hai Phong City,Kien An District,18,6,5,1,0
2022-02-28,Hai Phong City,Kien An District,19,12,8,4,2
2022-02-28,Hai Phong City,Kien An District,20,5,2,3,2
2022-02-28,Hai Phong City,Kien An District,21,2,0,2,2
2022-02-28,Hai Phong City,Le Chan District,0,4,3,1,0
2022-02-28,Hai Phong City,Le Chan District,2,1,0,1,0
2022-02-28,Hai Phong City,Le Chan District,6,2,1,1,1
2022-02-28,Hai Phong City,Le Chan District,7,37,29,8,1
2022-02-28,Hai Phong City,Le Chan District,8,59,50,9,0
2022-02-28,Hai Phong City,Le Chan District,9,65,60,5,0
2022-02-28,Hai Phong City,Le Chan District,10,149,135,14,1
2022-02-28,Hai Phong City,Le Chan District,11,258,224,34,14
2022-02-28,Hai Phong City,Le Chan District,12,170,159,11,1
2022-02-28,Hai Phong City,Le Chan District,13,115,100,15,1
2022-02-28,Hai Phong City,Le Chan District,14,161,130,31,5
2022-02-28,Hai Phong City,Le Chan District,15,179,154,25,11
2022-02-28,Hai Phong City,Le Chan District,16,168,145,23,2
2022-02-28,Hai Phong City,Le Chan District,17,214,189,25,2
2022-02-28,Hai Phong City,Le Chan District,18,239,200,39,8
2022-02-28,Hai Phong City,Le Chan District,19,166,147,19,5
2022-02-28,Hai Phong City,Le Chan District,20,120,107,13,2
2022-02-28,Hai Phong City,Le Chan District,21,50,40,10,5
2022-02-28,Hai Phong City,Le Chan District,22,2,1,1,0
2022-02-28,Hai Phong City,Le Chan District,23,1,0,1,0
2022-02-28,Hai Phong City,Ngo Quyen District,1,1,1,0,0
2022-02-28,Hai Phong City,Ngo Quyen District,7,14,10,4,0
2022-02-28,Hai Phong City,Ngo Quyen District,8,49,43,6,1
2022-02-28,Hai Phong City,Ngo Quyen District,9,48,45,3,0
2022-02-28,Hai Phong City,Ngo Quyen District,10,115,99,16,2
2022-02-28,Hai Phong City,Ngo Quyen District,11,208,183,25,8
2022-02-28,Hai Phong City,Ngo Quyen District,12,135,119,16,4
2022-02-28,Hai Phong City,Ngo Quyen District,13,105,93,12,1
2022-02-28,Hai Phong City,Ngo Quyen District,14,171,153,18,5
2022-02-28,Hai Phong City,Ngo Quyen District,15,164,142,22,8
2022-02-28,Hai Phong City,Ngo Quyen District,16,136,115,21,3
2022-02-28,Hai Phong City,Ngo Quyen District,17,158,139,19,1
2022-02-28,Hai Phong City,Ngo Quyen District,18,164,142,22,9
2022-02-28,Hai Phong City,Ngo Quyen District,19,114,99,15,2
2022-02-28,Hai Phong City,Ngo Quyen District,20,99,83,16,2
2022-02-28,Hai Phong City,Ngo Quyen District,21,47,38,9,1
2022-02-28,Hai Phong City,Thuy Nguyen,10,1,0,1,0
2022-02-28,Hai Phong City,Thuy Nguyen,11,1,0,1,1
2022-02-28,Hai Phong City,Thuy Nguyen,12,3,0,3,3
2022-02-28,Hai Phong City,Thuy Nguyen,13,5,0,5,5
2022-02-28,Hai Phong City,Thuy Nguyen,14,3,2,1,1
2022-02-28,Hai Phong City,Thuy Nguyen,18,1,0,1,1
2022-02-28,Hue City,Hue City,0,2,2,0,0
2022-02-28,Hue City,Hue City,1,2,0,2,1
2022-02-28,Hue City,Hue City,5,1,1,0,0
2022-02-28,Hue City,Hue City,6,50,45,5,2
2022-02-28,Hue City,Hue City,7,123,115,8,0
2022-02-28,Hue City,Hue City,8,203,193,10,0
2022-02-28,Hue City,Hue City,9,156,149,7,2
2022-02-28,Hue City,Hue City,10,322,305,17,1
2022-02-28,Hue City,Hue City,11,708,651,57,9
2022-02-28,Hue City,Hue City,12,420,394,26,1
2022-02-28,Hue City,Hue City,13,293,268,25,2
2022-02-28,Hue City,Hue City,14,290,275,15,1
2022-02-28,Hue City,Hue City,15,325,302,23,2
2022-02-28,Hue City,Hue City,16,396,367,29,3
2022-02-28,Hue City,Hue City,17,497,457,40,4
2022-02-28,Hue City,Hue City,18,573,523,50,8
2022-02-28,Hue City,Hue City,19,507,471,36,3
2022-02-28,Hue City,Hue City,20,342,296,46,5
2022-02-28,Hue City,Hue City,21,240,189,51,18
2022-02-28,Hue City,Hue City,22,4,2,2,0
2022-02-28,Hue City,Huong Thuy,8,2,0,2,2
2022-02-28,Hue City,Huong Thuy,11,1,0,1,1
2022-02-28,Hue City,Huong Thuy,19,2,0,2,2
2022-02-28,Hue City,Huong Thuy,20,1,1,0,0
2022-02-28,Hue City,Huong Thuy,21,1,1,0,0
2022-02-28,Hue City,Huong Tra,18,1,0,1,1
2022-02-28,Hue City,Huong Tra,21,1,0,1,1
2022-02-28,Hue City,Phu Vang,6,1,1,0,0
2022-02-28,Hue City,Phu Vang,7,1,1,0,0
2022-02-28,Hue City,Phu Vang,8,1,1,0,0
2022-02-28,Hue City,Phu Vang,9,1,1,0,0
2022-02-28,Hue City,Phu Vang,11,1,1,0,0
2022-02-28,Hue City,Phu Vang,14,2,0,2,2
2022-02-28,Hue City,Phu Vang,15,4,4,0,0
2022-02-28,Hue City,Phu Vang,16,4,2,2,1
2022-02-28,Hue City,Phu Vang,17,3,2,1,0
2022-02-28,Hue City,Phu Vang,18,2,1,1,0
2022-02-28,Hue City,Phu Vang,19,1,1,0,0
2022-02-28,Hue City,Phu Vang,21,4,2,2,1
2022-02-28,Vung Tau,Ba Ria City,7,1,0,1,1
2022-02-28,Vung Tau,Ba Ria City,8,2,0,2,2
2022-02-28,Vung Tau,Ba Ria City,9,6,5,1,0
2022-02-28,Vung Tau,Ba Ria City,10,4,1,3,0
2022-02-28,Vung Tau,Ba Ria City,11,17,10,7,5
2022-02-28,Vung Tau,Ba Ria City,12,14,8,6,5
2022-02-28,Vung Tau,Ba Ria City,13,6,4,2,1
2022-02-28,Vung Tau,Ba Ria City,14,5,4,1,1
2022-02-28,Vung Tau,Ba Ria City,15,4,3,1,0
2022-02-28,Vung Tau,Ba Ria City,16,2,2,0,0
2022-02-28,Vung Tau,Ba Ria City,17,4,2,2,2
2022-02-28,Vung Tau,Ba Ria City,18,10,3,7,7
2022-02-28,Vung Tau,Ba Ria City,19,9,1,8,7
2022-02-28,Vung Tau,Ba Ria City,20,6,0,6,6
2022-02-28,Vung Tau,Ba Ria City,21,1,0,1,1
2022-02-28,Vung Tau,Tan Thanh,15,1,0,1,1
2022-02-28,Vung Tau,Tan Thanh,16,1,0,1,1
2022-02-28,Vung Tau,Tan Thanh,17,1,0,1,1
2022-02-28,Vung Tau,Tan Thanh,18,1,0,1,1
2022-02-28,Vung Tau,Vung Tau City,0,1,1,0,0
2022-02-28,Vung Tau,Vung Tau City,2,1,0,1,0
2022-02-28,Vung Tau,Vung Tau City,3,1,0,1,0
2022-02-28,Vung Tau,Vung Tau City,6,19,16,3,2
2022-02-28,Vung Tau,Vung Tau City,7,56,51,5,2
2022-02-28,Vung Tau,Vung Tau City,8,96,81,15,7
2022-02-28,Vung Tau,Vung Tau City,9,87,79,8,2
2022-02-28,Vung Tau,Vung Tau City,10,174,154,20,3
2022-02-28,Vung Tau,Vung Tau City,11,301,274,27,4
2022-02-28,Vung Tau,Vung Tau City,12,222,210,12,2
2022-02-28,Vung Tau,Vung Tau City,13,193,178,15,1
2022-02-28,Vung Tau,Vung Tau City,14,198,187,11,4
2022-02-28,Vung Tau,Vung Tau City,15,202,185,17,1
2022-02-28,Vung Tau,Vung Tau City,16,184,163,21,0
2022-02-28,Vung Tau,Vung Tau City,17,188,163,25,0
2022-02-28,Vung Tau,Vung Tau City,18,280,257,23,1
2022-02-28,Vung Tau,Vung Tau City,19,224,201,23,2
2022-02-28,Vung Tau,Vung Tau City,20,190,154,36,7
2022-02-28,Vung Tau,Vung Tau City,21,97,70,27,15
2022-03-01,Binh Duong,Ben Cat,15,1,0,1,1
2022-03-01,Binh Duong,Ben Cat,16,1,0,1,1
2022-03-01,Binh Duong,Di An,5,1,0,1,1
2022-03-01,Binh Duong,Di An,6,1,0,1,1
2022-03-01,Binh Duong,Di An,7,3,0,3,3
2022-03-01,Binh Duong,Di An,8,9,2,7,6
2022-03-01,Binh Duong,Di An,9,7,3,4,2
2022-03-01,Binh Duong,Di An,10,19,6,13,9
2022-03-01,Binh Duong,Di An,11,44,4,40,35
2022-03-01,Binh Duong,Di An,12,48,5,43,39
2022-03-01,Binh Duong,Di An,13,38,5,33,27
2022-03-01,Binh Duong,Di An,14,25,8,17,14
2022-03-01,Binh Duong,Di An,15,20,2,18,16
2022-03-01,Binh Duong,Di An,16,18,4,14,10
2022-03-01,Binh Duong,Di An,17,17,9,8,7
2022-03-01,Binh Duong,Di An,18,17,6,11,9
2022-03-01,Binh Duong,Di An,19,6,3,3,2
2022-03-01,Binh Duong,Di An,20,7,3,4,3
2022-03-01,Binh Duong,Di An,21,7,2,5,4
2022-03-01,Binh Duong,Tan Uyen,9,2,1,1,1
2022-03-01,Binh Duong,Tan Uyen,10,2,1,1,1
2022-03-01,Binh Duong,Tan Uyen,11,4,1,3,3
2022-03-01,Binh Duong,Tan Uyen,12,1,0,1,1
2022-03-01,Binh Duong,Tan Uyen,13,4,2,2,2
2022-03-01,Binh Duong,Tan Uyen,14,1,1,0,0
2022-03-01,Binh Duong,Tan Uyen,15,1,0,1,1
2022-03-01,Binh Duong,Tan Uyen,17,1,1,0,0
2022-03-01,Binh Duong,Tan Uyen,20,2,0,2,2
2022-03-01,Binh Duong,Tan Uyen,21,1,0,1,1
2022-03-01,Binh Duong,Thu Dau Mot Town,0,2,2,0,0
2022-03-01,Binh Duong,Thu Dau Mot Town,4,1,1,0,0
2022-03-01,Binh Duong,Thu Dau Mot Town,6,24,20,4,4
2022-03-01,Binh Duong,Thu Dau Mot Town,7,105,94,11,4
2022-03-01,Binh Duong,Thu Dau Mot Town,8,192,176,16,1
2022-03-01,Binh Duong,Thu Dau Mot Town,9,212,196,16,4
2022-03-01,Binh Duong,Thu Dau Mot Town,10,328,298,30,5
2022-03-01,Binh Duong,Thu Dau Mot Town,11,546,514,32,2
2022-03-01,Binh Duong,Thu Dau Mot Town,12,376,350,26,3
2022-03-01,Binh Duong,Thu Dau Mot Town,13,336,314,22,0
2022-03-01,Binh Duong,Thu Dau Mot Town,14,289,270,19,1
2022-03-01,Binh Duong,Thu Dau Mot Town,15,210,196,14,2
2022-03-01,Binh Duong,Thu Dau Mot Town,16,226,210,16,5
2022-03-01,Binh Duong,Thu Dau Mot Town,17,315,292,23,3
2022-03-01,Binh Duong,Thu Dau Mot Town,18,310,291,19,2
2022-03-01,Binh Duong,Thu Dau Mot Town,19,241,229,12,4
2022-03-01,Binh Duong,Thu Dau Mot Town,20,209,183,26,5
2022-03-01,Binh Duong,Thu Dau Mot Town,21,91,73,18,2
2022-03-01,Binh Duong,Thu Dau Mot Town,22,4,0,4,0
2022-03-01,Binh Duong,Thu Dau Mot Town,23,2,2,0,0
2022-03-01,Binh Duong,Thuan An,6,1,0,1,1
2022-03-01,Binh Duong,Thuan An,7,7,2,5,2
2022-03-01,Binh Duong,Thuan An,8,10,7,3,1
2022-03-01,Binh Duong,Thuan An,9,21,13,8,6
2022-03-01,Binh Duong,Thuan An,10,39,28,11,9
2022-03-01,Binh Duong,Thuan An,11,77,33,44,29
2022-03-01,Binh Duong,Thuan An,12,62,35,27,21
2022-03-01,Binh Duong,Thuan An,13,77,29,48,43
2022-03-01,Binh Duong,Thuan An,14,72,17,55,50
2022-03-01,Binh Duong,Thuan An,15,40,11,29,25
2022-03-01,Binh Duong,Thuan An,16,18,12,6,4
2022-03-01,Binh Duong,Thuan An,17,29,22,7,6
2022-03-01,Binh Duong,Thuan An,18,32,28,4,2
2022-03-01,Binh Duong,Thuan An,19,32,28,4,2
2022-03-01,Binh Duong,Thuan An,20,23,13,10,8
2022-03-01,Binh Duong,Thuan An,21,6,2,4,4
2022-03-01,Can Tho City,Binh Thuy District,6,2,2,0,0
2022-03-01,Can Tho City,Binh Thuy District,7,2,1,1,0
2022-03-01,Can Tho City,Binh Thuy District,8,3,3,0,0
2022-03-01,Can Tho City,Binh Thuy District,9,6,5,1,0
2022-03-01,Can Tho City,Binh Thuy District,10,5,5,0,0
2022-03-01,Can Tho City,Binh Thuy District,11,12,10,2,0
2022-03-01,Can Tho City,Binh Thuy District,12,7,7,0,0
2022-03-01,Can Tho City,Binh Thuy District,13,14,13,1,0
2022-03-01,Can Tho City,Binh Thuy District,14,5,5,0,0
2022-03-01,Can Tho City,Binh Thuy District,15,12,12,0,0
2022-03-01,Can Tho City,Binh Thuy District,16,7,6,1,0
2022-03-01,Can Tho City,Binh Thuy District,17,7,6,1,0
2022-03-01,Can Tho City,Binh Thuy District,18,8,8,0,0
2022-03-01,Can Tho City,Binh Thuy District,19,5,5,0,0
2022-03-01,Can Tho City,Binh Thuy District,20,11,10,1,0
2022-03-01,Can Tho City,Binh Thuy District,21,3,3,0,0
2022-03-01,Can Tho City,Cai Rang District,7,1,1,0,0
2022-03-01,Can Tho City,Cai Rang District,8,4,3,1,1
2022-03-01,Can Tho City,Cai Rang District,9,4,3,1,0
2022-03-01,Can Tho City,Cai Rang District,10,6,5,1,0
2022-03-01,Can Tho City,Cai Rang District,11,8,7,1,0
2022-03-01,Can Tho City,Cai Rang District,12,7,6,1,0
2022-03-01,Can Tho City,Cai Rang District,13,10,8,2,0
2022-03-01,Can Tho City,Cai Rang District,14,9,6,3,1
2022-03-01,Can Tho City,Cai Rang District,15,7,6,1,0
2022-03-01,Can Tho City,Cai Rang District,16,10,10,0,0
2022-03-01,Can Tho City,Cai Rang District,17,13,13,0,0
2022-03-01,Can Tho City,Cai Rang District,18,10,8,2,0
2022-03-01,Can Tho City,Cai Rang District,19,5,5,0,0
2022-03-01,Can Tho City,Cai Rang District,20,8,6,2,0
2022-03-01,Can Tho City,Cai Rang District,21,1,1,0,0
2022-03-01,Can Tho City,Ninh Kieu District,0,1,1,0,0
2022-03-01,Can Tho City,Ninh Kieu District,1,1,0,1,0
2022-03-01,Can Tho City,Ninh Kieu District,3,3,3,0,0
2022-03-01,Can Tho City,Ninh Kieu District,5,1,1,0,0
2022-03-01,Can Tho City,Ninh Kieu District,6,40,32,8,3
2022-03-01,Can Tho City,Ninh Kieu District,7,133,124,9,0
2022-03-01,Can Tho City,Ninh Kieu District,8,214,203,11,0
2022-03-01,Can Tho City,Ninh Kieu District,9,207,195,12,0
2022-03-01,Can Tho City,Ninh Kieu District,10,500,480,20,0
2022-03-01,Can Tho City,Ninh Kieu District,11,748,713,35,2
2022-03-01,Can Tho City,Ninh Kieu District,12,514,497,17,0
2022-03-01,Can Tho City,Ninh Kieu District,13,376,365,11,0
2022-03-01,Can Tho City,Ninh Kieu District,14,337,322,15,0
2022-03-01,Can Tho City,Ninh Kieu District,15,283,271,12,0
2022-03-01,Can Tho City,Ninh Kieu District,16,377,351,26,0
2022-03-01,Can Tho City,Ninh Kieu District,17,418,392,26,0
2022-03-01,Can Tho City,Ninh Kieu District,18,444,419,25,0
2022-03-01,Can Tho City,Ninh Kieu District,19,370,351,19,0
2022-03-01,Can Tho City,Ninh Kieu District,20,333,312,21,0
2022-03-01,Can Tho City,Ninh Kieu District,21,171,154,17,0
2022-03-01,Can Tho City,Ninh Kieu District,22,3,0,3,0
2022-03-01,Can Tho City,Ninh Kieu District,23,5,4,1,0
2022-03-01,Dong Nai,Bien Hoa City,0,1,0,1,0
2022-03-01,Dong Nai,Bien Hoa City,4,4,1,3,0
2022-03-01,Dong Nai,Bien Hoa City,5,1,1,0,0
2022-03-01,Dong Nai,Bien Hoa City,6,37,22,15,12
2022-03-01,Dong Nai,Bien Hoa City,7,146,123,23,7
2022-03-01,Dong Nai,Bien Hoa City,8,259,238,21,6
2022-03-01,Dong Nai,Bien Hoa City,9,308,262,46,10
2022-03-01,Dong Nai,Bien Hoa City,10,641,572,69,13
2022-03-01,Dong Nai,Bien Hoa City,11,1015,926,89,24
2022-03-01,Dong Nai,Bien Hoa City,12,666,607,59,14
2022-03-01,Dong Nai,Bien Hoa City,13,661,614,47,10
2022-03-01,Dong Nai,Bien Hoa City,14,485,444,41,10
2022-03-01,Dong Nai,Bien Hoa City,15,455,412,43,5
2022-03-01,Dong Nai,Bien Hoa City,16,472,431,41,12
2022-03-01,Dong Nai,Bien Hoa City,17,496,455,41,10
2022-03-01,Dong Nai,Bien Hoa City,18,585,534,51,5
2022-03-01,Dong Nai,Bien Hoa City,19,529,471,58,15
2022-03-01,Dong Nai,Bien Hoa City,20,411,336,75,29
2022-03-01,Dong Nai,Bien Hoa City,21,183,123,60,22
2022-03-01,Dong Nai,Bien Hoa City,22,5,2,3,1
2022-03-01,Dong Nai,Bien Hoa City,23,2,1,1,0
2022-03-01,Dong Nai,Long Thanh,9,3,0,3,3
2022-03-01,Dong Nai,Long Thanh,11,3,0,3,3
2022-03-01,Dong Nai,Long Thanh,13,1,0,1,1
2022-03-01,Dong Nai,Long Thanh,15,1,0,1,1
2022-03-01,Dong Nai,Nhon trach,15,1,0,1,1
2022-03-01,Dong Nai,Thong Nhat,7,1,1,0,0
2022-03-01,Dong Nai,Thong Nhat,8,1,1,0,0
2022-03-01,Dong Nai,Thong Nhat,9,1,1,0,0
2022-03-01,Dong Nai,Thong Nhat,10,2,2,0,0
2022-03-01,Dong Nai,Thong Nhat,13,4,4,0,0
2022-03-01,Dong Nai,Thong Nhat,14,3,3,0,0
2022-03-01,Dong Nai,Thong Nhat,15,1,1,0,0
2022-03-01,Dong Nai,Thong Nhat,18,1,0,1,0
2022-03-01,Dong Nai,Thong Nhat,19,2,2,0,0
2022-03-01,Dong Nai,Thong Nhat,21,1,1,0,0
2022-03-01,Dong Nai,Trang Bom,10,1,0,1,1
2022-03-01,Dong Nai,Trang Bom,14,1,0,1,1
2022-03-01,Dong Nai,Trang Bom,19,2,0,2,1
2022-03-01,Hai Phong City,An Duong,8,1,0,1,1
2022-03-01,Hai Phong City,An Duong,9,6,1,5,5
2022-03-01,Hai Phong City,An Duong,10,6,4,2,1
2022-03-01,Hai Phong City,An Duong,11,1,0,1,1
2022-03-01,Hai Phong City,An Duong,12,1,1,0,0
2022-03-01,Hai Phong City,An Duong,13,4,2,2,1
2022-03-01,Hai Phong City,An Duong,14,9,4,5,4
2022-03-01,Hai Phong City,An Duong,15,4,2,2,0
2022-03-01,Hai Phong City,An Duong,16,3,3,0,0
2022-03-01,Hai Phong City,An Duong,17,2,2,0,0
2022-03-01,Hai Phong City,An Duong,18,4,1,3,2
2022-03-01,Hai Phong City,An Duong,19,2,1,1,1
2022-03-01,Hai Phong City,An Duong,20,1,0,1,1
2022-03-01,Hai Phong City,Do Son District,11,1,0,1,1
2022-03-01,Hai Phong City,Do Son District,12,1,0,1,1
2022-03-01,Hai Phong City,Duong Kinh District,9,1,0,1,1
2022-03-01,Hai Phong City,Hai An District,1,1,1,0,0
2022-03-01,Hai Phong City,Hai An District,7,9,4,5,1
2022-03-01,Hai Phong City,Hai An District,8,24,13,11,4
2022-03-01,Hai Phong City,Hai An District,9,8,8,0,0
2022-03-01,Hai Phong City,Hai An District,10,20,19,1,0
2022-03-01,Hai Phong City,Hai An District,11,32,30,2,0
2022-03-01,Hai Phong City,Hai An District,12,28,23,5,2
2022-03-01,Hai Phong City,Hai An District,13,11,10,1,0
2022-03-01,Hai Phong City,Hai An District,14,10,8,2,0
2022-03-01,Hai Phong City,Hai An District,15,24,19,5,1
2022-03-01,Hai Phong City,Hai An District,16,20,18,2,1
2022-03-01,Hai Phong City,Hai An District,17,37,34,3,0
2022-03-01,Hai Phong City,Hai An District,18,32,28,4,0
2022-03-01,Hai Phong City,Hai An District,19,18,15,3,0
2022-03-01,Hai Phong City,Hai An District,20,18,15,3,2
2022-03-01,Hai Phong City,Hai An District,21,7,6,1,0
2022-03-01,Hai Phong City,Hong Bang District,2,1,0,1,0
2022-03-01,Hai Phong City,Hong Bang District,3,1,0,1,0
2022-03-01,Hai Phong City,Hong Bang District,4,1,1,0,0
2022-03-01,Hai Phong City,Hong Bang District,6,2,1,1,0
2022-03-01,Hai Phong City,Hong Bang District,7,14,13,1,1
2022-03-01,Hai Phong City,Hong Bang District,8,31,28,3,1
2022-03-01,Hai Phong City,Hong Bang District,9,25,24,1,0
2022-03-01,Hai Phong City,Hong Bang District,10,66,57,9,1
2022-03-01,Hai Phong City,Hong Bang District,11,98,78,20,11
2022-03-01,Hai Phong City,Hong Bang District,12,49,44,5,0
2022-03-01,Hai Phong City,Hong Bang District,13,34,27,7,4
2022-03-01,Hai Phong City,Hong Bang District,14,47,37,10,2
2022-03-01,Hai Phong City,Hong Bang District,15,50,38,12,4
2022-03-01,Hai Phong City,Hong Bang District,16,40,32,8,0
2022-03-01,Hai Phong City,Hong Bang District,17,34,32,2,0
2022-03-01,Hai Phong City,Hong Bang District,18,63,53,10,1
2022-03-01,Hai Phong City,Hong Bang District,19,45,33,12,2
2022-03-01,Hai Phong City,Hong Bang District,20,33,28,5,1
2022-03-01,Hai Phong City,Hong Bang District,21,9,8,1,1
2022-03-01,Hai Phong City,Kien An District,6,1,0,1,0
2022-03-01,Hai Phong City,Kien An District,7,4,0,4,2
2022-03-01,Hai Phong City,Kien An District,8,1,1,0,0
2022-03-01,Hai Phong City,Kien An District,9,2,0,2,1
2022-03-01,Hai Phong City,Kien An District,10,6,6,0,0
2022-03-01,Hai Phong City,Kien An District,11,16,12,4,1
2022-03-01,Hai Phong City,Kien An District,12,3,3,0,0
2022-03-01,Hai Phong City,Kien An District,13,7,7,0,0
2022-03-01,Hai Phong City,Kien An District,14,4,2,2,2
2022-03-01,Hai Phong City,Kien An District,15,10,7,3,1
2022-03-01,Hai Phong City,Kien An District,16,6,3,3,1
2022-03-01,Hai Phong City,Kien An District,17,9,9,0,0
2022-03-01,Hai Phong City,Kien An District,18,8,8,0,0
2022-03-01,Hai Phong City,Kien An District,19,9,6,3,1
2022-03-01,Hai Phong City,Kien An District,20,11,8,3,2
2022-03-01,Hai Phong City,Kien An District,21,1,1,0,0
2022-03-01,Hai Phong City,Le Chan District,0,2,2,0,0
2022-03-01,Hai Phong City,Le Chan District,1,1,1,0,0
2022-03-01,Hai Phong City,Le Chan District,3,2,2,0,0
2022-03-01,Hai Phong City,Le Chan District,6,1,1,0,0
2022-03-01,Hai Phong City,Le Chan District,7,40,32,8,5
2022-03-01,Hai Phong City,Le Chan District,8,85,75,10,0
2022-03-01,Hai Phong City,Le Chan District,9,71,57,14,1
2022-03-01,Hai Phong City,Le Chan District,10,170,150,20,0
2022-03-01,Hai Phong City,Le Chan District,11,289,256,33,8
2022-03-01,Hai Phong City,Le Chan District,12,155,141,14,1
2022-03-01,Hai Phong City,Le Chan District,13,101,89,12,2
2022-03-01,Hai Phong City,Le Chan District,14,168,139,29,2
2022-03-01,Hai Phong City,Le Chan District,15,201,168,33,11
2022-03-01,Hai Phong City,Le Chan District,16,190,164,26,4
2022-03-01,Hai Phong City,Le Chan District,17,206,181,25,3
2022-03-01,Hai Phong City,Le Chan District,18,268,233,35,11
2022-03-01,Hai Phong City,Le Chan District,19,167,138,29,7
2022-03-01,Hai Phong City,Le Chan District,20,119,98,21,1
2022-03-01,Hai Phong City,Le Chan District,21,52,40,12,3
2022-03-01,Hai Phong City,Le Chan District,22,3,1,2,0
2022-03-01,Hai Phong City,Le Chan District,23,2,1,1,1
2022-03-01,Hai Phong City,Ngo Quyen District,1,1,1,0,0
2022-03-01,Hai Phong City,Ngo Quyen District,7,39,27,12,3
2022-03-01,Hai Phong City,Ngo Quyen District,8,76,63,13,4
2022-03-01,Hai Phong City,Ngo Quyen District,9,67,60,7,0
2022-03-01,Hai Phong City,Ngo Quyen District,10,148,139,9,1
2022-03-01,Hai Phong City,Ngo Quyen District,11,249,207,42,17
2022-03-01,Hai Phong City,Ngo Quyen District,12,113,101,12,4
2022-03-01,Hai Phong City,Ngo Quyen District,13,87,84,3,0
2022-03-01,Hai Phong City,Ngo Quyen District,14,164,141,23,7
2022-03-01,Hai Phong City,Ngo Quyen District,15,161,138,23,8
2022-03-01,Hai Phong City,Ngo Quyen District,16,154,131,23,5
2022-03-01,Hai Phong City,Ngo Quyen District,17,140,113,27,1
2022-03-01,Hai Phong City,Ngo Quyen District,18,161,140,21,2
2022-03-01,Hai Phong City,Ngo Quyen District,19,143,130,13,3
2022-03-01,Hai Phong City,Ngo Quyen District,20,107,85,22,6
2022-03-01,Hai Phong City,Ngo Quyen District,21,54,33,21,9
2022-03-01,Hai Phong City,Ngo Quyen District,23,1,0,1,0
2022-03-01,Hai Phong City,Thuy Nguyen,11,1,0,1,1
2022-03-01,Hai Phong City,Thuy Nguyen,14,1,0,1,1
2022-03-01,Hai Phong City,Thuy Nguyen,15,1,1,0,0
2022-03-01,Hai Phong City,Thuy Nguyen,16,3,0,3,1
2022-03-01,Hai Phong City,Thuy Nguyen,17,2,0,2,2
2022-03-01,Hai Phong City,Thuy Nguyen,18,1,1,0,0
2022-03-01,Hai Phong City,Thuy Nguyen,20,1,0,1,1
2022-03-01,Hue City,Hue City,0,4,2,2,1
2022-03-01,Hue City,Hue City,2,3,1,2,1
2022-03-01,Hue City,Hue City,3,2,2,0,0
2022-03-01,Hue City,Hue City,5,4,1,3,0
2022-03-01,Hue City,Hue City,6,58,49,9,3
2022-03-01,Hue City,Hue City,7,221,206,15,2
2022-03-01,Hue City,Hue City,8,284,263,21,0
2022-03-01,Hue City,Hue City,9,209,192,17,0
2022-03-01,Hue City,Hue City,10,380,356,24,1
2022-03-01,Hue City,Hue City,11,710,657,53,8
2022-03-01,Hue City,Hue City,12,433,413,20,0
2022-03-01,Hue City,Hue City,13,279,250,29,0
2022-03-01,Hue City,Hue City,14,340,317,23,1
2022-03-01,Hue City,Hue City,15,365,342,23,2
2022-03-01,Hue City,Hue City,16,387,364,23,0
2022-03-01,Hue City,Hue City,17,517,479,38,1
2022-03-01,Hue City,Hue City,18,616,570,46,6
2022-03-01,Hue City,Hue City,19,482,442,40,6
2022-03-01,Hue City,Hue City,20,357,327,30,7
2022-03-01,Hue City,Hue City,21,251,188,63,24
2022-03-01,Hue City,Hue City,22,4,4,0,0
2022-03-01,Hue City,Hue City,23,5,2,3,0
2022-03-01,Hue City,Huong Thuy,10,1,0,1,1
2022-03-01,Hue City,Huong Thuy,11,1,1,0,0
2022-03-01,Hue City,Huong Thuy,16,2,1,1,1
2022-03-01,Hue City,Huong Thuy,18,2,0,2,2
2022-03-01,Hue City,Huong Thuy,19,1,1,0,0
2022-03-01,Hue City,Huong Tra,15,1,0,1,0
2022-03-01,Hue City,Phu Vang,6,1,0,1,0
2022-03-01,Hue City,Phu Vang,7,1,0,1,0
2022-03-01,Hue City,Phu Vang,8,1,1,0,0
2022-03-01,Hue City,Phu Vang,9,1,1,0,0
2022-03-01,Hue City,Phu Vang,10,4,2,2,1
2022-03-01,Hue City,Phu Vang,12,1,1,0,0
2022-03-01,Hue City,Phu Vang,15,1,1,0,0
2022-03-01,Hue City,Phu Vang,16,1,0,1,1
2022-03-01,Hue City,Phu Vang,17,2,2,0,0
2022-03-01,Hue City,Phu Vang,18,3,3,0,0
2022-03-01,Hue City,Phu Vang,19,1,0,1,0
2022-03-01,Hue City,Phu Vang,21,1,0,1,0
2022-03-01,Vung Tau,Ba Ria City,9,4,0,4,3
2022-03-01,Vung Tau,Ba Ria City,10,5,0,5,5
2022-03-01,Vung Tau,Ba Ria City,11,13,5,8,6
2022-03-01,Vung Tau,Ba Ria City,12,4,3,1,1
2022-03-01,Vung Tau,Ba Ria City,13,7,5,2,0
2022-03-01,Vung Tau,Ba Ria City,14,9,3,6,4
2022-03-01,Vung Tau,Ba Ria City,15,2,2,0,0
2022-03-01,Vung Tau,Ba Ria City,18,7,4,3,2
2022-03-01,Vung Tau,Ba Ria City,19,4,4,0,0
2022-03-01,Vung Tau,Ba Ria City,21,1,0,1,0
2022-03-01,Vung Tau,Tan Thanh,11,1,0,1,1
2022-03-01,Vung Tau,Tan Thanh,17,1,0,1,1
2022-03-01,Vung Tau,Tan Thanh,18,1,0,1,1
2022-03-01,Vung Tau,Tan Thanh,19,1,0,1,1
2022-03-01,Vung Tau,Vung Tau City,0,1,0,1,1
2022-03-01,Vung Tau,Vung Tau City,1,1,1,0,0
2022-03-01,Vung Tau,Vung Tau City,2,2,1,1,0
2022-03-01,Vung Tau,Vung Tau City,3,1,1,0,0
2022-03-01,Vung Tau,Vung Tau City,6,49,38,11,7
2022-03-01,Vung Tau,Vung Tau City,7,119,108,11,3
2022-03-01,Vung Tau,Vung Tau City,8,130,119,11,1
2022-03-01,Vung Tau,Vung Tau City,9,114,111,3,0
2022-03-01,Vung Tau,Vung Tau City,10,135,122,13,1
2022-03-01,Vung Tau,Vung Tau City,11,304,282,22,5
2022-03-01,Vung Tau,Vung Tau City,12,220,209,11,1
2022-03-01,Vung Tau,Vung Tau City,13,170,159,11,1
2022-03-01,Vung Tau,Vung Tau City,14,213,191,22,4
2022-03-01,Vung Tau,Vung Tau City,15,224,211,13,1
2022-03-01,Vung Tau,Vung Tau City,16,198,180,18,1
2022-03-01,Vung Tau,Vung Tau City,17,246,229,17,1
2022-03-01,Vung Tau,Vung Tau City,18,272,250,22,0
2022-03-01,Vung Tau,Vung Tau City,19,219,197,22,5
2022-03-01,Vung Tau,Vung Tau City,20,173,148,25,6
2022-03-01,Vung Tau,Vung Tau City,21,69,55,14,8
2022-03-01,Vung Tau,Vung Tau City,22,1,0,1,0
2022-03-01,Vung Tau,Vung Tau City,23,2,1,1,1
2022-03-02,Binh Duong,Ben Cat,14,1,0,1,1
2022-03-02,Binh Duong,Di An,4,1,0,1,0
2022-03-02,Binh Duong,Di An,7,7,0,7,5
2022-03-02,Binh Duong,Di An,8,13,0,13,12
2022-03-02,Binh Duong,Di An,9,17,4,13,11
2022-03-02,Binh Duong,Di An,10,14,2,12,12
2022-03-02,Binh Duong,Di An,11,14,3,11,9
2022-03-02,Binh Duong,Di An,12,23,10,13,12
2022-03-02,Binh Duong,Di An,13,17,6,11,8
2022-03-02,Binh Duong,Di An,14,21,3,18,18
2022-03-02,Binh Duong,Di An,15,14,6,8,8
2022-03-02,Binh Duong,Di An,16,11,5,6,5
2022-03-02,Binh Duong,Di An,17,15,3,12,9
2022-03-02,Binh Duong,Di An,18,24,5,19,17
2022-03-02,Binh Duong,Di An,19,16,2,14,12
2022-03-02,Binh Duong,Di An,20,13,2,11,10
2022-03-02,Binh Duong,Di An,21,6,1,5,3
2022-03-02,Binh Duong,Tan Uyen,9,1,0,1,1
2022-03-02,Binh Duong,Tan Uyen,10,1,0,1,1
2022-03-02,Binh Duong,Tan Uyen,11,1,1,0,0
2022-03-02,Binh Duong,Tan Uyen,12,1,1,0,0
2022-03-02,Binh Duong,Tan Uyen,13,1,1,0,0
2022-03-02,Binh Duong,Tan Uyen,14,2,0,2,2
2022-03-02,Binh Duong,Tan Uyen,16,1,0,1,1
2022-03-02,Binh Duong,Tan Uyen,17,1,1,0,0
2022-03-02,Binh Duong,Tan Uyen,18,2,0,2,1
2022-03-02,Binh Duong,Tan Uyen,19,1,1,0,0
2022-03-02,Binh Duong,Tan Uyen,20,1,0,1,1
2022-03-02,Binh Duong,Thu Dau Mot Town,0,2,1,1,0
2022-03-02,Binh Duong,Thu Dau Mot Town,2,1,1,0,0
2022-03-02,Binh Duong,Thu Dau Mot Town,6,30,21,9,8
2022-03-02,Binh Duong,Thu Dau Mot Town,7,93,85,8,6
2022-03-02,Binh Duong,Thu Dau Mot Town,8,185,170,15,6
2022-03-02,Binh Duong,Thu Dau Mot Town,9,187,177,10,2
2022-03-02,Binh Duong,Thu Dau Mot Town,10,327,298,29,1
2022-03-02,Binh Duong,Thu Dau Mot Town,11,572,528,44,15
2022-03-02,Binh Duong,Thu Dau Mot Town,12,372,342,30,5
2022-03-02,Binh Duong,Thu Dau Mot Town,13,335,313,22,1
2022-03-02,Binh Duong,Thu Dau Mot Town,14,295,280,15,0
2022-03-02,Binh Duong,Thu Dau Mot Town,15,215,199,16,4
2022-03-02,Binh Duong,Thu Dau Mot Town,16,276,259,17,2
2022-03-02,Binh Duong,Thu Dau Mot Town,17,337,244,93,62
2022-03-02,Binh Duong,Thu Dau Mot Town,18,403,348,55,21
2022-03-02,Binh Duong,Thu Dau Mot Town,19,338,310,28,11
2022-03-02,Binh Duong,Thu Dau Mot Town,20,212,179,33,9
2022-03-02,Binh Duong,Thu Dau Mot Town,21,84,72,12,3
2022-03-02,Binh Duong,Thu Dau Mot Town,22,2,2,0,0
2022-03-02,Binh Duong,Thu Dau Mot Town,23,3,2,1,0
2022-03-02,Binh Duong,Thuan An,6,2,0,2,2
2022-03-02,Binh Duong,Thuan An,7,13,2,11,11
2022-03-02,Binh Duong,Thuan An,8,14,6,8,6
2022-03-02,Binh Duong,Thuan An,9,26,12,14,14
2022-03-02,Binh Duong,Thuan An,10,63,33,30,20
2022-03-02,Binh Duong,Thuan An,11,66,38,28,20
2022-03-02,Binh Duong,Thuan An,12,45,33,12,11
2022-03-02,Binh Duong,Thuan An,13,41,29,12,8
2022-03-02,Binh Duong,Thuan An,14,34,25,9,6
2022-03-02,Binh Duong,Thuan An,15,31,18,13,9
2022-03-02,Binh Duong,Thuan An,16,35,21,14,12
2022-03-02,Binh Duong,Thuan An,17,50,19,31,26
2022-03-02,Binh Duong,Thuan An,18,50,26,24,18
2022-03-02,Binh Duong,Thuan An,19,36,21,15,11
2022-03-02,Binh Duong,Thuan An,20,16,8,8,4
2022-03-02,Binh Duong,Thuan An,21,8,0,8,7
2022-03-02,Can Tho City,Binh Thuy District,7,3,2,1,0
2022-03-02,Can Tho City,Binh Thuy District,8,3,3,0,0
2022-03-02,Can Tho City,Binh Thuy District,9,7,5,2,0
2022-03-02,Can Tho City,Binh Thuy District,10,8,6,2,0
2022-03-02,Can Tho City,Binh Thuy District,11,10,9,1,0
2022-03-02,Can Tho City,Binh Thuy District,12,10,9,1,0
2022-03-02,Can Tho City,Binh Thuy District,13,12,10,2,0
2022-03-02,Can Tho City,Binh Thuy District,14,7,6,1,0
2022-03-02,Can Tho City,Binh Thuy District,15,6,6,0,0
2022-03-02,Can Tho City,Binh Thuy District,16,4,4,0,0
2022-03-02,Can Tho City,Binh Thuy District,17,16,16,0,0
2022-03-02,Can Tho City,Binh Thuy District,18,11,10,1,0
2022-03-02,Can Tho City,Binh Thuy District,19,4,4,0,0
2022-03-02,Can Tho City,Binh Thuy District,20,6,6,0,0
2022-03-02,Can Tho City,Binh Thuy District,21,2,1,1,0
2022-03-02,Can Tho City,Cai Rang District,8,3,3,0,0
2022-03-02,Can Tho City,Cai Rang District,9,1,1,0,0
2022-03-02,Can Tho City,Cai Rang District,10,8,8,0,0
2022-03-02,Can Tho City,Cai Rang District,11,11,8,3,0
2022-03-02,Can Tho City,Cai Rang District,12,11,11,0,0
2022-03-02,Can Tho City,Cai Rang District,13,7,7,0,0
2022-03-02,Can Tho City,Cai Rang District,14,9,8,1,0
2022-03-02,Can Tho City,Cai Rang District,15,12,8,4,1
2022-03-02,Can Tho City,Cai Rang District,16,11,8,3,2
2022-03-02,Can Tho City,Cai Rang District,17,8,6,2,1
2022-03-02,Can Tho City,Cai Rang District,18,12,12,0,0
2022-03-02,Can Tho City,Cai Rang District,19,11,9,2,0
2022-03-02,Can Tho City,Cai Rang District,20,5,5,0,0
2022-03-02,Can Tho City,Ninh Kieu District,0,1,1,0,0
2022-03-02,Can Tho City,Ninh Kieu District,2,1,1,0,0
2022-03-02,Can Tho City,Ninh Kieu District,3,1,0,1,0
2022-03-02,Can Tho City,Ninh Kieu District,4,1,0,1,0
2022-03-02,Can Tho City,Ninh Kieu District,5,6,5,1,0
2022-03-02,Can Tho City,Ninh Kieu District,6,36,32,4,0
2022-03-02,Can Tho City,Ninh Kieu District,7,121,116,5,0
2022-03-02,Can Tho City,Ninh Kieu District,8,209,199,10,0
2022-03-02,Can Tho City,Ninh Kieu District,9,224,214,10,0
2022-03-02,Can Tho City,Ninh Kieu District,10,492,466,26,0
2022-03-02,Can Tho City,Ninh Kieu District,11,739,694,45,9
2022-03-02,Can Tho City,Ninh Kieu District,12,463,445,18,0
2022-03-02,Can Tho City,Ninh Kieu District,13,395,381,14,0
2022-03-02,Can Tho City,Ninh Kieu District,14,327,313,14,0
2022-03-02,Can Tho City,Ninh Kieu District,15,317,302,15,0
2022-03-02,Can Tho City,Ninh Kieu District,16,385,366,19,0
2022-03-02,Can Tho City,Ninh Kieu District,17,465,442,23,1
2022-03-02,Can Tho City,Ninh Kieu District,18,444,425,19,0
2022-03-02,Can Tho City,Ninh Kieu District,19,376,351,25,1
2022-03-02,Can Tho City,Ninh Kieu District,20,257,240,17,0
2022-03-02,Can Tho City,Ninh Kieu District,21,168,162,6,0
2022-03-02,Can Tho City,Ninh Kieu District,22,3,3,0,0
2022-03-02,Dong Nai,Bien Hoa City,0,3,1,2,0
2022-03-02,Dong Nai,Bien Hoa City,3,1,1,0,0
2022-03-02,Dong Nai,Bien Hoa City,4,3,0,3,0
2022-03-02,Dong Nai,Bien Hoa City,6,37,25,12,5
2022-03-02,Dong Nai,Bien Hoa City,7,134,108,26,5
2022-03-02,Dong Nai,Bien Hoa City,8,229,198,31,6
2022-03-02,Dong Nai,Bien Hoa City,9,314,273,41,3
2022-03-02,Dong Nai,Bien Hoa City,10,586,527,59,17
2022-03-02,Dong Nai,Bien Hoa City,11,915,805,110,30
2022-03-02,Dong Nai,Bien Hoa City,12,648,594,54,8
2022-03-02,Dong Nai,Bien Hoa City,13,573,518,55,15
2022-03-02,Dong Nai,Bien Hoa City,14,483,439,44,11
2022-03-02,Dong Nai,Bien Hoa City,15,381,343,38,4
2022-03-02,Dong Nai,Bien Hoa City,16,393,302,91,34
2022-03-02,Dong Nai,Bien Hoa City,17,570,467,103,45
2022-03-02,Dong Nai,Bien Hoa City,18,585,497,88,32
2022-03-02,Dong Nai,Bien Hoa City,19,527,443,84,30
2022-03-02,Dong Nai,Bien Hoa City,20,401,301,100,49
2022-03-02,Dong Nai,Bien Hoa City,21,227,120,107,68
2022-03-02,Dong Nai,Bien Hoa City,22,4,1,3,0
2022-03-02,Dong Nai,Cam My,10,1,0,1,1
2022-03-02,Dong Nai,Long Thanh,11,1,0,1,0
2022-03-02,Dong Nai,Long Thanh,13,1,0,1,0
2022-03-02,Dong Nai,Long Thanh,15,2,0,2,2
2022-03-02,Dong Nai,Long Thanh,18,1,0,1,1
2022-03-02,Dong Nai,Long Thanh,19,1,0,1,1
2022-03-02,Dong Nai,Nhon trach,17,2,0,2,1
2022-03-02,Dong Nai,Thong Nhat,7,1,1,0,0
2022-03-02,Dong Nai,Thong Nhat,8,2,1,1,0
2022-03-02,Dong Nai,Thong Nhat,10,1,0,1,0
2022-03-02,Dong Nai,Thong Nhat,11,1,0,1,0
2022-03-02,Dong Nai,Thong Nhat,12,2,1,1,0
2022-03-02,Dong Nai,Thong Nhat,14,1,1,0,0
2022-03-02,Dong Nai,Thong Nhat,17,1,1,0,0
2022-03-02,Dong Nai,Thong Nhat,18,2,2,0,0
2022-03-02,Dong Nai,Trang Bom,21,1,0,1,1
2022-03-02,Hai Phong City,An Duong,8,2,1,1,0
2022-03-02,Hai Phong City,An Duong,9,3,2,1,1
2022-03-02,Hai Phong City,An Duong,10,4,3,1,1
2022-03-02,Hai Phong City,An Duong,11,3,2,1,1
2022-03-02,Hai Phong City,An Duong,13,2,1,1,1
2022-03-02,Hai Phong City,An Duong,14,4,2,2,0
2022-03-02,Hai Phong City,An Duong,15,7,4,3,3
2022-03-02,Hai Phong City,An Duong,16,3,2,1,0
2022-03-02,Hai Phong City,An Duong,17,2,2,0,0
2022-03-02,Hai Phong City,An Duong,18,1,0,1,1
2022-03-02,Hai Phong City,An Duong,19,1,1,0,0
2022-03-02,Hai Phong City,An Duong,21,1,0,1,1
2022-03-02,Hai Phong City,Duong Kinh District,12,1,1,0,0
2022-03-02,Hai Phong City,Hai An District,6,1,0,1,0
2022-03-02,Hai Phong City,Hai An District,7,5,3,2,0
2022-03-02,Hai Phong City,Hai An District,8,17,12,5,0
2022-03-02,Hai Phong City,Hai An District,9,8,8,0,0
2022-03-02,Hai Phong City,Hai An District,10,25,22,3,2
2022-03-02,Hai Phong City,Hai An District,11,50,42,8,4
2022-03-02,Hai Phong City,Hai An District,12,14,12,2,1
2022-03-02,Hai Phong City,Hai An District,13,17,13,4,0
2022-03-02,Hai Phong City,Hai An District,14,17,15,2,0
2022-03-02,Hai Phong City,Hai An District,15,25,20,5,0
2022-03-02,Hai Phong City,Hai An District,16,18,15,3,0
2022-03-02,Hai Phong City,Hai An District,17,30,27,3,1
2022-03-02,Hai Phong City,Hai An District,18,25,19,6,4
2022-03-02,Hai Phong City,Hai An District,19,24,15,9,3
2022-03-02,Hai Phong City,Hai An District,20,20,12,8,4
2022-03-02,Hai Phong City,Hai An District,21,9,7,2,1
2022-03-02,Hai Phong City,Hong Bang District,7,20,15,5,5
2022-03-02,Hai Phong City,Hong Bang District,8,32,25,7,3
2022-03-02,Hai Phong City,Hong Bang District,9,26,23,3,1
2022-03-02,Hai Phong City,Hong Bang District,10,57,49,8,0
2022-03-02,Hai Phong City,Hong Bang District,11,114,92,22,8
2022-03-02,Hai Phong City,Hong Bang District,12,49,45,4,1
2022-03-02,Hai Phong City,Hong Bang District,13,45,40,5,0
2022-03-02,Hai Phong City,Hong Bang District,14,57,43,14,3
2022-03-02,Hai Phong City,Hong Bang District,15,44,40,4,1
2022-03-02,Hai Phong City,Hong Bang District,16,36,34,2,1
2022-03-02,Hai Phong City,Hong Bang District,17,53,48,5,3
2022-03-02,Hai Phong City,Hong Bang District,18,52,45,7,2
2022-03-02,Hai Phong City,Hong Bang District,19,35,33,2,1
2022-03-02,Hai Phong City,Hong Bang District,20,25,21,4,2
2022-03-02,Hai Phong City,Hong Bang District,21,11,9,2,0
2022-03-02,Hai Phong City,Kien An District,7,1,0,1,1
2022-03-02,Hai Phong City,Kien An District,8,2,0,2,1
2022-03-02,Hai Phong City,Kien An District,9,4,3,1,0
2022-03-02,Hai Phong City,Kien An District,10,5,2,3,1
2022-03-02,Hai Phong City,Kien An District,11,5,5,0,0
2022-03-02,Hai Phong City,Kien An District,12,8,5,3,1
2022-03-02,Hai Phong City,Kien An District,13,10,7,3,1
2022-03-02,Hai Phong City,Kien An District,14,12,8,4,2
2022-03-02,Hai Phong City,Kien An District,15,9,7,2,1
2022-03-02,Hai Phong City,Kien An District,16,7,6,1,1
2022-03-02,Hai Phong City,Kien An District,17,13,11,2,2
2022-03-02,Hai Phong City,Kien An District,18,6,3,3,3
2022-03-02,Hai Phong City,Kien An District,19,16,6,10,6
2022-03-02,Hai Phong City,Kien An District,20,9,7,2,1
2022-03-02,Hai Phong City,Kien An District,21,6,2,4,4
2022-03-02,Hai Phong City,Le Chan District,0,3,2,1,0
2022-03-02,Hai Phong City,Le Chan District,1,1,1,0,0
2022-03-02,Hai Phong City,Le Chan District,2,1,0,1,0
2022-03-02,Hai Phong City,Le Chan District,3,1,0,1,0
2022-03-02,Hai Phong City,Le Chan District,4,1,0,1,0
2022-03-02,Hai Phong City,Le Chan District,5,1,1,0,0
2022-03-02,Hai Phong City,Le Chan District,6,2,2,0,0
2022-03-02,Hai Phong City,Le Chan District,7,54,44,10,2
2022-03-02,Hai Phong City,Le Chan District,8,67,58,9,0
2022-03-02,Hai Phong City,Le Chan District,9,74,64,10,1
2022-03-02,Hai Phong City,Le Chan District,10,179,153,26,3
2022-03-02,Hai Phong City,Le Chan District,11,290,244,46,18
2022-03-02,Hai Phong City,Le Chan District,12,177,154,23,1
2022-03-02,Hai Phong City,Le Chan District,13,118,103,15,2
2022-03-02,Hai Phong City,Le Chan District,14,188,160,28,6
2022-03-02,Hai Phong City,Le Chan District,15,194,172,22,10
2022-03-02,Hai Phong City,Le Chan District,16,190,162,28,10
2022-03-02,Hai Phong City,Le Chan District,17,220,193,27,8
2022-03-02,Hai Phong City,Le Chan District,18,233,201,32,6
2022-03-02,Hai Phong City,Le Chan District,19,156,141,15,1
2022-03-02,Hai Phong City,Le Chan District,20,127,110,17,1
2022-03-02,Hai Phong City,Le Chan District,21,44,36,8,2
2022-03-02,Hai Phong City,Le Chan District,22,2,1,1,0
2022-03-02,Hai Phong City,Ngo Quyen District,0,2,1,1,0
2022-03-02,Hai Phong City,Ngo Quyen District,1,1,1,0,0
2022-03-02,Hai Phong City,Ngo Quyen District,2,1,1,0,0
2022-03-02,Hai Phong City,Ngo Quyen District,5,1,1,0,0
2022-03-02,Hai Phong City,Ngo Quyen District,6,1,0,1,1
2022-03-02,Hai Phong City,Ngo Quyen District,7,43,34,9,2
2022-03-02,Hai Phong City,Ngo Quyen District,8,65,55,10,0
2022-03-02,Hai Phong City,Ngo Quyen District,9,88,75,13,0
2022-03-02,Hai Phong City,Ngo Quyen District,10,138,117,21,4
2022-03-02,Hai Phong City,Ngo Quyen District,11,212,180,32,16
2022-03-02,Hai Phong City,Ngo Quyen District,12,116,106,10,0
2022-03-02,Hai Phong City,Ngo Quyen District,13,95,85,10,2
2022-03-02,Hai Phong City,Ngo Quyen District,14,132,120,12,6
2022-03-02,Hai Phong City,Ngo Quyen District,15,152,128,24,9
2022-03-02,Hai Phong City,Ngo Quyen District,16,130,117,13,0
2022-03-02,Hai Phong City,Ngo Quyen District,17,162,149,13,2
2022-03-02,Hai Phong City,Ngo Quyen District,18,168,146,22,5
2022-03-02,Hai Phong City,Ngo Quyen District,19,153,129,24,2
2022-03-02,Hai Phong City,Ngo Quyen District,20,85,75,10,1
2022-03-02,Hai Phong City,Ngo Quyen District,21,51,32,19,1
2022-03-02,Hai Phong City,Ngo Quyen District,23,2,2,0,0
2022-03-02,Hai Phong City,Thuy Nguyen,11,2,0,2,2
2022-03-02,Hai Phong City,Thuy Nguyen,13,1,0,1,0
2022-03-02,Hai Phong City,Thuy Nguyen,14,2,0,2,2
2022-03-02,Hai Phong City,Thuy Nguyen,15,1,0,1,1
2022-03-02,Hai Phong City,Thuy Nguyen,16,2,0,2,1
2022-03-02,Hai Phong City,Thuy Nguyen,17,2,1,1,1
2022-03-02,Hai Phong City,Thuy Nguyen,19,2,0,2,1
2022-03-02,Hue City,Hue City,0,5,5,0,0
2022-03-02,Hue City,Hue City,2,3,3,0,0
2022-03-02,Hue City,Hue City,3,2,2,0,0
2022-03-02,Hue City,Hue City,5,1,1,0,0
2022-03-02,Hue City,Hue City,6,50,45,5,0
2022-03-02,Hue City,Hue City,7,205,194,11,0
2022-03-02,Hue City,Hue City,8,286,275,11,0
2022-03-02,Hue City,Hue City,9,214,198,16,0
2022-03-02,Hue City,Hue City,10,320,305,15,1
2022-03-02,Hue City,Hue City,11,738,691,47,11
2022-03-02,Hue City,Hue City,12,402,384,18,0
2022-03-02,Hue City,Hue City,13,268,252,16,1
2022-03-02,Hue City,Hue City,14,327,293,34,2
2022-03-02,Hue City,Hue City,15,374,356,18,1
2022-03-02,Hue City,Hue City,16,399,365,34,0
2022-03-02,Hue City,Hue City,17,593,546,47,1
2022-03-02,Hue City,Hue City,18,594,543,51,4
2022-03-02,Hue City,Hue City,19,524,478,46,5
2022-03-02,Hue City,Hue City,20,410,364,46,3
2022-03-02,Hue City,Hue City,21,207,175,32,6
2022-03-02,Hue City,Hue City,22,4,2,2,0
2022-03-02,Hue City,Hue City,23,2,1,1,0
2022-03-02,Hue City,Huong Thuy,11,1,1,0,0
2022-03-02,Hue City,Huong Thuy,12,1,1,0,0
2022-03-02,Hue City,Huong Thuy,13,2,1,1,0
2022-03-02,Hue City,Huong Thuy,16,2,2,0,0
2022-03-02,Hue City,Huong Thuy,17,1,1,0,0
2022-03-02,Hue City,Huong Thuy,18,1,1,0,0
2022-03-02,Hue City,Huong Thuy,19,4,1,3,3
2022-03-02,Hue City,Huong Thuy,20,1,1,0,0
2022-03-02,Hue City,Huong Thuy,21,1,1,0,0
2022-03-02,Hue City,Huong Tra,10,1,1,0,0
2022-03-02,Hue City,Huong Tra,19,2,2,0,0
2022-03-02,Hue City,Huong Tra,20,2,2,0,0
2022-03-02,Hue City,Phu Vang,7,1,0,1,0
2022-03-02,Hue City,Phu Vang,8,2,1,1,1
2022-03-02,Hue City,Phu Vang,9,1,0,1,0
2022-03-02,Hue City,Phu Vang,10,1,0,1,0
2022-03-02,Hue City,Phu Vang,11,3,0,3,2
2022-03-02,Hue City,Phu Vang,13,2,2,0,0
2022-03-02,Hue City,Phu Vang,14,1,1,0,0
2022-03-02,Hue City,Phu Vang,15,2,2,0,0
2022-03-02,Hue City,Phu Vang,17,3,1,2,1
2022-03-02,Hue City,Phu Vang,18,1,1,0,0
2022-03-02,Vung Tau,Ba Ria City,8,3,0,3,2
2022-03-02,Vung Tau,Ba Ria City,9,9,0,9,8
2022-03-02,Vung Tau,Ba Ria City,10,8,0,8,8
2022-03-02,Vung Tau,Ba Ria City,11,8,4,4,3
2022-03-02,Vung Tau,Ba Ria City,12,4,3,1,0
2022-03-02,Vung Tau,Ba Ria City,13,8,6,2,1
2022-03-02,Vung Tau,Ba Ria City,14,3,3,0,0
2022-03-02,Vung Tau,Ba Ria City,15,6,1,5,5
2022-03-02,Vung Tau,Ba Ria City,16,6,6,0,0
2022-03-02,Vung Tau,Ba Ria City,17,10,4,6,5
2022-03-02,Vung Tau,Ba Ria City,18,10,2,8,6
2022-03-02,Vung Tau,Ba Ria City,19,3,3,0,0
2022-03-02,Vung Tau,Ba Ria City,22,1,0,1,1
2022-03-02,Vung Tau,Tan Thanh,11,1,0,1,1
2022-03-02,Vung Tau,Tan Thanh,19,1,0,1,1
2022-03-02,Vung Tau,Vung Tau City,1,1,0,1,0
2022-03-02,Vung Tau,Vung Tau City,2,1,1,0,0
2022-03-02,Vung Tau,Vung Tau City,4,2,2,0,0
2022-03-02,Vung Tau,Vung Tau City,6,30,26,4,2
2022-03-02,Vung Tau,Vung Tau City,7,99,89,10,1
2022-03-02,Vung Tau,Vung Tau City,8,128,117,11,3
2022-03-02,Vung Tau,Vung Tau City,9,114,107,7,2
2022-03-02,Vung Tau,Vung Tau City,10,165,138,27,5
2022-03-02,Vung Tau,Vung Tau City,11,296,278,18,2
2022-03-02,Vung Tau,Vung Tau City,12,244,232,12,3
2022-03-02,Vung Tau,Vung Tau City,13,171,162,9,0
2022-03-02,Vung Tau,Vung Tau City,14,198,178,20,4
2022-03-02,Vung Tau,Vung Tau City,15,174,156,18,0
2022-03-02,Vung Tau,Vung Tau City,16,152,142,10,0
2022-03-02,Vung Tau,Vung Tau City,17,242,223,19,1
2022-03-02,Vung Tau,Vung Tau City,18,277,254,23,0
2022-03-02,Vung Tau,Vung Tau City,19,196,178,18,1
2022-03-02,Vung Tau,Vung Tau City,20,136,123,13,2
2022-03-02,Vung Tau,Vung Tau City,21,81,46,35,15
2022-03-02,Vung Tau,Vung Tau City,22,2,1,1,1
2022-03-02,Vung Tau,Vung Tau City,23,1,1,0,0
2022-03-03,Binh Duong,Ben Cat,9,1,0,1,1
2022-03-03,Binh Duong,Ben Cat,11,1,0,1,1
2022-03-03,Binh Duong,Ben Cat,12,1,0,1,1
2022-03-03,Binh Duong,Ben Cat,16,1,0,1,1
2022-03-03,Binh Duong,Ben Cat,18,2,1,1,1
2022-03-03,Binh Duong,Ben Cat,19,2,0,2,2
2022-03-03,Binh Duong,Ben Cat,20,3,0,3,2
2022-03-03,Binh Duong,Di An,0,1,0,1,0
2022-03-03,Binh Duong,Di An,1,3,3,0,0
2022-03-03,Binh Duong,Di An,6,6,0,6,5
2022-03-03,Binh Duong,Di An,7,4,0,4,4
2022-03-03,Binh Duong,Di An,8,12,1,11,10
2022-03-03,Binh Duong,Di An,9,21,7,14,12
2022-03-03,Binh Duong,Di An,10,19,4,15,11
2022-03-03,Binh Duong,Di An,11,19,5,14,11
2022-03-03,Binh Duong,Di An,12,31,11,20,16
2022-03-03,Binh Duong,Di An,13,20,15,5,4
2022-03-03,Binh Duong,Di An,14,24,14,10,10
2022-03-03,Binh Duong,Di An,15,23,8,15,12
2022-03-03,Binh Duong,Di An,16,29,12,17,17
2022-03-03,Binh Duong,Di An,17,25,8,17,15
2022-03-03,Binh Duong,Di An,18,13,10,3,3
2022-03-03,Binh Duong,Di An,19,15,10,5,4
2022-03-03,Binh Duong,Di An,20,6,3,3,2
2022-03-03,Binh Duong,Di An,21,2,0,2,1
2022-03-03,Binh Duong,Tan Uyen,6,1,0,1,1
2022-03-03,Binh Duong,Tan Uyen,9,2,0,2,1
2022-03-03,Binh Duong,Tan Uyen,10,1,1,0,0
2022-03-03,Binh Duong,Tan Uyen,11,1,1,0,0
2022-03-03,Binh Duong,Tan Uyen,12,1,0,1,0
2022-03-03,Binh Duong,Tan Uyen,13,4,0,4,3
2022-03-03,Binh Duong,Tan Uyen,14,1,0,1,0
2022-03-03,Binh Duong,Tan Uyen,15,3,1,2,2
2022-03-03,Binh Duong,Tan Uyen,16,1,1,0,0
2022-03-03,Binh Duong,Tan Uyen,17,1,0,1,1
2022-03-03,Binh Duong,Tan Uyen,18,2,1,1,1
2022-03-03,Binh Duong,Tan Uyen,19,1,0,1,1
2022-03-03,Binh Duong,Thu Dau Mot Town,0,2,0,2,0
2022-03-03,Binh Duong,Thu Dau Mot Town,2,1,0,1,0
2022-03-03,Binh Duong,Thu Dau Mot Town,6,39,27,12,9
2022-03-03,Binh Duong,Thu Dau Mot Town,7,111,100,11,2
2022-03-03,Binh Duong,Thu Dau Mot Town,8,194,187,7,2
2022-03-03,Binh Duong,Thu Dau Mot Town,9,216,201,15,2
2022-03-03,Binh Duong,Thu Dau Mot Town,10,371,349,22,2
2022-03-03,Binh Duong,Thu Dau Mot Town,11,608,566,42,10
2022-03-03,Binh Duong,Thu Dau Mot Town,12,393,362,31,14
2022-03-03,Binh Duong,Thu Dau Mot Town,13,397,370,27,8
2022-03-03,Binh Duong,Thu Dau Mot Town,14,323,310,13,2
2022-03-03,Binh Duong,Thu Dau Mot Town,15,295,279,16,1
2022-03-03,Binh Duong,Thu Dau Mot Town,16,268,251,17,2
2022-03-03,Binh Duong,Thu Dau Mot Town,17,392,362,30,4
2022-03-03,Binh Duong,Thu Dau Mot Town,18,350,326,24,2
2022-03-03,Binh Duong,Thu Dau Mot Town,19,295,276,19,5
2022-03-03,Binh Duong,Thu Dau Mot Town,20,215,185,30,5
2022-03-03,Binh Duong,Thu Dau Mot Town,21,85,65,20,4
2022-03-03,Binh Duong,Thu Dau Mot Town,22,4,0,4,0
2022-03-03,Binh Duong,Thu Dau Mot Town,23,1,1,0,0
2022-03-03,Binh Duong,Thuan An,6,2,0,2,2
2022-03-03,Binh Duong,Thuan An,7,7,1,6,4
2022-03-03,Binh Duong,Thuan An,8,24,9,15,13
2022-03-03,Binh Duong,Thuan An,9,30,16,14,10
2022-03-03,Binh Duong,Thuan An,10,52,33,19,12
2022-03-03,Binh Duong,Thuan An,11,48,33,15,11
2022-03-03,Binh Duong,Thuan An,12,58,36,22,18
2022-03-03,Binh Duong,Thuan An,13,51,32,19,16
2022-03-03,Binh Duong,Thuan An,14,67,25,42,30
2022-03-03,Binh Duong,Thuan An,15,35,18,17,13
2022-03-03,Binh Duong,Thuan An,16,33,13,20,16
2022-03-03,Binh Duong,Thuan An,17,50,29,21,17
2022-03-03,Binh Duong,Thuan An,18,25,21,4,1
2022-03-03,Binh Duong,Thuan An,19,29,19,10,10
2022-03-03,Binh Duong,Thuan An,20,21,10,11,6
2022-03-03,Binh Duong,Thuan An,21,8,1,7,4
2022-03-03,Can Tho City,Binh Thuy District,5,1,0,1,1
2022-03-03,Can Tho City,Binh Thuy District,6,2,2,0,0
2022-03-03,Can Tho City,Binh Thuy District,7,1,1,0,0
2022-03-03,Can Tho City,Binh Thuy District,8,1,1,0,0
2022-03-03,Can Tho City,Binh Thuy District,9,5,5,0,0
2022-03-03,Can Tho City,Binh Thuy District,10,11,9,2,0
2022-03-03,Can Tho City,Binh Thuy District,11,6,6,0,0
2022-03-03,Can Tho City,Binh Thuy District,12,10,10,0,0
2022-03-03,Can Tho City,Binh Thuy District,13,5,4,1,0
2022-03-03,Can Tho City,Binh Thuy District,14,7,7,0,0
2022-03-03,Can Tho City,Binh Thuy District,15,6,6,0,0
2022-03-03,Can Tho City,Binh Thuy District,16,8,7,1,0
2022-03-03,Can Tho City,Binh Thuy District,17,8,6,2,0
2022-03-03,Can Tho City,Binh Thuy District,18,11,8,3,2
2022-03-03,Can Tho City,Binh Thuy District,19,7,6,1,0
2022-03-03,Can Tho City,Binh Thuy District,20,10,10,0,0
2022-03-03,Can Tho City,Binh Thuy District,21,2,2,0,0
2022-03-03,Can Tho City,Cai Rang District,0,2,1,1,0
2022-03-03,Can Tho City,Cai Rang District,7,1,1,0,0
2022-03-03,Can Tho City,Cai Rang District,8,4,2,2,0
2022-03-03,Can Tho City,Cai Rang District,9,3,2,1,0
2022-03-03,Can Tho City,Cai Rang District,10,9,8,1,0
2022-03-03,Can Tho City,Cai Rang District,11,11,11,0,0
2022-03-03,Can Tho City,Cai Rang District,12,5,5,0,0
2022-03-03,Can Tho City,Cai Rang District,13,7,7,0,0
2022-03-03,Can Tho City,Cai Rang District,14,10,8,2,2
2022-03-03,Can Tho City,Cai Rang District,15,11,10,1,0
2022-03-03,Can Tho City,Cai Rang District,16,9,8,1,0
2022-03-03,Can Tho City,Cai Rang District,17,7,7,0,0
2022-03-03,Can Tho City,Cai Rang District,18,11,11,0,0
2022-03-03,Can Tho City,Cai Rang District,19,10,10,0,0
2022-03-03,Can Tho City,Cai Rang District,20,9,9,0,0
2022-03-03,Can Tho City,Cai Rang District,21,2,0,2,1
2022-03-03,Can Tho City,Ninh Kieu District,0,9,6,3,0
2022-03-03,Can Tho City,Ninh Kieu District,1,2,2,0,0
2022-03-03,Can Tho City,Ninh Kieu District,2,1,1,0,0
2022-03-03,Can Tho City,Ninh Kieu District,3,2,0,2,0
2022-03-03,Can Tho City,Ninh Kieu District,5,2,0,2,1
2022-03-03,Can Tho City,Ninh Kieu District,6,49,44,5,2
2022-03-03,Can Tho City,Ninh Kieu District,7,103,98,5,0
2022-03-03,Can Tho City,Ninh Kieu District,8,230,210,20,0
2022-03-03,Can Tho City,Ninh Kieu District,9,289,268,21,0
2022-03-03,Can Tho City,Ninh Kieu District,10,525,505,20,0
2022-03-03,Can Tho City,Ninh Kieu District,11,776,729,47,6
2022-03-03,Can Tho City,Ninh Kieu District,12,528,511,17,0
2022-03-03,Can Tho City,Ninh Kieu District,13,387,368,19,0
2022-03-03,Can Tho City,Ninh Kieu District,14,349,332,17,0
2022-03-03,Can Tho City,Ninh Kieu District,15,280,267,13,0
2022-03-03,Can Tho City,Ninh Kieu District,16,398,376,22,1
2022-03-03,Can Tho City,Ninh Kieu District,17,517,492,25,0
2022-03-03,Can Tho City,Ninh Kieu District,18,496,474,22,0
2022-03-03,Can Tho City,Ninh Kieu District,19,414,394,20,0
2022-03-03,Can Tho City,Ninh Kieu District,20,286,273,13,0
2022-03-03,Can Tho City,Ninh Kieu District,21,144,128,16,0
2022-03-03,Dong Nai,Bien Hoa City,0,14,9,5,0
2022-03-03,Dong Nai,Bien Hoa City,3,1,1,0,0
2022-03-03,Dong Nai,Bien Hoa City,4,1,1,0,0
2022-03-03,Dong Nai,Bien Hoa City,5,1,0,1,1
2022-03-03,Dong Nai,Bien Hoa City,6,31,17,14,9
2022-03-03,Dong Nai,Bien Hoa City,7,165,133,32,20
2022-03-03,Dong Nai,Bien Hoa City,8,285,246,39,11
2022-03-03,Dong Nai,Bien Hoa City,9,360,319,41,9
2022-03-03,Dong Nai,Bien Hoa City,10,741,649,92,25
2022-03-03,Dong Nai,Bien Hoa City,11,1025,883,142,59
2022-03-03,Dong Nai,Bien Hoa City,12,746,681,65,11
2022-03-03,Dong Nai,Bien Hoa City,13,720,654,66,20
2022-03-03,Dong Nai,Bien Hoa City,14,633,575,58,21
2022-03-03,Dong Nai,Bien Hoa City,15,445,400,45,10
2022-03-03,Dong Nai,Bien Hoa City,16,440,393,47,15
2022-03-03,Dong Nai,Bien Hoa City,17,581,523,58,18
2022-03-03,Dong Nai,Bien Hoa City,18,618,557,61,7
2022-03-03,Dong Nai,Bien Hoa City,19,557,477,80,19
2022-03-03,Dong Nai,Bien Hoa City,20,428,356,72,27
2022-03-03,Dong Nai,Bien Hoa City,21,185,128,57,23
2022-03-03,Dong Nai,Bien Hoa City,22,5,3,2,0
2022-03-03,Dong Nai,Bien Hoa City,23,1,0,1,1
2022-03-03,Dong Nai,Long Khanh,16,1,0,1,1
2022-03-03,Dong Nai,Long Thanh,9,1,0,1,1
2022-03-03,Dong Nai,Long Thanh,10,2,0,2,2
2022-03-03,Dong Nai,Long Thanh,11,5,0,5,4
2022-03-03,Dong Nai,Long Thanh,12,1,0,1,1
2022-03-03,Dong Nai,Long Thanh,13,2,0,2,2
2022-03-03,Dong Nai,Long Thanh,14,5,0,5,3
2022-03-03,Dong Nai,Long Thanh,15,3,0,3,3
2022-03-03,Dong Nai,Long Thanh,17,1,0,1,1
2022-03-03,Dong Nai,Long Thanh,18,1,0,1,1
2022-03-03,Dong Nai,Long Thanh,19,2,0,2,2
2022-03-03,Dong Nai,Nhon trach,20,1,0,1,1
2022-03-03,Dong Nai,Thong Nhat,9,3,3,0,0
2022-03-03,Dong Nai,Thong Nhat,10,3,3,0,0
2022-03-03,Dong Nai,Thong Nhat,17,1,1,0,0
2022-03-03,Dong Nai,Thong Nhat,18,1,1,0,0
2022-03-03,Dong Nai,Thong Nhat,20,2,2,0,0
2022-03-03,Dong Nai,Thong Nhat,21,1,1,0,0
2022-03-03,Dong Nai,Trang Bom,12,1,0,1,1
2022-03-03,Dong Nai,Trang Bom,21,1,0,1,1
2022-03-03,Hai Phong City,An Duong,7,1,1,0,0
2022-03-03,Hai Phong City,An Duong,8,5,3,2,0
2022-03-03,Hai Phong City,An Duong,9,6,0,6,1
2022-03-03,Hai Phong City,An Duong,10,3,2,1,1
2022-03-03,Hai Phong City,An Duong,11,9,3,6,3
2022-03-03,Hai Phong City,An Duong,12,7,3,4,3
2022-03-03,Hai Phong City,An Duong,13,6,4,2,2
2022-03-03,Hai Phong City,An Duong,14,9,2,7,4
2022-03-03,Hai Phong City,An Duong,15,1,1,0,0
2022-03-03,Hai Phong City,An Duong,16,1,1,0,0
2022-03-03,Hai Phong City,An Duong,17,5,3,2,0
2022-03-03,Hai Phong City,An Duong,18,2,1,1,0
2022-03-03,Hai Phong City,An Duong,19,1,0,1,1
2022-03-03,Hai Phong City,An Duong,20,1,0,1,1
2022-03-03,Hai Phong City,An Duong,21,2,0,2,0
2022-03-03,Hai Phong City,An Duong,23,1,0,1,0
2022-03-03,Hai Phong City,Duong Kinh District,12,2,0,2,1
2022-03-03,Hai Phong City,Duong Kinh District,15,1,0,1,1
2022-03-03,Hai Phong City,Hai An District,6,1,1,0,0
2022-03-03,Hai Phong City,Hai An District,7,9,8,1,1
2022-03-03,Hai Phong City,Hai An District,8,15,10,5,1
2022-03-03,Hai Phong City,Hai An District,9,8,6,2,1
2022-03-03,Hai Phong City,Hai An District,10,11,10,1,0
2022-03-03,Hai Phong City,Hai An District,11,41,37,4,1
2022-03-03,Hai Phong City,Hai An District,12,23,17,6,1
2022-03-03,Hai Phong City,Hai An District,13,17,14,3,1
2022-03-03,Hai Phong City,Hai An District,14,20,17,3,1
2022-03-03,Hai Phong City,Hai An District,15,23,16,7,1
2022-03-03,Hai Phong City,Hai An District,16,18,14,4,0
2022-03-03,Hai Phong City,Hai An District,17,21,20,1,1
2022-03-03,Hai Phong City,Hai An District,18,27,23,4,0
2022-03-03,Hai Phong City,Hai An District,19,14,13,1,0
2022-03-03,Hai Phong City,Hai An District,20,24,17,7,3
2022-03-03,Hai Phong City,Hai An District,21,7,3,4,2
2022-03-03,Hai Phong City,Hong Bang District,6,5,3,2,0
2022-03-03,Hai Phong City,Hong Bang District,7,12,8,4,4
2022-03-03,Hai Phong City,Hong Bang District,8,19,16,3,2
2022-03-03,Hai Phong City,Hong Bang District,9,26,22,4,1
2022-03-03,Hai Phong City,Hong Bang District,10,69,55,14,1
2022-03-03,Hai Phong City,Hong Bang District,11,107,88,19,9
2022-03-03,Hai Phong City,Hong Bang District,12,32,30,2,1
2022-03-03,Hai Phong City,Hong Bang District,13,35,34,1,0
2022-03-03,Hai Phong City,Hong Bang District,14,48,39,9,1
2022-03-03,Hai Phong City,Hong Bang District,15,70,50,20,8
2022-03-03,Hai Phong City,Hong Bang District,16,48,40,8,3
2022-03-03,Hai Phong City,Hong Bang District,17,37,29,8,5
2022-03-03,Hai Phong City,Hong Bang District,18,63,53,10,1
2022-03-03,Hai Phong City,Hong Bang District,19,42,35,7,2
2022-03-03,Hai Phong City,Hong Bang District,20,31,27,4,2
2022-03-03,Hai Phong City,Hong Bang District,21,11,5,6,2
2022-03-03,Hai Phong City,Hong Bang District,23,1,0,1,0
2022-03-03,Hai Phong City,Kien An District,0,3,3,0,0
2022-03-03,Hai Phong City,Kien An District,2,1,1,0,0
2022-03-03,Hai Phong City,Kien An District,7,3,0,3,3
2022-03-03,Hai Phong City,Kien An District,8,1,1,0,0
2022-03-03,Hai Phong City,Kien An District,9,6,5,1,1
2022-03-03,Hai Phong City,Kien An District,10,8,6,2,1
2022-03-03,Hai Phong City,Kien An District,11,17,13,4,4
2022-03-03,Hai Phong City,Kien An District,12,13,7,6,3
2022-03-03,Hai Phong City,Kien An District,13,8,6,2,0
2022-03-03,Hai Phong City,Kien An District,14,5,3,2,2
2022-03-03,Hai Phong City,Kien An District,15,5,4,1,0
2022-03-03,Hai Phong City,Kien An District,16,13,8,5,0
2022-03-03,Hai Phong City,Kien An District,17,12,8,4,1
2022-03-03,Hai Phong City,Kien An District,18,13,12,1,0
2022-03-03,Hai Phong City,Kien An District,19,3,3,0,0
2022-03-03,Hai Phong City,Kien An District,20,9,5,4,2
2022-03-03,Hai Phong City,Kien An District,21,1,0,1,0
2022-03-03,Hai Phong City,Le Chan District,0,8,5,3,0
2022-03-03,Hai Phong City,Le Chan District,1,4,3,1,0
2022-03-03,Hai Phong City,Le Chan District,2,2,1,1,0
2022-03-03,Hai Phong City,Le Chan District,3,2,2,0,0
2022-03-03,Hai Phong City,Le Chan District,4,1,1,0,0
2022-03-03,Hai Phong City,Le Chan District,5,1,1,0,0
2022-03-03,Hai Phong City,Le Chan District,6,4,2,2,1
2022-03-03,Hai Phong City,Le Chan District,7,43,36,7,4
2022-03-03,Hai Phong City,Le Chan District,8,90,69,21,7
2022-03-03,Hai Phong City,Le Chan District,9,89,72,17,3
2022-03-03,Hai Phong City,Le Chan District,10,164,154,10,3
2022-03-03,Hai Phong City,Le Chan District,11,288,243,45,23
2022-03-03,Hai Phong City,Le Chan District,12,182,159,23,4
2022-03-03,Hai Phong City,Le Chan District,13,129,110,19,2
2022-03-03,Hai Phong City,Le Chan District,14,147,122,25,9
2022-03-03,Hai Phong City,Le Chan District,15,215,176,39,19
2022-03-03,Hai Phong City,Le Chan District,16,187,161,26,11
2022-03-03,Hai Phong City,Le Chan District,17,223,187,36,6
2022-03-03,Hai Phong City,Le Chan District,18,243,202,41,15
2022-03-03,Hai Phong City,Le Chan District,19,209,182,27,7
2022-03-03,Hai Phong City,Le Chan District,20,123,103,20,3
2022-03-03,Hai Phong City,Le Chan District,21,60,44,16,9
2022-03-03,Hai Phong City,Le Chan District,23,1,1,0,0
2022-03-03,Hai Phong City,Ngo Quyen District,0,4,3,1,0
2022-03-03,Hai Phong City,Ngo Quyen District,1,1,1,0,0
2022-03-03,Hai Phong City,Ngo Quyen District,2,1,0,1,1
2022-03-03,Hai Phong City,Ngo Quyen District,3,3,3,0,0
2022-03-03,Hai Phong City,Ngo Quyen District,4,4,1,3,2
2022-03-03,Hai Phong City,Ngo Quyen District,5,2,0,2,1
2022-03-03,Hai Phong City,Ngo Quyen District,6,3,2,1,1
2022-03-03,Hai Phong City,Ngo Quyen District,7,30,22,8,4
2022-03-03,Hai Phong City,Ngo Quyen District,8,75,61,14,9
2022-03-03,Hai Phong City,Ngo Quyen District,9,57,49,8,2
2022-03-03,Hai Phong City,Ngo Quyen District,10,148,130,18,1
2022-03-03,Hai Phong City,Ngo Quyen District,11,231,191,40,18
2022-03-03,Hai Phong City,Ngo Quyen District,12,147,135,12,2
2022-03-03,Hai Phong City,Ngo Quyen District,13,95,91,4,0
2022-03-03,Hai Phong City,Ngo Quyen District,14,154,139,15,3
2022-03-03,Hai Phong City,Ngo Quyen District,15,158,128,30,14
2022-03-03,Hai Phong City,Ngo Quyen District,16,165,139,26,7
2022-03-03,Hai Phong City,Ngo Quyen District,17,194,161,33,8
2022-03-03,Hai Phong City,Ngo Quyen District,18,181,153,28,5
2022-03-03,Hai Phong City,Ngo Quyen District,19,157,132,25,9
2022-03-03,Hai Phong City,Ngo Quyen District,20,111,92,19,8
2022-03-03,Hai Phong City,Ngo Quyen District,21,55,40,15,6
2022-03-03,Hai Phong City,Ngo Quyen District,22,2,1,1,0
2022-03-03,Hai Phong City,Ngo Quyen District,23,2,1,1,0
2022-03-03,Hai Phong City,Thuy Nguyen,9,1,0,1,0
2022-03-03,Hai Phong City,Thuy Nguyen,10,1,0,1,1
2022-03-03,Hai Phong City,Thuy Nguyen,15,1,0,1,1
2022-03-03,Hai Phong City,Thuy Nguyen,18,1,0,1,1
2022-03-03,Hue City,Hue City,0,28,24,4,1
2022-03-03,Hue City,Hue City,1,22,19,3,0
2022-03-03,Hue City,Hue City,2,5,4,1,0
2022-03-03,Hue City,Hue City,4,4,4,0,0
2022-03-03,Hue City,Hue City,5,2,1,1,1
2022-03-03,Hue City,Hue City,6,67,58,9,1
2022-03-03,Hue City,Hue City,7,194,171,23,0
2022-03-03,Hue City,Hue City,8,317,289,28,3
2022-03-03,Hue City,Hue City,9,233,211,22,0
2022-03-03,Hue City,Hue City,10,420,384,36,5
2022-03-03,Hue City,Hue City,11,795,725,70,11
2022-03-03,Hue City,Hue City,12,428,396,32,0
2022-03-03,Hue City,Hue City,13,296,269,27,2
2022-03-03,Hue City,Hue City,14,338,313,25,1
2022-03-03,Hue City,Hue City,15,380,342,38,2
2022-03-03,Hue City,Hue City,16,437,415,22,1
2022-03-03,Hue City,Hue City,17,548,513,35,2
2022-03-03,Hue City,Hue City,18,623,587,36,2
2022-03-03,Hue City,Hue City,19,525,469,56,3
2022-03-03,Hue City,Hue City,20,417,364,53,4
2022-03-03,Hue City,Hue City,21,240,205,35,8
2022-03-03,Hue City,Hue City,22,4,2,2,0
2022-03-03,Hue City,Huong Thuy,8,1,1,0,0
2022-03-03,Hue City,Huong Thuy,10,2,1,1,0
2022-03-03,Hue City,Huong Thuy,13,2,1,1,0
2022-03-03,Hue City,Huong Thuy,15,1,0,1,0
2022-03-03,Hue City,Huong Thuy,17,1,1,0,0
2022-03-03,Hue City,Huong Thuy,18,2,2,0,0
2022-03-03,Hue City,Huong Thuy,20,1,1,0,0
2022-03-03,Hue City,Huong Thuy,21,1,1,0,0
2022-03-03,Hue City,Huong Tra,18,2,1,1,0
2022-03-03,Hue City,Huong Tra,19,1,0,1,0
2022-03-03,Hue City,Huong Tra,20,2,1,1,0
2022-03-03,Hue City,Phu Vang,7,1,0,1,0
2022-03-03,Hue City,Phu Vang,8,3,2,1,0
2022-03-03,Hue City,Phu Vang,10,3,2,1,1
2022-03-03,Hue City,Phu Vang,11,5,5,0,0
2022-03-03,Hue City,Phu Vang,12,4,2,2,0
2022-03-03,Hue City,Phu Vang,14,2,1,1,0
2022-03-03,Hue City,Phu Vang,17,5,5,0,0
2022-03-03,Hue City,Phu Vang,18,8,6,2,0
2022-03-03,Hue City,Phu Vang,19,4,3,1,1
2022-03-03,Hue City,Phu Vang,20,1,0,1,0
2022-03-03,Hue City,Phu Vang,21,1,0,1,1
2022-03-03,Vung Tau,Ba Ria City,6,2,0,2,0
2022-03-03,Vung Tau,Ba Ria City,7,8,2,6,2
2022-03-03,Vung Tau,Ba Ria City,8,2,0,2,2
2022-03-03,Vung Tau,Ba Ria City,9,5,4,1,1
2022-03-03,Vung Tau,Ba Ria City,10,11,5,6,6
2022-03-03,Vung Tau,Ba Ria City,11,4,4,0,0
2022-03-03,Vung Tau,Ba Ria City,12,12,6,6,2
2022-03-03,Vung Tau,Ba Ria City,13,5,4,1,0
2022-03-03,Vung Tau,Ba Ria City,14,4,3,1,1
2022-03-03,Vung Tau,Ba Ria City,15,8,5,3,2
2022-03-03,Vung Tau,Ba Ria City,16,2,2,0,0
2022-03-03,Vung Tau,Ba Ria City,17,2,2,0,0
2022-03-03,Vung Tau,Ba Ria City,18,3,3,0,0
2022-03-03,Vung Tau,Ba Ria City,19,2,1,1,1
2022-03-03,Vung Tau,Ba Ria City,20,4,0,4,3
2022-03-03,Vung Tau,Tan Thanh,10,2,0,2,2
2022-03-03,Vung Tau,Tan Thanh,11,1,0,1,1
2022-03-03,Vung Tau,Vung Tau City,0,1,1,0,0
2022-03-03,Vung Tau,Vung Tau City,1,1,1,0,0
2022-03-03,Vung Tau,Vung Tau City,2,1,0,1,0
2022-03-03,Vung Tau,Vung Tau City,5,2,1,1,1
2022-03-03,Vung Tau,Vung Tau City,6,46,30,16,14
2022-03-03,Vung Tau,Vung Tau City,7,103,90,13,0
2022-03-03,Vung Tau,Vung Tau City,8,139,126,13,3
2022-03-03,Vung Tau,Vung Tau City,9,146,131,15,0
2022-03-03,Vung Tau,Vung Tau City,10,173,153,20,4
2022-03-03,Vung Tau,Vung Tau City,11,337,310,27,7
2022-03-03,Vung Tau,Vung Tau City,12,199,185,14,0
2022-03-03,Vung Tau,Vung Tau City,13,164,154,10,1
2022-03-03,Vung Tau,Vung Tau City,14,183,172,11,1
2022-03-03,Vung Tau,Vung Tau City,15,190,176,14,1
2022-03-03,Vung Tau,Vung Tau City,16,221,196,25,6
2022-03-03,Vung Tau,Vung Tau City,17,273,257,16,0
2022-03-03,Vung Tau,Vung Tau City,18,300,273,27,3
2022-03-03,Vung Tau,Vung Tau City,19,245,224,21,0
2022-03-03,Vung Tau,Vung Tau City,20,149,137,12,1
2022-03-03,Vung Tau,Vung Tau City,21,75,63,12,2
2022-03-03,Vung Tau,Vung Tau City,22,2,1,1,0
2022-03-03,Vung Tau,Vung Tau City,23,1,1,0,0
2022-03-04,Binh Duong,Ben Cat,11,1,1,0,0
2022-03-04,Binh Duong,Ben Cat,17,1,0,1,1
2022-03-04,Binh Duong,Ben Cat,18,1,0,1,1
2022-03-04,Binh Duong,Di An,6,1,0,1,1
2022-03-04,Binh Duong,Di An,7,11,0,11,6
2022-03-04,Binh Duong,Di An,8,11,0,11,10
2022-03-04,Binh Duong,Di An,9,18,3,15,15
2022-03-04,Binh Duong,Di An,10,23,5,18,17
2022-03-04,Binh Duong,Di An,11,50,10,40,30
2022-03-04,Binh Duong,Di An,12,44,13,31,28
2022-03-04,Binh Duong,Di An,13,20,10,10,9
2022-03-04,Binh Duong,Di An,14,26,7,19,18
2022-03-04,Binh Duong,Di An,15,16,6,10,8
2022-03-04,Binh Duong,Di An,16,14,9,5,4
2022-03-04,Binh Duong,Di An,17,21,9,12,9
2022-03-04,Binh Duong,Di An,18,9,4,5,2
2022-03-04,Binh Duong,Di An,19,19,10,9,7
2022-03-04,Binh Duong,Di An,20,11,5,6,4
2022-03-04,Binh Duong,Di An,21,8,1,7,6
2022-03-04,Binh Duong,Tan Uyen,11,4,2,2,2
2022-03-04,Binh Duong,Tan Uyen,12,2,1,1,0
2022-03-04,Binh Duong,Tan Uyen,13,4,2,2,2
2022-03-04,Binh Duong,Tan Uyen,16,3,1,2,1
2022-03-04,Binh Duong,Tan Uyen,19,6,3,3,3
2022-03-04,Binh Duong,Tan Uyen,20,3,0,3,3
2022-03-04,Binh Duong,Thu Dau Mot Town,0,2,2,0,0
2022-03-04,Binh Duong,Thu Dau Mot Town,2,2,1,1,0
2022-03-04,Binh Duong,Thu Dau Mot Town,6,39,31,8,1
2022-03-04,Binh Duong,Thu Dau Mot Town,7,121,98,23,10
2022-03-04,Binh Duong,Thu Dau Mot Town,8,202,184,18,2
2022-03-04,Binh Duong,Thu Dau Mot Town,9,214,199,15,3
2022-03-04,Binh Duong,Thu Dau Mot Town,10,330,308,22,2
2022-03-04,Binh Duong,Thu Dau Mot Town,11,609,563,46,7
2022-03-04,Binh Duong,Thu Dau Mot Town,12,404,377,27,3
2022-03-04,Binh Duong,Thu Dau Mot Town,13,326,308,18,1
2022-03-04,Binh Duong,Thu Dau Mot Town,14,334,311,23,3
2022-03-04,Binh Duong,Thu Dau Mot Town,15,212,199,13,4
2022-03-04,Binh Duong,Thu Dau Mot Town,16,296,270,26,6
2022-03-04,Binh Duong,Thu Dau Mot Town,17,358,335,23,8
2022-03-04,Binh Duong,Thu Dau Mot Town,18,348,326,22,5
2022-03-04,Binh Duong,Thu Dau Mot Town,19,301,289,12,3
2022-03-04,Binh Duong,Thu Dau Mot Town,20,203,182,21,3
2022-03-04,Binh Duong,Thu Dau Mot Town,21,84,68,16,6
2022-03-04,Binh Duong,Thu Dau Mot Town,22,1,0,1,0
2022-03-04,Binh Duong,Thu Dau Mot Town,23,1,1,0,0
2022-03-04,Binh Duong,Thuan An,2,1,1,0,0
2022-03-04,Binh Duong,Thuan An,6,1,0,1,1
2022-03-04,Binh Duong,Thuan An,7,2,0,2,1
2022-03-04,Binh Duong,Thuan An,8,21,9,12,10
2022-03-04,Binh Duong,Thuan An,9,16,11,5,2
2022-03-04,Binh Duong,Thuan An,10,55,32,23,18
2022-03-04,Binh Duong,Thuan An,11,77,38,39,26
2022-03-04,Binh Duong,Thuan An,12,44,28,16,12
2022-03-04,Binh Duong,Thuan An,13,50,27,23,18
2022-03-04,Binh Duong,Thuan An,14,49,17,32,22
2022-03-04,Binh Duong,Thuan An,15,37,13,24,22
2022-03-04,Binh Duong,Thuan An,16,48,11,37,28
2022-03-04,Binh Duong,Thuan An,17,40,27,13,10
2022-03-04,Binh Duong,Thuan An,18,31,21,10,6
2022-03-04,Binh Duong,Thuan An,19,41,35,6,2
2022-03-04,Binh Duong,Thuan An,20,29,24,5,3
2022-03-04,Binh Duong,Thuan An,21,9,2,7,3
2022-03-04,Can Tho City,Binh Thuy District,6,1,0,1,1
2022-03-04,Can Tho City,Binh Thuy District,7,1,1,0,0
2022-03-04,Can Tho City,Binh Thuy District,8,5,5,0,0
2022-03-04,Can Tho City,Binh Thuy District,9,6,6,0,0
2022-03-04,Can Tho City,Binh Thuy District,10,10,9,1,0
2022-03-04,Can Tho City,Binh Thuy District,11,20,19,1,0
2022-03-04,Can Tho City,Binh Thuy District,12,12,12,0,0
2022-03-04,Can Tho City,Binh Thuy District,13,9,9,0,0
2022-03-04,Can Tho City,Binh Thuy District,14,9,9,0,0
2022-03-04,Can Tho City,Binh Thuy District,15,3,3,0,0
2022-03-04,Can Tho City,Binh Thuy District,16,12,9,3,1
2022-03-04,Can Tho City,Binh Thuy District,17,4,4,0,0
2022-03-04,Can Tho City,Binh Thuy District,18,16,15,1,0
2022-03-04,Can Tho City,Binh Thuy District,19,13,11,2,0
2022-03-04,Can Tho City,Binh Thuy District,20,6,6,0,0
2022-03-04,Can Tho City,Binh Thuy District,21,4,4,0,0
2022-03-04,Can Tho City,Binh Thuy District,22,1,0,1,0
2022-03-04,Can Tho City,Cai Rang District,0,1,0,1,0
2022-03-04,Can Tho City,Cai Rang District,6,1,1,0,0
2022-03-04,Can Tho City,Cai Rang District,7,4,3,1,0
2022-03-04,Can Tho City,Cai Rang District,8,5,4,1,1
2022-03-04,Can Tho City,Cai Rang District,9,3,3,0,0
2022-03-04,Can Tho City,Cai Rang District,10,5,5,0,0
2022-03-04,Can Tho City,Cai Rang District,11,20,15,5,2
2022-03-04,Can Tho City,Cai Rang District,12,10,10,0,0
2022-03-04,Can Tho City,Cai Rang District,13,6,5,1,0
2022-03-04,Can Tho City,Cai Rang District,14,8,7,1,1
2022-03-04,Can Tho City,Cai Rang District,15,4,4,0,0
2022-03-04,Can Tho City,Cai Rang District,16,8,8,0,0
2022-03-04,Can Tho City,Cai Rang District,17,6,6,0,0
2022-03-04,Can Tho City,Cai Rang District,18,10,10,0,0
2022-03-04,Can Tho City,Cai Rang District,19,11,10,1,0
2022-03-04,Can Tho City,Cai Rang District,20,5,5,0,0
2022-03-04,Can Tho City,Cai Rang District,21,3,3,0,0
2022-03-04,Can Tho City,Ninh Kieu District,0,8,6,2,0
2022-03-04,Can Tho City,Ninh Kieu District,1,4,4,0,0
2022-03-04,Can Tho City,Ninh Kieu District,2,1,1,0,0
2022-03-04,Can Tho City,Ninh Kieu District,4,1,1,0,0
2022-03-04,Can Tho City,Ninh Kieu District,5,4,4,0,0
2022-03-04,Can Tho City,Ninh Kieu District,6,30,28,2,1
2022-03-04,Can Tho City,Ninh Kieu District,7,114,105,9,0
2022-03-04,Can Tho City,Ninh Kieu District,8,225,214,11,0
2022-03-04,Can Tho City,Ninh Kieu District,9,287,271,16,0
2022-03-04,Can Tho City,Ninh Kieu District,10,515,490,25,0
2022-03-04,Can Tho City,Ninh Kieu District,11,785,731,54,2
2022-03-04,Can Tho City,Ninh Kieu District,12,522,499,23,2
2022-03-04,Can Tho City,Ninh Kieu District,13,403,375,28,0
2022-03-04,Can Tho City,Ninh Kieu District,14,335,316,19,0
2022-03-04,Can Tho City,Ninh Kieu District,15,286,269,17,0
2022-03-04,Can Tho City,Ninh Kieu District,16,333,313,20,0
2022-03-04,Can Tho City,Ninh Kieu District,17,484,448,36,1
2022-03-04,Can Tho City,Ninh Kieu District,18,449,429,20,0
2022-03-04,Can Tho City,Ninh Kieu District,19,422,406,16,0
2022-03-04,Can Tho City,Ninh Kieu District,20,304,277,27,0
2022-03-04,Can Tho City,Ninh Kieu District,21,160,151,9,0
2022-03-04,Can Tho City,Ninh Kieu District,22,4,2,2,0
2022-03-04,Can Tho City,Ninh Kieu District,23,1,1,0,0
2022-03-04,Dong Nai,Bien Hoa City,0,6,5,1,0
2022-03-04,Dong Nai,Bien Hoa City,1,1,1,0,0
2022-03-04,Dong Nai,Bien Hoa City,3,1,0,1,1
2022-03-04,Dong Nai,Bien Hoa City,4,1,0,1,0
2022-03-04,Dong Nai,Bien Hoa City,5,2,0,2,1
2022-03-04,Dong Nai,Bien Hoa City,6,33,19,14,11
2022-03-04,Dong Nai,Bien Hoa City,7,156,130,26,12
2022-03-04,Dong Nai,Bien Hoa City,8,259,228,31,8
2022-03-04,Dong Nai,Bien Hoa City,9,401,362,39,6
2022-03-04,Dong Nai,Bien Hoa City,10,702,626,76,19
2022-03-04,Dong Nai,Bien Hoa City,11,1048,925,123,32
2022-03-04,Dong Nai,Bien Hoa City,12,748,687,61,10
2022-03-04,Dong Nai,Bien Hoa City,13,728,660,68,6
2022-03-04,Dong Nai,Bien Hoa City,14,562,521,41,6
2022-03-04,Dong Nai,Bien Hoa City,15,437,402,35,6
2022-03-04,Dong Nai,Bien Hoa City,16,489,434,55,18
2022-03-04,Dong Nai,Bien Hoa City,17,623,561,62,25
2022-03-04,Dong Nai,Bien Hoa City,18,673,596,77,13
2022-03-04,Dong Nai,Bien Hoa City,19,577,512,65,19
2022-03-04,Dong Nai,Bien Hoa City,20,403,346,57,14
2022-03-04,Dong Nai,Bien Hoa City,21,182,133,49,22
2022-03-04,Dong Nai,Bien Hoa City,22,3,2,1,0
2022-03-04,Dong Nai,Long Khanh,18,1,0,1,1
2022-03-04,Dong Nai,Long Khanh,19,1,0,1,1
2022-03-04,Dong Nai,Long Thanh,11,2,0,2,2
2022-03-04,Dong Nai,Long Thanh,12,1,0,1,1
2022-03-04,Dong Nai,Long Thanh,13,4,0,4,4
2022-03-04,Dong Nai,Long Thanh,14,2,0,2,2
2022-03-04,Dong Nai,Long Thanh,15,2,0,2,2
2022-03-04,Dong Nai,Long Thanh,16,1,0,1,1
2022-03-04,Dong Nai,Long Thanh,17,1,0,1,0
2022-03-04,Dong Nai,Long Thanh,18,2,0,2,2
2022-03-04,Dong Nai,Long Thanh,19,1,0,1,1
2022-03-04,Dong Nai,Long Thanh,20,1,0,1,1
2022-03-04,Dong Nai,Nhon trach,13,2,0,2,2
2022-03-04,Dong Nai,Thong Nhat,6,1,0,1,0
2022-03-04,Dong Nai,Thong Nhat,9,1,1,0,0
2022-03-04,Dong Nai,Thong Nhat,10,2,2,0,0
2022-03-04,Dong Nai,Thong Nhat,12,4,4,0,0
2022-03-04,Dong Nai,Thong Nhat,13,1,1,0,0
2022-03-04,Dong Nai,Thong Nhat,14,1,1,0,0
2022-03-04,Dong Nai,Thong Nhat,15,1,1,0,0
2022-03-04,Dong Nai,Thong Nhat,17,1,1,0,0
2022-03-04,Dong Nai,Thong Nhat,18,2,2,0,0
2022-03-04,Dong Nai,Thong Nhat,19,1,1,0,0
2022-03-04,Dong Nai,Thong Nhat,20,2,2,0,0
2022-03-04,Dong Nai,Trang Bom,10,1,1,0,0
2022-03-04,Dong Nai,Vinh Cuu,10,1,0,1,1
2022-03-04,Dong Nai,Vinh Cuu,18,2,0,2,2
2022-03-04,Hai Phong City,An Duong,7,1,0,1,1
2022-03-04,Hai Phong City,An Duong,8,3,3,0,0
2022-03-04,Hai Phong City,An Duong,9,3,2,1,0
2022-03-04,Hai Phong City,An Duong,10,3,1,2,1
2022-03-04,Hai Phong City,An Duong,11,4,4,0,0
2022-03-04,Hai Phong City,An Duong,12,6,4,2,2
2022-03-04,Hai Phong City,An Duong,13,6,2,4,4
2022-03-04,Hai Phong City,An Duong,14,5,2,3,0
2022-03-04,Hai Phong City,An Duong,15,6,3,3,3
2022-03-04,Hai Phong City,An Duong,16,3,2,1,1
2022-03-04,Hai Phong City,An Duong,17,6,4,2,0
2022-03-04,Hai Phong City,An Duong,18,3,1,2,1
2022-03-04,Hai Phong City,An Duong,19,2,1,1,0
2022-03-04,Hai Phong City,Do Son District,14,1,0,1,1
2022-03-04,Hai Phong City,Hai An District,1,1,1,0,0
2022-03-04,Hai Phong City,Hai An District,6,2,1,1,1
2022-03-04,Hai Phong City,Hai An District,7,8,7,1,1
2022-03-04,Hai Phong City,Hai An District,8,7,6,1,0
2022-03-04,Hai Phong City,Hai An District,9,13,12,1,0
2022-03-04,Hai Phong City,Hai An District,10,20,17,3,0
2022-03-04,Hai Phong City,Hai An District,11,39,38,1,0
2022-03-04,Hai Phong City,Hai An District,12,18,16,2,0
2022-03-04,Hai Phong City,Hai An District,13,8,6,2,1
2022-03-04,Hai Phong City,Hai An District,14,20,18,2,0
2022-03-04,Hai Phong City,Hai An District,15,16,14,2,1
2022-03-04,Hai Phong City,Hai An District,16,19,16,3,0
2022-03-04,Hai Phong City,Hai An District,17,21,18,3,1
2022-03-04,Hai Phong City,Hai An District,18,27,20,7,2
2022-03-04,Hai Phong City,Hai An District,19,18,16,2,0
2022-03-04,Hai Phong City,Hai An District,20,18,12,6,4
2022-03-04,Hai Phong City,Hai An District,21,17,10,7,2
2022-03-04,Hai Phong City,Hong Bang District,1,2,1,1,0
2022-03-04,Hai Phong City,Hong Bang District,3,1,1,0,0
2022-03-04,Hai Phong City,Hong Bang District,6,2,1,1,1
2022-03-04,Hai Phong City,Hong Bang District,7,12,10,2,1
2022-03-04,Hai Phong City,Hong Bang District,8,29,23,6,1
2022-03-04,Hai Phong City,Hong Bang District,9,14,14,0,0
2022-03-04,Hai Phong City,Hong Bang District,10,56,49,7,0
2022-03-04,Hai Phong City,Hong Bang District,11,114,98,16,4
2022-03-04,Hai Phong City,Hong Bang District,12,63,54,9,2
2022-03-04,Hai Phong City,Hong Bang District,13,31,26,5,2
2022-03-04,Hai Phong City,Hong Bang District,14,38,34,4,2
2022-03-04,Hai Phong City,Hong Bang District,15,43,36,7,2
2022-03-04,Hai Phong City,Hong Bang District,16,53,47,6,3
2022-03-04,Hai Phong City,Hong Bang District,17,44,39,5,3
2022-03-04,Hai Phong City,Hong Bang District,18,53,49,4,0
2022-03-04,Hai Phong City,Hong Bang District,19,54,41,13,5
2022-03-04,Hai Phong City,Hong Bang District,20,33,23,10,4
2022-03-04,Hai Phong City,Hong Bang District,21,12,10,2,1
2022-03-04,Hai Phong City,Hong Bang District,22,1,1,0,0
2022-03-04,Hai Phong City,Hong Bang District,23,1,1,0,0
2022-03-04,Hai Phong City,Kien An District,0,2,2,0,0
2022-03-04,Hai Phong City,Kien An District,7,3,2,1,1
2022-03-04,Hai Phong City,Kien An District,8,4,4,0,0
2022-03-04,Hai Phong City,Kien An District,9,4,3,1,0
2022-03-04,Hai Phong City,Kien An District,10,13,11,2,0
2022-03-04,Hai Phong City,Kien An District,11,15,15,0,0
2022-03-04,Hai Phong City,Kien An District,12,5,4,1,1
2022-03-04,Hai Phong City,Kien An District,13,16,9,7,4
2022-03-04,Hai Phong City,Kien An District,14,9,5,4,4
2022-03-04,Hai Phong City,Kien An District,15,8,6,2,0
2022-03-04,Hai Phong City,Kien An District,16,11,6,5,2
2022-03-04,Hai Phong City,Kien An District,17,7,5,2,1
2022-03-04,Hai Phong City,Kien An District,18,17,8,9,4
2022-03-04,Hai Phong City,Kien An District,19,12,8,4,3
2022-03-04,Hai Phong City,Kien An District,20,8,7,1,0
2022-03-04,Hai Phong City,Kien An District,21,1,1,0,0
2022-03-04,Hai Phong City,Le Chan District,0,2,2,0,0
2022-03-04,Hai Phong City,Le Chan District,1,1,1,0,0
2022-03-04,Hai Phong City,Le Chan District,3,1,1,0,0
2022-03-04,Hai Phong City,Le Chan District,6,2,2,0,0
2022-03-04,Hai Phong City,Le Chan District,7,48,39,9,6
2022-03-04,Hai Phong City,Le Chan District,8,61,52,9,1
2022-03-04,Hai Phong City,Le Chan District,9,82,73,9,1
2022-03-04,Hai Phong City,Le Chan District,10,155,142,13,1
2022-03-04,Hai Phong City,Le Chan District,11,303,256,47,20
2022-03-04,Hai Phong City,Le Chan District,12,184,166,18,5
2022-03-04,Hai Phong City,Le Chan District,13,125,111,14,1
2022-03-04,Hai Phong City,Le Chan District,14,126,114,12,2
2022-03-04,Hai Phong City,Le Chan District,15,152,136,16,0
2022-03-04,Hai Phong City,Le Chan District,16,171,153,18,4
2022-03-04,Hai Phong City,Le Chan District,17,227,194,33,11
2022-03-04,Hai Phong City,Le Chan District,18,257,215,42,11
2022-03-04,Hai Phong City,Le Chan District,19,170,152,18,8
2022-03-04,Hai Phong City,Le Chan District,20,135,107,28,10
2022-03-04,Hai Phong City,Le Chan District,21,64,46,18,7
2022-03-04,Hai Phong City,Le Chan District,22,2,1,1,0
2022-03-04,Hai Phong City,Ngo Quyen District,0,3,3,0,0
2022-03-04,Hai Phong City,Ngo Quyen District,1,3,3,0,0
2022-03-04,Hai Phong City,Ngo Quyen District,3,1,1,0,0
2022-03-04,Hai Phong City,Ngo Quyen District,4,1,0,1,0
2022-03-04,Hai Phong City,Ngo Quyen District,6,2,1,1,0
2022-03-04,Hai Phong City,Ngo Quyen District,7,28,23,5,2
2022-03-04,Hai Phong City,Ngo Quyen District,8,74,61,13,0
2022-03-04,Hai Phong City,Ngo Quyen District,9,67,54,13,1
2022-03-04,Hai Phong City,Ngo Quyen District,10,123,106,17,3
2022-03-04,Hai Phong City,Ngo Quyen District,11,171,151,20,4
2022-03-04,Hai Phong City,Ngo Quyen District,12,111,109,2,0
2022-03-04,Hai Phong City,Ngo Quyen District,13,94,84,10,1
2022-03-04,Hai Phong City,Ngo Quyen District,14,110,105,5,0
2022-03-04,Hai Phong City,Ngo Quyen District,15,147,126,21,3
2022-03-04,Hai Phong City,Ngo Quyen District,16,153,140,13,1
2022-03-04,Hai Phong City,Ngo Quyen District,17,144,126,18,0
2022-03-04,Hai Phong City,Ngo Quyen District,18,165,151,14,4
2022-03-04,Hai Phong City,Ngo Quyen District,19,164,140,24,6
2022-03-04,Hai Phong City,Ngo Quyen District,20,128,106,22,4
2022-03-04,Hai Phong City,Ngo Quyen District,21,63,41,22,14
2022-03-04,Hai Phong City,Ngo Quyen District,22,2,1,1,1
2022-03-04,Hai Phong City,Ngo Quyen District,23,1,1,0,0
2022-03-04,Hai Phong City,Thuy Nguyen,10,1,0,1,1
2022-03-04,Hai Phong City,Thuy Nguyen,11,1,1,0,0
2022-03-04,Hai Phong City,Thuy Nguyen,12,1,1,0,0
2022-03-04,Hai Phong City,Thuy Nguyen,15,1,0,1,1
2022-03-04,Hai Phong City,Thuy Nguyen,18,2,0,2,2
2022-03-04,Hai Phong City,Thuy Nguyen,19,2,0,2,2
2022-03-04,Hue City,Hue City,0,10,7,3,1
2022-03-04,Hue City,Hue City,1,3,2,1,0
2022-03-04,Hue City,Hue City,3,1,0,1,0
2022-03-04,Hue City,Hue City,4,1,1,0,0
2022-03-04,Hue City,Hue City,5,3,2,1,1
2022-03-04,Hue City,Hue City,6,91,75,16,1
2022-03-04,Hue City,Hue City,7,194,173,21,0
2022-03-04,Hue City,Hue City,8,333,312,21,2
2022-03-04,Hue City,Hue City,9,252,221,31,3
2022-03-04,Hue City,Hue City,10,324,305,19,0
2022-03-04,Hue City,Hue City,11,725,667,58,10
2022-03-04,Hue City,Hue City,12,440,406,34,2
2022-03-04,Hue City,Hue City,13,277,264,13,1
2022-03-04,Hue City,Hue City,14,306,280,26,0
2022-03-04,Hue City,Hue City,15,321,306,15,1
2022-03-04,Hue City,Hue City,16,439,413,26,1
2022-03-04,Hue City,Hue City,17,488,466,22,0
2022-03-04,Hue City,Hue City,18,625,576,49,0
2022-03-04,Hue City,Hue City,19,500,457,43,1
2022-03-04,Hue City,Hue City,20,387,350,37,9
2022-03-04,Hue City,Hue City,21,213,165,48,5
2022-03-04,Hue City,Hue City,22,2,1,1,0
2022-03-04,Hue City,Hue City,23,3,3,0,0
2022-03-04,Hue City,Huong Thuy,15,1,1,0,0
2022-03-04,Hue City,Huong Thuy,20,1,1,0,0
2022-03-04,Hue City,Huong Thuy,21,1,0,1,1
2022-03-04,Hue City,Huong Tra,14,1,1,0,0
2022-03-04,Hue City,Huong Tra,19,1,1,0,0
2022-03-04,Hue City,Phu Vang,6,1,0,1,0
2022-03-04,Hue City,Phu Vang,7,2,2,0,0
2022-03-04,Hue City,Phu Vang,8,1,0,1,0
2022-03-04,Hue City,Phu Vang,10,2,2,0,0
2022-03-04,Hue City,Phu Vang,11,2,1,1,1
2022-03-04,Hue City,Phu Vang,12,2,1,1,0
2022-03-04,Hue City,Phu Vang,14,1,0,1,1
2022-03-04,Hue City,Phu Vang,15,1,1,0,0
2022-03-04,Hue City,Phu Vang,18,3,3,0,0
2022-03-04,Hue City,Phu Vang,19,1,1,0,0
2022-03-04,Hue City,Phu Vang,20,2,2,0,0
2022-03-04,Hue City,Phu Vang,21,1,1,0,0
2022-03-04,Vung Tau,Ba Ria City,7,3,0,3,1
2022-03-04,Vung Tau,Ba Ria City,8,5,2,3,2
2022-03-04,Vung Tau,Ba Ria City,9,3,3,0,0
2022-03-04,Vung Tau,Ba Ria City,10,9,6,3,2
2022-03-04,Vung Tau,Ba Ria City,11,6,3,3,3
2022-03-04,Vung Tau,Ba Ria City,12,6,3,3,2
2022-03-04,Vung Tau,Ba Ria City,13,10,4,6,3
2022-03-04,Vung Tau,Ba Ria City,14,3,2,1,0
2022-03-04,Vung Tau,Ba Ria City,15,3,3,0,0
2022-03-04,Vung Tau,Ba Ria City,16,5,3,2,0
2022-03-04,Vung Tau,Ba Ria City,17,4,3,1,1
2022-03-04,Vung Tau,Ba Ria City,18,8,4,4,4
2022-03-04,Vung Tau,Ba Ria City,19,4,3,1,1
2022-03-04,Vung Tau,Ba Ria City,20,1,1,0,0
2022-03-04,Vung Tau,Tan Thanh,13,1,0,1,1
2022-03-04,Vung Tau,Vung Tau City,0,2,1,1,0
2022-03-04,Vung Tau,Vung Tau City,1,3,0,3,1
2022-03-04,Vung Tau,Vung Tau City,3,1,1,0,0
2022-03-04,Vung Tau,Vung Tau City,5,1,0,1,1
2022-03-04,Vung Tau,Vung Tau City,6,42,36,6,1
2022-03-04,Vung Tau,Vung Tau City,7,124,105,19,7
2022-03-04,Vung Tau,Vung Tau City,8,143,129,14,0
2022-03-04,Vung Tau,Vung Tau City,9,151,144,7,0
2022-03-04,Vung Tau,Vung Tau City,10,176,158,18,1
2022-03-04,Vung Tau,Vung Tau City,11,293,269,24,2
2022-03-04,Vung Tau,Vung Tau City,12,226,211,15,0
2022-03-04,Vung Tau,Vung Tau City,13,190,175,15,0
2022-03-04,Vung Tau,Vung Tau City,14,206,189,17,2
2022-03-04,Vung Tau,Vung Tau City,15,174,160,14,3
2022-03-04,Vung Tau,Vung Tau City,16,195,176,19,3
2022-03-04,Vung Tau,Vung Tau City,17,253,237,16,1
2022-03-04,Vung Tau,Vung Tau City,18,291,268,23,3
2022-03-04,Vung Tau,Vung Tau City,19,245,219,26,1
2022-03-04,Vung Tau,Vung Tau City,20,167,146,21,4
2022-03-04,Vung Tau,Vung Tau City,21,104,76,28,10
2022-03-05,Binh Duong,Ben Cat,10,4,2,2,2
2022-03-05,Binh Duong,Ben Cat,12,1,0,1,0
2022-03-05,Binh Duong,Ben Cat,19,1,0,1,1
2022-03-05,Binh Duong,Di An,7,6,0,6,5
2022-03-05,Binh Duong,Di An,8,9,2,7,6
2022-03-05,Binh Duong,Di An,9,13,7,6,3
2022-03-05,Binh Duong,Di An,10,32,11,21,20
2022-03-05,Binh Duong,Di An,11,34,7,27,21
2022-03-05,Binh Duong,Di An,12,22,10,12,9
2022-03-05,Binh Duong,Di An,13,22,8,14,13
2022-03-05,Binh Duong,Di An,14,28,6,22,18
2022-03-05,Binh Duong,Di An,15,9,4,5,4
2022-03-05,Binh Duong,Di An,16,10,4,6,4
2022-03-05,Binh Duong,Di An,17,21,6,15,13
2022-03-05,Binh Duong,Di An,18,26,15,11,7
2022-03-05,Binh Duong,Di An,19,11,6,5,2
2022-03-05,Binh Duong,Di An,20,17,12,5,5
2022-03-05,Binh Duong,Di An,21,7,3,4,1
2022-03-05,Binh Duong,Tan Uyen,6,1,0,1,1
2022-03-05,Binh Duong,Tan Uyen,8,1,0,1,1
2022-03-05,Binh Duong,Tan Uyen,10,2,2,0,0
2022-03-05,Binh Duong,Tan Uyen,12,3,1,2,2
2022-03-05,Binh Duong,Tan Uyen,13,4,3,1,1
2022-03-05,Binh Duong,Tan Uyen,15,1,0,1,0
2022-03-05,Binh Duong,Tan Uyen,16,1,1,0,0
2022-03-05,Binh Duong,Tan Uyen,19,1,0,1,1
2022-03-05,Binh Duong,Tan Uyen,20,1,0,1,0
2022-03-05,Binh Duong,Thu Dau Mot Town,0,1,0,1,0
2022-03-05,Binh Duong,Thu Dau Mot Town,1,2,0,2,1
2022-03-05,Binh Duong,Thu Dau Mot Town,5,1,0,1,1
2022-03-05,Binh Duong,Thu Dau Mot Town,6,35,21,14,8
2022-03-05,Binh Duong,Thu Dau Mot Town,7,113,96,17,7
2022-03-05,Binh Duong,Thu Dau Mot Town,8,192,179,13,3
2022-03-05,Binh Duong,Thu Dau Mot Town,9,234,213,21,5
2022-03-05,Binh Duong,Thu Dau Mot Town,10,380,353,27,6
2022-03-05,Binh Duong,Thu Dau Mot Town,11,566,523,43,5
2022-03-05,Binh Duong,Thu Dau Mot Town,12,430,402,28,2
2022-03-05,Binh Duong,Thu Dau Mot Town,13,364,346,18,1
2022-03-05,Binh Duong,Thu Dau Mot Town,14,279,257,22,5
2022-03-05,Binh Duong,Thu Dau Mot Town,15,286,266,20,3
2022-03-05,Binh Duong,Thu Dau Mot Town,16,317,172,145,117
2022-03-05,Binh Duong,Thu Dau Mot Town,17,618,228,390,335
2022-03-05,Binh Duong,Thu Dau Mot Town,18,552,439,113,74
2022-03-05,Binh Duong,Thu Dau Mot Town,19,378,349,29,5
2022-03-05,Binh Duong,Thu Dau Mot Town,20,262,227,35,8
2022-03-05,Binh Duong,Thu Dau Mot Town,21,115,101,14,2
2022-03-05,Binh Duong,Thu Dau Mot Town,22,7,2,5,0
2022-03-05,Binh Duong,Thu Dau Mot Town,23,2,0,2,1
2022-03-05,Binh Duong,Thuan An,6,1,0,1,0
2022-03-05,Binh Duong,Thuan An,7,11,1,10,10
2022-03-05,Binh Duong,Thuan An,8,16,5,11,10
2022-03-05,Binh Duong,Thuan An,9,29,12,17,14
2022-03-05,Binh Duong,Thuan An,10,60,30,30,22
2022-03-05,Binh Duong,Thuan An,11,71,44,27,21
2022-03-05,Binh Duong,Thuan An,12,70,24,46,38
2022-03-05,Binh Duong,Thuan An,13,81,33,48,39
2022-03-05,Binh Duong,Thuan An,14,56,27,29,21
2022-03-05,Binh Duong,Thuan An,15,38,13,25,22
2022-03-05,Binh Duong,Thuan An,16,45,13,32,29
2022-03-05,Binh Duong,Thuan An,17,68,15,53,46
2022-03-05,Binh Duong,Thuan An,18,66,36,30,20
2022-03-05,Binh Duong,Thuan An,19,47,23,24,15
2022-03-05,Binh Duong,Thuan An,20,43,25,18,14
2022-03-05,Binh Duong,Thuan An,21,14,9,5,3
2022-03-05,Binh Duong,Thuan An,23,1,0,1,1
2022-03-05,Can Tho City,Binh Thuy District,1,1,1,0,0
2022-03-05,Can Tho City,Binh Thuy District,6,1,1,0,0
2022-03-05,Can Tho City,Binh Thuy District,7,1,1,0,0
2022-03-05,Can Tho City,Binh Thuy District,8,3,3,0,0
2022-03-05,Can Tho City,Binh Thuy District,9,7,6,1,0
2022-03-05,Can Tho City,Binh Thuy District,10,11,11,0,0
2022-03-05,Can Tho City,Binh Thuy District,11,16,14,2,0
2022-03-05,Can Tho City,Binh Thuy District,12,10,10,0,0
2022-03-05,Can Tho City,Binh Thuy District,13,9,9,0,0
2022-03-05,Can Tho City,Binh Thuy District,14,10,9,1,0
2022-03-05,Can Tho City,Binh Thuy District,15,6,5,1,0
2022-03-05,Can Tho City,Binh Thuy District,16,17,16,1,0
2022-03-05,Can Tho City,Binh Thuy District,17,16,14,2,0
2022-03-05,Can Tho City,Binh Thuy District,18,13,11,2,0
2022-03-05,Can Tho City,Binh Thuy District,19,7,7,0,0
2022-03-05,Can Tho City,Binh Thuy District,20,13,10,3,1
2022-03-05,Can Tho City,Binh Thuy District,21,2,2,0,0
2022-03-05,Can Tho City,Cai Rang District,7,6,4,2,1
2022-03-05,Can Tho City,Cai Rang District,8,5,3,2,1
2022-03-05,Can Tho City,Cai Rang District,9,2,2,0,0
2022-03-05,Can Tho City,Cai Rang District,10,6,5,1,0
2022-03-05,Can Tho City,Cai Rang District,11,15,12,3,1
2022-03-05,Can Tho City,Cai Rang District,12,11,11,0,0
2022-03-05,Can Tho City,Cai Rang District,13,5,5,0,0
2022-03-05,Can Tho City,Cai Rang District,14,9,8,1,0
2022-03-05,Can Tho City,Cai Rang District,15,8,8,0,0
2022-03-05,Can Tho City,Cai Rang District,16,11,9,2,0
2022-03-05,Can Tho City,Cai Rang District,17,11,10,1,1
2022-03-05,Can Tho City,Cai Rang District,18,18,17,1,0
2022-03-05,Can Tho City,Cai Rang District,19,9,8,1,0
2022-03-05,Can Tho City,Cai Rang District,20,13,10,3,0
2022-03-05,Can Tho City,Cai Rang District,21,1,1,0,0
2022-03-05,Can Tho City,Ninh Kieu District,0,1,1,0,0
2022-03-05,Can Tho City,Ninh Kieu District,1,1,0,1,0
2022-03-05,Can Tho City,Ninh Kieu District,4,1,1,0,0
2022-03-05,Can Tho City,Ninh Kieu District,6,45,41,4,0
2022-03-05,Can Tho City,Ninh Kieu District,7,131,124,7,1
2022-03-05,Can Tho City,Ninh Kieu District,8,251,240,11,0
2022-03-05,Can Tho City,Ninh Kieu District,9,261,245,16,0
2022-03-05,Can Tho City,Ninh Kieu District,10,455,429,26,0
2022-03-05,Can Tho City,Ninh Kieu District,11,713,665,48,2
2022-03-05,Can Tho City,Ninh Kieu District,12,587,564,23,0
2022-03-05,Can Tho City,Ninh Kieu District,13,433,414,19,0
2022-03-05,Can Tho City,Ninh Kieu District,14,360,334,26,0
2022-03-05,Can Tho City,Ninh Kieu District,15,332,312,20,0
2022-03-05,Can Tho City,Ninh Kieu District,16,403,388,15,0
2022-03-05,Can Tho City,Ninh Kieu District,17,444,410,34,0
2022-03-05,Can Tho City,Ninh Kieu District,18,547,511,36,1
2022-03-05,Can Tho City,Ninh Kieu District,19,391,368,23,0
2022-03-05,Can Tho City,Ninh Kieu District,20,301,280,21,0
2022-03-05,Can Tho City,Ninh Kieu District,21,160,141,19,0
2022-03-05,Can Tho City,Ninh Kieu District,22,6,2,4,0
2022-03-05,Can Tho City,Ninh Kieu District,23,4,4,0,0
2022-03-05,Dong Nai,Bien Hoa City,0,2,0,2,0
2022-03-05,Dong Nai,Bien Hoa City,1,1,1,0,0
2022-03-05,Dong Nai,Bien Hoa City,3,2,2,0,0
2022-03-05,Dong Nai,Bien Hoa City,4,1,1,0,0
2022-03-05,Dong Nai,Bien Hoa City,6,36,23,13,8
2022-03-05,Dong Nai,Bien Hoa City,7,174,137,37,21
2022-03-05,Dong Nai,Bien Hoa City,8,309,276,33,7
2022-03-05,Dong Nai,Bien Hoa City,9,391,351,40,5
2022-03-05,Dong Nai,Bien Hoa City,10,709,647,62,20
2022-03-05,Dong Nai,Bien Hoa City,11,1012,918,94,20
2022-03-05,Dong Nai,Bien Hoa City,12,891,782,109,21
2022-03-05,Dong Nai,Bien Hoa City,13,646,608,38,3
2022-03-05,Dong Nai,Bien Hoa City,14,567,516,51,15
2022-03-05,Dong Nai,Bien Hoa City,15,449,406,43,14
2022-03-05,Dong Nai,Bien Hoa City,16,594,458,136,89
2022-03-05,Dong Nai,Bien Hoa City,17,753,576,177,118
2022-03-05,Dong Nai,Bien Hoa City,18,768,646,122,55
2022-03-05,Dong Nai,Bien Hoa City,19,715,602,113,44
2022-03-05,Dong Nai,Bien Hoa City,20,540,431,109,57
2022-03-05,Dong Nai,Bien Hoa City,21,219,147,72,30
2022-03-05,Dong Nai,Bien Hoa City,22,8,0,8,2
2022-03-05,Dong Nai,Bien Hoa City,23,3,2,1,0
2022-03-05,Dong Nai,Long Khanh,12,1,0,1,1
2022-03-05,Dong Nai,Long Thanh,10,1,0,1,1
2022-03-05,Dong Nai,Long Thanh,11,6,0,6,4
2022-03-05,Dong Nai,Long Thanh,14,6,0,6,5
2022-03-05,Dong Nai,Long Thanh,15,1,0,1,1
2022-03-05,Dong Nai,Long Thanh,16,2,0,2,1
2022-03-05,Dong Nai,Long Thanh,17,6,0,6,6
2022-03-05,Dong Nai,Long Thanh,18,2,0,2,2
2022-03-05,Dong Nai,Long Thanh,19,2,0,2,1
2022-03-05,Dong Nai,Long Thanh,20,1,0,1,1
2022-03-05,Dong Nai,Nhon trach,14,1,0,1,0
2022-03-05,Dong Nai,Nhon trach,17,1,0,1,1
2022-03-05,Dong Nai,Thong Nhat,7,1,1,0,0
2022-03-05,Dong Nai,Thong Nhat,9,1,1,0,0
2022-03-05,Dong Nai,Thong Nhat,11,1,1,0,0
2022-03-05,Dong Nai,Thong Nhat,12,2,2,0,0
2022-03-05,Dong Nai,Thong Nhat,13,1,1,0,0
2022-03-05,Dong Nai,Thong Nhat,15,2,1,1,0
2022-03-05,Dong Nai,Thong Nhat,18,1,1,0,0
2022-03-05,Dong Nai,Thong Nhat,19,3,3,0,0
2022-03-05,Dong Nai,Thong Nhat,20,1,1,0,0
2022-03-05,Dong Nai,Thong Nhat,21,1,1,0,0
2022-03-05,Dong Nai,Trang Bom,14,1,0,1,1
2022-03-05,Hai Phong City,An Duong,8,8,1,7,5
2022-03-05,Hai Phong City,An Duong,9,6,2,4,3
2022-03-05,Hai Phong City,An Duong,10,9,2,7,3
2022-03-05,Hai Phong City,An Duong,11,4,0,4,3
2022-03-05,Hai Phong City,An Duong,12,3,0,3,3
2022-03-05,Hai Phong City,An Duong,13,5,2,3,3
2022-03-05,Hai Phong City,An Duong,14,2,0,2,2
2022-03-05,Hai Phong City,An Duong,15,3,3,0,0
2022-03-05,Hai Phong City,An Duong,16,3,3,0,0
2022-03-05,Hai Phong City,An Duong,19,2,0,2,2
2022-03-05,Hai Phong City,An Duong,20,1,0,1,1
2022-03-05,Hai Phong City,An Duong,21,1,0,1,0
2022-03-05,Hai Phong City,Hai An District,0,1,1,0,0
2022-03-05,Hai Phong City,Hai An District,2,1,0,1,0
2022-03-05,Hai Phong City,Hai An District,7,8,5,3,0
2022-03-05,Hai Phong City,Hai An District,8,19,10,9,4
2022-03-05,Hai Phong City,Hai An District,9,9,6,3,1
2022-03-05,Hai Phong City,Hai An District,10,21,19,2,0
2022-03-05,Hai Phong City,Hai An District,11,32,29,3,1
2022-03-05,Hai Phong City,Hai An District,12,21,19,2,0
2022-03-05,Hai Phong City,Hai An District,13,13,13,0,0
2022-03-05,Hai Phong City,Hai An District,14,18,15,3,1
2022-03-05,Hai Phong City,Hai An District,15,21,17,4,1
2022-03-05,Hai Phong City,Hai An District,16,22,18,4,2
2022-03-05,Hai Phong City,Hai An District,17,25,18,7,3
2022-03-05,Hai Phong City,Hai An District,18,33,29,4,2
2022-03-05,Hai Phong City,Hai An District,19,8,7,1,1
2022-03-05,Hai Phong City,Hai An District,20,18,12,6,3
2022-03-05,Hai Phong City,Hai An District,21,2,2,0,0
2022-03-05,Hai Phong City,Hong Bang District,7,16,10,6,5
2022-03-05,Hai Phong City,Hong Bang District,8,22,21,1,0
2022-03-05,Hai Phong City,Hong Bang District,9,15,15,0,0
2022-03-05,Hai Phong City,Hong Bang District,10,57,52,5,1
2022-03-05,Hai Phong City,Hong Bang District,11,95,84,11,5
2022-03-05,Hai Phong City,Hong Bang District,12,52,49,3,0
2022-03-05,Hai Phong City,Hong Bang District,13,28,27,1,0
2022-03-05,Hai Phong City,Hong Bang District,14,20,17,3,0
2022-03-05,Hai Phong City,Hong Bang District,15,28,26,2,1
2022-03-05,Hai Phong City,Hong Bang District,16,55,42,13,3
2022-03-05,Hai Phong City,Hong Bang District,17,36,30,6,1
2022-03-05,Hai Phong City,Hong Bang District,18,73,58,15,6
2022-03-05,Hai Phong City,Hong Bang District,19,57,55,2,1
2022-03-05,Hai Phong City,Hong Bang District,20,25,21,4,0
2022-03-05,Hai Phong City,Hong Bang District,21,7,7,0,0
2022-03-05,Hai Phong City,Kien An District,7,2,1,1,1
2022-03-05,Hai Phong City,Kien An District,8,3,1,2,1
2022-03-05,Hai Phong City,Kien An District,9,4,3,1,1
2022-03-05,Hai Phong City,Kien An District,10,6,5,1,1
2022-03-05,Hai Phong City,Kien An District,11,22,15,7,0
2022-03-05,Hai Phong City,Kien An District,12,3,3,0,0
2022-03-05,Hai Phong City,Kien An District,13,11,6,5,1
2022-03-05,Hai Phong City,Kien An District,14,12,11,1,0
2022-03-05,Hai Phong City,Kien An District,15,14,14,0,0
2022-03-05,Hai Phong City,Kien An District,16,12,10,2,0
2022-03-05,Hai Phong City,Kien An District,17,9,8,1,0
2022-03-05,Hai Phong City,Kien An District,18,7,7,0,0
2022-03-05,Hai Phong City,Kien An District,19,10,10,0,0
2022-03-05,Hai Phong City,Kien An District,20,7,5,2,1
2022-03-05,Hai Phong City,Kien An District,21,4,3,1,0
2022-03-05,Hai Phong City,Le Chan District,0,7,5,2,0
2022-03-05,Hai Phong City,Le Chan District,2,2,2,0,0
2022-03-05,Hai Phong City,Le Chan District,3,1,1,0,0
2022-03-05,Hai Phong City,Le Chan District,6,1,1,0,0
2022-03-05,Hai Phong City,Le Chan District,7,35,24,11,8
2022-03-05,Hai Phong City,Le Chan District,8,69,62,7,0
2022-03-05,Hai Phong City,Le Chan District,9,66,62,4,0
2022-03-05,Hai Phong City,Le Chan District,10,166,155,11,2
2022-03-05,Hai Phong City,Le Chan District,11,275,248,27,3
2022-03-05,Hai Phong City,Le Chan District,12,209,186,23,3
2022-03-05,Hai Phong City,Le Chan District,13,135,118,17,3
2022-03-05,Hai Phong City,Le Chan District,14,129,117,12,3
2022-03-05,Hai Phong City,Le Chan District,15,156,140,16,1
2022-03-05,Hai Phong City,Le Chan District,16,187,170,17,4
2022-03-05,Hai Phong City,Le Chan District,17,203,188,15,1
2022-03-05,Hai Phong City,Le Chan District,18,269,211,58,20
2022-03-05,Hai Phong City,Le Chan District,19,193,168,25,8
2022-03-05,Hai Phong City,Le Chan District,20,123,108,15,7
2022-03-05,Hai Phong City,Le Chan District,21,51,40,11,3
2022-03-05,Hai Phong City,Le Chan District,22,1,1,0,0
2022-03-05,Hai Phong City,Ngo Quyen District,0,1,1,0,0
2022-03-05,Hai Phong City,Ngo Quyen District,6,1,0,1,1
2022-03-05,Hai Phong City,Ngo Quyen District,7,40,24,16,13
2022-03-05,Hai Phong City,Ngo Quyen District,8,63,57,6,0
2022-03-05,Hai Phong City,Ngo Quyen District,9,74,65,9,0
2022-03-05,Hai Phong City,Ngo Quyen District,10,116,108,8,0
2022-03-05,Hai Phong City,Ngo Quyen District,11,203,185,18,6
2022-03-05,Hai Phong City,Ngo Quyen District,12,137,121,16,3
2022-03-05,Hai Phong City,Ngo Quyen District,13,98,91,7,1
2022-03-05,Hai Phong City,Ngo Quyen District,14,108,96,12,5
2022-03-05,Hai Phong City,Ngo Quyen District,15,151,133,18,1
2022-03-05,Hai Phong City,Ngo Quyen District,16,138,129,9,2
2022-03-05,Hai Phong City,Ngo Quyen District,17,167,150,17,2
2022-03-05,Hai Phong City,Ngo Quyen District,18,211,168,43,19
2022-03-05,Hai Phong City,Ngo Quyen District,19,163,144,19,5
2022-03-05,Hai Phong City,Ngo Quyen District,20,129,107,22,3
2022-03-05,Hai Phong City,Ngo Quyen District,21,55,38,17,5
2022-03-05,Hai Phong City,Ngo Quyen District,22,1,1,0,0
2022-03-05,Hai Phong City,Ngo Quyen District,23,1,1,0,0
2022-03-05,Hai Phong City,Thuy Nguyen,9,2,0,2,2
2022-03-05,Hai Phong City,Thuy Nguyen,10,1,0,1,1
2022-03-05,Hai Phong City,Thuy Nguyen,12,2,0,2,2
2022-03-05,Hai Phong City,Thuy Nguyen,14,1,0,1,1
2022-03-05,Hai Phong City,Thuy Nguyen,16,6,0,6,6
2022-03-05,Hai Phong City,Thuy Nguyen,17,6,0,6,6
2022-03-05,Hai Phong City,Thuy Nguyen,18,4,1,3,3
2022-03-05,Hai Phong City,Thuy Nguyen,19,2,0,2,2
2022-03-05,Hue City,Hue City,0,3,3,0,0
2022-03-05,Hue City,Hue City,1,2,1,1,0
2022-03-05,Hue City,Hue City,4,1,0,1,0
2022-03-05,Hue City,Hue City,5,3,3,0,0
2022-03-05,Hue City,Hue City,6,55,53,2,0
2022-03-05,Hue City,Hue City,7,237,212,25,3
2022-03-05,Hue City,Hue City,8,325,294,31,0
2022-03-05,Hue City,Hue City,9,252,234,18,1
2022-03-05,Hue City,Hue City,10,370,347,23,0
2022-03-05,Hue City,Hue City,11,696,655,41,6
2022-03-05,Hue City,Hue City,12,477,460,17,0
2022-03-05,Hue City,Hue City,13,285,272,13,0
2022-03-05,Hue City,Hue City,14,319,305,14,0
2022-03-05,Hue City,Hue City,15,363,340,23,0
2022-03-05,Hue City,Hue City,16,426,388,38,2
2022-03-05,Hue City,Hue City,17,525,495,30,1
2022-03-05,Hue City,Hue City,18,627,588,39,3
2022-03-05,Hue City,Hue City,19,563,518,45,7
2022-03-05,Hue City,Hue City,20,458,388,70,23
2022-03-05,Hue City,Hue City,21,239,192,47,11
2022-03-05,Hue City,Hue City,22,5,1,4,0
2022-03-05,Hue City,Hue City,23,4,4,0,0
2022-03-05,Hue City,Huong Thuy,7,1,0,1,0
2022-03-05,Hue City,Huong Thuy,8,2,2,0,0
2022-03-05,Hue City,Huong Thuy,9,1,1,0,0
2022-03-05,Hue City,Huong Thuy,11,2,1,1,0
2022-03-05,Hue City,Huong Thuy,12,1,1,0,0
2022-03-05,Hue City,Huong Thuy,13,1,0,1,0
2022-03-05,Hue City,Huong Thuy,16,1,0,1,0
2022-03-05,Hue City,Huong Thuy,18,2,0,2,0
2022-03-05,Hue City,Huong Thuy,20,1,1,0,0
2022-03-05,Hue City,Huong Tra,14,1,0,1,0
2022-03-05,Hue City,Huong Tra,17,1,1,0,0
2022-03-05,Hue City,Huong Tra,20,1,0,1,0
2022-03-05,Hue City,Phu Vang,8,3,2,1,0
2022-03-05,Hue City,Phu Vang,11,3,2,1,1
2022-03-05,Hue City,Phu Vang,12,4,2,2,2
2022-03-05,Hue City,Phu Vang,15,2,1,1,1
2022-03-05,Hue City,Phu Vang,16,2,1,1,0
2022-03-05,Hue City,Phu Vang,17,2,2,0,0
2022-03-05,Hue City,Phu Vang,18,3,2,1,0
2022-03-05,Hue City,Phu Vang,19,2,2,0,0
2022-03-05,Hue City,Phu Vang,20,7,3,4,2
2022-03-05,Hue City,Phu Vang,21,1,1,0,0
2022-03-05,Vung Tau,Ba Ria City,6,3,0,3,3
2022-03-05,Vung Tau,Ba Ria City,7,1,0,1,1
2022-03-05,Vung Tau,Ba Ria City,8,7,2,5,5
2022-03-05,Vung Tau,Ba Ria City,9,7,5,2,2
2022-03-05,Vung Tau,Ba Ria City,10,5,4,1,0
2022-03-05,Vung Tau,Ba Ria City,11,7,5,2,0
2022-03-05,Vung Tau,Ba Ria City,12,9,8,1,1
2022-03-05,Vung Tau,Ba Ria City,13,7,6,1,0
2022-03-05,Vung Tau,Ba Ria City,14,4,2,2,2
2022-03-05,Vung Tau,Ba Ria City,15,7,4,3,3
2022-03-05,Vung Tau,Ba Ria City,16,2,2,0,0
2022-03-05,Vung Tau,Ba Ria City,17,3,3,0,0
2022-03-05,Vung Tau,Ba Ria City,19,6,2,4,1
2022-03-05,Vung Tau,Ba Ria City,20,5,2,3,3
2022-03-05,Vung Tau,Ba Ria City,21,2,0,2,1
2022-03-05,Vung Tau,Ba Ria City,22,2,0,2,2
2022-03-05,Vung Tau,Tan Thanh,9,1,0,1,1
2022-03-05,Vung Tau,Tan Thanh,10,1,0,1,1
2022-03-05,Vung Tau,Vung Tau City,0,1,1,0,0
2022-03-05,Vung Tau,Vung Tau City,3,1,1,0,0
2022-03-05,Vung Tau,Vung Tau City,5,2,1,1,0
2022-03-05,Vung Tau,Vung Tau City,6,28,23,5,3
2022-03-05,Vung Tau,Vung Tau City,7,139,127,12,2
2022-03-05,Vung Tau,Vung Tau City,8,189,165,24,0
2022-03-05,Vung Tau,Vung Tau City,9,158,148,10,0
2022-03-05,Vung Tau,Vung Tau City,10,252,231,21,2
2022-03-05,Vung Tau,Vung Tau City,11,366,334,32,4
2022-03-05,Vung Tau,Vung Tau City,12,299,280,19,1
2022-03-05,Vung Tau,Vung Tau City,13,194,177,17,0
2022-03-05,Vung Tau,Vung Tau City,14,231,214,17,3
2022-03-05,Vung Tau,Vung Tau City,15,219,197,22,1
2022-03-05,Vung Tau,Vung Tau City,16,245,218,27,4
2022-03-05,Vung Tau,Vung Tau City,17,305,275,30,3
2022-03-05,Vung Tau,Vung Tau City,18,361,317,44,9
2022-03-05,Vung Tau,Vung Tau City,19,321,280,41,8
2022-03-05,Vung Tau,Vung Tau City,20,185,150,35,4
2022-03-05,Vung Tau,Vung Tau City,21,94,75,19,3
2022-03-05,Vung Tau,Vung Tau City,22,2,1,1,0
2022-03-05,Vung Tau,Vung Tau City,23,2,1,1,0
2022-03-06,Binh Duong,Ben Cat,10,1,1,0,0
2022-03-06,Binh Duong,Ben Cat,12,2,0,2,2
2022-03-06,Binh Duong,Ben Cat,14,1,0,1,0
2022-03-06,Binh Duong,Ben Cat,17,1,1,0,0
2022-03-06,Binh Duong,Ben Cat,18,1,1,0,0
2022-03-06,Binh Duong,Di An,6,2,1,1,1
2022-03-06,Binh Duong,Di An,7,11,1,10,10
2022-03-06,Binh Duong,Di An,8,14,2,12,8
2022-03-06,Binh Duong,Di An,9,15,5,10,7
2022-03-06,Binh Duong,Di An,10,38,9,29,25
2022-03-06,Binh Duong,Di An,11,42,16,26,24
2022-03-06,Binh Duong,Di An,12,26,14,12,10
2022-03-06,Binh Duong,Di An,13,25,14,11,8
2022-03-06,Binh Duong,Di An,14,18,13,5,1
2022-03-06,Binh Duong,Di An,15,13,10,3,1
2022-03-06,Binh Duong,Di An,16,33,21,12,11
2022-03-06,Binh Duong,Di An,17,26,14,12,6
2022-03-06,Binh Duong,Di An,18,32,16,16,9
2022-03-06,Binh Duong,Di An,19,37,16,21,19
2022-03-06,Binh Duong,Di An,20,13,4,9,6
2022-03-06,Binh Duong,Di An,21,5,2,3,3
2022-03-06,Binh Duong,Tan Uyen,7,1,0,1,1
2022-03-06,Binh Duong,Tan Uyen,8,2,0,2,1
2022-03-06,Binh Duong,Tan Uyen,9,2,0,2,1
2022-03-06,Binh Duong,Tan Uyen,10,1,0,1,0
2022-03-06,Binh Duong,Tan Uyen,11,1,0,1,1
2022-03-06,Binh Duong,Tan Uyen,12,1,1,0,0
2022-03-06,Binh Duong,Tan Uyen,13,4,2,2,2
2022-03-06,Binh Duong,Tan Uyen,15,2,0,2,2
2022-03-06,Binh Duong,Tan Uyen,16,1,1,0,0
2022-03-06,Binh Duong,Tan Uyen,17,4,1,3,3
2022-03-06,Binh Duong,Tan Uyen,18,1,0,1,1
2022-03-06,Binh Duong,Tan Uyen,21,1,0,1,0
2022-03-06,Binh Duong,Thu Dau Mot Town,3,2,1,1,0
2022-03-06,Binh Duong,Thu Dau Mot Town,5,1,0,1,1
2022-03-06,Binh Duong,Thu Dau Mot Town,6,35,26,9,7
2022-03-06,Binh Duong,Thu Dau Mot Town,7,133,104,29,15
2022-03-06,Binh Duong,Thu Dau Mot Town,8,223,200,23,5
2022-03-06,Binh Duong,Thu Dau Mot Town,9,272,241,31,8
2022-03-06,Binh Duong,Thu Dau Mot Town,10,369,347,22,4
2022-03-06,Binh Duong,Thu Dau Mot Town,11,618,529,89,41
2022-03-06,Binh Duong,Thu Dau Mot Town,12,581,458,123,80
2022-03-06,Binh Duong,Thu Dau Mot Town,13,401,358,43,21
2022-03-06,Binh Duong,Thu Dau Mot Town,14,383,350,33,11
2022-03-06,Binh Duong,Thu Dau Mot Town,15,323,298,25,4
2022-03-06,Binh Duong,Thu Dau Mot Town,16,339,303,36,9
2022-03-06,Binh Duong,Thu Dau Mot Town,17,364,320,44,27
2022-03-06,Binh Duong,Thu Dau Mot Town,18,395,355,40,13
2022-03-06,Binh Duong,Thu Dau Mot Town,19,368,312,56,20
2022-03-06,Binh Duong,Thu Dau Mot Town,20,241,209,32,8
2022-03-06,Binh Duong,Thu Dau Mot Town,21,104,83,21,5
2022-03-06,Binh Duong,Thu Dau Mot Town,22,2,1,1,0
2022-03-06,Binh Duong,Thuan An,6,3,0,3,3
2022-03-06,Binh Duong,Thuan An,7,6,2,4,4
2022-03-06,Binh Duong,Thuan An,8,21,5,16,8
2022-03-06,Binh Duong,Thuan An,9,37,18,19,15
2022-03-06,Binh Duong,Thuan An,10,65,34,31,20
2022-03-06,Binh Duong,Thuan An,11,95,46,49,37
2022-03-06,Binh Duong,Thuan An,12,83,46,37,32
2022-03-06,Binh Duong,Thuan An,13,55,31,24,22
2022-03-06,Binh Duong,Thuan An,14,71,40,31,18
2022-03-06,Binh Duong,Thuan An,15,60,31,29,18
2022-03-06,Binh Duong,Thuan An,16,50,20,30,18
2022-03-06,Binh Duong,Thuan An,17,41,25,16,10
2022-03-06,Binh Duong,Thuan An,18,40,26,14,8
2022-03-06,Binh Duong,Thuan An,19,44,27,17,10
2022-03-06,Binh Duong,Thuan An,20,18,8,10,6
2022-03-06,Binh Duong,Thuan An,21,18,5,13,10
2022-03-06,Can Tho City,Binh Thuy District,8,4,4,0,0
2022-03-06,Can Tho City,Binh Thuy District,9,4,2,2,0
2022-03-06,Can Tho City,Binh Thuy District,10,5,5,0,0
2022-03-06,Can Tho City,Binh Thuy District,11,13,11,2,0
2022-03-06,Can Tho City,Binh Thuy District,12,13,12,1,0
2022-03-06,Can Tho City,Binh Thuy District,13,18,17,1,0
2022-03-06,Can Tho City,Binh Thuy District,14,15,14,1,0
2022-03-06,Can Tho City,Binh Thuy District,15,20,17,3,1
2022-03-06,Can Tho City,Binh Thuy District,16,13,11,2,0
2022-03-06,Can Tho City,Binh Thuy District,17,17,16,1,0
2022-03-06,Can Tho City,Binh Thuy District,18,16,14,2,0
2022-03-06,Can Tho City,Binh Thuy District,19,15,14,1,0
2022-03-06,Can Tho City,Binh Thuy District,20,9,8,1,0
2022-03-06,Can Tho City,Binh Thuy District,21,2,0,2,0
2022-03-06,Can Tho City,Cai Rang District,0,1,1,0,0
2022-03-06,Can Tho City,Cai Rang District,6,2,2,0,0
2022-03-06,Can Tho City,Cai Rang District,7,4,2,2,1
2022-03-06,Can Tho City,Cai Rang District,8,3,3,0,0
2022-03-06,Can Tho City,Cai Rang District,9,7,6,1,0
2022-03-06,Can Tho City,Cai Rang District,10,12,9,3,0
2022-03-06,Can Tho City,Cai Rang District,11,12,11,1,0
2022-03-06,Can Tho City,Cai Rang District,12,14,14,0,0
2022-03-06,Can Tho City,Cai Rang District,13,10,9,1,0
2022-03-06,Can Tho City,Cai Rang District,14,8,7,1,0
2022-03-06,Can Tho City,Cai Rang District,15,11,10,1,1
2022-03-06,Can Tho City,Cai Rang District,16,15,14,1,0
2022-03-06,Can Tho City,Cai Rang District,17,17,16,1,0
2022-03-06,Can Tho City,Cai Rang District,18,11,10,1,0
2022-03-06,Can Tho City,Cai Rang District,19,14,11,3,0
2022-03-06,Can Tho City,Cai Rang District,20,6,6,0,0
2022-03-06,Can Tho City,Ninh Kieu District,4,2,2,0,0
2022-03-06,Can Tho City,Ninh Kieu District,5,2,2,0,0
2022-03-06,Can Tho City,Ninh Kieu District,6,35,29,6,0
2022-03-06,Can Tho City,Ninh Kieu District,7,109,100,9,0
2022-03-06,Can Tho City,Ninh Kieu District,8,228,213,15,0
2022-03-06,Can Tho City,Ninh Kieu District,9,283,266,17,0
2022-03-06,Can Tho City,Ninh Kieu District,10,497,466,31,0
2022-03-06,Can Tho City,Ninh Kieu District,11,737,693,44,6
2022-03-06,Can Tho City,Ninh Kieu District,12,602,577,25,0
2022-03-06,Can Tho City,Ninh Kieu District,13,446,424,22,0
2022-03-06,Can Tho City,Ninh Kieu District,14,355,333,22,0
2022-03-06,Can Tho City,Ninh Kieu District,15,375,349,26,0
2022-03-06,Can Tho City,Ninh Kieu District,16,444,414,30,0
2022-03-06,Can Tho City,Ninh Kieu District,17,456,434,22,0
2022-03-06,Can Tho City,Ninh Kieu District,18,524,494,30,0
2022-03-06,Can Tho City,Ninh Kieu District,19,443,407,36,1
2022-03-06,Can Tho City,Ninh Kieu District,20,328,298,30,1
2022-03-06,Can Tho City,Ninh Kieu District,21,171,152,19,0
2022-03-06,Can Tho City,Ninh Kieu District,22,3,2,1,0
2022-03-06,Can Tho City,Ninh Kieu District,23,1,1,0,0
2022-03-06,Can Tho City,Thoi Lai,15,1,0,1,1
2022-03-06,Dong Nai,Bien Hoa City,0,3,1,2,0
2022-03-06,Dong Nai,Bien Hoa City,1,2,0,2,0
2022-03-06,Dong Nai,Bien Hoa City,2,2,2,0,0
2022-03-06,Dong Nai,Bien Hoa City,3,1,1,0,0
2022-03-06,Dong Nai,Bien Hoa City,5,1,1,0,0
2022-03-06,Dong Nai,Bien Hoa City,6,41,30,11,5
2022-03-06,Dong Nai,Bien Hoa City,7,175,131,44,31
2022-03-06,Dong Nai,Bien Hoa City,8,291,247,44,16
2022-03-06,Dong Nai,Bien Hoa City,9,478,404,74,26
2022-03-06,Dong Nai,Bien Hoa City,10,825,660,165,93
2022-03-06,Dong Nai,Bien Hoa City,11,1238,979,259,147
2022-03-06,Dong Nai,Bien Hoa City,12,942,836,106,30
2022-03-06,Dong Nai,Bien Hoa City,13,713,643,70,18
2022-03-06,Dong Nai,Bien Hoa City,14,629,527,102,48
2022-03-06,Dong Nai,Bien Hoa City,15,593,505,88,36
2022-03-06,Dong Nai,Bien Hoa City,16,561,475,86,39
2022-03-06,Dong Nai,Bien Hoa City,17,708,554,154,80
2022-03-06,Dong Nai,Bien Hoa City,18,712,578,134,56
2022-03-06,Dong Nai,Bien Hoa City,19,646,523,123,38
2022-03-06,Dong Nai,Bien Hoa City,20,476,359,117,60
2022-03-06,Dong Nai,Bien Hoa City,21,236,139,97,54
2022-03-06,Dong Nai,Bien Hoa City,22,3,1,2,0
2022-03-06,Dong Nai,Long Thanh,9,1,0,1,1
2022-03-06,Dong Nai,Long Thanh,11,3,0,3,3
2022-03-06,Dong Nai,Long Thanh,12,2,0,2,2
2022-03-06,Dong Nai,Long Thanh,13,3,0,3,3
2022-03-06,Dong Nai,Long Thanh,15,2,0,2,2
2022-03-06,Dong Nai,Long Thanh,18,3,0,3,3
2022-03-06,Dong Nai,Long Thanh,19,1,0,1,1
2022-03-06,Dong Nai,Long Thanh,20,1,0,1,1
2022-03-06,Dong Nai,Long Thanh,21,1,0,1,1
2022-03-06,Dong Nai,Nhon trach,15,1,0,1,1
2022-03-06,Dong Nai,Thong Nhat,8,2,1,1,1
2022-03-06,Dong Nai,Thong Nhat,10,1,1,0,0
2022-03-06,Dong Nai,Thong Nhat,12,1,1,0,0
2022-03-06,Dong Nai,Thong Nhat,13,1,1,0,0
2022-03-06,Dong Nai,Thong Nhat,14,2,2,0,0
2022-03-06,Dong Nai,Thong Nhat,16,1,1,0,0
2022-03-06,Dong Nai,Thong Nhat,17,1,1,0,0
2022-03-06,Dong Nai,Trang Bom,12,1,0,1,1
2022-03-06,Dong Nai,Trang Bom,14,2,1,1,0
2022-03-06,Dong Nai,Trang Bom,18,1,0,1,1
2022-03-06,Dong Nai,Trang Bom,19,1,0,1,1
2022-03-06,Hai Phong City,An Duong,1,1,0,1,1
2022-03-06,Hai Phong City,An Duong,7,1,1,0,0
2022-03-06,Hai Phong City,An Duong,8,4,0,4,4
2022-03-06,Hai Phong City,An Duong,9,2,1,1,1
2022-03-06,Hai Phong City,An Duong,10,4,0,4,4
2022-03-06,Hai Phong City,An Duong,11,7,4,3,2
2022-03-06,Hai Phong City,An Duong,12,1,0,1,1
2022-03-06,Hai Phong City,An Duong,13,2,1,1,1
2022-03-06,Hai Phong City,An Duong,14,2,0,2,2
2022-03-06,Hai Phong City,An Duong,15,2,0,2,1
2022-03-06,Hai Phong City,An Duong,16,1,0,1,1
2022-03-06,Hai Phong City,An Duong,17,2,0,2,1
2022-03-06,Hai Phong City,An Duong,18,7,1,6,5
2022-03-06,Hai Phong City,An Duong,19,5,2,3,2
2022-03-06,Hai Phong City,An Duong,20,1,1,0,0
2022-03-06,Hai Phong City,Hai An District,3,1,0,1,0
2022-03-06,Hai Phong City,Hai An District,6,1,0,1,0
2022-03-06,Hai Phong City,Hai An District,7,8,3,5,1
2022-03-06,Hai Phong City,Hai An District,8,6,6,0,0
2022-03-06,Hai Phong City,Hai An District,9,5,5,0,0
2022-03-06,Hai Phong City,Hai An District,10,19,17,2,1
2022-03-06,Hai Phong City,Hai An District,11,38,31,7,3
2022-03-06,Hai Phong City,Hai An District,12,38,34,4,0
2022-03-06,Hai Phong City,Hai An District,13,20,14,6,3
2022-03-06,Hai Phong City,Hai An District,14,10,7,3,0
2022-03-06,Hai Phong City,Hai An District,15,14,7,7,0
2022-03-06,Hai Phong City,Hai An District,16,26,21,5,2
2022-03-06,Hai Phong City,Hai An District,17,18,15,3,1
2022-03-06,Hai Phong City,Hai An District,18,33,21,12,2
2022-03-06,Hai Phong City,Hai An District,19,21,15,6,4
2022-03-06,Hai Phong City,Hai An District,20,14,12,2,1
2022-03-06,Hai Phong City,Hai An District,21,12,8,4,3
2022-03-06,Hai Phong City,Hong Bang District,0,1,1,0,0
2022-03-06,Hai Phong City,Hong Bang District,6,1,0,1,1
2022-03-06,Hai Phong City,Hong Bang District,7,7,4,3,0
2022-03-06,Hai Phong City,Hong Bang District,8,23,21,2,0
2022-03-06,Hai Phong City,Hong Bang District,9,30,28,2,0
2022-03-06,Hai Phong City,Hong Bang District,10,66,59,7,3
2022-03-06,Hai Phong City,Hong Bang District,11,78,65,13,7
2022-03-06,Hai Phong City,Hong Bang District,12,63,59,4,0
2022-03-06,Hai Phong City,Hong Bang District,13,38,35,3,2
2022-03-06,Hai Phong City,Hong Bang District,14,32,29,3,1
2022-03-06,Hai Phong City,Hong Bang District,15,38,31,7,1
2022-03-06,Hai Phong City,Hong Bang District,16,53,32,21,15
2022-03-06,Hai Phong City,Hong Bang District,17,63,43,20,10
2022-03-06,Hai Phong City,Hong Bang District,18,87,54,33,26
2022-03-06,Hai Phong City,Hong Bang District,19,61,46,15,9
2022-03-06,Hai Phong City,Hong Bang District,20,49,33,16,9
2022-03-06,Hai Phong City,Hong Bang District,21,20,14,6,2
2022-03-06,Hai Phong City,Hong Bang District,22,1,0,1,0
2022-03-06,Hai Phong City,Kien An District,0,1,1,0,0
2022-03-06,Hai Phong City,Kien An District,1,1,0,1,0
2022-03-06,Hai Phong City,Kien An District,8,2,2,0,0
2022-03-06,Hai Phong City,Kien An District,9,6,3,3,3
2022-03-06,Hai Phong City,Kien An District,10,8,7,1,0
2022-03-06,Hai Phong City,Kien An District,11,14,8,6,4
2022-03-06,Hai Phong City,Kien An District,12,9,9,0,0
2022-03-06,Hai Phong City,Kien An District,13,5,4,1,0
2022-03-06,Hai Phong City,Kien An District,14,9,8,1,1
2022-03-06,Hai Phong City,Kien An District,15,9,6,3,0
2022-03-06,Hai Phong City,Kien An District,16,13,10,3,1
2022-03-06,Hai Phong City,Kien An District,17,9,8,1,1
2022-03-06,Hai Phong City,Kien An District,18,7,5,2,1
2022-03-06,Hai Phong City,Kien An District,19,8,6,2,1
2022-03-06,Hai Phong City,Kien An District,20,4,2,2,2
2022-03-06,Hai Phong City,Kien An District,21,4,4,0,0
2022-03-06,Hai Phong City,Le Chan District,0,2,1,1,0
2022-03-06,Hai Phong City,Le Chan District,4,1,1,0,0
2022-03-06,Hai Phong City,Le Chan District,6,2,1,1,1
2022-03-06,Hai Phong City,Le Chan District,7,26,20,6,2
2022-03-06,Hai Phong City,Le Chan District,8,60,54,6,2
2022-03-06,Hai Phong City,Le Chan District,9,76,67,9,2
2022-03-06,Hai Phong City,Le Chan District,10,172,157,15,3
2022-03-06,Hai Phong City,Le Chan District,11,323,269,54,28
2022-03-06,Hai Phong City,Le Chan District,12,228,193,35,8
2022-03-06,Hai Phong City,Le Chan District,13,131,121,10,0
2022-03-06,Hai Phong City,Le Chan District,14,128,118,10,1
2022-03-06,Hai Phong City,Le Chan District,15,176,157,19,5
2022-03-06,Hai Phong City,Le Chan District,16,217,171,46,28
2022-03-06,Hai Phong City,Le Chan District,17,274,199,75,52
2022-03-06,Hai Phong City,Le Chan District,18,278,196,82,58
2022-03-06,Hai Phong City,Le Chan District,19,173,145,28,16
2022-03-06,Hai Phong City,Le Chan District,20,119,93,26,12
2022-03-06,Hai Phong City,Le Chan District,21,61,45,16,9
2022-03-06,Hai Phong City,Le Chan District,23,1,1,0,0
2022-03-06,Hai Phong City,Ngo Quyen District,0,3,2,1,0
2022-03-06,Hai Phong City,Ngo Quyen District,1,1,0,1,0
2022-03-06,Hai Phong City,Ngo Quyen District,2,2,2,0,0
2022-03-06,Hai Phong City,Ngo Quyen District,6,2,0,2,1
2022-03-06,Hai Phong City,Ngo Quyen District,7,23,18,5,3
2022-03-06,Hai Phong City,Ngo Quyen District,8,53,46,7,3
2022-03-06,Hai Phong City,Ngo Quyen District,9,75,71,4,0
2022-03-06,Hai Phong City,Ngo Quyen District,10,129,116,13,1
2022-03-06,Hai Phong City,Ngo Quyen District,11,207,170,37,14
2022-03-06,Hai Phong City,Ngo Quyen District,12,167,147,20,6
2022-03-06,Hai Phong City,Ngo Quyen District,13,100,89,11,0
2022-03-06,Hai Phong City,Ngo Quyen District,14,105,96,9,0
2022-03-06,Hai Phong City,Ngo Quyen District,15,161,147,14,2
2022-03-06,Hai Phong City,Ngo Quyen District,16,155,107,48,35
2022-03-06,Hai Phong City,Ngo Quyen District,17,167,120,47,24
2022-03-06,Hai Phong City,Ngo Quyen District,18,211,151,60,33
2022-03-06,Hai Phong City,Ngo Quyen District,19,154,121,33,17
2022-03-06,Hai Phong City,Ngo Quyen District,20,116,97,19,10
2022-03-06,Hai Phong City,Ngo Quyen District,21,48,40,8,1
2022-03-06,Hai Phong City,Ngo Quyen District,23,1,1,0,0
2022-03-06,Hai Phong City,Thuy Nguyen,11,2,0,2,2
2022-03-06,Hai Phong City,Thuy Nguyen,12,2,0,2,2
2022-03-06,Hai Phong City,Thuy Nguyen,13,1,0,1,0
2022-03-06,Hai Phong City,Thuy Nguyen,14,1,0,1,1
2022-03-06,Hai Phong City,Thuy Nguyen,15,5,0,5,4
2022-03-06,Hai Phong City,Thuy Nguyen,16,4,0,4,4
2022-03-06,Hai Phong City,Thuy Nguyen,17,1,0,1,1
2022-03-06,Hai Phong City,Thuy Nguyen,18,1,0,1,1
2022-03-06,Hue City,Hue City,0,2,0,2,1
2022-03-06,Hue City,Hue City,1,3,3,0,0
2022-03-06,Hue City,Hue City,6,53,48,5,0
2022-03-06,Hue City,Hue City,7,201,184,17,1
2022-03-06,Hue City,Hue City,8,337,316,21,0
2022-03-06,Hue City,Hue City,9,283,260,23,0
2022-03-06,Hue City,Hue City,10,386,357,29,2
2022-03-06,Hue City,Hue City,11,697,636,61,7
2022-03-06,Hue City,Hue City,12,496,468,28,0
2022-03-06,Hue City,Hue City,13,308,278,30,0
2022-03-06,Hue City,Hue City,14,313,281,32,1
2022-03-06,Hue City,Hue City,15,406,363,43,1
2022-03-06,Hue City,Hue City,16,432,392,40,1
2022-03-06,Hue City,Hue City,17,580,533,47,2
2022-03-06,Hue City,Hue City,18,610,569,41,6
2022-03-06,Hue City,Hue City,19,512,468,44,2
2022-03-06,Hue City,Hue City,20,361,333,28,3
2022-03-06,Hue City,Hue City,21,221,184,37,8
2022-03-06,Hue City,Hue City,22,3,2,1,0
2022-03-06,Hue City,Hue City,23,3,0,3,0
2022-03-06,Hue City,Huong Thuy,9,1,1,0,0
2022-03-06,Hue City,Huong Thuy,11,2,1,1,0
2022-03-06,Hue City,Huong Thuy,15,1,0,1,1
2022-03-06,Hue City,Huong Thuy,17,1,1,0,0
2022-03-06,Hue City,Huong Thuy,18,1,0,1,0
2022-03-06,Hue City,Huong Tra,14,1,1,0,0
2022-03-06,Hue City,Huong Tra,17,2,1,1,0
2022-03-06,Hue City,Huong Tra,18,1,1,0,0
2022-03-06,Hue City,Huong Tra,20,1,1,0,0
2022-03-06,Hue City,Phu Vang,9,2,0,2,0
2022-03-06,Hue City,Phu Vang,10,1,1,0,0
2022-03-06,Hue City,Phu Vang,11,2,1,1,0
2022-03-06,Hue City,Phu Vang,12,2,1,1,0
2022-03-06,Hue City,Phu Vang,14,2,2,0,0
2022-03-06,Hue City,Phu Vang,16,1,1,0,0
2022-03-06,Hue City,Phu Vang,17,1,0,1,1
2022-03-06,Hue City,Phu Vang,18,2,1,1,0
2022-03-06,Vung Tau,Ba Ria City,7,2,0,2,2
2022-03-06,Vung Tau,Ba Ria City,8,7,1,6,6
2022-03-06,Vung Tau,Ba Ria City,9,13,3,10,10
2022-03-06,Vung Tau,Ba Ria City,10,9,2,7,6
2022-03-06,Vung Tau,Ba Ria City,11,11,1,10,8
2022-03-06,Vung Tau,Ba Ria City,12,14,4,10,8
2022-03-06,Vung Tau,Ba Ria City,13,17,4,13,10
2022-03-06,Vung Tau,Ba Ria City,14,11,3,8,7
2022-03-06,Vung Tau,Ba Ria City,15,13,2,11,10
2022-03-06,Vung Tau,Ba Ria City,16,3,1,2,2
2022-03-06,Vung Tau,Ba Ria City,17,4,1,3,3
2022-03-06,Vung Tau,Ba Ria City,18,8,0,8,8
2022-03-06,Vung Tau,Ba Ria City,19,16,0,16,16
2022-03-06,Vung Tau,Ba Ria City,20,6,0,6,5
2022-03-06,Vung Tau,Tan Thanh,14,1,0,1,1
2022-03-06,Vung Tau,Vung Tau City,0,2,1,1,0
2022-03-06,Vung Tau,Vung Tau City,1,2,2,0,0
2022-03-06,Vung Tau,Vung Tau City,2,1,0,1,0
2022-03-06,Vung Tau,Vung Tau City,6,31,28,3,2
2022-03-06,Vung Tau,Vung Tau City,7,121,111,10,4
2022-03-06,Vung Tau,Vung Tau City,8,203,181,22,7
2022-03-06,Vung Tau,Vung Tau City,9,193,181,12,0
2022-03-06,Vung Tau,Vung Tau City,10,258,239,19,2
2022-03-06,Vung Tau,Vung Tau City,11,420,358,62,29
2022-03-06,Vung Tau,Vung Tau City,12,324,301,23,4
2022-03-06,Vung Tau,Vung Tau City,13,194,187,7,0
2022-03-06,Vung Tau,Vung Tau City,14,153,142,11,2
2022-03-06,Vung Tau,Vung Tau City,15,200,180,20,3
2022-03-06,Vung Tau,Vung Tau City,16,194,181,13,2
2022-03-06,Vung Tau,Vung Tau City,17,296,275,21,3
2022-03-06,Vung Tau,Vung Tau City,18,352,307,45,11
2022-03-06,Vung Tau,Vung Tau City,19,280,239,41,16
2022-03-06,Vung Tau,Vung Tau City,20,191,170,21,6
2022-03-06,Vung Tau,Vung Tau City,21,86,66,20,5
2022-03-06,Vung Tau,Vung Tau City,22,3,1,2,0
2022-03-07,Binh Duong,Ben Cat,12,2,0,2,2
2022-03-07,Binh Duong,Ben Cat,13,1,0,1,1
2022-03-07,Binh Duong,Ben Cat,14,1,1,0,0
2022-03-07,Binh Duong,Ben Cat,20,2,0,2,2
2022-03-07,Binh Duong,Di An,0,1,0,1,0
2022-03-07,Binh Duong,Di An,4,1,0,1,1
2022-03-07,Binh Duong,Di An,6,1,1,0,0
2022-03-07,Binh Duong,Di An,7,4,0,4,4
2022-03-07,Binh Duong,Di An,8,19,2,17,12
2022-03-07,Binh Duong,Di An,9,14,8,6,5
2022-03-07,Binh Duong,Di An,10,27,10,17,10
2022-03-07,Binh Duong,Di An,11,34,16,18,7
2022-03-07,Binh Duong,Di An,12,21,7,14,10
2022-03-07,Binh Duong,Di An,13,33,8,25,19
2022-03-07,Binh Duong,Di An,14,23,7,16,10
2022-03-07,Binh Duong,Di An,15,17,7,10,8
2022-03-07,Binh Duong,Di An,16,14,8,6,3
2022-03-07,Binh Duong,Di An,17,14,6,8,7
2022-03-07,Binh Duong,Di An,18,21,10,11,11
2022-03-07,Binh Duong,Di An,19,31,5,26,24
2022-03-07,Binh Duong,Di An,20,6,2,4,1
2022-03-07,Binh Duong,Di An,21,2,0,2,2
2022-03-07,Binh Duong,Phu Giao,16,1,0,1,1
2022-03-07,Binh Duong,Tan Uyen,11,1,0,1,0
2022-03-07,Binh Duong,Tan Uyen,12,1,1,0,0
2022-03-07,Binh Duong,Tan Uyen,13,1,1,0,0
2022-03-07,Binh Duong,Tan Uyen,14,2,0,2,0
2022-03-07,Binh Duong,Tan Uyen,15,3,3,0,0
2022-03-07,Binh Duong,Tan Uyen,17,2,1,1,1
2022-03-07,Binh Duong,Tan Uyen,19,3,0,3,3
2022-03-07,Binh Duong,Tan Uyen,20,1,0,1,1
2022-03-07,Binh Duong,Tan Uyen,21,2,1,1,1
2022-03-07,Binh Duong,Thu Dau Mot Town,0,2,0,2,0
2022-03-07,Binh Duong,Thu Dau Mot Town,1,2,1,1,1
2022-03-07,Binh Duong,Thu Dau Mot Town,5,2,1,1,1
2022-03-07,Binh Duong,Thu Dau Mot Town,6,26,18,8,8
2022-03-07,Binh Duong,Thu Dau Mot Town,7,88,73,15,4
2022-03-07,Binh Duong,Thu Dau Mot Town,8,199,186,13,2
2022-03-07,Binh Duong,Thu Dau Mot Town,9,236,212,24,3
2022-03-07,Binh Duong,Thu Dau Mot Town,10,324,303,21,3
2022-03-07,Binh Duong,Thu Dau Mot Town,11,586,546,40,13
2022-03-07,Binh Duong,Thu Dau Mot Town,12,424,400,24,3
2022-03-07,Binh Duong,Thu Dau Mot Town,13,353,332,21,6
2022-03-07,Binh Duong,Thu Dau Mot Town,14,346,325,21,3
2022-03-07,Binh Duong,Thu Dau Mot Town,15,263,251,12,2
2022-03-07,Binh Duong,Thu Dau Mot Town,16,273,262,11,2
2022-03-07,Binh Duong,Thu Dau Mot Town,17,353,336,17,1
2022-03-07,Binh Duong,Thu Dau Mot Town,18,374,355,19,5
2022-03-07,Binh Duong,Thu Dau Mot Town,19,267,256,11,1
2022-03-07,Binh Duong,Thu Dau Mot Town,20,200,184,16,1
2022-03-07,Binh Duong,Thu Dau Mot Town,21,71,57,14,4
2022-03-07,Binh Duong,Thuan An,6,4,0,4,3
2022-03-07,Binh Duong,Thuan An,7,8,2,6,2
2022-03-07,Binh Duong,Thuan An,8,15,9,6,6
2022-03-07,Binh Duong,Thuan An,9,32,16,16,5
2022-03-07,Binh Duong,Thuan An,10,67,39,28,18
2022-03-07,Binh Duong,Thuan An,11,82,46,36,24
2022-03-07,Binh Duong,Thuan An,12,84,58,26,19
2022-03-07,Binh Duong,Thuan An,13,58,42,16,7
2022-03-07,Binh Duong,Thuan An,14,44,27,17,10
2022-03-07,Binh Duong,Thuan An,15,46,26,20,12
2022-03-07,Binh Duong,Thuan An,16,36,16,20,17
2022-03-07,Binh Duong,Thuan An,17,39,16,23,17
2022-03-07,Binh Duong,Thuan An,18,50,29,21,13
2022-03-07,Binh Duong,Thuan An,19,33,20,13,12
2022-03-07,Binh Duong,Thuan An,20,34,16,18,13
2022-03-07,Binh Duong,Thuan An,21,12,1,11,6
2022-03-07,Can Tho City,Binh Thuy District,0,1,0,1,1
2022-03-07,Can Tho City,Binh Thuy District,7,1,1,0,0
2022-03-07,Can Tho City,Binh Thuy District,8,2,1,1,0
2022-03-07,Can Tho City,Binh Thuy District,9,8,8,0,0
2022-03-07,Can Tho City,Binh Thuy District,10,6,5,1,0
2022-03-07,Can Tho City,Binh Thuy District,11,9,9,0,0
2022-03-07,Can Tho City,Binh Thuy District,12,14,12,2,0
2022-03-07,Can Tho City,Binh Thuy District,13,12,11,1,0
2022-03-07,Can Tho City,Binh Thuy District,14,15,15,0,0
2022-03-07,Can Tho City,Binh Thuy District,15,8,7,1,1
2022-03-07,Can Tho City,Binh Thuy District,16,8,7,1,0
2022-03-07,Can Tho City,Binh Thuy District,17,10,9,1,0
2022-03-07,Can Tho City,Binh Thuy District,18,8,5,3,1
2022-03-07,Can Tho City,Binh Thuy District,19,12,11,1,0
2022-03-07,Can Tho City,Binh Thuy District,20,7,7,0,0
2022-03-07,Can Tho City,Binh Thuy District,21,3,2,1,0
2022-03-07,Can Tho City,Binh Thuy District,22,1,1,0,0
2022-03-07,Can Tho City,Cai Rang District,8,1,1,0,0
2022-03-07,Can Tho City,Cai Rang District,9,4,4,0,0
2022-03-07,Can Tho City,Cai Rang District,10,12,12,0,0
2022-03-07,Can Tho City,Cai Rang District,11,17,15,2,1
2022-03-07,Can Tho City,Cai Rang District,12,8,8,0,0
2022-03-07,Can Tho City,Cai Rang District,13,8,8,0,0
2022-03-07,Can Tho City,Cai Rang District,14,8,8,0,0
2022-03-07,Can Tho City,Cai Rang District,15,7,7,0,0
2022-03-07,Can Tho City,Cai Rang District,16,9,9,0,0
2022-03-07,Can Tho City,Cai Rang District,17,10,9,1,1
2022-03-07,Can Tho City,Cai Rang District,18,7,7,0,0
2022-03-07,Can Tho City,Cai Rang District,19,12,12,0,0
2022-03-07,Can Tho City,Cai Rang District,20,6,6,0,0
2022-03-07,Can Tho City,Cai Rang District,21,2,2,0,0
2022-03-07,Can Tho City,Ninh Kieu District,0,2,2,0,0
2022-03-07,Can Tho City,Ninh Kieu District,2,2,2,0,0
2022-03-07,Can Tho City,Ninh Kieu District,6,34,33,1,0
2022-03-07,Can Tho City,Ninh Kieu District,7,111,102,9,0
2022-03-07,Can Tho City,Ninh Kieu District,8,189,180,9,0
2022-03-07,Can Tho City,Ninh Kieu District,9,236,218,18,0
2022-03-07,Can Tho City,Ninh Kieu District,10,465,442,23,0
2022-03-07,Can Tho City,Ninh Kieu District,11,768,721,47,10
2022-03-07,Can Tho City,Ninh Kieu District,12,524,498,26,0
2022-03-07,Can Tho City,Ninh Kieu District,13,414,391,23,0
2022-03-07,Can Tho City,Ninh Kieu District,14,365,351,14,0
2022-03-07,Can Tho City,Ninh Kieu District,15,301,285,16,0
2022-03-07,Can Tho City,Ninh Kieu District,16,388,364,24,1
2022-03-07,Can Tho City,Ninh Kieu District,17,467,446,21,0
2022-03-07,Can Tho City,Ninh Kieu District,18,557,528,29,0
2022-03-07,Can Tho City,Ninh Kieu District,19,473,442,31,0
2022-03-07,Can Tho City,Ninh Kieu District,20,324,309,15,0
2022-03-07,Can Tho City,Ninh Kieu District,21,135,127,8,0
2022-03-07,Can Tho City,Ninh Kieu District,22,4,2,2,0
2022-03-07,Can Tho City,Ninh Kieu District,23,2,2,0,0
2022-03-07,Can Tho City,Thoi Lai,18,1,0,1,1
2022-03-07,Dong Nai,Bien Hoa City,0,3,0,3,0
2022-03-07,Dong Nai,Bien Hoa City,2,5,3,2,0
2022-03-07,Dong Nai,Bien Hoa City,5,3,0,3,0
2022-03-07,Dong Nai,Bien Hoa City,6,46,19,27,21
2022-03-07,Dong Nai,Bien Hoa City,7,157,128,29,18
2022-03-07,Dong Nai,Bien Hoa City,8,294,246,48,22
2022-03-07,Dong Nai,Bien Hoa City,9,334,300,34,9
2022-03-07,Dong Nai,Bien Hoa City,10,639,564,75,25
2022-03-07,Dong Nai,Bien Hoa City,11,948,837,111,44
2022-03-07,Dong Nai,Bien Hoa City,12,750,690,60,9
2022-03-07,Dong Nai,Bien Hoa City,13,650,598,52,18
2022-03-07,Dong Nai,Bien Hoa City,14,624,557,67,23
2022-03-07,Dong Nai,Bien Hoa City,15,467,395,72,36
2022-03-07,Dong Nai,Bien Hoa City,16,501,403,98,58
2022-03-07,Dong Nai,Bien Hoa City,17,666,512,154,84
2022-03-07,Dong Nai,Bien Hoa City,18,672,596,76,23
2022-03-07,Dong Nai,Bien Hoa City,19,625,551,74,22
2022-03-07,Dong Nai,Bien Hoa City,20,372,323,49,16
2022-03-07,Dong Nai,Bien Hoa City,21,152,119,33,12
2022-03-07,Dong Nai,Bien Hoa City,22,4,1,3,0
2022-03-07,Dong Nai,Long Thanh,10,1,0,1,1
2022-03-07,Dong Nai,Long Thanh,12,1,0,1,1
2022-03-07,Dong Nai,Long Thanh,17,1,0,1,1
2022-03-07,Dong Nai,Long Thanh,18,2,0,2,1
2022-03-07,Dong Nai,Nhon trach,13,1,0,1,1
2022-03-07,Dong Nai,Thong Nhat,8,1,1,0,0
2022-03-07,Dong Nai,Thong Nhat,9,2,2,0,0
2022-03-07,Dong Nai,Thong Nhat,10,4,3,1,0
2022-03-07,Dong Nai,Thong Nhat,11,4,3,1,0
2022-03-07,Dong Nai,Thong Nhat,13,2,2,0,0
2022-03-07,Dong Nai,Thong Nhat,15,1,1,0,0
2022-03-07,Dong Nai,Thong Nhat,16,1,1,0,0
2022-03-07,Dong Nai,Thong Nhat,18,1,1,0,0
2022-03-07,Dong Nai,Thong Nhat,20,1,1,0,0
2022-03-07,Dong Nai,Trang Bom,10,2,1,1,1
2022-03-07,Dong Nai,Trang Bom,13,2,0,2,2
2022-03-07,Dong Nai,Trang Bom,16,1,1,0,0
2022-03-07,Dong Nai,Trang Bom,19,2,0,2,2
2022-03-07,Dong Nai,Vinh Cuu,15,1,0,1,0
2022-03-07,Hai Phong City,An Duong,7,4,1,3,3
2022-03-07,Hai Phong City,An Duong,8,2,0,2,2
2022-03-07,Hai Phong City,An Duong,9,7,1,6,6
2022-03-07,Hai Phong City,An Duong,10,7,3,4,3
2022-03-07,Hai Phong City,An Duong,11,3,2,1,1
2022-03-07,Hai Phong City,An Duong,12,4,2,2,2
2022-03-07,Hai Phong City,An Duong,13,1,0,1,1
2022-03-07,Hai Phong City,An Duong,14,6,1,5,4
2022-03-07,Hai Phong City,An Duong,15,6,2,4,2
2022-03-07,Hai Phong City,An Duong,16,5,3,2,2
2022-03-07,Hai Phong City,An Duong,17,2,2,0,0
2022-03-07,Hai Phong City,An Duong,18,3,1,2,1
2022-03-07,Hai Phong City,An Duong,19,6,1,5,3
2022-03-07,Hai Phong City,An Duong,20,1,1,0,0
2022-03-07,Hai Phong City,An Duong,21,1,0,1,1
2022-03-07,Hai Phong City,Do Son District,20,1,0,1,0
2022-03-07,Hai Phong City,Hai An District,0,2,1,1,0
2022-03-07,Hai Phong City,Hai An District,1,1,0,1,0
2022-03-07,Hai Phong City,Hai An District,7,10,3,7,6
2022-03-07,Hai Phong City,Hai An District,8,10,4,6,5
2022-03-07,Hai Phong City,Hai An District,9,13,11,2,0
2022-03-07,Hai Phong City,Hai An District,10,22,19,3,1
2022-03-07,Hai Phong City,Hai An District,11,39,33,6,0
2022-03-07,Hai Phong City,Hai An District,12,23,22,1,0
2022-03-07,Hai Phong City,Hai An District,13,14,13,1,1
2022-03-07,Hai Phong City,Hai An District,14,24,20,4,0
2022-03-07,Hai Phong City,Hai An District,15,17,14,3,0
2022-03-07,Hai Phong City,Hai An District,16,12,11,1,0
2022-03-07,Hai Phong City,Hai An District,17,25,22,3,0
2022-03-07,Hai Phong City,Hai An District,18,23,20,3,1
2022-03-07,Hai Phong City,Hai An District,19,10,10,0,0
2022-03-07,Hai Phong City,Hai An District,20,11,9,2,1
2022-03-07,Hai Phong City,Hai An District,21,4,3,1,0
2022-03-07,Hai Phong City,Hai An District,22,1,0,1,1
2022-03-07,Hai Phong City,Hong Bang District,6,1,1,0,0
2022-03-07,Hai Phong City,Hong Bang District,7,11,8,3,3
2022-03-07,Hai Phong City,Hong Bang District,8,37,23,14,10
2022-03-07,Hai Phong City,Hong Bang District,9,26,20,6,0
2022-03-07,Hai Phong City,Hong Bang District,10,52,48,4,0
2022-03-07,Hai Phong City,Hong Bang District,11,91,80,11,0
2022-03-07,Hai Phong City,Hong Bang District,12,59,53,6,2
2022-03-07,Hai Phong City,Hong Bang District,13,41,36,5,1
2022-03-07,Hai Phong City,Hong Bang District,14,53,48,5,1
2022-03-07,Hai Phong City,Hong Bang District,15,40,37,3,1
2022-03-07,Hai Phong City,Hong Bang District,16,34,31,3,1
2022-03-07,Hai Phong City,Hong Bang District,17,45,40,5,1
2022-03-07,Hai Phong City,Hong Bang District,18,78,72,6,2
2022-03-07,Hai Phong City,Hong Bang District,19,55,45,10,1
2022-03-07,Hai Phong City,Hong Bang District,20,27,23,4,1
2022-03-07,Hai Phong City,Hong Bang District,21,4,4,0,0
2022-03-07,Hai Phong City,Kien An District,7,4,0,4,4
2022-03-07,Hai Phong City,Kien An District,8,5,1,4,3
2022-03-07,Hai Phong City,Kien An District,9,2,2,0,0
2022-03-07,Hai Phong City,Kien An District,10,10,7,3,2
2022-03-07,Hai Phong City,Kien An District,11,10,9,1,1
2022-03-07,Hai Phong City,Kien An District,12,4,2,2,2
2022-03-07,Hai Phong City,Kien An District,13,5,4,1,0
2022-03-07,Hai Phong City,Kien An District,14,8,7,1,1
2022-03-07,Hai Phong City,Kien An District,15,5,3,2,2
2022-03-07,Hai Phong City,Kien An District,16,4,1,3,1
2022-03-07,Hai Phong City,Kien An District,17,12,10,2,2
2022-03-07,Hai Phong City,Kien An District,18,9,6,3,1
2022-03-07,Hai Phong City,Kien An District,19,11,11,0,0
2022-03-07,Hai Phong City,Kien An District,20,15,10,5,4
2022-03-07,Hai Phong City,Kien An District,21,2,1,1,1
2022-03-07,Hai Phong City,Kien An District,22,1,0,1,0
2022-03-07,Hai Phong City,Le Chan District,0,7,4,3,0
2022-03-07,Hai Phong City,Le Chan District,1,3,2,1,0
2022-03-07,Hai Phong City,Le Chan District,2,1,0,1,0
2022-03-07,Hai Phong City,Le Chan District,6,2,1,1,1
2022-03-07,Hai Phong City,Le Chan District,7,32,21,11,5
2022-03-07,Hai Phong City,Le Chan District,8,62,44,18,5
2022-03-07,Hai Phong City,Le Chan District,9,65,57,8,1
2022-03-07,Hai Phong City,Le Chan District,10,149,136,13,2
2022-03-07,Hai Phong City,Le Chan District,11,288,252,36,9
2022-03-07,Hai Phong City,Le Chan District,12,164,150,14,3
2022-03-07,Hai Phong City,Le Chan District,13,108,94,14,0
2022-03-07,Hai Phong City,Le Chan District,14,153,132,21,5
2022-03-07,Hai Phong City,Le Chan District,15,176,149,27,5
2022-03-07,Hai Phong City,Le Chan District,16,143,128,15,0
2022-03-07,Hai Phong City,Le Chan District,17,172,156,16,0
2022-03-07,Hai Phong City,Le Chan District,18,225,193,32,2
2022-03-07,Hai Phong City,Le Chan District,19,175,152,23,4
2022-03-07,Hai Phong City,Le Chan District,20,107,96,11,0
2022-03-07,Hai Phong City,Le Chan District,21,58,44,14,1
2022-03-07,Hai Phong City,Le Chan District,22,2,0,2,0
2022-03-07,Hai Phong City,Le Chan District,23,1,1,0,0
2022-03-07,Hai Phong City,Ngo Quyen District,3,1,0,1,0
2022-03-07,Hai Phong City,Ngo Quyen District,6,1,1,0,0
2022-03-07,Hai Phong City,Ngo Quyen District,7,42,19,23,21
2022-03-07,Hai Phong City,Ngo Quyen District,8,78,60,18,6
2022-03-07,Hai Phong City,Ngo Quyen District,9,74,67,7,1
2022-03-07,Hai Phong City,Ngo Quyen District,10,121,106,15,5
2022-03-07,Hai Phong City,Ngo Quyen District,11,180,159,21,9
2022-03-07,Hai Phong City,Ngo Quyen District,12,145,127,18,1
2022-03-07,Hai Phong City,Ngo Quyen District,13,107,93,14,4
2022-03-07,Hai Phong City,Ngo Quyen District,14,136,123,13,6
2022-03-07,Hai Phong City,Ngo Quyen District,15,178,156,22,4
2022-03-07,Hai Phong City,Ngo Quyen District,16,134,123,11,2
2022-03-07,Hai Phong City,Ngo Quyen District,17,115,107,8,0
2022-03-07,Hai Phong City,Ngo Quyen District,18,158,139,19,2
2022-03-07,Hai Phong City,Ngo Quyen District,19,137,120,17,1
2022-03-07,Hai Phong City,Ngo Quyen District,20,97,84,13,1
2022-03-07,Hai Phong City,Ngo Quyen District,21,35,21,14,0
2022-03-07,Hai Phong City,Ngo Quyen District,22,1,1,0,0
2022-03-07,Hai Phong City,Ngo Quyen District,23,6,5,1,0
2022-03-07,Hai Phong City,Thuy Nguyen,11,1,0,1,1
2022-03-07,Hai Phong City,Thuy Nguyen,12,1,0,1,1
2022-03-07,Hai Phong City,Thuy Nguyen,16,5,0,5,4
2022-03-07,Hai Phong City,Thuy Nguyen,18,1,0,1,1
2022-03-07,Hai Phong City,Thuy Nguyen,19,2,0,2,2
2022-03-07,Hue City,Hue City,0,4,3,1,0
2022-03-07,Hue City,Hue City,1,1,1,0,0
2022-03-07,Hue City,Hue City,5,1,0,1,0
2022-03-07,Hue City,Hue City,6,53,50,3,0
2022-03-07,Hue City,Hue City,7,190,172,18,0
2022-03-07,Hue City,Hue City,8,415,383,32,3
2022-03-07,Hue City,Hue City,9,273,252,21,1
2022-03-07,Hue City,Hue City,10,381,363,18,0
2022-03-07,Hue City,Hue City,11,729,674,55,9
2022-03-07,Hue City,Hue City,12,441,418,23,0
2022-03-07,Hue City,Hue City,13,281,264,17,0
2022-03-07,Hue City,Hue City,14,325,301,24,1
2022-03-07,Hue City,Hue City,15,367,335,32,1
2022-03-07,Hue City,Hue City,16,442,411,31,0
2022-03-07,Hue City,Hue City,17,530,504,26,0
2022-03-07,Hue City,Hue City,18,617,577,40,0
2022-03-07,Hue City,Hue City,19,688,594,94,33
2022-03-07,Hue City,Hue City,20,522,434,88,37
2022-03-07,Hue City,Hue City,21,209,167,42,10
2022-03-07,Hue City,Hue City,22,1,1,0,0
2022-03-07,Hue City,Hue City,23,2,1,1,0
2022-03-07,Hue City,Huong Thuy,7,1,1,0,0
2022-03-07,Hue City,Huong Thuy,11,1,0,1,0
2022-03-07,Hue City,Huong Thuy,12,2,0,2,0
2022-03-07,Hue City,Huong Thuy,15,1,1,0,0
2022-03-07,Hue City,Huong Thuy,17,3,2,1,0
2022-03-07,Hue City,Huong Thuy,18,5,5,0,0
2022-03-07,Hue City,Huong Thuy,19,2,0,2,2
2022-03-07,Hue City,Huong Thuy,20,3,0,3,3
2022-03-07,Hue City,Huong Thuy,21,2,0,2,0
2022-03-07,Hue City,Huong Tra,9,1,1,0,0
2022-03-07,Hue City,Huong Tra,16,1,1,0,0
2022-03-07,Hue City,Huong Tra,18,1,1,0,0
2022-03-07,Hue City,Phu Vang,6,4,2,2,2
2022-03-07,Hue City,Phu Vang,8,2,2,0,0
2022-03-07,Hue City,Phu Vang,10,2,2,0,0
2022-03-07,Hue City,Phu Vang,11,2,1,1,1
2022-03-07,Hue City,Phu Vang,14,1,1,0,0
2022-03-07,Hue City,Phu Vang,15,3,2,1,0
2022-03-07,Hue City,Phu Vang,16,5,2,3,0
2022-03-07,Hue City,Phu Vang,17,3,3,0,0
2022-03-07,Hue City,Phu Vang,18,7,3,4,1
2022-03-07,Hue City,Phu Vang,19,1,1,0,0
2022-03-07,Hue City,Phu Vang,20,1,0,1,0
2022-03-07,Hue City,Phu Vang,21,2,1,1,1
2022-03-07,Vung Tau,Ba Ria City,7,1,0,1,1
2022-03-07,Vung Tau,Ba Ria City,8,1,0,1,1
2022-03-07,Vung Tau,Ba Ria City,9,7,0,7,7
2022-03-07,Vung Tau,Ba Ria City,10,9,0,9,8
2022-03-07,Vung Tau,Ba Ria City,11,15,0,15,15
2022-03-07,Vung Tau,Ba Ria City,12,11,0,11,9
2022-03-07,Vung Tau,Ba Ria City,13,5,0,5,5
2022-03-07,Vung Tau,Ba Ria City,14,11,4,7,6
2022-03-07,Vung Tau,Ba Ria City,15,10,0,10,9
2022-03-07,Vung Tau,Ba Ria City,16,7,0,7,6
2022-03-07,Vung Tau,Ba Ria City,17,7,3,4,4
2022-03-07,Vung Tau,Ba Ria City,18,9,2,7,6
2022-03-07,Vung Tau,Ba Ria City,19,7,0,7,6
2022-03-07,Vung Tau,Ba Ria City,20,5,0,5,5
2022-03-07,Vung Tau,Vung Tau City,0,3,0,3,1
2022-03-07,Vung Tau,Vung Tau City,1,1,0,1,0
2022-03-07,Vung Tau,Vung Tau City,5,1,0,1,1
2022-03-07,Vung Tau,Vung Tau City,6,42,35,7,2
2022-03-07,Vung Tau,Vung Tau City,7,92,86,6,0
2022-03-07,Vung Tau,Vung Tau City,8,137,127,10,1
2022-03-07,Vung Tau,Vung Tau City,9,137,126,11,4
2022-03-07,Vung Tau,Vung Tau City,10,165,152,13,1
2022-03-07,Vung Tau,Vung Tau City,11,324,303,21,4
2022-03-07,Vung Tau,Vung Tau City,12,224,214,10,1
2022-03-07,Vung Tau,Vung Tau City,13,159,153,6,1
2022-03-07,Vung Tau,Vung Tau City,14,206,191,15,1
2022-03-07,Vung Tau,Vung Tau City,15,226,206,20,5
2022-03-07,Vung Tau,Vung Tau City,16,174,162,12,1
2022-03-07,Vung Tau,Vung Tau City,17,271,239,32,2
2022-03-07,Vung Tau,Vung Tau City,18,335,289,46,17
2022-03-07,Vung Tau,Vung Tau City,19,256,230,26,5
2022-03-07,Vung Tau,Vung Tau City,20,167,145,22,2
2022-03-07,Vung Tau,Vung Tau City,21,62,53,9,4
2022-03-07,Vung Tau,Vung Tau City,22,2,1,1,0
2022-03-08,Binh Duong,Ben Cat,7,1,1,0,0
2022-03-08,Binh Duong,Ben Cat,9,2,0,2,2
2022-03-08,Binh Duong,Ben Cat,10,1,0,1,1
2022-03-08,Binh Duong,Ben Cat,11,1,0,1,1
2022-03-08,Binh Duong,Ben Cat,12,1,0,1,1
2022-03-08,Binh Duong,Ben Cat,13,1,0,1,1
2022-03-08,Binh Duong,Ben Cat,18,1,0,1,1
2022-03-08,Binh Duong,Ben Cat,20,1,1,0,0
2022-03-08,Binh Duong,Di An,0,3,0,3,2
2022-03-08,Binh Duong,Di An,6,1,1,0,0
2022-03-08,Binh Duong,Di An,7,13,0,13,13
2022-03-08,Binh Duong,Di An,8,15,2,13,12
2022-03-08,Binh Duong,Di An,9,36,8,28,21
2022-03-08,Binh Duong,Di An,10,33,9,24,22
2022-03-08,Binh Duong,Di An,11,61,19,42,31
2022-03-08,Binh Duong,Di An,12,58,18,40,36
2022-03-08,Binh Duong,Di An,13,53,21,32,30
2022-03-08,Binh Duong,Di An,14,47,18,29,23
2022-03-08,Binh Duong,Di An,15,31,19,12,11
2022-03-08,Binh Duong,Di An,16,24,11,13,11
2022-03-08,Binh Duong,Di An,17,44,21,23,18
2022-03-08,Binh Duong,Di An,18,24,9,15,11
2022-03-08,Binh Duong,Di An,19,44,12,32,25
2022-03-08,Binh Duong,Di An,20,21,4,17,12
2022-03-08,Binh Duong,Di An,21,17,2,15,9
2022-03-08,Binh Duong,Tan Uyen,9,2,0,2,2
2022-03-08,Binh Duong,Tan Uyen,10,1,1,0,0
2022-03-08,Binh Duong,Tan Uyen,11,9,3,6,3
2022-03-08,Binh Duong,Tan Uyen,12,1,0,1,1
2022-03-08,Binh Duong,Tan Uyen,13,8,2,6,4
2022-03-08,Binh Duong,Tan Uyen,14,2,1,1,1
2022-03-08,Binh Duong,Tan Uyen,15,1,1,0,0
2022-03-08,Binh Duong,Tan Uyen,17,6,4,2,2
2022-03-08,Binh Duong,Tan Uyen,19,1,1,0,0
2022-03-08,Binh Duong,Tan Uyen,20,1,0,1,1
2022-03-08,Binh Duong,Tan Uyen,21,1,0,1,0
2022-03-08,Binh Duong,Thu Dau Mot Town,0,2,2,0,0
2022-03-08,Binh Duong,Thu Dau Mot Town,1,2,2,0,0
2022-03-08,Binh Duong,Thu Dau Mot Town,6,47,35,12,7
2022-03-08,Binh Duong,Thu Dau Mot Town,7,136,124,12,2
2022-03-08,Binh Duong,Thu Dau Mot Town,8,248,219,29,3
2022-03-08,Binh Duong,Thu Dau Mot Town,9,354,303,51,10
2022-03-08,Binh Duong,Thu Dau Mot Town,10,490,420,70,24
2022-03-08,Binh Duong,Thu Dau Mot Town,11,775,621,154,82
2022-03-08,Binh Duong,Thu Dau Mot Town,12,553,471,82,38
2022-03-08,Binh Duong,Thu Dau Mot Town,13,592,488,104,50
2022-03-08,Binh Duong,Thu Dau Mot Town,14,416,363,53,8
2022-03-08,Binh Duong,Thu Dau Mot Town,15,359,321,38,7
2022-03-08,Binh Duong,Thu Dau Mot Town,16,359,299,60,36
2022-03-08,Binh Duong,Thu Dau Mot Town,17,495,385,110,68
2022-03-08,Binh Duong,Thu Dau Mot Town,18,551,467,84,47
2022-03-08,Binh Duong,Thu Dau Mot Town,19,492,358,134,79
2022-03-08,Binh Duong,Thu Dau Mot Town,20,310,240,70,22
2022-03-08,Binh Duong,Thu Dau Mot Town,21,131,90,41,14
2022-03-08,Binh Duong,Thu Dau Mot Town,22,1,0,1,0
2022-03-08,Binh Duong,Thu Dau Mot Town,23,2,2,0,0
2022-03-08,Binh Duong,Thuan An,2,2,0,2,1
2022-03-08,Binh Duong,Thuan An,6,3,1,2,2
2022-03-08,Binh Duong,Thuan An,7,4,0,4,3
2022-03-08,Binh Duong,Thuan An,8,27,10,17,14
2022-03-08,Binh Duong,Thuan An,9,99,28,71,58
2022-03-08,Binh Duong,Thuan An,10,121,46,75,62
2022-03-08,Binh Duong,Thuan An,11,128,51,77,62
2022-03-08,Binh Duong,Thuan An,12,134,61,73,59
2022-03-08,Binh Duong,Thuan An,13,158,59,99,63
2022-03-08,Binh Duong,Thuan An,14,108,39,69,48
2022-03-08,Binh Duong,Thuan An,15,68,31,37,25
2022-03-08,Binh Duong,Thuan An,16,50,25,25,21
2022-03-08,Binh Duong,Thuan An,17,66,29,37,31
2022-03-08,Binh Duong,Thuan An,18,76,39,37,26
2022-03-08,Binh Duong,Thuan An,19,74,29,45,42
2022-03-08,Binh Duong,Thuan An,20,64,20,44,37
2022-03-08,Binh Duong,Thuan An,21,15,7,8,4
2022-03-08,Can Tho City,Binh Thuy District,6,2,2,0,0
2022-03-08,Can Tho City,Binh Thuy District,7,1,1,0,0
2022-03-08,Can Tho City,Binh Thuy District,8,6,5,1,0
2022-03-08,Can Tho City,Binh Thuy District,9,8,8,0,0
2022-03-08,Can Tho City,Binh Thuy District,10,5,5,0,0
2022-03-08,Can Tho City,Binh Thuy District,11,17,15,2,0
2022-03-08,Can Tho City,Binh Thuy District,12,11,9,2,0
2022-03-08,Can Tho City,Binh Thuy District,13,19,17,2,2
2022-03-08,Can Tho City,Binh Thuy District,14,18,18,0,0
2022-03-08,Can Tho City,Binh Thuy District,15,23,23,0,0
2022-03-08,Can Tho City,Binh Thuy District,16,21,20,1,0
2022-03-08,Can Tho City,Binh Thuy District,17,20,18,2,1
2022-03-08,Can Tho City,Binh Thuy District,18,19,18,1,0
2022-03-08,Can Tho City,Binh Thuy District,19,13,12,1,0
2022-03-08,Can Tho City,Binh Thuy District,20,14,13,1,0
2022-03-08,Can Tho City,Binh Thuy District,21,7,5,2,0
2022-03-08,Can Tho City,Cai Rang District,7,2,2,0,0
2022-03-08,Can Tho City,Cai Rang District,8,7,7,0,0
2022-03-08,Can Tho City,Cai Rang District,9,14,10,4,1
2022-03-08,Can Tho City,Cai Rang District,10,13,13,0,0
2022-03-08,Can Tho City,Cai Rang District,11,17,14,3,1
2022-03-08,Can Tho City,Cai Rang District,12,9,8,1,0
2022-03-08,Can Tho City,Cai Rang District,13,6,6,0,0
2022-03-08,Can Tho City,Cai Rang District,14,13,8,5,0
2022-03-08,Can Tho City,Cai Rang District,15,16,15,1,0
2022-03-08,Can Tho City,Cai Rang District,16,15,15,0,0
2022-03-08,Can Tho City,Cai Rang District,17,18,16,2,0
2022-03-08,Can Tho City,Cai Rang District,18,17,14,3,2
2022-03-08,Can Tho City,Cai Rang District,19,16,14,2,1
2022-03-08,Can Tho City,Cai Rang District,20,7,6,1,1
2022-03-08,Can Tho City,Cai Rang District,21,5,4,1,0
2022-03-08,Can Tho City,Ninh Kieu District,0,21,16,5,0
2022-03-08,Can Tho City,Ninh Kieu District,1,3,1,2,0
2022-03-08,Can Tho City,Ninh Kieu District,2,3,2,1,0
2022-03-08,Can Tho City,Ninh Kieu District,5,1,0,1,0
2022-03-08,Can Tho City,Ninh Kieu District,6,40,36,4,0
2022-03-08,Can Tho City,Ninh Kieu District,7,159,147,12,0
2022-03-08,Can Tho City,Ninh Kieu District,8,265,254,11,0
2022-03-08,Can Tho City,Ninh Kieu District,9,338,319,19,0
2022-03-08,Can Tho City,Ninh Kieu District,10,642,606,36,2
2022-03-08,Can Tho City,Ninh Kieu District,11,864,802,62,10
2022-03-08,Can Tho City,Ninh Kieu District,12,699,662,37,0
2022-03-08,Can Tho City,Ninh Kieu District,13,557,525,32,0
2022-03-08,Can Tho City,Ninh Kieu District,14,512,469,43,0
2022-03-08,Can Tho City,Ninh Kieu District,15,491,452,39,1
2022-03-08,Can Tho City,Ninh Kieu District,16,576,531,45,4
2022-03-08,Can Tho City,Ninh Kieu District,17,697,628,69,15
2022-03-08,Can Tho City,Ninh Kieu District,18,680,617,63,9
2022-03-08,Can Tho City,Ninh Kieu District,19,640,564,76,8
2022-03-08,Can Tho City,Ninh Kieu District,20,433,379,54,6
2022-03-08,Can Tho City,Ninh Kieu District,21,238,202,36,3
2022-03-08,Can Tho City,Ninh Kieu District,22,6,4,2,0
2022-03-08,Can Tho City,Ninh Kieu District,23,5,5,0,0
2022-03-08,Dong Nai,Bien Hoa City,0,11,8,3,1
2022-03-08,Dong Nai,Bien Hoa City,1,3,3,0,0
2022-03-08,Dong Nai,Bien Hoa City,2,1,0,1,0
2022-03-08,Dong Nai,Bien Hoa City,3,2,1,1,1
2022-03-08,Dong Nai,Bien Hoa City,5,3,1,2,1
2022-03-08,Dong Nai,Bien Hoa City,6,54,31,23,18
2022-03-08,Dong Nai,Bien Hoa City,7,220,150,70,44
2022-03-08,Dong Nai,Bien Hoa City,8,378,299,79,28
2022-03-08,Dong Nai,Bien Hoa City,9,640,488,152,66
2022-03-08,Dong Nai,Bien Hoa City,10,1055,808,247,143
2022-03-08,Dong Nai,Bien Hoa City,11,1427,1024,403,242
2022-03-08,Dong Nai,Bien Hoa City,12,1101,914,187,98
2022-03-08,Dong Nai,Bien Hoa City,13,1065,838,227,108
2022-03-08,Dong Nai,Bien Hoa City,14,829,643,186,62
2022-03-08,Dong Nai,Bien Hoa City,15,725,575,150,49
2022-03-08,Dong Nai,Bien Hoa City,16,720,610,110,53
2022-03-08,Dong Nai,Bien Hoa City,17,939,691,248,140
2022-03-08,Dong Nai,Bien Hoa City,18,1066,757,309,190
2022-03-08,Dong Nai,Bien Hoa City,19,1056,673,383,264
2022-03-08,Dong Nai,Bien Hoa City,20,685,422,263,178
2022-03-08,Dong Nai,Bien Hoa City,21,295,160,135,83
2022-03-08,Dong Nai,Bien Hoa City,22,6,1,5,1
2022-03-08,Dong Nai,Bien Hoa City,23,3,1,2,1
2022-03-08,Dong Nai,Long Thanh,8,1,0,1,1
2022-03-08,Dong Nai,Long Thanh,11,1,0,1,1
2022-03-08,Dong Nai,Long Thanh,12,1,0,1,1
2022-03-08,Dong Nai,Long Thanh,13,1,0,1,1
2022-03-08,Dong Nai,Long Thanh,14,1,0,1,1
2022-03-08,Dong Nai,Long Thanh,15,2,0,2,2
2022-03-08,Dong Nai,Long Thanh,16,1,0,1,1
2022-03-08,Dong Nai,Long Thanh,19,1,0,1,1
2022-03-08,Dong Nai,Long Thanh,20,1,0,1,1
2022-03-08,Dong Nai,Nhon trach,16,2,0,2,1
2022-03-08,Dong Nai,Nhon trach,19,1,0,1,1
2022-03-08,Dong Nai,Thong Nhat,7,3,3,0,0
2022-03-08,Dong Nai,Thong Nhat,8,2,2,0,0
2022-03-08,Dong Nai,Thong Nhat,9,3,3,0,0
2022-03-08,Dong Nai,Thong Nhat,10,3,2,1,1
2022-03-08,Dong Nai,Thong Nhat,11,4,3,1,1
2022-03-08,Dong Nai,Thong Nhat,12,5,5,0,0
2022-03-08,Dong Nai,Thong Nhat,13,6,3,3,2
2022-03-08,Dong Nai,Thong Nhat,14,12,8,4,2
2022-03-08,Dong Nai,Thong Nhat,15,1,1,0,0
2022-03-08,Dong Nai,Thong Nhat,16,2,2,0,0
2022-03-08,Dong Nai,Thong Nhat,17,2,2,0,0
2022-03-08,Dong Nai,Thong Nhat,18,3,3,0,0
2022-03-08,Dong Nai,Thong Nhat,19,2,1,1,1
2022-03-08,Dong Nai,Thong Nhat,20,3,1,2,1
2022-03-08,Dong Nai,Thong Nhat,21,2,2,0,0
2022-03-08,Dong Nai,Trang Bom,9,5,1,4,4
2022-03-08,Dong Nai,Trang Bom,10,4,0,4,4
2022-03-08,Dong Nai,Trang Bom,11,3,2,1,1
2022-03-08,Dong Nai,Trang Bom,12,3,0,3,2
2022-03-08,Dong Nai,Trang Bom,13,2,1,1,1
2022-03-08,Dong Nai,Trang Bom,14,2,2,0,0
2022-03-08,Dong Nai,Trang Bom,17,1,0,1,1
2022-03-08,Dong Nai,Trang Bom,18,1,1,0,0
2022-03-08,Dong Nai,Trang Bom,19,3,1,2,2
2022-03-08,Dong Nai,Trang Bom,20,1,0,1,1
2022-03-08,Dong Nai,Trang Bom,21,1,0,1,1
2022-03-08,Hai Phong City,An Duong,7,1,0,1,1
2022-03-08,Hai Phong City,An Duong,8,9,2,7,4
2022-03-08,Hai Phong City,An Duong,9,6,1,5,4
2022-03-08,Hai Phong City,An Duong,10,4,2,2,2
2022-03-08,Hai Phong City,An Duong,11,7,2,5,3
2022-03-08,Hai Phong City,An Duong,12,9,4,5,4
2022-03-08,Hai Phong City,An Duong,13,7,3,4,4
2022-03-08,Hai Phong City,An Duong,14,10,1,9,6
2022-03-08,Hai Phong City,An Duong,15,6,2,4,2
2022-03-08,Hai Phong City,An Duong,16,3,1,2,1
2022-03-08,Hai Phong City,An Duong,17,3,3,0,0
2022-03-08,Hai Phong City,An Duong,18,5,1,4,4
2022-03-08,Hai Phong City,An Duong,19,2,0,2,1
2022-03-08,Hai Phong City,An Duong,20,4,0,4,3
2022-03-08,Hai Phong City,An Duong,21,1,0,1,0
2022-03-08,Hai Phong City,Do Son District,20,1,0,1,1
2022-03-08,Hai Phong City,Duong Kinh District,12,1,1,0,0
2022-03-08,Hai Phong City,Duong Kinh District,13,1,0,1,0
2022-03-08,Hai Phong City,Hai An District,7,6,3,3,2
2022-03-08,Hai Phong City,Hai An District,8,15,12,3,2
2022-03-08,Hai Phong City,Hai An District,9,15,11,4,2
2022-03-08,Hai Phong City,Hai An District,10,27,24,3,1
2022-03-08,Hai Phong City,Hai An District,11,41,34,7,2
2022-03-08,Hai Phong City,Hai An District,12,28,22,6,0
2022-03-08,Hai Phong City,Hai An District,13,13,11,2,0
2022-03-08,Hai Phong City,Hai An District,14,25,22,3,2
2022-03-08,Hai Phong City,Hai An District,15,35,24,11,7
2022-03-08,Hai Phong City,Hai An District,16,20,13,7,1
2022-03-08,Hai Phong City,Hai An District,17,44,30,14,2
2022-03-08,Hai Phong City,Hai An District,18,38,25,13,6
2022-03-08,Hai Phong City,Hai An District,19,39,20,19,13
2022-03-08,Hai Phong City,Hai An District,20,36,27,9,4
2022-03-08,Hai Phong City,Hai An District,21,15,10,5,4
2022-03-08,Hai Phong City,Hong Bang District,1,1,0,1,0
2022-03-08,Hai Phong City,Hong Bang District,6,3,2,1,0
2022-03-08,Hai Phong City,Hong Bang District,7,18,17,1,1
2022-03-08,Hai Phong City,Hong Bang District,8,29,22,7,2
2022-03-08,Hai Phong City,Hong Bang District,9,48,39,9,2
2022-03-08,Hai Phong City,Hong Bang District,10,85,68,17,8
2022-03-08,Hai Phong City,Hong Bang District,11,118,94,24,17
2022-03-08,Hai Phong City,Hong Bang District,12,65,56,9,2
2022-03-08,Hai Phong City,Hong Bang District,13,46,41,5,1
2022-03-08,Hai Phong City,Hong Bang District,14,81,49,32,14
2022-03-08,Hai Phong City,Hong Bang District,15,70,51,19,10
2022-03-08,Hai Phong City,Hong Bang District,16,58,49,9,2
2022-03-08,Hai Phong City,Hong Bang District,17,61,49,12,5
2022-03-08,Hai Phong City,Hong Bang District,18,113,60,53,37
2022-03-08,Hai Phong City,Hong Bang District,19,95,59,36,23
2022-03-08,Hai Phong City,Hong Bang District,20,66,36,30,22
2022-03-08,Hai Phong City,Hong Bang District,21,31,17,14,7
2022-03-08,Hai Phong City,Hong Bang District,23,1,1,0,0
2022-03-08,Hai Phong City,Kien An District,7,2,1,1,0
2022-03-08,Hai Phong City,Kien An District,8,3,3,0,0
2022-03-08,Hai Phong City,Kien An District,9,2,1,1,1
2022-03-08,Hai Phong City,Kien An District,10,12,9,3,3
2022-03-08,Hai Phong City,Kien An District,11,17,14,3,1
2022-03-08,Hai Phong City,Kien An District,12,13,9,4,1
2022-03-08,Hai Phong City,Kien An District,13,8,6,2,1
2022-03-08,Hai Phong City,Kien An District,14,13,9,4,2
2022-03-08,Hai Phong City,Kien An District,15,20,9,11,4
2022-03-08,Hai Phong City,Kien An District,16,10,10,0,0
2022-03-08,Hai Phong City,Kien An District,17,9,8,1,0
2022-03-08,Hai Phong City,Kien An District,18,23,18,5,3
2022-03-08,Hai Phong City,Kien An District,19,26,14,12,10
2022-03-08,Hai Phong City,Kien An District,20,15,9,6,5
2022-03-08,Hai Phong City,Kien An District,21,9,4,5,3
2022-03-08,Hai Phong City,Le Chan District,0,13,8,5,0
2022-03-08,Hai Phong City,Le Chan District,1,5,3,2,1
2022-03-08,Hai Phong City,Le Chan District,2,1,1,0,0
2022-03-08,Hai Phong City,Le Chan District,5,1,0,1,0
2022-03-08,Hai Phong City,Le Chan District,6,5,2,3,1
2022-03-08,Hai Phong City,Le Chan District,7,36,28,8,4
2022-03-08,Hai Phong City,Le Chan District,8,85,67,18,5
2022-03-08,Hai Phong City,Le Chan District,9,105,86,19,4
2022-03-08,Hai Phong City,Le Chan District,10,228,188,40,14
2022-03-08,Hai Phong City,Le Chan District,11,382,308,74,31
2022-03-08,Hai Phong City,Le Chan District,12,230,201,29,6
2022-03-08,Hai Phong City,Le Chan District,13,140,118,22,3
2022-03-08,Hai Phong City,Le Chan District,14,218,151,67,37
2022-03-08,Hai Phong City,Le Chan District,15,248,172,76,53
2022-03-08,Hai Phong City,Le Chan District,16,182,152,30,7
2022-03-08,Hai Phong City,Le Chan District,17,275,213,62,19
2022-03-08,Hai Phong City,Le Chan District,18,364,203,161,89
2022-03-08,Hai Phong City,Le Chan District,19,389,192,197,141
2022-03-08,Hai Phong City,Le Chan District,20,224,123,101,67
2022-03-08,Hai Phong City,Le Chan District,21,98,55,43,20
2022-03-08,Hai Phong City,Le Chan District,23,1,0,1,0
2022-03-08,Hai Phong City,Ngo Quyen District,0,4,4,0,0
2022-03-08,Hai Phong City,Ngo Quyen District,1,2,1,1,0
2022-03-08,Hai Phong City,Ngo Quyen District,6,2,2,0,0
2022-03-08,Hai Phong City,Ngo Quyen District,7,32,24,8,4
2022-03-08,Hai Phong City,Ngo Quyen District,8,117,94,23,7
2022-03-08,Hai Phong City,Ngo Quyen District,9,97,84,13,5
2022-03-08,Hai Phong City,Ngo Quyen District,10,163,139,24,6
2022-03-08,Hai Phong City,Ngo Quyen District,11,279,233,46,24
2022-03-08,Hai Phong City,Ngo Quyen District,12,191,161,30,4
2022-03-08,Hai Phong City,Ngo Quyen District,13,172,147,25,4
2022-03-08,Hai Phong City,Ngo Quyen District,14,285,178,107,54
2022-03-08,Hai Phong City,Ngo Quyen District,15,293,177,116,63
2022-03-08,Hai Phong City,Ngo Quyen District,16,198,156,42,15
2022-03-08,Hai Phong City,Ngo Quyen District,17,196,154,42,16
2022-03-08,Hai Phong City,Ngo Quyen District,18,292,190,102,72
2022-03-08,Hai Phong City,Ngo Quyen District,19,271,142,129,81
2022-03-08,Hai Phong City,Ngo Quyen District,20,240,125,115,77
2022-03-08,Hai Phong City,Ngo Quyen District,21,98,51,47,24
2022-03-08,Hai Phong City,Thuy Nguyen,9,1,0,1,0
2022-03-08,Hai Phong City,Thuy Nguyen,10,2,0,2,1
2022-03-08,Hai Phong City,Thuy Nguyen,12,2,0,2,2
2022-03-08,Hai Phong City,Thuy Nguyen,13,3,0,3,2
2022-03-08,Hai Phong City,Thuy Nguyen,14,3,0,3,2
2022-03-08,Hai Phong City,Thuy Nguyen,15,2,1,1,1
2022-03-08,Hai Phong City,Thuy Nguyen,16,1,0,1,1
2022-03-08,Hai Phong City,Thuy Nguyen,17,2,0,2,2
2022-03-08,Hai Phong City,Thuy Nguyen,18,1,0,1,1
2022-03-08,Hue City,Hue City,0,18,13,5,0
2022-03-08,Hue City,Hue City,1,7,5,2,1
2022-03-08,Hue City,Hue City,2,3,2,1,0
2022-03-08,Hue City,Hue City,5,1,1,0,0
2022-03-08,Hue City,Hue City,6,68,65,3,1
2022-03-08,Hue City,Hue City,7,223,205,18,3
2022-03-08,Hue City,Hue City,8,357,328,29,0
2022-03-08,Hue City,Hue City,9,317,286,31,0
2022-03-08,Hue City,Hue City,10,459,431,28,0
2022-03-08,Hue City,Hue City,11,850,777,73,4
2022-03-08,Hue City,Hue City,12,531,481,50,0
2022-03-08,Hue City,Hue City,13,378,347,31,0
2022-03-08,Hue City,Hue City,14,454,415,39,0
2022-03-08,Hue City,Hue City,15,518,476,42,2
2022-03-08,Hue City,Hue City,16,507,470,37,2
2022-03-08,Hue City,Hue City,17,722,648,74,6
2022-03-08,Hue City,Hue City,18,948,797,151,41
2022-03-08,Hue City,Hue City,19,851,683,168,44
2022-03-08,Hue City,Hue City,20,603,492,111,31
2022-03-08,Hue City,Hue City,21,253,204,49,8
2022-03-08,Hue City,Hue City,22,2,1,1,1
2022-03-08,Hue City,Hue City,23,1,1,0,0
2022-03-08,Hue City,Huong Thuy,11,1,1,0,0
2022-03-08,Hue City,Huong Thuy,12,2,1,1,1
2022-03-08,Hue City,Huong Thuy,13,2,1,1,0
2022-03-08,Hue City,Huong Thuy,14,3,3,0,0
2022-03-08,Hue City,Huong Thuy,15,1,1,0,0
2022-03-08,Hue City,Huong Thuy,17,1,1,0,0
2022-03-08,Hue City,Huong Thuy,18,2,2,0,0
2022-03-08,Hue City,Huong Thuy,19,4,1,3,0
2022-03-08,Hue City,Huong Thuy,20,1,1,0,0
2022-03-08,Hue City,Huong Thuy,21,2,0,2,2
2022-03-08,Hue City,Huong Tra,11,1,1,0,0
2022-03-08,Hue City,Huong Tra,18,1,1,0,0
2022-03-08,Hue City,Phu Vang,7,1,1,0,0
2022-03-08,Hue City,Phu Vang,9,1,1,0,0
2022-03-08,Hue City,Phu Vang,10,2,2,0,0
2022-03-08,Hue City,Phu Vang,11,1,1,0,0
2022-03-08,Hue City,Phu Vang,12,1,1,0,0
2022-03-08,Hue City,Phu Vang,14,2,1,1,0
2022-03-08,Hue City,Phu Vang,15,1,1,0,0
2022-03-08,Hue City,Phu Vang,16,4,2,2,1
2022-03-08,Hue City,Phu Vang,17,5,4,1,0
2022-03-08,Hue City,Phu Vang,18,5,5,0,0
2022-03-08,Hue City,Phu Vang,19,1,0,1,1
2022-03-08,Hue City,Phu Vang,20,1,1,0,0
2022-03-08,Vung Tau,Ba Ria City,6,1,0,1,1
2022-03-08,Vung Tau,Ba Ria City,7,5,0,5,3
2022-03-08,Vung Tau,Ba Ria City,8,3,1,2,2
2022-03-08,Vung Tau,Ba Ria City,9,15,2,13,9
2022-03-08,Vung Tau,Ba Ria City,10,26,6,20,19
2022-03-08,Vung Tau,Ba Ria City,11,11,3,8,8
2022-03-08,Vung Tau,Ba Ria City,12,10,7,3,3
2022-03-08,Vung Tau,Ba Ria City,13,14,2,12,12
2022-03-08,Vung Tau,Ba Ria City,14,18,2,16,11
2022-03-08,Vung Tau,Ba Ria City,15,6,3,3,3
2022-03-08,Vung Tau,Ba Ria City,16,10,3,7,6
2022-03-08,Vung Tau,Ba Ria City,17,10,3,7,4
2022-03-08,Vung Tau,Ba Ria City,18,10,0,10,8
2022-03-08,Vung Tau,Ba Ria City,19,16,5,11,9
2022-03-08,Vung Tau,Ba Ria City,20,5,0,5,5
2022-03-08,Vung Tau,Vung Tau City,1,2,2,0,0
2022-03-08,Vung Tau,Vung Tau City,2,1,1,0,0
2022-03-08,Vung Tau,Vung Tau City,6,40,31,9,6
2022-03-08,Vung Tau,Vung Tau City,7,98,87,11,2
2022-03-08,Vung Tau,Vung Tau City,8,189,162,27,4
2022-03-08,Vung Tau,Vung Tau City,9,206,176,30,1
2022-03-08,Vung Tau,Vung Tau City,10,257,232,25,0
2022-03-08,Vung Tau,Vung Tau City,11,377,338,39,8
2022-03-08,Vung Tau,Vung Tau City,12,283,251,32,2
2022-03-08,Vung Tau,Vung Tau City,13,262,237,25,9
2022-03-08,Vung Tau,Vung Tau City,14,273,221,52,3
2022-03-08,Vung Tau,Vung Tau City,15,287,251,36,3
2022-03-08,Vung Tau,Vung Tau City,16,309,273,36,10
2022-03-08,Vung Tau,Vung Tau City,17,377,292,85,28
2022-03-08,Vung Tau,Vung Tau City,18,450,325,125,64
2022-03-08,Vung Tau,Vung Tau City,19,321,250,71,20
2022-03-08,Vung Tau,Vung Tau City,20,204,161,43,15
2022-03-08,Vung Tau,Vung Tau City,21,87,63,24,3
2022-03-08,Vung Tau,Vung Tau City,22,1,1,0,0
2022-03-08,Vung Tau,Vung Tau City,23,1,1,0,0
2022-03-09,Binh Duong,Ben Cat,11,1,0,1,1
2022-03-09,Binh Duong,Ben Cat,12,1,0,1,1
2022-03-09,Binh Duong,Ben Cat,13,1,0,1,1
2022-03-09,Binh Duong,Ben Cat,19,1,0,1,1
2022-03-09,Binh Duong,Ben Cat,20,2,0,2,1
2022-03-09,Binh Duong,Ben Cat,21,1,0,1,1
2022-03-09,Binh Duong,Di An,6,2,0,2,1
2022-03-09,Binh Duong,Di An,7,5,0,5,3
2022-03-09,Binh Duong,Di An,8,8,0,8,5
2022-03-09,Binh Duong,Di An,9,13,2,11,10
2022-03-09,Binh Duong,Di An,10,39,8,31,28
2022-03-09,Binh Duong,Di An,11,28,13,15,11
2022-03-09,Binh Duong,Di An,12,47,14,33,31
2022-03-09,Binh Duong,Di An,13,36,5,31,24
2022-03-09,Binh Duong,Di An,14,42,2,40,36
2022-03-09,Binh Duong,Di An,15,33,8,25,21
2022-03-09,Binh Duong,Di An,16,22,8,14,12
2022-03-09,Binh Duong,Di An,17,32,6,26,23
2022-03-09,Binh Duong,Di An,18,42,14,28,24
2022-03-09,Binh Duong,Di An,19,28,5,23,18
2022-03-09,Binh Duong,Di An,20,17,2,15,12
2022-03-09,Binh Duong,Di An,21,12,1,11,9
2022-03-09,Binh Duong,Tan Uyen,7,3,0,3,3
2022-03-09,Binh Duong,Tan Uyen,8,1,1,0,0
2022-03-09,Binh Duong,Tan Uyen,9,3,0,3,3
2022-03-09,Binh Duong,Tan Uyen,11,2,1,1,1
2022-03-09,Binh Duong,Tan Uyen,12,5,1,4,2
2022-03-09,Binh Duong,Tan Uyen,13,2,2,0,0
2022-03-09,Binh Duong,Tan Uyen,14,1,0,1,1
2022-03-09,Binh Duong,Tan Uyen,16,1,0,1,1
2022-03-09,Binh Duong,Tan Uyen,17,4,0,4,3
2022-03-09,Binh Duong,Tan Uyen,18,4,0,4,3
2022-03-09,Binh Duong,Thu Dau Mot Town,2,1,1,0,0
2022-03-09,Binh Duong,Thu Dau Mot Town,3,1,0,1,0
2022-03-09,Binh Duong,Thu Dau Mot Town,6,53,29,24,22
2022-03-09,Binh Duong,Thu Dau Mot Town,7,135,114,21,10
2022-03-09,Binh Duong,Thu Dau Mot Town,8,210,196,14,4
2022-03-09,Binh Duong,Thu Dau Mot Town,9,231,213,18,3
2022-03-09,Binh Duong,Thu Dau Mot Town,10,366,319,47,11
2022-03-09,Binh Duong,Thu Dau Mot Town,11,596,546,50,11
2022-03-09,Binh Duong,Thu Dau Mot Town,12,423,393,30,4
2022-03-09,Binh Duong,Thu Dau Mot Town,13,384,350,34,8
2022-03-09,Binh Duong,Thu Dau Mot Town,14,369,345,24,9
2022-03-09,Binh Duong,Thu Dau Mot Town,15,263,249,14,1
2022-03-09,Binh Duong,Thu Dau Mot Town,16,288,264,24,0
2022-03-09,Binh Duong,Thu Dau Mot Town,17,347,326,21,2
2022-03-09,Binh Duong,Thu Dau Mot Town,18,337,311,26,5
2022-03-09,Binh Duong,Thu Dau Mot Town,19,319,297,22,6
2022-03-09,Binh Duong,Thu Dau Mot Town,20,222,191,31,12
2022-03-09,Binh Duong,Thu Dau Mot Town,21,120,82,38,22
2022-03-09,Binh Duong,Thu Dau Mot Town,22,2,1,1,0
2022-03-09,Binh Duong,Thuan An,2,2,0,2,0
2022-03-09,Binh Duong,Thuan An,6,1,1,0,0
2022-03-09,Binh Duong,Thuan An,7,4,1,3,3
2022-03-09,Binh Duong,Thuan An,8,13,7,6,4
2022-03-09,Binh Duong,Thuan An,9,29,18,11,7
2022-03-09,Binh Duong,Thuan An,10,57,37,20,14
2022-03-09,Binh Duong,Thuan An,11,67,44,23,9
2022-03-09,Binh Duong,Thuan An,12,55,33,22,19
2022-03-09,Binh Duong,Thuan An,13,58,21,37,32
2022-03-09,Binh Duong,Thuan An,14,42,22,20,17
2022-03-09,Binh Duong,Thuan An,15,49,25,24,18
2022-03-09,Binh Duong,Thuan An,16,44,26,18,14
2022-03-09,Binh Duong,Thuan An,17,44,20,24,22
2022-03-09,Binh Duong,Thuan An,18,52,32,20,17
2022-03-09,Binh Duong,Thuan An,19,36,16,20,15
2022-03-09,Binh Duong,Thuan An,20,26,16,10,5
2022-03-09,Binh Duong,Thuan An,21,20,6,14,12
2022-03-09,Can Tho City,Binh Thuy District,8,6,6,0,0
2022-03-09,Can Tho City,Binh Thuy District,9,11,10,1,0
2022-03-09,Can Tho City,Binh Thuy District,10,9,7,2,0
2022-03-09,Can Tho City,Binh Thuy District,11,15,14,1,1
2022-03-09,Can Tho City,Binh Thuy District,12,9,8,1,0
2022-03-09,Can Tho City,Binh Thuy District,13,11,11,0,0
2022-03-09,Can Tho City,Binh Thuy District,14,3,3,0,0
2022-03-09,Can Tho City,Binh Thuy District,15,12,12,0,0
2022-03-09,Can Tho City,Binh Thuy District,16,10,10,0,0
2022-03-09,Can Tho City,Binh Thuy District,17,12,11,1,0
2022-03-09,Can Tho City,Binh Thuy District,18,22,18,4,2
2022-03-09,Can Tho City,Binh Thuy District,19,15,12,3,2
2022-03-09,Can Tho City,Binh Thuy District,20,7,7,0,0
2022-03-09,Can Tho City,Binh Thuy District,21,1,0,1,0
2022-03-09,Can Tho City,Cai Rang District,6,1,0,1,0
2022-03-09,Can Tho City,Cai Rang District,7,5,4,1,0
2022-03-09,Can Tho City,Cai Rang District,8,4,4,0,0
2022-03-09,Can Tho City,Cai Rang District,9,7,7,0,0
2022-03-09,Can Tho City,Cai Rang District,10,7,7,0,0
2022-03-09,Can Tho City,Cai Rang District,11,17,16,1,0
2022-03-09,Can Tho City,Cai Rang District,12,11,10,1,0
2022-03-09,Can Tho City,Cai Rang District,13,9,8,1,0
2022-03-09,Can Tho City,Cai Rang District,14,7,6,1,1
2022-03-09,Can Tho City,Cai Rang District,15,7,6,1,0
2022-03-09,Can Tho City,Cai Rang District,16,9,9,0,0
2022-03-09,Can Tho City,Cai Rang District,17,13,11,2,2
2022-03-09,Can Tho City,Cai Rang District,18,15,13,2,0
2022-03-09,Can Tho City,Cai Rang District,19,15,10,5,0
2022-03-09,Can Tho City,Cai Rang District,20,7,6,1,0
2022-03-09,Can Tho City,Cai Rang District,21,5,4,1,0
2022-03-09,Can Tho City,Cai Rang District,22,1,0,1,0
2022-03-09,Can Tho City,Ninh Kieu District,1,2,0,2,0
2022-03-09,Can Tho City,Ninh Kieu District,2,1,1,0,0
2022-03-09,Can Tho City,Ninh Kieu District,5,3,2,1,0
2022-03-09,Can Tho City,Ninh Kieu District,6,36,36,0,0
2022-03-09,Can Tho City,Ninh Kieu District,7,120,111,9,0
2022-03-09,Can Tho City,Ninh Kieu District,8,230,210,20,0
2022-03-09,Can Tho City,Ninh Kieu District,9,259,236,23,0
2022-03-09,Can Tho City,Ninh Kieu District,10,539,517,22,0
2022-03-09,Can Tho City,Ninh Kieu District,11,823,772,51,1
2022-03-09,Can Tho City,Ninh Kieu District,12,563,545,18,0
2022-03-09,Can Tho City,Ninh Kieu District,13,438,422,16,0
2022-03-09,Can Tho City,Ninh Kieu District,14,367,348,19,0
2022-03-09,Can Tho City,Ninh Kieu District,15,357,337,20,0
2022-03-09,Can Tho City,Ninh Kieu District,16,402,384,18,0
2022-03-09,Can Tho City,Ninh Kieu District,17,548,516,32,0
2022-03-09,Can Tho City,Ninh Kieu District,18,514,494,20,0
2022-03-09,Can Tho City,Ninh Kieu District,19,456,423,33,0
2022-03-09,Can Tho City,Ninh Kieu District,20,384,367,17,0
2022-03-09,Can Tho City,Ninh Kieu District,21,182,166,16,1
2022-03-09,Can Tho City,Ninh Kieu District,22,3,1,2,0
2022-03-09,Can Tho City,Ninh Kieu District,23,1,1,0,0
2022-03-09,Dong Nai,Bien Hoa City,0,4,2,2,0
2022-03-09,Dong Nai,Bien Hoa City,1,1,0,1,0
2022-03-09,Dong Nai,Bien Hoa City,2,1,1,0,0
2022-03-09,Dong Nai,Bien Hoa City,3,2,1,1,0
2022-03-09,Dong Nai,Bien Hoa City,5,1,1,0,0
2022-03-09,Dong Nai,Bien Hoa City,6,42,23,19,16
2022-03-09,Dong Nai,Bien Hoa City,7,189,132,57,38
2022-03-09,Dong Nai,Bien Hoa City,8,334,273,61,32
2022-03-09,Dong Nai,Bien Hoa City,9,437,368,69,25
2022-03-09,Dong Nai,Bien Hoa City,10,666,583,83,31
2022-03-09,Dong Nai,Bien Hoa City,11,1057,877,180,99
2022-03-09,Dong Nai,Bien Hoa City,12,748,674,74,13
2022-03-09,Dong Nai,Bien Hoa City,13,807,687,120,55
2022-03-09,Dong Nai,Bien Hoa City,14,641,541,100,55
2022-03-09,Dong Nai,Bien Hoa City,15,542,461,81,27
2022-03-09,Dong Nai,Bien Hoa City,16,488,422,66,21
2022-03-09,Dong Nai,Bien Hoa City,17,578,507,71,33
2022-03-09,Dong Nai,Bien Hoa City,18,607,544,63,13
2022-03-09,Dong Nai,Bien Hoa City,19,636,533,103,46
2022-03-09,Dong Nai,Bien Hoa City,20,571,343,228,155
2022-03-09,Dong Nai,Bien Hoa City,21,233,132,101,62
2022-03-09,Dong Nai,Bien Hoa City,22,1,0,1,0
2022-03-09,Dong Nai,Bien Hoa City,23,1,0,1,1
2022-03-09,Dong Nai,Long Thanh,9,1,0,1,1
2022-03-09,Dong Nai,Long Thanh,12,2,0,2,2
2022-03-09,Dong Nai,Long Thanh,14,2,0,2,2
2022-03-09,Dong Nai,Long Thanh,20,2,0,2,2
2022-03-09,Dong Nai,Thong Nhat,8,2,2,0,0
2022-03-09,Dong Nai,Thong Nhat,9,1,1,0,0
2022-03-09,Dong Nai,Thong Nhat,10,1,1,0,0
2022-03-09,Dong Nai,Thong Nhat,11,2,2,0,0
2022-03-09,Dong Nai,Thong Nhat,12,3,1,2,0
2022-03-09,Dong Nai,Thong Nhat,13,2,1,1,1
2022-03-09,Dong Nai,Thong Nhat,14,2,2,0,0
2022-03-09,Dong Nai,Thong Nhat,15,2,2,0,0
2022-03-09,Dong Nai,Thong Nhat,16,1,1,0,0
2022-03-09,Dong Nai,Thong Nhat,18,2,2,0,0
2022-03-09,Dong Nai,Thong Nhat,19,1,1,0,0
2022-03-09,Dong Nai,Thong Nhat,20,1,1,0,0
2022-03-09,Dong Nai,Trang Bom,9,2,0,2,2
2022-03-09,Dong Nai,Trang Bom,10,1,0,1,1
2022-03-09,Dong Nai,Trang Bom,11,1,1,0,0
2022-03-09,Dong Nai,Trang Bom,13,1,0,1,1
2022-03-09,Dong Nai,Trang Bom,14,4,0,4,3
2022-03-09,Dong Nai,Trang Bom,15,2,1,1,1
2022-03-09,Hai Phong City,An Duong,5,1,0,1,0
2022-03-09,Hai Phong City,An Duong,8,10,3,7,6
2022-03-09,Hai Phong City,An Duong,10,4,1,3,3
2022-03-09,Hai Phong City,An Duong,11,8,4,4,1
2022-03-09,Hai Phong City,An Duong,12,4,1,3,3
2022-03-09,Hai Phong City,An Duong,13,10,5,5,2
2022-03-09,Hai Phong City,An Duong,14,14,1,13,8
2022-03-09,Hai Phong City,An Duong,15,6,3,3,2
2022-03-09,Hai Phong City,An Duong,16,3,2,1,1
2022-03-09,Hai Phong City,An Duong,17,8,0,8,6
2022-03-09,Hai Phong City,An Duong,18,4,2,2,2
2022-03-09,Hai Phong City,An Duong,19,1,0,1,1
2022-03-09,Hai Phong City,An Duong,20,1,0,1,1
2022-03-09,Hai Phong City,An Duong,21,2,0,2,1
2022-03-09,Hai Phong City,Duong Kinh District,14,1,0,1,1
2022-03-09,Hai Phong City,Duong Kinh District,17,1,0,1,1
2022-03-09,Hai Phong City,Hai An District,7,10,5,5,5
2022-03-09,Hai Phong City,Hai An District,8,12,11,1,0
2022-03-09,Hai Phong City,Hai An District,9,8,6,2,0
2022-03-09,Hai Phong City,Hai An District,10,25,20,5,0
2022-03-09,Hai Phong City,Hai An District,11,34,30,4,0
2022-03-09,Hai Phong City,Hai An District,12,8,8,0,0
2022-03-09,Hai Phong City,Hai An District,13,10,8,2,2
2022-03-09,Hai Phong City,Hai An District,14,7,6,1,1
2022-03-09,Hai Phong City,Hai An District,15,21,15,6,3
2022-03-09,Hai Phong City,Hai An District,16,15,14,1,0
2022-03-09,Hai Phong City,Hai An District,17,23,19,4,1
2022-03-09,Hai Phong City,Hai An District,18,25,22,3,1
2022-03-09,Hai Phong City,Hai An District,19,20,13,7,1
2022-03-09,Hai Phong City,Hai An District,20,19,11,8,5
2022-03-09,Hai Phong City,Hai An District,21,9,7,2,1
2022-03-09,Hai Phong City,Hong Bang District,0,1,1,0,0
2022-03-09,Hai Phong City,Hong Bang District,5,1,0,1,0
2022-03-09,Hai Phong City,Hong Bang District,7,9,6,3,2
2022-03-09,Hai Phong City,Hong Bang District,8,25,22,3,1
2022-03-09,Hai Phong City,Hong Bang District,9,28,23,5,1
2022-03-09,Hai Phong City,Hong Bang District,10,58,50,8,6
2022-03-09,Hai Phong City,Hong Bang District,11,109,96,13,5
2022-03-09,Hai Phong City,Hong Bang District,12,52,48,4,0
2022-03-09,Hai Phong City,Hong Bang District,13,40,36,4,0
2022-03-09,Hai Phong City,Hong Bang District,14,53,47,6,4
2022-03-09,Hai Phong City,Hong Bang District,15,33,31,2,1
2022-03-09,Hai Phong City,Hong Bang District,16,36,27,9,1
2022-03-09,Hai Phong City,Hong Bang District,17,45,40,5,1
2022-03-09,Hai Phong City,Hong Bang District,18,77,59,18,12
2022-03-09,Hai Phong City,Hong Bang District,19,53,32,21,10
2022-03-09,Hai Phong City,Hong Bang District,20,37,27,10,7
2022-03-09,Hai Phong City,Hong Bang District,21,9,6,3,2
2022-03-09,Hai Phong City,Hong Bang District,23,1,0,1,0
2022-03-09,Hai Phong City,Kien An District,7,3,2,1,1
2022-03-09,Hai Phong City,Kien An District,8,4,1,3,2
2022-03-09,Hai Phong City,Kien An District,9,6,1,5,4
2022-03-09,Hai Phong City,Kien An District,10,6,5,1,1
2022-03-09,Hai Phong City,Kien An District,11,15,13,2,2
2022-03-09,Hai Phong City,Kien An District,12,5,5,0,0
2022-03-09,Hai Phong City,Kien An District,13,8,5,3,1
2022-03-09,Hai Phong City,Kien An District,14,12,10,2,1
2022-03-09,Hai Phong City,Kien An District,15,5,3,2,0
2022-03-09,Hai Phong City,Kien An District,16,1,0,1,0
2022-03-09,Hai Phong City,Kien An District,17,11,7,4,2
2022-03-09,Hai Phong City,Kien An District,18,13,11,2,1
2022-03-09,Hai Phong City,Kien An District,19,11,7,4,1
2022-03-09,Hai Phong City,Kien An District,20,15,8,7,6
2022-03-09,Hai Phong City,Kien An District,21,3,0,3,3
2022-03-09,Hai Phong City,Le Chan District,0,2,2,0,0
2022-03-09,Hai Phong City,Le Chan District,3,1,1,0,0
2022-03-09,Hai Phong City,Le Chan District,4,1,0,1,0
2022-03-09,Hai Phong City,Le Chan District,6,3,0,3,1
2022-03-09,Hai Phong City,Le Chan District,7,40,26,14,7
2022-03-09,Hai Phong City,Le Chan District,8,67,61,6,0
2022-03-09,Hai Phong City,Le Chan District,9,65,49,16,2
2022-03-09,Hai Phong City,Le Chan District,10,149,134,15,4
2022-03-09,Hai Phong City,Le Chan District,11,258,227,31,8
2022-03-09,Hai Phong City,Le Chan District,12,172,157,15,3
2022-03-09,Hai Phong City,Le Chan District,13,107,96,11,3
2022-03-09,Hai Phong City,Le Chan District,14,144,122,22,9
2022-03-09,Hai Phong City,Le Chan District,15,127,114,13,3
2022-03-09,Hai Phong City,Le Chan District,16,171,158,13,1
2022-03-09,Hai Phong City,Le Chan District,17,195,173,22,6
2022-03-09,Hai Phong City,Le Chan District,18,247,186,61,17
2022-03-09,Hai Phong City,Le Chan District,19,167,134,33,12
2022-03-09,Hai Phong City,Le Chan District,20,142,94,48,22
2022-03-09,Hai Phong City,Le Chan District,21,62,42,20,8
2022-03-09,Hai Phong City,Le Chan District,22,1,0,1,0
2022-03-09,Hai Phong City,Ngo Quyen District,1,2,1,1,1
2022-03-09,Hai Phong City,Ngo Quyen District,2,1,1,0,0
2022-03-09,Hai Phong City,Ngo Quyen District,6,7,3,4,3
2022-03-09,Hai Phong City,Ngo Quyen District,7,39,26,13,11
2022-03-09,Hai Phong City,Ngo Quyen District,8,56,46,10,1
2022-03-09,Hai Phong City,Ngo Quyen District,9,83,76,7,0
2022-03-09,Hai Phong City,Ngo Quyen District,10,110,100,10,1
2022-03-09,Hai Phong City,Ngo Quyen District,11,220,195,25,7
2022-03-09,Hai Phong City,Ngo Quyen District,12,128,117,11,2
2022-03-09,Hai Phong City,Ngo Quyen District,13,100,89,11,2
2022-03-09,Hai Phong City,Ngo Quyen District,14,149,122,27,13
2022-03-09,Hai Phong City,Ngo Quyen District,15,119,106,13,0
2022-03-09,Hai Phong City,Ngo Quyen District,16,162,146,16,2
2022-03-09,Hai Phong City,Ngo Quyen District,17,163,134,29,13
2022-03-09,Hai Phong City,Ngo Quyen District,18,181,149,32,15
2022-03-09,Hai Phong City,Ngo Quyen District,19,170,140,30,14
2022-03-09,Hai Phong City,Ngo Quyen District,20,137,94,43,21
2022-03-09,Hai Phong City,Ngo Quyen District,21,45,36,9,3
2022-03-09,Hai Phong City,Ngo Quyen District,22,2,2,0,0
2022-03-09,Hai Phong City,Thuy Nguyen,14,2,0,2,1
2022-03-09,Hai Phong City,Thuy Nguyen,15,1,0,1,1
2022-03-09,Hai Phong City,Thuy Nguyen,16,1,1,0,0
2022-03-09,Hai Phong City,Thuy Nguyen,17,1,0,1,1
2022-03-09,Hai Phong City,Thuy Nguyen,18,1,0,1,1
2022-03-09,Hai Phong City,Thuy Nguyen,19,1,0,1,1
2022-03-09,Hue City,Hue City,0,6,6,0,0
2022-03-09,Hue City,Hue City,1,1,0,1,1
2022-03-09,Hue City,Hue City,4,2,1,1,0
2022-03-09,Hue City,Hue City,6,55,50,5,1
2022-03-09,Hue City,Hue City,7,214,196,18,0
2022-03-09,Hue City,Hue City,8,301,283,18,0
2022-03-09,Hue City,Hue City,9,238,220,18,2
2022-03-09,Hue City,Hue City,10,395,370,25,2
2022-03-09,Hue City,Hue City,11,801,754,47,4
2022-03-09,Hue City,Hue City,12,472,445,27,0
2022-03-09,Hue City,Hue City,13,264,253,11,0
2022-03-09,Hue City,Hue City,14,298,277,21,1
2022-03-09,Hue City,Hue City,15,367,353,14,0
2022-03-09,Hue City,Hue City,16,416,395,21,0
2022-03-09,Hue City,Hue City,17,568,539,29,1
2022-03-09,Hue City,Hue City,18,693,629,64,10
2022-03-09,Hue City,Hue City,19,549,494,55,7
2022-03-09,Hue City,Hue City,20,403,365,38,3
2022-03-09,Hue City,Hue City,21,223,185,38,9
2022-03-09,Hue City,Hue City,22,5,4,1,0
2022-03-09,Hue City,Hue City,23,1,0,1,0
2022-03-09,Hue City,Huong Thuy,11,2,1,1,0
2022-03-09,Hue City,Huong Thuy,15,1,0,1,0
2022-03-09,Hue City,Huong Thuy,16,3,1,2,0
2022-03-09,Hue City,Huong Thuy,21,1,0,1,1
2022-03-09,Hue City,Huong Tra,16,2,2,0,0
2022-03-09,Hue City,Huong Tra,21,1,1,0,0
2022-03-09,Hue City,Phu Vang,6,1,1,0,0
2022-03-09,Hue City,Phu Vang,7,1,1,0,0
2022-03-09,Hue City,Phu Vang,8,1,1,0,0
2022-03-09,Hue City,Phu Vang,11,2,2,0,0
2022-03-09,Hue City,Phu Vang,12,1,1,0,0
2022-03-09,Hue City,Phu Vang,13,1,1,0,0
2022-03-09,Hue City,Phu Vang,14,1,1,0,0
2022-03-09,Hue City,Phu Vang,17,4,3,1,0
2022-03-09,Hue City,Phu Vang,18,1,1,0,0
2022-03-09,Hue City,Phu Vang,20,1,0,1,0
2022-03-09,Vung Tau,Ba Ria City,7,2,0,2,2
2022-03-09,Vung Tau,Ba Ria City,8,1,0,1,1
2022-03-09,Vung Tau,Ba Ria City,9,4,0,4,4
2022-03-09,Vung Tau,Ba Ria City,10,14,2,12,10
2022-03-09,Vung Tau,Ba Ria City,11,7,3,4,4
2022-03-09,Vung Tau,Ba Ria City,12,3,0,3,3
2022-03-09,Vung Tau,Ba Ria City,13,4,3,1,1
2022-03-09,Vung Tau,Ba Ria City,14,11,3,8,5
2022-03-09,Vung Tau,Ba Ria City,15,8,3,5,4
2022-03-09,Vung Tau,Ba Ria City,16,6,2,4,3
2022-03-09,Vung Tau,Ba Ria City,17,4,2,2,2
2022-03-09,Vung Tau,Ba Ria City,18,5,2,3,2
2022-03-09,Vung Tau,Ba Ria City,19,12,4,8,7
2022-03-09,Vung Tau,Ba Ria City,20,3,0,3,3
2022-03-09,Vung Tau,Ba Ria City,21,3,0,3,3
2022-03-09,Vung Tau,Vung Tau City,0,1,1,0,0
2022-03-09,Vung Tau,Vung Tau City,2,2,0,2,0
2022-03-09,Vung Tau,Vung Tau City,6,45,36,9,4
2022-03-09,Vung Tau,Vung Tau City,7,118,99,19,5
2022-03-09,Vung Tau,Vung Tau City,8,152,138,14,4
2022-03-09,Vung Tau,Vung Tau City,9,165,140,25,2
2022-03-09,Vung Tau,Vung Tau City,10,167,155,12,1
2022-03-09,Vung Tau,Vung Tau City,11,325,292,33,12
2022-03-09,Vung Tau,Vung Tau City,12,240,232,8,0
2022-03-09,Vung Tau,Vung Tau City,13,206,187,19,1
2022-03-09,Vung Tau,Vung Tau City,14,196,186,10,4
2022-03-09,Vung Tau,Vung Tau City,15,185,171,14,0
2022-03-09,Vung Tau,Vung Tau City,16,204,191,13,0
2022-03-09,Vung Tau,Vung Tau City,17,266,242,24,2
2022-03-09,Vung Tau,Vung Tau City,18,251,226,25,3
2022-03-09,Vung Tau,Vung Tau City,19,244,224,20,6
2022-03-09,Vung Tau,Vung Tau City,20,172,147,25,7
2022-03-09,Vung Tau,Vung Tau City,21,93,73,20,0
2022-03-09,Vung Tau,Vung Tau City,22,2,1,1,1
2022-03-10,Binh Duong,Ben Cat,8,1,0,1,1
2022-03-10,Binh Duong,Ben Cat,10,1,0,1,1
2022-03-10,Binh Duong,Ben Cat,11,1,0,1,1
2022-03-10,Binh Duong,Ben Cat,12,3,0,3,2
2022-03-10,Binh Duong,Ben Cat,13,1,0,1,1
2022-03-10,Binh Duong,Ben Cat,15,3,1,2,0
2022-03-10,Binh Duong,Ben Cat,16,3,0,3,3
2022-03-10,Binh Duong,Ben Cat,17,3,0,3,3
2022-03-10,Binh Duong,Di An,6,1,0,1,1
2022-03-10,Binh Duong,Di An,7,4,0,4,2
2022-03-10,Binh Duong,Di An,8,12,3,9,8
2022-03-10,Binh Duong,Di An,9,18,5,13,7
2022-03-10,Binh Duong,Di An,10,25,7,18,18
2022-03-10,Binh Duong,Di An,11,28,5,23,20
2022-03-10,Binh Duong,Di An,12,37,8,29,26
2022-03-10,Binh Duong,Di An,13,36,12,24,18
2022-03-10,Binh Duong,Di An,14,19,11,8,8
2022-03-10,Binh Duong,Di An,15,22,7,15,14
2022-03-10,Binh Duong,Di An,16,25,5,20,13
2022-03-10,Binh Duong,Di An,17,20,8,12,11
2022-03-10,Binh Duong,Di An,18,18,6,12,8
2022-03-10,Binh Duong,Di An,19,18,6,12,11
2022-03-10,Binh Duong,Di An,20,15,4,11,9
2022-03-10,Binh Duong,Di An,21,5,1,4,4
2022-03-10,Binh Duong,Tan Uyen,8,3,2,1,1
2022-03-10,Binh Duong,Tan Uyen,9,4,1,3,3
2022-03-10,Binh Duong,Tan Uyen,10,4,0,4,3
2022-03-10,Binh Duong,Tan Uyen,11,1,1,0,0
2022-03-10,Binh Duong,Tan Uyen,14,1,1,0,0
2022-03-10,Binh Duong,Tan Uyen,15,1,1,0,0
2022-03-10,Binh Duong,Tan Uyen,17,4,2,2,2
2022-03-10,Binh Duong,Tan Uyen,18,1,0,1,0
2022-03-10,Binh Duong,Thu Dau Mot Town,0,1,1,0,0
2022-03-10,Binh Duong,Thu Dau Mot Town,6,33,23,10,5
2022-03-10,Binh Duong,Thu Dau Mot Town,7,128,113,15,4
2022-03-10,Binh Duong,Thu Dau Mot Town,8,182,170,12,1
2022-03-10,Binh Duong,Thu Dau Mot Town,9,224,215,9,0
2022-03-10,Binh Duong,Thu Dau Mot Town,10,384,344,40,5
2022-03-10,Binh Duong,Thu Dau Mot Town,11,577,526,51,11
2022-03-10,Binh Duong,Thu Dau Mot Town,12,418,391,27,8
2022-03-10,Binh Duong,Thu Dau Mot Town,13,320,303,17,3
2022-03-10,Binh Duong,Thu Dau Mot Town,14,326,305,21,7
2022-03-10,Binh Duong,Thu Dau Mot Town,15,275,251,24,1
2022-03-10,Binh Duong,Thu Dau Mot Town,16,285,268,17,7
2022-03-10,Binh Duong,Thu Dau Mot Town,17,375,351,24,9
2022-03-10,Binh Duong,Thu Dau Mot Town,18,337,314,23,3
2022-03-10,Binh Duong,Thu Dau Mot Town,19,320,284,36,9
2022-03-10,Binh Duong,Thu Dau Mot Town,20,222,204,18,3
2022-03-10,Binh Duong,Thu Dau Mot Town,21,107,88,19,7
2022-03-10,Binh Duong,Thu Dau Mot Town,22,3,2,1,0
2022-03-10,Binh Duong,Thu Dau Mot Town,23,1,0,1,0
2022-03-10,Binh Duong,Thuan An,6,4,0,4,3
2022-03-10,Binh Duong,Thuan An,7,10,5,5,5
2022-03-10,Binh Duong,Thuan An,8,18,13,5,4
2022-03-10,Binh Duong,Thuan An,9,35,15,20,15
2022-03-10,Binh Duong,Thuan An,10,62,35,27,23
2022-03-10,Binh Duong,Thuan An,11,68,42,26,16
2022-03-10,Binh Duong,Thuan An,12,48,37,11,6
2022-03-10,Binh Duong,Thuan An,13,56,32,24,18
2022-03-10,Binh Duong,Thuan An,14,63,28,35,26
2022-03-10,Binh Duong,Thuan An,15,42,20,22,16
2022-03-10,Binh Duong,Thuan An,16,38,25,13,12
2022-03-10,Binh Duong,Thuan An,17,46,25,21,14
2022-03-10,Binh Duong,Thuan An,18,29,19,10,6
2022-03-10,Binh Duong,Thuan An,19,50,22,28,22
2022-03-10,Binh Duong,Thuan An,20,32,11,21,19
2022-03-10,Binh Duong,Thuan An,21,15,4,11,5
2022-03-10,Can Tho City,Binh Thuy District,6,1,0,1,1
2022-03-10,Can Tho City,Binh Thuy District,7,2,1,1,0
2022-03-10,Can Tho City,Binh Thuy District,8,2,2,0,0
2022-03-10,Can Tho City,Binh Thuy District,9,3,2,1,0
2022-03-10,Can Tho City,Binh Thuy District,10,10,8,2,0
2022-03-10,Can Tho City,Binh Thuy District,11,13,12,1,0
2022-03-10,Can Tho City,Binh Thuy District,12,10,8,2,0
2022-03-10,Can Tho City,Binh Thuy District,13,12,12,0,0
2022-03-10,Can Tho City,Binh Thuy District,14,7,7,0,0
2022-03-10,Can Tho City,Binh Thuy District,15,13,12,1,0
2022-03-10,Can Tho City,Binh Thuy District,16,8,8,0,0
2022-03-10,Can Tho City,Binh Thuy District,17,7,7,0,0
2022-03-10,Can Tho City,Binh Thuy District,18,13,12,1,0
2022-03-10,Can Tho City,Binh Thuy District,19,13,12,1,0
2022-03-10,Can Tho City,Binh Thuy District,20,12,9,3,1
2022-03-10,Can Tho City,Binh Thuy District,21,3,2,1,0
2022-03-10,Can Tho City,Cai Rang District,4,1,0,1,0
2022-03-10,Can Tho City,Cai Rang District,7,3,2,1,1
2022-03-10,Can Tho City,Cai Rang District,8,2,2,0,0
2022-03-10,Can Tho City,Cai Rang District,9,10,6,4,0
2022-03-10,Can Tho City,Cai Rang District,10,9,8,1,0
2022-03-10,Can Tho City,Cai Rang District,11,13,11,2,0
2022-03-10,Can Tho City,Cai Rang District,12,17,14,3,0
2022-03-10,Can Tho City,Cai Rang District,13,6,6,0,0
2022-03-10,Can Tho City,Cai Rang District,14,8,8,0,0
2022-03-10,Can Tho City,Cai Rang District,15,7,7,0,0
2022-03-10,Can Tho City,Cai Rang District,16,12,11,1,0
2022-03-10,Can Tho City,Cai Rang District,17,12,11,1,0
2022-03-10,Can Tho City,Cai Rang District,18,9,9,0,0
2022-03-10,Can Tho City,Cai Rang District,19,13,11,2,0
2022-03-10,Can Tho City,Cai Rang District,20,3,3,0,0
2022-03-10,Can Tho City,Cai Rang District,21,2,1,1,0
2022-03-10,Can Tho City,Ninh Kieu District,0,5,2,3,0
2022-03-10,Can Tho City,Ninh Kieu District,1,1,1,0,0
2022-03-10,Can Tho City,Ninh Kieu District,2,1,1,0,0
2022-03-10,Can Tho City,Ninh Kieu District,5,2,1,1,0
2022-03-10,Can Tho City,Ninh Kieu District,6,36,30,6,0
2022-03-10,Can Tho City,Ninh Kieu District,7,157,144,13,1
2022-03-10,Can Tho City,Ninh Kieu District,8,213,203,10,0
2022-03-10,Can Tho City,Ninh Kieu District,9,302,286,16,0
2022-03-10,Can Tho City,Ninh Kieu District,10,531,512,19,0
2022-03-10,Can Tho City,Ninh Kieu District,11,849,792,57,11
2022-03-10,Can Tho City,Ninh Kieu District,12,530,504,26,2
2022-03-10,Can Tho City,Ninh Kieu District,13,440,419,21,0
2022-03-10,Can Tho City,Ninh Kieu District,14,366,348,18,0
2022-03-10,Can Tho City,Ninh Kieu District,15,331,318,13,0
2022-03-10,Can Tho City,Ninh Kieu District,16,407,391,16,0
2022-03-10,Can Tho City,Ninh Kieu District,17,554,522,32,0
2022-03-10,Can Tho City,Ninh Kieu District,18,527,500,27,0
2022-03-10,Can Tho City,Ninh Kieu District,19,443,415,28,0
2022-03-10,Can Tho City,Ninh Kieu District,20,327,298,29,4
2022-03-10,Can Tho City,Ninh Kieu District,21,160,132,28,3
2022-03-10,Can Tho City,Ninh Kieu District,22,8,5,3,0
2022-03-10,Can Tho City,Ninh Kieu District,23,1,1,0,0
2022-03-10,Dong Nai,Bien Hoa City,0,2,1,1,1
2022-03-10,Dong Nai,Bien Hoa City,1,4,2,2,0
2022-03-10,Dong Nai,Bien Hoa City,2,1,1,0,0
2022-03-10,Dong Nai,Bien Hoa City,6,45,30,15,12
2022-03-10,Dong Nai,Bien Hoa City,7,194,150,44,24
2022-03-10,Dong Nai,Bien Hoa City,8,310,260,50,18
2022-03-10,Dong Nai,Bien Hoa City,9,361,303,58,6
2022-03-10,Dong Nai,Bien Hoa City,10,680,613,67,21
2022-03-10,Dong Nai,Bien Hoa City,11,982,852,130,49
2022-03-10,Dong Nai,Bien Hoa City,12,731,679,52,14
2022-03-10,Dong Nai,Bien Hoa City,13,737,661,76,22
2022-03-10,Dong Nai,Bien Hoa City,14,585,510,75,27
2022-03-10,Dong Nai,Bien Hoa City,15,483,445,38,14
2022-03-10,Dong Nai,Bien Hoa City,16,507,460,47,14
2022-03-10,Dong Nai,Bien Hoa City,17,562,497,65,24
2022-03-10,Dong Nai,Bien Hoa City,18,627,571,56,12
2022-03-10,Dong Nai,Bien Hoa City,19,619,548,71,24
2022-03-10,Dong Nai,Bien Hoa City,20,473,376,97,37
2022-03-10,Dong Nai,Bien Hoa City,21,213,131,82,48
2022-03-10,Dong Nai,Bien Hoa City,22,5,2,3,0
2022-03-10,Dong Nai,Long Khanh,11,1,0,1,1
2022-03-10,Dong Nai,Long Thanh,8,1,0,1,1
2022-03-10,Dong Nai,Long Thanh,11,2,0,2,2
2022-03-10,Dong Nai,Long Thanh,12,1,0,1,1
2022-03-10,Dong Nai,Long Thanh,13,4,0,4,4
2022-03-10,Dong Nai,Long Thanh,14,1,0,1,1
2022-03-10,Dong Nai,Long Thanh,15,1,0,1,1
2022-03-10,Dong Nai,Long Thanh,18,2,0,2,2
2022-03-10,Dong Nai,Long Thanh,19,1,0,1,1
2022-03-10,Dong Nai,Thong Nhat,7,1,1,0,0
2022-03-10,Dong Nai,Thong Nhat,10,3,3,0,0
2022-03-10,Dong Nai,Thong Nhat,11,2,1,1,0
2022-03-10,Dong Nai,Thong Nhat,12,3,3,0,0
2022-03-10,Dong Nai,Thong Nhat,13,3,3,0,0
2022-03-10,Dong Nai,Thong Nhat,14,1,1,0,0
2022-03-10,Dong Nai,Thong Nhat,15,2,2,0,0
2022-03-10,Dong Nai,Thong Nhat,19,2,2,0,0
2022-03-10,Dong Nai,Thong Nhat,20,1,1,0,0
2022-03-10,Dong Nai,Trang Bom,11,1,0,1,1
2022-03-10,Dong Nai,Trang Bom,13,2,0,2,2
2022-03-10,Dong Nai,Trang Bom,15,1,0,1,1
2022-03-10,Dong Nai,Vinh Cuu,8,2,0,2,2
2022-03-10,Hai Phong City,An Duong,7,1,0,1,1
2022-03-10,Hai Phong City,An Duong,8,1,1,0,0
2022-03-10,Hai Phong City,An Duong,9,3,2,1,1
2022-03-10,Hai Phong City,An Duong,10,7,4,3,2
2022-03-10,Hai Phong City,An Duong,11,2,0,2,1
2022-03-10,Hai Phong City,An Duong,12,2,2,0,0
2022-03-10,Hai Phong City,An Duong,13,1,1,0,0
2022-03-10,Hai Phong City,An Duong,14,1,1,0,0
2022-03-10,Hai Phong City,An Duong,15,1,1,0,0
2022-03-10,Hai Phong City,An Duong,16,2,1,1,1
2022-03-10,Hai Phong City,An Duong,18,2,2,0,0
2022-03-10,Hai Phong City,An Duong,19,2,0,2,1
2022-03-10,Hai Phong City,An Duong,20,1,1,0,0
2022-03-10,Hai Phong City,Duong Kinh District,11,1,0,1,1
2022-03-10,Hai Phong City,Duong Kinh District,13,1,0,1,1
2022-03-10,Hai Phong City,Duong Kinh District,20,1,0,1,1
2022-03-10,Hai Phong City,Hai An District,6,1,0,1,0
2022-03-10,Hai Phong City,Hai An District,7,6,5,1,0
2022-03-10,Hai Phong City,Hai An District,8,14,11,3,0
2022-03-10,Hai Phong City,Hai An District,9,21,15,6,0
2022-03-10,Hai Phong City,Hai An District,10,32,26,6,1
2022-03-10,Hai Phong City,Hai An District,11,47,40,7,4
2022-03-10,Hai Phong City,Hai An District,12,21,19,2,0
2022-03-10,Hai Phong City,Hai An District,13,9,8,1,1
2022-03-10,Hai Phong City,Hai An District,14,13,11,2,1
2022-03-10,Hai Phong City,Hai An District,15,20,15,5,2
2022-03-10,Hai Phong City,Hai An District,16,14,13,1,1
2022-03-10,Hai Phong City,Hai An District,17,32,24,8,4
2022-03-10,Hai Phong City,Hai An District,18,15,13,2,0
2022-03-10,Hai Phong City,Hai An District,19,22,21,1,0
2022-03-10,Hai Phong City,Hai An District,20,14,13,1,1
2022-03-10,Hai Phong City,Hai An District,21,7,5,2,1
2022-03-10,Hai Phong City,Hong Bang District,7,9,8,1,0
2022-03-10,Hai Phong City,Hong Bang District,8,33,26,7,2
2022-03-10,Hai Phong City,Hong Bang District,9,29,25,4,1
2022-03-10,Hai Phong City,Hong Bang District,10,62,51,11,2
2022-03-10,Hai Phong City,Hong Bang District,11,78,72,6,3
2022-03-10,Hai Phong City,Hong Bang District,12,47,41,6,0
2022-03-10,Hai Phong City,Hong Bang District,13,34,29,5,1
2022-03-10,Hai Phong City,Hong Bang District,14,43,34,9,4
2022-03-10,Hai Phong City,Hong Bang District,15,42,36,6,4
2022-03-10,Hai Phong City,Hong Bang District,16,40,36,4,0
2022-03-10,Hai Phong City,Hong Bang District,17,39,39,0,0
2022-03-10,Hai Phong City,Hong Bang District,18,38,34,4,0
2022-03-10,Hai Phong City,Hong Bang District,19,35,32,3,0
2022-03-10,Hai Phong City,Hong Bang District,20,22,15,7,3
2022-03-10,Hai Phong City,Hong Bang District,21,11,8,3,2
2022-03-10,Hai Phong City,Hong Bang District,23,2,1,1,0
2022-03-10,Hai Phong City,Kien An District,7,6,2,4,3
2022-03-10,Hai Phong City,Kien An District,8,11,3,8,4
2022-03-10,Hai Phong City,Kien An District,9,6,5,1,0
2022-03-10,Hai Phong City,Kien An District,10,7,7,0,0
2022-03-10,Hai Phong City,Kien An District,11,12,10,2,1
2022-03-10,Hai Phong City,Kien An District,12,11,8,3,0
2022-03-10,Hai Phong City,Kien An District,13,11,8,3,2
2022-03-10,Hai Phong City,Kien An District,14,7,5,2,0
2022-03-10,Hai Phong City,Kien An District,15,10,8,2,1
2022-03-10,Hai Phong City,Kien An District,16,4,4,0,0
2022-03-10,Hai Phong City,Kien An District,17,8,5,3,0
2022-03-10,Hai Phong City,Kien An District,18,3,3,0,0
2022-03-10,Hai Phong City,Kien An District,19,10,4,6,6
2022-03-10,Hai Phong City,Kien An District,20,10,4,6,6
2022-03-10,Hai Phong City,Kien An District,21,1,1,0,0
2022-03-10,Hai Phong City,Le Chan District,0,3,2,1,1
2022-03-10,Hai Phong City,Le Chan District,5,2,2,0,0
2022-03-10,Hai Phong City,Le Chan District,7,43,30,13,4
2022-03-10,Hai Phong City,Le Chan District,8,78,69,9,2
2022-03-10,Hai Phong City,Le Chan District,9,87,77,10,0
2022-03-10,Hai Phong City,Le Chan District,10,199,176,23,6
2022-03-10,Hai Phong City,Le Chan District,11,266,221,45,18
2022-03-10,Hai Phong City,Le Chan District,12,186,166,20,3
2022-03-10,Hai Phong City,Le Chan District,13,101,91,10,0
2022-03-10,Hai Phong City,Le Chan District,14,134,117,17,7
2022-03-10,Hai Phong City,Le Chan District,15,178,160,18,5
2022-03-10,Hai Phong City,Le Chan District,16,174,147,27,3
2022-03-10,Hai Phong City,Le Chan District,17,164,147,17,0
2022-03-10,Hai Phong City,Le Chan District,18,194,177,17,1
2022-03-10,Hai Phong City,Le Chan District,19,188,174,14,3
2022-03-10,Hai Phong City,Le Chan District,20,124,102,22,0
2022-03-10,Hai Phong City,Le Chan District,21,49,40,9,0
2022-03-10,Hai Phong City,Le Chan District,22,1,1,0,0
2022-03-10,Hai Phong City,Ngo Quyen District,1,4,2,2,0
2022-03-10,Hai Phong City,Ngo Quyen District,2,2,1,1,0
2022-03-10,Hai Phong City,Ngo Quyen District,6,1,1,0,0
2022-03-10,Hai Phong City,Ngo Quyen District,7,28,18,10,5
2022-03-10,Hai Phong City,Ngo Quyen District,8,60,52,8,0
2022-03-10,Hai Phong City,Ngo Quyen District,9,71,60,11,1
2022-03-10,Hai Phong City,Ngo Quyen District,10,138,119,19,2
2022-03-10,Hai Phong City,Ngo Quyen District,11,225,204,21,4
2022-03-10,Hai Phong City,Ngo Quyen District,12,125,115,10,1
2022-03-10,Hai Phong City,Ngo Quyen District,13,98,89,9,0
2022-03-10,Hai Phong City,Ngo Quyen District,14,119,99,20,2
2022-03-10,Hai Phong City,Ngo Quyen District,15,144,130,14,2
2022-03-10,Hai Phong City,Ngo Quyen District,16,83,74,9,0
2022-03-10,Hai Phong City,Ngo Quyen District,17,114,106,8,0
2022-03-10,Hai Phong City,Ngo Quyen District,18,158,140,18,1
2022-03-10,Hai Phong City,Ngo Quyen District,19,135,117,18,1
2022-03-10,Hai Phong City,Ngo Quyen District,20,103,88,15,0
2022-03-10,Hai Phong City,Ngo Quyen District,21,50,44,6,1
2022-03-10,Hai Phong City,Thuy Nguyen,10,3,1,2,2
2022-03-10,Hai Phong City,Thuy Nguyen,11,3,1,2,1
2022-03-10,Hai Phong City,Thuy Nguyen,12,2,0,2,2
2022-03-10,Hai Phong City,Thuy Nguyen,13,1,0,1,1
2022-03-10,Hai Phong City,Thuy Nguyen,14,1,0,1,1
2022-03-10,Hai Phong City,Thuy Nguyen,16,1,0,1,1
2022-03-10,Hai Phong City,Thuy Nguyen,17,3,0,3,3
2022-03-10,Hai Phong City,Thuy Nguyen,18,2,0,2,2
2022-03-10,Hue City,Hue City,0,4,3,1,0
2022-03-10,Hue City,Hue City,1,1,1,0,0
2022-03-10,Hue City,Hue City,2,1,1,0,0
2022-03-10,Hue City,Hue City,4,1,1,0,0
2022-03-10,Hue City,Hue City,5,1,1,0,0
2022-03-10,Hue City,Hue City,6,86,73,13,1
2022-03-10,Hue City,Hue City,7,208,191,17,1
2022-03-10,Hue City,Hue City,8,289,277,12,0
2022-03-10,Hue City,Hue City,9,241,228,13,0
2022-03-10,Hue City,Hue City,10,421,390,31,0
2022-03-10,Hue City,Hue City,11,773,717,56,4
2022-03-10,Hue City,Hue City,12,421,403,18,2
2022-03-10,Hue City,Hue City,13,272,256,16,0
2022-03-10,Hue City,Hue City,14,367,332,35,3
2022-03-10,Hue City,Hue City,15,350,330,20,0
2022-03-10,Hue City,Hue City,16,406,381,25,4
2022-03-10,Hue City,Hue City,17,475,442,33,0
2022-03-10,Hue City,Hue City,18,577,539,38,0
2022-03-10,Hue City,Hue City,19,520,481,39,0
2022-03-10,Hue City,Hue City,20,414,362,52,2
2022-03-10,Hue City,Hue City,21,183,152,31,2
2022-03-10,Hue City,Hue City,22,3,1,2,0
2022-03-10,Hue City,Hue City,23,2,2,0,0
2022-03-10,Hue City,Huong Thuy,10,1,1,0,0
2022-03-10,Hue City,Huong Thuy,12,3,1,2,0
2022-03-10,Hue City,Huong Thuy,13,1,1,0,0
2022-03-10,Hue City,Huong Thuy,16,1,1,0,0
2022-03-10,Hue City,Huong Thuy,18,1,1,0,0
2022-03-10,Hue City,Huong Thuy,19,1,1,0,0
2022-03-10,Hue City,Huong Thuy,20,1,1,0,0
2022-03-10,Hue City,Huong Tra,7,1,1,0,0
2022-03-10,Hue City,Huong Tra,15,1,1,0,0
2022-03-10,Hue City,Phu Vang,6,1,1,0,0
2022-03-10,Hue City,Phu Vang,7,1,0,1,0
2022-03-10,Hue City,Phu Vang,8,1,1,0,0
2022-03-10,Hue City,Phu Vang,9,1,0,1,0
2022-03-10,Hue City,Phu Vang,11,1,1,0,0
2022-03-10,Hue City,Phu Vang,12,1,1,0,0
2022-03-10,Hue City,Phu Vang,13,1,1,0,0
2022-03-10,Hue City,Phu Vang,14,1,1,0,0
2022-03-10,Hue City,Phu Vang,15,2,0,2,0
2022-03-10,Hue City,Phu Vang,16,1,1,0,0
2022-03-10,Hue City,Phu Vang,17,5,4,1,0
2022-03-10,Hue City,Phu Vang,18,2,2,0,0
2022-03-10,Hue City,Phu Vang,19,1,1,0,0
2022-03-10,Hue City,Phu Vang,20,2,1,1,0
2022-03-10,Vung Tau,Ba Ria City,8,7,0,7,6
2022-03-10,Vung Tau,Ba Ria City,9,8,0,8,7
2022-03-10,Vung Tau,Ba Ria City,10,9,1,8,6
2022-03-10,Vung Tau,Ba Ria City,11,13,5,8,5
2022-03-10,Vung Tau,Ba Ria City,12,10,4,6,6
2022-03-10,Vung Tau,Ba Ria City,13,9,3,6,5
2022-03-10,Vung Tau,Ba Ria City,14,8,5,3,3
2022-03-10,Vung Tau,Ba Ria City,15,9,6,3,2
2022-03-10,Vung Tau,Ba Ria City,16,3,2,1,1
2022-03-10,Vung Tau,Ba Ria City,17,14,3,11,11
2022-03-10,Vung Tau,Ba Ria City,18,14,2,12,12
2022-03-10,Vung Tau,Ba Ria City,19,5,2,3,3
2022-03-10,Vung Tau,Ba Ria City,20,1,0,1,1
2022-03-10,Vung Tau,Ba Ria City,21,1,0,1,1
2022-03-10,Vung Tau,Vung Tau City,1,1,1,0,0
2022-03-10,Vung Tau,Vung Tau City,3,1,1,0,0
2022-03-10,Vung Tau,Vung Tau City,5,1,1,0,0
2022-03-10,Vung Tau,Vung Tau City,6,44,35,9,5
2022-03-10,Vung Tau,Vung Tau City,7,101,92,9,2
2022-03-10,Vung Tau,Vung Tau City,8,162,151,11,0
2022-03-10,Vung Tau,Vung Tau City,9,149,133,16,0
2022-03-10,Vung Tau,Vung Tau City,10,189,174,15,3
2022-03-10,Vung Tau,Vung Tau City,11,320,297,23,3
2022-03-10,Vung Tau,Vung Tau City,12,244,227,17,1
2022-03-10,Vung Tau,Vung Tau City,13,195,182,13,1
2022-03-10,Vung Tau,Vung Tau City,14,213,199,14,1
2022-03-10,Vung Tau,Vung Tau City,15,205,190,15,1
2022-03-10,Vung Tau,Vung Tau City,16,220,201,19,0
2022-03-10,Vung Tau,Vung Tau City,17,257,244,13,0
2022-03-10,Vung Tau,Vung Tau City,18,291,265,26,7
2022-03-10,Vung Tau,Vung Tau City,19,236,222,14,0
2022-03-10,Vung Tau,Vung Tau City,20,155,137,18,7
2022-03-10,Vung Tau,Vung Tau City,21,58,47,11,4
2022-03-10,Vung Tau,Vung Tau City,22,3,2,1,0
2022-03-11,Binh Duong,Ben Cat,11,1,0,1,1
2022-03-11,Binh Duong,Ben Cat,12,1,0,1,1
2022-03-11,Binh Duong,Ben Cat,14,1,0,1,1
2022-03-11,Binh Duong,Ben Cat,17,1,0,1,1
2022-03-11,Binh Duong,Ben Cat,18,1,1,0,0
2022-03-11,Binh Duong,Di An,6,3,0,3,3
2022-03-11,Binh Duong,Di An,7,8,0,8,8
2022-03-11,Binh Duong,Di An,8,14,2,12,12
2022-03-11,Binh Duong,Di An,9,22,3,19,18
2022-03-11,Binh Duong,Di An,10,39,7,32,28
2022-03-11,Binh Duong,Di An,11,38,14,24,21
2022-03-11,Binh Duong,Di An,12,33,24,9,5
2022-03-11,Binh Duong,Di An,13,22,11,11,9
2022-03-11,Binh Duong,Di An,14,19,12,7,6
2022-03-11,Binh Duong,Di An,15,7,1,6,5
2022-03-11,Binh Duong,Di An,16,31,9,22,20
2022-03-11,Binh Duong,Di An,17,35,14,21,16
2022-03-11,Binh Duong,Di An,18,22,6,16,8
2022-03-11,Binh Duong,Di An,19,19,9,10,9
2022-03-11,Binh Duong,Di An,20,14,5,9,7
2022-03-11,Binh Duong,Di An,21,7,3,4,3
2022-03-11,Binh Duong,Tan Uyen,7,2,0,2,2
2022-03-11,Binh Duong,Tan Uyen,10,3,0,3,2
2022-03-11,Binh Duong,Tan Uyen,11,2,1,1,1
2022-03-11,Binh Duong,Tan Uyen,12,1,0,1,1
2022-03-11,Binh Duong,Tan Uyen,13,4,0,4,4
2022-03-11,Binh Duong,Tan Uyen,14,6,2,4,4
2022-03-11,Binh Duong,Tan Uyen,16,6,0,6,5
2022-03-11,Binh Duong,Tan Uyen,17,3,2,1,1
2022-03-11,Binh Duong,Tan Uyen,18,1,0,1,1
2022-03-11,Binh Duong,Tan Uyen,19,2,1,1,1
2022-03-11,Binh Duong,Tan Uyen,20,7,0,7,6
2022-03-11,Binh Duong,Thu Dau Mot Town,0,1,1,0,0
2022-03-11,Binh Duong,Thu Dau Mot Town,1,1,1,0,0
2022-03-11,Binh Duong,Thu Dau Mot Town,5,2,1,1,0
2022-03-11,Binh Duong,Thu Dau Mot Town,6,41,32,9,5
2022-03-11,Binh Duong,Thu Dau Mot Town,7,137,117,20,6
2022-03-11,Binh Duong,Thu Dau Mot Town,8,205,186,19,0
2022-03-11,Binh Duong,Thu Dau Mot Town,9,242,232,10,1
2022-03-11,Binh Duong,Thu Dau Mot Town,10,397,372,25,6
2022-03-11,Binh Duong,Thu Dau Mot Town,11,621,531,90,42
2022-03-11,Binh Duong,Thu Dau Mot Town,12,451,422,29,6
2022-03-11,Binh Duong,Thu Dau Mot Town,13,376,348,28,9
2022-03-11,Binh Duong,Thu Dau Mot Town,14,336,317,19,3
2022-03-11,Binh Duong,Thu Dau Mot Town,15,262,243,19,7
2022-03-11,Binh Duong,Thu Dau Mot Town,16,295,270,25,9
2022-03-11,Binh Duong,Thu Dau Mot Town,17,378,347,31,9
2022-03-11,Binh Duong,Thu Dau Mot Town,18,397,352,45,10
2022-03-11,Binh Duong,Thu Dau Mot Town,19,324,294,30,7
2022-03-11,Binh Duong,Thu Dau Mot Town,20,286,244,42,16
2022-03-11,Binh Duong,Thu Dau Mot Town,21,98,83,15,8
2022-03-11,Binh Duong,Thu Dau Mot Town,22,5,1,4,1
2022-03-11,Binh Duong,Thu Dau Mot Town,23,2,1,1,0
2022-03-11,Binh Duong,Thuan An,7,4,0,4,2
2022-03-11,Binh Duong,Thuan An,8,15,9,6,6
2022-03-11,Binh Duong,Thuan An,9,38,19,19,15
2022-03-11,Binh Duong,Thuan An,10,50,23,27,23
2022-03-11,Binh Duong,Thuan An,11,53,37,16,13
2022-03-11,Binh Duong,Thuan An,12,50,34,16,13
2022-03-11,Binh Duong,Thuan An,13,68,42,26,16
2022-03-11,Binh Duong,Thuan An,14,38,26,12,10
2022-03-11,Binh Duong,Thuan An,15,26,21,5,4
2022-03-11,Binh Duong,Thuan An,16,44,33,11,7
2022-03-11,Binh Duong,Thuan An,17,33,23,10,9
2022-03-11,Binh Duong,Thuan An,18,41,29,12,10
2022-03-11,Binh Duong,Thuan An,19,53,36,17,14
2022-03-11,Binh Duong,Thuan An,20,30,13,17,16
2022-03-11,Binh Duong,Thuan An,21,21,7,14,10
2022-03-11,Can Tho City,Binh Thuy District,6,1,1,0,0
2022-03-11,Can Tho City,Binh Thuy District,8,7,6,1,0
2022-03-11,Can Tho City,Binh Thuy District,9,6,6,0,0
2022-03-11,Can Tho City,Binh Thuy District,10,11,11,0,0
2022-03-11,Can Tho City,Binh Thuy District,11,17,14,3,0
2022-03-11,Can Tho City,Binh Thuy District,12,15,13,2,0
2022-03-11,Can Tho City,Binh Thuy District,13,19,17,2,0
2022-03-11,Can Tho City,Binh Thuy District,14,13,12,1,0
2022-03-11,Can Tho City,Binh Thuy District,15,9,9,0,0
2022-03-11,Can Tho City,Binh Thuy District,16,15,13,2,0
2022-03-11,Can Tho City,Binh Thuy District,17,10,10,0,0
2022-03-11,Can Tho City,Binh Thuy District,18,9,8,1,0
2022-03-11,Can Tho City,Binh Thuy District,19,10,10,0,0
2022-03-11,Can Tho City,Binh Thuy District,20,7,5,2,1
2022-03-11,Can Tho City,Binh Thuy District,21,7,4,3,0
2022-03-11,Can Tho City,Binh Thuy District,22,1,1,0,0
2022-03-11,Can Tho City,Cai Rang District,6,2,0,2,2
2022-03-11,Can Tho City,Cai Rang District,7,3,3,0,0
2022-03-11,Can Tho City,Cai Rang District,8,4,3,1,1
2022-03-11,Can Tho City,Cai Rang District,9,5,4,1,0
2022-03-11,Can Tho City,Cai Rang District,10,9,8,1,0
2022-03-11,Can Tho City,Cai Rang District,11,15,10,5,0
2022-03-11,Can Tho City,Cai Rang District,12,12,11,1,0
2022-03-11,Can Tho City,Cai Rang District,13,11,11,0,0
2022-03-11,Can Tho City,Cai Rang District,14,4,4,0,0
2022-03-11,Can Tho City,Cai Rang District,15,6,6,0,0
2022-03-11,Can Tho City,Cai Rang District,16,11,9,2,2
2022-03-11,Can Tho City,Cai Rang District,17,6,6,0,0
2022-03-11,Can Tho City,Cai Rang District,18,11,10,1,0
2022-03-11,Can Tho City,Cai Rang District,19,12,9,3,0
2022-03-11,Can Tho City,Cai Rang District,20,13,9,4,2
2022-03-11,Can Tho City,Cai Rang District,21,3,3,0,0
2022-03-11,Can Tho City,Ninh Kieu District,0,4,2,2,0
2022-03-11,Can Tho City,Ninh Kieu District,2,1,1,0,0
2022-03-11,Can Tho City,Ninh Kieu District,3,1,1,0,0
2022-03-11,Can Tho City,Ninh Kieu District,5,1,1,0,0
2022-03-11,Can Tho City,Ninh Kieu District,6,46,45,1,0
2022-03-11,Can Tho City,Ninh Kieu District,7,137,131,6,0
2022-03-11,Can Tho City,Ninh Kieu District,8,268,253,15,0
2022-03-11,Can Tho City,Ninh Kieu District,9,309,289,20,0
2022-03-11,Can Tho City,Ninh Kieu District,10,579,552,27,0
2022-03-11,Can Tho City,Ninh Kieu District,11,869,796,73,11
2022-03-11,Can Tho City,Ninh Kieu District,12,551,516,35,5
2022-03-11,Can Tho City,Ninh Kieu District,13,477,446,31,1
2022-03-11,Can Tho City,Ninh Kieu District,14,372,352,20,0
2022-03-11,Can Tho City,Ninh Kieu District,15,351,333,18,0
2022-03-11,Can Tho City,Ninh Kieu District,16,465,439,26,1
2022-03-11,Can Tho City,Ninh Kieu District,17,540,498,42,4
2022-03-11,Can Tho City,Ninh Kieu District,18,571,534,37,0
2022-03-11,Can Tho City,Ninh Kieu District,19,434,400,34,1
2022-03-11,Can Tho City,Ninh Kieu District,20,372,346,26,0
2022-03-11,Can Tho City,Ninh Kieu District,21,197,177,20,3
2022-03-11,Can Tho City,Ninh Kieu District,22,7,3,4,0
2022-03-11,Can Tho City,Ninh Kieu District,23,5,3,2,0
2022-03-11,Dong Nai,Bien Hoa City,1,4,2,2,1
2022-03-11,Dong Nai,Bien Hoa City,2,3,0,3,2
2022-03-11,Dong Nai,Bien Hoa City,3,1,0,1,1
2022-03-11,Dong Nai,Bien Hoa City,6,58,25,33,23
2022-03-11,Dong Nai,Bien Hoa City,7,202,147,55,41
2022-03-11,Dong Nai,Bien Hoa City,8,277,242,35,12
2022-03-11,Dong Nai,Bien Hoa City,9,380,338,42,9
2022-03-11,Dong Nai,Bien Hoa City,10,764,664,100,31
2022-03-11,Dong Nai,Bien Hoa City,11,1041,913,128,50
2022-03-11,Dong Nai,Bien Hoa City,12,762,715,47,16
2022-03-11,Dong Nai,Bien Hoa City,13,713,645,68,27
2022-03-11,Dong Nai,Bien Hoa City,14,635,548,87,38
2022-03-11,Dong Nai,Bien Hoa City,15,572,479,93,51
2022-03-11,Dong Nai,Bien Hoa City,16,534,444,90,45
2022-03-11,Dong Nai,Bien Hoa City,17,642,538,104,65
2022-03-11,Dong Nai,Bien Hoa City,18,668,586,82,26
2022-03-11,Dong Nai,Bien Hoa City,19,630,555,75,20
2022-03-11,Dong Nai,Bien Hoa City,20,481,378,103,51
2022-03-11,Dong Nai,Bien Hoa City,21,255,132,123,78
2022-03-11,Dong Nai,Bien Hoa City,23,3,1,2,0
2022-03-11,Dong Nai,Long Thanh,9,2,0,2,2
2022-03-11,Dong Nai,Long Thanh,10,2,0,2,2
2022-03-11,Dong Nai,Long Thanh,11,1,0,1,0
2022-03-11,Dong Nai,Long Thanh,14,1,0,1,1
2022-03-11,Dong Nai,Long Thanh,16,2,0,2,2
2022-03-11,Dong Nai,Long Thanh,17,3,0,3,3
2022-03-11,Dong Nai,Long Thanh,18,4,0,4,4
2022-03-11,Dong Nai,Long Thanh,19,2,0,2,2
2022-03-11,Dong Nai,Long Thanh,21,1,0,1,1
2022-03-11,Dong Nai,Nhon trach,13,1,0,1,1
2022-03-11,Dong Nai,Thong Nhat,9,2,2,0,0
2022-03-11,Dong Nai,Thong Nhat,10,2,2,0,0
2022-03-11,Dong Nai,Thong Nhat,11,3,3,0,0
2022-03-11,Dong Nai,Thong Nhat,12,2,2,0,0
2022-03-11,Dong Nai,Thong Nhat,13,4,4,0,0
2022-03-11,Dong Nai,Thong Nhat,14,2,2,0,0
2022-03-11,Dong Nai,Thong Nhat,15,1,1,0,0
2022-03-11,Dong Nai,Thong Nhat,18,1,1,0,0
2022-03-11,Dong Nai,Thong Nhat,21,1,1,0,0
2022-03-11,Dong Nai,Trang Bom,9,1,0,1,1
2022-03-11,Dong Nai,Trang Bom,12,2,0,2,1
2022-03-11,Dong Nai,Trang Bom,13,1,0,1,1
2022-03-11,Dong Nai,Trang Bom,18,3,0,3,2
2022-03-11,Dong Nai,Trang Bom,20,1,1,0,0
2022-03-11,Hai Phong City,An Duong,6,1,0,1,1
2022-03-11,Hai Phong City,An Duong,7,1,1,0,0
2022-03-11,Hai Phong City,An Duong,8,1,1,0,0
2022-03-11,Hai Phong City,An Duong,9,2,2,0,0
2022-03-11,Hai Phong City,An Duong,10,2,2,0,0
2022-03-11,Hai Phong City,An Duong,11,1,1,0,0
2022-03-11,Hai Phong City,An Duong,12,1,0,1,0
2022-03-11,Hai Phong City,An Duong,13,1,1,0,0
2022-03-11,Hai Phong City,An Duong,14,3,2,1,0
2022-03-11,Hai Phong City,An Duong,15,1,1,0,0
2022-03-11,Hai Phong City,An Duong,18,2,2,0,0
2022-03-11,Hai Phong City,An Duong,21,2,1,1,0
2022-03-11,Hai Phong City,Duong Kinh District,12,1,0,1,0
2022-03-11,Hai Phong City,Duong Kinh District,19,1,0,1,1
2022-03-11,Hai Phong City,Hai An District,7,3,2,1,0
2022-03-11,Hai Phong City,Hai An District,8,4,2,2,0
2022-03-11,Hai Phong City,Hai An District,9,8,6,2,1
2022-03-11,Hai Phong City,Hai An District,10,25,23,2,0
2022-03-11,Hai Phong City,Hai An District,11,32,27,5,3
2022-03-11,Hai Phong City,Hai An District,12,13,12,1,0
2022-03-11,Hai Phong City,Hai An District,13,13,10,3,2
2022-03-11,Hai Phong City,Hai An District,14,16,10,6,3
2022-03-11,Hai Phong City,Hai An District,15,18,15,3,0
2022-03-11,Hai Phong City,Hai An District,16,14,12,2,0
2022-03-11,Hai Phong City,Hai An District,17,15,11,4,2
2022-03-11,Hai Phong City,Hai An District,18,17,13,4,1
2022-03-11,Hai Phong City,Hai An District,19,17,10,7,1
2022-03-11,Hai Phong City,Hai An District,20,20,17,3,0
2022-03-11,Hai Phong City,Hai An District,21,12,7,5,4
2022-03-11,Hai Phong City,Hong Bang District,6,1,0,1,0
2022-03-11,Hai Phong City,Hong Bang District,7,11,7,4,1
2022-03-11,Hai Phong City,Hong Bang District,8,28,22,6,2
2022-03-11,Hai Phong City,Hong Bang District,9,26,22,4,0
2022-03-11,Hai Phong City,Hong Bang District,10,67,64,3,1
2022-03-11,Hai Phong City,Hong Bang District,11,108,90,18,5
2022-03-11,Hai Phong City,Hong Bang District,12,55,51,4,0
2022-03-11,Hai Phong City,Hong Bang District,13,38,37,1,0
2022-03-11,Hai Phong City,Hong Bang District,14,31,28,3,1
2022-03-11,Hai Phong City,Hong Bang District,15,45,35,10,2
2022-03-11,Hai Phong City,Hong Bang District,16,37,36,1,0
2022-03-11,Hai Phong City,Hong Bang District,17,51,48,3,0
2022-03-11,Hai Phong City,Hong Bang District,18,52,44,8,6
2022-03-11,Hai Phong City,Hong Bang District,19,49,45,4,1
2022-03-11,Hai Phong City,Hong Bang District,20,37,32,5,2
2022-03-11,Hai Phong City,Hong Bang District,21,15,8,7,7
2022-03-11,Hai Phong City,Hong Bang District,23,1,0,1,0
2022-03-11,Hai Phong City,Kien An District,7,5,1,4,3
2022-03-11,Hai Phong City,Kien An District,8,4,3,1,1
2022-03-11,Hai Phong City,Kien An District,9,5,4,1,1
2022-03-11,Hai Phong City,Kien An District,10,6,4,2,0
2022-03-11,Hai Phong City,Kien An District,11,17,12,5,3
2022-03-11,Hai Phong City,Kien An District,12,8,7,1,1
2022-03-11,Hai Phong City,Kien An District,13,9,9,0,0
2022-03-11,Hai Phong City,Kien An District,14,7,6,1,0
2022-03-11,Hai Phong City,Kien An District,15,8,6,2,1
2022-03-11,Hai Phong City,Kien An District,16,8,8,0,0
2022-03-11,Hai Phong City,Kien An District,17,7,7,0,0
2022-03-11,Hai Phong City,Kien An District,18,4,3,1,1
2022-03-11,Hai Phong City,Kien An District,19,14,11,3,2
2022-03-11,Hai Phong City,Kien An District,20,9,8,1,1
2022-03-11,Hai Phong City,Kien An District,21,6,3,3,2
2022-03-11,Hai Phong City,Le Chan District,1,3,0,3,0
2022-03-11,Hai Phong City,Le Chan District,2,1,0,1,0
2022-03-11,Hai Phong City,Le Chan District,6,4,4,0,0
2022-03-11,Hai Phong City,Le Chan District,7,40,34,6,4
2022-03-11,Hai Phong City,Le Chan District,8,65,57,8,1
2022-03-11,Hai Phong City,Le Chan District,9,79,64,15,0
2022-03-11,Hai Phong City,Le Chan District,10,150,124,26,2
2022-03-11,Hai Phong City,Le Chan District,11,238,208,30,9
2022-03-11,Hai Phong City,Le Chan District,12,190,178,12,2
2022-03-11,Hai Phong City,Le Chan District,13,114,98,16,0
2022-03-11,Hai Phong City,Le Chan District,14,150,127,23,5
2022-03-11,Hai Phong City,Le Chan District,15,143,120,23,5
2022-03-11,Hai Phong City,Le Chan District,16,129,118,11,0
2022-03-11,Hai Phong City,Le Chan District,17,158,144,14,1
2022-03-11,Hai Phong City,Le Chan District,18,238,210,28,9
2022-03-11,Hai Phong City,Le Chan District,19,177,157,20,2
2022-03-11,Hai Phong City,Le Chan District,20,132,101,31,8
2022-03-11,Hai Phong City,Le Chan District,21,68,48,20,13
2022-03-11,Hai Phong City,Ngo Quyen District,0,1,1,0,0
2022-03-11,Hai Phong City,Ngo Quyen District,3,3,0,3,0
2022-03-11,Hai Phong City,Ngo Quyen District,5,1,1,0,0
2022-03-11,Hai Phong City,Ngo Quyen District,6,4,3,1,0
2022-03-11,Hai Phong City,Ngo Quyen District,7,27,22,5,3
2022-03-11,Hai Phong City,Ngo Quyen District,8,74,67,7,3
2022-03-11,Hai Phong City,Ngo Quyen District,9,55,50,5,1
2022-03-11,Hai Phong City,Ngo Quyen District,10,118,102,16,0
2022-03-11,Hai Phong City,Ngo Quyen District,11,271,238,33,11
2022-03-11,Hai Phong City,Ngo Quyen District,12,151,133,18,1
2022-03-11,Hai Phong City,Ngo Quyen District,13,93,81,12,2
2022-03-11,Hai Phong City,Ngo Quyen District,14,150,135,15,5
2022-03-11,Hai Phong City,Ngo Quyen District,15,172,149,23,1
2022-03-11,Hai Phong City,Ngo Quyen District,16,117,108,9,0
2022-03-11,Hai Phong City,Ngo Quyen District,17,157,145,12,1
2022-03-11,Hai Phong City,Ngo Quyen District,18,160,143,17,5
2022-03-11,Hai Phong City,Ngo Quyen District,19,144,129,15,3
2022-03-11,Hai Phong City,Ngo Quyen District,20,116,101,15,3
2022-03-11,Hai Phong City,Ngo Quyen District,21,56,44,12,4
2022-03-11,Hai Phong City,Ngo Quyen District,22,4,2,2,0
2022-03-11,Hai Phong City,Thuy Nguyen,14,1,0,1,1
2022-03-11,Hai Phong City,Thuy Nguyen,15,4,1,3,3
2022-03-11,Hai Phong City,Thuy Nguyen,19,5,0,5,5
2022-03-11,Hai Phong City,Thuy Nguyen,20,3,0,3,3
2022-03-11,Hue City,Hue City,0,6,6,0,0
2022-03-11,Hue City,Hue City,1,12,12,0,0
2022-03-11,Hue City,Hue City,2,2,1,1,0
2022-03-11,Hue City,Hue City,4,7,7,0,0
2022-03-11,Hue City,Hue City,5,1,1,0,0
2022-03-11,Hue City,Hue City,6,74,64,10,0
2022-03-11,Hue City,Hue City,7,269,248,21,1
2022-03-11,Hue City,Hue City,8,302,282,20,0
2022-03-11,Hue City,Hue City,9,225,211,14,0
2022-03-11,Hue City,Hue City,10,450,423,27,1
2022-03-11,Hue City,Hue City,11,803,753,50,2
2022-03-11,Hue City,Hue City,12,496,465,31,0
2022-03-11,Hue City,Hue City,13,278,257,21,0
2022-03-11,Hue City,Hue City,14,348,329,19,3
2022-03-11,Hue City,Hue City,15,400,372,28,1
2022-03-11,Hue City,Hue City,16,435,409,26,2
2022-03-11,Hue City,Hue City,17,531,498,33,1
2022-03-11,Hue City,Hue City,18,630,579,51,2
2022-03-11,Hue City,Hue City,19,603,554,49,1
2022-03-11,Hue City,Hue City,20,384,352,32,0
2022-03-11,Hue City,Hue City,21,227,199,28,2
2022-03-11,Hue City,Hue City,22,4,2,2,0
2022-03-11,Hue City,Hue City,23,4,4,0,0
2022-03-11,Hue City,Huong Thuy,8,1,1,0,0
2022-03-11,Hue City,Huong Thuy,11,1,0,1,0
2022-03-11,Hue City,Huong Thuy,12,1,1,0,0
2022-03-11,Hue City,Huong Thuy,15,1,1,0,0
2022-03-11,Hue City,Huong Thuy,17,2,2,0,0
2022-03-11,Hue City,Huong Thuy,18,1,1,0,0
2022-03-11,Hue City,Huong Thuy,19,1,1,0,0
2022-03-11,Hue City,Huong Tra,8,1,1,0,0
2022-03-11,Hue City,Huong Tra,19,2,2,0,0
2022-03-11,Hue City,Phu Vang,7,1,1,0,0
2022-03-11,Hue City,Phu Vang,8,2,2,0,0
2022-03-11,Hue City,Phu Vang,9,2,1,1,1
2022-03-11,Hue City,Phu Vang,11,4,2,2,0
2022-03-11,Hue City,Phu Vang,12,2,2,0,0
2022-03-11,Hue City,Phu Vang,13,2,2,0,0
2022-03-11,Hue City,Phu Vang,14,1,1,0,0
2022-03-11,Hue City,Phu Vang,15,4,3,1,1
2022-03-11,Hue City,Phu Vang,16,4,0,4,1
2022-03-11,Hue City,Phu Vang,17,6,4,2,0
2022-03-11,Hue City,Phu Vang,18,2,2,0,0
2022-03-11,Hue City,Phu Vang,19,1,1,0,0
2022-03-11,Hue City,Phu Vang,20,4,1,3,0
2022-03-11,Vung Tau,Ba Ria City,7,2,0,2,1
2022-03-11,Vung Tau,Ba Ria City,8,6,0,6,6
2022-03-11,Vung Tau,Ba Ria City,9,5,2,3,2
2022-03-11,Vung Tau,Ba Ria City,10,7,6,1,1
2022-03-11,Vung Tau,Ba Ria City,11,13,5,8,6
2022-03-11,Vung Tau,Ba Ria City,12,4,3,1,1
2022-03-11,Vung Tau,Ba Ria City,13,2,0,2,2
2022-03-11,Vung Tau,Ba Ria City,14,7,5,2,1
2022-03-11,Vung Tau,Ba Ria City,15,10,5,5,5
2022-03-11,Vung Tau,Ba Ria City,16,5,2,3,1
2022-03-11,Vung Tau,Ba Ria City,17,5,4,1,0
2022-03-11,Vung Tau,Ba Ria City,18,2,0,2,2
2022-03-11,Vung Tau,Ba Ria City,19,8,3,5,2
2022-03-11,Vung Tau,Ba Ria City,20,5,0,5,5
2022-03-11,Vung Tau,Ba Ria City,21,4,0,4,3
2022-03-11,Vung Tau,Vung Tau City,0,2,2,0,0
2022-03-11,Vung Tau,Vung Tau City,3,1,1,0,0
2022-03-11,Vung Tau,Vung Tau City,5,1,1,0,0
2022-03-11,Vung Tau,Vung Tau City,6,31,24,7,2
2022-03-11,Vung Tau,Vung Tau City,7,136,116,20,7
2022-03-11,Vung Tau,Vung Tau City,8,143,132,11,2
2022-03-11,Vung Tau,Vung Tau City,9,143,138,5,0
2022-03-11,Vung Tau,Vung Tau City,10,183,164,19,5
2022-03-11,Vung Tau,Vung Tau City,11,356,329,27,7
2022-03-11,Vung Tau,Vung Tau City,12,236,222,14,1
2022-03-11,Vung Tau,Vung Tau City,13,203,182,21,2
2022-03-11,Vung Tau,Vung Tau City,14,210,189,21,0
2022-03-11,Vung Tau,Vung Tau City,15,202,187,15,5
2022-03-11,Vung Tau,Vung Tau City,16,191,180,11,2
2022-03-11,Vung Tau,Vung Tau City,17,286,268,18,3
2022-03-11,Vung Tau,Vung Tau City,18,318,274,44,27
2022-03-11,Vung Tau,Vung Tau City,19,225,210,15,2
2022-03-11,Vung Tau,Vung Tau City,20,188,169,19,3
2022-03-11,Vung Tau,Vung Tau City,21,88,70,18,4
2022-03-11,Vung Tau,Vung Tau City,22,2,1,1,0
2022-03-11,Vung Tau,Vung Tau City,23,2,2,0,0
2022-03-12,Binh Duong,Ben Cat,8,1,0,1,0
2022-03-12,Binh Duong,Ben Cat,11,2,0,2,2
2022-03-12,Binh Duong,Ben Cat,13,2,0,2,2
2022-03-12,Binh Duong,Ben Cat,14,1,0,1,1
2022-03-12,Binh Duong,Ben Cat,15,1,0,1,1
2022-03-12,Binh Duong,Ben Cat,18,1,1,0,0
2022-03-12,Binh Duong,Ben Cat,19,1,1,0,0
2022-03-12,Binh Duong,Di An,6,1,0,1,1
2022-03-12,Binh Duong,Di An,7,10,0,10,10
2022-03-12,Binh Duong,Di An,8,12,1,11,11
2022-03-12,Binh Duong,Di An,9,18,5,13,13
2022-03-12,Binh Duong,Di An,10,38,13,25,24
2022-03-12,Binh Duong,Di An,11,47,17,30,20
2022-03-12,Binh Duong,Di An,12,29,11,18,15
2022-03-12,Binh Duong,Di An,13,19,8,11,7
2022-03-12,Binh Duong,Di An,14,24,12,12,9
2022-03-12,Binh Duong,Di An,15,20,11,9,6
2022-03-12,Binh Duong,Di An,16,25,11,14,9
2022-03-12,Binh Duong,Di An,17,26,13,13,10
2022-03-12,Binh Duong,Di An,18,26,9,17,13
2022-03-12,Binh Duong,Di An,19,21,11,10,9
2022-03-12,Binh Duong,Di An,20,11,2,9,5
2022-03-12,Binh Duong,Di An,21,6,2,4,4
2022-03-12,Binh Duong,Tan Uyen,7,1,0,1,1
2022-03-12,Binh Duong,Tan Uyen,8,2,0,2,2
2022-03-12,Binh Duong,Tan Uyen,9,2,1,1,1
2022-03-12,Binh Duong,Tan Uyen,10,1,0,1,1
2022-03-12,Binh Duong,Tan Uyen,11,2,1,1,1
2022-03-12,Binh Duong,Tan Uyen,12,3,0,3,2
2022-03-12,Binh Duong,Tan Uyen,13,2,2,0,0
2022-03-12,Binh Duong,Tan Uyen,14,1,1,0,0
2022-03-12,Binh Duong,Tan Uyen,15,1,0,1,1
2022-03-12,Binh Duong,Tan Uyen,16,2,2,0,0
2022-03-12,Binh Duong,Tan Uyen,17,2,2,0,0
2022-03-12,Binh Duong,Tan Uyen,18,1,0,1,0
2022-03-12,Binh Duong,Tan Uyen,19,2,2,0,0
2022-03-12,Binh Duong,Tan Uyen,20,1,0,1,1
2022-03-12,Binh Duong,Tan Uyen,21,1,1,0,0
2022-03-12,Binh Duong,Thu Dau Mot Town,1,1,0,1,0
2022-03-12,Binh Duong,Thu Dau Mot Town,5,3,2,1,1
2022-03-12,Binh Duong,Thu Dau Mot Town,6,30,22,8,7
2022-03-12,Binh Duong,Thu Dau Mot Town,7,127,116,11,6
2022-03-12,Binh Duong,Thu Dau Mot Town,8,199,189,10,2
2022-03-12,Binh Duong,Thu Dau Mot Town,9,235,221,14,2
2022-03-12,Binh Duong,Thu Dau Mot Town,10,398,366,32,7
2022-03-12,Binh Duong,Thu Dau Mot Town,11,547,515,32,8
2022-03-12,Binh Duong,Thu Dau Mot Town,12,480,442,38,15
2022-03-12,Binh Duong,Thu Dau Mot Town,13,342,328,14,0
2022-03-12,Binh Duong,Thu Dau Mot Town,14,317,310,7,1
2022-03-12,Binh Duong,Thu Dau Mot Town,15,277,258,19,1
2022-03-12,Binh Duong,Thu Dau Mot Town,16,326,287,39,17
2022-03-12,Binh Duong,Thu Dau Mot Town,17,371,342,29,4
2022-03-12,Binh Duong,Thu Dau Mot Town,18,424,377,47,15
2022-03-12,Binh Duong,Thu Dau Mot Town,19,321,283,38,13
2022-03-12,Binh Duong,Thu Dau Mot Town,20,261,225,36,11
2022-03-12,Binh Duong,Thu Dau Mot Town,21,105,80,25,12
2022-03-12,Binh Duong,Thu Dau Mot Town,22,1,0,1,0
2022-03-12,Binh Duong,Thu Dau Mot Town,23,2,2,0,0
2022-03-12,Binh Duong,Thuan An,6,2,0,2,2
2022-03-12,Binh Duong,Thuan An,7,8,1,7,7
2022-03-12,Binh Duong,Thuan An,8,17,12,5,4
2022-03-12,Binh Duong,Thuan An,9,28,17,11,5
2022-03-12,Binh Duong,Thuan An,10,34,23,11,9
2022-03-12,Binh Duong,Thuan An,11,97,44,53,47
2022-03-12,Binh Duong,Thuan An,12,62,42,20,10
2022-03-12,Binh Duong,Thuan An,13,47,30,17,9
2022-03-12,Binh Duong,Thuan An,14,50,24,26,18
2022-03-12,Binh Duong,Thuan An,15,40,27,13,10
2022-03-12,Binh Duong,Thuan An,16,30,19,11,9
2022-03-12,Binh Duong,Thuan An,17,50,23,27,17
2022-03-12,Binh Duong,Thuan An,18,56,24,32,26
2022-03-12,Binh Duong,Thuan An,19,40,21,19,15
2022-03-12,Binh Duong,Thuan An,20,34,14,20,16
2022-03-12,Binh Duong,Thuan An,21,19,4,15,11
2022-03-12,Can Tho City,Binh Thuy District,7,5,5,0,0
2022-03-12,Can Tho City,Binh Thuy District,8,2,1,1,0
2022-03-12,Can Tho City,Binh Thuy District,9,14,14,0,0
2022-03-12,Can Tho City,Binh Thuy District,10,10,9,1,0
2022-03-12,Can Tho City,Binh Thuy District,11,20,19,1,0
2022-03-12,Can Tho City,Binh Thuy District,12,12,11,1,0
2022-03-12,Can Tho City,Binh Thuy District,13,16,15,1,1
2022-03-12,Can Tho City,Binh Thuy District,14,19,18,1,0
2022-03-12,Can Tho City,Binh Thuy District,15,14,12,2,1
2022-03-12,Can Tho City,Binh Thuy District,16,13,12,1,1
2022-03-12,Can Tho City,Binh Thuy District,17,14,13,1,1
2022-03-12,Can Tho City,Binh Thuy District,18,15,14,1,0
2022-03-12,Can Tho City,Binh Thuy District,19,11,8,3,0
2022-03-12,Can Tho City,Binh Thuy District,20,12,7,5,1
2022-03-12,Can Tho City,Binh Thuy District,21,3,1,2,0
2022-03-12,Can Tho City,Cai Rang District,7,1,1,0,0
2022-03-12,Can Tho City,Cai Rang District,8,2,2,0,0
2022-03-12,Can Tho City,Cai Rang District,9,2,2,0,0
2022-03-12,Can Tho City,Cai Rang District,10,7,7,0,0
2022-03-12,Can Tho City,Cai Rang District,11,14,13,1,0
2022-03-12,Can Tho City,Cai Rang District,12,9,8,1,0
2022-03-12,Can Tho City,Cai Rang District,13,11,11,0,0
2022-03-12,Can Tho City,Cai Rang District,14,5,4,1,0
2022-03-12,Can Tho City,Cai Rang District,15,17,13,4,3
2022-03-12,Can Tho City,Cai Rang District,16,9,8,1,1
2022-03-12,Can Tho City,Cai Rang District,17,7,5,2,1
2022-03-12,Can Tho City,Cai Rang District,18,9,9,0,0
2022-03-12,Can Tho City,Cai Rang District,19,13,11,2,1
2022-03-12,Can Tho City,Cai Rang District,20,4,4,0,0
2022-03-12,Can Tho City,Cai Rang District,21,4,2,2,2
2022-03-12,Can Tho City,Cai Rang District,22,1,1,0,0
2022-03-12,Can Tho City,Ninh Kieu District,0,3,3,0,0
2022-03-12,Can Tho City,Ninh Kieu District,1,2,1,1,0
2022-03-12,Can Tho City,Ninh Kieu District,3,2,1,1,0
2022-03-12,Can Tho City,Ninh Kieu District,4,3,2,1,0
2022-03-12,Can Tho City,Ninh Kieu District,5,1,1,0,0
2022-03-12,Can Tho City,Ninh Kieu District,6,48,44,4,0
2022-03-12,Can Tho City,Ninh Kieu District,7,138,126,12,1
2022-03-12,Can Tho City,Ninh Kieu District,8,273,256,17,0
2022-03-12,Can Tho City,Ninh Kieu District,9,296,286,10,0
2022-03-12,Can Tho City,Ninh Kieu District,10,524,499,25,0
2022-03-12,Can Tho City,Ninh Kieu District,11,816,757,59,6
2022-03-12,Can Tho City,Ninh Kieu District,12,587,567,20,1
2022-03-12,Can Tho City,Ninh Kieu District,13,437,411,26,0
2022-03-12,Can Tho City,Ninh Kieu District,14,341,327,14,0
2022-03-12,Can Tho City,Ninh Kieu District,15,411,390,21,0
2022-03-12,Can Tho City,Ninh Kieu District,16,506,393,113,76
2022-03-12,Can Tho City,Ninh Kieu District,17,630,526,104,61
2022-03-12,Can Tho City,Ninh Kieu District,18,562,530,32,8
2022-03-12,Can Tho City,Ninh Kieu District,19,456,424,32,4
2022-03-12,Can Tho City,Ninh Kieu District,20,350,315,35,3
2022-03-12,Can Tho City,Ninh Kieu District,21,154,141,13,2
2022-03-12,Can Tho City,Ninh Kieu District,22,4,1,3,1
2022-03-12,Can Tho City,Ninh Kieu District,23,2,1,1,0
2022-03-12,Dong Nai,Bien Hoa City,0,3,3,0,0
2022-03-12,Dong Nai,Bien Hoa City,1,6,2,4,0
2022-03-12,Dong Nai,Bien Hoa City,2,3,2,1,0
2022-03-12,Dong Nai,Bien Hoa City,3,4,2,2,1
2022-03-12,Dong Nai,Bien Hoa City,5,7,1,6,1
2022-03-12,Dong Nai,Bien Hoa City,6,47,24,23,19
2022-03-12,Dong Nai,Bien Hoa City,7,173,132,41,24
2022-03-12,Dong Nai,Bien Hoa City,8,292,242,50,19
2022-03-12,Dong Nai,Bien Hoa City,9,444,371,73,23
2022-03-12,Dong Nai,Bien Hoa City,10,804,666,138,86
2022-03-12,Dong Nai,Bien Hoa City,11,1136,941,195,109
2022-03-12,Dong Nai,Bien Hoa City,12,920,818,102,28
2022-03-12,Dong Nai,Bien Hoa City,13,724,660,64,10
2022-03-12,Dong Nai,Bien Hoa City,14,543,475,68,24
2022-03-12,Dong Nai,Bien Hoa City,15,520,433,87,34
2022-03-12,Dong Nai,Bien Hoa City,16,621,470,151,85
2022-03-12,Dong Nai,Bien Hoa City,17,730,528,202,125
2022-03-12,Dong Nai,Bien Hoa City,18,840,555,285,195
2022-03-12,Dong Nai,Bien Hoa City,19,739,567,172,102
2022-03-12,Dong Nai,Bien Hoa City,20,530,365,165,94
2022-03-12,Dong Nai,Bien Hoa City,21,228,133,95,41
2022-03-12,Dong Nai,Bien Hoa City,22,2,1,1,0
2022-03-12,Dong Nai,Bien Hoa City,23,2,0,2,1
2022-03-12,Dong Nai,Long Khanh,11,1,0,1,0
2022-03-12,Dong Nai,Long Thanh,9,2,0,2,2
2022-03-12,Dong Nai,Long Thanh,10,1,0,1,1
2022-03-12,Dong Nai,Long Thanh,11,3,0,3,3
2022-03-12,Dong Nai,Long Thanh,12,1,0,1,1
2022-03-12,Dong Nai,Long Thanh,13,1,0,1,1
2022-03-12,Dong Nai,Long Thanh,14,3,0,3,2
2022-03-12,Dong Nai,Long Thanh,17,2,0,2,1
2022-03-12,Dong Nai,Long Thanh,18,1,0,1,0
2022-03-12,Dong Nai,Long Thanh,20,3,0,3,3
2022-03-12,Dong Nai,Long Thanh,21,1,0,1,1
2022-03-12,Dong Nai,Thong Nhat,8,1,1,0,0
2022-03-12,Dong Nai,Thong Nhat,9,6,5,1,0
2022-03-12,Dong Nai,Thong Nhat,11,1,0,1,1
2022-03-12,Dong Nai,Thong Nhat,12,1,1,0,0
2022-03-12,Dong Nai,Thong Nhat,14,3,3,0,0
2022-03-12,Dong Nai,Thong Nhat,15,1,1,0,0
2022-03-12,Dong Nai,Thong Nhat,18,1,1,0,0
2022-03-12,Dong Nai,Thong Nhat,19,1,1,0,0
2022-03-12,Dong Nai,Thong Nhat,20,1,1,0,0
2022-03-12,Dong Nai,Thong Nhat,21,1,1,0,0
2022-03-12,Dong Nai,Trang Bom,10,4,0,4,4
2022-03-12,Dong Nai,Trang Bom,11,2,1,1,0
2022-03-12,Dong Nai,Trang Bom,12,1,1,0,0
2022-03-12,Hai Phong City,An Duong,8,1,0,1,1
2022-03-12,Hai Phong City,An Duong,9,2,1,1,1
2022-03-12,Hai Phong City,An Duong,10,7,1,6,6
2022-03-12,Hai Phong City,An Duong,11,6,2,4,3
2022-03-12,Hai Phong City,An Duong,12,2,1,1,1
2022-03-12,Hai Phong City,An Duong,13,2,2,0,0
2022-03-12,Hai Phong City,An Duong,14,2,2,0,0
2022-03-12,Hai Phong City,An Duong,15,2,2,0,0
2022-03-12,Hai Phong City,An Duong,16,2,2,0,0
2022-03-12,Hai Phong City,An Duong,17,3,0,3,2
2022-03-12,Hai Phong City,An Duong,18,1,1,0,0
2022-03-12,Hai Phong City,An Duong,19,2,1,1,1
2022-03-12,Hai Phong City,Duong Kinh District,10,2,0,2,2
2022-03-12,Hai Phong City,Duong Kinh District,11,1,1,0,0
2022-03-12,Hai Phong City,Hai An District,6,1,1,0,0
2022-03-12,Hai Phong City,Hai An District,7,3,1,2,2
2022-03-12,Hai Phong City,Hai An District,8,12,10,2,0
2022-03-12,Hai Phong City,Hai An District,9,8,7,1,1
2022-03-12,Hai Phong City,Hai An District,10,19,15,4,2
2022-03-12,Hai Phong City,Hai An District,11,46,39,7,2
2022-03-12,Hai Phong City,Hai An District,12,14,12,2,0
2022-03-12,Hai Phong City,Hai An District,13,6,5,1,0
2022-03-12,Hai Phong City,Hai An District,14,15,10,5,1
2022-03-12,Hai Phong City,Hai An District,15,14,9,5,3
2022-03-12,Hai Phong City,Hai An District,16,21,18,3,1
2022-03-12,Hai Phong City,Hai An District,17,22,14,8,1
2022-03-12,Hai Phong City,Hai An District,18,11,10,1,1
2022-03-12,Hai Phong City,Hai An District,19,17,14,3,0
2022-03-12,Hai Phong City,Hai An District,20,17,10,7,3
2022-03-12,Hai Phong City,Hai An District,21,12,8,4,2
2022-03-12,Hai Phong City,Hai An District,22,1,0,1,0
2022-03-12,Hai Phong City,Hong Bang District,6,2,0,2,1
2022-03-12,Hai Phong City,Hong Bang District,7,11,8,3,3
2022-03-12,Hai Phong City,Hong Bang District,8,19,15,4,3
2022-03-12,Hai Phong City,Hong Bang District,9,43,39,4,1
2022-03-12,Hai Phong City,Hong Bang District,10,49,43,6,1
2022-03-12,Hai Phong City,Hong Bang District,11,115,99,16,11
2022-03-12,Hai Phong City,Hong Bang District,12,76,65,11,4
2022-03-12,Hai Phong City,Hong Bang District,13,33,29,4,1
2022-03-12,Hai Phong City,Hong Bang District,14,34,29,5,1
2022-03-12,Hai Phong City,Hong Bang District,15,37,30,7,1
2022-03-12,Hai Phong City,Hong Bang District,16,33,28,5,2
2022-03-12,Hai Phong City,Hong Bang District,17,48,43,5,2
2022-03-12,Hai Phong City,Hong Bang District,18,67,50,17,11
2022-03-12,Hai Phong City,Hong Bang District,19,54,43,11,7
2022-03-12,Hai Phong City,Hong Bang District,20,38,24,14,7
2022-03-12,Hai Phong City,Hong Bang District,21,15,7,8,8
2022-03-12,Hai Phong City,Kien An District,7,7,1,6,1
2022-03-12,Hai Phong City,Kien An District,8,7,4,3,2
2022-03-12,Hai Phong City,Kien An District,9,3,2,1,1
2022-03-12,Hai Phong City,Kien An District,10,10,9,1,1
2022-03-12,Hai Phong City,Kien An District,11,8,7,1,0
2022-03-12,Hai Phong City,Kien An District,12,5,4,1,0
2022-03-12,Hai Phong City,Kien An District,13,10,9,1,0
2022-03-12,Hai Phong City,Kien An District,14,9,7,2,2
2022-03-12,Hai Phong City,Kien An District,15,14,12,2,1
2022-03-12,Hai Phong City,Kien An District,16,5,4,1,0
2022-03-12,Hai Phong City,Kien An District,17,10,10,0,0
2022-03-12,Hai Phong City,Kien An District,18,10,7,3,1
2022-03-12,Hai Phong City,Kien An District,19,13,10,3,2
2022-03-12,Hai Phong City,Kien An District,20,8,7,1,0
2022-03-12,Hai Phong City,Kien An District,21,5,2,3,1
2022-03-12,Hai Phong City,Kien An District,22,1,0,1,0
2022-03-12,Hai Phong City,Le Chan District,0,1,0,1,0
2022-03-12,Hai Phong City,Le Chan District,1,1,1,0,0
2022-03-12,Hai Phong City,Le Chan District,2,1,0,1,0
2022-03-12,Hai Phong City,Le Chan District,6,3,0,3,3
2022-03-12,Hai Phong City,Le Chan District,7,33,25,8,5
2022-03-12,Hai Phong City,Le Chan District,8,66,59,7,1
2022-03-12,Hai Phong City,Le Chan District,9,72,63,9,0
2022-03-12,Hai Phong City,Le Chan District,10,162,153,9,2
2022-03-12,Hai Phong City,Le Chan District,11,291,237,54,31
2022-03-12,Hai Phong City,Le Chan District,12,201,191,10,2
2022-03-12,Hai Phong City,Le Chan District,13,121,113,8,0
2022-03-12,Hai Phong City,Le Chan District,14,106,92,14,1
2022-03-12,Hai Phong City,Le Chan District,15,146,122,24,1
2022-03-12,Hai Phong City,Le Chan District,16,152,137,15,0
2022-03-12,Hai Phong City,Le Chan District,17,202,175,27,4
2022-03-12,Hai Phong City,Le Chan District,18,238,191,47,25
2022-03-12,Hai Phong City,Le Chan District,19,200,152,48,29
2022-03-12,Hai Phong City,Le Chan District,20,134,100,34,22
2022-03-12,Hai Phong City,Le Chan District,21,81,52,29,15
2022-03-12,Hai Phong City,Le Chan District,23,3,0,3,0
2022-03-12,Hai Phong City,Ngo Quyen District,0,1,1,0,0
2022-03-12,Hai Phong City,Ngo Quyen District,1,1,0,1,0
2022-03-12,Hai Phong City,Ngo Quyen District,2,1,1,0,0
2022-03-12,Hai Phong City,Ngo Quyen District,6,6,2,4,2
2022-03-12,Hai Phong City,Ngo Quyen District,7,37,24,13,9
2022-03-12,Hai Phong City,Ngo Quyen District,8,74,66,8,2
2022-03-12,Hai Phong City,Ngo Quyen District,9,85,79,6,1
2022-03-12,Hai Phong City,Ngo Quyen District,10,147,132,15,1
2022-03-12,Hai Phong City,Ngo Quyen District,11,218,191,27,12
2022-03-12,Hai Phong City,Ngo Quyen District,12,122,111,11,4
2022-03-12,Hai Phong City,Ngo Quyen District,13,90,83,7,1
2022-03-12,Hai Phong City,Ngo Quyen District,14,116,104,12,0
2022-03-12,Hai Phong City,Ngo Quyen District,15,109,103,6,1
2022-03-12,Hai Phong City,Ngo Quyen District,16,127,120,7,0
2022-03-12,Hai Phong City,Ngo Quyen District,17,165,143,22,2
2022-03-12,Hai Phong City,Ngo Quyen District,18,188,156,32,9
2022-03-12,Hai Phong City,Ngo Quyen District,19,156,118,38,18
2022-03-12,Hai Phong City,Ngo Quyen District,20,137,95,42,21
2022-03-12,Hai Phong City,Ngo Quyen District,21,72,42,30,15
2022-03-12,Hai Phong City,Ngo Quyen District,22,2,2,0,0
2022-03-12,Hai Phong City,Thuy Nguyen,11,1,0,1,1
2022-03-12,Hai Phong City,Thuy Nguyen,12,2,0,2,1
2022-03-12,Hai Phong City,Thuy Nguyen,14,1,1,0,0
2022-03-12,Hai Phong City,Thuy Nguyen,17,3,0,3,1
2022-03-12,Hai Phong City,Thuy Nguyen,18,7,0,7,7
2022-03-12,Hai Phong City,Thuy Nguyen,19,1,0,1,1
2022-03-12,Hue City,Hue City,0,5,3,2,1
2022-03-12,Hue City,Hue City,1,1,1,0,0
2022-03-12,Hue City,Hue City,3,1,0,1,0
2022-03-12,Hue City,Hue City,4,2,0,2,0
2022-03-12,Hue City,Hue City,5,2,2,0,0
2022-03-12,Hue City,Hue City,6,74,67,7,2
2022-03-12,Hue City,Hue City,7,202,186,16,0
2022-03-12,Hue City,Hue City,8,343,313,30,0
2022-03-12,Hue City,Hue City,9,264,247,17,0
2022-03-12,Hue City,Hue City,10,426,402,24,1
2022-03-12,Hue City,Hue City,11,738,703,35,1
2022-03-12,Hue City,Hue City,12,540,498,42,2
2022-03-12,Hue City,Hue City,13,316,303,13,0
2022-03-12,Hue City,Hue City,14,334,301,33,0
2022-03-12,Hue City,Hue City,15,361,344,17,1
2022-03-12,Hue City,Hue City,16,430,404,26,2
2022-03-12,Hue City,Hue City,17,543,504,39,1
2022-03-12,Hue City,Hue City,18,645,603,42,1
2022-03-12,Hue City,Hue City,19,668,622,46,7
2022-03-12,Hue City,Hue City,20,519,457,62,11
2022-03-12,Hue City,Hue City,21,255,215,40,3
2022-03-12,Hue City,Hue City,22,5,2,3,1
2022-03-12,Hue City,Hue City,23,2,2,0,0
2022-03-12,Hue City,Huong Thuy,9,2,0,2,0
2022-03-12,Hue City,Huong Thuy,10,1,1,0,0
2022-03-12,Hue City,Huong Thuy,11,1,1,0,0
2022-03-12,Hue City,Huong Thuy,12,2,2,0,0
2022-03-12,Hue City,Huong Thuy,14,1,0,1,1
2022-03-12,Hue City,Huong Thuy,15,3,1,2,0
2022-03-12,Hue City,Huong Thuy,18,2,2,0,0
2022-03-12,Hue City,Huong Thuy,19,1,1,0,0
2022-03-12,Hue City,Huong Tra,7,1,1,0,0
2022-03-12,Hue City,Huong Tra,11,1,1,0,0
2022-03-12,Hue City,Huong Tra,12,1,1,0,0
2022-03-12,Hue City,Huong Tra,17,1,1,0,0
2022-03-12,Hue City,Phu Vang,6,1,1,0,0
2022-03-12,Hue City,Phu Vang,7,2,2,0,0
2022-03-12,Hue City,Phu Vang,8,1,1,0,0
2022-03-12,Hue City,Phu Vang,9,2,2,0,0
2022-03-12,Hue City,Phu Vang,10,2,2,0,0
2022-03-12,Hue City,Phu Vang,11,2,2,0,0
2022-03-12,Hue City,Phu Vang,12,1,1,0,0
2022-03-12,Hue City,Phu Vang,15,2,0,2,2
2022-03-12,Hue City,Phu Vang,16,1,0,1,1
2022-03-12,Hue City,Phu Vang,19,6,5,1,0
2022-03-12,Hue City,Phu Vang,20,2,0,2,0
2022-03-12,Hue City,Phu Vang,21,2,1,1,0
2022-03-12,Hue City,Phu Vang,23,1,1,0,0
2022-03-12,Vung Tau,Ba Ria City,8,3,0,3,3
2022-03-12,Vung Tau,Ba Ria City,9,4,0,4,4
2022-03-12,Vung Tau,Ba Ria City,10,4,3,1,1
2022-03-12,Vung Tau,Ba Ria City,11,13,7,6,5
2022-03-12,Vung Tau,Ba Ria City,12,9,4,5,3
2022-03-12,Vung Tau,Ba Ria City,13,9,4,5,0
2022-03-12,Vung Tau,Ba Ria City,14,10,6,4,4
2022-03-12,Vung Tau,Ba Ria City,15,11,1,10,7
2022-03-12,Vung Tau,Ba Ria City,16,8,3,5,3
2022-03-12,Vung Tau,Ba Ria City,17,6,3,3,2
2022-03-12,Vung Tau,Ba Ria City,18,4,3,1,1
2022-03-12,Vung Tau,Ba Ria City,19,7,1,6,4
2022-03-12,Vung Tau,Ba Ria City,20,11,0,11,11
2022-03-12,Vung Tau,Ba Ria City,21,2,0,2,1
2022-03-12,Vung Tau,Tan Thanh,21,1,0,1,1
2022-03-12,Vung Tau,Vung Tau City,1,1,1,0,0
2022-03-12,Vung Tau,Vung Tau City,3,1,0,1,0
2022-03-12,Vung Tau,Vung Tau City,4,1,0,1,0
2022-03-12,Vung Tau,Vung Tau City,6,36,29,7,4
2022-03-12,Vung Tau,Vung Tau City,7,120,112,8,3
2022-03-12,Vung Tau,Vung Tau City,8,176,156,20,4
2022-03-12,Vung Tau,Vung Tau City,9,165,153,12,1
2022-03-12,Vung Tau,Vung Tau City,10,215,196,19,4
2022-03-12,Vung Tau,Vung Tau City,11,393,358,35,11
2022-03-12,Vung Tau,Vung Tau City,12,279,256,23,7
2022-03-12,Vung Tau,Vung Tau City,13,185,168,17,0
2022-03-12,Vung Tau,Vung Tau City,14,221,174,47,29
2022-03-12,Vung Tau,Vung Tau City,15,238,198,40,16
2022-03-12,Vung Tau,Vung Tau City,16,261,237,24,4
2022-03-12,Vung Tau,Vung Tau City,17,368,265,103,70
2022-03-12,Vung Tau,Vung Tau City,18,371,264,107,73
2022-03-12,Vung Tau,Vung Tau City,19,369,235,134,96
2022-03-12,Vung Tau,Vung Tau City,20,231,165,66,31
2022-03-12,Vung Tau,Vung Tau City,21,128,75,53,31
2022-03-12,Vung Tau,Vung Tau City,22,4,1,3,1
2022-03-13,Binh Duong,Ben Cat,9,1,0,1,1
2022-03-13,Binh Duong,Ben Cat,10,1,0,1,1
2022-03-13,Binh Duong,Ben Cat,11,2,0,2,2
2022-03-13,Binh Duong,Ben Cat,13,1,0,1,0
2022-03-13,Binh Duong,Ben Cat,14,1,0,1,1
2022-03-13,Binh Duong,Ben Cat,16,1,0,1,1
2022-03-13,Binh Duong,Ben Cat,17,1,0,1,1
2022-03-13,Binh Duong,Di An,0,1,0,1,1
2022-03-13,Binh Duong,Di An,7,2,0,2,1
2022-03-13,Binh Duong,Di An,8,13,0,13,11
2022-03-13,Binh Duong,Di An,9,35,5,30,26
2022-03-13,Binh Duong,Di An,10,39,7,32,32
2022-03-13,Binh Duong,Di An,11,42,8,34,29
2022-03-13,Binh Duong,Di An,12,57,3,54,47
2022-03-13,Binh Duong,Di An,13,55,9,46,39
2022-03-13,Binh Duong,Di An,14,40,10,30,29
2022-03-13,Binh Duong,Di An,15,27,3,24,21
2022-03-13,Binh Duong,Di An,16,26,6,20,19
2022-03-13,Binh Duong,Di An,17,26,8,18,14
2022-03-13,Binh Duong,Di An,18,29,4,25,21
2022-03-13,Binh Duong,Di An,19,33,9,24,18
2022-03-13,Binh Duong,Di An,20,17,5,12,8
2022-03-13,Binh Duong,Di An,21,2,2,0,0
2022-03-13,Binh Duong,Tan Uyen,7,1,0,1,1
2022-03-13,Binh Duong,Tan Uyen,10,2,1,1,1
2022-03-13,Binh Duong,Tan Uyen,11,4,3,1,1
2022-03-13,Binh Duong,Tan Uyen,13,2,1,1,1
2022-03-13,Binh Duong,Tan Uyen,14,1,1,0,0
2022-03-13,Binh Duong,Tan Uyen,15,1,0,1,1
2022-03-13,Binh Duong,Tan Uyen,16,2,0,2,2
2022-03-13,Binh Duong,Tan Uyen,17,5,3,2,1
2022-03-13,Binh Duong,Tan Uyen,18,2,1,1,1
2022-03-13,Binh Duong,Tan Uyen,19,5,1,4,4
2022-03-13,Binh Duong,Tan Uyen,21,1,0,1,1
2022-03-13,Binh Duong,Thu Dau Mot Town,0,1,0,1,0
2022-03-13,Binh Duong,Thu Dau Mot Town,6,49,29,20,15
2022-03-13,Binh Duong,Thu Dau Mot Town,7,158,134,24,10
2022-03-13,Binh Duong,Thu Dau Mot Town,8,239,219,20,1
2022-03-13,Binh Duong,Thu Dau Mot Town,9,276,253,23,6
2022-03-13,Binh Duong,Thu Dau Mot Town,10,381,351,30,8
2022-03-13,Binh Duong,Thu Dau Mot Town,11,587,533,54,22
2022-03-13,Binh Duong,Thu Dau Mot Town,12,454,419,35,7
2022-03-13,Binh Duong,Thu Dau Mot Town,13,381,356,25,7
2022-03-13,Binh Duong,Thu Dau Mot Town,14,388,334,54,29
2022-03-13,Binh Duong,Thu Dau Mot Town,15,331,308,23,8
2022-03-13,Binh Duong,Thu Dau Mot Town,16,337,314,23,4
2022-03-13,Binh Duong,Thu Dau Mot Town,17,335,305,30,6
2022-03-13,Binh Duong,Thu Dau Mot Town,18,430,363,67,40
2022-03-13,Binh Duong,Thu Dau Mot Town,19,391,314,77,37
2022-03-13,Binh Duong,Thu Dau Mot Town,20,267,237,30,3
2022-03-13,Binh Duong,Thu Dau Mot Town,21,121,95,26,7
2022-03-13,Binh Duong,Thu Dau Mot Town,22,3,1,2,0
2022-03-13,Binh Duong,Thuan An,7,9,1,8,7
2022-03-13,Binh Duong,Thuan An,8,22,8,14,12
2022-03-13,Binh Duong,Thuan An,9,45,11,34,29
2022-03-13,Binh Duong,Thuan An,10,101,23,78,65
2022-03-13,Binh Duong,Thuan An,11,88,26,62,52
2022-03-13,Binh Duong,Thuan An,12,113,46,67,59
2022-03-13,Binh Duong,Thuan An,13,87,30,57,52
2022-03-13,Binh Duong,Thuan An,14,76,23,53,46
2022-03-13,Binh Duong,Thuan An,15,59,28,31,27
2022-03-13,Binh Duong,Thuan An,16,56,27,29,17
2022-03-13,Binh Duong,Thuan An,17,55,26,29,24
2022-03-13,Binh Duong,Thuan An,18,48,23,25,21
2022-03-13,Binh Duong,Thuan An,19,44,15,29,21
2022-03-13,Binh Duong,Thuan An,20,46,17,29,18
2022-03-13,Binh Duong,Thuan An,21,16,5,11,7
2022-03-13,Can Tho City,Binh Thuy District,7,4,3,1,0
2022-03-13,Can Tho City,Binh Thuy District,8,5,5,0,0
2022-03-13,Can Tho City,Binh Thuy District,9,7,6,1,1
2022-03-13,Can Tho City,Binh Thuy District,10,13,11,2,0
2022-03-13,Can Tho City,Binh Thuy District,11,14,13,1,0
2022-03-13,Can Tho City,Binh Thuy District,12,11,10,1,0
2022-03-13,Can Tho City,Binh Thuy District,13,12,10,2,0
2022-03-13,Can Tho City,Binh Thuy District,14,10,9,1,0
2022-03-13,Can Tho City,Binh Thuy District,15,9,9,0,0
2022-03-13,Can Tho City,Binh Thuy District,16,14,13,1,0
2022-03-13,Can Tho City,Binh Thuy District,17,21,18,3,1
2022-03-13,Can Tho City,Binh Thuy District,18,17,15,2,0
2022-03-13,Can Tho City,Binh Thuy District,19,15,13,2,1
2022-03-13,Can Tho City,Binh Thuy District,20,7,5,2,0
2022-03-13,Can Tho City,Binh Thuy District,21,1,1,0,0
2022-03-13,Can Tho City,Cai Rang District,7,4,3,1,1
2022-03-13,Can Tho City,Cai Rang District,8,7,3,4,2
2022-03-13,Can Tho City,Cai Rang District,9,6,6,0,0
2022-03-13,Can Tho City,Cai Rang District,10,9,8,1,1
2022-03-13,Can Tho City,Cai Rang District,11,15,12,3,0
2022-03-13,Can Tho City,Cai Rang District,12,10,8,2,0
2022-03-13,Can Tho City,Cai Rang District,13,11,10,1,0
2022-03-13,Can Tho City,Cai Rang District,14,7,7,0,0
2022-03-13,Can Tho City,Cai Rang District,15,10,8,2,0
2022-03-13,Can Tho City,Cai Rang District,16,22,19,3,1
2022-03-13,Can Tho City,Cai Rang District,17,13,9,4,0
2022-03-13,Can Tho City,Cai Rang District,18,15,14,1,1
2022-03-13,Can Tho City,Cai Rang District,19,13,9,4,0
2022-03-13,Can Tho City,Cai Rang District,20,8,7,1,0
2022-03-13,Can Tho City,Cai Rang District,21,1,0,1,1
2022-03-13,Can Tho City,Cai Rang District,22,1,1,0,0
2022-03-13,Can Tho City,Ninh Kieu District,0,5,1,4,0
2022-03-13,Can Tho City,Ninh Kieu District,1,4,3,1,0
2022-03-13,Can Tho City,Ninh Kieu District,2,3,2,1,0
2022-03-13,Can Tho City,Ninh Kieu District,6,43,38,5,0
2022-03-13,Can Tho City,Ninh Kieu District,7,147,130,17,9
2022-03-13,Can Tho City,Ninh Kieu District,8,276,238,38,13
2022-03-13,Can Tho City,Ninh Kieu District,9,330,302,28,2
2022-03-13,Can Tho City,Ninh Kieu District,10,624,590,34,3
2022-03-13,Can Tho City,Ninh Kieu District,11,699,658,41,6
2022-03-13,Can Tho City,Ninh Kieu District,12,594,566,28,1
2022-03-13,Can Tho City,Ninh Kieu District,13,422,394,28,0
2022-03-13,Can Tho City,Ninh Kieu District,14,403,383,20,0
2022-03-13,Can Tho City,Ninh Kieu District,15,400,371,29,0
2022-03-13,Can Tho City,Ninh Kieu District,16,510,467,43,5
2022-03-13,Can Tho City,Ninh Kieu District,17,523,501,22,2
2022-03-13,Can Tho City,Ninh Kieu District,18,566,529,37,1
2022-03-13,Can Tho City,Ninh Kieu District,19,488,460,28,1
2022-03-13,Can Tho City,Ninh Kieu District,20,356,321,35,3
2022-03-13,Can Tho City,Ninh Kieu District,21,200,168,32,2
2022-03-13,Can Tho City,Ninh Kieu District,22,1,0,1,0
2022-03-13,Can Tho City,Ninh Kieu District,23,2,1,1,0
2022-03-13,Dong Nai,Bien Hoa City,0,2,0,2,2
2022-03-13,Dong Nai,Bien Hoa City,1,1,0,1,0
2022-03-13,Dong Nai,Bien Hoa City,3,3,2,1,1
2022-03-13,Dong Nai,Bien Hoa City,4,1,1,0,0
2022-03-13,Dong Nai,Bien Hoa City,5,1,1,0,0
2022-03-13,Dong Nai,Bien Hoa City,6,44,22,22,18
2022-03-13,Dong Nai,Bien Hoa City,7,229,117,112,93
2022-03-13,Dong Nai,Bien Hoa City,8,335,236,99,63
2022-03-13,Dong Nai,Bien Hoa City,9,525,419,106,54
2022-03-13,Dong Nai,Bien Hoa City,10,874,679,195,133
2022-03-13,Dong Nai,Bien Hoa City,11,1194,924,270,170
2022-03-13,Dong Nai,Bien Hoa City,12,967,839,128,49
2022-03-13,Dong Nai,Bien Hoa City,13,683,609,74,18
2022-03-13,Dong Nai,Bien Hoa City,14,705,572,133,70
2022-03-13,Dong Nai,Bien Hoa City,15,630,530,100,54
2022-03-13,Dong Nai,Bien Hoa City,16,593,502,91,41
2022-03-13,Dong Nai,Bien Hoa City,17,675,558,117,41
2022-03-13,Dong Nai,Bien Hoa City,18,842,611,231,145
2022-03-13,Dong Nai,Bien Hoa City,19,944,576,368,261
2022-03-13,Dong Nai,Bien Hoa City,20,552,358,194,104
2022-03-13,Dong Nai,Bien Hoa City,21,235,123,112,66
2022-03-13,Dong Nai,Bien Hoa City,22,2,2,0,0
2022-03-13,Dong Nai,Bien Hoa City,23,1,0,1,1
2022-03-13,Dong Nai,Long Thanh,10,3,0,3,3
2022-03-13,Dong Nai,Long Thanh,11,4,0,4,4
2022-03-13,Dong Nai,Long Thanh,12,2,0,2,2
2022-03-13,Dong Nai,Long Thanh,13,1,0,1,1
2022-03-13,Dong Nai,Long Thanh,15,1,0,1,1
2022-03-13,Dong Nai,Long Thanh,16,1,0,1,1
2022-03-13,Dong Nai,Long Thanh,17,2,0,2,2
2022-03-13,Dong Nai,Long Thanh,18,1,0,1,1
2022-03-13,Dong Nai,Long Thanh,19,2,0,2,2
2022-03-13,Dong Nai,Nhon trach,10,2,0,2,2
2022-03-13,Dong Nai,Thong Nhat,9,1,1,0,0
2022-03-13,Dong Nai,Thong Nhat,10,1,1,0,0
2022-03-13,Dong Nai,Thong Nhat,11,2,2,0,0
2022-03-13,Dong Nai,Thong Nhat,13,2,2,0,0
2022-03-13,Dong Nai,Thong Nhat,14,2,2,0,0
2022-03-13,Dong Nai,Thong Nhat,15,4,4,0,0
2022-03-13,Dong Nai,Thong Nhat,16,1,1,0,0
2022-03-13,Dong Nai,Thong Nhat,20,4,3,1,1
2022-03-13,Dong Nai,Trang Bom,10,1,1,0,0
2022-03-13,Dong Nai,Trang Bom,14,2,1,1,1
2022-03-13,Hai Phong City,An Duong,0,1,0,1,1
2022-03-13,Hai Phong City,An Duong,4,1,0,1,1
2022-03-13,Hai Phong City,An Duong,6,1,0,1,1
2022-03-13,Hai Phong City,An Duong,7,2,1,1,1
2022-03-13,Hai Phong City,An Duong,8,1,1,0,0
2022-03-13,Hai Phong City,An Duong,9,1,1,0,0
2022-03-13,Hai Phong City,An Duong,10,4,1,3,3
2022-03-13,Hai Phong City,An Duong,11,3,0,3,2
2022-03-13,Hai Phong City,An Duong,12,2,1,1,1
2022-03-13,Hai Phong City,An Duong,14,2,1,1,1
2022-03-13,Hai Phong City,An Duong,15,1,1,0,0
2022-03-13,Hai Phong City,An Duong,16,2,2,0,0
2022-03-13,Hai Phong City,An Duong,17,4,2,2,1
2022-03-13,Hai Phong City,An Duong,18,1,0,1,0
2022-03-13,Hai Phong City,An Duong,20,1,0,1,1
2022-03-13,Hai Phong City,An Duong,21,1,0,1,1
2022-03-13,Hai Phong City,Duong Kinh District,13,1,0,1,1
2022-03-13,Hai Phong City,Hai An District,7,4,3,1,0
2022-03-13,Hai Phong City,Hai An District,8,9,6,3,0
2022-03-13,Hai Phong City,Hai An District,9,10,7,3,0
2022-03-13,Hai Phong City,Hai An District,10,24,19,5,2
2022-03-13,Hai Phong City,Hai An District,11,49,33,16,9
2022-03-13,Hai Phong City,Hai An District,12,31,26,5,5
2022-03-13,Hai Phong City,Hai An District,13,16,14,2,0
2022-03-13,Hai Phong City,Hai An District,14,18,7,11,6
2022-03-13,Hai Phong City,Hai An District,15,19,16,3,0
2022-03-13,Hai Phong City,Hai An District,16,25,19,6,2
2022-03-13,Hai Phong City,Hai An District,17,26,21,5,1
2022-03-13,Hai Phong City,Hai An District,18,25,16,9,6
2022-03-13,Hai Phong City,Hai An District,19,11,9,2,1
2022-03-13,Hai Phong City,Hai An District,20,19,16,3,3
2022-03-13,Hai Phong City,Hai An District,21,14,8,6,5
2022-03-13,Hai Phong City,Hong Bang District,4,1,0,1,1
2022-03-13,Hai Phong City,Hong Bang District,7,7,1,6,5
2022-03-13,Hai Phong City,Hong Bang District,8,16,12,4,2
2022-03-13,Hai Phong City,Hong Bang District,9,31,23,8,1
2022-03-13,Hai Phong City,Hong Bang District,10,50,39,11,8
2022-03-13,Hai Phong City,Hong Bang District,11,113,74,39,32
2022-03-13,Hai Phong City,Hong Bang District,12,75,59,16,15
2022-03-13,Hai Phong City,Hong Bang District,13,34,32,2,0
2022-03-13,Hai Phong City,Hong Bang District,14,35,27,8,5
2022-03-13,Hai Phong City,Hong Bang District,15,37,26,11,6
2022-03-13,Hai Phong City,Hong Bang District,16,34,23,11,11
2022-03-13,Hai Phong City,Hong Bang District,17,54,39,15,9
2022-03-13,Hai Phong City,Hong Bang District,18,59,43,16,9
2022-03-13,Hai Phong City,Hong Bang District,19,49,41,8,5
2022-03-13,Hai Phong City,Hong Bang District,20,33,27,6,3
2022-03-13,Hai Phong City,Hong Bang District,21,14,9,5,3
2022-03-13,Hai Phong City,Kien An District,7,2,2,0,0
2022-03-13,Hai Phong City,Kien An District,8,5,3,2,0
2022-03-13,Hai Phong City,Kien An District,9,1,1,0,0
2022-03-13,Hai Phong City,Kien An District,10,10,4,6,6
2022-03-13,Hai Phong City,Kien An District,11,18,10,8,6
2022-03-13,Hai Phong City,Kien An District,12,13,6,7,6
2022-03-13,Hai Phong City,Kien An District,13,6,5,1,0
2022-03-13,Hai Phong City,Kien An District,14,10,5,5,4
2022-03-13,Hai Phong City,Kien An District,15,6,4,2,1
2022-03-13,Hai Phong City,Kien An District,16,11,8,3,2
2022-03-13,Hai Phong City,Kien An District,17,11,10,1,1
2022-03-13,Hai Phong City,Kien An District,18,22,16,6,3
2022-03-13,Hai Phong City,Kien An District,19,3,3,0,0
2022-03-13,Hai Phong City,Kien An District,20,5,4,1,0
2022-03-13,Hai Phong City,Kien An District,21,2,1,1,1
2022-03-13,Hai Phong City,Le Chan District,0,1,0,1,0
2022-03-13,Hai Phong City,Le Chan District,1,1,1,0,0
2022-03-13,Hai Phong City,Le Chan District,2,2,1,1,1
2022-03-13,Hai Phong City,Le Chan District,5,1,0,1,1
2022-03-13,Hai Phong City,Le Chan District,6,4,1,3,2
2022-03-13,Hai Phong City,Le Chan District,7,54,31,23,19
2022-03-13,Hai Phong City,Le Chan District,8,69,54,15,3
2022-03-13,Hai Phong City,Le Chan District,9,119,92,27,5
2022-03-13,Hai Phong City,Le Chan District,10,202,159,43,17
2022-03-13,Hai Phong City,Le Chan District,11,323,232,91,64
2022-03-13,Hai Phong City,Le Chan District,12,217,154,63,43
2022-03-13,Hai Phong City,Le Chan District,13,144,126,18,5
2022-03-13,Hai Phong City,Le Chan District,14,122,111,11,5
2022-03-13,Hai Phong City,Le Chan District,15,187,148,39,20
2022-03-13,Hai Phong City,Le Chan District,16,192,153,39,19
2022-03-13,Hai Phong City,Le Chan District,17,226,179,47,22
2022-03-13,Hai Phong City,Le Chan District,18,262,191,71,34
2022-03-13,Hai Phong City,Le Chan District,19,163,126,37,14
2022-03-13,Hai Phong City,Le Chan District,20,123,99,24,7
2022-03-13,Hai Phong City,Le Chan District,21,59,41,18,7
2022-03-13,Hai Phong City,Ngo Quyen District,1,1,0,1,1
2022-03-13,Hai Phong City,Ngo Quyen District,2,1,0,1,1
2022-03-13,Hai Phong City,Ngo Quyen District,3,2,0,2,0
2022-03-13,Hai Phong City,Ngo Quyen District,4,2,1,1,1
2022-03-13,Hai Phong City,Ngo Quyen District,6,3,3,0,0
2022-03-13,Hai Phong City,Ngo Quyen District,7,27,19,8,7
2022-03-13,Hai Phong City,Ngo Quyen District,8,59,46,13,6
2022-03-13,Hai Phong City,Ngo Quyen District,9,107,89,18,8
2022-03-13,Hai Phong City,Ngo Quyen District,10,182,159,23,11
2022-03-13,Hai Phong City,Ngo Quyen District,11,261,193,68,43
2022-03-13,Hai Phong City,Ngo Quyen District,12,217,185,32,15
2022-03-13,Hai Phong City,Ngo Quyen District,13,125,101,24,4
2022-03-13,Hai Phong City,Ngo Quyen District,14,115,104,11,3
2022-03-13,Hai Phong City,Ngo Quyen District,15,133,117,16,10
2022-03-13,Hai Phong City,Ngo Quyen District,16,166,137,29,17
2022-03-13,Hai Phong City,Ngo Quyen District,17,172,139,33,13
2022-03-13,Hai Phong City,Ngo Quyen District,18,202,168,34,10
2022-03-13,Hai Phong City,Ngo Quyen District,19,164,136,28,12
2022-03-13,Hai Phong City,Ngo Quyen District,20,115,94,21,8
2022-03-13,Hai Phong City,Ngo Quyen District,21,68,44,24,7
2022-03-13,Hai Phong City,Ngo Quyen District,22,1,0,1,0
2022-03-13,Hai Phong City,Thuy Nguyen,9,2,0,2,2
2022-03-13,Hai Phong City,Thuy Nguyen,10,2,1,1,1
2022-03-13,Hai Phong City,Thuy Nguyen,11,5,1,4,4
2022-03-13,Hai Phong City,Thuy Nguyen,12,3,0,3,3
2022-03-13,Hai Phong City,Thuy Nguyen,17,4,0,4,4
2022-03-13,Hai Phong City,Thuy Nguyen,18,1,0,1,1
2022-03-13,Hai Phong City,Thuy Nguyen,21,1,0,1,1
2022-03-13,Hue City,Hue City,0,4,4,0,0
2022-03-13,Hue City,Hue City,1,6,6,0,0
2022-03-13,Hue City,Hue City,5,3,2,1,0
2022-03-13,Hue City,Hue City,6,66,58,8,0
2022-03-13,Hue City,Hue City,7,203,183,20,3
2022-03-13,Hue City,Hue City,8,358,330,28,0
2022-03-13,Hue City,Hue City,9,319,296,23,0
2022-03-13,Hue City,Hue City,10,440,410,30,0
2022-03-13,Hue City,Hue City,11,746,692,54,0
2022-03-13,Hue City,Hue City,12,509,484,25,0
2022-03-13,Hue City,Hue City,13,333,307,26,0
2022-03-13,Hue City,Hue City,14,287,271,16,1
2022-03-13,Hue City,Hue City,15,383,368,15,0
2022-03-13,Hue City,Hue City,16,443,419,24,1
2022-03-13,Hue City,Hue City,17,513,487,26,1
2022-03-13,Hue City,Hue City,18,638,596,42,2
2022-03-13,Hue City,Hue City,19,500,458,42,2
2022-03-13,Hue City,Hue City,20,429,364,65,7
2022-03-13,Hue City,Hue City,21,233,189,44,10
2022-03-13,Hue City,Hue City,22,4,2,2,0
2022-03-13,Hue City,Hue City,23,7,6,1,0
2022-03-13,Hue City,Huong Thuy,15,1,1,0,0
2022-03-13,Hue City,Huong Thuy,17,1,1,0,0
2022-03-13,Hue City,Huong Thuy,18,1,0,1,0
2022-03-13,Hue City,Huong Thuy,19,2,2,0,0
2022-03-13,Hue City,Huong Tra,16,2,0,2,1
2022-03-13,Hue City,Huong Tra,21,2,0,2,0
2022-03-13,Hue City,Phu Vang,7,1,1,0,0
2022-03-13,Hue City,Phu Vang,8,3,2,1,0
2022-03-13,Hue City,Phu Vang,10,4,1,3,2
2022-03-13,Hue City,Phu Vang,11,4,3,1,1
2022-03-13,Hue City,Phu Vang,12,2,2,0,0
2022-03-13,Hue City,Phu Vang,13,2,2,0,0
2022-03-13,Hue City,Phu Vang,14,2,1,1,0
2022-03-13,Hue City,Phu Vang,15,1,1,0,0
2022-03-13,Hue City,Phu Vang,16,2,2,0,0
2022-03-13,Hue City,Phu Vang,17,2,2,0,0
2022-03-13,Hue City,Phu Vang,18,2,2,0,0
2022-03-13,Hue City,Phu Vang,19,6,4,2,1
2022-03-13,Hue City,Phu Vang,21,1,1,0,0
2022-03-13,Vung Tau,Ba Ria City,8,4,0,4,4
2022-03-13,Vung Tau,Ba Ria City,9,11,3,8,7
2022-03-13,Vung Tau,Ba Ria City,10,11,5,6,5
2022-03-13,Vung Tau,Ba Ria City,11,18,7,11,10
2022-03-13,Vung Tau,Ba Ria City,12,14,5,9,8
2022-03-13,Vung Tau,Ba Ria City,13,7,4,3,3
2022-03-13,Vung Tau,Ba Ria City,14,6,3,3,3
2022-03-13,Vung Tau,Ba Ria City,15,5,0,5,5
2022-03-13,Vung Tau,Ba Ria City,16,8,0,8,8
2022-03-13,Vung Tau,Ba Ria City,17,10,0,10,10
2022-03-13,Vung Tau,Ba Ria City,18,11,1,10,10
2022-03-13,Vung Tau,Ba Ria City,19,12,0,12,9
2022-03-13,Vung Tau,Ba Ria City,20,7,0,7,6
2022-03-13,Vung Tau,Ba Ria City,21,2,0,2,1
2022-03-13,Vung Tau,Vung Tau City,0,1,0,1,0
2022-03-13,Vung Tau,Vung Tau City,2,1,1,0,0
2022-03-13,Vung Tau,Vung Tau City,3,1,1,0,0
2022-03-13,Vung Tau,Vung Tau City,6,34,29,5,3
2022-03-13,Vung Tau,Vung Tau City,7,134,118,16,6
2022-03-13,Vung Tau,Vung Tau City,8,233,195,38,24
2022-03-13,Vung Tau,Vung Tau City,9,238,210,28,10
2022-03-13,Vung Tau,Vung Tau City,10,265,246,19,5
2022-03-13,Vung Tau,Vung Tau City,11,366,337,29,6
2022-03-13,Vung Tau,Vung Tau City,12,303,282,21,5
2022-03-13,Vung Tau,Vung Tau City,13,223,203,20,2
2022-03-13,Vung Tau,Vung Tau City,14,219,206,13,3
2022-03-13,Vung Tau,Vung Tau City,15,200,184,16,1
2022-03-13,Vung Tau,Vung Tau City,16,263,230,33,8
2022-03-13,Vung Tau,Vung Tau City,17,332,294,38,16
2022-03-13,Vung Tau,Vung Tau City,18,391,294,97,64
2022-03-13,Vung Tau,Vung Tau City,19,310,245,65,34
2022-03-13,Vung Tau,Vung Tau City,20,195,159,36,8
2022-03-13,Vung Tau,Vung Tau City,21,88,67,21,8
2022-03-13,Vung Tau,Vung Tau City,22,2,1,1,1
2022-03-13,Vung Tau,Vung Tau City,23,1,1,0,0
2022-03-14,Binh Duong,Ben Cat,11,1,0,1,1
2022-03-14,Binh Duong,Ben Cat,12,2,1,1,1
2022-03-14,Binh Duong,Ben Cat,15,1,0,1,1
2022-03-14,Binh Duong,Ben Cat,18,4,0,4,4
2022-03-14,Binh Duong,Ben Cat,19,3,0,3,1
2022-03-14,Binh Duong,Di An,7,3,0,3,3
2022-03-14,Binh Duong,Di An,8,13,2,11,10
2022-03-14,Binh Duong,Di An,9,19,0,19,18
2022-03-14,Binh Duong,Di An,10,20,5,15,14
2022-03-14,Binh Duong,Di An,11,31,9,22,15
2022-03-14,Binh Duong,Di An,12,36,14,22,21
2022-03-14,Binh Duong,Di An,13,20,7,13,11
2022-03-14,Binh Duong,Di An,14,21,8,13,12
2022-03-14,Binh Duong,Di An,15,23,3,20,18
2022-03-14,Binh Duong,Di An,16,26,5,21,19
2022-03-14,Binh Duong,Di An,17,25,2,23,22
2022-03-14,Binh Duong,Di An,18,19,8,11,8
2022-03-14,Binh Duong,Di An,19,19,4,15,12
2022-03-14,Binh Duong,Di An,20,14,5,9,9
2022-03-14,Binh Duong,Di An,21,10,0,10,10
2022-03-14,Binh Duong,Tan Uyen,7,1,0,1,1
2022-03-14,Binh Duong,Tan Uyen,9,2,0,2,2
2022-03-14,Binh Duong,Tan Uyen,10,1,0,1,1
2022-03-14,Binh Duong,Tan Uyen,11,3,1,2,1
2022-03-14,Binh Duong,Tan Uyen,12,1,1,0,0
2022-03-14,Binh Duong,Tan Uyen,13,1,0,1,1
2022-03-14,Binh Duong,Tan Uyen,14,1,0,1,1
2022-03-14,Binh Duong,Tan Uyen,15,1,1,0,0
2022-03-14,Binh Duong,Tan Uyen,20,1,0,1,0
2022-03-14,Binh Duong,Tan Uyen,21,2,0,2,2
2022-03-14,Binh Duong,Thu Dau Mot Town,0,1,0,1,0
2022-03-14,Binh Duong,Thu Dau Mot Town,5,2,1,1,0
2022-03-14,Binh Duong,Thu Dau Mot Town,6,38,21,17,14
2022-03-14,Binh Duong,Thu Dau Mot Town,7,108,91,17,6
2022-03-14,Binh Duong,Thu Dau Mot Town,8,203,181,22,6
2022-03-14,Binh Duong,Thu Dau Mot Town,9,253,234,19,1
2022-03-14,Binh Duong,Thu Dau Mot Town,10,363,336,27,3
2022-03-14,Binh Duong,Thu Dau Mot Town,11,612,560,52,16
2022-03-14,Binh Duong,Thu Dau Mot Town,12,392,357,35,9
2022-03-14,Binh Duong,Thu Dau Mot Town,13,363,330,33,7
2022-03-14,Binh Duong,Thu Dau Mot Town,14,286,260,26,12
2022-03-14,Binh Duong,Thu Dau Mot Town,15,282,261,21,4
2022-03-14,Binh Duong,Thu Dau Mot Town,16,273,260,13,5
2022-03-14,Binh Duong,Thu Dau Mot Town,17,357,331,26,6
2022-03-14,Binh Duong,Thu Dau Mot Town,18,362,326,36,5
2022-03-14,Binh Duong,Thu Dau Mot Town,19,304,282,22,4
2022-03-14,Binh Duong,Thu Dau Mot Town,20,196,180,16,3
2022-03-14,Binh Duong,Thu Dau Mot Town,21,88,75,13,3
2022-03-14,Binh Duong,Thu Dau Mot Town,22,1,1,0,0
2022-03-14,Binh Duong,Thu Dau Mot Town,23,1,1,0,0
2022-03-14,Binh Duong,Thuan An,6,2,0,2,1
2022-03-14,Binh Duong,Thuan An,7,4,1,3,2
2022-03-14,Binh Duong,Thuan An,8,22,7,15,12
2022-03-14,Binh Duong,Thuan An,9,52,15,37,31
2022-03-14,Binh Duong,Thuan An,10,62,35,27,21
2022-03-14,Binh Duong,Thuan An,11,84,35,49,38
2022-03-14,Binh Duong,Thuan An,12,77,35,42,36
2022-03-14,Binh Duong,Thuan An,13,78,32,46,43
2022-03-14,Binh Duong,Thuan An,14,44,23,21,19
2022-03-14,Binh Duong,Thuan An,15,26,5,21,19
2022-03-14,Binh Duong,Thuan An,16,59,24,35,30
2022-03-14,Binh Duong,Thuan An,17,46,23,23,16
2022-03-14,Binh Duong,Thuan An,18,33,21,12,11
2022-03-14,Binh Duong,Thuan An,19,35,21,14,11
2022-03-14,Binh Duong,Thuan An,20,26,8,18,16
2022-03-14,Binh Duong,Thuan An,21,18,5,13,12
2022-03-14,Binh Duong,Thuan An,22,1,0,1,0
2022-03-14,Can Tho City,Binh Thuy District,7,1,1,0,0
2022-03-14,Can Tho City,Binh Thuy District,8,1,1,0,0
2022-03-14,Can Tho City,Binh Thuy District,9,6,5,1,0
2022-03-14,Can Tho City,Binh Thuy District,10,7,7,0,0
2022-03-14,Can Tho City,Binh Thuy District,11,5,5,0,0
2022-03-14,Can Tho City,Binh Thuy District,12,6,6,0,0
2022-03-14,Can Tho City,Binh Thuy District,13,13,11,2,0
2022-03-14,Can Tho City,Binh Thuy District,14,16,13,3,2
2022-03-14,Can Tho City,Binh Thuy District,15,16,13,3,2
2022-03-14,Can Tho City,Binh Thuy District,16,13,12,1,1
2022-03-14,Can Tho City,Binh Thuy District,17,14,12,2,2
2022-03-14,Can Tho City,Binh Thuy District,18,10,10,0,0
2022-03-14,Can Tho City,Binh Thuy District,19,18,16,2,0
2022-03-14,Can Tho City,Binh Thuy District,20,13,12,1,0
2022-03-14,Can Tho City,Binh Thuy District,21,2,1,1,1
2022-03-14,Can Tho City,Cai Rang District,6,1,1,0,0
2022-03-14,Can Tho City,Cai Rang District,7,2,2,0,0
2022-03-14,Can Tho City,Cai Rang District,8,4,4,0,0
2022-03-14,Can Tho City,Cai Rang District,9,4,2,2,0
2022-03-14,Can Tho City,Cai Rang District,10,7,7,0,0
2022-03-14,Can Tho City,Cai Rang District,11,11,11,0,0
2022-03-14,Can Tho City,Cai Rang District,12,12,10,2,0
2022-03-14,Can Tho City,Cai Rang District,13,13,13,0,0
2022-03-14,Can Tho City,Cai Rang District,14,5,4,1,0
2022-03-14,Can Tho City,Cai Rang District,15,10,8,2,1
2022-03-14,Can Tho City,Cai Rang District,16,9,8,1,1
2022-03-14,Can Tho City,Cai Rang District,17,9,7,2,1
2022-03-14,Can Tho City,Cai Rang District,18,4,4,0,0
2022-03-14,Can Tho City,Cai Rang District,19,3,3,0,0
2022-03-14,Can Tho City,Cai Rang District,20,9,8,1,1
2022-03-14,Can Tho City,Cai Rang District,21,3,3,0,0
2022-03-14,Can Tho City,Cai Rang District,23,2,1,1,0
2022-03-14,Can Tho City,Ninh Kieu District,0,2,0,2,0
2022-03-14,Can Tho City,Ninh Kieu District,1,3,3,0,0
2022-03-14,Can Tho City,Ninh Kieu District,2,1,1,0,0
2022-03-14,Can Tho City,Ninh Kieu District,5,4,3,1,1
2022-03-14,Can Tho City,Ninh Kieu District,6,48,43,5,4
2022-03-14,Can Tho City,Ninh Kieu District,7,139,132,7,0
2022-03-14,Can Tho City,Ninh Kieu District,8,215,200,15,0
2022-03-14,Can Tho City,Ninh Kieu District,9,258,242,16,0
2022-03-14,Can Tho City,Ninh Kieu District,10,573,536,37,1
2022-03-14,Can Tho City,Ninh Kieu District,11,844,784,60,9
2022-03-14,Can Tho City,Ninh Kieu District,12,602,571,31,0
2022-03-14,Can Tho City,Ninh Kieu District,13,471,452,19,0
2022-03-14,Can Tho City,Ninh Kieu District,14,364,352,12,1
2022-03-14,Can Tho City,Ninh Kieu District,15,344,333,11,0
2022-03-14,Can Tho City,Ninh Kieu District,16,436,411,25,1
2022-03-14,Can Tho City,Ninh Kieu District,17,520,499,21,1
2022-03-14,Can Tho City,Ninh Kieu District,18,519,492,27,0
2022-03-14,Can Tho City,Ninh Kieu District,19,471,445,26,0
2022-03-14,Can Tho City,Ninh Kieu District,20,331,312,19,0
2022-03-14,Can Tho City,Ninh Kieu District,21,151,133,18,0
2022-03-14,Can Tho City,Ninh Kieu District,22,5,4,1,0
2022-03-14,Can Tho City,Ninh Kieu District,23,3,3,0,0
2022-03-14,Dong Nai,Bien Hoa City,0,1,1,0,0
2022-03-14,Dong Nai,Bien Hoa City,1,1,1,0,0
2022-03-14,Dong Nai,Bien Hoa City,2,4,2,2,0
2022-03-14,Dong Nai,Bien Hoa City,4,3,2,1,1
2022-03-14,Dong Nai,Bien Hoa City,5,1,1,0,0
2022-03-14,Dong Nai,Bien Hoa City,6,35,22,13,9
2022-03-14,Dong Nai,Bien Hoa City,7,170,115,55,33
2022-03-14,Dong Nai,Bien Hoa City,8,290,237,53,31
2022-03-14,Dong Nai,Bien Hoa City,9,388,337,51,20
2022-03-14,Dong Nai,Bien Hoa City,10,740,624,116,59
2022-03-14,Dong Nai,Bien Hoa City,11,964,858,106,31
2022-03-14,Dong Nai,Bien Hoa City,12,798,735,63,23
2022-03-14,Dong Nai,Bien Hoa City,13,776,665,111,59
2022-03-14,Dong Nai,Bien Hoa City,14,550,484,66,24
2022-03-14,Dong Nai,Bien Hoa City,15,480,420,60,17
2022-03-14,Dong Nai,Bien Hoa City,16,541,429,112,57
2022-03-14,Dong Nai,Bien Hoa City,17,637,517,120,63
2022-03-14,Dong Nai,Bien Hoa City,18,691,604,87,32
2022-03-14,Dong Nai,Bien Hoa City,19,616,524,92,49
2022-03-14,Dong Nai,Bien Hoa City,20,465,352,113,51
2022-03-14,Dong Nai,Bien Hoa City,21,192,111,81,59
2022-03-14,Dong Nai,Bien Hoa City,22,6,3,3,0
2022-03-14,Dong Nai,Bien Hoa City,23,4,1,3,0
2022-03-14,Dong Nai,Long Thanh,11,1,0,1,1
2022-03-14,Dong Nai,Long Thanh,12,2,0,2,2
2022-03-14,Dong Nai,Long Thanh,13,5,0,5,5
2022-03-14,Dong Nai,Long Thanh,14,1,0,1,1
2022-03-14,Dong Nai,Long Thanh,17,3,0,3,3
2022-03-14,Dong Nai,Long Thanh,18,4,0,4,4
2022-03-14,Dong Nai,Nhon trach,12,2,0,2,2
2022-03-14,Dong Nai,Nhon trach,17,1,0,1,1
2022-03-14,Dong Nai,Thong Nhat,8,1,1,0,0
2022-03-14,Dong Nai,Thong Nhat,9,1,1,0,0
2022-03-14,Dong Nai,Thong Nhat,10,1,1,0,0
2022-03-14,Dong Nai,Thong Nhat,11,5,3,2,0
2022-03-14,Dong Nai,Thong Nhat,12,1,1,0,0
2022-03-14,Dong Nai,Thong Nhat,13,1,1,0,0
2022-03-14,Dong Nai,Thong Nhat,15,1,1,0,0
2022-03-14,Dong Nai,Thong Nhat,16,2,2,0,0
2022-03-14,Dong Nai,Thong Nhat,17,1,1,0,0
2022-03-14,Dong Nai,Thong Nhat,18,1,1,0,0
2022-03-14,Dong Nai,Thong Nhat,19,2,2,0,0
2022-03-14,Dong Nai,Thong Nhat,20,1,0,1,1
2022-03-14,Dong Nai,Trang Bom,11,1,0,1,1
2022-03-14,Dong Nai,Trang Bom,12,1,1,0,0
2022-03-14,Dong Nai,Trang Bom,14,1,0,1,1
2022-03-14,Dong Nai,Trang Bom,17,1,0,1,1
2022-03-14,Dong Nai,Trang Bom,18,1,0,1,1
2022-03-14,Hai Phong City,An Duong,7,2,2,0,0
2022-03-14,Hai Phong City,An Duong,8,2,1,1,1
2022-03-14,Hai Phong City,An Duong,10,2,0,2,1
2022-03-14,Hai Phong City,An Duong,11,5,3,2,2
2022-03-14,Hai Phong City,An Duong,12,1,0,1,1
2022-03-14,Hai Phong City,An Duong,13,4,2,2,0
2022-03-14,Hai Phong City,An Duong,14,4,3,1,0
2022-03-14,Hai Phong City,An Duong,15,4,2,2,1
2022-03-14,Hai Phong City,An Duong,16,2,1,1,1
2022-03-14,Hai Phong City,An Duong,17,5,4,1,1
2022-03-14,Hai Phong City,An Duong,18,1,1,0,0
2022-03-14,Hai Phong City,An Duong,19,1,1,0,0
2022-03-14,Hai Phong City,An Duong,23,1,1,0,0
2022-03-14,Hai Phong City,Duong Kinh District,11,1,0,1,1
2022-03-14,Hai Phong City,Hai An District,7,3,1,2,1
2022-03-14,Hai Phong City,Hai An District,8,9,8,1,0
2022-03-14,Hai Phong City,Hai An District,9,14,11,3,0
2022-03-14,Hai Phong City,Hai An District,10,22,18,4,0
2022-03-14,Hai Phong City,Hai An District,11,48,42,6,0
2022-03-14,Hai Phong City,Hai An District,12,7,7,0,0
2022-03-14,Hai Phong City,Hai An District,13,10,9,1,1
2022-03-14,Hai Phong City,Hai An District,14,18,13,5,2
2022-03-14,Hai Phong City,Hai An District,15,16,12,4,1
2022-03-14,Hai Phong City,Hai An District,16,22,21,1,0
2022-03-14,Hai Phong City,Hai An District,17,17,16,1,0
2022-03-14,Hai Phong City,Hai An District,18,22,18,4,0
2022-03-14,Hai Phong City,Hai An District,19,15,13,2,0
2022-03-14,Hai Phong City,Hai An District,20,16,15,1,0
2022-03-14,Hai Phong City,Hai An District,21,12,8,4,2
2022-03-14,Hai Phong City,Hong Bang District,1,1,1,0,0
2022-03-14,Hai Phong City,Hong Bang District,2,1,1,0,0
2022-03-14,Hai Phong City,Hong Bang District,3,1,1,0,0
2022-03-14,Hai Phong City,Hong Bang District,6,1,1,0,0
2022-03-14,Hai Phong City,Hong Bang District,7,7,7,0,0
2022-03-14,Hai Phong City,Hong Bang District,8,27,24,3,1
2022-03-14,Hai Phong City,Hong Bang District,9,24,21,3,2
2022-03-14,Hai Phong City,Hong Bang District,10,49,47,2,1
2022-03-14,Hai Phong City,Hong Bang District,11,99,82,17,11
2022-03-14,Hai Phong City,Hong Bang District,12,51,49,2,0
2022-03-14,Hai Phong City,Hong Bang District,13,38,34,4,0
2022-03-14,Hai Phong City,Hong Bang District,14,36,34,2,0
2022-03-14,Hai Phong City,Hong Bang District,15,38,33,5,0
2022-03-14,Hai Phong City,Hong Bang District,16,30,22,8,2
2022-03-14,Hai Phong City,Hong Bang District,17,50,41,9,1
2022-03-14,Hai Phong City,Hong Bang District,18,54,48,6,0
2022-03-14,Hai Phong City,Hong Bang District,19,38,34,4,0
2022-03-14,Hai Phong City,Hong Bang District,20,36,25,11,3
2022-03-14,Hai Phong City,Hong Bang District,21,15,6,9,4
2022-03-14,Hai Phong City,Kien An District,7,1,0,1,0
2022-03-14,Hai Phong City,Kien An District,8,4,0,4,2
2022-03-14,Hai Phong City,Kien An District,9,8,3,5,4
2022-03-14,Hai Phong City,Kien An District,10,8,3,5,5
2022-03-14,Hai Phong City,Kien An District,11,21,12,9,5
2022-03-14,Hai Phong City,Kien An District,12,15,9,6,0
2022-03-14,Hai Phong City,Kien An District,13,4,3,1,1
2022-03-14,Hai Phong City,Kien An District,14,5,1,4,4
2022-03-14,Hai Phong City,Kien An District,15,12,7,5,5
2022-03-14,Hai Phong City,Kien An District,16,9,5,4,0
2022-03-14,Hai Phong City,Kien An District,17,15,13,2,0
2022-03-14,Hai Phong City,Kien An District,18,16,13,3,2
2022-03-14,Hai Phong City,Kien An District,19,8,5,3,1
2022-03-14,Hai Phong City,Kien An District,20,13,9,4,3
2022-03-14,Hai Phong City,Kien An District,21,6,2,4,2
2022-03-14,Hai Phong City,Le Chan District,0,2,2,0,0
2022-03-14,Hai Phong City,Le Chan District,1,1,0,1,0
2022-03-14,Hai Phong City,Le Chan District,2,1,1,0,0
2022-03-14,Hai Phong City,Le Chan District,3,2,1,1,0
2022-03-14,Hai Phong City,Le Chan District,6,2,0,2,1
2022-03-14,Hai Phong City,Le Chan District,7,24,22,2,0
2022-03-14,Hai Phong City,Le Chan District,8,50,43,7,0
2022-03-14,Hai Phong City,Le Chan District,9,72,63,9,2
2022-03-14,Hai Phong City,Le Chan District,10,131,120,11,0
2022-03-14,Hai Phong City,Le Chan District,11,283,232,51,25
2022-03-14,Hai Phong City,Le Chan District,12,172,151,21,1
2022-03-14,Hai Phong City,Le Chan District,13,87,80,7,1
2022-03-14,Hai Phong City,Le Chan District,14,113,106,7,1
2022-03-14,Hai Phong City,Le Chan District,15,137,120,17,0
2022-03-14,Hai Phong City,Le Chan District,16,131,116,15,1
2022-03-14,Hai Phong City,Le Chan District,17,171,156,15,2
2022-03-14,Hai Phong City,Le Chan District,18,195,178,17,1
2022-03-14,Hai Phong City,Le Chan District,19,153,130,23,4
2022-03-14,Hai Phong City,Le Chan District,20,109,100,9,1
2022-03-14,Hai Phong City,Le Chan District,21,58,40,18,5
2022-03-14,Hai Phong City,Le Chan District,23,1,0,1,0
2022-03-14,Hai Phong City,Ngo Quyen District,1,2,0,2,0
2022-03-14,Hai Phong City,Ngo Quyen District,3,1,0,1,0
2022-03-14,Hai Phong City,Ngo Quyen District,6,1,0,1,0
2022-03-14,Hai Phong City,Ngo Quyen District,7,20,17,3,1
2022-03-14,Hai Phong City,Ngo Quyen District,8,65,54,11,0
2022-03-14,Hai Phong City,Ngo Quyen District,9,82,72,10,2
2022-03-14,Hai Phong City,Ngo Quyen District,10,118,92,26,7
2022-03-14,Hai Phong City,Ngo Quyen District,11,205,178,27,11
2022-03-14,Hai Phong City,Ngo Quyen District,12,123,118,5,0
2022-03-14,Hai Phong City,Ngo Quyen District,13,98,90,8,0
2022-03-14,Hai Phong City,Ngo Quyen District,14,126,120,6,0
2022-03-14,Hai Phong City,Ngo Quyen District,15,144,128,16,0
2022-03-14,Hai Phong City,Ngo Quyen District,16,114,100,14,1
2022-03-14,Hai Phong City,Ngo Quyen District,17,138,123,15,0
2022-03-14,Hai Phong City,Ngo Quyen District,18,151,132,19,0
2022-03-14,Hai Phong City,Ngo Quyen District,19,151,139,12,1
2022-03-14,Hai Phong City,Ngo Quyen District,20,111,96,15,2
2022-03-14,Hai Phong City,Ngo Quyen District,21,58,40,18,10
2022-03-14,Hai Phong City,Thuy Nguyen,18,1,1,0,0
2022-03-14,Hai Phong City,Thuy Nguyen,19,1,1,0,0
2022-03-14,Hue City,Hue City,0,3,2,1,0
2022-03-14,Hue City,Hue City,1,1,0,1,0
2022-03-14,Hue City,Hue City,2,2,0,2,0
2022-03-14,Hue City,Hue City,5,2,2,0,0
2022-03-14,Hue City,Hue City,6,68,60,8,0
2022-03-14,Hue City,Hue City,7,178,173,5,0
2022-03-14,Hue City,Hue City,8,302,279,23,0
2022-03-14,Hue City,Hue City,9,211,199,12,1
2022-03-14,Hue City,Hue City,10,367,350,17,0
2022-03-14,Hue City,Hue City,11,758,706,52,2
2022-03-14,Hue City,Hue City,12,454,423,31,2
2022-03-14,Hue City,Hue City,13,303,289,14,0
2022-03-14,Hue City,Hue City,14,314,292,22,2
2022-03-14,Hue City,Hue City,15,325,305,20,1
2022-03-14,Hue City,Hue City,16,372,349,23,1
2022-03-14,Hue City,Hue City,17,485,447,38,1
2022-03-14,Hue City,Hue City,18,605,565,40,1
2022-03-14,Hue City,Hue City,19,539,496,43,2
2022-03-14,Hue City,Hue City,20,351,321,30,3
2022-03-14,Hue City,Hue City,21,218,194,24,2
2022-03-14,Hue City,Hue City,22,3,2,1,0
2022-03-14,Hue City,Hue City,23,1,1,0,0
2022-03-14,Hue City,Huong Thuy,11,1,1,0,0
2022-03-14,Hue City,Huong Thuy,12,1,1,0,0
2022-03-14,Hue City,Huong Thuy,14,3,0,3,2
2022-03-14,Hue City,Huong Thuy,16,1,1,0,0
2022-03-14,Hue City,Huong Thuy,17,3,0,3,2
2022-03-14,Hue City,Huong Thuy,18,3,3,0,0
2022-03-14,Hue City,Huong Thuy,19,1,0,1,0
2022-03-14,Hue City,Huong Thuy,20,6,1,5,0
2022-03-14,Hue City,Huong Thuy,21,1,1,0,0
2022-03-14,Hue City,Huong Tra,9,1,1,0,0
2022-03-14,Hue City,Huong Tra,10,1,1,0,0
2022-03-14,Hue City,Huong Tra,11,1,1,0,0
2022-03-14,Hue City,Huong Tra,15,1,1,0,0
2022-03-14,Hue City,Huong Tra,16,2,2,0,0
2022-03-14,Hue City,Phu Vang,6,1,1,0,0
2022-03-14,Hue City,Phu Vang,9,1,1,0,0
2022-03-14,Hue City,Phu Vang,10,4,2,2,0
2022-03-14,Hue City,Phu Vang,11,4,3,1,1
2022-03-14,Hue City,Phu Vang,12,3,3,0,0
2022-03-14,Hue City,Phu Vang,14,1,1,0,0
2022-03-14,Hue City,Phu Vang,15,3,3,0,0
2022-03-14,Hue City,Phu Vang,16,1,1,0,0
2022-03-14,Hue City,Phu Vang,17,4,3,1,0
2022-03-14,Hue City,Phu Vang,18,4,2,2,1
2022-03-14,Hue City,Phu Vang,19,2,2,0,0
2022-03-14,Vung Tau,Ba Ria City,8,3,0,3,3
2022-03-14,Vung Tau,Ba Ria City,9,7,1,6,6
2022-03-14,Vung Tau,Ba Ria City,10,11,3,8,5
2022-03-14,Vung Tau,Ba Ria City,11,5,1,4,2
2022-03-14,Vung Tau,Ba Ria City,12,2,2,0,0
2022-03-14,Vung Tau,Ba Ria City,13,9,5,4,3
2022-03-14,Vung Tau,Ba Ria City,14,6,5,1,1
2022-03-14,Vung Tau,Ba Ria City,15,8,5,3,1
2022-03-14,Vung Tau,Ba Ria City,16,6,2,4,4
2022-03-14,Vung Tau,Ba Ria City,17,10,5,5,4
2022-03-14,Vung Tau,Ba Ria City,18,4,1,3,1
2022-03-14,Vung Tau,Ba Ria City,19,6,2,4,3
2022-03-14,Vung Tau,Ba Ria City,20,9,0,9,1
2022-03-14,Vung Tau,Ba Ria City,21,2,0,2,2
2022-03-14,Vung Tau,Vung Tau City,4,1,1,0,0
2022-03-14,Vung Tau,Vung Tau City,6,49,37,12,9
2022-03-14,Vung Tau,Vung Tau City,7,117,109,8,1
2022-03-14,Vung Tau,Vung Tau City,8,164,154,10,0
2022-03-14,Vung Tau,Vung Tau City,9,141,133,8,1
2022-03-14,Vung Tau,Vung Tau City,10,179,158,21,8
2022-03-14,Vung Tau,Vung Tau City,11,417,365,52,29
2022-03-14,Vung Tau,Vung Tau City,12,260,242,18,2
2022-03-14,Vung Tau,Vung Tau City,13,202,185,17,3
2022-03-14,Vung Tau,Vung Tau City,14,221,205,16,2
2022-03-14,Vung Tau,Vung Tau City,15,218,200,18,0
2022-03-14,Vung Tau,Vung Tau City,16,199,185,14,0
2022-03-14,Vung Tau,Vung Tau City,17,291,262,29,1
2022-03-14,Vung Tau,Vung Tau City,18,281,261,20,1
2022-03-14,Vung Tau,Vung Tau City,19,250,231,19,1
2022-03-14,Vung Tau,Vung Tau City,20,181,155,26,8
2022-03-14,Vung Tau,Vung Tau City,21,82,64,18,4
2022-03-14,Vung Tau,Vung Tau City,22,2,0,2,0
2022-03-14,Vung Tau,Vung Tau City,23,1,1,0,0
2022-03-15,Binh Duong,Ben Cat,8,1,0,1,1
2022-03-15,Binh Duong,Ben Cat,9,1,0,1,1
2022-03-15,Binh Duong,Ben Cat,10,1,0,1,1
2022-03-15,Binh Duong,Ben Cat,11,1,0,1,0
2022-03-15,Binh Duong,Ben Cat,12,1,0,1,1
2022-03-15,Binh Duong,Ben Cat,13,1,0,1,1
2022-03-15,Binh Duong,Ben Cat,16,1,0,1,1
2022-03-15,Binh Duong,Ben Cat,20,1,0,1,0
2022-03-15,Binh Duong,Di An,1,2,1,1,1
2022-03-15,Binh Duong,Di An,6,2,0,2,2
2022-03-15,Binh Duong,Di An,7,5,1,4,4
2022-03-15,Binh Duong,Di An,8,12,2,10,10
2022-03-15,Binh Duong,Di An,9,24,9,15,14
2022-03-15,Binh Duong,Di An,10,22,7,15,12
2022-03-15,Binh Duong,Di An,11,52,24,28,22
2022-03-15,Binh Duong,Di An,12,28,20,8,5
2022-03-15,Binh Duong,Di An,13,23,10,13,9
2022-03-15,Binh Duong,Di An,14,18,16,2,1
2022-03-15,Binh Duong,Di An,15,11,6,5,2
2022-03-15,Binh Duong,Di An,16,26,13,13,6
2022-03-15,Binh Duong,Di An,17,14,10,4,3
2022-03-15,Binh Duong,Di An,18,12,9,3,2
2022-03-15,Binh Duong,Di An,19,15,10,5,2
2022-03-15,Binh Duong,Di An,20,11,5,6,2
2022-03-15,Binh Duong,Di An,21,11,3,8,3
2022-03-15,Binh Duong,Tan Uyen,10,3,0,3,3
2022-03-15,Binh Duong,Tan Uyen,11,2,1,1,0
2022-03-15,Binh Duong,Tan Uyen,12,2,1,1,1
2022-03-15,Binh Duong,Tan Uyen,13,2,0,2,2
2022-03-15,Binh Duong,Tan Uyen,14,1,0,1,1
2022-03-15,Binh Duong,Tan Uyen,16,1,1,0,0
2022-03-15,Binh Duong,Tan Uyen,17,2,2,0,0
2022-03-15,Binh Duong,Tan Uyen,18,2,1,1,1
2022-03-15,Binh Duong,Tan Uyen,19,2,1,1,1
2022-03-15,Binh Duong,Thu Dau Mot Town,0,1,1,0,0
2022-03-15,Binh Duong,Thu Dau Mot Town,1,1,0,1,1
2022-03-15,Binh Duong,Thu Dau Mot Town,3,2,1,1,0
2022-03-15,Binh Duong,Thu Dau Mot Town,5,2,1,1,0
2022-03-15,Binh Duong,Thu Dau Mot Town,6,30,23,7,6
2022-03-15,Binh Duong,Thu Dau Mot Town,7,112,99,13,3
2022-03-15,Binh Duong,Thu Dau Mot Town,8,196,181,15,1
2022-03-15,Binh Duong,Thu Dau Mot Town,9,258,236,22,4
2022-03-15,Binh Duong,Thu Dau Mot Town,10,372,345,27,3
2022-03-15,Binh Duong,Thu Dau Mot Town,11,687,632,55,13
2022-03-15,Binh Duong,Thu Dau Mot Town,12,433,406,27,4
2022-03-15,Binh Duong,Thu Dau Mot Town,13,383,352,31,4
2022-03-15,Binh Duong,Thu Dau Mot Town,14,368,349,19,1
2022-03-15,Binh Duong,Thu Dau Mot Town,15,268,249,19,2
2022-03-15,Binh Duong,Thu Dau Mot Town,16,264,248,16,0
2022-03-15,Binh Duong,Thu Dau Mot Town,17,331,316,15,3
2022-03-15,Binh Duong,Thu Dau Mot Town,18,353,331,22,2
2022-03-15,Binh Duong,Thu Dau Mot Town,19,327,304,23,4
2022-03-15,Binh Duong,Thu Dau Mot Town,20,243,222,21,3
2022-03-15,Binh Duong,Thu Dau Mot Town,21,107,93,14,1
2022-03-15,Binh Duong,Thu Dau Mot Town,22,1,1,0,0
2022-03-15,Binh Duong,Thu Dau Mot Town,23,2,2,0,0
2022-03-15,Binh Duong,Thuan An,0,2,0,2,0
2022-03-15,Binh Duong,Thuan An,1,3,0,3,0
2022-03-15,Binh Duong,Thuan An,2,1,0,1,0
2022-03-15,Binh Duong,Thuan An,6,2,0,2,2
2022-03-15,Binh Duong,Thuan An,7,13,1,12,9
2022-03-15,Binh Duong,Thuan An,8,15,6,9,6
2022-03-15,Binh Duong,Thuan An,9,29,18,11,9
2022-03-15,Binh Duong,Thuan An,10,53,37,16,10
2022-03-15,Binh Duong,Thuan An,11,132,83,49,27
2022-03-15,Binh Duong,Thuan An,12,51,41,10,7
2022-03-15,Binh Duong,Thuan An,13,40,36,4,1
2022-03-15,Binh Duong,Thuan An,14,51,31,20,15
2022-03-15,Binh Duong,Thuan An,15,32,22,10,5
2022-03-15,Binh Duong,Thuan An,16,32,27,5,3
2022-03-15,Binh Duong,Thuan An,17,32,22,10,7
2022-03-15,Binh Duong,Thuan An,18,49,36,13,10
2022-03-15,Binh Duong,Thuan An,19,30,22,8,6
2022-03-15,Binh Duong,Thuan An,20,25,21,4,2
2022-03-15,Binh Duong,Thuan An,21,23,5,18,15
2022-03-15,Can Tho City,Binh Thuy District,7,3,3,0,0
2022-03-15,Can Tho City,Binh Thuy District,8,1,1,0,0
2022-03-15,Can Tho City,Binh Thuy District,9,8,8,0,0
2022-03-15,Can Tho City,Binh Thuy District,10,10,10,0,0
2022-03-15,Can Tho City,Binh Thuy District,11,17,16,1,0
2022-03-15,Can Tho City,Binh Thuy District,12,10,8,2,1
2022-03-15,Can Tho City,Binh Thuy District,13,14,13,1,0
2022-03-15,Can Tho City,Binh Thuy District,14,18,16,2,2
2022-03-15,Can Tho City,Binh Thuy District,15,12,9,3,0
2022-03-15,Can Tho City,Binh Thuy District,16,12,11,1,0
2022-03-15,Can Tho City,Binh Thuy District,17,14,13,1,0
2022-03-15,Can Tho City,Binh Thuy District,18,17,14,3,3
2022-03-15,Can Tho City,Binh Thuy District,19,5,4,1,0
2022-03-15,Can Tho City,Binh Thuy District,20,12,10,2,0
2022-03-15,Can Tho City,Binh Thuy District,21,2,0,2,1
2022-03-15,Can Tho City,Cai Rang District,0,1,0,1,0
2022-03-15,Can Tho City,Cai Rang District,6,2,1,1,0
2022-03-15,Can Tho City,Cai Rang District,7,1,1,0,0
2022-03-15,Can Tho City,Cai Rang District,8,5,4,1,1
2022-03-15,Can Tho City,Cai Rang District,9,9,7,2,1
2022-03-15,Can Tho City,Cai Rang District,10,12,12,0,0
2022-03-15,Can Tho City,Cai Rang District,11,11,10,1,0
2022-03-15,Can Tho City,Cai Rang District,12,13,13,0,0
2022-03-15,Can Tho City,Cai Rang District,13,10,9,1,1
2022-03-15,Can Tho City,Cai Rang District,14,8,7,1,1
2022-03-15,Can Tho City,Cai Rang District,15,11,10,1,1
2022-03-15,Can Tho City,Cai Rang District,16,14,9,5,1
2022-03-15,Can Tho City,Cai Rang District,17,13,13,0,0
2022-03-15,Can Tho City,Cai Rang District,18,11,11,0,0
2022-03-15,Can Tho City,Cai Rang District,19,8,6,2,0
2022-03-15,Can Tho City,Cai Rang District,20,4,2,2,0
2022-03-15,Can Tho City,Cai Rang District,21,6,5,1,1
2022-03-15,Can Tho City,Ninh Kieu District,0,14,9,5,0
2022-03-15,Can Tho City,Ninh Kieu District,1,6,5,1,0
2022-03-15,Can Tho City,Ninh Kieu District,2,1,1,0,0
2022-03-15,Can Tho City,Ninh Kieu District,4,2,0,2,0
2022-03-15,Can Tho City,Ninh Kieu District,5,1,0,1,1
2022-03-15,Can Tho City,Ninh Kieu District,6,62,57,5,1
2022-03-15,Can Tho City,Ninh Kieu District,7,156,145,11,1
2022-03-15,Can Tho City,Ninh Kieu District,8,259,252,7,0
2022-03-15,Can Tho City,Ninh Kieu District,9,306,284,22,0
2022-03-15,Can Tho City,Ninh Kieu District,10,603,572,31,0
2022-03-15,Can Tho City,Ninh Kieu District,11,955,906,49,2
2022-03-15,Can Tho City,Ninh Kieu District,12,574,538,36,0
2022-03-15,Can Tho City,Ninh Kieu District,13,468,454,14,0
2022-03-15,Can Tho City,Ninh Kieu District,14,398,374,24,0
2022-03-15,Can Tho City,Ninh Kieu District,15,415,392,23,0
2022-03-15,Can Tho City,Ninh Kieu District,16,463,430,33,0
2022-03-15,Can Tho City,Ninh Kieu District,17,556,536,20,0
2022-03-15,Can Tho City,Ninh Kieu District,18,580,549,31,0
2022-03-15,Can Tho City,Ninh Kieu District,19,533,512,21,0
2022-03-15,Can Tho City,Ninh Kieu District,20,388,353,35,0
2022-03-15,Can Tho City,Ninh Kieu District,21,181,156,25,0
2022-03-15,Can Tho City,Ninh Kieu District,22,4,3,1,0
2022-03-15,Can Tho City,Ninh Kieu District,23,1,0,1,0
2022-03-15,Dong Nai,Bien Hoa City,0,19,14,5,1
2022-03-15,Dong Nai,Bien Hoa City,1,4,3,1,0
2022-03-15,Dong Nai,Bien Hoa City,4,2,1,1,1
2022-03-15,Dong Nai,Bien Hoa City,5,2,1,1,0
2022-03-15,Dong Nai,Bien Hoa City,6,53,24,29,28
2022-03-15,Dong Nai,Bien Hoa City,7,161,125,36,13
2022-03-15,Dong Nai,Bien Hoa City,8,251,220,31,2
2022-03-15,Dong Nai,Bien Hoa City,9,349,308,41,9
2022-03-15,Dong Nai,Bien Hoa City,10,740,647,93,24
2022-03-15,Dong Nai,Bien Hoa City,11,1032,922,110,35
2022-03-15,Dong Nai,Bien Hoa City,12,765,699,66,3
2022-03-15,Dong Nai,Bien Hoa City,13,682,621,61,13
2022-03-15,Dong Nai,Bien Hoa City,14,584,532,52,8
2022-03-15,Dong Nai,Bien Hoa City,15,475,426,49,7
2022-03-15,Dong Nai,Bien Hoa City,16,500,411,89,20
2022-03-15,Dong Nai,Bien Hoa City,17,570,510,60,14
2022-03-15,Dong Nai,Bien Hoa City,18,661,600,61,11
2022-03-15,Dong Nai,Bien Hoa City,19,607,536,71,17
2022-03-15,Dong Nai,Bien Hoa City,20,439,377,62,26
2022-03-15,Dong Nai,Bien Hoa City,21,218,134,84,40
2022-03-15,Dong Nai,Bien Hoa City,22,7,0,7,0
2022-03-15,Dong Nai,Cam My,11,1,0,1,1
2022-03-15,Dong Nai,Cam My,12,1,0,1,1
2022-03-15,Dong Nai,Cam My,13,1,0,1,1
2022-03-15,Dong Nai,Long Khanh,18,1,0,1,1
2022-03-15,Dong Nai,Long Thanh,11,5,0,5,5
2022-03-15,Dong Nai,Long Thanh,12,1,0,1,1
2022-03-15,Dong Nai,Long Thanh,13,1,0,1,1
2022-03-15,Dong Nai,Long Thanh,14,1,0,1,1
2022-03-15,Dong Nai,Long Thanh,15,1,0,1,1
2022-03-15,Dong Nai,Long Thanh,18,2,0,2,1
2022-03-15,Dong Nai,Long Thanh,19,1,0,1,1
2022-03-15,Dong Nai,Nhon trach,10,1,0,1,1
2022-03-15,Dong Nai,Nhon trach,13,1,0,1,1
2022-03-15,Dong Nai,Thong Nhat,8,1,1,0,0
2022-03-15,Dong Nai,Thong Nhat,9,2,2,0,0
2022-03-15,Dong Nai,Thong Nhat,10,2,2,0,0
2022-03-15,Dong Nai,Thong Nhat,12,3,2,1,0
2022-03-15,Dong Nai,Thong Nhat,13,5,4,1,0
2022-03-15,Dong Nai,Thong Nhat,14,1,1,0,0
2022-03-15,Dong Nai,Thong Nhat,16,1,1,0,0
2022-03-15,Dong Nai,Thong Nhat,20,1,1,0,0
2022-03-15,Dong Nai,Trang Bom,17,1,1,0,0
2022-03-15,Dong Nai,Trang Bom,18,1,0,1,1
2022-03-15,Hai Phong City,An Duong,0,1,0,1,0
2022-03-15,Hai Phong City,An Duong,7,5,3,2,2
2022-03-15,Hai Phong City,An Duong,10,8,4,4,3
2022-03-15,Hai Phong City,An Duong,11,2,1,1,1
2022-03-15,Hai Phong City,An Duong,12,2,0,2,1
2022-03-15,Hai Phong City,An Duong,13,4,1,3,3
2022-03-15,Hai Phong City,An Duong,14,5,5,0,0
2022-03-15,Hai Phong City,An Duong,15,2,2,0,0
2022-03-15,Hai Phong City,An Duong,16,1,1,0,0
2022-03-15,Hai Phong City,An Duong,17,2,0,2,1
2022-03-15,Hai Phong City,An Duong,18,3,1,2,1
2022-03-15,Hai Phong City,An Duong,19,2,1,1,0
2022-03-15,Hai Phong City,An Duong,20,1,1,0,0
2022-03-15,Hai Phong City,Do Son District,12,1,0,1,1
2022-03-15,Hai Phong City,Do Son District,13,1,0,1,1
2022-03-15,Hai Phong City,Do Son District,16,1,0,1,1
2022-03-15,Hai Phong City,Do Son District,17,1,0,1,1
2022-03-15,Hai Phong City,Do Son District,18,1,0,1,1
2022-03-15,Hai Phong City,Do Son District,21,1,0,1,1
2022-03-15,Hai Phong City,Duong Kinh District,11,1,0,1,0
2022-03-15,Hai Phong City,Duong Kinh District,15,1,0,1,0
2022-03-15,Hai Phong City,Duong Kinh District,17,1,0,1,1
2022-03-15,Hai Phong City,Duong Kinh District,20,1,0,1,0
2022-03-15,Hai Phong City,Hai An District,7,8,7,1,1
2022-03-15,Hai Phong City,Hai An District,8,13,11,2,0
2022-03-15,Hai Phong City,Hai An District,9,15,13,2,0
2022-03-15,Hai Phong City,Hai An District,10,16,15,1,0
2022-03-15,Hai Phong City,Hai An District,11,45,39,6,3
2022-03-15,Hai Phong City,Hai An District,12,26,25,1,0
2022-03-15,Hai Phong City,Hai An District,13,20,16,4,2
2022-03-15,Hai Phong City,Hai An District,14,11,7,4,0
2022-03-15,Hai Phong City,Hai An District,15,21,18,3,0
2022-03-15,Hai Phong City,Hai An District,16,14,11,3,1
2022-03-15,Hai Phong City,Hai An District,17,12,11,1,0
2022-03-15,Hai Phong City,Hai An District,18,21,18,3,1
2022-03-15,Hai Phong City,Hai An District,19,23,19,4,1
2022-03-15,Hai Phong City,Hai An District,20,10,8,2,0
2022-03-15,Hai Phong City,Hai An District,21,5,3,2,0
2022-03-15,Hai Phong City,Hong Bang District,0,3,1,2,0
2022-03-15,Hai Phong City,Hong Bang District,1,1,1,0,0
2022-03-15,Hai Phong City,Hong Bang District,7,19,18,1,0
2022-03-15,Hai Phong City,Hong Bang District,8,28,25,3,1
2022-03-15,Hai Phong City,Hong Bang District,9,30,27,3,1
2022-03-15,Hai Phong City,Hong Bang District,10,62,55,7,0
2022-03-15,Hai Phong City,Hong Bang District,11,89,77,12,0
2022-03-15,Hai Phong City,Hong Bang District,12,55,49,6,1
2022-03-15,Hai Phong City,Hong Bang District,13,43,38,5,0
2022-03-15,Hai Phong City,Hong Bang District,14,41,34,7,1
2022-03-15,Hai Phong City,Hong Bang District,15,39,33,6,1
2022-03-15,Hai Phong City,Hong Bang District,16,32,29,3,1
2022-03-15,Hai Phong City,Hong Bang District,17,39,34,5,0
2022-03-15,Hai Phong City,Hong Bang District,18,57,53,4,0
2022-03-15,Hai Phong City,Hong Bang District,19,45,39,6,0
2022-03-15,Hai Phong City,Hong Bang District,20,25,19,6,3
2022-03-15,Hai Phong City,Hong Bang District,21,8,7,1,0
2022-03-15,Hai Phong City,Kien An District,0,2,1,1,1
2022-03-15,Hai Phong City,Kien An District,1,2,1,1,0
2022-03-15,Hai Phong City,Kien An District,7,1,1,0,0
2022-03-15,Hai Phong City,Kien An District,8,5,1,4,3
2022-03-15,Hai Phong City,Kien An District,9,6,4,2,0
2022-03-15,Hai Phong City,Kien An District,10,11,9,2,1
2022-03-15,Hai Phong City,Kien An District,11,13,13,0,0
2022-03-15,Hai Phong City,Kien An District,12,9,9,0,0
2022-03-15,Hai Phong City,Kien An District,13,4,4,0,0
2022-03-15,Hai Phong City,Kien An District,14,12,7,5,4
2022-03-15,Hai Phong City,Kien An District,15,8,6,2,1
2022-03-15,Hai Phong City,Kien An District,16,4,3,1,0
2022-03-15,Hai Phong City,Kien An District,17,6,6,0,0
2022-03-15,Hai Phong City,Kien An District,18,6,6,0,0
2022-03-15,Hai Phong City,Kien An District,19,9,9,0,0
2022-03-15,Hai Phong City,Kien An District,20,9,6,3,1
2022-03-15,Hai Phong City,Kien An District,21,7,5,2,1
2022-03-15,Hai Phong City,Le Chan District,0,6,6,0,0
2022-03-15,Hai Phong City,Le Chan District,3,1,0,1,1
2022-03-15,Hai Phong City,Le Chan District,7,26,24,2,0
2022-03-15,Hai Phong City,Le Chan District,8,53,52,1,0
2022-03-15,Hai Phong City,Le Chan District,9,97,82,15,0
2022-03-15,Hai Phong City,Le Chan District,10,117,103,14,0
2022-03-15,Hai Phong City,Le Chan District,11,305,273,32,10
2022-03-15,Hai Phong City,Le Chan District,12,153,142,11,0
2022-03-15,Hai Phong City,Le Chan District,13,116,111,5,0
2022-03-15,Hai Phong City,Le Chan District,14,123,109,14,0
2022-03-15,Hai Phong City,Le Chan District,15,170,151,19,0
2022-03-15,Hai Phong City,Le Chan District,16,113,101,12,0
2022-03-15,Hai Phong City,Le Chan District,17,168,158,10,0
2022-03-15,Hai Phong City,Le Chan District,18,198,185,13,1
2022-03-15,Hai Phong City,Le Chan District,19,183,157,26,3
2022-03-15,Hai Phong City,Le Chan District,20,125,103,22,0
2022-03-15,Hai Phong City,Le Chan District,21,52,42,10,1
2022-03-15,Hai Phong City,Le Chan District,22,3,2,1,0
2022-03-15,Hai Phong City,Le Chan District,23,1,0,1,1
2022-03-15,Hai Phong City,Ngo Quyen District,0,4,4,0,0
2022-03-15,Hai Phong City,Ngo Quyen District,1,2,2,0,0
2022-03-15,Hai Phong City,Ngo Quyen District,6,3,3,0,0
2022-03-15,Hai Phong City,Ngo Quyen District,7,25,21,4,2
2022-03-15,Hai Phong City,Ngo Quyen District,8,67,60,7,2
2022-03-15,Hai Phong City,Ngo Quyen District,9,70,65,5,0
2022-03-15,Hai Phong City,Ngo Quyen District,10,130,121,9,0
2022-03-15,Hai Phong City,Ngo Quyen District,11,246,218,28,4
2022-03-15,Hai Phong City,Ngo Quyen District,12,126,119,7,0
2022-03-15,Hai Phong City,Ngo Quyen District,13,125,113,12,0
2022-03-15,Hai Phong City,Ngo Quyen District,14,143,127,16,1
2022-03-15,Hai Phong City,Ngo Quyen District,15,158,135,23,3
2022-03-15,Hai Phong City,Ngo Quyen District,16,140,128,12,0
2022-03-15,Hai Phong City,Ngo Quyen District,17,134,121,13,1
2022-03-15,Hai Phong City,Ngo Quyen District,18,136,124,12,0
2022-03-15,Hai Phong City,Ngo Quyen District,19,157,144,13,1
2022-03-15,Hai Phong City,Ngo Quyen District,20,113,97,16,6
2022-03-15,Hai Phong City,Ngo Quyen District,21,48,41,7,0
2022-03-15,Hai Phong City,Ngo Quyen District,22,3,1,2,0
2022-03-15,Hai Phong City,Ngo Quyen District,23,2,0,2,0
2022-03-15,Hai Phong City,Thuy Nguyen,10,1,0,1,0
2022-03-15,Hai Phong City,Thuy Nguyen,11,3,1,2,2
2022-03-15,Hai Phong City,Thuy Nguyen,12,1,0,1,0
2022-03-15,Hai Phong City,Thuy Nguyen,13,1,0,1,0
2022-03-15,Hai Phong City,Thuy Nguyen,14,1,0,1,1
2022-03-15,Hai Phong City,Thuy Nguyen,16,1,0,1,1
2022-03-15,Hai Phong City,Thuy Nguyen,17,1,0,1,1
2022-03-15,Hue City,Hue City,0,11,9,2,0
2022-03-15,Hue City,Hue City,1,6,3,3,0
2022-03-15,Hue City,Hue City,3,2,2,0,0
2022-03-15,Hue City,Hue City,4,1,1,0,0
2022-03-15,Hue City,Hue City,5,4,4,0,0
2022-03-15,Hue City,Hue City,6,67,59,8,0
2022-03-15,Hue City,Hue City,7,193,185,8,1
2022-03-15,Hue City,Hue City,8,320,308,12,2
2022-03-15,Hue City,Hue City,9,237,214,23,1
2022-03-15,Hue City,Hue City,10,368,339,29,1
2022-03-15,Hue City,Hue City,11,783,745,38,0
2022-03-15,Hue City,Hue City,12,415,385,30,0
2022-03-15,Hue City,Hue City,13,288,270,18,0
2022-03-15,Hue City,Hue City,14,301,282,19,0
2022-03-15,Hue City,Hue City,15,383,364,19,0
2022-03-15,Hue City,Hue City,16,436,384,52,0
2022-03-15,Hue City,Hue City,17,492,456,36,0
2022-03-15,Hue City,Hue City,18,593,559,34,2
2022-03-15,Hue City,Hue City,19,564,534,30,0
2022-03-15,Hue City,Hue City,20,372,334,38,1
2022-03-15,Hue City,Hue City,21,246,207,39,3
2022-03-15,Hue City,Hue City,22,5,3,2,0
2022-03-15,Hue City,Hue City,23,2,1,1,0
2022-03-15,Hue City,Huong Thuy,0,1,0,1,1
2022-03-15,Hue City,Huong Thuy,9,1,1,0,0
2022-03-15,Hue City,Huong Thuy,10,1,1,0,0
2022-03-15,Hue City,Huong Thuy,11,2,1,1,0
2022-03-15,Hue City,Huong Thuy,15,1,1,0,0
2022-03-15,Hue City,Huong Thuy,16,2,0,2,2
2022-03-15,Hue City,Huong Thuy,17,2,1,1,1
2022-03-15,Hue City,Huong Thuy,18,2,1,1,0
2022-03-15,Hue City,Huong Tra,14,1,1,0,0
2022-03-15,Hue City,Phu Vang,6,2,2,0,0
2022-03-15,Hue City,Phu Vang,7,1,1,0,0
2022-03-15,Hue City,Phu Vang,9,1,0,1,1
2022-03-15,Hue City,Phu Vang,10,1,1,0,0
2022-03-15,Hue City,Phu Vang,11,2,2,0,0
2022-03-15,Hue City,Phu Vang,13,2,1,1,0
2022-03-15,Hue City,Phu Vang,14,1,1,0,0
2022-03-15,Hue City,Phu Vang,15,1,1,0,0
2022-03-15,Hue City,Phu Vang,16,3,3,0,0
2022-03-15,Hue City,Phu Vang,17,3,3,0,0
2022-03-15,Hue City,Phu Vang,19,2,2,0,0
2022-03-15,Hue City,Phu Vang,20,1,1,0,0
2022-03-15,Hue City,Phu Vang,21,1,0,1,0
2022-03-15,Vung Tau,Ba Ria City,7,1,0,1,0
2022-03-15,Vung Tau,Ba Ria City,8,3,2,1,1
2022-03-15,Vung Tau,Ba Ria City,9,6,6,0,0
2022-03-15,Vung Tau,Ba Ria City,10,8,5,3,1
2022-03-15,Vung Tau,Ba Ria City,11,5,3,2,2
2022-03-15,Vung Tau,Ba Ria City,12,4,3,1,0
2022-03-15,Vung Tau,Ba Ria City,13,7,2,5,3
2022-03-15,Vung Tau,Ba Ria City,14,9,5,4,4
2022-03-15,Vung Tau,Ba Ria City,15,5,3,2,1
2022-03-15,Vung Tau,Ba Ria City,16,2,2,0,0
2022-03-15,Vung Tau,Ba Ria City,17,3,3,0,0
2022-03-15,Vung Tau,Ba Ria City,18,5,3,2,2
2022-03-15,Vung Tau,Ba Ria City,19,2,2,0,0
2022-03-15,Vung Tau,Ba Ria City,20,9,2,7,7
2022-03-15,Vung Tau,Ba Ria City,21,1,0,1,1
2022-03-15,Vung Tau,Vung Tau City,0,8,8,0,0
2022-03-15,Vung Tau,Vung Tau City,1,1,1,0,0
2022-03-15,Vung Tau,Vung Tau City,2,4,0,4,0
2022-03-15,Vung Tau,Vung Tau City,3,1,1,0,0
2022-03-15,Vung Tau,Vung Tau City,5,2,2,0,0
2022-03-15,Vung Tau,Vung Tau City,6,33,30,3,1
2022-03-15,Vung Tau,Vung Tau City,7,119,111,8,3
2022-03-15,Vung Tau,Vung Tau City,8,168,158,10,2
2022-03-15,Vung Tau,Vung Tau City,9,142,131,11,1
2022-03-15,Vung Tau,Vung Tau City,10,198,178,20,5
2022-03-15,Vung Tau,Vung Tau City,11,374,340,34,11
2022-03-15,Vung Tau,Vung Tau City,12,244,229,15,2
2022-03-15,Vung Tau,Vung Tau City,13,197,186,11,0
2022-03-15,Vung Tau,Vung Tau City,14,192,172,20,0
2022-03-15,Vung Tau,Vung Tau City,15,225,212,13,1
2022-03-15,Vung Tau,Vung Tau City,16,235,215,20,2
2022-03-15,Vung Tau,Vung Tau City,17,263,246,17,1
2022-03-15,Vung Tau,Vung Tau City,18,310,292,18,2
2022-03-15,Vung Tau,Vung Tau City,19,207,191,16,1
2022-03-15,Vung Tau,Vung Tau City,20,160,143,17,1
2022-03-15,Vung Tau,Vung Tau City,21,79,60,19,4
2022-03-15,Vung Tau,Vung Tau City,22,3,1,2,0
2022-03-16,Binh Duong,Ben Cat,13,2,1,1,1
2022-03-16,Binh Duong,Ben Cat,15,1,0,1,1
2022-03-16,Binh Duong,Di An,0,1,0,1,1
2022-03-16,Binh Duong,Di An,6,2,0,2,1
2022-03-16,Binh Duong,Di An,7,3,0,3,2
2022-03-16,Binh Duong,Di An,8,16,2,14,11
2022-03-16,Binh Duong,Di An,9,15,6,9,9
2022-03-16,Binh Duong,Di An,10,22,11,11,9
2022-03-16,Binh Duong,Di An,11,36,14,22,17
2022-03-16,Binh Duong,Di An,12,16,12,4,2
2022-03-16,Binh Duong,Di An,13,29,17,12,11
2022-03-16,Binh Duong,Di An,14,17,8,9,5
2022-03-16,Binh Duong,Di An,15,14,8,6,4
2022-03-16,Binh Duong,Di An,16,13,5,8,5
2022-03-16,Binh Duong,Di An,17,16,12,4,3
2022-03-16,Binh Duong,Di An,18,15,12,3,1
2022-03-16,Binh Duong,Di An,19,15,9,6,1
2022-03-16,Binh Duong,Di An,20,15,6,9,6
2022-03-16,Binh Duong,Di An,21,5,3,2,1
2022-03-16,Binh Duong,Di An,22,1,0,1,0
2022-03-16,Binh Duong,Tan Uyen,9,2,0,2,2
2022-03-16,Binh Duong,Tan Uyen,11,5,4,1,1
2022-03-16,Binh Duong,Tan Uyen,12,2,0,2,1
2022-03-16,Binh Duong,Tan Uyen,13,1,0,1,1
2022-03-16,Binh Duong,Tan Uyen,15,2,1,1,1
2022-03-16,Binh Duong,Tan Uyen,16,1,0,1,0
2022-03-16,Binh Duong,Tan Uyen,17,1,0,1,0
2022-03-16,Binh Duong,Tan Uyen,19,1,0,1,1
2022-03-16,Binh Duong,Tan Uyen,20,1,0,1,1
2022-03-16,Binh Duong,Thu Dau Mot Town,0,1,0,1,1
2022-03-16,Binh Duong,Thu Dau Mot Town,2,1,0,1,0
2022-03-16,Binh Duong,Thu Dau Mot Town,5,1,0,1,0
2022-03-16,Binh Duong,Thu Dau Mot Town,6,29,25,4,1
2022-03-16,Binh Duong,Thu Dau Mot Town,7,112,102,10,1
2022-03-16,Binh Duong,Thu Dau Mot Town,8,197,184,13,2
2022-03-16,Binh Duong,Thu Dau Mot Town,9,246,234,12,2
2022-03-16,Binh Duong,Thu Dau Mot Town,10,414,379,35,2
2022-03-16,Binh Duong,Thu Dau Mot Town,11,599,541,58,20
2022-03-16,Binh Duong,Thu Dau Mot Town,12,408,385,23,1
2022-03-16,Binh Duong,Thu Dau Mot Town,13,359,341,18,0
2022-03-16,Binh Duong,Thu Dau Mot Town,14,336,311,25,2
2022-03-16,Binh Duong,Thu Dau Mot Town,15,263,252,11,0
2022-03-16,Binh Duong,Thu Dau Mot Town,16,281,258,23,1
2022-03-16,Binh Duong,Thu Dau Mot Town,17,357,321,36,5
2022-03-16,Binh Duong,Thu Dau Mot Town,18,372,343,29,2
2022-03-16,Binh Duong,Thu Dau Mot Town,19,293,273,20,2
2022-03-16,Binh Duong,Thu Dau Mot Town,20,237,209,28,2
2022-03-16,Binh Duong,Thu Dau Mot Town,21,116,88,28,3
2022-03-16,Binh Duong,Thu Dau Mot Town,23,3,0,3,0
2022-03-16,Binh Duong,Thuan An,6,3,0,3,3
2022-03-16,Binh Duong,Thuan An,7,8,3,5,4
2022-03-16,Binh Duong,Thuan An,8,17,8,9,7
2022-03-16,Binh Duong,Thuan An,9,25,19,6,3
2022-03-16,Binh Duong,Thuan An,10,50,33,17,9
2022-03-16,Binh Duong,Thuan An,11,69,39,30,18
2022-03-16,Binh Duong,Thuan An,12,60,40,20,14
2022-03-16,Binh Duong,Thuan An,13,54,38,16,14
2022-03-16,Binh Duong,Thuan An,14,42,29,13,7
2022-03-16,Binh Duong,Thuan An,15,30,25,5,1
2022-03-16,Binh Duong,Thuan An,16,38,19,19,17
2022-03-16,Binh Duong,Thuan An,17,42,28,14,8
2022-03-16,Binh Duong,Thuan An,18,37,27,10,6
2022-03-16,Binh Duong,Thuan An,19,22,19,3,1
2022-03-16,Binh Duong,Thuan An,20,20,11,9,3
2022-03-16,Binh Duong,Thuan An,21,11,3,8,4
2022-03-16,Binh Duong,Thuan An,22,1,0,1,0
2022-03-16,Can Tho City,Binh Thuy District,6,1,0,1,1
2022-03-16,Can Tho City,Binh Thuy District,7,2,2,0,0
2022-03-16,Can Tho City,Binh Thuy District,8,6,5,1,0
2022-03-16,Can Tho City,Binh Thuy District,9,6,6,0,0
2022-03-16,Can Tho City,Binh Thuy District,10,10,8,2,0
2022-03-16,Can Tho City,Binh Thuy District,11,15,15,0,0
2022-03-16,Can Tho City,Binh Thuy District,12,5,5,0,0
2022-03-16,Can Tho City,Binh Thuy District,13,9,9,0,0
2022-03-16,Can Tho City,Binh Thuy District,14,15,12,3,1
2022-03-16,Can Tho City,Binh Thuy District,15,9,9,0,0
2022-03-16,Can Tho City,Binh Thuy District,16,8,6,2,1
2022-03-16,Can Tho City,Binh Thuy District,17,19,19,0,0
2022-03-16,Can Tho City,Binh Thuy District,18,11,10,1,1
2022-03-16,Can Tho City,Binh Thuy District,19,19,15,4,2
2022-03-16,Can Tho City,Binh Thuy District,20,6,5,1,0
2022-03-16,Can Tho City,Binh Thuy District,21,8,4,4,0
2022-03-16,Can Tho City,Cai Rang District,6,2,2,0,0
2022-03-16,Can Tho City,Cai Rang District,7,2,2,0,0
2022-03-16,Can Tho City,Cai Rang District,8,2,2,0,0
2022-03-16,Can Tho City,Cai Rang District,9,3,3,0,0
2022-03-16,Can Tho City,Cai Rang District,10,7,6,1,0
2022-03-16,Can Tho City,Cai Rang District,11,15,13,2,1
2022-03-16,Can Tho City,Cai Rang District,12,11,11,0,0
2022-03-16,Can Tho City,Cai Rang District,13,10,8,2,0
2022-03-16,Can Tho City,Cai Rang District,14,11,11,0,0
2022-03-16,Can Tho City,Cai Rang District,15,5,4,1,0
2022-03-16,Can Tho City,Cai Rang District,16,10,9,1,1
2022-03-16,Can Tho City,Cai Rang District,17,8,6,2,1
2022-03-16,Can Tho City,Cai Rang District,18,1,1,0,0
2022-03-16,Can Tho City,Cai Rang District,19,11,10,1,0
2022-03-16,Can Tho City,Cai Rang District,20,9,7,2,1
2022-03-16,Can Tho City,Cai Rang District,21,4,3,1,0
2022-03-16,Can Tho City,Ninh Kieu District,0,2,1,1,0
2022-03-16,Can Tho City,Ninh Kieu District,1,3,2,1,0
2022-03-16,Can Tho City,Ninh Kieu District,3,2,0,2,0
2022-03-16,Can Tho City,Ninh Kieu District,4,1,0,1,0
2022-03-16,Can Tho City,Ninh Kieu District,5,3,1,2,1
2022-03-16,Can Tho City,Ninh Kieu District,6,67,48,19,12
2022-03-16,Can Tho City,Ninh Kieu District,7,143,136,7,0
2022-03-16,Can Tho City,Ninh Kieu District,8,228,213,15,0
2022-03-16,Can Tho City,Ninh Kieu District,9,314,300,14,0
2022-03-16,Can Tho City,Ninh Kieu District,10,578,544,34,0
2022-03-16,Can Tho City,Ninh Kieu District,11,855,814,41,4
2022-03-16,Can Tho City,Ninh Kieu District,12,608,581,27,1
2022-03-16,Can Tho City,Ninh Kieu District,13,487,467,20,0
2022-03-16,Can Tho City,Ninh Kieu District,14,382,366,16,0
2022-03-16,Can Tho City,Ninh Kieu District,15,382,355,27,0
2022-03-16,Can Tho City,Ninh Kieu District,16,486,463,23,0
2022-03-16,Can Tho City,Ninh Kieu District,17,535,515,20,1
2022-03-16,Can Tho City,Ninh Kieu District,18,579,556,23,0
2022-03-16,Can Tho City,Ninh Kieu District,19,468,440,28,0
2022-03-16,Can Tho City,Ninh Kieu District,20,402,376,26,0
2022-03-16,Can Tho City,Ninh Kieu District,21,200,181,19,2
2022-03-16,Can Tho City,Ninh Kieu District,22,5,1,4,0
2022-03-16,Can Tho City,Ninh Kieu District,23,6,4,2,0
2022-03-16,Dong Nai,Bien Hoa City,0,3,2,1,0
2022-03-16,Dong Nai,Bien Hoa City,2,3,2,1,0
2022-03-16,Dong Nai,Bien Hoa City,3,1,0,1,0
2022-03-16,Dong Nai,Bien Hoa City,5,2,0,2,1
2022-03-16,Dong Nai,Bien Hoa City,6,25,19,6,3
2022-03-16,Dong Nai,Bien Hoa City,7,116,97,19,4
2022-03-16,Dong Nai,Bien Hoa City,8,293,253,40,6
2022-03-16,Dong Nai,Bien Hoa City,9,364,325,39,5
2022-03-16,Dong Nai,Bien Hoa City,10,741,663,78,15
2022-03-16,Dong Nai,Bien Hoa City,11,1007,900,107,26
2022-03-16,Dong Nai,Bien Hoa City,12,724,669,55,5
2022-03-16,Dong Nai,Bien Hoa City,13,703,644,59,17
2022-03-16,Dong Nai,Bien Hoa City,14,587,524,63,15
2022-03-16,Dong Nai,Bien Hoa City,15,498,445,53,11
2022-03-16,Dong Nai,Bien Hoa City,16,499,435,64,21
2022-03-16,Dong Nai,Bien Hoa City,17,590,504,86,22
2022-03-16,Dong Nai,Bien Hoa City,18,658,589,69,18
2022-03-16,Dong Nai,Bien Hoa City,19,594,514,80,18
2022-03-16,Dong Nai,Bien Hoa City,20,382,318,64,11
2022-03-16,Dong Nai,Bien Hoa City,21,188,129,59,33
2022-03-16,Dong Nai,Bien Hoa City,22,2,1,1,0
2022-03-16,Dong Nai,Bien Hoa City,23,1,1,0,0
2022-03-16,Dong Nai,Long Khanh,7,1,0,1,0
2022-03-16,Dong Nai,Long Khanh,14,1,0,1,0
2022-03-16,Dong Nai,Long Khanh,15,1,0,1,1
2022-03-16,Dong Nai,Long Thanh,8,1,0,1,1
2022-03-16,Dong Nai,Long Thanh,9,1,0,1,1
2022-03-16,Dong Nai,Long Thanh,10,3,0,3,2
2022-03-16,Dong Nai,Long Thanh,11,1,0,1,1
2022-03-16,Dong Nai,Long Thanh,12,2,0,2,0
2022-03-16,Dong Nai,Long Thanh,16,3,0,3,3
2022-03-16,Dong Nai,Long Thanh,17,1,0,1,0
2022-03-16,Dong Nai,Long Thanh,18,1,0,1,1
2022-03-16,Dong Nai,Long Thanh,19,1,0,1,1
2022-03-16,Dong Nai,Thong Nhat,7,1,1,0,0
2022-03-16,Dong Nai,Thong Nhat,8,1,1,0,0
2022-03-16,Dong Nai,Thong Nhat,9,1,1,0,0
2022-03-16,Dong Nai,Thong Nhat,10,2,2,0,0
2022-03-16,Dong Nai,Thong Nhat,11,1,1,0,0
2022-03-16,Dong Nai,Thong Nhat,12,1,1,0,0
2022-03-16,Dong Nai,Thong Nhat,15,1,1,0,0
2022-03-16,Dong Nai,Thong Nhat,16,2,2,0,0
2022-03-16,Dong Nai,Thong Nhat,18,2,2,0,0
2022-03-16,Dong Nai,Thong Nhat,19,4,3,1,1
2022-03-16,Dong Nai,Thong Nhat,20,1,1,0,0
2022-03-16,Dong Nai,Trang Bom,11,1,0,1,1
2022-03-16,Dong Nai,Trang Bom,12,2,0,2,2
2022-03-16,Dong Nai,Trang Bom,16,1,0,1,1
2022-03-16,Hai Phong City,An Duong,7,5,1,4,3
2022-03-16,Hai Phong City,An Duong,8,1,0,1,0
2022-03-16,Hai Phong City,An Duong,9,6,1,5,1
2022-03-16,Hai Phong City,An Duong,10,5,1,4,3
2022-03-16,Hai Phong City,An Duong,11,4,3,1,1
2022-03-16,Hai Phong City,An Duong,13,6,4,2,1
2022-03-16,Hai Phong City,An Duong,14,3,1,2,1
2022-03-16,Hai Phong City,An Duong,15,3,1,2,2
2022-03-16,Hai Phong City,An Duong,16,2,2,0,0
2022-03-16,Hai Phong City,An Duong,17,1,1,0,0
2022-03-16,Hai Phong City,An Duong,18,1,0,1,0
2022-03-16,Hai Phong City,An Duong,19,1,0,1,1
2022-03-16,Hai Phong City,An Duong,20,1,1,0,0
2022-03-16,Hai Phong City,Hai An District,7,2,1,1,1
2022-03-16,Hai Phong City,Hai An District,8,7,6,1,0
2022-03-16,Hai Phong City,Hai An District,9,17,13,4,2
2022-03-16,Hai Phong City,Hai An District,10,22,19,3,1
2022-03-16,Hai Phong City,Hai An District,11,34,32,2,1
2022-03-16,Hai Phong City,Hai An District,12,21,19,2,2
2022-03-16,Hai Phong City,Hai An District,13,15,12,3,1
2022-03-16,Hai Phong City,Hai An District,14,11,10,1,0
2022-03-16,Hai Phong City,Hai An District,15,17,13,4,1
2022-03-16,Hai Phong City,Hai An District,16,10,8,2,0
2022-03-16,Hai Phong City,Hai An District,17,20,13,7,3
2022-03-16,Hai Phong City,Hai An District,18,22,19,3,1
2022-03-16,Hai Phong City,Hai An District,19,24,20,4,0
2022-03-16,Hai Phong City,Hai An District,20,22,20,2,0
2022-03-16,Hai Phong City,Hai An District,21,3,1,2,0
2022-03-16,Hai Phong City,Hong Bang District,0,1,0,1,1
2022-03-16,Hai Phong City,Hong Bang District,6,1,1,0,0
2022-03-16,Hai Phong City,Hong Bang District,7,9,7,2,1
2022-03-16,Hai Phong City,Hong Bang District,8,26,24,2,0
2022-03-16,Hai Phong City,Hong Bang District,9,35,29,6,3
2022-03-16,Hai Phong City,Hong Bang District,10,47,45,2,1
2022-03-16,Hai Phong City,Hong Bang District,11,96,84,12,9
2022-03-16,Hai Phong City,Hong Bang District,12,53,48,5,2
2022-03-16,Hai Phong City,Hong Bang District,13,23,22,1,0
2022-03-16,Hai Phong City,Hong Bang District,14,37,31,6,1
2022-03-16,Hai Phong City,Hong Bang District,15,36,29,7,0
2022-03-16,Hai Phong City,Hong Bang District,16,41,36,5,1
2022-03-16,Hai Phong City,Hong Bang District,17,44,39,5,0
2022-03-16,Hai Phong City,Hong Bang District,18,56,54,2,0
2022-03-16,Hai Phong City,Hong Bang District,19,35,30,5,1
2022-03-16,Hai Phong City,Hong Bang District,20,25,20,5,3
2022-03-16,Hai Phong City,Hong Bang District,21,8,6,2,1
2022-03-16,Hai Phong City,Kien An District,7,1,0,1,1
2022-03-16,Hai Phong City,Kien An District,8,1,1,0,0
2022-03-16,Hai Phong City,Kien An District,9,8,5,3,3
2022-03-16,Hai Phong City,Kien An District,10,13,9,4,0
2022-03-16,Hai Phong City,Kien An District,11,6,5,1,0
2022-03-16,Hai Phong City,Kien An District,12,7,6,1,0
2022-03-16,Hai Phong City,Kien An District,13,5,2,3,2
2022-03-16,Hai Phong City,Kien An District,14,5,5,0,0
2022-03-16,Hai Phong City,Kien An District,15,5,2,3,1
2022-03-16,Hai Phong City,Kien An District,16,8,5,3,3
2022-03-16,Hai Phong City,Kien An District,17,10,10,0,0
2022-03-16,Hai Phong City,Kien An District,18,10,7,3,2
2022-03-16,Hai Phong City,Kien An District,19,7,4,3,0
2022-03-16,Hai Phong City,Kien An District,20,8,6,2,0
2022-03-16,Hai Phong City,Kien An District,21,5,3,2,1
2022-03-16,Hai Phong City,Le Chan District,0,3,1,2,0
2022-03-16,Hai Phong City,Le Chan District,6,1,1,0,0
2022-03-16,Hai Phong City,Le Chan District,7,28,26,2,1
2022-03-16,Hai Phong City,Le Chan District,8,47,41,6,0
2022-03-16,Hai Phong City,Le Chan District,9,62,53,9,3
2022-03-16,Hai Phong City,Le Chan District,10,144,137,7,1
2022-03-16,Hai Phong City,Le Chan District,11,268,238,30,8
2022-03-16,Hai Phong City,Le Chan District,12,134,126,8,1
2022-03-16,Hai Phong City,Le Chan District,13,108,100,8,1
2022-03-16,Hai Phong City,Le Chan District,14,103,92,11,3
2022-03-16,Hai Phong City,Le Chan District,15,150,137,13,0
2022-03-16,Hai Phong City,Le Chan District,16,123,110,13,1
2022-03-16,Hai Phong City,Le Chan District,17,170,156,14,0
2022-03-16,Hai Phong City,Le Chan District,18,212,188,24,2
2022-03-16,Hai Phong City,Le Chan District,19,151,137,14,2
2022-03-16,Hai Phong City,Le Chan District,20,108,95,13,0
2022-03-16,Hai Phong City,Le Chan District,21,53,43,10,1
2022-03-16,Hai Phong City,Ngo Quyen District,0,2,2,0,0
2022-03-16,Hai Phong City,Ngo Quyen District,1,2,1,1,0
2022-03-16,Hai Phong City,Ngo Quyen District,4,1,1,0,0
2022-03-16,Hai Phong City,Ngo Quyen District,7,26,22,4,0
2022-03-16,Hai Phong City,Ngo Quyen District,8,56,51,5,1
2022-03-16,Hai Phong City,Ngo Quyen District,9,101,88,13,5
2022-03-16,Hai Phong City,Ngo Quyen District,10,124,112,12,4
2022-03-16,Hai Phong City,Ngo Quyen District,11,217,194,23,2
2022-03-16,Hai Phong City,Ngo Quyen District,12,129,120,9,2
2022-03-16,Hai Phong City,Ngo Quyen District,13,75,69,6,1
2022-03-16,Hai Phong City,Ngo Quyen District,14,130,112,18,1
2022-03-16,Hai Phong City,Ngo Quyen District,15,143,125,18,2
2022-03-16,Hai Phong City,Ngo Quyen District,16,135,126,9,0
2022-03-16,Hai Phong City,Ngo Quyen District,17,129,120,9,0
2022-03-16,Hai Phong City,Ngo Quyen District,18,168,153,15,1
2022-03-16,Hai Phong City,Ngo Quyen District,19,142,133,9,1
2022-03-16,Hai Phong City,Ngo Quyen District,20,110,96,14,1
2022-03-16,Hai Phong City,Ngo Quyen District,21,53,42,11,2
2022-03-16,Hai Phong City,Ngo Quyen District,22,1,0,1,0
2022-03-16,Hai Phong City,Ngo Quyen District,23,1,1,0,0
2022-03-16,Hai Phong City,Thuy Nguyen,10,4,1,3,2
2022-03-16,Hai Phong City,Thuy Nguyen,11,1,1,0,0
2022-03-16,Hai Phong City,Thuy Nguyen,12,2,0,2,2
2022-03-16,Hai Phong City,Thuy Nguyen,13,1,0,1,1
2022-03-16,Hai Phong City,Thuy Nguyen,15,1,0,1,1
2022-03-16,Hai Phong City,Thuy Nguyen,17,1,1,0,0
2022-03-16,Hai Phong City,Thuy Nguyen,18,1,0,1,1
2022-03-16,Hue City,Hue City,0,1,1,0,0
2022-03-16,Hue City,Hue City,1,2,2,0,0
2022-03-16,Hue City,Hue City,2,1,1,0,0
2022-03-16,Hue City,Hue City,5,2,2,0,0
2022-03-16,Hue City,Hue City,6,80,68,12,1
2022-03-16,Hue City,Hue City,7,201,188,13,0
2022-03-16,Hue City,Hue City,8,321,296,25,0
2022-03-16,Hue City,Hue City,9,225,208,17,1
2022-03-16,Hue City,Hue City,10,421,400,21,0
2022-03-16,Hue City,Hue City,11,836,783,53,1
2022-03-16,Hue City,Hue City,12,473,451,22,0
2022-03-16,Hue City,Hue City,13,277,263,14,1
2022-03-16,Hue City,Hue City,14,307,288,19,0
2022-03-16,Hue City,Hue City,15,386,359,27,2
2022-03-16,Hue City,Hue City,16,441,417,24,6
2022-03-16,Hue City,Hue City,17,563,537,26,1
2022-03-16,Hue City,Hue City,18,620,586,34,1
2022-03-16,Hue City,Hue City,19,565,517,48,2
2022-03-16,Hue City,Hue City,20,389,362,27,2
2022-03-16,Hue City,Hue City,21,212,185,27,4
2022-03-16,Hue City,Hue City,22,5,3,2,0
2022-03-16,Hue City,Hue City,23,4,1,3,0
2022-03-16,Hue City,Huong Thuy,11,1,1,0,0
2022-03-16,Hue City,Huong Thuy,16,1,0,1,1
2022-03-16,Hue City,Huong Thuy,18,3,0,3,2
2022-03-16,Hue City,Huong Thuy,20,1,0,1,1
2022-03-16,Hue City,Huong Thuy,21,1,1,0,0
2022-03-16,Hue City,Huong Tra,14,1,0,1,0
2022-03-16,Hue City,Huong Tra,16,2,2,0,0
2022-03-16,Hue City,Huong Tra,19,1,1,0,0
2022-03-16,Hue City,Phu Vang,6,3,2,1,1
2022-03-16,Hue City,Phu Vang,7,1,0,1,1
2022-03-16,Hue City,Phu Vang,9,2,1,1,0
2022-03-16,Hue City,Phu Vang,10,1,1,0,0
2022-03-16,Hue City,Phu Vang,11,1,1,0,0
2022-03-16,Hue City,Phu Vang,13,1,1,0,0
2022-03-16,Hue City,Phu Vang,14,1,1,0,0
2022-03-16,Hue City,Phu Vang,15,1,0,1,1
2022-03-16,Hue City,Phu Vang,17,3,2,1,0
2022-03-16,Hue City,Phu Vang,19,4,3,1,0
2022-03-16,Hue City,Phu Vang,20,2,2,0,0
2022-03-16,Hue City,Phu Vang,21,2,1,1,0
2022-03-16,Vung Tau,Ba Ria City,7,1,1,0,0
2022-03-16,Vung Tau,Ba Ria City,8,3,2,1,0
2022-03-16,Vung Tau,Ba Ria City,9,2,2,0,0
2022-03-16,Vung Tau,Ba Ria City,10,3,2,1,1
2022-03-16,Vung Tau,Ba Ria City,11,3,3,0,0
2022-03-16,Vung Tau,Ba Ria City,12,5,3,2,1
2022-03-16,Vung Tau,Ba Ria City,13,4,4,0,0
2022-03-16,Vung Tau,Ba Ria City,14,5,3,2,0
2022-03-16,Vung Tau,Ba Ria City,15,4,4,0,0
2022-03-16,Vung Tau,Ba Ria City,16,3,2,1,0
2022-03-16,Vung Tau,Ba Ria City,17,4,2,2,0
2022-03-16,Vung Tau,Ba Ria City,18,6,5,1,1
2022-03-16,Vung Tau,Ba Ria City,19,3,3,0,0
2022-03-16,Vung Tau,Ba Ria City,21,1,0,1,1
2022-03-16,Vung Tau,Vung Tau City,0,4,1,3,0
2022-03-16,Vung Tau,Vung Tau City,2,1,0,1,0
2022-03-16,Vung Tau,Vung Tau City,4,3,2,1,0
2022-03-16,Vung Tau,Vung Tau City,6,44,43,1,0
2022-03-16,Vung Tau,Vung Tau City,7,128,123,5,2
2022-03-16,Vung Tau,Vung Tau City,8,149,134,15,0
2022-03-16,Vung Tau,Vung Tau City,9,158,143,15,0
2022-03-16,Vung Tau,Vung Tau City,10,199,182,17,2
2022-03-16,Vung Tau,Vung Tau City,11,346,320,26,1
2022-03-16,Vung Tau,Vung Tau City,12,226,216,10,0
2022-03-16,Vung Tau,Vung Tau City,13,167,157,10,0
2022-03-16,Vung Tau,Vung Tau City,14,202,188,14,2
2022-03-16,Vung Tau,Vung Tau City,15,179,167,12,0
2022-03-16,Vung Tau,Vung Tau City,16,190,180,10,1
2022-03-16,Vung Tau,Vung Tau City,17,283,245,38,8
2022-03-16,Vung Tau,Vung Tau City,18,312,284,28,2
2022-03-16,Vung Tau,Vung Tau City,19,210,196,14,1
2022-03-16,Vung Tau,Vung Tau City,20,171,145,26,8
2022-03-16,Vung Tau,Vung Tau City,21,88,69,19,9
2022-03-16,Vung Tau,Vung Tau City,22,4,2,2,0
2022-03-17,Binh Duong,Ben Cat,10,2,0,2,2
2022-03-17,Binh Duong,Ben Cat,11,1,1,0,0
2022-03-17,Binh Duong,Ben Cat,12,3,0,3,3
2022-03-17,Binh Duong,Ben Cat,13,2,1,1,1
2022-03-17,Binh Duong,Ben Cat,14,1,0,1,1
2022-03-17,Binh Duong,Ben Cat,15,2,0,2,2
2022-03-17,Binh Duong,Ben Cat,16,3,1,2,2
2022-03-17,Binh Duong,Ben Cat,17,2,0,2,2
2022-03-17,Binh Duong,Ben Cat,18,5,1,4,4
2022-03-17,Binh Duong,Di An,5,2,0,2,0
2022-03-17,Binh Duong,Di An,6,1,0,1,1
2022-03-17,Binh Duong,Di An,7,6,1,5,5
2022-03-17,Binh Duong,Di An,8,11,3,8,7
2022-03-17,Binh Duong,Di An,9,17,6,11,11
2022-03-17,Binh Duong,Di An,10,23,17,6,4
2022-03-17,Binh Duong,Di An,11,29,16,13,9
2022-03-17,Binh Duong,Di An,12,25,15,10,7
2022-03-17,Binh Duong,Di An,13,20,8,12,11
2022-03-17,Binh Duong,Di An,14,18,8,10,9
2022-03-17,Binh Duong,Di An,15,19,8,11,8
2022-03-17,Binh Duong,Di An,16,16,6,10,8
2022-03-17,Binh Duong,Di An,17,31,14,17,13
2022-03-17,Binh Duong,Di An,18,18,10,8,3
2022-03-17,Binh Duong,Di An,19,13,7,6,5
2022-03-17,Binh Duong,Di An,20,8,4,4,3
2022-03-17,Binh Duong,Di An,21,4,2,2,2
2022-03-17,Binh Duong,Tan Uyen,6,1,0,1,1
2022-03-17,Binh Duong,Tan Uyen,9,2,0,2,1
2022-03-17,Binh Duong,Tan Uyen,10,3,0,3,2
2022-03-17,Binh Duong,Tan Uyen,11,4,1,3,3
2022-03-17,Binh Duong,Tan Uyen,12,2,2,0,0
2022-03-17,Binh Duong,Tan Uyen,13,2,1,1,1
2022-03-17,Binh Duong,Tan Uyen,14,4,2,2,2
2022-03-17,Binh Duong,Tan Uyen,15,3,1,2,1
2022-03-17,Binh Duong,Tan Uyen,16,3,1,2,2
2022-03-17,Binh Duong,Tan Uyen,17,6,4,2,2
2022-03-17,Binh Duong,Tan Uyen,18,3,1,2,1
2022-03-17,Binh Duong,Tan Uyen,19,1,1,0,0
2022-03-17,Binh Duong,Tan Uyen,20,1,0,1,0
2022-03-17,Binh Duong,Tan Uyen,21,1,0,1,1
2022-03-17,Binh Duong,Thu Dau Mot Town,0,5,0,5,0
2022-03-17,Binh Duong,Thu Dau Mot Town,1,1,1,0,0
2022-03-17,Binh Duong,Thu Dau Mot Town,4,1,1,0,0
2022-03-17,Binh Duong,Thu Dau Mot Town,6,38,18,20,10
2022-03-17,Binh Duong,Thu Dau Mot Town,7,89,83,6,1
2022-03-17,Binh Duong,Thu Dau Mot Town,8,191,176,15,1
2022-03-17,Binh Duong,Thu Dau Mot Town,9,233,210,23,7
2022-03-17,Binh Duong,Thu Dau Mot Town,10,433,395,38,9
2022-03-17,Binh Duong,Thu Dau Mot Town,11,614,568,46,9
2022-03-17,Binh Duong,Thu Dau Mot Town,12,384,364,20,3
2022-03-17,Binh Duong,Thu Dau Mot Town,13,375,358,17,3
2022-03-17,Binh Duong,Thu Dau Mot Town,14,302,286,16,5
2022-03-17,Binh Duong,Thu Dau Mot Town,15,210,196,14,3
2022-03-17,Binh Duong,Thu Dau Mot Town,16,305,284,21,3
2022-03-17,Binh Duong,Thu Dau Mot Town,17,400,374,26,3
2022-03-17,Binh Duong,Thu Dau Mot Town,18,395,366,29,3
2022-03-17,Binh Duong,Thu Dau Mot Town,19,388,353,35,8
2022-03-17,Binh Duong,Thu Dau Mot Town,20,211,185,26,6
2022-03-17,Binh Duong,Thu Dau Mot Town,21,86,79,7,1
2022-03-17,Binh Duong,Thu Dau Mot Town,22,3,0,3,2
2022-03-17,Binh Duong,Thuan An,6,1,0,1,0
2022-03-17,Binh Duong,Thuan An,7,7,4,3,3
2022-03-17,Binh Duong,Thuan An,8,18,11,7,6
2022-03-17,Binh Duong,Thuan An,9,24,14,10,6
2022-03-17,Binh Duong,Thuan An,10,45,24,21,18
2022-03-17,Binh Duong,Thuan An,11,103,53,50,35
2022-03-17,Binh Duong,Thuan An,12,57,37,20,14
2022-03-17,Binh Duong,Thuan An,13,70,40,30,20
2022-03-17,Binh Duong,Thuan An,14,50,29,21,14
2022-03-17,Binh Duong,Thuan An,15,31,20,11,8
2022-03-17,Binh Duong,Thuan An,16,32,17,15,11
2022-03-17,Binh Duong,Thuan An,17,50,29,21,15
2022-03-17,Binh Duong,Thuan An,18,44,29,15,12
2022-03-17,Binh Duong,Thuan An,19,35,20,15,10
2022-03-17,Binh Duong,Thuan An,20,17,13,4,2
2022-03-17,Binh Duong,Thuan An,21,18,6,12,9
2022-03-17,Binh Duong,Thuan An,22,1,0,1,1
2022-03-17,Can Tho City,Binh Thuy District,7,1,1,0,0
2022-03-17,Can Tho City,Binh Thuy District,8,3,3,0,0
2022-03-17,Can Tho City,Binh Thuy District,9,9,8,1,0
2022-03-17,Can Tho City,Binh Thuy District,10,7,7,0,0
2022-03-17,Can Tho City,Binh Thuy District,11,13,12,1,0
2022-03-17,Can Tho City,Binh Thuy District,12,13,13,0,0
2022-03-17,Can Tho City,Binh Thuy District,13,6,5,1,0
2022-03-17,Can Tho City,Binh Thuy District,14,7,7,0,0
2022-03-17,Can Tho City,Binh Thuy District,15,11,11,0,0
2022-03-17,Can Tho City,Binh Thuy District,16,5,3,2,0
2022-03-17,Can Tho City,Binh Thuy District,17,11,10,1,0
2022-03-17,Can Tho City,Binh Thuy District,18,18,17,1,0
2022-03-17,Can Tho City,Binh Thuy District,19,11,10,1,0
2022-03-17,Can Tho City,Binh Thuy District,20,7,7,0,0
2022-03-17,Can Tho City,Binh Thuy District,21,2,2,0,0
2022-03-17,Can Tho City,Cai Rang District,6,1,0,1,1
2022-03-17,Can Tho City,Cai Rang District,7,4,3,1,0
2022-03-17,Can Tho City,Cai Rang District,8,5,5,0,0
2022-03-17,Can Tho City,Cai Rang District,9,6,4,2,2
2022-03-17,Can Tho City,Cai Rang District,10,6,6,0,0
2022-03-17,Can Tho City,Cai Rang District,11,11,11,0,0
2022-03-17,Can Tho City,Cai Rang District,12,11,10,1,0
2022-03-17,Can Tho City,Cai Rang District,13,11,9,2,1
2022-03-17,Can Tho City,Cai Rang District,14,4,3,1,1
2022-03-17,Can Tho City,Cai Rang District,15,11,9,2,1
2022-03-17,Can Tho City,Cai Rang District,16,8,8,0,0
2022-03-17,Can Tho City,Cai Rang District,17,10,8,2,0
2022-03-17,Can Tho City,Cai Rang District,18,7,6,1,0
2022-03-17,Can Tho City,Cai Rang District,19,9,8,1,0
2022-03-17,Can Tho City,Cai Rang District,20,8,8,0,0
2022-03-17,Can Tho City,Cai Rang District,21,2,2,0,0
2022-03-17,Can Tho City,Ninh Kieu District,0,5,2,3,0
2022-03-17,Can Tho City,Ninh Kieu District,1,1,0,1,0
2022-03-17,Can Tho City,Ninh Kieu District,3,1,1,0,0
2022-03-17,Can Tho City,Ninh Kieu District,4,1,0,1,0
2022-03-17,Can Tho City,Ninh Kieu District,5,1,1,0,0
2022-03-17,Can Tho City,Ninh Kieu District,6,41,36,5,2
2022-03-17,Can Tho City,Ninh Kieu District,7,125,117,8,0
2022-03-17,Can Tho City,Ninh Kieu District,8,273,250,23,0
2022-03-17,Can Tho City,Ninh Kieu District,9,343,323,20,0
2022-03-17,Can Tho City,Ninh Kieu District,10,587,550,37,0
2022-03-17,Can Tho City,Ninh Kieu District,11,894,848,46,3
2022-03-17,Can Tho City,Ninh Kieu District,12,547,516,31,0
2022-03-17,Can Tho City,Ninh Kieu District,13,488,470,18,0
2022-03-17,Can Tho City,Ninh Kieu District,14,382,356,26,0
2022-03-17,Can Tho City,Ninh Kieu District,15,362,349,13,0
2022-03-17,Can Tho City,Ninh Kieu District,16,480,454,26,1
2022-03-17,Can Tho City,Ninh Kieu District,17,602,571,31,0
2022-03-17,Can Tho City,Ninh Kieu District,18,561,537,24,0
2022-03-17,Can Tho City,Ninh Kieu District,19,470,444,26,1
2022-03-17,Can Tho City,Ninh Kieu District,20,362,334,28,0
2022-03-17,Can Tho City,Ninh Kieu District,21,165,151,14,1
2022-03-17,Can Tho City,Ninh Kieu District,22,5,2,3,0
2022-03-17,Can Tho City,Ninh Kieu District,23,1,1,0,0
2022-03-17,Dong Nai,Bien Hoa City,0,4,2,2,1
2022-03-17,Dong Nai,Bien Hoa City,2,1,0,1,1
2022-03-17,Dong Nai,Bien Hoa City,3,1,0,1,1
2022-03-17,Dong Nai,Bien Hoa City,4,4,2,2,2
2022-03-17,Dong Nai,Bien Hoa City,5,2,1,1,1
2022-03-17,Dong Nai,Bien Hoa City,6,47,29,18,12
2022-03-17,Dong Nai,Bien Hoa City,7,164,118,46,22
2022-03-17,Dong Nai,Bien Hoa City,8,287,238,49,11
2022-03-17,Dong Nai,Bien Hoa City,9,375,334,41,7
2022-03-17,Dong Nai,Bien Hoa City,10,729,656,73,16
2022-03-17,Dong Nai,Bien Hoa City,11,1044,922,122,36
2022-03-17,Dong Nai,Bien Hoa City,12,719,659,60,9
2022-03-17,Dong Nai,Bien Hoa City,13,740,670,70,23
2022-03-17,Dong Nai,Bien Hoa City,14,503,452,51,6
2022-03-17,Dong Nai,Bien Hoa City,15,484,418,66,24
2022-03-17,Dong Nai,Bien Hoa City,16,498,433,65,31
2022-03-17,Dong Nai,Bien Hoa City,17,605,519,86,31
2022-03-17,Dong Nai,Bien Hoa City,18,663,589,74,33
2022-03-17,Dong Nai,Bien Hoa City,19,588,525,63,18
2022-03-17,Dong Nai,Bien Hoa City,20,416,334,82,28
2022-03-17,Dong Nai,Bien Hoa City,21,192,133,59,34
2022-03-17,Dong Nai,Bien Hoa City,22,3,1,2,0
2022-03-17,Dong Nai,Bien Hoa City,23,3,1,2,0
2022-03-17,Dong Nai,Long Thanh,9,1,0,1,1
2022-03-17,Dong Nai,Long Thanh,10,4,0,4,4
2022-03-17,Dong Nai,Long Thanh,12,6,0,6,4
2022-03-17,Dong Nai,Long Thanh,14,2,0,2,2
2022-03-17,Dong Nai,Long Thanh,15,1,0,1,1
2022-03-17,Dong Nai,Long Thanh,20,1,0,1,1
2022-03-17,Dong Nai,Thong Nhat,11,2,2,0,0
2022-03-17,Dong Nai,Thong Nhat,12,2,2,0,0
2022-03-17,Dong Nai,Thong Nhat,13,7,2,5,0
2022-03-17,Dong Nai,Thong Nhat,17,2,1,1,0
2022-03-17,Dong Nai,Thong Nhat,18,2,2,0,0
2022-03-17,Dong Nai,Trang Bom,13,4,2,2,2
2022-03-17,Dong Nai,Trang Bom,17,2,0,2,0
2022-03-17,Hai Phong City,An Duong,7,1,0,1,1
2022-03-17,Hai Phong City,An Duong,8,2,0,2,1
2022-03-17,Hai Phong City,An Duong,9,4,1,3,0
2022-03-17,Hai Phong City,An Duong,10,5,1,4,3
2022-03-17,Hai Phong City,An Duong,11,7,4,3,3
2022-03-17,Hai Phong City,An Duong,12,1,1,0,0
2022-03-17,Hai Phong City,An Duong,13,1,0,1,1
2022-03-17,Hai Phong City,An Duong,14,5,0,5,4
2022-03-17,Hai Phong City,An Duong,15,4,3,1,1
2022-03-17,Hai Phong City,An Duong,16,2,2,0,0
2022-03-17,Hai Phong City,An Duong,17,1,1,0,0
2022-03-17,Hai Phong City,An Duong,18,1,1,0,0
2022-03-17,Hai Phong City,An Duong,20,1,1,0,0
2022-03-17,Hai Phong City,An Duong,21,3,1,2,1
2022-03-17,Hai Phong City,Duong Kinh District,16,1,0,1,1
2022-03-17,Hai Phong City,Hai An District,7,3,2,1,0
2022-03-17,Hai Phong City,Hai An District,8,15,11,4,1
2022-03-17,Hai Phong City,Hai An District,9,9,9,0,0
2022-03-17,Hai Phong City,Hai An District,10,13,13,0,0
2022-03-17,Hai Phong City,Hai An District,11,44,41,3,1
2022-03-17,Hai Phong City,Hai An District,12,20,19,1,1
2022-03-17,Hai Phong City,Hai An District,13,18,15,3,0
2022-03-17,Hai Phong City,Hai An District,14,10,8,2,1
2022-03-17,Hai Phong City,Hai An District,15,15,11,4,0
2022-03-17,Hai Phong City,Hai An District,16,13,13,0,0
2022-03-17,Hai Phong City,Hai An District,17,22,17,5,0
2022-03-17,Hai Phong City,Hai An District,18,27,24,3,1
2022-03-17,Hai Phong City,Hai An District,19,15,14,1,0
2022-03-17,Hai Phong City,Hai An District,20,15,13,2,1
2022-03-17,Hai Phong City,Hai An District,21,7,5,2,2
2022-03-17,Hai Phong City,Hong Bang District,2,1,0,1,1
2022-03-17,Hai Phong City,Hong Bang District,3,1,1,0,0
2022-03-17,Hai Phong City,Hong Bang District,7,15,10,5,2
2022-03-17,Hai Phong City,Hong Bang District,8,15,14,1,0
2022-03-17,Hai Phong City,Hong Bang District,9,26,25,1,1
2022-03-17,Hai Phong City,Hong Bang District,10,59,53,6,1
2022-03-17,Hai Phong City,Hong Bang District,11,95,84,11,3
2022-03-17,Hai Phong City,Hong Bang District,12,51,47,4,0
2022-03-17,Hai Phong City,Hong Bang District,13,36,31,5,1
2022-03-17,Hai Phong City,Hong Bang District,14,36,30,6,2
2022-03-17,Hai Phong City,Hong Bang District,15,31,31,0,0
2022-03-17,Hai Phong City,Hong Bang District,16,35,33,2,0
2022-03-17,Hai Phong City,Hong Bang District,17,43,39,4,0
2022-03-17,Hai Phong City,Hong Bang District,18,47,41,6,2
2022-03-17,Hai Phong City,Hong Bang District,19,48,43,5,0
2022-03-17,Hai Phong City,Hong Bang District,20,33,28,5,1
2022-03-17,Hai Phong City,Hong Bang District,21,11,9,2,1
2022-03-17,Hai Phong City,Hong Bang District,22,1,0,1,0
2022-03-17,Hai Phong City,Kien An District,8,3,1,2,1
2022-03-17,Hai Phong City,Kien An District,9,8,4,4,1
2022-03-17,Hai Phong City,Kien An District,10,8,5,3,0
2022-03-17,Hai Phong City,Kien An District,11,6,5,1,0
2022-03-17,Hai Phong City,Kien An District,12,7,5,2,2
2022-03-17,Hai Phong City,Kien An District,13,4,3,1,1
2022-03-17,Hai Phong City,Kien An District,14,11,7,4,3
2022-03-17,Hai Phong City,Kien An District,15,7,6,1,1
2022-03-17,Hai Phong City,Kien An District,16,3,3,0,0
2022-03-17,Hai Phong City,Kien An District,17,2,2,0,0
2022-03-17,Hai Phong City,Kien An District,18,8,5,3,2
2022-03-17,Hai Phong City,Kien An District,19,13,11,2,0
2022-03-17,Hai Phong City,Kien An District,20,7,4,3,2
2022-03-17,Hai Phong City,Kien An District,21,6,0,6,3
2022-03-17,Hai Phong City,Le Chan District,6,5,3,2,0
2022-03-17,Hai Phong City,Le Chan District,7,27,23,4,1
2022-03-17,Hai Phong City,Le Chan District,8,65,61,4,0
2022-03-17,Hai Phong City,Le Chan District,9,68,61,7,0
2022-03-17,Hai Phong City,Le Chan District,10,132,120,12,2
2022-03-17,Hai Phong City,Le Chan District,11,282,255,27,8
2022-03-17,Hai Phong City,Le Chan District,12,149,137,12,3
2022-03-17,Hai Phong City,Le Chan District,13,77,72,5,0
2022-03-17,Hai Phong City,Le Chan District,14,106,97,9,2
2022-03-17,Hai Phong City,Le Chan District,15,118,112,6,0
2022-03-17,Hai Phong City,Le Chan District,16,141,134,7,0
2022-03-17,Hai Phong City,Le Chan District,17,151,143,8,0
2022-03-17,Hai Phong City,Le Chan District,18,205,179,26,4
2022-03-17,Hai Phong City,Le Chan District,19,146,130,16,2
2022-03-17,Hai Phong City,Le Chan District,20,116,105,11,4
2022-03-17,Hai Phong City,Le Chan District,21,64,47,17,4
2022-03-17,Hai Phong City,Ngo Quyen District,0,1,1,0,0
2022-03-17,Hai Phong City,Ngo Quyen District,6,1,1,0,0
2022-03-17,Hai Phong City,Ngo Quyen District,7,14,13,1,1
2022-03-17,Hai Phong City,Ngo Quyen District,8,61,53,8,0
2022-03-17,Hai Phong City,Ngo Quyen District,9,76,71,5,0
2022-03-17,Hai Phong City,Ngo Quyen District,10,106,96,10,2
2022-03-17,Hai Phong City,Ngo Quyen District,11,217,210,7,1
2022-03-17,Hai Phong City,Ngo Quyen District,12,108,103,5,0
2022-03-17,Hai Phong City,Ngo Quyen District,13,106,96,10,0
2022-03-17,Hai Phong City,Ngo Quyen District,14,110,106,4,0
2022-03-17,Hai Phong City,Ngo Quyen District,15,129,122,7,0
2022-03-17,Hai Phong City,Ngo Quyen District,16,106,93,13,1
2022-03-17,Hai Phong City,Ngo Quyen District,17,97,89,8,1
2022-03-17,Hai Phong City,Ngo Quyen District,18,167,147,20,2
2022-03-17,Hai Phong City,Ngo Quyen District,19,127,115,12,1
2022-03-17,Hai Phong City,Ngo Quyen District,20,109,99,10,1
2022-03-17,Hai Phong City,Ngo Quyen District,21,54,44,10,2
2022-03-17,Hai Phong City,Ngo Quyen District,22,3,2,1,0
2022-03-17,Hai Phong City,Thuy Nguyen,11,2,0,2,1
2022-03-17,Hai Phong City,Thuy Nguyen,14,1,0,1,1
2022-03-17,Hai Phong City,Thuy Nguyen,19,2,0,2,2
2022-03-17,Hai Phong City,Thuy Nguyen,20,1,0,1,1
2022-03-17,Hue City,Hue City,2,1,1,0,0
2022-03-17,Hue City,Hue City,5,7,4,3,0
2022-03-17,Hue City,Hue City,6,58,52,6,1
2022-03-17,Hue City,Hue City,7,173,158,15,0
2022-03-17,Hue City,Hue City,8,273,248,25,0
2022-03-17,Hue City,Hue City,9,220,202,18,2
2022-03-17,Hue City,Hue City,10,400,371,29,0
2022-03-17,Hue City,Hue City,11,863,806,57,3
2022-03-17,Hue City,Hue City,12,450,420,30,0
2022-03-17,Hue City,Hue City,13,286,265,21,0
2022-03-17,Hue City,Hue City,14,300,284,16,1
2022-03-17,Hue City,Hue City,15,372,346,26,4
2022-03-17,Hue City,Hue City,16,385,358,27,5
2022-03-17,Hue City,Hue City,17,530,496,34,0
2022-03-17,Hue City,Hue City,18,658,600,58,2
2022-03-17,Hue City,Hue City,19,568,518,50,0
2022-03-17,Hue City,Hue City,20,398,367,31,4
2022-03-17,Hue City,Hue City,21,224,189,35,1
2022-03-17,Hue City,Hue City,22,5,1,4,0
2022-03-17,Hue City,Hue City,23,3,1,2,0
2022-03-17,Hue City,Huong Thuy,8,2,0,2,2
2022-03-17,Hue City,Huong Thuy,10,2,1,1,0
2022-03-17,Hue City,Huong Thuy,12,1,1,0,0
2022-03-17,Hue City,Huong Thuy,15,1,0,1,0
2022-03-17,Hue City,Huong Thuy,16,1,1,0,0
2022-03-17,Hue City,Huong Thuy,17,1,1,0,0
2022-03-17,Hue City,Huong Thuy,19,1,1,0,0
2022-03-17,Hue City,Huong Tra,11,1,0,1,0
2022-03-17,Hue City,Huong Tra,15,1,0,1,1
2022-03-17,Hue City,Huong Tra,18,1,1,0,0
2022-03-17,Hue City,Huong Tra,19,1,1,0,0
2022-03-17,Hue City,Phu Vang,6,1,1,0,0
2022-03-17,Hue City,Phu Vang,7,1,1,0,0
2022-03-17,Hue City,Phu Vang,8,1,0,1,0
2022-03-17,Hue City,Phu Vang,9,2,1,1,1
2022-03-17,Hue City,Phu Vang,10,1,1,0,0
2022-03-17,Hue City,Phu Vang,11,3,3,0,0
2022-03-17,Hue City,Phu Vang,12,1,1,0,0
2022-03-17,Hue City,Phu Vang,13,1,1,0,0
2022-03-17,Hue City,Phu Vang,14,1,1,0,0
2022-03-17,Hue City,Phu Vang,15,1,1,0,0
2022-03-17,Hue City,Phu Vang,17,3,3,0,0
2022-03-17,Hue City,Phu Vang,18,3,3,0,0
2022-03-17,Hue City,Phu Vang,19,1,1,0,0
2022-03-17,Hue City,Phu Vang,20,3,3,0,0
2022-03-17,Vung Tau,Ba Ria City,8,3,1,2,1
2022-03-17,Vung Tau,Ba Ria City,9,2,2,0,0
2022-03-17,Vung Tau,Ba Ria City,10,4,3,1,0
2022-03-17,Vung Tau,Ba Ria City,11,6,4,2,0
2022-03-17,Vung Tau,Ba Ria City,12,4,4,0,0
2022-03-17,Vung Tau,Ba Ria City,13,4,4,0,0
2022-03-17,Vung Tau,Ba Ria City,14,3,3,0,0
2022-03-17,Vung Tau,Ba Ria City,15,3,3,0,0
2022-03-17,Vung Tau,Ba Ria City,16,2,2,0,0
2022-03-17,Vung Tau,Ba Ria City,17,5,3,2,1
2022-03-17,Vung Tau,Ba Ria City,18,5,3,2,1
2022-03-17,Vung Tau,Ba Ria City,19,8,2,6,4
2022-03-17,Vung Tau,Ba Ria City,20,1,0,1,1
2022-03-17,Vung Tau,Ba Ria City,21,2,0,2,2
2022-03-17,Vung Tau,Vung Tau City,2,2,2,0,0
2022-03-17,Vung Tau,Vung Tau City,3,1,1,0,0
2022-03-17,Vung Tau,Vung Tau City,5,3,3,0,0
2022-03-17,Vung Tau,Vung Tau City,6,37,30,7,4
2022-03-17,Vung Tau,Vung Tau City,7,104,93,11,1
2022-03-17,Vung Tau,Vung Tau City,8,151,136,15,2
2022-03-17,Vung Tau,Vung Tau City,9,130,120,10,0
2022-03-17,Vung Tau,Vung Tau City,10,197,184,13,0
2022-03-17,Vung Tau,Vung Tau City,11,338,312,26,1
2022-03-17,Vung Tau,Vung Tau City,12,265,244,21,0
2022-03-17,Vung Tau,Vung Tau City,13,185,168,17,2
2022-03-17,Vung Tau,Vung Tau City,14,189,173,16,1
2022-03-17,Vung Tau,Vung Tau City,15,202,181,21,5
2022-03-17,Vung Tau,Vung Tau City,16,188,178,10,0
2022-03-17,Vung Tau,Vung Tau City,17,255,243,12,1
2022-03-17,Vung Tau,Vung Tau City,18,339,309,30,3
2022-03-17,Vung Tau,Vung Tau City,19,232,220,12,1
2022-03-17,Vung Tau,Vung Tau City,20,180,160,20,1
2022-03-17,Vung Tau,Vung Tau City,21,92,66,26,6
2022-03-17,Vung Tau,Vung Tau City,22,4,3,1,0
2022-03-17,Vung Tau,Vung Tau City,23,3,2,1,0
2022-03-18,Binh Duong,Ben Cat,11,1,0,1,0
2022-03-18,Binh Duong,Ben Cat,17,1,0,1,1
2022-03-18,Binh Duong,Ben Cat,18,1,0,1,0
2022-03-18,Binh Duong,Ben Cat,19,1,0,1,1
2022-03-18,Binh Duong,Di An,7,4,0,4,4
2022-03-18,Binh Duong,Di An,8,14,3,11,9
2022-03-18,Binh Duong,Di An,9,15,6,9,9
2022-03-18,Binh Duong,Di An,10,30,19,11,10
2022-03-18,Binh Duong,Di An,11,35,18,17,9
2022-03-18,Binh Duong,Di An,12,22,19,3,1
2022-03-18,Binh Duong,Di An,13,38,21,17,14
2022-03-18,Binh Duong,Di An,14,23,13,10,8
2022-03-18,Binh Duong,Di An,15,13,11,2,1
2022-03-18,Binh Duong,Di An,16,14,11,3,1
2022-03-18,Binh Duong,Di An,17,15,7,8,7
2022-03-18,Binh Duong,Di An,18,25,14,11,7
2022-03-18,Binh Duong,Di An,19,15,6,9,5
2022-03-18,Binh Duong,Di An,20,20,5,15,11
2022-03-18,Binh Duong,Di An,21,11,4,7,3
2022-03-18,Binh Duong,Di An,22,1,0,1,1
2022-03-18,Binh Duong,Tan Uyen,8,1,0,1,1
2022-03-18,Binh Duong,Tan Uyen,9,2,0,2,2
2022-03-18,Binh Duong,Tan Uyen,10,4,2,2,2
2022-03-18,Binh Duong,Tan Uyen,11,1,1,0,0
2022-03-18,Binh Duong,Tan Uyen,14,2,1,1,1
2022-03-18,Binh Duong,Tan Uyen,18,1,0,1,1
2022-03-18,Binh Duong,Tan Uyen,19,2,2,0,0
2022-03-18,Binh Duong,Thu Dau Mot Town,5,1,1,0,0
2022-03-18,Binh Duong,Thu Dau Mot Town,6,46,31,15,11
2022-03-18,Binh Duong,Thu Dau Mot Town,7,96,87,9,2
2022-03-18,Binh Duong,Thu Dau Mot Town,8,236,205,31,4
2022-03-18,Binh Duong,Thu Dau Mot Town,9,240,214,26,2
2022-03-18,Binh Duong,Thu Dau Mot Town,10,373,349,24,6
2022-03-18,Binh Duong,Thu Dau Mot Town,11,565,525,40,9
2022-03-18,Binh Duong,Thu Dau Mot Town,12,405,387,18,6
2022-03-18,Binh Duong,Thu Dau Mot Town,13,366,353,13,0
2022-03-18,Binh Duong,Thu Dau Mot Town,14,341,326,15,1
2022-03-18,Binh Duong,Thu Dau Mot Town,15,264,249,15,2
2022-03-18,Binh Duong,Thu Dau Mot Town,16,287,270,17,2
2022-03-18,Binh Duong,Thu Dau Mot Town,17,375,351,24,5
2022-03-18,Binh Duong,Thu Dau Mot Town,18,360,328,32,2
2022-03-18,Binh Duong,Thu Dau Mot Town,19,324,298,26,4
2022-03-18,Binh Duong,Thu Dau Mot Town,20,269,240,29,3
2022-03-18,Binh Duong,Thu Dau Mot Town,21,96,84,12,5
2022-03-18,Binh Duong,Thu Dau Mot Town,22,6,3,3,0
2022-03-18,Binh Duong,Thu Dau Mot Town,23,1,1,0,0
2022-03-18,Binh Duong,Thuan An,6,5,0,5,3
2022-03-18,Binh Duong,Thuan An,7,6,1,5,5
2022-03-18,Binh Duong,Thuan An,8,23,8,15,12
2022-03-18,Binh Duong,Thuan An,9,45,17,28,21
2022-03-18,Binh Duong,Thuan An,10,55,33,22,18
2022-03-18,Binh Duong,Thuan An,11,87,38,49,43
2022-03-18,Binh Duong,Thuan An,12,52,37,15,10
2022-03-18,Binh Duong,Thuan An,13,49,39,10,6
2022-03-18,Binh Duong,Thuan An,14,54,33,21,15
2022-03-18,Binh Duong,Thuan An,15,37,22,15,9
2022-03-18,Binh Duong,Thuan An,16,39,19,20,17
2022-03-18,Binh Duong,Thuan An,17,46,28,18,16
2022-03-18,Binh Duong,Thuan An,18,43,24,19,15
2022-03-18,Binh Duong,Thuan An,19,39,24,15,11
2022-03-18,Binh Duong,Thuan An,20,26,20,6,6
2022-03-18,Binh Duong,Thuan An,21,18,6,12,10
2022-03-18,Can Tho City,Binh Thuy District,7,2,1,1,0
2022-03-18,Can Tho City,Binh Thuy District,8,4,4,0,0
2022-03-18,Can Tho City,Binh Thuy District,9,5,5,0,0
2022-03-18,Can Tho City,Binh Thuy District,10,16,16,0,0
2022-03-18,Can Tho City,Binh Thuy District,11,14,13,1,0
2022-03-18,Can Tho City,Binh Thuy District,12,3,3,0,0
2022-03-18,Can Tho City,Binh Thuy District,13,13,12,1,0
2022-03-18,Can Tho City,Binh Thuy District,14,9,8,1,0
2022-03-18,Can Tho City,Binh Thuy District,15,11,10,1,0
2022-03-18,Can Tho City,Binh Thuy District,16,6,6,0,0
2022-03-18,Can Tho City,Binh Thuy District,17,10,9,1,0
2022-03-18,Can Tho City,Binh Thuy District,18,13,11,2,0
2022-03-18,Can Tho City,Binh Thuy District,19,16,14,2,0
2022-03-18,Can Tho City,Binh Thuy District,20,10,9,1,0
2022-03-18,Can Tho City,Binh Thuy District,21,6,3,3,1
2022-03-18,Can Tho City,Cai Rang District,6,2,1,1,1
2022-03-18,Can Tho City,Cai Rang District,7,1,1,0,0
2022-03-18,Can Tho City,Cai Rang District,8,5,3,2,1
2022-03-18,Can Tho City,Cai Rang District,9,9,8,1,1
2022-03-18,Can Tho City,Cai Rang District,10,8,8,0,0
2022-03-18,Can Tho City,Cai Rang District,11,17,14,3,1
2022-03-18,Can Tho City,Cai Rang District,12,15,15,0,0
2022-03-18,Can Tho City,Cai Rang District,13,8,7,1,0
2022-03-18,Can Tho City,Cai Rang District,14,7,7,0,0
2022-03-18,Can Tho City,Cai Rang District,15,7,6,1,0
2022-03-18,Can Tho City,Cai Rang District,16,17,14,3,0
2022-03-18,Can Tho City,Cai Rang District,17,12,12,0,0
2022-03-18,Can Tho City,Cai Rang District,18,14,13,1,0
2022-03-18,Can Tho City,Cai Rang District,19,10,10,0,0
2022-03-18,Can Tho City,Cai Rang District,20,7,6,1,0
2022-03-18,Can Tho City,Cai Rang District,21,1,1,0,0
2022-03-18,Can Tho City,Ninh Kieu District,0,9,5,4,0
2022-03-18,Can Tho City,Ninh Kieu District,1,3,2,1,0
2022-03-18,Can Tho City,Ninh Kieu District,2,1,1,0,0
2022-03-18,Can Tho City,Ninh Kieu District,3,3,2,1,0
2022-03-18,Can Tho City,Ninh Kieu District,4,1,0,1,0
2022-03-18,Can Tho City,Ninh Kieu District,5,3,0,3,0
2022-03-18,Can Tho City,Ninh Kieu District,6,46,44,2,0
2022-03-18,Can Tho City,Ninh Kieu District,7,141,139,2,0
2022-03-18,Can Tho City,Ninh Kieu District,8,231,217,14,0
2022-03-18,Can Tho City,Ninh Kieu District,9,313,300,13,0
2022-03-18,Can Tho City,Ninh Kieu District,10,566,545,21,1
2022-03-18,Can Tho City,Ninh Kieu District,11,807,766,41,3
2022-03-18,Can Tho City,Ninh Kieu District,12,589,558,31,0
2022-03-18,Can Tho City,Ninh Kieu District,13,437,419,18,0
2022-03-18,Can Tho City,Ninh Kieu District,14,406,386,20,0
2022-03-18,Can Tho City,Ninh Kieu District,15,357,337,20,1
2022-03-18,Can Tho City,Ninh Kieu District,16,441,421,20,0
2022-03-18,Can Tho City,Ninh Kieu District,17,536,515,21,1
2022-03-18,Can Tho City,Ninh Kieu District,18,541,509,32,0
2022-03-18,Can Tho City,Ninh Kieu District,19,495,476,19,0
2022-03-18,Can Tho City,Ninh Kieu District,20,333,305,28,0
2022-03-18,Can Tho City,Ninh Kieu District,21,171,158,13,2
2022-03-18,Can Tho City,Ninh Kieu District,22,8,3,5,0
2022-03-18,Can Tho City,Ninh Kieu District,23,4,2,2,1
2022-03-18,Dong Nai,Bien Hoa City,0,2,1,1,1
2022-03-18,Dong Nai,Bien Hoa City,1,3,1,2,0
2022-03-18,Dong Nai,Bien Hoa City,3,3,2,1,0
2022-03-18,Dong Nai,Bien Hoa City,4,1,1,0,0
2022-03-18,Dong Nai,Bien Hoa City,5,2,1,1,0
2022-03-18,Dong Nai,Bien Hoa City,6,50,27,23,16
2022-03-18,Dong Nai,Bien Hoa City,7,156,128,28,14
2022-03-18,Dong Nai,Bien Hoa City,8,259,221,38,10
2022-03-18,Dong Nai,Bien Hoa City,9,347,307,40,7
2022-03-18,Dong Nai,Bien Hoa City,10,746,643,103,34
2022-03-18,Dong Nai,Bien Hoa City,11,1028,907,121,51
2022-03-18,Dong Nai,Bien Hoa City,12,719,657,62,9
2022-03-18,Dong Nai,Bien Hoa City,13,679,629,50,16
2022-03-18,Dong Nai,Bien Hoa City,14,600,549,51,9
2022-03-18,Dong Nai,Bien Hoa City,15,485,441,44,12
2022-03-18,Dong Nai,Bien Hoa City,16,466,420,46,13
2022-03-18,Dong Nai,Bien Hoa City,17,632,542,90,29
2022-03-18,Dong Nai,Bien Hoa City,18,652,589,63,13
2022-03-18,Dong Nai,Bien Hoa City,19,630,559,71,22
2022-03-18,Dong Nai,Bien Hoa City,20,434,348,86,33
2022-03-18,Dong Nai,Bien Hoa City,21,209,142,67,30
2022-03-18,Dong Nai,Bien Hoa City,22,2,0,2,0
2022-03-18,Dong Nai,Bien Hoa City,23,4,0,4,0
2022-03-18,Dong Nai,Long Thanh,9,1,0,1,1
2022-03-18,Dong Nai,Long Thanh,11,4,0,4,4
2022-03-18,Dong Nai,Long Thanh,12,1,0,1,1
2022-03-18,Dong Nai,Long Thanh,14,1,0,1,1
2022-03-18,Dong Nai,Long Thanh,15,1,0,1,1
2022-03-18,Dong Nai,Long Thanh,19,2,0,2,2
2022-03-18,Dong Nai,Long Thanh,20,1,0,1,0
2022-03-18,Dong Nai,Nhon trach,10,2,0,2,2
2022-03-18,Dong Nai,Thong Nhat,9,2,2,0,0
2022-03-18,Dong Nai,Thong Nhat,10,2,1,1,0
2022-03-18,Dong Nai,Thong Nhat,11,1,1,0,0
2022-03-18,Dong Nai,Thong Nhat,13,1,1,0,0
2022-03-18,Dong Nai,Thong Nhat,14,2,2,0,0
2022-03-18,Dong Nai,Thong Nhat,15,2,2,0,0
2022-03-18,Dong Nai,Thong Nhat,17,1,1,0,0
2022-03-18,Dong Nai,Thong Nhat,19,1,1,0,0
2022-03-18,Dong Nai,Trang Bom,11,1,1,0,0
2022-03-18,Dong Nai,Trang Bom,14,3,0,3,3
2022-03-18,Hai Phong City,An Duong,7,3,2,1,0
2022-03-18,Hai Phong City,An Duong,8,2,2,0,0
2022-03-18,Hai Phong City,An Duong,9,2,1,1,0
2022-03-18,Hai Phong City,An Duong,10,1,0,1,1
2022-03-18,Hai Phong City,An Duong,11,4,1,3,2
2022-03-18,Hai Phong City,An Duong,12,5,0,5,3
2022-03-18,Hai Phong City,An Duong,13,8,2,6,5
2022-03-18,Hai Phong City,An Duong,14,4,1,3,3
2022-03-18,Hai Phong City,An Duong,15,8,3,5,4
2022-03-18,Hai Phong City,An Duong,16,5,3,2,1
2022-03-18,Hai Phong City,An Duong,17,5,2,3,2
2022-03-18,Hai Phong City,An Duong,18,4,0,4,2
2022-03-18,Hai Phong City,An Duong,21,1,0,1,1
2022-03-18,Hai Phong City,Duong Kinh District,20,1,0,1,1
2022-03-18,Hai Phong City,Hai An District,5,1,0,1,0
2022-03-18,Hai Phong City,Hai An District,7,4,2,2,1
2022-03-18,Hai Phong City,Hai An District,8,12,8,4,1
2022-03-18,Hai Phong City,Hai An District,9,7,7,0,0
2022-03-18,Hai Phong City,Hai An District,10,21,17,4,0
2022-03-18,Hai Phong City,Hai An District,11,46,37,9,4
2022-03-18,Hai Phong City,Hai An District,12,26,26,0,0
2022-03-18,Hai Phong City,Hai An District,13,12,10,2,0
2022-03-18,Hai Phong City,Hai An District,14,21,16,5,3
2022-03-18,Hai Phong City,Hai An District,15,16,15,1,0
2022-03-18,Hai Phong City,Hai An District,16,12,9,3,0
2022-03-18,Hai Phong City,Hai An District,17,20,20,0,0
2022-03-18,Hai Phong City,Hai An District,18,30,26,4,3
2022-03-18,Hai Phong City,Hai An District,19,20,18,2,0
2022-03-18,Hai Phong City,Hai An District,20,13,11,2,0
2022-03-18,Hai Phong City,Hai An District,21,7,4,3,3
2022-03-18,Hai Phong City,Hong Bang District,0,1,0,1,0
2022-03-18,Hai Phong City,Hong Bang District,6,1,1,0,0
2022-03-18,Hai Phong City,Hong Bang District,7,16,14,2,0
2022-03-18,Hai Phong City,Hong Bang District,8,27,27,0,0
2022-03-18,Hai Phong City,Hong Bang District,9,29,26,3,0
2022-03-18,Hai Phong City,Hong Bang District,10,46,36,10,3
2022-03-18,Hai Phong City,Hong Bang District,11,101,89,12,2
2022-03-18,Hai Phong City,Hong Bang District,12,53,46,7,2
2022-03-18,Hai Phong City,Hong Bang District,13,35,31,4,1
2022-03-18,Hai Phong City,Hong Bang District,14,35,27,8,3
2022-03-18,Hai Phong City,Hong Bang District,15,47,33,14,6
2022-03-18,Hai Phong City,Hong Bang District,16,35,32,3,2
2022-03-18,Hai Phong City,Hong Bang District,17,37,33,4,0
2022-03-18,Hai Phong City,Hong Bang District,18,75,64,11,1
2022-03-18,Hai Phong City,Hong Bang District,19,46,40,6,2
2022-03-18,Hai Phong City,Hong Bang District,20,30,25,5,1
2022-03-18,Hai Phong City,Hong Bang District,21,16,14,2,1
2022-03-18,Hai Phong City,Hong Bang District,22,1,1,0,0
2022-03-18,Hai Phong City,Kien An District,7,1,1,0,0
2022-03-18,Hai Phong City,Kien An District,8,2,1,1,0
2022-03-18,Hai Phong City,Kien An District,9,2,1,1,0
2022-03-18,Hai Phong City,Kien An District,10,10,6,4,3
2022-03-18,Hai Phong City,Kien An District,11,12,7,5,3
2022-03-18,Hai Phong City,Kien An District,12,6,6,0,0
2022-03-18,Hai Phong City,Kien An District,13,4,3,1,0
2022-03-18,Hai Phong City,Kien An District,14,7,7,0,0
2022-03-18,Hai Phong City,Kien An District,15,3,3,0,0
2022-03-18,Hai Phong City,Kien An District,16,8,6,2,1
2022-03-18,Hai Phong City,Kien An District,17,9,5,4,2
2022-03-18,Hai Phong City,Kien An District,18,13,8,5,4
2022-03-18,Hai Phong City,Kien An District,19,6,6,0,0
2022-03-18,Hai Phong City,Kien An District,20,10,10,0,0
2022-03-18,Hai Phong City,Kien An District,21,4,4,0,0
2022-03-18,Hai Phong City,Le Chan District,2,1,1,0,0
2022-03-18,Hai Phong City,Le Chan District,4,1,0,1,1
2022-03-18,Hai Phong City,Le Chan District,6,3,2,1,1
2022-03-18,Hai Phong City,Le Chan District,7,31,25,6,0
2022-03-18,Hai Phong City,Le Chan District,8,50,46,4,0
2022-03-18,Hai Phong City,Le Chan District,9,53,47,6,0
2022-03-18,Hai Phong City,Le Chan District,10,137,124,13,2
2022-03-18,Hai Phong City,Le Chan District,11,286,248,38,5
2022-03-18,Hai Phong City,Le Chan District,12,157,143,14,0
2022-03-18,Hai Phong City,Le Chan District,13,106,93,13,0
2022-03-18,Hai Phong City,Le Chan District,14,119,108,11,4
2022-03-18,Hai Phong City,Le Chan District,15,161,137,24,7
2022-03-18,Hai Phong City,Le Chan District,16,142,122,20,2
2022-03-18,Hai Phong City,Le Chan District,17,162,146,16,1
2022-03-18,Hai Phong City,Le Chan District,18,204,180,24,3
2022-03-18,Hai Phong City,Le Chan District,19,180,165,15,3
2022-03-18,Hai Phong City,Le Chan District,20,133,120,13,4
2022-03-18,Hai Phong City,Le Chan District,21,72,58,14,3
2022-03-18,Hai Phong City,Ngo Quyen District,0,2,0,2,0
2022-03-18,Hai Phong City,Ngo Quyen District,1,1,0,1,0
2022-03-18,Hai Phong City,Ngo Quyen District,2,1,0,1,0
2022-03-18,Hai Phong City,Ngo Quyen District,7,16,14,2,1
2022-03-18,Hai Phong City,Ngo Quyen District,8,77,66,11,4
2022-03-18,Hai Phong City,Ngo Quyen District,9,79,71,8,0
2022-03-18,Hai Phong City,Ngo Quyen District,10,123,111,12,1
2022-03-18,Hai Phong City,Ngo Quyen District,11,228,206,22,5
2022-03-18,Hai Phong City,Ngo Quyen District,12,119,115,4,1
2022-03-18,Hai Phong City,Ngo Quyen District,13,120,108,12,0
2022-03-18,Hai Phong City,Ngo Quyen District,14,137,129,8,0
2022-03-18,Hai Phong City,Ngo Quyen District,15,150,124,26,9
2022-03-18,Hai Phong City,Ngo Quyen District,16,127,113,14,1
2022-03-18,Hai Phong City,Ngo Quyen District,17,109,98,11,0
2022-03-18,Hai Phong City,Ngo Quyen District,18,168,149,19,4
2022-03-18,Hai Phong City,Ngo Quyen District,19,155,138,17,6
2022-03-18,Hai Phong City,Ngo Quyen District,20,137,121,16,2
2022-03-18,Hai Phong City,Ngo Quyen District,21,56,44,12,4
2022-03-18,Hai Phong City,Ngo Quyen District,23,1,1,0,0
2022-03-18,Hai Phong City,Thuy Nguyen,8,1,0,1,1
2022-03-18,Hai Phong City,Thuy Nguyen,11,1,0,1,1
2022-03-18,Hai Phong City,Thuy Nguyen,12,2,1,1,1
2022-03-18,Hai Phong City,Thuy Nguyen,13,1,0,1,1
2022-03-18,Hai Phong City,Thuy Nguyen,17,1,0,1,1
2022-03-18,Hai Phong City,Thuy Nguyen,18,2,0,2,2
2022-03-18,Hai Phong City,Thuy Nguyen,19,3,0,3,2
2022-03-18,Hue City,Hue City,0,4,3,1,0
2022-03-18,Hue City,Hue City,1,7,6,1,0
2022-03-18,Hue City,Hue City,2,1,1,0,0
2022-03-18,Hue City,Hue City,4,3,3,0,0
2022-03-18,Hue City,Hue City,5,1,1,0,0
2022-03-18,Hue City,Hue City,6,67,55,12,6
2022-03-18,Hue City,Hue City,7,229,208,21,0
2022-03-18,Hue City,Hue City,8,280,263,17,0
2022-03-18,Hue City,Hue City,9,241,219,22,0
2022-03-18,Hue City,Hue City,10,374,354,20,0
2022-03-18,Hue City,Hue City,11,860,797,63,2
2022-03-18,Hue City,Hue City,12,442,416,26,0
2022-03-18,Hue City,Hue City,13,281,266,15,0
2022-03-18,Hue City,Hue City,14,367,332,35,6
2022-03-18,Hue City,Hue City,15,443,415,28,2
2022-03-18,Hue City,Hue City,16,550,527,23,5
2022-03-18,Hue City,Hue City,17,726,655,71,13
2022-03-18,Hue City,Hue City,18,766,664,102,30
2022-03-18,Hue City,Hue City,19,633,561,72,11
2022-03-18,Hue City,Hue City,20,470,402,68,8
2022-03-18,Hue City,Hue City,21,235,199,36,6
2022-03-18,Hue City,Hue City,23,4,2,2,0
2022-03-18,Hue City,Huong Thuy,5,2,1,1,0
2022-03-18,Hue City,Huong Thuy,10,1,0,1,1
2022-03-18,Hue City,Huong Thuy,11,2,0,2,0
2022-03-18,Hue City,Huong Thuy,14,1,1,0,0
2022-03-18,Hue City,Huong Thuy,15,3,2,1,1
2022-03-18,Hue City,Huong Thuy,16,1,1,0,0
2022-03-18,Hue City,Huong Thuy,18,1,1,0,0
2022-03-18,Hue City,Huong Thuy,20,3,1,2,0
2022-03-18,Hue City,Huong Tra,14,1,0,1,1
2022-03-18,Hue City,Phu Vang,6,1,1,0,0
2022-03-18,Hue City,Phu Vang,7,3,3,0,0
2022-03-18,Hue City,Phu Vang,10,1,0,1,0
2022-03-18,Hue City,Phu Vang,11,4,1,3,1
2022-03-18,Hue City,Phu Vang,12,1,1,0,0
2022-03-18,Hue City,Phu Vang,13,3,2,1,1
2022-03-18,Hue City,Phu Vang,14,1,0,1,1
2022-03-18,Hue City,Phu Vang,15,1,1,0,0
2022-03-18,Hue City,Phu Vang,16,1,1,0,0
2022-03-18,Hue City,Phu Vang,18,5,4,1,0
2022-03-18,Hue City,Phu Vang,19,2,2,0,0
2022-03-18,Hue City,Phu Vang,20,2,1,1,0
2022-03-18,Hue City,Phu Vang,21,1,0,1,1
2022-03-18,Vung Tau,Ba Ria City,7,3,2,1,1
2022-03-18,Vung Tau,Ba Ria City,8,2,1,1,1
2022-03-18,Vung Tau,Ba Ria City,9,3,3,0,0
2022-03-18,Vung Tau,Ba Ria City,10,11,8,3,0
2022-03-18,Vung Tau,Ba Ria City,11,7,5,2,2
2022-03-18,Vung Tau,Ba Ria City,12,2,0,2,2
2022-03-18,Vung Tau,Ba Ria City,13,3,3,0,0
2022-03-18,Vung Tau,Ba Ria City,14,2,1,1,1
2022-03-18,Vung Tau,Ba Ria City,15,5,4,1,1
2022-03-18,Vung Tau,Ba Ria City,16,5,4,1,1
2022-03-18,Vung Tau,Ba Ria City,17,4,3,1,1
2022-03-18,Vung Tau,Ba Ria City,18,7,5,2,0
2022-03-18,Vung Tau,Ba Ria City,19,9,5,4,2
2022-03-18,Vung Tau,Ba Ria City,20,1,0,1,0
2022-03-18,Vung Tau,Vung Tau City,3,1,1,0,0
2022-03-18,Vung Tau,Vung Tau City,5,1,1,0,0
2022-03-18,Vung Tau,Vung Tau City,6,33,31,2,0
2022-03-18,Vung Tau,Vung Tau City,7,107,102,5,0
2022-03-18,Vung Tau,Vung Tau City,8,153,143,10,0
2022-03-18,Vung Tau,Vung Tau City,9,158,144,14,1
2022-03-18,Vung Tau,Vung Tau City,10,172,155,17,0
2022-03-18,Vung Tau,Vung Tau City,11,299,276,23,4
2022-03-18,Vung Tau,Vung Tau City,12,263,258,5,0
2022-03-18,Vung Tau,Vung Tau City,13,197,187,10,1
2022-03-18,Vung Tau,Vung Tau City,14,212,197,15,4
2022-03-18,Vung Tau,Vung Tau City,15,234,211,23,3
2022-03-18,Vung Tau,Vung Tau City,16,184,174,10,0
2022-03-18,Vung Tau,Vung Tau City,17,283,271,12,5
2022-03-18,Vung Tau,Vung Tau City,18,293,277,16,4
2022-03-18,Vung Tau,Vung Tau City,19,264,244,20,3
2022-03-18,Vung Tau,Vung Tau City,20,184,150,34,18
2022-03-18,Vung Tau,Vung Tau City,21,114,74,40,19
2022-03-18,Vung Tau,Vung Tau City,22,4,2,2,0
2022-03-18,Vung Tau,Vung Tau City,23,2,2,0,0
2022-03-19,Binh Duong,Ben Cat,11,1,0,1,1
2022-03-19,Binh Duong,Ben Cat,12,1,1,0,0
2022-03-19,Binh Duong,Ben Cat,14,2,0,2,2
2022-03-19,Binh Duong,Ben Cat,15,1,0,1,1
2022-03-19,Binh Duong,Ben Cat,17,1,0,1,1
2022-03-19,Binh Duong,Di An,7,5,0,5,5
2022-03-19,Binh Duong,Di An,8,4,0,4,3
2022-03-19,Binh Duong,Di An,9,25,8,17,15
2022-03-19,Binh Duong,Di An,10,45,8,37,36
2022-03-19,Binh Duong,Di An,11,49,10,39,39
2022-03-19,Binh Duong,Di An,12,44,13,31,25
2022-03-19,Binh Duong,Di An,13,25,9,16,13
2022-03-19,Binh Duong,Di An,14,24,13,11,10
2022-03-19,Binh Duong,Di An,15,21,11,10,10
2022-03-19,Binh Duong,Di An,16,9,8,1,1
2022-03-19,Binh Duong,Di An,17,30,10,20,16
2022-03-19,Binh Duong,Di An,18,34,12,22,19
2022-03-19,Binh Duong,Di An,19,27,13,14,13
2022-03-19,Binh Duong,Di An,20,17,5,12,10
2022-03-19,Binh Duong,Di An,21,11,2,9,8
2022-03-19,Binh Duong,Tan Uyen,9,2,0,2,2
2022-03-19,Binh Duong,Tan Uyen,10,3,0,3,3
2022-03-19,Binh Duong,Tan Uyen,11,5,1,4,2
2022-03-19,Binh Duong,Tan Uyen,14,4,1,3,2
2022-03-19,Binh Duong,Tan Uyen,16,1,0,1,1
2022-03-19,Binh Duong,Tan Uyen,17,4,2,2,1
2022-03-19,Binh Duong,Tan Uyen,18,3,2,1,1
2022-03-19,Binh Duong,Thu Dau Mot Town,1,3,2,1,0
2022-03-19,Binh Duong,Thu Dau Mot Town,3,1,0,1,0
2022-03-19,Binh Duong,Thu Dau Mot Town,5,2,0,2,2
2022-03-19,Binh Duong,Thu Dau Mot Town,6,34,18,16,14
2022-03-19,Binh Duong,Thu Dau Mot Town,7,117,103,14,5
2022-03-19,Binh Duong,Thu Dau Mot Town,8,193,168,25,4
2022-03-19,Binh Duong,Thu Dau Mot Town,9,262,240,22,8
2022-03-19,Binh Duong,Thu Dau Mot Town,10,419,384,35,7
2022-03-19,Binh Duong,Thu Dau Mot Town,11,645,604,41,9
2022-03-19,Binh Duong,Thu Dau Mot Town,12,498,472,26,5
2022-03-19,Binh Duong,Thu Dau Mot Town,13,405,379,26,3
2022-03-19,Binh Duong,Thu Dau Mot Town,14,323,301,22,6
2022-03-19,Binh Duong,Thu Dau Mot Town,15,264,253,11,2
2022-03-19,Binh Duong,Thu Dau Mot Town,16,306,288,18,0
2022-03-19,Binh Duong,Thu Dau Mot Town,17,329,303,26,5
2022-03-19,Binh Duong,Thu Dau Mot Town,18,389,360,29,5
2022-03-19,Binh Duong,Thu Dau Mot Town,19,345,315,30,3
2022-03-19,Binh Duong,Thu Dau Mot Town,20,268,232,36,13
2022-03-19,Binh Duong,Thu Dau Mot Town,21,111,88,23,6
2022-03-19,Binh Duong,Thu Dau Mot Town,22,4,1,3,0
2022-03-19,Binh Duong,Thuan An,6,3,0,3,3
2022-03-19,Binh Duong,Thuan An,7,7,4,3,3
2022-03-19,Binh Duong,Thuan An,8,26,9,17,14
2022-03-19,Binh Duong,Thuan An,9,30,16,14,9
2022-03-19,Binh Duong,Thuan An,10,61,31,30,22
2022-03-19,Binh Duong,Thuan An,11,97,55,42,28
2022-03-19,Binh Duong,Thuan An,12,44,25,19,15
2022-03-19,Binh Duong,Thuan An,13,57,32,25,20
2022-03-19,Binh Duong,Thuan An,14,61,22,39,31
2022-03-19,Binh Duong,Thuan An,15,36,27,9,6
2022-03-19,Binh Duong,Thuan An,16,34,21,13,7
2022-03-19,Binh Duong,Thuan An,17,40,23,17,15
2022-03-19,Binh Duong,Thuan An,18,47,31,16,10
2022-03-19,Binh Duong,Thuan An,19,57,31,26,23
2022-03-19,Binh Duong,Thuan An,20,22,10,12,8
2022-03-19,Binh Duong,Thuan An,21,23,1,22,19
2022-03-19,Binh Duong,Thuan An,22,1,0,1,0
2022-03-19,Can Tho City,Binh Thuy District,6,2,0,2,2
2022-03-19,Can Tho City,Binh Thuy District,8,1,1,0,0
2022-03-19,Can Tho City,Binh Thuy District,9,9,9,0,0
2022-03-19,Can Tho City,Binh Thuy District,10,9,9,0,0
2022-03-19,Can Tho City,Binh Thuy District,11,10,10,0,0
2022-03-19,Can Tho City,Binh Thuy District,12,8,7,1,0
2022-03-19,Can Tho City,Binh Thuy District,13,14,14,0,0
2022-03-19,Can Tho City,Binh Thuy District,14,6,5,1,1
2022-03-19,Can Tho City,Binh Thuy District,15,11,9,2,2
2022-03-19,Can Tho City,Binh Thuy District,16,15,12,3,0
2022-03-19,Can Tho City,Binh Thuy District,17,5,5,0,0
2022-03-19,Can Tho City,Binh Thuy District,18,15,14,1,0
2022-03-19,Can Tho City,Binh Thuy District,19,12,12,0,0
2022-03-19,Can Tho City,Binh Thuy District,20,7,7,0,0
2022-03-19,Can Tho City,Binh Thuy District,21,2,1,1,1
2022-03-19,Can Tho City,Cai Rang District,6,2,0,2,1
2022-03-19,Can Tho City,Cai Rang District,7,9,5,4,3
2022-03-19,Can Tho City,Cai Rang District,8,4,4,0,0
2022-03-19,Can Tho City,Cai Rang District,9,5,5,0,0
2022-03-19,Can Tho City,Cai Rang District,10,10,9,1,0
2022-03-19,Can Tho City,Cai Rang District,11,15,13,2,0
2022-03-19,Can Tho City,Cai Rang District,12,9,7,2,0
2022-03-19,Can Tho City,Cai Rang District,13,10,9,1,0
2022-03-19,Can Tho City,Cai Rang District,14,17,17,0,0
2022-03-19,Can Tho City,Cai Rang District,15,12,12,0,0
2022-03-19,Can Tho City,Cai Rang District,16,14,12,2,0
2022-03-19,Can Tho City,Cai Rang District,17,17,16,1,1
2022-03-19,Can Tho City,Cai Rang District,18,15,15,0,0
2022-03-19,Can Tho City,Cai Rang District,19,12,9,3,3
2022-03-19,Can Tho City,Cai Rang District,20,7,6,1,0
2022-03-19,Can Tho City,Cai Rang District,21,8,4,4,3
2022-03-19,Can Tho City,Ninh Kieu District,0,2,1,1,0
2022-03-19,Can Tho City,Ninh Kieu District,1,3,0,3,0
2022-03-19,Can Tho City,Ninh Kieu District,2,3,2,1,0
2022-03-19,Can Tho City,Ninh Kieu District,5,2,2,0,0
2022-03-19,Can Tho City,Ninh Kieu District,6,49,45,4,2
2022-03-19,Can Tho City,Ninh Kieu District,7,158,142,16,1
2022-03-19,Can Tho City,Ninh Kieu District,8,265,237,28,0
2022-03-19,Can Tho City,Ninh Kieu District,9,310,291,19,0
2022-03-19,Can Tho City,Ninh Kieu District,10,558,546,12,0
2022-03-19,Can Tho City,Ninh Kieu District,11,819,785,34,2
2022-03-19,Can Tho City,Ninh Kieu District,12,615,591,24,4
2022-03-19,Can Tho City,Ninh Kieu District,13,441,419,22,0
2022-03-19,Can Tho City,Ninh Kieu District,14,390,370,20,0
2022-03-19,Can Tho City,Ninh Kieu District,15,425,405,20,0
2022-03-19,Can Tho City,Ninh Kieu District,16,458,443,15,0
2022-03-19,Can Tho City,Ninh Kieu District,17,527,508,19,1
2022-03-19,Can Tho City,Ninh Kieu District,18,552,533,19,0
2022-03-19,Can Tho City,Ninh Kieu District,19,488,463,25,0
2022-03-19,Can Tho City,Ninh Kieu District,20,337,308,29,1
2022-03-19,Can Tho City,Ninh Kieu District,21,162,143,19,2
2022-03-19,Can Tho City,Ninh Kieu District,22,5,2,3,0
2022-03-19,Can Tho City,Ninh Kieu District,23,1,1,0,0
2022-03-19,Dong Nai,Bien Hoa City,0,3,2,1,0
2022-03-19,Dong Nai,Bien Hoa City,1,1,0,1,0
2022-03-19,Dong Nai,Bien Hoa City,2,2,1,1,0
2022-03-19,Dong Nai,Bien Hoa City,3,1,1,0,0
2022-03-19,Dong Nai,Bien Hoa City,5,1,1,0,0
2022-03-19,Dong Nai,Bien Hoa City,6,33,26,7,5
2022-03-19,Dong Nai,Bien Hoa City,7,164,127,37,21
2022-03-19,Dong Nai,Bien Hoa City,8,260,228,32,9
2022-03-19,Dong Nai,Bien Hoa City,9,467,397,70,21
2022-03-19,Dong Nai,Bien Hoa City,10,870,741,129,57
2022-03-19,Dong Nai,Bien Hoa City,11,1081,955,126,54
2022-03-19,Dong Nai,Bien Hoa City,12,914,823,91,27
2022-03-19,Dong Nai,Bien Hoa City,13,761,674,87,27
2022-03-19,Dong Nai,Bien Hoa City,14,540,490,50,17
2022-03-19,Dong Nai,Bien Hoa City,15,511,446,65,21
2022-03-19,Dong Nai,Bien Hoa City,16,511,455,56,18
2022-03-19,Dong Nai,Bien Hoa City,17,654,561,93,49
2022-03-19,Dong Nai,Bien Hoa City,18,860,634,226,168
2022-03-19,Dong Nai,Bien Hoa City,19,780,552,228,140
2022-03-19,Dong Nai,Bien Hoa City,20,612,418,194,137
2022-03-19,Dong Nai,Bien Hoa City,21,260,159,101,59
2022-03-19,Dong Nai,Bien Hoa City,22,2,1,1,0
2022-03-19,Dong Nai,Dinh Quan,15,1,0,1,1
2022-03-19,Dong Nai,Long Thanh,10,4,0,4,4
2022-03-19,Dong Nai,Long Thanh,12,2,0,2,1
2022-03-19,Dong Nai,Long Thanh,17,3,0,3,3
2022-03-19,Dong Nai,Long Thanh,18,1,0,1,1
2022-03-19,Dong Nai,Long Thanh,19,2,0,2,2
2022-03-19,Dong Nai,Nhon trach,9,1,0,1,1
2022-03-19,Dong Nai,Nhon trach,10,1,0,1,1
2022-03-19,Dong Nai,Nhon trach,14,1,0,1,1
2022-03-19,Dong Nai,Nhon trach,19,1,0,1,1
2022-03-19,Dong Nai,Thong Nhat,8,1,1,0,0
2022-03-19,Dong Nai,Thong Nhat,9,1,1,0,0
2022-03-19,Dong Nai,Thong Nhat,10,2,2,0,0
2022-03-19,Dong Nai,Thong Nhat,11,2,1,1,1
2022-03-19,Dong Nai,Thong Nhat,13,2,2,0,0
2022-03-19,Dong Nai,Thong Nhat,15,4,4,0,0
2022-03-19,Dong Nai,Thong Nhat,17,1,1,0,0
2022-03-19,Dong Nai,Thong Nhat,18,2,1,1,1
2022-03-19,Dong Nai,Thong Nhat,19,3,2,1,1
2022-03-19,Dong Nai,Trang Bom,7,1,0,1,1
2022-03-19,Dong Nai,Trang Bom,10,1,0,1,1
2022-03-19,Dong Nai,Trang Bom,13,3,1,2,1
2022-03-19,Dong Nai,Trang Bom,14,1,1,0,0
2022-03-19,Dong Nai,Trang Bom,15,1,1,0,0
2022-03-19,Dong Nai,Trang Bom,19,2,0,2,1
2022-03-19,Hai Phong City,An Duong,8,5,2,3,3
2022-03-19,Hai Phong City,An Duong,9,4,2,2,2
2022-03-19,Hai Phong City,An Duong,10,1,1,0,0
2022-03-19,Hai Phong City,An Duong,11,1,0,1,1
2022-03-19,Hai Phong City,An Duong,12,2,0,2,2
2022-03-19,Hai Phong City,An Duong,13,4,1,3,3
2022-03-19,Hai Phong City,An Duong,14,6,2,4,4
2022-03-19,Hai Phong City,An Duong,15,6,2,4,3
2022-03-19,Hai Phong City,An Duong,16,4,4,0,0
2022-03-19,Hai Phong City,An Duong,17,2,2,0,0
2022-03-19,Hai Phong City,An Duong,18,3,2,1,1
2022-03-19,Hai Phong City,An Duong,19,1,0,1,1
2022-03-19,Hai Phong City,An Duong,20,4,0,4,4
2022-03-19,Hai Phong City,Hai An District,7,4,3,1,1
2022-03-19,Hai Phong City,Hai An District,8,16,10,6,1
2022-03-19,Hai Phong City,Hai An District,9,11,7,4,1
2022-03-19,Hai Phong City,Hai An District,10,17,13,4,0
2022-03-19,Hai Phong City,Hai An District,11,32,31,1,1
2022-03-19,Hai Phong City,Hai An District,12,40,37,3,0
2022-03-19,Hai Phong City,Hai An District,13,13,12,1,0
2022-03-19,Hai Phong City,Hai An District,14,15,15,0,0
2022-03-19,Hai Phong City,Hai An District,15,7,6,1,0
2022-03-19,Hai Phong City,Hai An District,16,22,19,3,0
2022-03-19,Hai Phong City,Hai An District,17,26,23,3,3
2022-03-19,Hai Phong City,Hai An District,18,30,25,5,1
2022-03-19,Hai Phong City,Hai An District,19,22,17,5,3
2022-03-19,Hai Phong City,Hai An District,20,21,18,3,1
2022-03-19,Hai Phong City,Hai An District,21,7,6,1,1
2022-03-19,Hai Phong City,Hong Bang District,7,9,6,3,1
2022-03-19,Hai Phong City,Hong Bang District,8,29,25,4,0
2022-03-19,Hai Phong City,Hong Bang District,9,29,24,5,0
2022-03-19,Hai Phong City,Hong Bang District,10,40,36,4,1
2022-03-19,Hai Phong City,Hong Bang District,11,91,85,6,3
2022-03-19,Hai Phong City,Hong Bang District,12,48,44,4,2
2022-03-19,Hai Phong City,Hong Bang District,13,27,22,5,1
2022-03-19,Hai Phong City,Hong Bang District,14,33,31,2,0
2022-03-19,Hai Phong City,Hong Bang District,15,29,25,4,0
2022-03-19,Hai Phong City,Hong Bang District,16,30,28,2,0
2022-03-19,Hai Phong City,Hong Bang District,17,51,47,4,1
2022-03-19,Hai Phong City,Hong Bang District,18,70,55,15,7
2022-03-19,Hai Phong City,Hong Bang District,19,37,31,6,3
2022-03-19,Hai Phong City,Hong Bang District,20,33,23,10,6
2022-03-19,Hai Phong City,Hong Bang District,21,19,14,5,2
2022-03-19,Hai Phong City,Hong Bang District,22,1,1,0,0
2022-03-19,Hai Phong City,Hong Bang District,23,1,1,0,0
2022-03-19,Hai Phong City,Kien An District,7,2,0,2,1
2022-03-19,Hai Phong City,Kien An District,8,8,5,3,2
2022-03-19,Hai Phong City,Kien An District,9,8,4,4,2
2022-03-19,Hai Phong City,Kien An District,10,10,7,3,0
2022-03-19,Hai Phong City,Kien An District,11,13,9,4,2
2022-03-19,Hai Phong City,Kien An District,12,8,7,1,1
2022-03-19,Hai Phong City,Kien An District,13,14,11,3,3
2022-03-19,Hai Phong City,Kien An District,14,9,6,3,0
2022-03-19,Hai Phong City,Kien An District,15,8,6,2,2
2022-03-19,Hai Phong City,Kien An District,16,14,10,4,0
2022-03-19,Hai Phong City,Kien An District,17,11,9,2,0
2022-03-19,Hai Phong City,Kien An District,18,17,10,7,4
2022-03-19,Hai Phong City,Kien An District,19,8,7,1,0
2022-03-19,Hai Phong City,Kien An District,20,13,5,8,4
2022-03-19,Hai Phong City,Kien An District,21,13,3,10,9
2022-03-19,Hai Phong City,Le Chan District,0,1,1,0,0
2022-03-19,Hai Phong City,Le Chan District,1,2,2,0,0
2022-03-19,Hai Phong City,Le Chan District,6,3,0,3,2
2022-03-19,Hai Phong City,Le Chan District,7,40,33,7,4
2022-03-19,Hai Phong City,Le Chan District,8,61,50,11,0
2022-03-19,Hai Phong City,Le Chan District,9,69,57,12,0
2022-03-19,Hai Phong City,Le Chan District,10,150,135,15,2
2022-03-19,Hai Phong City,Le Chan District,11,297,269,28,4
2022-03-19,Hai Phong City,Le Chan District,12,198,180,18,2
2022-03-19,Hai Phong City,Le Chan District,13,100,93,7,0
2022-03-19,Hai Phong City,Le Chan District,14,112,100,12,1
2022-03-19,Hai Phong City,Le Chan District,15,130,120,10,0
2022-03-19,Hai Phong City,Le Chan District,16,149,139,10,1
2022-03-19,Hai Phong City,Le Chan District,17,198,169,29,4
2022-03-19,Hai Phong City,Le Chan District,18,209,178,31,13
2022-03-19,Hai Phong City,Le Chan District,19,181,163,18,4
2022-03-19,Hai Phong City,Le Chan District,20,136,106,30,11
2022-03-19,Hai Phong City,Le Chan District,21,59,50,9,2
2022-03-19,Hai Phong City,Le Chan District,22,2,0,2,0
2022-03-19,Hai Phong City,Ngo Quyen District,0,1,0,1,1
2022-03-19,Hai Phong City,Ngo Quyen District,6,2,1,1,0
2022-03-19,Hai Phong City,Ngo Quyen District,7,35,29,6,2
2022-03-19,Hai Phong City,Ngo Quyen District,8,65,59,6,0
2022-03-19,Hai Phong City,Ngo Quyen District,9,95,82,13,1
2022-03-19,Hai Phong City,Ngo Quyen District,10,143,131,12,1
2022-03-19,Hai Phong City,Ngo Quyen District,11,210,193,17,1
2022-03-19,Hai Phong City,Ngo Quyen District,12,184,169,15,0
2022-03-19,Hai Phong City,Ngo Quyen District,13,111,101,10,0
2022-03-19,Hai Phong City,Ngo Quyen District,14,126,112,14,1
2022-03-19,Hai Phong City,Ngo Quyen District,15,109,104,5,0
2022-03-19,Hai Phong City,Ngo Quyen District,16,117,109,8,1
2022-03-19,Hai Phong City,Ngo Quyen District,17,165,150,15,6
2022-03-19,Hai Phong City,Ngo Quyen District,18,188,150,38,15
2022-03-19,Hai Phong City,Ngo Quyen District,19,174,148,26,4
2022-03-19,Hai Phong City,Ngo Quyen District,20,130,105,25,11
2022-03-19,Hai Phong City,Ngo Quyen District,21,52,42,10,5
2022-03-19,Hai Phong City,Ngo Quyen District,22,3,2,1,1
2022-03-19,Hai Phong City,Ngo Quyen District,23,4,2,2,2
2022-03-19,Hai Phong City,Thuy Nguyen,6,1,0,1,1
2022-03-19,Hai Phong City,Thuy Nguyen,7,1,0,1,1
2022-03-19,Hai Phong City,Thuy Nguyen,8,2,0,2,2
2022-03-19,Hai Phong City,Thuy Nguyen,11,1,0,1,0
2022-03-19,Hai Phong City,Thuy Nguyen,12,1,0,1,0
2022-03-19,Hai Phong City,Thuy Nguyen,13,1,0,1,1
2022-03-19,Hai Phong City,Thuy Nguyen,17,1,0,1,1
2022-03-19,Hai Phong City,Thuy Nguyen,18,5,0,5,4
2022-03-19,Hai Phong City,Thuy Nguyen,19,1,0,1,1
2022-03-19,Hue City,Hue City,0,5,4,1,0
2022-03-19,Hue City,Hue City,1,2,2,0,0
2022-03-19,Hue City,Hue City,3,1,1,0,0
2022-03-19,Hue City,Hue City,4,1,1,0,0
2022-03-19,Hue City,Hue City,5,1,0,1,0
2022-03-19,Hue City,Hue City,6,68,62,6,2
2022-03-19,Hue City,Hue City,7,205,193,12,3
2022-03-19,Hue City,Hue City,8,310,288,22,0
2022-03-19,Hue City,Hue City,9,247,232,15,1
2022-03-19,Hue City,Hue City,10,423,404,19,2
2022-03-19,Hue City,Hue City,11,786,746,40,0
2022-03-19,Hue City,Hue City,12,505,481,24,0
2022-03-19,Hue City,Hue City,13,335,310,25,1
2022-03-19,Hue City,Hue City,14,317,288,29,4
2022-03-19,Hue City,Hue City,15,399,370,29,1
2022-03-19,Hue City,Hue City,16,420,390,30,3
2022-03-19,Hue City,Hue City,17,510,472,38,3
2022-03-19,Hue City,Hue City,18,621,577,44,1
2022-03-19,Hue City,Hue City,19,556,509,47,3
2022-03-19,Hue City,Hue City,20,392,358,34,4
2022-03-19,Hue City,Hue City,21,245,185,60,16
2022-03-19,Hue City,Hue City,22,5,4,1,0
2022-03-19,Hue City,Hue City,23,1,1,0,0
2022-03-19,Hue City,Huong Thuy,8,2,1,1,1
2022-03-19,Hue City,Huong Thuy,9,2,1,1,1
2022-03-19,Hue City,Huong Thuy,11,1,1,0,0
2022-03-19,Hue City,Huong Thuy,12,2,1,1,0
2022-03-19,Hue City,Huong Thuy,15,1,0,1,0
2022-03-19,Hue City,Huong Thuy,16,1,1,0,0
2022-03-19,Hue City,Huong Thuy,17,1,1,0,0
2022-03-19,Hue City,Huong Thuy,18,3,2,1,0
2022-03-19,Hue City,Huong Thuy,19,2,2,0,0
2022-03-19,Hue City,Huong Tra,14,1,1,0,0
2022-03-19,Hue City,Huong Tra,17,1,0,1,0
2022-03-19,Hue City,Huong Tra,18,1,1,0,0
2022-03-19,Hue City,Phu Vang,7,2,2,0,0
2022-03-19,Hue City,Phu Vang,8,1,0,1,0
2022-03-19,Hue City,Phu Vang,10,1,1,0,0
2022-03-19,Hue City,Phu Vang,12,2,1,1,0
2022-03-19,Hue City,Phu Vang,13,3,3,0,0
2022-03-19,Hue City,Phu Vang,14,2,2,0,0
2022-03-19,Hue City,Phu Vang,15,6,2,4,4
2022-03-19,Hue City,Phu Vang,16,2,2,0,0
2022-03-19,Hue City,Phu Vang,18,3,3,0,0
2022-03-19,Hue City,Phu Vang,19,1,1,0,0
2022-03-19,Hue City,Phu Vang,20,4,3,1,1
2022-03-19,Hue City,Phu Vang,21,3,2,1,0
2022-03-19,Vung Tau,Ba Ria City,6,1,0,1,1
2022-03-19,Vung Tau,Ba Ria City,7,2,1,1,1
2022-03-19,Vung Tau,Ba Ria City,8,4,1,3,0
2022-03-19,Vung Tau,Ba Ria City,9,10,5,5,2
2022-03-19,Vung Tau,Ba Ria City,10,11,8,3,2
2022-03-19,Vung Tau,Ba Ria City,11,9,5,4,1
2022-03-19,Vung Tau,Ba Ria City,12,10,7,3,1
2022-03-19,Vung Tau,Ba Ria City,13,7,7,0,0
2022-03-19,Vung Tau,Ba Ria City,14,3,2,1,0
2022-03-19,Vung Tau,Ba Ria City,15,13,6,7,3
2022-03-19,Vung Tau,Ba Ria City,16,8,3,5,3
2022-03-19,Vung Tau,Ba Ria City,17,9,7,2,2
2022-03-19,Vung Tau,Ba Ria City,18,12,5,7,6
2022-03-19,Vung Tau,Ba Ria City,19,5,3,2,0
2022-03-19,Vung Tau,Ba Ria City,20,4,0,4,4
2022-03-19,Vung Tau,Ba Ria City,21,2,0,2,2
2022-03-19,Vung Tau,Vung Tau City,1,4,2,2,0
2022-03-19,Vung Tau,Vung Tau City,6,31,28,3,1
2022-03-19,Vung Tau,Vung Tau City,7,115,112,3,1
2022-03-19,Vung Tau,Vung Tau City,8,180,161,19,1
2022-03-19,Vung Tau,Vung Tau City,9,161,147,14,0
2022-03-19,Vung Tau,Vung Tau City,10,204,190,14,1
2022-03-19,Vung Tau,Vung Tau City,11,349,326,23,6
2022-03-19,Vung Tau,Vung Tau City,12,292,279,13,0
2022-03-19,Vung Tau,Vung Tau City,13,197,189,8,1
2022-03-19,Vung Tau,Vung Tau City,14,202,188,14,2
2022-03-19,Vung Tau,Vung Tau City,15,209,194,15,0
2022-03-19,Vung Tau,Vung Tau City,16,236,219,17,1
2022-03-19,Vung Tau,Vung Tau City,17,309,282,27,8
2022-03-19,Vung Tau,Vung Tau City,18,398,318,80,48
2022-03-19,Vung Tau,Vung Tau City,19,269,236,33,5
2022-03-19,Vung Tau,Vung Tau City,20,200,164,36,5
2022-03-19,Vung Tau,Vung Tau City,21,108,78,30,16
2022-03-19,Vung Tau,Vung Tau City,22,4,2,2,0
2022-03-20,Binh Duong,Ben Cat,11,1,0,1,1
2022-03-20,Binh Duong,Ben Cat,12,1,0,1,1
2022-03-20,Binh Duong,Ben Cat,16,1,0,1,1
2022-03-20,Binh Duong,Ben Cat,17,2,0,2,0
2022-03-20,Binh Duong,Ben Cat,19,1,0,1,0
2022-03-20,Binh Duong,Di An,7,7,0,7,6
2022-03-20,Binh Duong,Di An,8,13,5,8,7
2022-03-20,Binh Duong,Di An,9,23,9,14,12
2022-03-20,Binh Duong,Di An,10,38,18,20,15
2022-03-20,Binh Duong,Di An,11,52,23,29,25
2022-03-20,Binh Duong,Di An,12,38,18,20,12
2022-03-20,Binh Duong,Di An,13,33,15,18,14
2022-03-20,Binh Duong,Di An,14,31,11,20,15
2022-03-20,Binh Duong,Di An,15,27,14,13,11
2022-03-20,Binh Duong,Di An,16,24,12,12,10
2022-03-20,Binh Duong,Di An,17,35,13,22,20
2022-03-20,Binh Duong,Di An,18,19,6,13,13
2022-03-20,Binh Duong,Di An,19,17,7,10,7
2022-03-20,Binh Duong,Di An,20,17,5,12,8
2022-03-20,Binh Duong,Di An,21,9,2,7,5
2022-03-20,Binh Duong,Phu Giao,12,1,0,1,1
2022-03-20,Binh Duong,Tan Uyen,8,1,0,1,1
2022-03-20,Binh Duong,Tan Uyen,9,1,0,1,1
2022-03-20,Binh Duong,Tan Uyen,10,1,1,0,0
2022-03-20,Binh Duong,Tan Uyen,11,2,1,1,1
2022-03-20,Binh Duong,Tan Uyen,12,4,1,3,1
2022-03-20,Binh Duong,Tan Uyen,13,2,1,1,1
2022-03-20,Binh Duong,Tan Uyen,16,3,0,3,3
2022-03-20,Binh Duong,Tan Uyen,17,2,1,1,1
2022-03-20,Binh Duong,Tan Uyen,19,1,1,0,0
2022-03-20,Binh Duong,Thu Dau Mot Town,1,1,0,1,0
2022-03-20,Binh Duong,Thu Dau Mot Town,4,2,1,1,1
2022-03-20,Binh Duong,Thu Dau Mot Town,6,33,22,11,10
2022-03-20,Binh Duong,Thu Dau Mot Town,7,146,119,27,17
2022-03-20,Binh Duong,Thu Dau Mot Town,8,209,190,19,9
2022-03-20,Binh Duong,Thu Dau Mot Town,9,283,261,22,3
2022-03-20,Binh Duong,Thu Dau Mot Town,10,407,376,31,4
2022-03-20,Binh Duong,Thu Dau Mot Town,11,612,535,77,37
2022-03-20,Binh Duong,Thu Dau Mot Town,12,516,478,38,17
2022-03-20,Binh Duong,Thu Dau Mot Town,13,375,347,28,14
2022-03-20,Binh Duong,Thu Dau Mot Town,14,328,284,44,22
2022-03-20,Binh Duong,Thu Dau Mot Town,15,289,263,26,5
2022-03-20,Binh Duong,Thu Dau Mot Town,16,327,304,23,4
2022-03-20,Binh Duong,Thu Dau Mot Town,17,356,315,41,13
2022-03-20,Binh Duong,Thu Dau Mot Town,18,399,364,35,9
2022-03-20,Binh Duong,Thu Dau Mot Town,19,344,303,41,16
2022-03-20,Binh Duong,Thu Dau Mot Town,20,224,202,22,7
2022-03-20,Binh Duong,Thu Dau Mot Town,21,101,81,20,6
2022-03-20,Binh Duong,Thu Dau Mot Town,22,2,0,2,0
2022-03-20,Binh Duong,Thu Dau Mot Town,23,2,0,2,1
2022-03-20,Binh Duong,Thuan An,1,1,0,1,1
2022-03-20,Binh Duong,Thuan An,6,3,1,2,2
2022-03-20,Binh Duong,Thuan An,7,10,2,8,4
2022-03-20,Binh Duong,Thuan An,8,14,9,5,4
2022-03-20,Binh Duong,Thuan An,9,44,20,24,19
2022-03-20,Binh Duong,Thuan An,10,56,25,31,21
2022-03-20,Binh Duong,Thuan An,11,102,40,62,50
2022-03-20,Binh Duong,Thuan An,12,80,36,44,36
2022-03-20,Binh Duong,Thuan An,13,66,28,38,31
2022-03-20,Binh Duong,Thuan An,14,58,17,41,34
2022-03-20,Binh Duong,Thuan An,15,61,21,40,35
2022-03-20,Binh Duong,Thuan An,16,53,26,27,22
2022-03-20,Binh Duong,Thuan An,17,65,30,35,31
2022-03-20,Binh Duong,Thuan An,18,59,29,30,25
2022-03-20,Binh Duong,Thuan An,19,50,27,23,13
2022-03-20,Binh Duong,Thuan An,20,35,6,29,18
2022-03-20,Binh Duong,Thuan An,21,12,4,8,7
2022-03-20,Binh Duong,Thuan An,22,1,0,1,0
2022-03-20,Can Tho City,Binh Thuy District,7,3,1,2,0
2022-03-20,Can Tho City,Binh Thuy District,8,4,4,0,0
2022-03-20,Can Tho City,Binh Thuy District,9,6,6,0,0
2022-03-20,Can Tho City,Binh Thuy District,10,16,16,0,0
2022-03-20,Can Tho City,Binh Thuy District,11,8,8,0,0
2022-03-20,Can Tho City,Binh Thuy District,12,12,10,2,1
2022-03-20,Can Tho City,Binh Thuy District,13,12,11,1,0
2022-03-20,Can Tho City,Binh Thuy District,14,11,11,0,0
2022-03-20,Can Tho City,Binh Thuy District,15,16,14,2,0
2022-03-20,Can Tho City,Binh Thuy District,16,11,11,0,0
2022-03-20,Can Tho City,Binh Thuy District,17,14,12,2,1
2022-03-20,Can Tho City,Binh Thuy District,18,11,8,3,0
2022-03-20,Can Tho City,Binh Thuy District,19,10,8,2,0
2022-03-20,Can Tho City,Binh Thuy District,20,9,8,1,0
2022-03-20,Can Tho City,Binh Thuy District,21,3,3,0,0
2022-03-20,Can Tho City,Cai Rang District,3,1,0,1,1
2022-03-20,Can Tho City,Cai Rang District,4,1,0,1,1
2022-03-20,Can Tho City,Cai Rang District,6,1,0,1,1
2022-03-20,Can Tho City,Cai Rang District,7,2,2,0,0
2022-03-20,Can Tho City,Cai Rang District,8,9,9,0,0
2022-03-20,Can Tho City,Cai Rang District,9,6,6,0,0
2022-03-20,Can Tho City,Cai Rang District,10,14,9,5,0
2022-03-20,Can Tho City,Cai Rang District,11,17,14,3,1
2022-03-20,Can Tho City,Cai Rang District,12,10,9,1,0
2022-03-20,Can Tho City,Cai Rang District,13,8,8,0,0
2022-03-20,Can Tho City,Cai Rang District,14,16,14,2,1
2022-03-20,Can Tho City,Cai Rang District,15,16,14,2,0
2022-03-20,Can Tho City,Cai Rang District,16,17,15,2,0
2022-03-20,Can Tho City,Cai Rang District,17,21,16,5,0
2022-03-20,Can Tho City,Cai Rang District,18,13,9,4,0
2022-03-20,Can Tho City,Cai Rang District,19,7,5,2,0
2022-03-20,Can Tho City,Cai Rang District,20,3,3,0,0
2022-03-20,Can Tho City,Cai Rang District,21,3,2,1,0
2022-03-20,Can Tho City,Ninh Kieu District,0,4,3,1,0
2022-03-20,Can Tho City,Ninh Kieu District,1,2,2,0,0
2022-03-20,Can Tho City,Ninh Kieu District,3,2,0,2,0
2022-03-20,Can Tho City,Ninh Kieu District,5,5,4,1,0
2022-03-20,Can Tho City,Ninh Kieu District,6,49,42,7,0
2022-03-20,Can Tho City,Ninh Kieu District,7,165,144,21,9
2022-03-20,Can Tho City,Ninh Kieu District,8,248,225,23,5
2022-03-20,Can Tho City,Ninh Kieu District,9,337,318,19,0
2022-03-20,Can Tho City,Ninh Kieu District,10,612,588,24,1
2022-03-20,Can Tho City,Ninh Kieu District,11,746,689,57,7
2022-03-20,Can Tho City,Ninh Kieu District,12,668,617,51,15
2022-03-20,Can Tho City,Ninh Kieu District,13,497,476,21,0
2022-03-20,Can Tho City,Ninh Kieu District,14,417,386,31,0
2022-03-20,Can Tho City,Ninh Kieu District,15,422,393,29,0
2022-03-20,Can Tho City,Ninh Kieu District,16,502,458,44,2
2022-03-20,Can Tho City,Ninh Kieu District,17,586,547,39,3
2022-03-20,Can Tho City,Ninh Kieu District,18,558,508,50,8
2022-03-20,Can Tho City,Ninh Kieu District,19,510,450,60,27
2022-03-20,Can Tho City,Ninh Kieu District,20,400,320,80,42
2022-03-20,Can Tho City,Ninh Kieu District,21,178,148,30,13
2022-03-20,Can Tho City,Ninh Kieu District,22,3,0,3,0
2022-03-20,Can Tho City,Ninh Kieu District,23,1,1,0,0
2022-03-20,Dong Nai,Bien Hoa City,0,2,0,2,1
2022-03-20,Dong Nai,Bien Hoa City,1,1,0,1,1
2022-03-20,Dong Nai,Bien Hoa City,2,2,1,1,0
2022-03-20,Dong Nai,Bien Hoa City,3,1,1,0,0
2022-03-20,Dong Nai,Bien Hoa City,5,1,0,1,0
2022-03-20,Dong Nai,Bien Hoa City,6,49,23,26,21
2022-03-20,Dong Nai,Bien Hoa City,7,172,110,62,48
2022-03-20,Dong Nai,Bien Hoa City,8,324,228,96,64
2022-03-20,Dong Nai,Bien Hoa City,9,489,397,92,50
2022-03-20,Dong Nai,Bien Hoa City,10,854,687,167,92
2022-03-20,Dong Nai,Bien Hoa City,11,1184,908,276,165
2022-03-20,Dong Nai,Bien Hoa City,12,934,785,149,80
2022-03-20,Dong Nai,Bien Hoa City,13,686,603,83,36
2022-03-20,Dong Nai,Bien Hoa City,14,516,452,64,16
2022-03-20,Dong Nai,Bien Hoa City,15,546,474,72,27
2022-03-20,Dong Nai,Bien Hoa City,16,582,465,117,66
2022-03-20,Dong Nai,Bien Hoa City,17,676,515,161,104
2022-03-20,Dong Nai,Bien Hoa City,18,824,577,247,171
2022-03-20,Dong Nai,Bien Hoa City,19,771,489,282,185
2022-03-20,Dong Nai,Bien Hoa City,20,513,311,202,144
2022-03-20,Dong Nai,Bien Hoa City,21,220,129,91,66
2022-03-20,Dong Nai,Bien Hoa City,22,1,0,1,0
2022-03-20,Dong Nai,Bien Hoa City,23,2,1,1,1
2022-03-20,Dong Nai,Long Khanh,13,1,0,1,1
2022-03-20,Dong Nai,Long Thanh,9,2,0,2,1
2022-03-20,Dong Nai,Long Thanh,10,1,0,1,1
2022-03-20,Dong Nai,Long Thanh,11,2,0,2,2
2022-03-20,Dong Nai,Long Thanh,12,1,0,1,1
2022-03-20,Dong Nai,Long Thanh,13,4,0,4,4
2022-03-20,Dong Nai,Long Thanh,14,1,0,1,1
2022-03-20,Dong Nai,Long Thanh,16,2,0,2,1
2022-03-20,Dong Nai,Long Thanh,17,3,0,3,1
2022-03-20,Dong Nai,Long Thanh,19,1,0,1,1
2022-03-20,Dong Nai,Thong Nhat,8,1,1,0,0
2022-03-20,Dong Nai,Thong Nhat,10,3,3,0,0
2022-03-20,Dong Nai,Thong Nhat,11,1,1,0,0
2022-03-20,Dong Nai,Thong Nhat,12,2,2,0,0
2022-03-20,Dong Nai,Thong Nhat,15,2,2,0,0
2022-03-20,Dong Nai,Thong Nhat,16,1,1,0,0
2022-03-20,Dong Nai,Thong Nhat,18,1,1,0,0
2022-03-20,Dong Nai,Thong Nhat,19,4,2,2,2
2022-03-20,Dong Nai,Trang Bom,11,1,0,1,1
2022-03-20,Dong Nai,Trang Bom,13,1,0,1,1
2022-03-20,Dong Nai,Trang Bom,15,2,0,2,1
2022-03-20,Hai Phong City,An Duong,7,1,0,1,1
2022-03-20,Hai Phong City,An Duong,10,8,4,4,3
2022-03-20,Hai Phong City,An Duong,11,7,3,4,2
2022-03-20,Hai Phong City,An Duong,12,6,1,5,4
2022-03-20,Hai Phong City,An Duong,13,3,2,1,1
2022-03-20,Hai Phong City,An Duong,14,5,1,4,4
2022-03-20,Hai Phong City,An Duong,15,5,5,0,0
2022-03-20,Hai Phong City,An Duong,16,2,2,0,0
2022-03-20,Hai Phong City,An Duong,17,3,2,1,0
2022-03-20,Hai Phong City,An Duong,18,1,0,1,0
2022-03-20,Hai Phong City,An Duong,19,2,0,2,2
2022-03-20,Hai Phong City,An Duong,20,4,0,4,3
2022-03-20,Hai Phong City,An Duong,21,1,1,0,0
2022-03-20,Hai Phong City,Do Son District,16,1,0,1,1
2022-03-20,Hai Phong City,Hai An District,6,1,1,0,0
2022-03-20,Hai Phong City,Hai An District,7,4,3,1,0
2022-03-20,Hai Phong City,Hai An District,8,13,11,2,1
2022-03-20,Hai Phong City,Hai An District,9,16,9,7,1
2022-03-20,Hai Phong City,Hai An District,10,15,14,1,0
2022-03-20,Hai Phong City,Hai An District,11,50,41,9,6
2022-03-20,Hai Phong City,Hai An District,12,16,15,1,0
2022-03-20,Hai Phong City,Hai An District,13,18,16,2,0
2022-03-20,Hai Phong City,Hai An District,14,12,11,1,1
2022-03-20,Hai Phong City,Hai An District,15,10,10,0,0
2022-03-20,Hai Phong City,Hai An District,16,12,12,0,0
2022-03-20,Hai Phong City,Hai An District,17,16,15,1,0
2022-03-20,Hai Phong City,Hai An District,18,14,11,3,2
2022-03-20,Hai Phong City,Hai An District,19,23,16,7,1
2022-03-20,Hai Phong City,Hai An District,20,13,6,7,2
2022-03-20,Hai Phong City,Hai An District,21,10,7,3,3
2022-03-20,Hai Phong City,Hong Bang District,1,1,1,0,0
2022-03-20,Hai Phong City,Hong Bang District,6,1,1,0,0
2022-03-20,Hai Phong City,Hong Bang District,7,10,5,5,5
2022-03-20,Hai Phong City,Hong Bang District,8,16,8,8,6
2022-03-20,Hai Phong City,Hong Bang District,9,25,16,9,1
2022-03-20,Hai Phong City,Hong Bang District,10,69,53,16,8
2022-03-20,Hai Phong City,Hong Bang District,11,111,83,28,18
2022-03-20,Hai Phong City,Hong Bang District,12,69,53,16,3
2022-03-20,Hai Phong City,Hong Bang District,13,36,30,6,0
2022-03-20,Hai Phong City,Hong Bang District,14,30,29,1,0
2022-03-20,Hai Phong City,Hong Bang District,15,31,28,3,0
2022-03-20,Hai Phong City,Hong Bang District,16,35,30,5,1
2022-03-20,Hai Phong City,Hong Bang District,17,58,48,10,5
2022-03-20,Hai Phong City,Hong Bang District,18,64,42,22,13
2022-03-20,Hai Phong City,Hong Bang District,19,52,41,11,7
2022-03-20,Hai Phong City,Hong Bang District,20,37,30,7,4
2022-03-20,Hai Phong City,Hong Bang District,21,9,7,2,0
2022-03-20,Hai Phong City,Hong Bang District,22,1,1,0,0
2022-03-20,Hai Phong City,Kien An District,3,1,0,1,1
2022-03-20,Hai Phong City,Kien An District,7,3,1,2,1
2022-03-20,Hai Phong City,Kien An District,8,16,4,12,6
2022-03-20,Hai Phong City,Kien An District,9,13,5,8,6
2022-03-20,Hai Phong City,Kien An District,10,12,8,4,4
2022-03-20,Hai Phong City,Kien An District,11,16,10,6,3
2022-03-20,Hai Phong City,Kien An District,12,18,10,8,6
2022-03-20,Hai Phong City,Kien An District,13,10,8,2,2
2022-03-20,Hai Phong City,Kien An District,14,5,3,2,1
2022-03-20,Hai Phong City,Kien An District,15,5,3,2,1
2022-03-20,Hai Phong City,Kien An District,16,5,3,2,2
2022-03-20,Hai Phong City,Kien An District,17,13,9,4,0
2022-03-20,Hai Phong City,Kien An District,18,15,13,2,2
2022-03-20,Hai Phong City,Kien An District,19,6,6,0,0
2022-03-20,Hai Phong City,Kien An District,20,10,9,1,0
2022-03-20,Hai Phong City,Kien An District,21,3,1,2,2
2022-03-20,Hai Phong City,Le Chan District,0,1,1,0,0
2022-03-20,Hai Phong City,Le Chan District,5,3,0,3,0
2022-03-20,Hai Phong City,Le Chan District,6,1,1,0,0
2022-03-20,Hai Phong City,Le Chan District,7,32,24,8,5
2022-03-20,Hai Phong City,Le Chan District,8,77,59,18,9
2022-03-20,Hai Phong City,Le Chan District,9,90,77,13,1
2022-03-20,Hai Phong City,Le Chan District,10,216,181,35,6
2022-03-20,Hai Phong City,Le Chan District,11,345,277,68,37
2022-03-20,Hai Phong City,Le Chan District,12,225,193,32,17
2022-03-20,Hai Phong City,Le Chan District,13,147,133,14,0
2022-03-20,Hai Phong City,Le Chan District,14,126,114,12,0
2022-03-20,Hai Phong City,Le Chan District,15,149,140,9,1
2022-03-20,Hai Phong City,Le Chan District,16,143,128,15,1
2022-03-20,Hai Phong City,Le Chan District,17,207,157,50,30
2022-03-20,Hai Phong City,Le Chan District,18,244,182,62,33
2022-03-20,Hai Phong City,Le Chan District,19,183,140,43,18
2022-03-20,Hai Phong City,Le Chan District,20,109,90,19,8
2022-03-20,Hai Phong City,Le Chan District,21,72,60,12,4
2022-03-20,Hai Phong City,Le Chan District,22,1,0,1,0
2022-03-20,Hai Phong City,Ngo Quyen District,0,1,1,0,0
2022-03-20,Hai Phong City,Ngo Quyen District,6,1,0,1,0
2022-03-20,Hai Phong City,Ngo Quyen District,7,28,23,5,5
2022-03-20,Hai Phong City,Ngo Quyen District,8,83,59,24,16
2022-03-20,Hai Phong City,Ngo Quyen District,9,99,78,21,2
2022-03-20,Hai Phong City,Ngo Quyen District,10,165,137,28,6
2022-03-20,Hai Phong City,Ngo Quyen District,11,260,212,48,19
2022-03-20,Hai Phong City,Ngo Quyen District,12,163,145,18,6
2022-03-20,Hai Phong City,Ngo Quyen District,13,128,120,8,1
2022-03-20,Hai Phong City,Ngo Quyen District,14,116,99,17,1
2022-03-20,Hai Phong City,Ngo Quyen District,15,131,114,17,3
2022-03-20,Hai Phong City,Ngo Quyen District,16,136,129,7,0
2022-03-20,Hai Phong City,Ngo Quyen District,17,173,143,30,14
2022-03-20,Hai Phong City,Ngo Quyen District,18,205,152,53,31
2022-03-20,Hai Phong City,Ngo Quyen District,19,205,168,37,14
2022-03-20,Hai Phong City,Ngo Quyen District,20,110,92,18,5
2022-03-20,Hai Phong City,Ngo Quyen District,21,60,46,14,7
2022-03-20,Hai Phong City,Thuy Nguyen,9,1,0,1,1
2022-03-20,Hai Phong City,Thuy Nguyen,10,2,0,2,2
2022-03-20,Hai Phong City,Thuy Nguyen,11,3,0,3,3
2022-03-20,Hai Phong City,Thuy Nguyen,12,5,0,5,5
2022-03-20,Hai Phong City,Thuy Nguyen,13,3,0,3,2
2022-03-20,Hai Phong City,Thuy Nguyen,17,1,0,1,1
2022-03-20,Hai Phong City,Thuy Nguyen,19,1,0,1,0
2022-03-20,Hai Phong City,Thuy Nguyen,20,1,0,1,0
2022-03-20,Hue City,Hue City,1,1,1,0,0
2022-03-20,Hue City,Hue City,2,1,1,0,0
2022-03-20,Hue City,Hue City,4,1,1,0,0
2022-03-20,Hue City,Hue City,5,2,2,0,0
2022-03-20,Hue City,Hue City,6,61,54,7,1
2022-03-20,Hue City,Hue City,7,208,196,12,0
2022-03-20,Hue City,Hue City,8,299,284,15,0
2022-03-20,Hue City,Hue City,9,292,273,19,0
2022-03-20,Hue City,Hue City,10,433,399,34,0
2022-03-20,Hue City,Hue City,11,742,685,57,2
2022-03-20,Hue City,Hue City,12,496,477,19,0
2022-03-20,Hue City,Hue City,13,324,309,15,0
2022-03-20,Hue City,Hue City,14,345,322,23,1
2022-03-20,Hue City,Hue City,15,388,361,27,3
2022-03-20,Hue City,Hue City,16,423,382,41,1
2022-03-20,Hue City,Hue City,17,604,552,52,3
2022-03-20,Hue City,Hue City,18,777,637,140,64
2022-03-20,Hue City,Hue City,19,603,483,120,44
2022-03-20,Hue City,Hue City,20,419,357,62,5
2022-03-20,Hue City,Hue City,21,239,176,63,9
2022-03-20,Hue City,Hue City,22,7,1,6,0
2022-03-20,Hue City,Huong Thuy,9,1,0,1,0
2022-03-20,Hue City,Huong Thuy,13,3,1,2,1
2022-03-20,Hue City,Huong Thuy,14,2,2,0,0
2022-03-20,Hue City,Huong Thuy,15,2,2,0,0
2022-03-20,Hue City,Huong Thuy,16,1,1,0,0
2022-03-20,Hue City,Huong Thuy,18,1,0,1,0
2022-03-20,Hue City,Huong Thuy,19,1,0,1,0
2022-03-20,Hue City,Huong Tra,9,1,1,0,0
2022-03-20,Hue City,Huong Tra,13,1,1,0,0
2022-03-20,Hue City,Huong Tra,14,1,1,0,0
2022-03-20,Hue City,Phu Vang,7,1,1,0,0
2022-03-20,Hue City,Phu Vang,8,2,1,1,0
2022-03-20,Hue City,Phu Vang,10,1,1,0,0
2022-03-20,Hue City,Phu Vang,11,5,4,1,1
2022-03-20,Hue City,Phu Vang,12,1,1,0,0
2022-03-20,Hue City,Phu Vang,13,2,2,0,0
2022-03-20,Hue City,Phu Vang,15,1,1,0,0
2022-03-20,Hue City,Phu Vang,16,1,1,0,0
2022-03-20,Hue City,Phu Vang,17,1,1,0,0
2022-03-20,Hue City,Phu Vang,18,1,0,1,0
2022-03-20,Hue City,Phu Vang,19,5,2,3,0
2022-03-20,Hue City,Phu Vang,20,3,1,2,2
2022-03-20,Hue City,Phu Vang,21,3,2,1,1
2022-03-20,Vung Tau,Ba Ria City,7,1,0,1,1
2022-03-20,Vung Tau,Ba Ria City,8,1,0,1,1
2022-03-20,Vung Tau,Ba Ria City,9,7,4,3,2
2022-03-20,Vung Tau,Ba Ria City,10,11,6,5,5
2022-03-20,Vung Tau,Ba Ria City,11,13,8,5,4
2022-03-20,Vung Tau,Ba Ria City,12,5,3,2,2
2022-03-20,Vung Tau,Ba Ria City,13,6,4,2,1
2022-03-20,Vung Tau,Ba Ria City,14,5,4,1,0
2022-03-20,Vung Tau,Ba Ria City,15,7,3,4,4
2022-03-20,Vung Tau,Ba Ria City,16,8,2,6,6
2022-03-20,Vung Tau,Ba Ria City,17,6,2,4,3
2022-03-20,Vung Tau,Ba Ria City,18,11,5,6,4
2022-03-20,Vung Tau,Ba Ria City,19,11,2,9,7
2022-03-20,Vung Tau,Ba Ria City,20,2,0,2,2
2022-03-20,Vung Tau,Ba Ria City,21,2,0,2,2
2022-03-20,Vung Tau,Vung Tau City,0,4,2,2,0
2022-03-20,Vung Tau,Vung Tau City,1,1,1,0,0
2022-03-20,Vung Tau,Vung Tau City,2,1,1,0,0
2022-03-20,Vung Tau,Vung Tau City,6,28,23,5,2
2022-03-20,Vung Tau,Vung Tau City,7,130,126,4,1
2022-03-20,Vung Tau,Vung Tau City,8,175,166,9,0
2022-03-20,Vung Tau,Vung Tau City,9,218,196,22,6
2022-03-20,Vung Tau,Vung Tau City,10,258,225,33,10
2022-03-20,Vung Tau,Vung Tau City,11,406,355,51,20
2022-03-20,Vung Tau,Vung Tau City,12,347,320,27,4
2022-03-20,Vung Tau,Vung Tau City,13,239,219,20,3
2022-03-20,Vung Tau,Vung Tau City,14,228,206,22,4
2022-03-20,Vung Tau,Vung Tau City,15,245,219,26,3
2022-03-20,Vung Tau,Vung Tau City,16,219,207,12,2
2022-03-20,Vung Tau,Vung Tau City,17,301,269,32,11
2022-03-20,Vung Tau,Vung Tau City,18,397,310,87,45
2022-03-20,Vung Tau,Vung Tau City,19,253,226,27,8
2022-03-20,Vung Tau,Vung Tau City,20,202,168,34,16
2022-03-20,Vung Tau,Vung Tau City,21,109,63,46,29
2022-03-20,Vung Tau,Vung Tau City,22,4,0,4,1
2022-03-20,Vung Tau,Vung Tau City,23,1,1,0,0
2022-03-21,Binh Duong,Ben Cat,9,1,0,1,1
2022-03-21,Binh Duong,Ben Cat,12,1,0,1,1
2022-03-21,Binh Duong,Ben Cat,15,2,0,2,1
2022-03-21,Binh Duong,Ben Cat,16,1,0,1,1
2022-03-21,Binh Duong,Ben Cat,19,1,0,1,1
2022-03-21,Binh Duong,Di An,7,3,0,3,3
2022-03-21,Binh Duong,Di An,8,17,0,17,14
2022-03-21,Binh Duong,Di An,9,11,2,9,9
2022-03-21,Binh Duong,Di An,10,23,10,13,10
2022-03-21,Binh Duong,Di An,11,38,10,28,22
2022-03-21,Binh Duong,Di An,12,20,3,17,15
2022-03-21,Binh Duong,Di An,13,36,6,30,26
2022-03-21,Binh Duong,Di An,14,26,10,16,11
2022-03-21,Binh Duong,Di An,15,21,4,17,14
2022-03-21,Binh Duong,Di An,16,24,13,11,11
2022-03-21,Binh Duong,Di An,17,18,9,9,9
2022-03-21,Binh Duong,Di An,18,20,13,7,4
2022-03-21,Binh Duong,Di An,19,14,6,8,6
2022-03-21,Binh Duong,Di An,20,3,3,0,0
2022-03-21,Binh Duong,Di An,21,12,2,10,7
2022-03-21,Binh Duong,Di An,22,1,0,1,0
2022-03-21,Binh Duong,Tan Uyen,8,1,0,1,1
2022-03-21,Binh Duong,Tan Uyen,10,3,1,2,2
2022-03-21,Binh Duong,Tan Uyen,11,4,2,2,2
2022-03-21,Binh Duong,Tan Uyen,12,1,1,0,0
2022-03-21,Binh Duong,Tan Uyen,13,4,3,1,1
2022-03-21,Binh Duong,Tan Uyen,14,1,1,0,0
2022-03-21,Binh Duong,Tan Uyen,15,1,1,0,0
2022-03-21,Binh Duong,Tan Uyen,16,3,0,3,0
2022-03-21,Binh Duong,Tan Uyen,17,2,2,0,0
2022-03-21,Binh Duong,Tan Uyen,18,2,2,0,0
2022-03-21,Binh Duong,Tan Uyen,19,2,0,2,1
2022-03-21,Binh Duong,Thu Dau Mot Town,6,15,11,4,4
2022-03-21,Binh Duong,Thu Dau Mot Town,7,103,87,16,3
2022-03-21,Binh Duong,Thu Dau Mot Town,8,160,143,17,4
2022-03-21,Binh Duong,Thu Dau Mot Town,9,245,229,16,1
2022-03-21,Binh Duong,Thu Dau Mot Town,10,339,318,21,3
2022-03-21,Binh Duong,Thu Dau Mot Town,11,611,532,79,34
2022-03-21,Binh Duong,Thu Dau Mot Town,12,411,383,28,2
2022-03-21,Binh Duong,Thu Dau Mot Town,13,357,328,29,5
2022-03-21,Binh Duong,Thu Dau Mot Town,14,329,297,32,6
2022-03-21,Binh Duong,Thu Dau Mot Town,15,255,237,18,8
2022-03-21,Binh Duong,Thu Dau Mot Town,16,251,235,16,1
2022-03-21,Binh Duong,Thu Dau Mot Town,17,346,327,19,2
2022-03-21,Binh Duong,Thu Dau Mot Town,18,317,299,18,1
2022-03-21,Binh Duong,Thu Dau Mot Town,19,320,297,23,1
2022-03-21,Binh Duong,Thu Dau Mot Town,20,222,210,12,1
2022-03-21,Binh Duong,Thu Dau Mot Town,21,97,85,12,1
2022-03-21,Binh Duong,Thu Dau Mot Town,22,1,1,0,0
2022-03-21,Binh Duong,Thu Dau Mot Town,23,1,1,0,0
2022-03-21,Binh Duong,Thuan An,6,2,0,2,1
2022-03-21,Binh Duong,Thuan An,7,2,2,0,0
2022-03-21,Binh Duong,Thuan An,8,18,9,9,6
2022-03-21,Binh Duong,Thuan An,9,27,11,16,12
2022-03-21,Binh Duong,Thuan An,10,63,22,41,30
2022-03-21,Binh Duong,Thuan An,11,86,25,61,54
2022-03-21,Binh Duong,Thuan An,12,75,32,43,38
2022-03-21,Binh Duong,Thuan An,13,70,36,34,26
2022-03-21,Binh Duong,Thuan An,14,44,27,17,12
2022-03-21,Binh Duong,Thuan An,15,46,28,18,12
2022-03-21,Binh Duong,Thuan An,16,32,18,14,9
2022-03-21,Binh Duong,Thuan An,17,32,20,12,9
2022-03-21,Binh Duong,Thuan An,18,44,30,14,8
2022-03-21,Binh Duong,Thuan An,19,26,18,8,7
2022-03-21,Binh Duong,Thuan An,20,27,12,15,10
2022-03-21,Binh Duong,Thuan An,21,10,5,5,1
2022-03-21,Can Tho City,Binh Thuy District,7,1,0,1,0
2022-03-21,Can Tho City,Binh Thuy District,8,4,3,1,1
2022-03-21,Can Tho City,Binh Thuy District,9,7,6,1,0
2022-03-21,Can Tho City,Binh Thuy District,10,7,4,3,2
2022-03-21,Can Tho City,Binh Thuy District,11,7,5,2,0
2022-03-21,Can Tho City,Binh Thuy District,12,10,8,2,0
2022-03-21,Can Tho City,Binh Thuy District,13,10,7,3,3
2022-03-21,Can Tho City,Binh Thuy District,14,9,7,2,1
2022-03-21,Can Tho City,Binh Thuy District,15,11,8,3,2
2022-03-21,Can Tho City,Binh Thuy District,16,18,14,4,2
2022-03-21,Can Tho City,Binh Thuy District,17,13,12,1,0
2022-03-21,Can Tho City,Binh Thuy District,18,11,10,1,0
2022-03-21,Can Tho City,Binh Thuy District,19,11,10,1,0
2022-03-21,Can Tho City,Binh Thuy District,20,4,4,0,0
2022-03-21,Can Tho City,Cai Rang District,2,1,0,1,0
2022-03-21,Can Tho City,Cai Rang District,6,4,0,4,4
2022-03-21,Can Tho City,Cai Rang District,7,6,3,3,0
2022-03-21,Can Tho City,Cai Rang District,8,6,5,1,1
2022-03-21,Can Tho City,Cai Rang District,10,11,11,0,0
2022-03-21,Can Tho City,Cai Rang District,11,15,14,1,0
2022-03-21,Can Tho City,Cai Rang District,12,13,10,3,0
2022-03-21,Can Tho City,Cai Rang District,13,12,8,4,0
2022-03-21,Can Tho City,Cai Rang District,14,5,4,1,0
2022-03-21,Can Tho City,Cai Rang District,15,6,5,1,1
2022-03-21,Can Tho City,Cai Rang District,16,14,8,6,4
2022-03-21,Can Tho City,Cai Rang District,17,15,11,4,0
2022-03-21,Can Tho City,Cai Rang District,18,13,11,2,1
2022-03-21,Can Tho City,Cai Rang District,19,15,14,1,0
2022-03-21,Can Tho City,Cai Rang District,20,3,1,2,1
2022-03-21,Can Tho City,Cai Rang District,21,1,0,1,0
2022-03-21,Can Tho City,Ninh Kieu District,0,3,2,1,0
2022-03-21,Can Tho City,Ninh Kieu District,1,3,3,0,0
2022-03-21,Can Tho City,Ninh Kieu District,2,3,0,3,1
2022-03-21,Can Tho City,Ninh Kieu District,4,1,1,0,0
2022-03-21,Can Tho City,Ninh Kieu District,5,2,1,1,0
2022-03-21,Can Tho City,Ninh Kieu District,6,57,48,9,4
2022-03-21,Can Tho City,Ninh Kieu District,7,157,144,13,2
2022-03-21,Can Tho City,Ninh Kieu District,8,275,252,23,0
2022-03-21,Can Tho City,Ninh Kieu District,9,316,290,26,1
2022-03-21,Can Tho City,Ninh Kieu District,10,550,522,28,1
2022-03-21,Can Tho City,Ninh Kieu District,11,831,770,61,17
2022-03-21,Can Tho City,Ninh Kieu District,12,491,457,34,1
2022-03-21,Can Tho City,Ninh Kieu District,13,410,392,18,2
2022-03-21,Can Tho City,Ninh Kieu District,14,369,355,14,2
2022-03-21,Can Tho City,Ninh Kieu District,15,309,262,47,13
2022-03-21,Can Tho City,Ninh Kieu District,16,455,321,134,99
2022-03-21,Can Tho City,Ninh Kieu District,17,515,443,72,37
2022-03-21,Can Tho City,Ninh Kieu District,18,509,477,32,3
2022-03-21,Can Tho City,Ninh Kieu District,19,484,459,25,2
2022-03-21,Can Tho City,Ninh Kieu District,20,370,346,24,1
2022-03-21,Can Tho City,Ninh Kieu District,21,163,147,16,0
2022-03-21,Can Tho City,Ninh Kieu District,22,4,2,2,0
2022-03-21,Can Tho City,Ninh Kieu District,23,2,2,0,0
2022-03-21,Dong Nai,Bien Hoa City,0,6,3,3,0
2022-03-21,Dong Nai,Bien Hoa City,1,1,0,1,0
2022-03-21,Dong Nai,Bien Hoa City,2,2,1,1,0
2022-03-21,Dong Nai,Bien Hoa City,3,3,1,2,1
2022-03-21,Dong Nai,Bien Hoa City,4,1,1,0,0
2022-03-21,Dong Nai,Bien Hoa City,5,3,2,1,0
2022-03-21,Dong Nai,Bien Hoa City,6,34,17,17,15
2022-03-21,Dong Nai,Bien Hoa City,7,147,115,32,18
2022-03-21,Dong Nai,Bien Hoa City,8,275,236,39,17
2022-03-21,Dong Nai,Bien Hoa City,9,330,283,47,12
2022-03-21,Dong Nai,Bien Hoa City,10,620,569,51,14
2022-03-21,Dong Nai,Bien Hoa City,11,921,830,91,33
2022-03-21,Dong Nai,Bien Hoa City,12,769,683,86,26
2022-03-21,Dong Nai,Bien Hoa City,13,667,583,84,26
2022-03-21,Dong Nai,Bien Hoa City,14,593,505,88,52
2022-03-21,Dong Nai,Bien Hoa City,15,491,417,74,45
2022-03-21,Dong Nai,Bien Hoa City,16,473,407,66,27
2022-03-21,Dong Nai,Bien Hoa City,17,539,471,68,31
2022-03-21,Dong Nai,Bien Hoa City,18,654,580,74,20
2022-03-21,Dong Nai,Bien Hoa City,19,548,477,71,25
2022-03-21,Dong Nai,Bien Hoa City,20,397,332,65,26
2022-03-21,Dong Nai,Bien Hoa City,21,205,127,78,31
2022-03-21,Dong Nai,Bien Hoa City,22,1,0,1,0
2022-03-21,Dong Nai,Bien Hoa City,23,1,1,0,0
2022-03-21,Dong Nai,Long Khanh,17,1,0,1,1
2022-03-21,Dong Nai,Long Khanh,18,1,0,1,1
2022-03-21,Dong Nai,Long Thanh,8,1,0,1,1
2022-03-21,Dong Nai,Long Thanh,9,2,0,2,2
2022-03-21,Dong Nai,Long Thanh,10,1,0,1,1
2022-03-21,Dong Nai,Long Thanh,11,2,0,2,2
2022-03-21,Dong Nai,Long Thanh,13,1,0,1,1
2022-03-21,Dong Nai,Long Thanh,14,4,0,4,4
2022-03-21,Dong Nai,Long Thanh,15,2,0,2,2
2022-03-21,Dong Nai,Long Thanh,16,2,0,2,2
2022-03-21,Dong Nai,Long Thanh,17,3,0,3,3
2022-03-21,Dong Nai,Long Thanh,20,1,0,1,1
2022-03-21,Dong Nai,Nhon trach,9,1,0,1,1
2022-03-21,Dong Nai,Nhon trach,14,1,0,1,1
2022-03-21,Dong Nai,Thong Nhat,9,1,1,0,0
2022-03-21,Dong Nai,Thong Nhat,11,1,1,0,0
2022-03-21,Dong Nai,Thong Nhat,14,1,1,0,0
2022-03-21,Dong Nai,Thong Nhat,15,1,1,0,0
2022-03-21,Dong Nai,Thong Nhat,18,1,1,0,0
2022-03-21,Dong Nai,Thong Nhat,19,1,1,0,0
2022-03-21,Dong Nai,Trang Bom,11,2,0,2,0
2022-03-21,Dong Nai,Trang Bom,12,3,0,3,2
2022-03-21,Dong Nai,Trang Bom,14,2,0,2,2
2022-03-21,Dong Nai,Trang Bom,15,1,0,1,1
2022-03-21,Dong Nai,Trang Bom,18,1,0,1,1
2022-03-21,Dong Nai,Vinh Cuu,13,1,0,1,1
2022-03-21,Hai Phong City,An Duong,8,8,1,7,6
2022-03-21,Hai Phong City,An Duong,11,5,2,3,1
2022-03-21,Hai Phong City,An Duong,12,4,2,2,1
2022-03-21,Hai Phong City,An Duong,13,5,0,5,5
2022-03-21,Hai Phong City,An Duong,14,2,0,2,2
2022-03-21,Hai Phong City,An Duong,15,4,2,2,2
2022-03-21,Hai Phong City,An Duong,17,3,2,1,1
2022-03-21,Hai Phong City,An Duong,18,1,1,0,0
2022-03-21,Hai Phong City,An Duong,20,2,0,2,2
2022-03-21,Hai Phong City,Hai An District,7,8,5,3,1
2022-03-21,Hai Phong City,Hai An District,8,9,9,0,0
2022-03-21,Hai Phong City,Hai An District,9,11,11,0,0
2022-03-21,Hai Phong City,Hai An District,10,21,17,4,2
2022-03-21,Hai Phong City,Hai An District,11,37,33,4,2
2022-03-21,Hai Phong City,Hai An District,12,18,14,4,1
2022-03-21,Hai Phong City,Hai An District,13,8,7,1,0
2022-03-21,Hai Phong City,Hai An District,14,10,9,1,0
2022-03-21,Hai Phong City,Hai An District,15,15,11,4,2
2022-03-21,Hai Phong City,Hai An District,16,5,5,0,0
2022-03-21,Hai Phong City,Hai An District,17,18,18,0,0
2022-03-21,Hai Phong City,Hai An District,18,21,20,1,0
2022-03-21,Hai Phong City,Hai An District,19,13,12,1,1
2022-03-21,Hai Phong City,Hai An District,20,19,15,4,2
2022-03-21,Hai Phong City,Hai An District,21,7,2,5,2
2022-03-21,Hai Phong City,Hong Bang District,1,1,0,1,0
2022-03-21,Hai Phong City,Hong Bang District,6,1,0,1,0
2022-03-21,Hai Phong City,Hong Bang District,7,9,9,0,0
2022-03-21,Hai Phong City,Hong Bang District,8,27,19,8,3
2022-03-21,Hai Phong City,Hong Bang District,9,25,22,3,1
2022-03-21,Hai Phong City,Hong Bang District,10,36,35,1,0
2022-03-21,Hai Phong City,Hong Bang District,11,105,92,13,9
2022-03-21,Hai Phong City,Hong Bang District,12,65,57,8,1
2022-03-21,Hai Phong City,Hong Bang District,13,38,29,9,4
2022-03-21,Hai Phong City,Hong Bang District,14,33,29,4,1
2022-03-21,Hai Phong City,Hong Bang District,15,27,26,1,0
2022-03-21,Hai Phong City,Hong Bang District,16,40,38,2,0
2022-03-21,Hai Phong City,Hong Bang District,17,27,24,3,0
2022-03-21,Hai Phong City,Hong Bang District,18,46,41,5,0
2022-03-21,Hai Phong City,Hong Bang District,19,32,28,4,1
2022-03-21,Hai Phong City,Hong Bang District,20,29,25,4,2
2022-03-21,Hai Phong City,Hong Bang District,21,9,6,3,1
2022-03-21,Hai Phong City,Kien An District,7,2,1,1,1
2022-03-21,Hai Phong City,Kien An District,8,2,0,2,2
2022-03-21,Hai Phong City,Kien An District,9,5,1,4,3
2022-03-21,Hai Phong City,Kien An District,10,12,6,6,5
2022-03-21,Hai Phong City,Kien An District,11,10,7,3,2
2022-03-21,Hai Phong City,Kien An District,12,7,6,1,1
2022-03-21,Hai Phong City,Kien An District,13,7,6,1,1
2022-03-21,Hai Phong City,Kien An District,14,6,4,2,1
2022-03-21,Hai Phong City,Kien An District,15,8,6,2,1
2022-03-21,Hai Phong City,Kien An District,16,3,2,1,0
2022-03-21,Hai Phong City,Kien An District,17,7,6,1,0
2022-03-21,Hai Phong City,Kien An District,18,10,9,1,0
2022-03-21,Hai Phong City,Kien An District,19,7,5,2,0
2022-03-21,Hai Phong City,Kien An District,20,10,7,3,1
2022-03-21,Hai Phong City,Kien An District,21,4,2,2,1
2022-03-21,Hai Phong City,Le Chan District,3,2,0,2,1
2022-03-21,Hai Phong City,Le Chan District,5,2,0,2,0
2022-03-21,Hai Phong City,Le Chan District,7,24,21,3,1
2022-03-21,Hai Phong City,Le Chan District,8,51,41,10,4
2022-03-21,Hai Phong City,Le Chan District,9,64,54,10,0
2022-03-21,Hai Phong City,Le Chan District,10,133,119,14,2
2022-03-21,Hai Phong City,Le Chan District,11,259,235,24,5
2022-03-21,Hai Phong City,Le Chan District,12,152,144,8,3
2022-03-21,Hai Phong City,Le Chan District,13,87,76,11,0
2022-03-21,Hai Phong City,Le Chan District,14,117,102,15,5
2022-03-21,Hai Phong City,Le Chan District,15,129,111,18,2
2022-03-21,Hai Phong City,Le Chan District,16,119,105,14,2
2022-03-21,Hai Phong City,Le Chan District,17,136,127,9,0
2022-03-21,Hai Phong City,Le Chan District,18,169,150,19,0
2022-03-21,Hai Phong City,Le Chan District,19,188,171,17,2
2022-03-21,Hai Phong City,Le Chan District,20,104,99,5,2
2022-03-21,Hai Phong City,Le Chan District,21,54,45,9,2
2022-03-21,Hai Phong City,Le Chan District,22,3,0,3,0
2022-03-21,Hai Phong City,Le Chan District,23,2,1,1,1
2022-03-21,Hai Phong City,Ngo Quyen District,0,1,0,1,1
2022-03-21,Hai Phong City,Ngo Quyen District,1,1,0,1,0
2022-03-21,Hai Phong City,Ngo Quyen District,3,1,1,0,0
2022-03-21,Hai Phong City,Ngo Quyen District,7,25,20,5,2
2022-03-21,Hai Phong City,Ngo Quyen District,8,57,52,5,3
2022-03-21,Hai Phong City,Ngo Quyen District,9,63,60,3,1
2022-03-21,Hai Phong City,Ngo Quyen District,10,90,81,9,1
2022-03-21,Hai Phong City,Ngo Quyen District,11,213,192,21,8
2022-03-21,Hai Phong City,Ngo Quyen District,12,140,129,11,1
2022-03-21,Hai Phong City,Ngo Quyen District,13,104,98,6,1
2022-03-21,Hai Phong City,Ngo Quyen District,14,118,114,4,0
2022-03-21,Hai Phong City,Ngo Quyen District,15,117,112,5,1
2022-03-21,Hai Phong City,Ngo Quyen District,16,98,85,13,1
2022-03-21,Hai Phong City,Ngo Quyen District,17,129,109,20,0
2022-03-21,Hai Phong City,Ngo Quyen District,18,158,142,16,2
2022-03-21,Hai Phong City,Ngo Quyen District,19,120,112,8,0
2022-03-21,Hai Phong City,Ngo Quyen District,20,122,110,12,2
2022-03-21,Hai Phong City,Ngo Quyen District,21,50,39,11,3
2022-03-21,Hai Phong City,Ngo Quyen District,23,2,0,2,0
2022-03-21,Hai Phong City,Thuy Nguyen,13,1,0,1,1
2022-03-21,Hai Phong City,Thuy Nguyen,14,1,1,0,0
2022-03-21,Hai Phong City,Thuy Nguyen,15,3,1,2,1
2022-03-21,Hai Phong City,Thuy Nguyen,19,2,0,2,1
2022-03-21,Hue City,Hue City,0,2,1,1,0
2022-03-21,Hue City,Hue City,1,1,0,1,0
2022-03-21,Hue City,Hue City,4,1,1,0,0
2022-03-21,Hue City,Hue City,6,72,66,6,1
2022-03-21,Hue City,Hue City,7,223,206,17,0
2022-03-21,Hue City,Hue City,8,299,283,16,2
2022-03-21,Hue City,Hue City,9,242,237,5,0
2022-03-21,Hue City,Hue City,10,360,337,23,1
2022-03-21,Hue City,Hue City,11,799,750,49,5
2022-03-21,Hue City,Hue City,12,502,467,35,2
2022-03-21,Hue City,Hue City,13,290,272,18,0
2022-03-21,Hue City,Hue City,14,316,287,29,1
2022-03-21,Hue City,Hue City,15,338,310,28,1
2022-03-21,Hue City,Hue City,16,373,350,23,2
2022-03-21,Hue City,Hue City,17,539,493,46,0
2022-03-21,Hue City,Hue City,18,575,538,37,5
2022-03-21,Hue City,Hue City,19,508,472,36,2
2022-03-21,Hue City,Hue City,20,439,390,49,3
2022-03-21,Hue City,Hue City,21,209,165,44,16
2022-03-21,Hue City,Hue City,22,5,3,2,0
2022-03-21,Hue City,Hue City,23,1,1,0,0
2022-03-21,Hue City,Huong Thuy,10,2,1,1,0
2022-03-21,Hue City,Huong Thuy,16,1,1,0,0
2022-03-21,Hue City,Huong Thuy,19,2,1,1,0
2022-03-21,Hue City,Huong Thuy,20,1,1,0,0
2022-03-21,Hue City,Huong Thuy,21,1,0,1,1
2022-03-21,Hue City,Huong Tra,13,1,0,1,0
2022-03-21,Hue City,Huong Tra,16,1,0,1,1
2022-03-21,Hue City,Huong Tra,18,1,1,0,0
2022-03-21,Hue City,Phu Vang,6,1,1,0,0
2022-03-21,Hue City,Phu Vang,9,1,1,0,0
2022-03-21,Hue City,Phu Vang,10,3,3,0,0
2022-03-21,Hue City,Phu Vang,11,6,4,2,0
2022-03-21,Hue City,Phu Vang,13,1,1,0,0
2022-03-21,Hue City,Phu Vang,14,3,3,0,0
2022-03-21,Hue City,Phu Vang,15,1,0,1,1
2022-03-21,Hue City,Phu Vang,17,2,2,0,0
2022-03-21,Hue City,Phu Vang,18,5,5,0,0
2022-03-21,Hue City,Phu Vang,19,3,2,1,1
2022-03-21,Hue City,Phu Vang,20,3,1,2,0
2022-03-21,Hue City,Phu Vang,21,2,2,0,0
2022-03-21,Vung Tau,Ba Ria City,6,1,0,1,1
2022-03-21,Vung Tau,Ba Ria City,7,5,1,4,2
2022-03-21,Vung Tau,Ba Ria City,8,4,3,1,1
2022-03-21,Vung Tau,Ba Ria City,9,4,4,0,0
2022-03-21,Vung Tau,Ba Ria City,10,5,5,0,0
2022-03-21,Vung Tau,Ba Ria City,11,7,5,2,0
2022-03-21,Vung Tau,Ba Ria City,12,5,3,2,0
2022-03-21,Vung Tau,Ba Ria City,13,4,4,0,0
2022-03-21,Vung Tau,Ba Ria City,14,3,3,0,0
2022-03-21,Vung Tau,Ba Ria City,15,6,3,3,2
2022-03-21,Vung Tau,Ba Ria City,16,11,6,5,4
2022-03-21,Vung Tau,Ba Ria City,17,4,3,1,0
2022-03-21,Vung Tau,Ba Ria City,18,1,1,0,0
2022-03-21,Vung Tau,Ba Ria City,19,2,1,1,1
2022-03-21,Vung Tau,Ba Ria City,20,4,0,4,3
2022-03-21,Vung Tau,Ba Ria City,21,1,0,1,1
2022-03-21,Vung Tau,Vung Tau City,0,1,0,1,0
2022-03-21,Vung Tau,Vung Tau City,3,1,1,0,0
2022-03-21,Vung Tau,Vung Tau City,4,1,1,0,0
2022-03-21,Vung Tau,Vung Tau City,5,6,4,2,0
2022-03-21,Vung Tau,Vung Tau City,6,37,35,2,2
2022-03-21,Vung Tau,Vung Tau City,7,82,74,8,1
2022-03-21,Vung Tau,Vung Tau City,8,124,114,10,3
2022-03-21,Vung Tau,Vung Tau City,9,137,125,12,3
2022-03-21,Vung Tau,Vung Tau City,10,174,151,23,9
2022-03-21,Vung Tau,Vung Tau City,11,322,297,25,6
2022-03-21,Vung Tau,Vung Tau City,12,245,234,11,2
2022-03-21,Vung Tau,Vung Tau City,13,180,167,13,2
2022-03-21,Vung Tau,Vung Tau City,14,194,178,16,4
2022-03-21,Vung Tau,Vung Tau City,15,193,173,20,2
2022-03-21,Vung Tau,Vung Tau City,16,176,160,16,3
2022-03-21,Vung Tau,Vung Tau City,17,259,232,27,7
2022-03-21,Vung Tau,Vung Tau City,18,271,248,23,1
2022-03-21,Vung Tau,Vung Tau City,19,215,196,19,2
2022-03-21,Vung Tau,Vung Tau City,20,163,144,19,2
2022-03-21,Vung Tau,Vung Tau City,21,93,56,37,13
2022-03-21,Vung Tau,Vung Tau City,22,4,2,2,0
2022-03-22,Binh Duong,Ben Cat,17,1,0,1,1
2022-03-22,Binh Duong,Di An,6,1,0,1,1
2022-03-22,Binh Duong,Di An,7,2,0,2,2
2022-03-22,Binh Duong,Di An,8,11,1,10,9
2022-03-22,Binh Duong,Di An,9,27,11,16,11
2022-03-22,Binh Duong,Di An,10,14,7,7,7
2022-03-22,Binh Duong,Di An,11,18,12,6,2
2022-03-22,Binh Duong,Di An,12,29,12,17,14
2022-03-22,Binh Duong,Di An,13,15,10,5,5
2022-03-22,Binh Duong,Di An,14,18,9,9,7
2022-03-22,Binh Duong,Di An,15,8,7,1,1
2022-03-22,Binh Duong,Di An,16,8,4,4,3
2022-03-22,Binh Duong,Di An,17,21,7,14,11
2022-03-22,Binh Duong,Di An,18,15,7,8,7
2022-03-22,Binh Duong,Di An,19,14,6,8,7
2022-03-22,Binh Duong,Di An,20,10,4,6,5
2022-03-22,Binh Duong,Di An,21,2,0,2,2
2022-03-22,Binh Duong,Tan Uyen,10,1,0,1,1
2022-03-22,Binh Duong,Tan Uyen,11,2,1,1,1
2022-03-22,Binh Duong,Tan Uyen,12,3,2,1,1
2022-03-22,Binh Duong,Tan Uyen,13,2,1,1,1
2022-03-22,Binh Duong,Tan Uyen,16,5,1,4,4
2022-03-22,Binh Duong,Tan Uyen,17,5,0,5,4
2022-03-22,Binh Duong,Tan Uyen,18,1,0,1,1
2022-03-22,Binh Duong,Tan Uyen,19,2,0,2,2
2022-03-22,Binh Duong,Thu Dau Mot Town,1,1,1,0,0
2022-03-22,Binh Duong,Thu Dau Mot Town,5,1,1,0,0
2022-03-22,Binh Duong,Thu Dau Mot Town,6,33,23,10,9
2022-03-22,Binh Duong,Thu Dau Mot Town,7,105,100,5,2
2022-03-22,Binh Duong,Thu Dau Mot Town,8,174,157,17,2
2022-03-22,Binh Duong,Thu Dau Mot Town,9,212,196,16,2
2022-03-22,Binh Duong,Thu Dau Mot Town,10,306,283,23,1
2022-03-22,Binh Duong,Thu Dau Mot Town,11,525,487,38,6
2022-03-22,Binh Duong,Thu Dau Mot Town,12,324,291,33,10
2022-03-22,Binh Duong,Thu Dau Mot Town,13,364,321,43,19
2022-03-22,Binh Duong,Thu Dau Mot Town,14,285,244,41,16
2022-03-22,Binh Duong,Thu Dau Mot Town,15,233,200,33,12
2022-03-22,Binh Duong,Thu Dau Mot Town,16,324,168,156,126
2022-03-22,Binh Duong,Thu Dau Mot Town,17,464,314,150,113
2022-03-22,Binh Duong,Thu Dau Mot Town,18,446,375,71,43
2022-03-22,Binh Duong,Thu Dau Mot Town,19,319,285,34,4
2022-03-22,Binh Duong,Thu Dau Mot Town,20,230,205,25,7
2022-03-22,Binh Duong,Thu Dau Mot Town,21,106,90,16,8
2022-03-22,Binh Duong,Thu Dau Mot Town,22,1,1,0,0
2022-03-22,Binh Duong,Thu Dau Mot Town,23,1,0,1,0
2022-03-22,Binh Duong,Thuan An,6,1,0,1,1
2022-03-22,Binh Duong,Thuan An,7,8,1,7,6
2022-03-22,Binh Duong,Thuan An,8,24,6,18,15
2022-03-22,Binh Duong,Thuan An,9,36,17,19,17
2022-03-22,Binh Duong,Thuan An,10,44,24,20,14
2022-03-22,Binh Duong,Thuan An,11,70,45,25,17
2022-03-22,Binh Duong,Thuan An,12,36,17,19,12
2022-03-22,Binh Duong,Thuan An,13,47,27,20,18
2022-03-22,Binh Duong,Thuan An,14,38,10,28,25
2022-03-22,Binh Duong,Thuan An,15,31,15,16,13
2022-03-22,Binh Duong,Thuan An,16,60,12,48,37
2022-03-22,Binh Duong,Thuan An,17,38,15,23,20
2022-03-22,Binh Duong,Thuan An,18,46,25,21,18
2022-03-22,Binh Duong,Thuan An,19,39,20,19,16
2022-03-22,Binh Duong,Thuan An,20,18,9,9,4
2022-03-22,Binh Duong,Thuan An,21,22,3,19,13
2022-03-22,Binh Duong,Thuan An,22,1,0,1,1
2022-03-22,Can Tho City,Binh Thuy District,6,1,1,0,0
2022-03-22,Can Tho City,Binh Thuy District,7,1,1,0,0
2022-03-22,Can Tho City,Binh Thuy District,8,3,2,1,0
2022-03-22,Can Tho City,Binh Thuy District,9,6,5,1,0
2022-03-22,Can Tho City,Binh Thuy District,10,12,9,3,0
2022-03-22,Can Tho City,Binh Thuy District,11,15,14,1,0
2022-03-22,Can Tho City,Binh Thuy District,12,9,8,1,0
2022-03-22,Can Tho City,Binh Thuy District,13,6,5,1,0
2022-03-22,Can Tho City,Binh Thuy District,14,6,5,1,0
2022-03-22,Can Tho City,Binh Thuy District,15,8,8,0,0
2022-03-22,Can Tho City,Binh Thuy District,16,17,17,0,0
2022-03-22,Can Tho City,Binh Thuy District,17,10,9,1,1
2022-03-22,Can Tho City,Binh Thuy District,18,13,9,4,2
2022-03-22,Can Tho City,Binh Thuy District,19,24,19,5,0
2022-03-22,Can Tho City,Binh Thuy District,20,9,4,5,4
2022-03-22,Can Tho City,Binh Thuy District,21,2,1,1,0
2022-03-22,Can Tho City,Cai Rang District,7,3,2,1,1
2022-03-22,Can Tho City,Cai Rang District,8,8,8,0,0
2022-03-22,Can Tho City,Cai Rang District,9,5,4,1,0
2022-03-22,Can Tho City,Cai Rang District,10,4,4,0,0
2022-03-22,Can Tho City,Cai Rang District,11,12,12,0,0
2022-03-22,Can Tho City,Cai Rang District,12,10,8,2,1
2022-03-22,Can Tho City,Cai Rang District,13,6,5,1,1
2022-03-22,Can Tho City,Cai Rang District,14,6,5,1,0
2022-03-22,Can Tho City,Cai Rang District,15,9,8,1,0
2022-03-22,Can Tho City,Cai Rang District,16,19,11,8,4
2022-03-22,Can Tho City,Cai Rang District,17,14,10,4,0
2022-03-22,Can Tho City,Cai Rang District,18,23,17,6,2
2022-03-22,Can Tho City,Cai Rang District,19,14,11,3,2
2022-03-22,Can Tho City,Cai Rang District,20,12,9,3,0
2022-03-22,Can Tho City,Cai Rang District,21,5,3,2,0
2022-03-22,Can Tho City,Ninh Kieu District,0,2,1,1,0
2022-03-22,Can Tho City,Ninh Kieu District,2,1,1,0,0
2022-03-22,Can Tho City,Ninh Kieu District,3,3,3,0,0
2022-03-22,Can Tho City,Ninh Kieu District,4,1,1,0,0
2022-03-22,Can Tho City,Ninh Kieu District,5,3,1,2,1
2022-03-22,Can Tho City,Ninh Kieu District,6,47,46,1,1
2022-03-22,Can Tho City,Ninh Kieu District,7,133,125,8,1
2022-03-22,Can Tho City,Ninh Kieu District,8,214,205,9,0
2022-03-22,Can Tho City,Ninh Kieu District,9,280,264,16,0
2022-03-22,Can Tho City,Ninh Kieu District,10,495,463,32,0
2022-03-22,Can Tho City,Ninh Kieu District,11,775,718,57,0
2022-03-22,Can Tho City,Ninh Kieu District,12,501,482,19,0
2022-03-22,Can Tho City,Ninh Kieu District,13,319,290,29,10
2022-03-22,Can Tho City,Ninh Kieu District,14,260,229,31,10
2022-03-22,Can Tho City,Ninh Kieu District,15,423,371,52,31
2022-03-22,Can Tho City,Ninh Kieu District,16,479,424,55,27
2022-03-22,Can Tho City,Ninh Kieu District,17,621,531,90,43
2022-03-22,Can Tho City,Ninh Kieu District,18,815,515,300,232
2022-03-22,Can Tho City,Ninh Kieu District,19,628,479,149,87
2022-03-22,Can Tho City,Ninh Kieu District,20,507,369,138,63
2022-03-22,Can Tho City,Ninh Kieu District,21,205,174,31,5
2022-03-22,Can Tho City,Ninh Kieu District,22,2,0,2,0
2022-03-22,Can Tho City,Ninh Kieu District,23,3,3,0,0
2022-03-22,Dong Nai,Bien Hoa City,0,3,2,1,0
2022-03-22,Dong Nai,Bien Hoa City,1,2,1,1,0
2022-03-22,Dong Nai,Bien Hoa City,2,1,0,1,1
2022-03-22,Dong Nai,Bien Hoa City,5,4,3,1,0
2022-03-22,Dong Nai,Bien Hoa City,6,32,21,11,10
2022-03-22,Dong Nai,Bien Hoa City,7,153,118,35,17
2022-03-22,Dong Nai,Bien Hoa City,8,270,236,34,12
2022-03-22,Dong Nai,Bien Hoa City,9,344,289,55,12
2022-03-22,Dong Nai,Bien Hoa City,10,541,482,59,4
2022-03-22,Dong Nai,Bien Hoa City,11,893,739,154,33
2022-03-22,Dong Nai,Bien Hoa City,12,641,577,64,26
2022-03-22,Dong Nai,Bien Hoa City,13,656,547,109,61
2022-03-22,Dong Nai,Bien Hoa City,14,506,403,103,61
2022-03-22,Dong Nai,Bien Hoa City,15,442,267,175,129
2022-03-22,Dong Nai,Bien Hoa City,16,655,341,314,268
2022-03-22,Dong Nai,Bien Hoa City,17,815,538,277,202
2022-03-22,Dong Nai,Bien Hoa City,18,684,539,145,68
2022-03-22,Dong Nai,Bien Hoa City,19,565,480,85,23
2022-03-22,Dong Nai,Bien Hoa City,20,457,348,109,42
2022-03-22,Dong Nai,Bien Hoa City,21,197,123,74,38
2022-03-22,Dong Nai,Bien Hoa City,22,5,1,4,0
2022-03-22,Dong Nai,Long Khanh,17,1,0,1,1
2022-03-22,Dong Nai,Long Thanh,7,1,0,1,1
2022-03-22,Dong Nai,Long Thanh,9,1,0,1,1
2022-03-22,Dong Nai,Long Thanh,10,2,0,2,1
2022-03-22,Dong Nai,Long Thanh,12,2,0,2,2
2022-03-22,Dong Nai,Long Thanh,13,2,0,2,2
2022-03-22,Dong Nai,Long Thanh,14,1,0,1,1
2022-03-22,Dong Nai,Long Thanh,15,2,0,2,2
2022-03-22,Dong Nai,Long Thanh,19,1,0,1,1
2022-03-22,Dong Nai,Long Thanh,21,1,0,1,1
2022-03-22,Dong Nai,Nhon trach,13,1,0,1,1
2022-03-22,Dong Nai,Thong Nhat,9,2,2,0,0
2022-03-22,Dong Nai,Thong Nhat,11,1,1,0,0
2022-03-22,Dong Nai,Thong Nhat,13,3,3,0,0
2022-03-22,Dong Nai,Thong Nhat,16,1,0,1,1
2022-03-22,Dong Nai,Thong Nhat,17,3,1,2,2
2022-03-22,Dong Nai,Thong Nhat,19,5,3,2,0
2022-03-22,Dong Nai,Thong Nhat,20,2,2,0,0
2022-03-22,Dong Nai,Trang Bom,17,1,0,1,1
2022-03-22,Dong Nai,Trang Bom,18,3,0,3,2
2022-03-22,Dong Nai,Vinh Cuu,17,1,0,1,1
2022-03-22,Hai Phong City,An Duong,9,2,1,1,0
2022-03-22,Hai Phong City,An Duong,10,1,1,0,0
2022-03-22,Hai Phong City,An Duong,11,3,3,0,0
2022-03-22,Hai Phong City,An Duong,12,1,1,0,0
2022-03-22,Hai Phong City,An Duong,13,2,2,0,0
2022-03-22,Hai Phong City,An Duong,14,1,0,1,1
2022-03-22,Hai Phong City,An Duong,15,4,1,3,3
2022-03-22,Hai Phong City,An Duong,16,2,0,2,1
2022-03-22,Hai Phong City,An Duong,17,1,1,0,0
2022-03-22,Hai Phong City,An Duong,18,2,1,1,1
2022-03-22,Hai Phong City,An Duong,19,4,2,2,1
2022-03-22,Hai Phong City,An Duong,20,2,2,0,0
2022-03-22,Hai Phong City,Do Son District,15,1,0,1,1
2022-03-22,Hai Phong City,Duong Kinh District,20,1,0,1,1
2022-03-22,Hai Phong City,Hai An District,7,5,1,4,3
2022-03-22,Hai Phong City,Hai An District,8,11,7,4,3
2022-03-22,Hai Phong City,Hai An District,9,12,9,3,0
2022-03-22,Hai Phong City,Hai An District,10,14,13,1,0
2022-03-22,Hai Phong City,Hai An District,11,37,32,5,1
2022-03-22,Hai Phong City,Hai An District,12,20,19,1,0
2022-03-22,Hai Phong City,Hai An District,13,7,4,3,2
2022-03-22,Hai Phong City,Hai An District,14,20,15,5,0
2022-03-22,Hai Phong City,Hai An District,15,18,16,2,0
2022-03-22,Hai Phong City,Hai An District,16,11,11,0,0
2022-03-22,Hai Phong City,Hai An District,17,21,18,3,0
2022-03-22,Hai Phong City,Hai An District,18,16,11,5,0
2022-03-22,Hai Phong City,Hai An District,19,11,10,1,1
2022-03-22,Hai Phong City,Hai An District,20,14,10,4,2
2022-03-22,Hai Phong City,Hai An District,21,13,8,5,2
2022-03-22,Hai Phong City,Hong Bang District,1,1,1,0,0
2022-03-22,Hai Phong City,Hong Bang District,7,14,14,0,0
2022-03-22,Hai Phong City,Hong Bang District,8,24,16,8,2
2022-03-22,Hai Phong City,Hong Bang District,9,31,27,4,0
2022-03-22,Hai Phong City,Hong Bang District,10,52,47,5,0
2022-03-22,Hai Phong City,Hong Bang District,11,103,86,17,1
2022-03-22,Hai Phong City,Hong Bang District,12,48,46,2,1
2022-03-22,Hai Phong City,Hong Bang District,13,30,29,1,0
2022-03-22,Hai Phong City,Hong Bang District,14,41,35,6,2
2022-03-22,Hai Phong City,Hong Bang District,15,37,33,4,1
2022-03-22,Hai Phong City,Hong Bang District,16,31,25,6,1
2022-03-22,Hai Phong City,Hong Bang District,17,31,30,1,0
2022-03-22,Hai Phong City,Hong Bang District,18,56,52,4,0
2022-03-22,Hai Phong City,Hong Bang District,19,45,38,7,1
2022-03-22,Hai Phong City,Hong Bang District,20,41,34,7,6
2022-03-22,Hai Phong City,Hong Bang District,21,12,9,3,1
2022-03-22,Hai Phong City,Kien An District,7,2,0,2,2
2022-03-22,Hai Phong City,Kien An District,8,2,2,0,0
2022-03-22,Hai Phong City,Kien An District,9,4,1,3,2
2022-03-22,Hai Phong City,Kien An District,10,2,1,1,0
2022-03-22,Hai Phong City,Kien An District,11,13,12,1,0
2022-03-22,Hai Phong City,Kien An District,12,6,6,0,0
2022-03-22,Hai Phong City,Kien An District,13,7,4,3,2
2022-03-22,Hai Phong City,Kien An District,14,7,1,6,5
2022-03-22,Hai Phong City,Kien An District,15,6,2,4,2
2022-03-22,Hai Phong City,Kien An District,16,6,4,2,1
2022-03-22,Hai Phong City,Kien An District,17,7,3,4,3
2022-03-22,Hai Phong City,Kien An District,18,16,9,7,6
2022-03-22,Hai Phong City,Kien An District,19,14,10,4,3
2022-03-22,Hai Phong City,Kien An District,20,16,6,10,8
2022-03-22,Hai Phong City,Kien An District,21,3,0,3,3
2022-03-22,Hai Phong City,Le Chan District,6,3,1,2,0
2022-03-22,Hai Phong City,Le Chan District,7,21,19,2,2
2022-03-22,Hai Phong City,Le Chan District,8,42,37,5,2
2022-03-22,Hai Phong City,Le Chan District,9,65,59,6,1
2022-03-22,Hai Phong City,Le Chan District,10,124,115,9,0
2022-03-22,Hai Phong City,Le Chan District,11,219,197,22,2
2022-03-22,Hai Phong City,Le Chan District,12,144,135,9,2
2022-03-22,Hai Phong City,Le Chan District,13,115,107,8,1
2022-03-22,Hai Phong City,Le Chan District,14,131,108,23,3
2022-03-22,Hai Phong City,Le Chan District,15,127,115,12,0
2022-03-22,Hai Phong City,Le Chan District,16,121,110,11,2
2022-03-22,Hai Phong City,Le Chan District,17,151,130,21,2
2022-03-22,Hai Phong City,Le Chan District,18,193,174,19,0
2022-03-22,Hai Phong City,Le Chan District,19,165,143,22,3
2022-03-22,Hai Phong City,Le Chan District,20,123,101,22,6
2022-03-22,Hai Phong City,Le Chan District,21,67,44,23,8
2022-03-22,Hai Phong City,Le Chan District,22,1,0,1,1
2022-03-22,Hai Phong City,Le Chan District,23,1,0,1,1
2022-03-22,Hai Phong City,Ngo Quyen District,1,2,1,1,0
2022-03-22,Hai Phong City,Ngo Quyen District,2,2,2,0,0
2022-03-22,Hai Phong City,Ngo Quyen District,5,1,0,1,0
2022-03-22,Hai Phong City,Ngo Quyen District,7,26,19,7,4
2022-03-22,Hai Phong City,Ngo Quyen District,8,53,43,10,2
2022-03-22,Hai Phong City,Ngo Quyen District,9,69,64,5,1
2022-03-22,Hai Phong City,Ngo Quyen District,10,92,81,11,1
2022-03-22,Hai Phong City,Ngo Quyen District,11,208,182,26,0
2022-03-22,Hai Phong City,Ngo Quyen District,12,125,117,8,0
2022-03-22,Hai Phong City,Ngo Quyen District,13,110,97,13,1
2022-03-22,Hai Phong City,Ngo Quyen District,14,162,140,22,6
2022-03-22,Hai Phong City,Ngo Quyen District,15,135,120,15,4
2022-03-22,Hai Phong City,Ngo Quyen District,16,139,122,17,0
2022-03-22,Hai Phong City,Ngo Quyen District,17,131,124,7,0
2022-03-22,Hai Phong City,Ngo Quyen District,18,163,148,15,0
2022-03-22,Hai Phong City,Ngo Quyen District,19,147,131,16,0
2022-03-22,Hai Phong City,Ngo Quyen District,20,113,98,15,6
2022-03-22,Hai Phong City,Ngo Quyen District,21,68,50,18,6
2022-03-22,Hai Phong City,Ngo Quyen District,23,1,1,0,0
2022-03-22,Hai Phong City,Thuy Nguyen,8,1,0,1,1
2022-03-22,Hai Phong City,Thuy Nguyen,11,1,0,1,1
2022-03-22,Hai Phong City,Thuy Nguyen,12,1,0,1,1
2022-03-22,Hai Phong City,Thuy Nguyen,18,1,0,1,1
2022-03-22,Hai Phong City,Thuy Nguyen,19,1,1,0,0
2022-03-22,Hue City,Hue City,0,3,3,0,0
2022-03-22,Hue City,Hue City,1,2,2,0,0
2022-03-22,Hue City,Hue City,2,1,1,0,0
2022-03-22,Hue City,Hue City,4,1,1,0,0
2022-03-22,Hue City,Hue City,6,51,46,5,0
2022-03-22,Hue City,Hue City,7,206,188,18,0
2022-03-22,Hue City,Hue City,8,262,248,14,0
2022-03-22,Hue City,Hue City,9,229,215,14,0
2022-03-22,Hue City,Hue City,10,263,245,18,0
2022-03-22,Hue City,Hue City,11,792,724,68,1
2022-03-22,Hue City,Hue City,12,423,385,38,2
2022-03-22,Hue City,Hue City,13,363,321,42,2
2022-03-22,Hue City,Hue City,14,350,325,25,3
2022-03-22,Hue City,Hue City,15,357,328,29,1
2022-03-22,Hue City,Hue City,16,359,337,22,1
2022-03-22,Hue City,Hue City,17,453,423,30,2
2022-03-22,Hue City,Hue City,18,553,505,48,4
2022-03-22,Hue City,Hue City,19,507,460,47,0
2022-03-22,Hue City,Hue City,20,342,306,36,0
2022-03-22,Hue City,Hue City,21,234,191,43,3
2022-03-22,Hue City,Hue City,22,5,2,3,0
2022-03-22,Hue City,Hue City,23,1,1,0,0
2022-03-22,Hue City,Huong Thuy,7,1,1,0,0
2022-03-22,Hue City,Huong Thuy,8,1,1,0,0
2022-03-22,Hue City,Huong Thuy,9,1,1,0,0
2022-03-22,Hue City,Huong Thuy,18,1,1,0,0
2022-03-22,Hue City,Huong Thuy,19,1,0,1,1
2022-03-22,Hue City,Huong Tra,11,1,1,0,0
2022-03-22,Hue City,Huong Tra,12,1,1,0,0
2022-03-22,Hue City,Huong Tra,19,1,1,0,0
2022-03-22,Hue City,Phu Vang,7,2,2,0,0
2022-03-22,Hue City,Phu Vang,8,2,2,0,0
2022-03-22,Hue City,Phu Vang,11,3,2,1,1
2022-03-22,Hue City,Phu Vang,12,2,2,0,0
2022-03-22,Hue City,Phu Vang,13,2,0,2,0
2022-03-22,Hue City,Phu Vang,14,2,2,0,0
2022-03-22,Hue City,Phu Vang,16,1,1,0,0
2022-03-22,Hue City,Phu Vang,18,1,0,1,1
2022-03-22,Hue City,Phu Vang,20,1,1,0,0
2022-03-22,Hue City,Phu Vang,21,2,1,1,0
2022-03-22,Vung Tau,Ba Ria City,7,1,1,0,0
2022-03-22,Vung Tau,Ba Ria City,8,2,2,0,0
2022-03-22,Vung Tau,Ba Ria City,9,4,2,2,1
2022-03-22,Vung Tau,Ba Ria City,10,4,3,1,1
2022-03-22,Vung Tau,Ba Ria City,11,10,4,6,2
2022-03-22,Vung Tau,Ba Ria City,12,4,3,1,0
2022-03-22,Vung Tau,Ba Ria City,13,9,4,5,1
2022-03-22,Vung Tau,Ba Ria City,14,5,1,4,3
2022-03-22,Vung Tau,Ba Ria City,15,3,2,1,1
2022-03-22,Vung Tau,Ba Ria City,16,3,1,2,2
2022-03-22,Vung Tau,Ba Ria City,17,1,1,0,0
2022-03-22,Vung Tau,Ba Ria City,18,5,3,2,1
2022-03-22,Vung Tau,Ba Ria City,19,3,2,1,1
2022-03-22,Vung Tau,Vung Tau City,3,3,1,2,1
2022-03-22,Vung Tau,Vung Tau City,5,1,1,0,0
2022-03-22,Vung Tau,Vung Tau City,6,45,34,11,9
2022-03-22,Vung Tau,Vung Tau City,7,86,83,3,0
2022-03-22,Vung Tau,Vung Tau City,8,136,129,7,3
2022-03-22,Vung Tau,Vung Tau City,9,130,124,6,1
2022-03-22,Vung Tau,Vung Tau City,10,168,141,27,4
2022-03-22,Vung Tau,Vung Tau City,11,275,254,21,1
2022-03-22,Vung Tau,Vung Tau City,12,198,181,17,0
2022-03-22,Vung Tau,Vung Tau City,13,200,184,16,1
2022-03-22,Vung Tau,Vung Tau City,14,185,170,15,1
2022-03-22,Vung Tau,Vung Tau City,15,205,195,10,0
2022-03-22,Vung Tau,Vung Tau City,16,179,172,7,0
2022-03-22,Vung Tau,Vung Tau City,17,261,241,20,1
2022-03-22,Vung Tau,Vung Tau City,18,227,216,11,0
2022-03-22,Vung Tau,Vung Tau City,19,214,191,23,2
2022-03-22,Vung Tau,Vung Tau City,20,174,147,27,3
2022-03-22,Vung Tau,Vung Tau City,21,82,63,19,3
2022-03-22,Vung Tau,Vung Tau City,22,2,0,2,0
2022-03-23,Binh Duong,Ben Cat,8,1,1,0,0
2022-03-23,Binh Duong,Ben Cat,14,1,1,0,0
2022-03-23,Binh Duong,Ben Cat,17,1,1,0,0
2022-03-23,Binh Duong,Ben Cat,20,1,0,1,1
2022-03-23,Binh Duong,Di An,2,1,0,1,1
2022-03-23,Binh Duong,Di An,7,5,1,4,3
2022-03-23,Binh Duong,Di An,8,8,3,5,5
2022-03-23,Binh Duong,Di An,9,20,13,7,5
2022-03-23,Binh Duong,Di An,10,17,13,4,3
2022-03-23,Binh Duong,Di An,11,34,20,14,5
2022-03-23,Binh Duong,Di An,12,26,13,13,7
2022-03-23,Binh Duong,Di An,13,18,10,8,6
2022-03-23,Binh Duong,Di An,14,19,12,7,4
2022-03-23,Binh Duong,Di An,15,6,4,2,1
2022-03-23,Binh Duong,Di An,16,17,8,9,6
2022-03-23,Binh Duong,Di An,17,20,6,14,12
2022-03-23,Binh Duong,Di An,18,22,15,7,7
2022-03-23,Binh Duong,Di An,19,24,12,12,7
2022-03-23,Binh Duong,Di An,20,9,3,6,6
2022-03-23,Binh Duong,Di An,21,3,2,1,1
2022-03-23,Binh Duong,Tan Uyen,10,1,0,1,0
2022-03-23,Binh Duong,Tan Uyen,11,2,1,1,0
2022-03-23,Binh Duong,Tan Uyen,12,1,1,0,0
2022-03-23,Binh Duong,Tan Uyen,13,3,2,1,0
2022-03-23,Binh Duong,Tan Uyen,14,1,1,0,0
2022-03-23,Binh Duong,Tan Uyen,15,1,0,1,1
2022-03-23,Binh Duong,Tan Uyen,16,2,1,1,1
2022-03-23,Binh Duong,Tan Uyen,18,2,0,2,0
2022-03-23,Binh Duong,Thu Dau Mot Town,2,1,1,0,0
2022-03-23,Binh Duong,Thu Dau Mot Town,6,30,24,6,4
2022-03-23,Binh Duong,Thu Dau Mot Town,7,101,87,14,4
2022-03-23,Binh Duong,Thu Dau Mot Town,8,189,182,7,0
2022-03-23,Binh Duong,Thu Dau Mot Town,9,216,203,13,2
2022-03-23,Binh Duong,Thu Dau Mot Town,10,344,315,29,4
2022-03-23,Binh Duong,Thu Dau Mot Town,11,554,515,39,1
2022-03-23,Binh Duong,Thu Dau Mot Town,12,386,356,30,3
2022-03-23,Binh Duong,Thu Dau Mot Town,13,349,332,17,4
2022-03-23,Binh Duong,Thu Dau Mot Town,14,258,225,33,16
2022-03-23,Binh Duong,Thu Dau Mot Town,15,276,246,30,12
2022-03-23,Binh Duong,Thu Dau Mot Town,16,318,278,40,19
2022-03-23,Binh Duong,Thu Dau Mot Town,17,351,328,23,5
2022-03-23,Binh Duong,Thu Dau Mot Town,18,364,342,22,4
2022-03-23,Binh Duong,Thu Dau Mot Town,19,298,268,30,2
2022-03-23,Binh Duong,Thu Dau Mot Town,20,213,192,21,5
2022-03-23,Binh Duong,Thu Dau Mot Town,21,99,85,14,2
2022-03-23,Binh Duong,Thu Dau Mot Town,22,1,0,1,1
2022-03-23,Binh Duong,Thuan An,6,5,0,5,5
2022-03-23,Binh Duong,Thuan An,7,10,4,6,5
2022-03-23,Binh Duong,Thuan An,8,11,5,6,5
2022-03-23,Binh Duong,Thuan An,9,37,22,15,10
2022-03-23,Binh Duong,Thuan An,10,70,38,32,29
2022-03-23,Binh Duong,Thuan An,11,66,40,26,16
2022-03-23,Binh Duong,Thuan An,12,53,34,19,16
2022-03-23,Binh Duong,Thuan An,13,50,30,20,12
2022-03-23,Binh Duong,Thuan An,14,68,31,37,35
2022-03-23,Binh Duong,Thuan An,15,36,26,10,7
2022-03-23,Binh Duong,Thuan An,16,21,13,8,5
2022-03-23,Binh Duong,Thuan An,17,24,14,10,5
2022-03-23,Binh Duong,Thuan An,18,26,24,2,2
2022-03-23,Binh Duong,Thuan An,19,28,22,6,4
2022-03-23,Binh Duong,Thuan An,20,21,15,6,4
2022-03-23,Binh Duong,Thuan An,21,10,3,7,5
2022-03-23,Can Tho City,Binh Thuy District,6,2,0,2,2
2022-03-23,Can Tho City,Binh Thuy District,7,1,1,0,0
2022-03-23,Can Tho City,Binh Thuy District,8,1,1,0,0
2022-03-23,Can Tho City,Binh Thuy District,9,1,1,0,0
2022-03-23,Can Tho City,Binh Thuy District,10,13,11,2,0
2022-03-23,Can Tho City,Binh Thuy District,11,18,13,5,2
2022-03-23,Can Tho City,Binh Thuy District,12,22,18,4,2
2022-03-23,Can Tho City,Binh Thuy District,13,12,10,2,0
2022-03-23,Can Tho City,Binh Thuy District,14,9,7,2,0
2022-03-23,Can Tho City,Binh Thuy District,15,11,10,1,1
2022-03-23,Can Tho City,Binh Thuy District,16,10,10,0,0
2022-03-23,Can Tho City,Binh Thuy District,17,18,18,0,0
2022-03-23,Can Tho City,Binh Thuy District,18,8,6,2,0
2022-03-23,Can Tho City,Binh Thuy District,19,16,12,4,0
2022-03-23,Can Tho City,Binh Thuy District,20,8,8,0,0
2022-03-23,Can Tho City,Binh Thuy District,21,3,3,0,0
2022-03-23,Can Tho City,Cai Rang District,6,3,2,1,1
2022-03-23,Can Tho City,Cai Rang District,8,10,5,5,5
2022-03-23,Can Tho City,Cai Rang District,9,5,5,0,0
2022-03-23,Can Tho City,Cai Rang District,10,9,8,1,0
2022-03-23,Can Tho City,Cai Rang District,11,14,13,1,1
2022-03-23,Can Tho City,Cai Rang District,12,8,8,0,0
2022-03-23,Can Tho City,Cai Rang District,13,10,10,0,0
2022-03-23,Can Tho City,Cai Rang District,14,6,6,0,0
2022-03-23,Can Tho City,Cai Rang District,15,5,3,2,1
2022-03-23,Can Tho City,Cai Rang District,16,9,7,2,1
2022-03-23,Can Tho City,Cai Rang District,17,17,15,2,0
2022-03-23,Can Tho City,Cai Rang District,18,11,11,0,0
2022-03-23,Can Tho City,Cai Rang District,19,8,6,2,0
2022-03-23,Can Tho City,Cai Rang District,20,8,8,0,0
2022-03-23,Can Tho City,Cai Rang District,21,5,2,3,1
2022-03-23,Can Tho City,Ninh Kieu District,0,2,2,0,0
2022-03-23,Can Tho City,Ninh Kieu District,2,1,1,0,0
2022-03-23,Can Tho City,Ninh Kieu District,4,1,1,0,0
2022-03-23,Can Tho City,Ninh Kieu District,5,1,1,0,0
2022-03-23,Can Tho City,Ninh Kieu District,6,52,44,8,2
2022-03-23,Can Tho City,Ninh Kieu District,7,143,129,14,1
2022-03-23,Can Tho City,Ninh Kieu District,8,235,215,20,0
2022-03-23,Can Tho City,Ninh Kieu District,9,292,276,16,0
2022-03-23,Can Tho City,Ninh Kieu District,10,552,518,34,0
2022-03-23,Can Tho City,Ninh Kieu District,11,879,816,63,4
2022-03-23,Can Tho City,Ninh Kieu District,12,584,565,19,0
2022-03-23,Can Tho City,Ninh Kieu District,13,467,426,41,0
2022-03-23,Can Tho City,Ninh Kieu District,14,359,342,17,0
2022-03-23,Can Tho City,Ninh Kieu District,15,348,331,17,0
2022-03-23,Can Tho City,Ninh Kieu District,16,410,389,21,1
2022-03-23,Can Tho City,Ninh Kieu District,17,491,463,28,0
2022-03-23,Can Tho City,Ninh Kieu District,18,504,488,16,0
2022-03-23,Can Tho City,Ninh Kieu District,19,432,394,38,0
2022-03-23,Can Tho City,Ninh Kieu District,20,351,326,25,0
2022-03-23,Can Tho City,Ninh Kieu District,21,175,154,21,1
2022-03-23,Can Tho City,Ninh Kieu District,22,5,4,1,0
2022-03-23,Can Tho City,Ninh Kieu District,23,4,3,1,0
2022-03-23,Dong Nai,Bien Hoa City,0,1,1,0,0
2022-03-23,Dong Nai,Bien Hoa City,1,2,2,0,0
2022-03-23,Dong Nai,Bien Hoa City,2,1,1,0,0
2022-03-23,Dong Nai,Bien Hoa City,3,1,1,0,0
2022-03-23,Dong Nai,Bien Hoa City,4,1,0,1,1
2022-03-23,Dong Nai,Bien Hoa City,5,6,2,4,2
2022-03-23,Dong Nai,Bien Hoa City,6,46,23,23,15
2022-03-23,Dong Nai,Bien Hoa City,7,150,121,29,11
2022-03-23,Dong Nai,Bien Hoa City,8,267,226,41,10
2022-03-23,Dong Nai,Bien Hoa City,9,355,311,44,5
2022-03-23,Dong Nai,Bien Hoa City,10,669,600,69,17
2022-03-23,Dong Nai,Bien Hoa City,11,904,818,86,21
2022-03-23,Dong Nai,Bien Hoa City,12,671,614,57,13
2022-03-23,Dong Nai,Bien Hoa City,13,684,588,96,26
2022-03-23,Dong Nai,Bien Hoa City,14,566,502,64,27
2022-03-23,Dong Nai,Bien Hoa City,15,428,340,88,56
2022-03-23,Dong Nai,Bien Hoa City,16,487,284,203,141
2022-03-23,Dong Nai,Bien Hoa City,17,658,486,172,107
2022-03-23,Dong Nai,Bien Hoa City,18,703,586,117,68
2022-03-23,Dong Nai,Bien Hoa City,19,592,516,76,32
2022-03-23,Dong Nai,Bien Hoa City,20,480,368,112,56
2022-03-23,Dong Nai,Bien Hoa City,21,200,123,77,41
2022-03-23,Dong Nai,Bien Hoa City,22,2,0,2,0
2022-03-23,Dong Nai,Long Thanh,11,2,0,2,2
2022-03-23,Dong Nai,Long Thanh,12,1,0,1,1
2022-03-23,Dong Nai,Long Thanh,13,1,0,1,1
2022-03-23,Dong Nai,Long Thanh,14,2,0,2,2
2022-03-23,Dong Nai,Long Thanh,17,2,0,2,2
2022-03-23,Dong Nai,Long Thanh,18,1,0,1,1
2022-03-23,Dong Nai,Long Thanh,21,2,0,2,2
2022-03-23,Dong Nai,Thong Nhat,8,1,1,0,0
2022-03-23,Dong Nai,Thong Nhat,9,1,1,0,0
2022-03-23,Dong Nai,Thong Nhat,10,2,2,0,0
2022-03-23,Dong Nai,Thong Nhat,11,1,1,0,0
2022-03-23,Dong Nai,Thong Nhat,13,1,1,0,0
2022-03-23,Dong Nai,Thong Nhat,14,3,3,0,0
2022-03-23,Dong Nai,Thong Nhat,15,1,1,0,0
2022-03-23,Dong Nai,Thong Nhat,16,2,2,0,0
2022-03-23,Dong Nai,Thong Nhat,18,1,1,0,0
2022-03-23,Dong Nai,Thong Nhat,20,1,1,0,0
2022-03-23,Dong Nai,Thong Nhat,21,1,1,0,0
2022-03-23,Dong Nai,Trang Bom,10,2,0,2,2
2022-03-23,Dong Nai,Trang Bom,11,1,0,1,1
2022-03-23,Dong Nai,Trang Bom,12,1,0,1,0
2022-03-23,Hai Phong City,An Duong,7,3,0,3,3
2022-03-23,Hai Phong City,An Duong,8,1,1,0,0
2022-03-23,Hai Phong City,An Duong,9,5,1,4,4
2022-03-23,Hai Phong City,An Duong,10,9,4,5,4
2022-03-23,Hai Phong City,An Duong,11,8,3,5,5
2022-03-23,Hai Phong City,An Duong,12,3,2,1,1
2022-03-23,Hai Phong City,An Duong,13,7,1,6,5
2022-03-23,Hai Phong City,An Duong,14,6,1,5,4
2022-03-23,Hai Phong City,An Duong,15,7,3,4,4
2022-03-23,Hai Phong City,An Duong,17,2,1,1,0
2022-03-23,Hai Phong City,An Duong,20,2,0,2,0
2022-03-23,Hai Phong City,An Duong,21,2,0,2,2
2022-03-23,Hai Phong City,Hai An District,6,1,0,1,1
2022-03-23,Hai Phong City,Hai An District,7,3,0,3,3
2022-03-23,Hai Phong City,Hai An District,8,11,4,7,7
2022-03-23,Hai Phong City,Hai An District,9,10,8,2,1
2022-03-23,Hai Phong City,Hai An District,10,9,9,0,0
2022-03-23,Hai Phong City,Hai An District,11,45,38,7,2
2022-03-23,Hai Phong City,Hai An District,12,23,20,3,0
2022-03-23,Hai Phong City,Hai An District,13,16,11,5,0
2022-03-23,Hai Phong City,Hai An District,14,13,11,2,1
2022-03-23,Hai Phong City,Hai An District,15,18,13,5,0
2022-03-23,Hai Phong City,Hai An District,16,15,11,4,0
2022-03-23,Hai Phong City,Hai An District,17,33,27,6,3
2022-03-23,Hai Phong City,Hai An District,18,32,24,8,6
2022-03-23,Hai Phong City,Hai An District,19,13,10,3,0
2022-03-23,Hai Phong City,Hai An District,20,11,10,1,0
2022-03-23,Hai Phong City,Hai An District,21,11,8,3,2
2022-03-23,Hai Phong City,Hong Bang District,6,1,1,0,0
2022-03-23,Hai Phong City,Hong Bang District,7,7,4,3,2
2022-03-23,Hai Phong City,Hong Bang District,8,31,25,6,2
2022-03-23,Hai Phong City,Hong Bang District,9,29,24,5,4
2022-03-23,Hai Phong City,Hong Bang District,10,45,39,6,0
2022-03-23,Hai Phong City,Hong Bang District,11,109,90,19,8
2022-03-23,Hai Phong City,Hong Bang District,12,60,59,1,0
2022-03-23,Hai Phong City,Hong Bang District,13,33,32,1,0
2022-03-23,Hai Phong City,Hong Bang District,14,24,20,4,0
2022-03-23,Hai Phong City,Hong Bang District,15,30,26,4,3
2022-03-23,Hai Phong City,Hong Bang District,16,37,33,4,0
2022-03-23,Hai Phong City,Hong Bang District,17,49,35,14,9
2022-03-23,Hai Phong City,Hong Bang District,18,70,47,23,16
2022-03-23,Hai Phong City,Hong Bang District,19,49,38,11,6
2022-03-23,Hai Phong City,Hong Bang District,20,29,19,10,5
2022-03-23,Hai Phong City,Hong Bang District,21,15,9,6,2
2022-03-23,Hai Phong City,Kien An District,8,5,3,2,1
2022-03-23,Hai Phong City,Kien An District,9,4,3,1,1
2022-03-23,Hai Phong City,Kien An District,10,9,5,4,2
2022-03-23,Hai Phong City,Kien An District,11,11,11,0,0
2022-03-23,Hai Phong City,Kien An District,12,6,4,2,0
2022-03-23,Hai Phong City,Kien An District,13,4,3,1,0
2022-03-23,Hai Phong City,Kien An District,14,10,3,7,5
2022-03-23,Hai Phong City,Kien An District,15,9,8,1,0
2022-03-23,Hai Phong City,Kien An District,16,5,3,2,1
2022-03-23,Hai Phong City,Kien An District,17,10,6,4,3
2022-03-23,Hai Phong City,Kien An District,18,23,15,8,7
2022-03-23,Hai Phong City,Kien An District,19,6,6,0,0
2022-03-23,Hai Phong City,Kien An District,20,7,6,1,1
2022-03-23,Hai Phong City,Kien An District,21,5,0,5,4
2022-03-23,Hai Phong City,Le Chan District,0,1,0,1,0
2022-03-23,Hai Phong City,Le Chan District,5,1,0,1,1
2022-03-23,Hai Phong City,Le Chan District,6,2,2,0,0
2022-03-23,Hai Phong City,Le Chan District,7,28,12,16,12
2022-03-23,Hai Phong City,Le Chan District,8,55,39,16,10
2022-03-23,Hai Phong City,Le Chan District,9,62,47,15,1
2022-03-23,Hai Phong City,Le Chan District,10,142,128,14,1
2022-03-23,Hai Phong City,Le Chan District,11,321,277,44,16
2022-03-23,Hai Phong City,Le Chan District,12,161,152,9,3
2022-03-23,Hai Phong City,Le Chan District,13,115,101,14,1
2022-03-23,Hai Phong City,Le Chan District,14,112,99,13,0
2022-03-23,Hai Phong City,Le Chan District,15,143,128,15,1
2022-03-23,Hai Phong City,Le Chan District,16,130,107,23,1
2022-03-23,Hai Phong City,Le Chan District,17,215,170,45,26
2022-03-23,Hai Phong City,Le Chan District,18,222,173,49,30
2022-03-23,Hai Phong City,Le Chan District,19,178,154,24,5
2022-03-23,Hai Phong City,Le Chan District,20,109,90,19,9
2022-03-23,Hai Phong City,Le Chan District,21,73,47,26,10
2022-03-23,Hai Phong City,Le Chan District,22,2,0,2,1
2022-03-23,Hai Phong City,Le Chan District,23,1,1,0,0
2022-03-23,Hai Phong City,Ngo Quyen District,0,1,0,1,0
2022-03-23,Hai Phong City,Ngo Quyen District,1,3,1,2,0
2022-03-23,Hai Phong City,Ngo Quyen District,5,1,0,1,1
2022-03-23,Hai Phong City,Ngo Quyen District,7,29,14,15,12
2022-03-23,Hai Phong City,Ngo Quyen District,8,111,79,32,27
2022-03-23,Hai Phong City,Ngo Quyen District,9,73,62,11,4
2022-03-23,Hai Phong City,Ngo Quyen District,10,130,123,7,2
2022-03-23,Hai Phong City,Ngo Quyen District,11,218,187,31,7
2022-03-23,Hai Phong City,Ngo Quyen District,12,127,121,6,2
2022-03-23,Hai Phong City,Ngo Quyen District,13,74,70,4,0
2022-03-23,Hai Phong City,Ngo Quyen District,14,120,106,14,0
2022-03-23,Hai Phong City,Ngo Quyen District,15,125,117,8,1
2022-03-23,Hai Phong City,Ngo Quyen District,16,128,117,11,2
2022-03-23,Hai Phong City,Ngo Quyen District,17,158,120,38,21
2022-03-23,Hai Phong City,Ngo Quyen District,18,189,145,44,23
2022-03-23,Hai Phong City,Ngo Quyen District,19,140,115,25,4
2022-03-23,Hai Phong City,Ngo Quyen District,20,129,106,23,6
2022-03-23,Hai Phong City,Ngo Quyen District,21,76,44,32,12
2022-03-23,Hai Phong City,Thuy Nguyen,11,4,0,4,4
2022-03-23,Hai Phong City,Thuy Nguyen,12,2,1,1,1
2022-03-23,Hai Phong City,Thuy Nguyen,14,1,0,1,1
2022-03-23,Hai Phong City,Thuy Nguyen,18,2,0,2,2
2022-03-23,Hue City,Hue City,3,1,1,0,0
2022-03-23,Hue City,Hue City,5,3,3,0,0
2022-03-23,Hue City,Hue City,6,78,71,7,0
2022-03-23,Hue City,Hue City,7,227,208,19,0
2022-03-23,Hue City,Hue City,8,296,266,30,0
2022-03-23,Hue City,Hue City,9,255,234,21,0
2022-03-23,Hue City,Hue City,10,408,379,29,0
2022-03-23,Hue City,Hue City,11,938,871,67,0
2022-03-23,Hue City,Hue City,12,493,461,32,0
2022-03-23,Hue City,Hue City,13,280,261,19,0
2022-03-23,Hue City,Hue City,14,294,275,19,1
2022-03-23,Hue City,Hue City,15,343,316,27,0
2022-03-23,Hue City,Hue City,16,421,380,41,4
2022-03-23,Hue City,Hue City,17,645,600,45,9
2022-03-23,Hue City,Hue City,18,682,633,49,1
2022-03-23,Hue City,Hue City,19,575,529,46,2
2022-03-23,Hue City,Hue City,20,380,344,36,3
2022-03-23,Hue City,Hue City,21,230,190,40,10
2022-03-23,Hue City,Hue City,22,11,5,6,1
2022-03-23,Hue City,Hue City,23,1,0,1,0
2022-03-23,Hue City,Huong Thuy,9,2,2,0,0
2022-03-23,Hue City,Huong Thuy,13,1,0,1,1
2022-03-23,Hue City,Huong Thuy,14,1,1,0,0
2022-03-23,Hue City,Huong Thuy,16,1,1,0,0
2022-03-23,Hue City,Huong Thuy,17,2,1,1,0
2022-03-23,Hue City,Huong Thuy,18,1,0,1,0
2022-03-23,Hue City,Huong Thuy,19,1,1,0,0
2022-03-23,Hue City,Huong Thuy,20,1,1,0,0
2022-03-23,Hue City,Huong Thuy,21,1,0,1,0
2022-03-23,Hue City,Huong Tra,13,1,1,0,0
2022-03-23,Hue City,Huong Tra,15,1,1,0,0
2022-03-23,Hue City,Phu Vang,7,3,3,0,0
2022-03-23,Hue City,Phu Vang,8,2,2,0,0
2022-03-23,Hue City,Phu Vang,9,2,1,1,0
2022-03-23,Hue City,Phu Vang,10,3,2,1,0
2022-03-23,Hue City,Phu Vang,11,1,1,0,0
2022-03-23,Hue City,Phu Vang,12,2,2,0,0
2022-03-23,Hue City,Phu Vang,13,1,0,1,0
2022-03-23,Hue City,Phu Vang,15,3,2,1,0
2022-03-23,Hue City,Phu Vang,16,1,1,0,0
2022-03-23,Hue City,Phu Vang,17,2,1,1,0
2022-03-23,Hue City,Phu Vang,18,1,1,0,0
2022-03-23,Hue City,Phu Vang,19,1,1,0,0
2022-03-23,Hue City,Phu Vang,20,2,1,1,0
2022-03-23,Hue City,Phu Vang,21,1,1,0,0
2022-03-23,Vung Tau,Ba Ria City,6,1,0,1,1
2022-03-23,Vung Tau,Ba Ria City,7,1,0,1,1
2022-03-23,Vung Tau,Ba Ria City,8,5,5,0,0
2022-03-23,Vung Tau,Ba Ria City,9,5,5,0,0
2022-03-23,Vung Tau,Ba Ria City,10,2,2,0,0
2022-03-23,Vung Tau,Ba Ria City,11,2,2,0,0
2022-03-23,Vung Tau,Ba Ria City,12,5,4,1,0
2022-03-23,Vung Tau,Ba Ria City,13,14,7,7,4
2022-03-23,Vung Tau,Ba Ria City,14,2,2,0,0
2022-03-23,Vung Tau,Ba Ria City,15,7,3,4,4
2022-03-23,Vung Tau,Ba Ria City,16,4,2,2,2
2022-03-23,Vung Tau,Ba Ria City,17,5,2,3,1
2022-03-23,Vung Tau,Ba Ria City,18,12,3,9,5
2022-03-23,Vung Tau,Ba Ria City,19,12,0,12,11
2022-03-23,Vung Tau,Ba Ria City,20,9,0,9,9
2022-03-23,Vung Tau,Ba Ria City,21,8,0,8,8
2022-03-23,Vung Tau,Vung Tau City,5,1,1,0,0
2022-03-23,Vung Tau,Vung Tau City,6,28,27,1,1
2022-03-23,Vung Tau,Vung Tau City,7,96,92,4,1
2022-03-23,Vung Tau,Vung Tau City,8,148,140,8,1
2022-03-23,Vung Tau,Vung Tau City,9,139,128,11,0
2022-03-23,Vung Tau,Vung Tau City,10,171,154,17,1
2022-03-23,Vung Tau,Vung Tau City,11,346,321,25,3
2022-03-23,Vung Tau,Vung Tau City,12,249,237,12,1
2022-03-23,Vung Tau,Vung Tau City,13,182,166,16,5
2022-03-23,Vung Tau,Vung Tau City,14,183,167,16,1
2022-03-23,Vung Tau,Vung Tau City,15,187,169,18,1
2022-03-23,Vung Tau,Vung Tau City,16,193,178,15,1
2022-03-23,Vung Tau,Vung Tau City,17,218,205,13,0
2022-03-23,Vung Tau,Vung Tau City,18,277,258,19,3
2022-03-23,Vung Tau,Vung Tau City,19,232,213,19,1
2022-03-23,Vung Tau,Vung Tau City,20,167,148,19,2
2022-03-23,Vung Tau,Vung Tau City,21,80,57,23,9
2022-03-23,Vung Tau,Vung Tau City,22,5,1,4,0
2022-03-24,Binh Duong,Ben Cat,11,1,0,1,1
2022-03-24,Binh Duong,Ben Cat,14,1,0,1,1
2022-03-24,Binh Duong,Ben Cat,18,2,0,2,2
2022-03-24,Binh Duong,Ben Cat,19,2,0,2,2
2022-03-24,Binh Duong,Ben Cat,20,1,1,0,0
2022-03-24,Binh Duong,Di An,6,1,0,1,1
2022-03-24,Binh Duong,Di An,7,2,1,1,0
2022-03-24,Binh Duong,Di An,8,10,1,9,8
2022-03-24,Binh Duong,Di An,9,18,6,12,7
2022-03-24,Binh Duong,Di An,10,17,12,5,4
2022-03-24,Binh Duong,Di An,11,33,20,13,9
2022-03-24,Binh Duong,Di An,12,22,16,6,5
2022-03-24,Binh Duong,Di An,13,29,18,11,8
2022-03-24,Binh Duong,Di An,14,25,14,11,7
2022-03-24,Binh Duong,Di An,15,12,10,2,2
2022-03-24,Binh Duong,Di An,16,9,6,3,2
2022-03-24,Binh Duong,Di An,17,18,9,9,5
2022-03-24,Binh Duong,Di An,18,14,8,6,3
2022-03-24,Binh Duong,Di An,19,13,8,5,3
2022-03-24,Binh Duong,Di An,20,8,2,6,5
2022-03-24,Binh Duong,Di An,21,12,4,8,5
2022-03-24,Binh Duong,Tan Uyen,9,1,0,1,1
2022-03-24,Binh Duong,Tan Uyen,10,1,0,1,1
2022-03-24,Binh Duong,Tan Uyen,11,1,0,1,1
2022-03-24,Binh Duong,Tan Uyen,12,1,1,0,0
2022-03-24,Binh Duong,Tan Uyen,14,4,0,4,4
2022-03-24,Binh Duong,Tan Uyen,16,1,0,1,1
2022-03-24,Binh Duong,Tan Uyen,18,2,1,1,0
2022-03-24,Binh Duong,Tan Uyen,20,3,0,3,1
2022-03-24,Binh Duong,Thu Dau Mot Town,0,1,0,1,1
2022-03-24,Binh Duong,Thu Dau Mot Town,3,2,0,2,0
2022-03-24,Binh Duong,Thu Dau Mot Town,4,2,1,1,0
2022-03-24,Binh Duong,Thu Dau Mot Town,6,30,26,4,1
2022-03-24,Binh Duong,Thu Dau Mot Town,7,116,110,6,2
2022-03-24,Binh Duong,Thu Dau Mot Town,8,199,181,18,2
2022-03-24,Binh Duong,Thu Dau Mot Town,9,193,181,12,0
2022-03-24,Binh Duong,Thu Dau Mot Town,10,350,316,34,5
2022-03-24,Binh Duong,Thu Dau Mot Town,11,578,538,40,8
2022-03-24,Binh Duong,Thu Dau Mot Town,12,363,336,27,6
2022-03-24,Binh Duong,Thu Dau Mot Town,13,345,324,21,1
2022-03-24,Binh Duong,Thu Dau Mot Town,14,306,287,19,0
2022-03-24,Binh Duong,Thu Dau Mot Town,15,241,219,22,6
2022-03-24,Binh Duong,Thu Dau Mot Town,16,278,260,18,6
2022-03-24,Binh Duong,Thu Dau Mot Town,17,316,293,23,3
2022-03-24,Binh Duong,Thu Dau Mot Town,18,352,308,44,6
2022-03-24,Binh Duong,Thu Dau Mot Town,19,289,265,24,4
2022-03-24,Binh Duong,Thu Dau Mot Town,20,214,197,17,0
2022-03-24,Binh Duong,Thu Dau Mot Town,21,90,76,14,5
2022-03-24,Binh Duong,Thu Dau Mot Town,23,1,1,0,0
2022-03-24,Binh Duong,Thuan An,7,9,2,7,2
2022-03-24,Binh Duong,Thuan An,8,11,5,6,5
2022-03-24,Binh Duong,Thuan An,9,40,21,19,11
2022-03-24,Binh Duong,Thuan An,10,46,34,12,11
2022-03-24,Binh Duong,Thuan An,11,73,49,24,15
2022-03-24,Binh Duong,Thuan An,12,53,33,20,15
2022-03-24,Binh Duong,Thuan An,13,44,25,19,16
2022-03-24,Binh Duong,Thuan An,14,27,21,6,5
2022-03-24,Binh Duong,Thuan An,15,30,22,8,3
2022-03-24,Binh Duong,Thuan An,16,23,19,4,3
2022-03-24,Binh Duong,Thuan An,17,33,21,12,3
2022-03-24,Binh Duong,Thuan An,18,35,28,7,3
2022-03-24,Binh Duong,Thuan An,19,27,19,8,6
2022-03-24,Binh Duong,Thuan An,20,15,11,4,4
2022-03-24,Binh Duong,Thuan An,21,10,0,10,4
2022-03-24,Can Tho City,Binh Thuy District,7,3,3,0,0
2022-03-24,Can Tho City,Binh Thuy District,8,1,1,0,0
2022-03-24,Can Tho City,Binh Thuy District,9,5,4,1,0
2022-03-24,Can Tho City,Binh Thuy District,10,7,6,1,0
2022-03-24,Can Tho City,Binh Thuy District,11,8,8,0,0
2022-03-24,Can Tho City,Binh Thuy District,12,10,9,1,0
2022-03-24,Can Tho City,Binh Thuy District,13,8,8,0,0
2022-03-24,Can Tho City,Binh Thuy District,14,16,15,1,0
2022-03-24,Can Tho City,Binh Thuy District,15,15,14,1,0
2022-03-24,Can Tho City,Binh Thuy District,16,10,9,1,0
2022-03-24,Can Tho City,Binh Thuy District,17,4,4,0,0
2022-03-24,Can Tho City,Binh Thuy District,18,13,11,2,1
2022-03-24,Can Tho City,Binh Thuy District,19,10,8,2,0
2022-03-24,Can Tho City,Binh Thuy District,20,5,4,1,0
2022-03-24,Can Tho City,Binh Thuy District,21,3,1,2,0
2022-03-24,Can Tho City,Cai Rang District,7,3,2,1,0
2022-03-24,Can Tho City,Cai Rang District,8,5,4,1,1
2022-03-24,Can Tho City,Cai Rang District,9,6,6,0,0
2022-03-24,Can Tho City,Cai Rang District,10,9,8,1,0
2022-03-24,Can Tho City,Cai Rang District,11,13,9,4,1
2022-03-24,Can Tho City,Cai Rang District,12,8,7,1,0
2022-03-24,Can Tho City,Cai Rang District,13,6,5,1,0
2022-03-24,Can Tho City,Cai Rang District,14,5,5,0,0
2022-03-24,Can Tho City,Cai Rang District,15,7,7,0,0
2022-03-24,Can Tho City,Cai Rang District,16,6,5,1,0
2022-03-24,Can Tho City,Cai Rang District,17,5,5,0,0
2022-03-24,Can Tho City,Cai Rang District,18,8,8,0,0
2022-03-24,Can Tho City,Cai Rang District,19,9,9,0,0
2022-03-24,Can Tho City,Cai Rang District,20,9,7,2,0
2022-03-24,Can Tho City,Cai Rang District,21,3,3,0,0
2022-03-24,Can Tho City,Ninh Kieu District,0,2,1,1,0
2022-03-24,Can Tho City,Ninh Kieu District,1,1,0,1,0
2022-03-24,Can Tho City,Ninh Kieu District,2,1,1,0,0
2022-03-24,Can Tho City,Ninh Kieu District,3,2,1,1,0
2022-03-24,Can Tho City,Ninh Kieu District,4,1,1,0,0
2022-03-24,Can Tho City,Ninh Kieu District,5,2,1,1,0
2022-03-24,Can Tho City,Ninh Kieu District,6,36,33,3,0
2022-03-24,Can Tho City,Ninh Kieu District,7,111,107,4,0
2022-03-24,Can Tho City,Ninh Kieu District,8,222,206,16,0
2022-03-24,Can Tho City,Ninh Kieu District,9,257,240,17,0
2022-03-24,Can Tho City,Ninh Kieu District,10,578,552,26,0
2022-03-24,Can Tho City,Ninh Kieu District,11,821,775,46,0
2022-03-24,Can Tho City,Ninh Kieu District,12,570,543,27,0
2022-03-24,Can Tho City,Ninh Kieu District,13,394,376,18,0
2022-03-24,Can Tho City,Ninh Kieu District,14,373,359,14,0
2022-03-24,Can Tho City,Ninh Kieu District,15,297,283,14,0
2022-03-24,Can Tho City,Ninh Kieu District,16,410,387,23,0
2022-03-24,Can Tho City,Ninh Kieu District,17,494,461,33,0
2022-03-24,Can Tho City,Ninh Kieu District,18,501,469,32,0
2022-03-24,Can Tho City,Ninh Kieu District,19,444,420,24,0
2022-03-24,Can Tho City,Ninh Kieu District,20,342,309,33,2
2022-03-24,Can Tho City,Ninh Kieu District,21,196,175,21,2
2022-03-24,Can Tho City,Ninh Kieu District,22,8,6,2,0
2022-03-24,Dong Nai,Bien Hoa City,1,3,2,1,1
2022-03-24,Dong Nai,Bien Hoa City,3,1,0,1,0
2022-03-24,Dong Nai,Bien Hoa City,4,2,2,0,0
2022-03-24,Dong Nai,Bien Hoa City,5,2,1,1,1
2022-03-24,Dong Nai,Bien Hoa City,6,46,20,26,17
2022-03-24,Dong Nai,Bien Hoa City,7,156,120,36,20
2022-03-24,Dong Nai,Bien Hoa City,8,236,206,30,5
2022-03-24,Dong Nai,Bien Hoa City,9,341,301,40,9
2022-03-24,Dong Nai,Bien Hoa City,10,640,569,71,14
2022-03-24,Dong Nai,Bien Hoa City,11,982,878,104,31
2022-03-24,Dong Nai,Bien Hoa City,12,749,687,62,11
2022-03-24,Dong Nai,Bien Hoa City,13,680,633,47,5
2022-03-24,Dong Nai,Bien Hoa City,14,567,517,50,16
2022-03-24,Dong Nai,Bien Hoa City,15,517,431,86,29
2022-03-24,Dong Nai,Bien Hoa City,16,499,443,56,12
2022-03-24,Dong Nai,Bien Hoa City,17,565,487,78,25
2022-03-24,Dong Nai,Bien Hoa City,18,607,553,54,14
2022-03-24,Dong Nai,Bien Hoa City,19,585,512,73,16
2022-03-24,Dong Nai,Bien Hoa City,20,441,365,76,30
2022-03-24,Dong Nai,Bien Hoa City,21,167,113,54,18
2022-03-24,Dong Nai,Bien Hoa City,22,4,1,3,1
2022-03-24,Dong Nai,Cam My,19,1,0,1,1
2022-03-24,Dong Nai,Long Khanh,20,1,0,1,1
2022-03-24,Dong Nai,Long Thanh,9,1,0,1,1
2022-03-24,Dong Nai,Long Thanh,13,2,0,2,2
2022-03-24,Dong Nai,Long Thanh,14,1,0,1,1
2022-03-24,Dong Nai,Long Thanh,16,1,0,1,1
2022-03-24,Dong Nai,Long Thanh,19,1,0,1,1
2022-03-24,Dong Nai,Nhon trach,10,1,0,1,1
2022-03-24,Dong Nai,Nhon trach,14,1,0,1,1
2022-03-24,Dong Nai,Thong Nhat,10,1,1,0,0
2022-03-24,Dong Nai,Thong Nhat,11,1,1,0,0
2022-03-24,Dong Nai,Thong Nhat,12,1,1,0,0
2022-03-24,Dong Nai,Thong Nhat,14,1,1,0,0
2022-03-24,Dong Nai,Thong Nhat,16,1,1,0,0
2022-03-24,Dong Nai,Thong Nhat,19,1,1,0,0
2022-03-24,Dong Nai,Thong Nhat,20,1,1,0,0
2022-03-24,Dong Nai,Trang Bom,12,1,0,1,1
2022-03-24,Dong Nai,Trang Bom,14,1,0,1,0
2022-03-24,Dong Nai,Trang Bom,15,1,0,1,1
2022-03-24,Hai Phong City,An Duong,1,1,1,0,0
2022-03-24,Hai Phong City,An Duong,7,2,1,1,1
2022-03-24,Hai Phong City,An Duong,8,5,2,3,0
2022-03-24,Hai Phong City,An Duong,9,1,0,1,0
2022-03-24,Hai Phong City,An Duong,10,6,2,4,2
2022-03-24,Hai Phong City,An Duong,11,9,3,6,3
2022-03-24,Hai Phong City,An Duong,12,9,2,7,5
2022-03-24,Hai Phong City,An Duong,13,9,0,9,8
2022-03-24,Hai Phong City,An Duong,14,18,1,17,15
2022-03-24,Hai Phong City,An Duong,15,6,2,4,4
2022-03-24,Hai Phong City,An Duong,16,2,1,1,1
2022-03-24,Hai Phong City,An Duong,17,7,2,5,4
2022-03-24,Hai Phong City,An Duong,18,5,4,1,1
2022-03-24,Hai Phong City,An Duong,19,2,0,2,2
2022-03-24,Hai Phong City,An Duong,20,1,1,0,0
2022-03-24,Hai Phong City,Hai An District,6,1,0,1,1
2022-03-24,Hai Phong City,Hai An District,7,1,0,1,0
2022-03-24,Hai Phong City,Hai An District,8,9,7,2,1
2022-03-24,Hai Phong City,Hai An District,9,10,8,2,1
2022-03-24,Hai Phong City,Hai An District,10,13,12,1,0
2022-03-24,Hai Phong City,Hai An District,11,39,35,4,0
2022-03-24,Hai Phong City,Hai An District,12,16,14,2,0
2022-03-24,Hai Phong City,Hai An District,13,8,8,0,0
2022-03-24,Hai Phong City,Hai An District,14,13,10,3,1
2022-03-24,Hai Phong City,Hai An District,15,20,19,1,1
2022-03-24,Hai Phong City,Hai An District,16,16,15,1,1
2022-03-24,Hai Phong City,Hai An District,17,16,11,5,2
2022-03-24,Hai Phong City,Hai An District,18,26,23,3,1
2022-03-24,Hai Phong City,Hai An District,19,15,13,2,0
2022-03-24,Hai Phong City,Hai An District,20,15,13,2,1
2022-03-24,Hai Phong City,Hai An District,21,6,6,0,0
2022-03-24,Hai Phong City,Hong Bang District,1,3,0,3,0
2022-03-24,Hai Phong City,Hong Bang District,6,1,1,0,0
2022-03-24,Hai Phong City,Hong Bang District,7,12,8,4,2
2022-03-24,Hai Phong City,Hong Bang District,8,18,18,0,0
2022-03-24,Hai Phong City,Hong Bang District,9,16,15,1,0
2022-03-24,Hai Phong City,Hong Bang District,10,54,48,6,0
2022-03-24,Hai Phong City,Hong Bang District,11,89,77,12,4
2022-03-24,Hai Phong City,Hong Bang District,12,45,39,6,0
2022-03-24,Hai Phong City,Hong Bang District,13,27,24,3,0
2022-03-24,Hai Phong City,Hong Bang District,14,33,26,7,3
2022-03-24,Hai Phong City,Hong Bang District,15,36,31,5,2
2022-03-24,Hai Phong City,Hong Bang District,16,27,22,5,0
2022-03-24,Hai Phong City,Hong Bang District,17,43,32,11,0
2022-03-24,Hai Phong City,Hong Bang District,18,53,48,5,1
2022-03-24,Hai Phong City,Hong Bang District,19,57,50,7,1
2022-03-24,Hai Phong City,Hong Bang District,20,23,17,6,1
2022-03-24,Hai Phong City,Hong Bang District,21,7,6,1,0
2022-03-24,Hai Phong City,Kien An District,7,1,0,1,1
2022-03-24,Hai Phong City,Kien An District,8,5,3,2,1
2022-03-24,Hai Phong City,Kien An District,9,5,0,5,3
2022-03-24,Hai Phong City,Kien An District,10,11,5,6,4
2022-03-24,Hai Phong City,Kien An District,11,16,12,4,1
2022-03-24,Hai Phong City,Kien An District,12,7,3,4,3
2022-03-24,Hai Phong City,Kien An District,13,6,1,5,4
2022-03-24,Hai Phong City,Kien An District,14,14,4,10,10
2022-03-24,Hai Phong City,Kien An District,15,10,4,6,4
2022-03-24,Hai Phong City,Kien An District,16,12,9,3,1
2022-03-24,Hai Phong City,Kien An District,17,6,4,2,1
2022-03-24,Hai Phong City,Kien An District,18,11,4,7,7
2022-03-24,Hai Phong City,Kien An District,19,8,6,2,0
2022-03-24,Hai Phong City,Kien An District,20,12,6,6,4
2022-03-24,Hai Phong City,Kien An District,21,4,4,0,0
2022-03-24,Hai Phong City,Kien An District,22,2,0,2,0
2022-03-24,Hai Phong City,Le Chan District,1,1,0,1,0
2022-03-24,Hai Phong City,Le Chan District,2,1,0,1,0
2022-03-24,Hai Phong City,Le Chan District,7,44,34,10,4
2022-03-24,Hai Phong City,Le Chan District,8,62,55,7,0
2022-03-24,Hai Phong City,Le Chan District,9,60,55,5,0
2022-03-24,Hai Phong City,Le Chan District,10,136,118,18,1
2022-03-24,Hai Phong City,Le Chan District,11,262,231,31,5
2022-03-24,Hai Phong City,Le Chan District,12,163,150,13,2
2022-03-24,Hai Phong City,Le Chan District,13,84,76,8,1
2022-03-24,Hai Phong City,Le Chan District,14,103,94,9,2
2022-03-24,Hai Phong City,Le Chan District,15,150,126,24,6
2022-03-24,Hai Phong City,Le Chan District,16,130,109,21,0
2022-03-24,Hai Phong City,Le Chan District,17,144,135,9,1
2022-03-24,Hai Phong City,Le Chan District,18,207,187,20,3
2022-03-24,Hai Phong City,Le Chan District,19,190,167,23,6
2022-03-24,Hai Phong City,Le Chan District,20,130,107,23,7
2022-03-24,Hai Phong City,Le Chan District,21,52,43,9,2
2022-03-24,Hai Phong City,Le Chan District,22,1,1,0,0
2022-03-24,Hai Phong City,Le Chan District,23,1,1,0,0
2022-03-24,Hai Phong City,Ngo Quyen District,2,1,0,1,0
2022-03-24,Hai Phong City,Ngo Quyen District,7,15,13,2,1
2022-03-24,Hai Phong City,Ngo Quyen District,8,51,45,6,0
2022-03-24,Hai Phong City,Ngo Quyen District,9,54,52,2,0
2022-03-24,Hai Phong City,Ngo Quyen District,10,115,104,11,0
2022-03-24,Hai Phong City,Ngo Quyen District,11,221,191,30,8
2022-03-24,Hai Phong City,Ngo Quyen District,12,129,123,6,1
2022-03-24,Hai Phong City,Ngo Quyen District,13,94,90,4,0
2022-03-24,Hai Phong City,Ngo Quyen District,14,121,98,23,8
2022-03-24,Hai Phong City,Ngo Quyen District,15,144,123,21,6
2022-03-24,Hai Phong City,Ngo Quyen District,16,115,99,16,1
2022-03-24,Hai Phong City,Ngo Quyen District,17,130,109,21,3
2022-03-24,Hai Phong City,Ngo Quyen District,18,125,119,6,0
2022-03-24,Hai Phong City,Ngo Quyen District,19,132,115,17,2
2022-03-24,Hai Phong City,Ngo Quyen District,20,102,89,13,2
2022-03-24,Hai Phong City,Ngo Quyen District,21,55,41,14,3
2022-03-24,Hai Phong City,Ngo Quyen District,22,2,1,1,0
2022-03-24,Hai Phong City,Thuy Nguyen,9,1,0,1,1
2022-03-24,Hai Phong City,Thuy Nguyen,12,1,0,1,1
2022-03-24,Hai Phong City,Thuy Nguyen,13,5,0,5,5
2022-03-24,Hai Phong City,Thuy Nguyen,14,1,0,1,1
2022-03-24,Hai Phong City,Thuy Nguyen,16,5,1,4,3
2022-03-24,Hai Phong City,Thuy Nguyen,17,2,1,1,1
2022-03-24,Hai Phong City,Thuy Nguyen,19,2,0,2,2
2022-03-24,Hue City,Hue City,0,1,1,0,0
2022-03-24,Hue City,Hue City,1,1,1,0,0
2022-03-24,Hue City,Hue City,3,5,4,1,0
2022-03-24,Hue City,Hue City,4,1,1,0,0
2022-03-24,Hue City,Hue City,5,3,3,0,0
2022-03-24,Hue City,Hue City,6,65,60,5,1
2022-03-24,Hue City,Hue City,7,160,150,10,0
2022-03-24,Hue City,Hue City,8,257,236,21,0
2022-03-24,Hue City,Hue City,9,226,204,22,1
2022-03-24,Hue City,Hue City,10,309,293,16,1
2022-03-24,Hue City,Hue City,11,689,648,41,2
2022-03-24,Hue City,Hue City,12,474,447,27,0
2022-03-24,Hue City,Hue City,13,260,244,16,0
2022-03-24,Hue City,Hue City,14,285,257,28,4
2022-03-24,Hue City,Hue City,15,325,298,27,1
2022-03-24,Hue City,Hue City,16,324,304,20,4
2022-03-24,Hue City,Hue City,17,453,424,29,2
2022-03-24,Hue City,Hue City,18,591,533,58,0
2022-03-24,Hue City,Hue City,19,561,522,39,1
2022-03-24,Hue City,Hue City,20,410,365,45,6
2022-03-24,Hue City,Hue City,21,205,163,42,6
2022-03-24,Hue City,Hue City,22,3,0,3,0
2022-03-24,Hue City,Hue City,23,2,1,1,0
2022-03-24,Hue City,Huong Thuy,7,1,1,0,0
2022-03-24,Hue City,Huong Thuy,8,1,1,0,0
2022-03-24,Hue City,Huong Thuy,10,1,1,0,0
2022-03-24,Hue City,Huong Thuy,12,1,1,0,0
2022-03-24,Hue City,Huong Thuy,15,1,0,1,1
2022-03-24,Hue City,Huong Thuy,17,5,2,3,1
2022-03-24,Hue City,Huong Thuy,18,4,2,2,1
2022-03-24,Hue City,Huong Thuy,20,2,0,2,2
2022-03-24,Hue City,Huong Thuy,21,1,0,1,1
2022-03-24,Hue City,Huong Tra,10,1,1,0,0
2022-03-24,Hue City,Huong Tra,11,2,2,0,0
2022-03-24,Hue City,Huong Tra,15,1,1,0,0
2022-03-24,Hue City,Huong Tra,19,1,0,1,0
2022-03-24,Hue City,Phu Vang,7,1,0,1,0
2022-03-24,Hue City,Phu Vang,8,1,1,0,0
2022-03-24,Hue City,Phu Vang,9,1,0,1,1
2022-03-24,Hue City,Phu Vang,10,3,2,1,1
2022-03-24,Hue City,Phu Vang,11,1,0,1,0
2022-03-24,Hue City,Phu Vang,12,2,2,0,0
2022-03-24,Hue City,Phu Vang,13,2,0,2,2
2022-03-24,Hue City,Phu Vang,14,1,1,0,0
2022-03-24,Hue City,Phu Vang,15,1,1,0,0
2022-03-24,Hue City,Phu Vang,16,1,0,1,0
2022-03-24,Hue City,Phu Vang,18,2,2,0,0
2022-03-24,Hue City,Phu Vang,19,7,3,4,0
2022-03-24,Hue City,Phu Vang,20,2,2,0,0
2022-03-24,Hue City,Phu Vang,21,1,1,0,0
2022-03-24,Vung Tau,Ba Ria City,6,2,0,2,2
2022-03-24,Vung Tau,Ba Ria City,7,4,0,4,2
2022-03-24,Vung Tau,Ba Ria City,8,2,1,1,1
2022-03-24,Vung Tau,Ba Ria City,9,7,6,1,0
2022-03-24,Vung Tau,Ba Ria City,10,2,0,2,1
2022-03-24,Vung Tau,Ba Ria City,11,9,5,4,0
2022-03-24,Vung Tau,Ba Ria City,12,7,7,0,0
2022-03-24,Vung Tau,Ba Ria City,13,4,4,0,0
2022-03-24,Vung Tau,Ba Ria City,14,10,4,6,6
2022-03-24,Vung Tau,Ba Ria City,15,7,3,4,4
2022-03-24,Vung Tau,Ba Ria City,16,4,4,0,0
2022-03-24,Vung Tau,Ba Ria City,17,4,3,1,1
2022-03-24,Vung Tau,Ba Ria City,18,2,2,0,0
2022-03-24,Vung Tau,Ba Ria City,19,2,2,0,0
2022-03-24,Vung Tau,Ba Ria City,20,3,1,2,1
2022-03-24,Vung Tau,Vung Tau City,0,1,0,1,1
2022-03-24,Vung Tau,Vung Tau City,5,1,0,1,0
2022-03-24,Vung Tau,Vung Tau City,6,29,27,2,2
2022-03-24,Vung Tau,Vung Tau City,7,94,88,6,0
2022-03-24,Vung Tau,Vung Tau City,8,133,126,7,0
2022-03-24,Vung Tau,Vung Tau City,9,126,123,3,0
2022-03-24,Vung Tau,Vung Tau City,10,154,147,7,1
2022-03-24,Vung Tau,Vung Tau City,11,340,309,31,3
2022-03-24,Vung Tau,Vung Tau City,12,248,238,10,0
2022-03-24,Vung Tau,Vung Tau City,13,192,173,19,3
2022-03-24,Vung Tau,Vung Tau City,14,187,166,21,2
2022-03-24,Vung Tau,Vung Tau City,15,178,172,6,0
2022-03-24,Vung Tau,Vung Tau City,16,183,170,13,0
2022-03-24,Vung Tau,Vung Tau City,17,242,222,20,0
2022-03-24,Vung Tau,Vung Tau City,18,275,247,28,0
2022-03-24,Vung Tau,Vung Tau City,19,242,228,14,1
2022-03-24,Vung Tau,Vung Tau City,20,143,135,8,3
2022-03-24,Vung Tau,Vung Tau City,21,89,73,16,2
2022-03-24,Vung Tau,Vung Tau City,22,2,1,1,0
2022-03-25,Binh Duong,Ben Cat,10,1,0,1,1
2022-03-25,Binh Duong,Ben Cat,12,2,0,2,1
2022-03-25,Binh Duong,Ben Cat,13,1,0,1,1
2022-03-25,Binh Duong,Ben Cat,19,2,0,2,2
2022-03-25,Binh Duong,Di An,6,2,0,2,2
2022-03-25,Binh Duong,Di An,7,7,1,6,4
2022-03-25,Binh Duong,Di An,8,12,1,11,10
2022-03-25,Binh Duong,Di An,9,15,8,7,6
2022-03-25,Binh Duong,Di An,10,23,11,12,11
2022-03-25,Binh Duong,Di An,11,40,15,25,22
2022-03-25,Binh Duong,Di An,12,29,13,16,11
2022-03-25,Binh Duong,Di An,13,25,17,8,6
2022-03-25,Binh Duong,Di An,14,35,14,21,14
2022-03-25,Binh Duong,Di An,15,23,12,11,7
2022-03-25,Binh Duong,Di An,16,15,8,7,3
2022-03-25,Binh Duong,Di An,17,22,11,11,8
2022-03-25,Binh Duong,Di An,18,26,12,14,8
2022-03-25,Binh Duong,Di An,19,16,11,5,4
2022-03-25,Binh Duong,Di An,20,13,8,5,2
2022-03-25,Binh Duong,Di An,21,3,1,2,2
2022-03-25,Binh Duong,Di An,22,1,0,1,0
2022-03-25,Binh Duong,Tan Uyen,9,1,0,1,1
2022-03-25,Binh Duong,Tan Uyen,12,1,0,1,1
2022-03-25,Binh Duong,Tan Uyen,13,1,0,1,1
2022-03-25,Binh Duong,Tan Uyen,15,2,1,1,1
2022-03-25,Binh Duong,Tan Uyen,16,3,0,3,2
2022-03-25,Binh Duong,Tan Uyen,17,1,0,1,0
2022-03-25,Binh Duong,Tan Uyen,18,1,1,0,0
2022-03-25,Binh Duong,Tan Uyen,19,1,0,1,0
2022-03-25,Binh Duong,Tan Uyen,20,1,0,1,1
2022-03-25,Binh Duong,Tan Uyen,21,2,0,2,2
2022-03-25,Binh Duong,Thu Dau Mot Town,0,1,0,1,0
2022-03-25,Binh Duong,Thu Dau Mot Town,1,2,2,0,0
2022-03-25,Binh Duong,Thu Dau Mot Town,2,1,1,0,0
2022-03-25,Binh Duong,Thu Dau Mot Town,5,2,2,0,0
2022-03-25,Binh Duong,Thu Dau Mot Town,6,40,30,10,8
2022-03-25,Binh Duong,Thu Dau Mot Town,7,109,93,16,4
2022-03-25,Binh Duong,Thu Dau Mot Town,8,158,152,6,1
2022-03-25,Binh Duong,Thu Dau Mot Town,9,230,208,22,5
2022-03-25,Binh Duong,Thu Dau Mot Town,10,383,347,36,3
2022-03-25,Binh Duong,Thu Dau Mot Town,11,608,569,39,5
2022-03-25,Binh Duong,Thu Dau Mot Town,12,397,371,26,3
2022-03-25,Binh Duong,Thu Dau Mot Town,13,368,346,22,2
2022-03-25,Binh Duong,Thu Dau Mot Town,14,296,284,12,4
2022-03-25,Binh Duong,Thu Dau Mot Town,15,219,213,6,0
2022-03-25,Binh Duong,Thu Dau Mot Town,16,248,236,12,0
2022-03-25,Binh Duong,Thu Dau Mot Town,17,356,330,26,1
2022-03-25,Binh Duong,Thu Dau Mot Town,18,357,334,23,3
2022-03-25,Binh Duong,Thu Dau Mot Town,19,330,286,44,6
2022-03-25,Binh Duong,Thu Dau Mot Town,20,221,199,22,6
2022-03-25,Binh Duong,Thu Dau Mot Town,21,83,74,9,1
2022-03-25,Binh Duong,Thu Dau Mot Town,22,3,1,2,0
2022-03-25,Binh Duong,Thuan An,6,3,1,2,2
2022-03-25,Binh Duong,Thuan An,7,7,2,5,4
2022-03-25,Binh Duong,Thuan An,8,14,7,7,5
2022-03-25,Binh Duong,Thuan An,9,34,20,14,13
2022-03-25,Binh Duong,Thuan An,10,62,38,24,20
2022-03-25,Binh Duong,Thuan An,11,72,49,23,11
2022-03-25,Binh Duong,Thuan An,12,44,36,8,3
2022-03-25,Binh Duong,Thuan An,13,39,33,6,3
2022-03-25,Binh Duong,Thuan An,14,35,23,12,8
2022-03-25,Binh Duong,Thuan An,15,36,26,10,4
2022-03-25,Binh Duong,Thuan An,16,28,21,7,2
2022-03-25,Binh Duong,Thuan An,17,39,27,12,4
2022-03-25,Binh Duong,Thuan An,18,36,29,7,4
2022-03-25,Binh Duong,Thuan An,19,25,19,6,3
2022-03-25,Binh Duong,Thuan An,20,25,14,11,6
2022-03-25,Binh Duong,Thuan An,21,17,8,9,4
2022-03-25,Can Tho City,Binh Thuy District,1,1,1,0,0
2022-03-25,Can Tho City,Binh Thuy District,8,3,2,1,1
2022-03-25,Can Tho City,Binh Thuy District,9,8,8,0,0
2022-03-25,Can Tho City,Binh Thuy District,10,15,12,3,1
2022-03-25,Can Tho City,Binh Thuy District,11,12,10,2,0
2022-03-25,Can Tho City,Binh Thuy District,12,13,12,1,0
2022-03-25,Can Tho City,Binh Thuy District,13,13,12,1,1
2022-03-25,Can Tho City,Binh Thuy District,14,12,12,0,0
2022-03-25,Can Tho City,Binh Thuy District,15,12,11,1,0
2022-03-25,Can Tho City,Binh Thuy District,16,8,8,0,0
2022-03-25,Can Tho City,Binh Thuy District,17,13,11,2,0
2022-03-25,Can Tho City,Binh Thuy District,18,5,5,0,0
2022-03-25,Can Tho City,Binh Thuy District,19,6,5,1,0
2022-03-25,Can Tho City,Binh Thuy District,20,12,12,0,0
2022-03-25,Can Tho City,Binh Thuy District,21,3,2,1,0
2022-03-25,Can Tho City,Cai Rang District,0,1,1,0,0
2022-03-25,Can Tho City,Cai Rang District,6,8,5,3,2
2022-03-25,Can Tho City,Cai Rang District,7,1,1,0,0
2022-03-25,Can Tho City,Cai Rang District,8,6,4,2,2
2022-03-25,Can Tho City,Cai Rang District,9,9,6,3,0
2022-03-25,Can Tho City,Cai Rang District,10,10,5,5,2
2022-03-25,Can Tho City,Cai Rang District,11,14,13,1,0
2022-03-25,Can Tho City,Cai Rang District,12,8,8,0,0
2022-03-25,Can Tho City,Cai Rang District,13,9,8,1,0
2022-03-25,Can Tho City,Cai Rang District,14,8,8,0,0
2022-03-25,Can Tho City,Cai Rang District,15,11,10,1,0
2022-03-25,Can Tho City,Cai Rang District,16,5,4,1,0
2022-03-25,Can Tho City,Cai Rang District,17,10,10,0,0
2022-03-25,Can Tho City,Cai Rang District,18,9,7,2,0
2022-03-25,Can Tho City,Cai Rang District,19,13,10,3,0
2022-03-25,Can Tho City,Cai Rang District,20,8,6,2,0
2022-03-25,Can Tho City,Cai Rang District,21,1,0,1,1
2022-03-25,Can Tho City,Ninh Kieu District,0,9,7,2,0
2022-03-25,Can Tho City,Ninh Kieu District,1,7,6,1,0
2022-03-25,Can Tho City,Ninh Kieu District,2,1,1,0,0
2022-03-25,Can Tho City,Ninh Kieu District,3,1,1,0,0
2022-03-25,Can Tho City,Ninh Kieu District,5,4,3,1,1
2022-03-25,Can Tho City,Ninh Kieu District,6,61,50,11,4
2022-03-25,Can Tho City,Ninh Kieu District,7,121,117,4,0
2022-03-25,Can Tho City,Ninh Kieu District,8,257,248,9,0
2022-03-25,Can Tho City,Ninh Kieu District,9,307,294,13,1
2022-03-25,Can Tho City,Ninh Kieu District,10,620,587,33,0
2022-03-25,Can Tho City,Ninh Kieu District,11,823,789,34,0
2022-03-25,Can Tho City,Ninh Kieu District,12,624,595,29,0
2022-03-25,Can Tho City,Ninh Kieu District,13,434,411,23,0
2022-03-25,Can Tho City,Ninh Kieu District,14,391,369,22,0
2022-03-25,Can Tho City,Ninh Kieu District,15,374,349,25,0
2022-03-25,Can Tho City,Ninh Kieu District,16,383,356,27,0
2022-03-25,Can Tho City,Ninh Kieu District,17,511,481,30,0
2022-03-25,Can Tho City,Ninh Kieu District,18,523,497,26,0
2022-03-25,Can Tho City,Ninh Kieu District,19,471,437,34,0
2022-03-25,Can Tho City,Ninh Kieu District,20,336,310,26,0
2022-03-25,Can Tho City,Ninh Kieu District,21,173,161,12,0
2022-03-25,Can Tho City,Ninh Kieu District,22,2,2,0,0
2022-03-25,Can Tho City,Ninh Kieu District,23,4,3,1,0
2022-03-25,Can Tho City,Phong Dien,20,2,0,2,2
2022-03-25,Dong Nai,Bien Hoa City,0,7,5,2,0
2022-03-25,Dong Nai,Bien Hoa City,1,6,4,2,0
2022-03-25,Dong Nai,Bien Hoa City,2,1,1,0,0
2022-03-25,Dong Nai,Bien Hoa City,4,2,2,0,0
2022-03-25,Dong Nai,Bien Hoa City,5,3,1,2,0
2022-03-25,Dong Nai,Bien Hoa City,6,40,21,19,17
2022-03-25,Dong Nai,Bien Hoa City,7,176,129,47,22
2022-03-25,Dong Nai,Bien Hoa City,8,268,238,30,8
2022-03-25,Dong Nai,Bien Hoa City,9,392,354,38,5
2022-03-25,Dong Nai,Bien Hoa City,10,693,633,60,19
2022-03-25,Dong Nai,Bien Hoa City,11,1041,905,136,49
2022-03-25,Dong Nai,Bien Hoa City,12,765,675,90,25
2022-03-25,Dong Nai,Bien Hoa City,13,746,648,98,49
2022-03-25,Dong Nai,Bien Hoa City,14,603,510,93,46
2022-03-25,Dong Nai,Bien Hoa City,15,519,457,62,25
2022-03-25,Dong Nai,Bien Hoa City,16,465,428,37,10
2022-03-25,Dong Nai,Bien Hoa City,17,542,494,48,17
2022-03-25,Dong Nai,Bien Hoa City,18,649,578,71,9
2022-03-25,Dong Nai,Bien Hoa City,19,558,484,74,20
2022-03-25,Dong Nai,Bien Hoa City,20,426,352,74,35
2022-03-25,Dong Nai,Bien Hoa City,21,167,118,49,19
2022-03-25,Dong Nai,Bien Hoa City,22,2,1,1,0
2022-03-25,Dong Nai,Bien Hoa City,23,2,1,1,0
2022-03-25,Dong Nai,Long Khanh,13,1,0,1,1
2022-03-25,Dong Nai,Long Thanh,9,1,0,1,1
2022-03-25,Dong Nai,Long Thanh,10,2,0,2,2
2022-03-25,Dong Nai,Long Thanh,11,2,0,2,2
2022-03-25,Dong Nai,Long Thanh,15,2,0,2,2
2022-03-25,Dong Nai,Long Thanh,16,1,0,1,1
2022-03-25,Dong Nai,Nhon trach,9,1,0,1,1
2022-03-25,Dong Nai,Nhon trach,10,1,0,1,1
2022-03-25,Dong Nai,Thong Nhat,8,1,1,0,0
2022-03-25,Dong Nai,Thong Nhat,10,2,0,2,2
2022-03-25,Dong Nai,Thong Nhat,11,2,2,0,0
2022-03-25,Dong Nai,Thong Nhat,12,1,1,0,0
2022-03-25,Dong Nai,Thong Nhat,13,3,2,1,1
2022-03-25,Dong Nai,Thong Nhat,14,4,3,1,0
2022-03-25,Dong Nai,Thong Nhat,15,2,2,0,0
2022-03-25,Dong Nai,Thong Nhat,17,1,1,0,0
2022-03-25,Dong Nai,Thong Nhat,18,2,2,0,0
2022-03-25,Dong Nai,Thong Nhat,19,2,1,1,1
2022-03-25,Dong Nai,Thong Nhat,20,1,1,0,0
2022-03-25,Dong Nai,Trang Bom,15,1,0,1,1
2022-03-25,Dong Nai,Trang Bom,21,1,0,1,1
2022-03-25,Hai Phong City,An Duong,0,2,0,2,0
2022-03-25,Hai Phong City,An Duong,7,3,0,3,1
2022-03-25,Hai Phong City,An Duong,8,2,0,2,2
2022-03-25,Hai Phong City,An Duong,9,3,1,2,0
2022-03-25,Hai Phong City,An Duong,10,5,2,3,1
2022-03-25,Hai Phong City,An Duong,11,3,1,2,1
2022-03-25,Hai Phong City,An Duong,12,9,2,7,4
2022-03-25,Hai Phong City,An Duong,13,5,0,5,5
2022-03-25,Hai Phong City,An Duong,14,7,1,6,6
2022-03-25,Hai Phong City,An Duong,15,10,2,8,6
2022-03-25,Hai Phong City,An Duong,16,5,2,3,2
2022-03-25,Hai Phong City,An Duong,17,1,1,0,0
2022-03-25,Hai Phong City,An Duong,18,2,1,1,1
2022-03-25,Hai Phong City,An Duong,19,1,0,1,1
2022-03-25,Hai Phong City,An Duong,20,2,0,2,2
2022-03-25,Hai Phong City,An Duong,21,2,0,2,1
2022-03-25,Hai Phong City,Duong Kinh District,12,1,0,1,1
2022-03-25,Hai Phong City,Duong Kinh District,16,1,0,1,1
2022-03-25,Hai Phong City,Hai An District,3,1,0,1,1
2022-03-25,Hai Phong City,Hai An District,7,3,2,1,1
2022-03-25,Hai Phong City,Hai An District,8,15,10,5,2
2022-03-25,Hai Phong City,Hai An District,9,14,11,3,1
2022-03-25,Hai Phong City,Hai An District,10,18,17,1,0
2022-03-25,Hai Phong City,Hai An District,11,36,31,5,2
2022-03-25,Hai Phong City,Hai An District,12,29,22,7,2
2022-03-25,Hai Phong City,Hai An District,13,5,5,0,0
2022-03-25,Hai Phong City,Hai An District,14,11,9,2,2
2022-03-25,Hai Phong City,Hai An District,15,17,13,4,2
2022-03-25,Hai Phong City,Hai An District,16,20,16,4,1
2022-03-25,Hai Phong City,Hai An District,17,18,16,2,0
2022-03-25,Hai Phong City,Hai An District,18,30,24,6,1
2022-03-25,Hai Phong City,Hai An District,19,21,17,4,0
2022-03-25,Hai Phong City,Hai An District,20,15,12,3,2
2022-03-25,Hai Phong City,Hai An District,21,3,3,0,0
2022-03-25,Hai Phong City,Hong Bang District,1,1,1,0,0
2022-03-25,Hai Phong City,Hong Bang District,5,1,0,1,1
2022-03-25,Hai Phong City,Hong Bang District,6,1,1,0,0
2022-03-25,Hai Phong City,Hong Bang District,7,15,9,6,1
2022-03-25,Hai Phong City,Hong Bang District,8,24,23,1,0
2022-03-25,Hai Phong City,Hong Bang District,9,22,16,6,2
2022-03-25,Hai Phong City,Hong Bang District,10,69,57,12,3
2022-03-25,Hai Phong City,Hong Bang District,11,109,96,13,2
2022-03-25,Hai Phong City,Hong Bang District,12,56,54,2,0
2022-03-25,Hai Phong City,Hong Bang District,13,43,39,4,0
2022-03-25,Hai Phong City,Hong Bang District,14,39,37,2,1
2022-03-25,Hai Phong City,Hong Bang District,15,32,31,1,0
2022-03-25,Hai Phong City,Hong Bang District,16,26,24,2,0
2022-03-25,Hai Phong City,Hong Bang District,17,36,29,7,0
2022-03-25,Hai Phong City,Hong Bang District,18,56,49,7,0
2022-03-25,Hai Phong City,Hong Bang District,19,47,44,3,0
2022-03-25,Hai Phong City,Hong Bang District,20,25,24,1,0
2022-03-25,Hai Phong City,Hong Bang District,21,18,15,3,1
2022-03-25,Hai Phong City,Kien An District,7,6,0,6,5
2022-03-25,Hai Phong City,Kien An District,8,10,6,4,2
2022-03-25,Hai Phong City,Kien An District,9,9,7,2,1
2022-03-25,Hai Phong City,Kien An District,10,14,9,5,4
2022-03-25,Hai Phong City,Kien An District,11,13,7,6,1
2022-03-25,Hai Phong City,Kien An District,12,11,9,2,1
2022-03-25,Hai Phong City,Kien An District,13,3,2,1,1
2022-03-25,Hai Phong City,Kien An District,14,11,6,5,4
2022-03-25,Hai Phong City,Kien An District,15,8,8,0,0
2022-03-25,Hai Phong City,Kien An District,16,3,3,0,0
2022-03-25,Hai Phong City,Kien An District,17,7,5,2,0
2022-03-25,Hai Phong City,Kien An District,18,7,6,1,1
2022-03-25,Hai Phong City,Kien An District,19,16,5,11,6
2022-03-25,Hai Phong City,Kien An District,20,23,6,17,12
2022-03-25,Hai Phong City,Kien An District,21,3,2,1,0
2022-03-25,Hai Phong City,Le Chan District,0,5,4,1,0
2022-03-25,Hai Phong City,Le Chan District,2,1,1,0,0
2022-03-25,Hai Phong City,Le Chan District,5,1,0,1,0
2022-03-25,Hai Phong City,Le Chan District,6,1,1,0,0
2022-03-25,Hai Phong City,Le Chan District,7,22,16,6,2
2022-03-25,Hai Phong City,Le Chan District,8,51,48,3,0
2022-03-25,Hai Phong City,Le Chan District,9,74,64,10,1
2022-03-25,Hai Phong City,Le Chan District,10,149,136,13,2
2022-03-25,Hai Phong City,Le Chan District,11,257,229,28,8
2022-03-25,Hai Phong City,Le Chan District,12,140,129,11,1
2022-03-25,Hai Phong City,Le Chan District,13,103,90,13,3
2022-03-25,Hai Phong City,Le Chan District,14,119,97,22,7
2022-03-25,Hai Phong City,Le Chan District,15,131,112,19,3
2022-03-25,Hai Phong City,Le Chan District,16,125,111,14,1
2022-03-25,Hai Phong City,Le Chan District,17,133,119,14,2
2022-03-25,Hai Phong City,Le Chan District,18,206,190,16,1
2022-03-25,Hai Phong City,Le Chan District,19,147,128,19,2
2022-03-25,Hai Phong City,Le Chan District,20,115,101,14,1
2022-03-25,Hai Phong City,Le Chan District,21,69,52,17,3
2022-03-25,Hai Phong City,Le Chan District,22,1,0,1,0
2022-03-25,Hai Phong City,Ngo Quyen District,0,4,2,2,0
2022-03-25,Hai Phong City,Ngo Quyen District,1,3,2,1,0
2022-03-25,Hai Phong City,Ngo Quyen District,2,1,0,1,0
2022-03-25,Hai Phong City,Ngo Quyen District,3,1,0,1,1
2022-03-25,Hai Phong City,Ngo Quyen District,5,1,1,0,0
2022-03-25,Hai Phong City,Ngo Quyen District,6,1,1,0,0
2022-03-25,Hai Phong City,Ngo Quyen District,7,23,18,5,3
2022-03-25,Hai Phong City,Ngo Quyen District,8,62,54,8,1
2022-03-25,Hai Phong City,Ngo Quyen District,9,83,76,7,0
2022-03-25,Hai Phong City,Ngo Quyen District,10,113,106,7,2
2022-03-25,Hai Phong City,Ngo Quyen District,11,244,224,20,5
2022-03-25,Hai Phong City,Ngo Quyen District,12,161,149,12,1
2022-03-25,Hai Phong City,Ngo Quyen District,13,97,85,12,2
2022-03-25,Hai Phong City,Ngo Quyen District,14,152,129,23,8
2022-03-25,Hai Phong City,Ngo Quyen District,15,137,123,14,1
2022-03-25,Hai Phong City,Ngo Quyen District,16,126,115,11,0
2022-03-25,Hai Phong City,Ngo Quyen District,17,149,131,18,0
2022-03-25,Hai Phong City,Ngo Quyen District,18,176,151,25,1
2022-03-25,Hai Phong City,Ngo Quyen District,19,125,110,15,0
2022-03-25,Hai Phong City,Ngo Quyen District,20,135,112,23,7
2022-03-25,Hai Phong City,Ngo Quyen District,21,69,54,15,3
2022-03-25,Hai Phong City,Thuy Nguyen,9,4,0,4,4
2022-03-25,Hai Phong City,Thuy Nguyen,10,1,0,1,1
2022-03-25,Hai Phong City,Thuy Nguyen,11,2,0,2,2
2022-03-25,Hai Phong City,Thuy Nguyen,12,1,0,1,1
2022-03-25,Hai Phong City,Thuy Nguyen,16,1,0,1,1
2022-03-25,Hai Phong City,Thuy Nguyen,17,1,1,0,0
2022-03-25,Hai Phong City,Thuy Nguyen,19,1,0,1,1
2022-03-25,Hai Phong City,Thuy Nguyen,20,2,0,2,1
2022-03-25,Hue City,Hue City,0,7,5,2,0
2022-03-25,Hue City,Hue City,1,16,14,2,0
2022-03-25,Hue City,Hue City,2,3,1,2,0
2022-03-25,Hue City,Hue City,5,1,1,0,0
2022-03-25,Hue City,Hue City,6,72,69,3,1
2022-03-25,Hue City,Hue City,7,185,170,15,1
2022-03-25,Hue City,Hue City,8,293,274,19,1
2022-03-25,Hue City,Hue City,9,284,267,17,0
2022-03-25,Hue City,Hue City,10,451,423,28,0
2022-03-25,Hue City,Hue City,11,845,793,52,4
2022-03-25,Hue City,Hue City,12,571,529,42,3
2022-03-25,Hue City,Hue City,13,303,279,24,1
2022-03-25,Hue City,Hue City,14,351,325,26,3
2022-03-25,Hue City,Hue City,15,401,362,39,1
2022-03-25,Hue City,Hue City,16,402,377,25,0
2022-03-25,Hue City,Hue City,17,629,586,43,7
2022-03-25,Hue City,Hue City,18,751,693,58,6
2022-03-25,Hue City,Hue City,19,625,552,73,3
2022-03-25,Hue City,Hue City,20,400,356,44,1
2022-03-25,Hue City,Hue City,21,266,221,45,6
2022-03-25,Hue City,Hue City,22,3,1,2,0
2022-03-25,Hue City,Hue City,23,1,1,0,0
2022-03-25,Hue City,Huong Thuy,11,1,0,1,0
2022-03-25,Hue City,Huong Thuy,13,2,0,2,0
2022-03-25,Hue City,Huong Thuy,14,3,1,2,1
2022-03-25,Hue City,Huong Thuy,16,2,2,0,0
2022-03-25,Hue City,Huong Thuy,17,1,1,0,0
2022-03-25,Hue City,Huong Thuy,18,2,2,0,0
2022-03-25,Hue City,Huong Thuy,19,3,1,2,0
2022-03-25,Hue City,Huong Thuy,21,1,0,1,1
2022-03-25,Hue City,Huong Tra,14,1,1,0,0
2022-03-25,Hue City,Huong Tra,18,1,1,0,0
2022-03-25,Hue City,Huong Tra,19,1,1,0,0
2022-03-25,Hue City,Huong Tra,21,1,0,1,1
2022-03-25,Hue City,Phu Vang,6,2,2,0,0
2022-03-25,Hue City,Phu Vang,9,5,4,1,0
2022-03-25,Hue City,Phu Vang,10,1,0,1,0
2022-03-25,Hue City,Phu Vang,11,4,4,0,0
2022-03-25,Hue City,Phu Vang,12,1,1,0,0
2022-03-25,Hue City,Phu Vang,13,1,1,0,0
2022-03-25,Hue City,Phu Vang,16,1,1,0,0
2022-03-25,Hue City,Phu Vang,17,4,4,0,0
2022-03-25,Hue City,Phu Vang,18,2,1,1,1
2022-03-25,Hue City,Phu Vang,19,4,3,1,0
2022-03-25,Hue City,Phu Vang,20,3,1,2,1
2022-03-25,Hue City,Phu Vang,21,1,1,0,0
2022-03-25,Vung Tau,Ba Ria City,1,1,0,1,0
2022-03-25,Vung Tau,Ba Ria City,7,3,1,2,0
2022-03-25,Vung Tau,Ba Ria City,8,4,0,4,3
2022-03-25,Vung Tau,Ba Ria City,9,1,0,1,1
2022-03-25,Vung Tau,Ba Ria City,10,8,5,3,3
2022-03-25,Vung Tau,Ba Ria City,11,14,6,8,5
2022-03-25,Vung Tau,Ba Ria City,12,12,6,6,5
2022-03-25,Vung Tau,Ba Ria City,13,10,6,4,2
2022-03-25,Vung Tau,Ba Ria City,14,5,2,3,1
2022-03-25,Vung Tau,Ba Ria City,15,6,4,2,2
2022-03-25,Vung Tau,Ba Ria City,16,4,1,3,3
2022-03-25,Vung Tau,Ba Ria City,17,5,3,2,2
2022-03-25,Vung Tau,Ba Ria City,18,3,3,0,0
2022-03-25,Vung Tau,Ba Ria City,19,4,1,3,3
2022-03-25,Vung Tau,Ba Ria City,20,2,0,2,2
2022-03-25,Vung Tau,Ba Ria City,21,1,0,1,1
2022-03-25,Vung Tau,Tan Thanh,16,1,0,1,0
2022-03-25,Vung Tau,Tan Thanh,17,3,0,3,2
2022-03-25,Vung Tau,Vung Tau City,0,2,2,0,0
2022-03-25,Vung Tau,Vung Tau City,5,1,1,0,0
2022-03-25,Vung Tau,Vung Tau City,6,37,32,5,2
2022-03-25,Vung Tau,Vung Tau City,7,100,92,8,0
2022-03-25,Vung Tau,Vung Tau City,8,139,125,14,3
2022-03-25,Vung Tau,Vung Tau City,9,142,135,7,0
2022-03-25,Vung Tau,Vung Tau City,10,187,176,11,3
2022-03-25,Vung Tau,Vung Tau City,11,345,325,20,1
2022-03-25,Vung Tau,Vung Tau City,12,232,217,15,1
2022-03-25,Vung Tau,Vung Tau City,13,194,179,15,3
2022-03-25,Vung Tau,Vung Tau City,14,210,198,12,2
2022-03-25,Vung Tau,Vung Tau City,15,176,161,15,4
2022-03-25,Vung Tau,Vung Tau City,16,169,150,19,1
2022-03-25,Vung Tau,Vung Tau City,17,238,223,15,2
2022-03-25,Vung Tau,Vung Tau City,18,306,283,23,1
2022-03-25,Vung Tau,Vung Tau City,19,256,230,26,1
2022-03-25,Vung Tau,Vung Tau City,20,169,148,21,4
2022-03-25,Vung Tau,Vung Tau City,21,91,72,19,8
2022-03-25,Vung Tau,Vung Tau City,22,2,0,2,0
2022-03-26,Binh Duong,Ben Cat,13,1,0,1,1
2022-03-26,Binh Duong,Ben Cat,14,2,0,2,2
2022-03-26,Binh Duong,Di An,0,1,0,1,0
2022-03-26,Binh Duong,Di An,6,1,0,1,1
2022-03-26,Binh Duong,Di An,7,3,1,2,1
2022-03-26,Binh Duong,Di An,8,18,8,10,9
2022-03-26,Binh Duong,Di An,9,16,10,6,6
2022-03-26,Binh Duong,Di An,10,27,19,8,3
2022-03-26,Binh Duong,Di An,11,43,21,22,14
2022-03-26,Binh Duong,Di An,12,31,19,12,10
2022-03-26,Binh Duong,Di An,13,37,14,23,19
2022-03-26,Binh Duong,Di An,14,24,16,8,5
2022-03-26,Binh Duong,Di An,15,27,15,12,9
2022-03-26,Binh Duong,Di An,16,15,12,3,2
2022-03-26,Binh Duong,Di An,17,26,15,11,9
2022-03-26,Binh Duong,Di An,18,31,16,15,10
2022-03-26,Binh Duong,Di An,19,20,5,15,15
2022-03-26,Binh Duong,Di An,20,20,8,12,11
2022-03-26,Binh Duong,Di An,21,7,4,3,2
2022-03-26,Binh Duong,Phu Giao,9,2,0,2,1
2022-03-26,Binh Duong,Phu Giao,14,1,0,1,1
2022-03-26,Binh Duong,Tan Uyen,7,1,0,1,1
2022-03-26,Binh Duong,Tan Uyen,8,2,0,2,2
2022-03-26,Binh Duong,Tan Uyen,10,2,0,2,1
2022-03-26,Binh Duong,Tan Uyen,11,5,3,2,2
2022-03-26,Binh Duong,Tan Uyen,12,5,3,2,2
2022-03-26,Binh Duong,Tan Uyen,13,3,3,0,0
2022-03-26,Binh Duong,Tan Uyen,14,4,1,3,2
2022-03-26,Binh Duong,Tan Uyen,15,4,1,3,2
2022-03-26,Binh Duong,Tan Uyen,16,1,0,1,1
2022-03-26,Binh Duong,Tan Uyen,17,1,0,1,1
2022-03-26,Binh Duong,Tan Uyen,18,1,0,1,1
2022-03-26,Binh Duong,Tan Uyen,19,4,2,2,2
2022-03-26,Binh Duong,Tan Uyen,20,1,0,1,1
2022-03-26,Binh Duong,Tan Uyen,21,1,0,1,1
2022-03-26,Binh Duong,Thu Dau Mot Town,1,2,2,0,0
2022-03-26,Binh Duong,Thu Dau Mot Town,5,1,0,1,1
2022-03-26,Binh Duong,Thu Dau Mot Town,6,36,29,7,4
2022-03-26,Binh Duong,Thu Dau Mot Town,7,104,99,5,1
2022-03-26,Binh Duong,Thu Dau Mot Town,8,209,194,15,1
2022-03-26,Binh Duong,Thu Dau Mot Town,9,267,244,23,2
2022-03-26,Binh Duong,Thu Dau Mot Town,10,379,355,24,2
2022-03-26,Binh Duong,Thu Dau Mot Town,11,549,520,29,3
2022-03-26,Binh Duong,Thu Dau Mot Town,12,420,404,16,2
2022-03-26,Binh Duong,Thu Dau Mot Town,13,350,332,18,1
2022-03-26,Binh Duong,Thu Dau Mot Town,14,288,273,15,2
2022-03-26,Binh Duong,Thu Dau Mot Town,15,296,277,19,4
2022-03-26,Binh Duong,Thu Dau Mot Town,16,282,265,17,2
2022-03-26,Binh Duong,Thu Dau Mot Town,17,332,308,24,3
2022-03-26,Binh Duong,Thu Dau Mot Town,18,399,373,26,9
2022-03-26,Binh Duong,Thu Dau Mot Town,19,330,310,20,5
2022-03-26,Binh Duong,Thu Dau Mot Town,20,210,192,18,5
2022-03-26,Binh Duong,Thu Dau Mot Town,21,98,80,18,0
2022-03-26,Binh Duong,Thu Dau Mot Town,22,1,0,1,0
2022-03-26,Binh Duong,Thu Dau Mot Town,23,1,1,0,0
2022-03-26,Binh Duong,Thuan An,6,2,1,1,1
2022-03-26,Binh Duong,Thuan An,7,4,1,3,3
2022-03-26,Binh Duong,Thuan An,8,23,12,11,9
2022-03-26,Binh Duong,Thuan An,9,34,23,11,6
2022-03-26,Binh Duong,Thuan An,10,57,37,20,13
2022-03-26,Binh Duong,Thuan An,11,84,57,27,16
2022-03-26,Binh Duong,Thuan An,12,68,46,22,12
2022-03-26,Binh Duong,Thuan An,13,40,27,13,6
2022-03-26,Binh Duong,Thuan An,14,38,25,13,10
2022-03-26,Binh Duong,Thuan An,15,47,32,15,9
2022-03-26,Binh Duong,Thuan An,16,36,26,10,5
2022-03-26,Binh Duong,Thuan An,17,34,24,10,7
2022-03-26,Binh Duong,Thuan An,18,42,29,13,11
2022-03-26,Binh Duong,Thuan An,19,35,24,11,6
2022-03-26,Binh Duong,Thuan An,20,32,17,15,13
2022-03-26,Binh Duong,Thuan An,21,10,3,7,5
2022-03-26,Binh Duong,Thuan An,23,2,0,2,1
2022-03-26,Can Tho City,Binh Thuy District,0,1,1,0,0
2022-03-26,Can Tho City,Binh Thuy District,6,1,1,0,0
2022-03-26,Can Tho City,Binh Thuy District,7,3,3,0,0
2022-03-26,Can Tho City,Binh Thuy District,8,2,2,0,0
2022-03-26,Can Tho City,Binh Thuy District,9,5,5,0,0
2022-03-26,Can Tho City,Binh Thuy District,10,12,11,1,0
2022-03-26,Can Tho City,Binh Thuy District,11,16,16,0,0
2022-03-26,Can Tho City,Binh Thuy District,12,13,11,2,1
2022-03-26,Can Tho City,Binh Thuy District,13,9,7,2,0
2022-03-26,Can Tho City,Binh Thuy District,14,9,9,0,0
2022-03-26,Can Tho City,Binh Thuy District,15,8,7,1,0
2022-03-26,Can Tho City,Binh Thuy District,16,12,12,0,0
2022-03-26,Can Tho City,Binh Thuy District,17,11,11,0,0
2022-03-26,Can Tho City,Binh Thuy District,18,14,12,2,0
2022-03-26,Can Tho City,Binh Thuy District,19,12,11,1,0
2022-03-26,Can Tho City,Binh Thuy District,20,9,7,2,0
2022-03-26,Can Tho City,Binh Thuy District,21,5,3,2,1
2022-03-26,Can Tho City,Cai Rang District,7,4,3,1,1
2022-03-26,Can Tho City,Cai Rang District,9,6,6,0,0
2022-03-26,Can Tho City,Cai Rang District,10,8,7,1,0
2022-03-26,Can Tho City,Cai Rang District,11,14,13,1,0
2022-03-26,Can Tho City,Cai Rang District,12,16,16,0,0
2022-03-26,Can Tho City,Cai Rang District,13,10,7,3,0
2022-03-26,Can Tho City,Cai Rang District,14,17,15,2,0
2022-03-26,Can Tho City,Cai Rang District,15,10,10,0,0
2022-03-26,Can Tho City,Cai Rang District,16,10,10,0,0
2022-03-26,Can Tho City,Cai Rang District,17,15,13,2,0
2022-03-26,Can Tho City,Cai Rang District,18,15,14,1,0
2022-03-26,Can Tho City,Cai Rang District,19,18,17,1,0
2022-03-26,Can Tho City,Cai Rang District,20,5,4,1,0
2022-03-26,Can Tho City,Cai Rang District,21,1,0,1,0
2022-03-26,Can Tho City,Ninh Kieu District,0,7,5,2,0
2022-03-26,Can Tho City,Ninh Kieu District,1,6,3,3,0
2022-03-26,Can Tho City,Ninh Kieu District,2,1,1,0,0
2022-03-26,Can Tho City,Ninh Kieu District,4,1,1,0,0
2022-03-26,Can Tho City,Ninh Kieu District,5,4,2,2,0
2022-03-26,Can Tho City,Ninh Kieu District,6,53,47,6,1
2022-03-26,Can Tho City,Ninh Kieu District,7,138,126,12,0
2022-03-26,Can Tho City,Ninh Kieu District,8,262,250,12,0
2022-03-26,Can Tho City,Ninh Kieu District,9,286,273,13,0
2022-03-26,Can Tho City,Ninh Kieu District,10,587,556,31,0
2022-03-26,Can Tho City,Ninh Kieu District,11,815,764,51,2
2022-03-26,Can Tho City,Ninh Kieu District,12,612,580,32,0
2022-03-26,Can Tho City,Ninh Kieu District,13,424,407,17,0
2022-03-26,Can Tho City,Ninh Kieu District,14,421,407,14,0
2022-03-26,Can Tho City,Ninh Kieu District,15,354,329,25,0
2022-03-26,Can Tho City,Ninh Kieu District,16,447,428,19,0
2022-03-26,Can Tho City,Ninh Kieu District,17,491,471,20,0
2022-03-26,Can Tho City,Ninh Kieu District,18,519,494,25,0
2022-03-26,Can Tho City,Ninh Kieu District,19,443,424,19,0
2022-03-26,Can Tho City,Ninh Kieu District,20,325,305,20,0
2022-03-26,Can Tho City,Ninh Kieu District,21,182,158,24,0
2022-03-26,Can Tho City,Ninh Kieu District,22,3,3,0,0
2022-03-26,Dong Nai,Bien Hoa City,0,2,1,1,0
2022-03-26,Dong Nai,Bien Hoa City,1,1,0,1,0
2022-03-26,Dong Nai,Bien Hoa City,3,2,2,0,0
2022-03-26,Dong Nai,Bien Hoa City,4,1,1,0,0
2022-03-26,Dong Nai,Bien Hoa City,5,2,0,2,2
2022-03-26,Dong Nai,Bien Hoa City,6,51,27,24,20
2022-03-26,Dong Nai,Bien Hoa City,7,170,137,33,16
2022-03-26,Dong Nai,Bien Hoa City,8,273,237,36,5
2022-03-26,Dong Nai,Bien Hoa City,9,421,384,37,5
2022-03-26,Dong Nai,Bien Hoa City,10,746,680,66,16
2022-03-26,Dong Nai,Bien Hoa City,11,1015,904,111,33
2022-03-26,Dong Nai,Bien Hoa City,12,849,779,70,8
2022-03-26,Dong Nai,Bien Hoa City,13,687,626,61,16
2022-03-26,Dong Nai,Bien Hoa City,14,616,575,41,5
2022-03-26,Dong Nai,Bien Hoa City,15,480,433,47,12
2022-03-26,Dong Nai,Bien Hoa City,16,560,477,83,43
2022-03-26,Dong Nai,Bien Hoa City,17,672,558,114,79
2022-03-26,Dong Nai,Bien Hoa City,18,725,578,147,85
2022-03-26,Dong Nai,Bien Hoa City,19,730,545,185,121
2022-03-26,Dong Nai,Bien Hoa City,20,604,403,201,145
2022-03-26,Dong Nai,Bien Hoa City,21,234,142,92,53
2022-03-26,Dong Nai,Bien Hoa City,22,3,0,3,1
2022-03-26,Dong Nai,Bien Hoa City,23,1,1,0,0
2022-03-26,Dong Nai,Long Khanh,19,1,0,1,1
2022-03-26,Dong Nai,Long Thanh,9,3,0,3,3
2022-03-26,Dong Nai,Long Thanh,10,2,0,2,2
2022-03-26,Dong Nai,Long Thanh,12,5,0,5,5
2022-03-26,Dong Nai,Long Thanh,13,1,0,1,1
2022-03-26,Dong Nai,Long Thanh,14,1,0,1,1
2022-03-26,Dong Nai,Long Thanh,15,1,0,1,1
2022-03-26,Dong Nai,Long Thanh,16,2,0,2,2
2022-03-26,Dong Nai,Long Thanh,17,1,0,1,1
2022-03-26,Dong Nai,Long Thanh,18,3,0,3,2
2022-03-26,Dong Nai,Long Thanh,19,8,0,8,2
2022-03-26,Dong Nai,Nhon trach,10,1,0,1,1
2022-03-26,Dong Nai,Nhon trach,11,1,0,1,1
2022-03-26,Dong Nai,Thong Nhat,11,1,1,0,0
2022-03-26,Dong Nai,Thong Nhat,12,1,1,0,0
2022-03-26,Dong Nai,Thong Nhat,18,2,1,1,1
2022-03-26,Dong Nai,Thong Nhat,20,1,1,0,0
2022-03-26,Dong Nai,Trang Bom,9,3,0,3,3
2022-03-26,Dong Nai,Trang Bom,12,3,0,3,1
2022-03-26,Dong Nai,Trang Bom,13,1,0,1,1
2022-03-26,Dong Nai,Trang Bom,14,1,0,1,1
2022-03-26,Dong Nai,Trang Bom,20,1,0,1,1
2022-03-26,Hai Phong City,An Duong,7,1,0,1,1
2022-03-26,Hai Phong City,An Duong,8,5,4,1,1
2022-03-26,Hai Phong City,An Duong,9,6,4,2,2
2022-03-26,Hai Phong City,An Duong,10,3,2,1,0
2022-03-26,Hai Phong City,An Duong,11,2,1,1,1
2022-03-26,Hai Phong City,An Duong,12,2,2,0,0
2022-03-26,Hai Phong City,An Duong,13,10,3,7,7
2022-03-26,Hai Phong City,An Duong,14,5,0,5,5
2022-03-26,Hai Phong City,An Duong,15,4,1,3,3
2022-03-26,Hai Phong City,An Duong,16,2,1,1,0
2022-03-26,Hai Phong City,An Duong,17,3,1,2,2
2022-03-26,Hai Phong City,An Duong,18,4,2,2,2
2022-03-26,Hai Phong City,An Duong,19,1,0,1,0
2022-03-26,Hai Phong City,An Duong,21,1,1,0,0
2022-03-26,Hai Phong City,Do Son District,9,2,0,2,2
2022-03-26,Hai Phong City,Duong Kinh District,14,2,0,2,1
2022-03-26,Hai Phong City,Duong Kinh District,19,1,0,1,1
2022-03-26,Hai Phong City,Hai An District,7,7,5,2,2
2022-03-26,Hai Phong City,Hai An District,8,8,7,1,0
2022-03-26,Hai Phong City,Hai An District,9,8,7,1,0
2022-03-26,Hai Phong City,Hai An District,10,17,17,0,0
2022-03-26,Hai Phong City,Hai An District,11,43,38,5,0
2022-03-26,Hai Phong City,Hai An District,12,25,23,2,1
2022-03-26,Hai Phong City,Hai An District,13,19,16,3,2
2022-03-26,Hai Phong City,Hai An District,14,25,13,12,8
2022-03-26,Hai Phong City,Hai An District,15,14,11,3,2
2022-03-26,Hai Phong City,Hai An District,16,12,11,1,0
2022-03-26,Hai Phong City,Hai An District,17,21,16,5,1
2022-03-26,Hai Phong City,Hai An District,18,21,17,4,2
2022-03-26,Hai Phong City,Hai An District,19,16,13,3,0
2022-03-26,Hai Phong City,Hai An District,20,14,13,1,1
2022-03-26,Hai Phong City,Hai An District,21,22,15,7,5
2022-03-26,Hai Phong City,Hong Bang District,7,10,5,5,4
2022-03-26,Hai Phong City,Hong Bang District,8,20,18,2,0
2022-03-26,Hai Phong City,Hong Bang District,9,36,27,9,4
2022-03-26,Hai Phong City,Hong Bang District,10,52,48,4,0
2022-03-26,Hai Phong City,Hong Bang District,11,119,104,15,5
2022-03-26,Hai Phong City,Hong Bang District,12,74,51,23,9
2022-03-26,Hai Phong City,Hong Bang District,13,40,31,9,3
2022-03-26,Hai Phong City,Hong Bang District,14,39,28,11,5
2022-03-26,Hai Phong City,Hong Bang District,15,39,26,13,6
2022-03-26,Hai Phong City,Hong Bang District,16,34,29,5,2
2022-03-26,Hai Phong City,Hong Bang District,17,29,28,1,0
2022-03-26,Hai Phong City,Hong Bang District,18,56,53,3,0
2022-03-26,Hai Phong City,Hong Bang District,19,60,43,17,9
2022-03-26,Hai Phong City,Hong Bang District,20,31,19,12,6
2022-03-26,Hai Phong City,Hong Bang District,21,17,9,8,4
2022-03-26,Hai Phong City,Hong Bang District,22,1,0,1,0
2022-03-26,Hai Phong City,Kien An District,6,1,0,1,1
2022-03-26,Hai Phong City,Kien An District,7,1,0,1,0
2022-03-26,Hai Phong City,Kien An District,8,7,5,2,0
2022-03-26,Hai Phong City,Kien An District,9,5,2,3,3
2022-03-26,Hai Phong City,Kien An District,10,10,9,1,0
2022-03-26,Hai Phong City,Kien An District,11,18,12,6,3
2022-03-26,Hai Phong City,Kien An District,12,14,9,5,4
2022-03-26,Hai Phong City,Kien An District,13,9,4,5,1
2022-03-26,Hai Phong City,Kien An District,14,15,7,8,6
2022-03-26,Hai Phong City,Kien An District,15,9,7,2,2
2022-03-26,Hai Phong City,Kien An District,16,6,5,1,0
2022-03-26,Hai Phong City,Kien An District,17,9,9,0,0
2022-03-26,Hai Phong City,Kien An District,18,8,3,5,0
2022-03-26,Hai Phong City,Kien An District,19,9,5,4,4
2022-03-26,Hai Phong City,Kien An District,20,11,5,6,3
2022-03-26,Hai Phong City,Kien An District,21,9,3,6,6
2022-03-26,Hai Phong City,Le Chan District,1,2,1,1,0
2022-03-26,Hai Phong City,Le Chan District,4,1,1,0,0
2022-03-26,Hai Phong City,Le Chan District,6,2,0,2,2
2022-03-26,Hai Phong City,Le Chan District,7,46,34,12,6
2022-03-26,Hai Phong City,Le Chan District,8,57,48,9,2
2022-03-26,Hai Phong City,Le Chan District,9,92,80,12,0
2022-03-26,Hai Phong City,Le Chan District,10,177,157,20,1
2022-03-26,Hai Phong City,Le Chan District,11,285,252,33,9
2022-03-26,Hai Phong City,Le Chan District,12,232,201,31,6
2022-03-26,Hai Phong City,Le Chan District,13,101,89,12,4
2022-03-26,Hai Phong City,Le Chan District,14,174,122,52,27
2022-03-26,Hai Phong City,Le Chan District,15,142,120,22,8
2022-03-26,Hai Phong City,Le Chan District,16,145,121,24,3
2022-03-26,Hai Phong City,Le Chan District,17,171,151,20,4
2022-03-26,Hai Phong City,Le Chan District,18,210,175,35,16
2022-03-26,Hai Phong City,Le Chan District,19,196,158,38,17
2022-03-26,Hai Phong City,Le Chan District,20,137,108,29,20
2022-03-26,Hai Phong City,Le Chan District,21,103,67,36,18
2022-03-26,Hai Phong City,Le Chan District,22,3,0,3,1
2022-03-26,Hai Phong City,Le Chan District,23,1,1,0,0
2022-03-26,Hai Phong City,Ngo Quyen District,0,1,0,1,0
2022-03-26,Hai Phong City,Ngo Quyen District,6,2,0,2,0
2022-03-26,Hai Phong City,Ngo Quyen District,7,23,21,2,1
2022-03-26,Hai Phong City,Ngo Quyen District,8,80,68,12,0
2022-03-26,Hai Phong City,Ngo Quyen District,9,94,83,11,1
2022-03-26,Hai Phong City,Ngo Quyen District,10,147,133,14,2
2022-03-26,Hai Phong City,Ngo Quyen District,11,238,217,21,10
2022-03-26,Hai Phong City,Ngo Quyen District,12,202,182,20,4
2022-03-26,Hai Phong City,Ngo Quyen District,13,121,109,12,1
2022-03-26,Hai Phong City,Ngo Quyen District,14,125,108,17,11
2022-03-26,Hai Phong City,Ngo Quyen District,15,135,112,23,10
2022-03-26,Hai Phong City,Ngo Quyen District,16,147,125,22,4
2022-03-26,Hai Phong City,Ngo Quyen District,17,137,116,21,4
2022-03-26,Hai Phong City,Ngo Quyen District,18,212,172,40,12
2022-03-26,Hai Phong City,Ngo Quyen District,19,165,151,14,6
2022-03-26,Hai Phong City,Ngo Quyen District,20,154,118,36,14
2022-03-26,Hai Phong City,Ngo Quyen District,21,72,50,22,9
2022-03-26,Hai Phong City,Ngo Quyen District,22,1,0,1,0
2022-03-26,Hai Phong City,Thuy Nguyen,8,2,0,2,2
2022-03-26,Hai Phong City,Thuy Nguyen,11,2,0,2,2
2022-03-26,Hai Phong City,Thuy Nguyen,13,1,0,1,0
2022-03-26,Hai Phong City,Thuy Nguyen,14,2,0,2,1
2022-03-26,Hai Phong City,Thuy Nguyen,17,1,0,1,0
2022-03-26,Hai Phong City,Thuy Nguyen,21,2,0,2,1
2022-03-26,Hue City,Hue City,0,7,3,4,0
2022-03-26,Hue City,Hue City,2,1,1,0,0
2022-03-26,Hue City,Hue City,3,2,2,0,0
2022-03-26,Hue City,Hue City,5,2,2,0,0
2022-03-26,Hue City,Hue City,6,58,53,5,2
2022-03-26,Hue City,Hue City,7,182,173,9,1
2022-03-26,Hue City,Hue City,8,306,284,22,0
2022-03-26,Hue City,Hue City,9,257,235,22,0
2022-03-26,Hue City,Hue City,10,487,451,36,1
2022-03-26,Hue City,Hue City,11,874,810,64,5
2022-03-26,Hue City,Hue City,12,597,555,42,2
2022-03-26,Hue City,Hue City,13,356,335,21,0
2022-03-26,Hue City,Hue City,14,352,322,30,1
2022-03-26,Hue City,Hue City,15,390,363,27,0
2022-03-26,Hue City,Hue City,16,430,407,23,1
2022-03-26,Hue City,Hue City,17,455,429,26,0
2022-03-26,Hue City,Hue City,18,542,512,30,0
2022-03-26,Hue City,Hue City,19,539,494,45,1
2022-03-26,Hue City,Hue City,20,399,351,48,3
2022-03-26,Hue City,Hue City,21,234,182,52,17
2022-03-26,Hue City,Hue City,22,3,1,2,0
2022-03-26,Hue City,Hue City,23,1,1,0,0
2022-03-26,Hue City,Huong Thuy,7,1,1,0,0
2022-03-26,Hue City,Huong Thuy,8,1,1,0,0
2022-03-26,Hue City,Huong Thuy,11,1,1,0,0
2022-03-26,Hue City,Huong Thuy,12,1,1,0,0
2022-03-26,Hue City,Huong Thuy,14,1,1,0,0
2022-03-26,Hue City,Huong Thuy,16,1,0,1,1
2022-03-26,Hue City,Huong Thuy,17,1,0,1,1
2022-03-26,Hue City,Huong Thuy,18,1,1,0,0
2022-03-26,Hue City,Huong Thuy,19,1,0,1,1
2022-03-26,Hue City,Huong Thuy,20,1,0,1,1
2022-03-26,Hue City,Huong Tra,10,1,1,0,0
2022-03-26,Hue City,Huong Tra,15,1,1,0,0
2022-03-26,Hue City,Huong Tra,20,1,0,1,0
2022-03-26,Hue City,Phu Vang,7,2,2,0,0
2022-03-26,Hue City,Phu Vang,9,1,1,0,0
2022-03-26,Hue City,Phu Vang,10,3,3,0,0
2022-03-26,Hue City,Phu Vang,11,4,4,0,0
2022-03-26,Hue City,Phu Vang,13,2,1,1,0
2022-03-26,Hue City,Phu Vang,14,1,1,0,0
2022-03-26,Hue City,Phu Vang,15,1,1,0,0
2022-03-26,Hue City,Phu Vang,16,3,2,1,0
2022-03-26,Hue City,Phu Vang,17,2,1,1,0
2022-03-26,Hue City,Phu Vang,19,3,3,0,0
2022-03-26,Vung Tau,Ba Ria City,6,1,0,1,1
2022-03-26,Vung Tau,Ba Ria City,7,2,1,1,0
2022-03-26,Vung Tau,Ba Ria City,8,3,1,2,1
2022-03-26,Vung Tau,Ba Ria City,9,3,2,1,1
2022-03-26,Vung Tau,Ba Ria City,10,10,8,2,1
2022-03-26,Vung Tau,Ba Ria City,11,4,3,1,1
2022-03-26,Vung Tau,Ba Ria City,12,7,6,1,0
2022-03-26,Vung Tau,Ba Ria City,13,5,3,2,2
2022-03-26,Vung Tau,Ba Ria City,14,16,6,10,1
2022-03-26,Vung Tau,Ba Ria City,15,4,1,3,1
2022-03-26,Vung Tau,Ba Ria City,16,7,4,3,2
2022-03-26,Vung Tau,Ba Ria City,17,10,5,5,3
2022-03-26,Vung Tau,Ba Ria City,18,13,1,12,10
2022-03-26,Vung Tau,Ba Ria City,19,7,1,6,2
2022-03-26,Vung Tau,Ba Ria City,20,4,1,3,3
2022-03-26,Vung Tau,Ba Ria City,21,5,0,5,1
2022-03-26,Vung Tau,Vung Tau City,5,1,0,1,1
2022-03-26,Vung Tau,Vung Tau City,6,34,30,4,2
2022-03-26,Vung Tau,Vung Tau City,7,113,106,7,0
2022-03-26,Vung Tau,Vung Tau City,8,163,148,15,2
2022-03-26,Vung Tau,Vung Tau City,9,196,171,25,6
2022-03-26,Vung Tau,Vung Tau City,10,252,239,13,3
2022-03-26,Vung Tau,Vung Tau City,11,416,376,40,7
2022-03-26,Vung Tau,Vung Tau City,12,381,354,27,5
2022-03-26,Vung Tau,Vung Tau City,13,245,235,10,0
2022-03-26,Vung Tau,Vung Tau City,14,247,228,19,1
2022-03-26,Vung Tau,Vung Tau City,15,232,218,14,5
2022-03-26,Vung Tau,Vung Tau City,16,216,197,19,2
2022-03-26,Vung Tau,Vung Tau City,17,299,274,25,4
2022-03-26,Vung Tau,Vung Tau City,18,348,308,40,15
2022-03-26,Vung Tau,Vung Tau City,19,293,253,40,10
2022-03-26,Vung Tau,Vung Tau City,20,212,184,28,6
2022-03-26,Vung Tau,Vung Tau City,21,162,91,71,46
2022-03-26,Vung Tau,Vung Tau City,22,2,0,2,0
2022-03-27,Binh Duong,Ben Cat,14,1,0,1,1
2022-03-27,Binh Duong,Ben Cat,16,3,0,3,1
2022-03-27,Binh Duong,Ben Cat,17,1,0,1,1
2022-03-27,Binh Duong,Ben Cat,18,2,0,2,2
2022-03-27,Binh Duong,Di An,6,1,0,1,1
2022-03-27,Binh Duong,Di An,7,6,2,4,4
2022-03-27,Binh Duong,Di An,8,12,7,5,4
2022-03-27,Binh Duong,Di An,9,23,7,16,11
2022-03-27,Binh Duong,Di An,10,51,24,27,22
2022-03-27,Binh Duong,Di An,11,41,22,19,16
2022-03-27,Binh Duong,Di An,12,45,17,28,18
2022-03-27,Binh Duong,Di An,13,51,27,24,20
2022-03-27,Binh Duong,Di An,14,27,13,14,8
2022-03-27,Binh Duong,Di An,15,16,8,8,3
2022-03-27,Binh Duong,Di An,16,19,10,9,6
2022-03-27,Binh Duong,Di An,17,30,15,15,13
2022-03-27,Binh Duong,Di An,18,30,15,15,12
2022-03-27,Binh Duong,Di An,19,28,16,12,10
2022-03-27,Binh Duong,Di An,20,19,8,11,9
2022-03-27,Binh Duong,Di An,21,9,1,8,7
2022-03-27,Binh Duong,Phu Giao,11,1,0,1,0
2022-03-27,Binh Duong,Phu Giao,19,1,0,1,1
2022-03-27,Binh Duong,Tan Uyen,8,2,0,2,2
2022-03-27,Binh Duong,Tan Uyen,9,1,1,0,0
2022-03-27,Binh Duong,Tan Uyen,10,4,2,2,2
2022-03-27,Binh Duong,Tan Uyen,11,4,3,1,1
2022-03-27,Binh Duong,Tan Uyen,13,1,1,0,0
2022-03-27,Binh Duong,Tan Uyen,14,3,1,2,1
2022-03-27,Binh Duong,Tan Uyen,15,3,0,3,3
2022-03-27,Binh Duong,Tan Uyen,16,1,0,1,1
2022-03-27,Binh Duong,Tan Uyen,17,1,0,1,1
2022-03-27,Binh Duong,Tan Uyen,18,2,1,1,0
2022-03-27,Binh Duong,Tan Uyen,19,2,0,2,2
2022-03-27,Binh Duong,Tan Uyen,21,1,1,0,0
2022-03-27,Binh Duong,Thu Dau Mot Town,0,1,1,0,0
2022-03-27,Binh Duong,Thu Dau Mot Town,1,1,0,1,1
2022-03-27,Binh Duong,Thu Dau Mot Town,2,3,1,2,0
2022-03-27,Binh Duong,Thu Dau Mot Town,5,3,2,1,0
2022-03-27,Binh Duong,Thu Dau Mot Town,6,34,28,6,4
2022-03-27,Binh Duong,Thu Dau Mot Town,7,112,106,6,1
2022-03-27,Binh Duong,Thu Dau Mot Town,8,188,181,7,2
2022-03-27,Binh Duong,Thu Dau Mot Town,9,256,241,15,0
2022-03-27,Binh Duong,Thu Dau Mot Town,10,391,361,30,6
2022-03-27,Binh Duong,Thu Dau Mot Town,11,560,526,34,8
2022-03-27,Binh Duong,Thu Dau Mot Town,12,508,459,49,6
2022-03-27,Binh Duong,Thu Dau Mot Town,13,381,356,25,9
2022-03-27,Binh Duong,Thu Dau Mot Town,14,318,302,16,2
2022-03-27,Binh Duong,Thu Dau Mot Town,15,342,315,27,4
2022-03-27,Binh Duong,Thu Dau Mot Town,16,312,296,16,4
2022-03-27,Binh Duong,Thu Dau Mot Town,17,333,299,34,6
2022-03-27,Binh Duong,Thu Dau Mot Town,18,370,334,36,7
2022-03-27,Binh Duong,Thu Dau Mot Town,19,347,308,39,3
2022-03-27,Binh Duong,Thu Dau Mot Town,20,219,202,17,2
2022-03-27,Binh Duong,Thu Dau Mot Town,21,112,90,22,6
2022-03-27,Binh Duong,Thuan An,4,1,0,1,0
2022-03-27,Binh Duong,Thuan An,6,1,0,1,1
2022-03-27,Binh Duong,Thuan An,7,4,1,3,3
2022-03-27,Binh Duong,Thuan An,8,14,7,7,6
2022-03-27,Binh Duong,Thuan An,9,36,11,25,20
2022-03-27,Binh Duong,Thuan An,10,67,36,31,26
2022-03-27,Binh Duong,Thuan An,11,84,41,43,37
2022-03-27,Binh Duong,Thuan An,12,62,42,20,14
2022-03-27,Binh Duong,Thuan An,13,59,35,24,13
2022-03-27,Binh Duong,Thuan An,14,52,25,27,21
2022-03-27,Binh Duong,Thuan An,15,43,21,22,19
2022-03-27,Binh Duong,Thuan An,16,39,30,9,6
2022-03-27,Binh Duong,Thuan An,17,34,20,14,12
2022-03-27,Binh Duong,Thuan An,18,46,33,13,12
2022-03-27,Binh Duong,Thuan An,19,37,17,20,12
2022-03-27,Binh Duong,Thuan An,20,34,17,17,16
2022-03-27,Binh Duong,Thuan An,21,7,2,5,1
2022-03-27,Binh Duong,Thuan An,22,1,0,1,0
2022-03-27,Can Tho City,Binh Thuy District,6,1,1,0,0
2022-03-27,Can Tho City,Binh Thuy District,7,1,1,0,0
2022-03-27,Can Tho City,Binh Thuy District,8,3,3,0,0
2022-03-27,Can Tho City,Binh Thuy District,9,12,10,2,0
2022-03-27,Can Tho City,Binh Thuy District,10,9,8,1,0
2022-03-27,Can Tho City,Binh Thuy District,11,19,16,3,2
2022-03-27,Can Tho City,Binh Thuy District,12,15,14,1,0
2022-03-27,Can Tho City,Binh Thuy District,13,4,4,0,0
2022-03-27,Can Tho City,Binh Thuy District,14,11,9,2,0
2022-03-27,Can Tho City,Binh Thuy District,15,14,13,1,0
2022-03-27,Can Tho City,Binh Thuy District,16,9,8,1,0
2022-03-27,Can Tho City,Binh Thuy District,17,15,14,1,0
2022-03-27,Can Tho City,Binh Thuy District,18,12,12,0,0
2022-03-27,Can Tho City,Binh Thuy District,19,19,17,2,0
2022-03-27,Can Tho City,Binh Thuy District,20,8,8,0,0
2022-03-27,Can Tho City,Binh Thuy District,21,2,0,2,1
2022-03-27,Can Tho City,Cai Rang District,2,1,0,1,0
2022-03-27,Can Tho City,Cai Rang District,3,4,0,4,0
2022-03-27,Can Tho City,Cai Rang District,7,1,0,1,0
2022-03-27,Can Tho City,Cai Rang District,8,4,3,1,0
2022-03-27,Can Tho City,Cai Rang District,9,9,8,1,0
2022-03-27,Can Tho City,Cai Rang District,10,9,7,2,0
2022-03-27,Can Tho City,Cai Rang District,11,15,12,3,2
2022-03-27,Can Tho City,Cai Rang District,12,10,8,2,1
2022-03-27,Can Tho City,Cai Rang District,13,12,11,1,0
2022-03-27,Can Tho City,Cai Rang District,14,7,7,0,0
2022-03-27,Can Tho City,Cai Rang District,15,17,17,0,0
2022-03-27,Can Tho City,Cai Rang District,16,12,12,0,0
2022-03-27,Can Tho City,Cai Rang District,17,9,8,1,0
2022-03-27,Can Tho City,Cai Rang District,18,9,9,0,0
2022-03-27,Can Tho City,Cai Rang District,19,13,12,1,0
2022-03-27,Can Tho City,Cai Rang District,20,14,12,2,1
2022-03-27,Can Tho City,Cai Rang District,21,5,1,4,2
2022-03-27,Can Tho City,Ninh Kieu District,0,2,1,1,0
2022-03-27,Can Tho City,Ninh Kieu District,1,3,1,2,0
2022-03-27,Can Tho City,Ninh Kieu District,2,1,1,0,0
2022-03-27,Can Tho City,Ninh Kieu District,3,1,0,1,0
2022-03-27,Can Tho City,Ninh Kieu District,4,2,2,0,0
2022-03-27,Can Tho City,Ninh Kieu District,5,1,1,0,0
2022-03-27,Can Tho City,Ninh Kieu District,6,42,36,6,0
2022-03-27,Can Tho City,Ninh Kieu District,7,137,128,9,1
2022-03-27,Can Tho City,Ninh Kieu District,8,230,215,15,0
2022-03-27,Can Tho City,Ninh Kieu District,9,304,279,25,0
2022-03-27,Can Tho City,Ninh Kieu District,10,582,551,31,3
2022-03-27,Can Tho City,Ninh Kieu District,11,763,714,49,11
2022-03-27,Can Tho City,Ninh Kieu District,12,560,525,35,1
2022-03-27,Can Tho City,Ninh Kieu District,13,469,437,32,0
2022-03-27,Can Tho City,Ninh Kieu District,14,393,373,20,0
2022-03-27,Can Tho City,Ninh Kieu District,15,351,333,18,0
2022-03-27,Can Tho City,Ninh Kieu District,16,457,429,28,2
2022-03-27,Can Tho City,Ninh Kieu District,17,541,511,30,2
2022-03-27,Can Tho City,Ninh Kieu District,18,533,502,31,1
2022-03-27,Can Tho City,Ninh Kieu District,19,419,399,20,0
2022-03-27,Can Tho City,Ninh Kieu District,20,369,331,38,3
2022-03-27,Can Tho City,Ninh Kieu District,21,150,132,18,1
2022-03-27,Can Tho City,Ninh Kieu District,22,5,4,1,1
2022-03-27,Can Tho City,Ninh Kieu District,23,3,1,2,0
2022-03-27,Dong Nai,Bien Hoa City,0,3,2,1,0
2022-03-27,Dong Nai,Bien Hoa City,1,1,1,0,0
2022-03-27,Dong Nai,Bien Hoa City,3,1,1,0,0
2022-03-27,Dong Nai,Bien Hoa City,6,41,27,14,8
2022-03-27,Dong Nai,Bien Hoa City,7,178,114,64,44
2022-03-27,Dong Nai,Bien Hoa City,8,319,219,100,67
2022-03-27,Dong Nai,Bien Hoa City,9,460,354,106,57
2022-03-27,Dong Nai,Bien Hoa City,10,807,649,158,96
2022-03-27,Dong Nai,Bien Hoa City,11,1143,942,201,112
2022-03-27,Dong Nai,Bien Hoa City,12,1004,865,139,56
2022-03-27,Dong Nai,Bien Hoa City,13,741,658,83,25
2022-03-27,Dong Nai,Bien Hoa City,14,576,515,61,23
2022-03-27,Dong Nai,Bien Hoa City,15,546,466,80,33
2022-03-27,Dong Nai,Bien Hoa City,16,573,461,112,64
2022-03-27,Dong Nai,Bien Hoa City,17,677,523,154,83
2022-03-27,Dong Nai,Bien Hoa City,18,787,555,232,173
2022-03-27,Dong Nai,Bien Hoa City,19,788,528,260,202
2022-03-27,Dong Nai,Bien Hoa City,20,550,350,200,128
2022-03-27,Dong Nai,Bien Hoa City,21,229,132,97,57
2022-03-27,Dong Nai,Bien Hoa City,22,3,0,3,1
2022-03-27,Dong Nai,Bien Hoa City,23,1,1,0,0
2022-03-27,Dong Nai,Cam My,19,1,0,1,1
2022-03-27,Dong Nai,Long Thanh,11,3,0,3,3
2022-03-27,Dong Nai,Long Thanh,12,1,0,1,1
2022-03-27,Dong Nai,Long Thanh,13,2,0,2,2
2022-03-27,Dong Nai,Long Thanh,14,1,0,1,1
2022-03-27,Dong Nai,Long Thanh,15,2,0,2,2
2022-03-27,Dong Nai,Long Thanh,17,1,0,1,1
2022-03-27,Dong Nai,Nhon trach,9,1,0,1,1
2022-03-27,Dong Nai,Nhon trach,14,1,0,1,1
2022-03-27,Dong Nai,Nhon trach,16,3,0,3,2
2022-03-27,Dong Nai,Nhon trach,19,1,0,1,1
2022-03-27,Dong Nai,Thong Nhat,8,1,1,0,0
2022-03-27,Dong Nai,Thong Nhat,9,1,1,0,0
2022-03-27,Dong Nai,Thong Nhat,10,3,2,1,1
2022-03-27,Dong Nai,Thong Nhat,11,2,2,0,0
2022-03-27,Dong Nai,Thong Nhat,12,1,1,0,0
2022-03-27,Dong Nai,Thong Nhat,13,1,1,0,0
2022-03-27,Dong Nai,Thong Nhat,14,1,1,0,0
2022-03-27,Dong Nai,Thong Nhat,16,4,4,0,0
2022-03-27,Dong Nai,Thong Nhat,17,1,1,0,0
2022-03-27,Dong Nai,Thong Nhat,18,1,1,0,0
2022-03-27,Dong Nai,Thong Nhat,19,2,1,1,1
2022-03-27,Dong Nai,Thong Nhat,21,1,1,0,0
2022-03-27,Dong Nai,Trang Bom,11,5,0,5,5
2022-03-27,Dong Nai,Trang Bom,15,1,0,1,1
2022-03-27,Hai Phong City,An Duong,7,1,0,1,1
2022-03-27,Hai Phong City,An Duong,8,4,0,4,3
2022-03-27,Hai Phong City,An Duong,9,5,1,4,4
2022-03-27,Hai Phong City,An Duong,10,7,4,3,3
2022-03-27,Hai Phong City,An Duong,11,9,4,5,4
2022-03-27,Hai Phong City,An Duong,12,7,2,5,4
2022-03-27,Hai Phong City,An Duong,13,3,1,2,1
2022-03-27,Hai Phong City,An Duong,14,4,2,2,2
2022-03-27,Hai Phong City,An Duong,15,3,0,3,2
2022-03-27,Hai Phong City,An Duong,16,8,3,5,4
2022-03-27,Hai Phong City,An Duong,17,6,1,5,4
2022-03-27,Hai Phong City,An Duong,18,1,0,1,1
2022-03-27,Hai Phong City,An Duong,19,4,0,4,4
2022-03-27,Hai Phong City,An Duong,20,3,0,3,1
2022-03-27,Hai Phong City,Duong Kinh District,15,1,0,1,1
2022-03-27,Hai Phong City,Hai An District,2,1,0,1,0
2022-03-27,Hai Phong City,Hai An District,7,8,4,4,4
2022-03-27,Hai Phong City,Hai An District,8,17,8,9,6
2022-03-27,Hai Phong City,Hai An District,9,17,11,6,5
2022-03-27,Hai Phong City,Hai An District,10,21,18,3,0
2022-03-27,Hai Phong City,Hai An District,11,32,28,4,1
2022-03-27,Hai Phong City,Hai An District,12,17,15,2,0
2022-03-27,Hai Phong City,Hai An District,13,12,10,2,2
2022-03-27,Hai Phong City,Hai An District,14,13,12,1,0
2022-03-27,Hai Phong City,Hai An District,15,19,17,2,1
2022-03-27,Hai Phong City,Hai An District,16,10,7,3,0
2022-03-27,Hai Phong City,Hai An District,17,26,17,9,6
2022-03-27,Hai Phong City,Hai An District,18,27,21,6,2
2022-03-27,Hai Phong City,Hai An District,19,21,13,8,3
2022-03-27,Hai Phong City,Hai An District,20,16,10,6,4
2022-03-27,Hai Phong City,Hai An District,21,18,2,16,11
2022-03-27,Hai Phong City,Hong Bang District,4,1,1,0,0
2022-03-27,Hai Phong City,Hong Bang District,7,20,9,11,9
2022-03-27,Hai Phong City,Hong Bang District,8,30,14,16,12
2022-03-27,Hai Phong City,Hong Bang District,9,41,27,14,10
2022-03-27,Hai Phong City,Hong Bang District,10,48,38,10,6
2022-03-27,Hai Phong City,Hong Bang District,11,122,92,30,20
2022-03-27,Hai Phong City,Hong Bang District,12,78,64,14,7
2022-03-27,Hai Phong City,Hong Bang District,13,29,25,4,0
2022-03-27,Hai Phong City,Hong Bang District,14,33,23,10,6
2022-03-27,Hai Phong City,Hong Bang District,15,37,22,15,7
2022-03-27,Hai Phong City,Hong Bang District,16,33,25,8,3
2022-03-27,Hai Phong City,Hong Bang District,17,43,33,10,6
2022-03-27,Hai Phong City,Hong Bang District,18,78,54,24,19
2022-03-27,Hai Phong City,Hong Bang District,19,57,29,28,22
2022-03-27,Hai Phong City,Hong Bang District,20,33,16,17,13
2022-03-27,Hai Phong City,Hong Bang District,21,11,6,5,4
2022-03-27,Hai Phong City,Kien An District,7,7,3,4,3
2022-03-27,Hai Phong City,Kien An District,8,5,0,5,5
2022-03-27,Hai Phong City,Kien An District,9,9,7,2,2
2022-03-27,Hai Phong City,Kien An District,10,7,6,1,1
2022-03-27,Hai Phong City,Kien An District,11,14,12,2,2
2022-03-27,Hai Phong City,Kien An District,12,4,4,0,0
2022-03-27,Hai Phong City,Kien An District,13,6,3,3,2
2022-03-27,Hai Phong City,Kien An District,14,4,3,1,0
2022-03-27,Hai Phong City,Kien An District,15,5,4,1,0
2022-03-27,Hai Phong City,Kien An District,16,6,2,4,1
2022-03-27,Hai Phong City,Kien An District,17,8,5,3,2
2022-03-27,Hai Phong City,Kien An District,18,8,6,2,1
2022-03-27,Hai Phong City,Kien An District,19,16,6,10,10
2022-03-27,Hai Phong City,Kien An District,20,16,5,11,9
2022-03-27,Hai Phong City,Kien An District,21,5,1,4,3
2022-03-27,Hai Phong City,Le Chan District,0,1,0,1,0
2022-03-27,Hai Phong City,Le Chan District,2,2,2,0,0
2022-03-27,Hai Phong City,Le Chan District,4,1,1,0,0
2022-03-27,Hai Phong City,Le Chan District,7,34,24,10,3
2022-03-27,Hai Phong City,Le Chan District,8,70,53,17,10
2022-03-27,Hai Phong City,Le Chan District,9,115,81,34,18
2022-03-27,Hai Phong City,Le Chan District,10,202,172,30,10
2022-03-27,Hai Phong City,Le Chan District,11,319,246,73,40
2022-03-27,Hai Phong City,Le Chan District,12,225,179,46,17
2022-03-27,Hai Phong City,Le Chan District,13,132,109,23,6
2022-03-27,Hai Phong City,Le Chan District,14,118,92,26,11
2022-03-27,Hai Phong City,Le Chan District,15,142,111,31,9
2022-03-27,Hai Phong City,Le Chan District,16,174,131,43,17
2022-03-27,Hai Phong City,Le Chan District,17,228,164,64,34
2022-03-27,Hai Phong City,Le Chan District,18,220,146,74,46
2022-03-27,Hai Phong City,Le Chan District,19,202,134,68,53
2022-03-27,Hai Phong City,Le Chan District,20,178,93,85,64
2022-03-27,Hai Phong City,Le Chan District,21,75,29,46,33
2022-03-27,Hai Phong City,Le Chan District,22,1,1,0,0
2022-03-27,Hai Phong City,Ngo Quyen District,0,1,1,0,0
2022-03-27,Hai Phong City,Ngo Quyen District,2,1,1,0,0
2022-03-27,Hai Phong City,Ngo Quyen District,6,1,0,1,0
2022-03-27,Hai Phong City,Ngo Quyen District,7,30,13,17,14
2022-03-27,Hai Phong City,Ngo Quyen District,8,65,41,24,15
2022-03-27,Hai Phong City,Ngo Quyen District,9,89,70,19,12
2022-03-27,Hai Phong City,Ngo Quyen District,10,166,142,24,12
2022-03-27,Hai Phong City,Ngo Quyen District,11,235,186,49,27
2022-03-27,Hai Phong City,Ngo Quyen District,12,183,156,27,13
2022-03-27,Hai Phong City,Ngo Quyen District,13,110,100,10,1
2022-03-27,Hai Phong City,Ngo Quyen District,14,108,84,24,11
2022-03-27,Hai Phong City,Ngo Quyen District,15,141,108,33,19
2022-03-27,Hai Phong City,Ngo Quyen District,16,150,121,29,9
2022-03-27,Hai Phong City,Ngo Quyen District,17,141,112,29,21
2022-03-27,Hai Phong City,Ngo Quyen District,18,213,148,65,36
2022-03-27,Hai Phong City,Ngo Quyen District,19,198,128,70,51
2022-03-27,Hai Phong City,Ngo Quyen District,20,168,97,71,51
2022-03-27,Hai Phong City,Ngo Quyen District,21,63,27,36,27
2022-03-27,Hai Phong City,Thuy Nguyen,8,1,0,1,1
2022-03-27,Hai Phong City,Thuy Nguyen,10,2,0,2,2
2022-03-27,Hai Phong City,Thuy Nguyen,11,7,1,6,6
2022-03-27,Hai Phong City,Thuy Nguyen,13,1,0,1,1
2022-03-27,Hai Phong City,Thuy Nguyen,17,7,0,7,4
2022-03-27,Hai Phong City,Thuy Nguyen,18,1,0,1,1
2022-03-27,Hai Phong City,Thuy Nguyen,20,2,0,2,2
2022-03-27,Hue City,Hue City,0,2,2,0,0
2022-03-27,Hue City,Hue City,5,1,1,0,0
2022-03-27,Hue City,Hue City,6,62,55,7,2
2022-03-27,Hue City,Hue City,7,180,163,17,2
2022-03-27,Hue City,Hue City,8,324,308,16,1
2022-03-27,Hue City,Hue City,9,318,285,33,1
2022-03-27,Hue City,Hue City,10,468,442,26,0
2022-03-27,Hue City,Hue City,11,850,774,76,3
2022-03-27,Hue City,Hue City,12,577,529,48,1
2022-03-27,Hue City,Hue City,13,388,365,23,1
2022-03-27,Hue City,Hue City,14,335,303,32,4
2022-03-27,Hue City,Hue City,15,348,315,33,3
2022-03-27,Hue City,Hue City,16,382,348,34,2
2022-03-27,Hue City,Hue City,17,494,454,40,1
2022-03-27,Hue City,Hue City,18,675,584,91,25
2022-03-27,Hue City,Hue City,19,654,515,139,59
2022-03-27,Hue City,Hue City,20,637,407,230,138
2022-03-27,Hue City,Hue City,21,281,188,93,45
2022-03-27,Hue City,Hue City,22,6,2,4,0
2022-03-27,Hue City,Hue City,23,2,2,0,0
2022-03-27,Hue City,Huong Thuy,8,1,1,0,0
2022-03-27,Hue City,Huong Thuy,9,2,2,0,0
2022-03-27,Hue City,Huong Thuy,11,2,1,1,1
2022-03-27,Hue City,Huong Thuy,14,1,0,1,0
2022-03-27,Hue City,Huong Thuy,15,5,2,3,1
2022-03-27,Hue City,Huong Thuy,19,1,1,0,0
2022-03-27,Hue City,Huong Thuy,20,2,2,0,0
2022-03-27,Hue City,Huong Tra,11,1,1,0,0
2022-03-27,Hue City,Huong Tra,13,1,0,1,0
2022-03-27,Hue City,Huong Tra,16,1,1,0,0
2022-03-27,Hue City,Huong Tra,18,1,1,0,0
2022-03-27,Hue City,Phu Vang,6,2,1,1,1
2022-03-27,Hue City,Phu Vang,7,1,1,0,0
2022-03-27,Hue City,Phu Vang,8,1,1,0,0
2022-03-27,Hue City,Phu Vang,9,2,2,0,0
2022-03-27,Hue City,Phu Vang,10,2,2,0,0
2022-03-27,Hue City,Phu Vang,11,1,1,0,0
2022-03-27,Hue City,Phu Vang,12,3,2,1,0
2022-03-27,Hue City,Phu Vang,13,1,1,0,0
2022-03-27,Hue City,Phu Vang,16,2,1,1,1
2022-03-27,Hue City,Phu Vang,17,4,2,2,2
2022-03-27,Hue City,Phu Vang,18,4,3,1,0
2022-03-27,Hue City,Phu Vang,19,4,2,2,0
2022-03-27,Hue City,Phu Vang,20,3,0,3,1
2022-03-27,Vung Tau,Ba Ria City,7,1,1,0,0
2022-03-27,Vung Tau,Ba Ria City,8,4,2,2,2
2022-03-27,Vung Tau,Ba Ria City,9,13,5,8,7
2022-03-27,Vung Tau,Ba Ria City,10,6,1,5,4
2022-03-27,Vung Tau,Ba Ria City,11,17,2,15,14
2022-03-27,Vung Tau,Ba Ria City,12,20,2,18,17
2022-03-27,Vung Tau,Ba Ria City,13,12,3,9,7
2022-03-27,Vung Tau,Ba Ria City,14,13,5,8,6
2022-03-27,Vung Tau,Ba Ria City,15,5,1,4,2
2022-03-27,Vung Tau,Ba Ria City,16,10,0,10,9
2022-03-27,Vung Tau,Ba Ria City,17,16,3,13,10
2022-03-27,Vung Tau,Ba Ria City,18,13,4,9,8
2022-03-27,Vung Tau,Ba Ria City,19,12,0,12,10
2022-03-27,Vung Tau,Ba Ria City,20,2,0,2,2
2022-03-27,Vung Tau,Ba Ria City,21,1,0,1,1
2022-03-27,Vung Tau,Vung Tau City,1,1,0,1,0
2022-03-27,Vung Tau,Vung Tau City,5,2,1,1,1
2022-03-27,Vung Tau,Vung Tau City,6,35,27,8,5
2022-03-27,Vung Tau,Vung Tau City,7,147,112,35,23
2022-03-27,Vung Tau,Vung Tau City,8,249,176,73,47
2022-03-27,Vung Tau,Vung Tau City,9,241,215,26,5
2022-03-27,Vung Tau,Vung Tau City,10,304,272,32,5
2022-03-27,Vung Tau,Vung Tau City,11,442,386,56,14
2022-03-27,Vung Tau,Vung Tau City,12,352,328,24,4
2022-03-27,Vung Tau,Vung Tau City,13,250,225,25,3
2022-03-27,Vung Tau,Vung Tau City,14,251,217,34,8
2022-03-27,Vung Tau,Vung Tau City,15,232,215,17,6
2022-03-27,Vung Tau,Vung Tau City,16,244,220,24,2
2022-03-27,Vung Tau,Vung Tau City,17,289,261,28,6
2022-03-27,Vung Tau,Vung Tau City,18,363,301,62,26
2022-03-27,Vung Tau,Vung Tau City,19,288,232,56,35
2022-03-27,Vung Tau,Vung Tau City,20,174,148,26,6
2022-03-27,Vung Tau,Vung Tau City,21,85,70,15,3
2022-03-27,Vung Tau,Vung Tau City,22,2,2,0,0
2022-03-27,Vung Tau,Vung Tau City,23,2,1,1,0
2022-03-28,Binh Duong,Ben Cat,11,2,0,2,2
2022-03-28,Binh Duong,Ben Cat,15,1,0,1,1
2022-03-28,Binh Duong,Ben Cat,17,5,1,4,2
2022-03-28,Binh Duong,Ben Cat,18,2,0,2,2
2022-03-28,Binh Duong,Ben Cat,19,2,0,2,2
2022-03-28,Binh Duong,Ben Cat,20,2,0,2,1
2022-03-28,Binh Duong,Ben Cat,21,2,0,2,2
2022-03-28,Binh Duong,Di An,2,1,0,1,1
2022-03-28,Binh Duong,Di An,6,1,0,1,1
2022-03-28,Binh Duong,Di An,7,1,0,1,0
2022-03-28,Binh Duong,Di An,8,12,5,7,3
2022-03-28,Binh Duong,Di An,9,11,4,7,7
2022-03-28,Binh Duong,Di An,10,20,10,10,9
2022-03-28,Binh Duong,Di An,11,32,6,26,23
2022-03-28,Binh Duong,Di An,12,37,14,23,21
2022-03-28,Binh Duong,Di An,13,26,9,17,16
2022-03-28,Binh Duong,Di An,14,18,11,7,5
2022-03-28,Binh Duong,Di An,15,17,7,10,8
2022-03-28,Binh Duong,Di An,16,12,9,3,3
2022-03-28,Binh Duong,Di An,17,14,4,10,9
2022-03-28,Binh Duong,Di An,18,15,5,10,7
2022-03-28,Binh Duong,Di An,19,12,6,6,3
2022-03-28,Binh Duong,Di An,20,17,7,10,7
2022-03-28,Binh Duong,Di An,21,9,2,7,6
2022-03-28,Binh Duong,Tan Uyen,9,1,1,0,0
2022-03-28,Binh Duong,Tan Uyen,11,4,2,2,2
2022-03-28,Binh Duong,Tan Uyen,12,2,1,1,1
2022-03-28,Binh Duong,Tan Uyen,13,2,1,1,1
2022-03-28,Binh Duong,Tan Uyen,14,1,0,1,0
2022-03-28,Binh Duong,Tan Uyen,15,1,0,1,0
2022-03-28,Binh Duong,Tan Uyen,16,4,0,4,4
2022-03-28,Binh Duong,Tan Uyen,17,2,1,1,1
2022-03-28,Binh Duong,Tan Uyen,18,2,1,1,1
2022-03-28,Binh Duong,Tan Uyen,20,2,0,2,2
2022-03-28,Binh Duong,Tan Uyen,21,1,0,1,1
2022-03-28,Binh Duong,Thu Dau Mot Town,0,3,2,1,0
2022-03-28,Binh Duong,Thu Dau Mot Town,2,1,1,0,0
2022-03-28,Binh Duong,Thu Dau Mot Town,6,18,13,5,2
2022-03-28,Binh Duong,Thu Dau Mot Town,7,70,61,9,1
2022-03-28,Binh Duong,Thu Dau Mot Town,8,191,175,16,0
2022-03-28,Binh Duong,Thu Dau Mot Town,9,208,195,13,4
2022-03-28,Binh Duong,Thu Dau Mot Town,10,326,303,23,4
2022-03-28,Binh Duong,Thu Dau Mot Town,11,563,523,40,2
2022-03-28,Binh Duong,Thu Dau Mot Town,12,456,425,31,6
2022-03-28,Binh Duong,Thu Dau Mot Town,13,334,316,18,5
2022-03-28,Binh Duong,Thu Dau Mot Town,14,290,281,9,2
2022-03-28,Binh Duong,Thu Dau Mot Town,15,235,210,25,4
2022-03-28,Binh Duong,Thu Dau Mot Town,16,255,236,19,3
2022-03-28,Binh Duong,Thu Dau Mot Town,17,349,324,25,2
2022-03-28,Binh Duong,Thu Dau Mot Town,18,360,335,25,2
2022-03-28,Binh Duong,Thu Dau Mot Town,19,332,287,45,9
2022-03-28,Binh Duong,Thu Dau Mot Town,20,238,201,37,14
2022-03-28,Binh Duong,Thu Dau Mot Town,21,149,110,39,18
2022-03-28,Binh Duong,Thuan An,6,1,1,0,0
2022-03-28,Binh Duong,Thuan An,7,6,1,5,5
2022-03-28,Binh Duong,Thuan An,8,13,6,7,3
2022-03-28,Binh Duong,Thuan An,9,36,20,16,11
2022-03-28,Binh Duong,Thuan An,10,64,40,24,18
2022-03-28,Binh Duong,Thuan An,11,82,50,32,23
2022-03-28,Binh Duong,Thuan An,12,39,27,12,6
2022-03-28,Binh Duong,Thuan An,13,38,23,15,7
2022-03-28,Binh Duong,Thuan An,14,36,32,4,1
2022-03-28,Binh Duong,Thuan An,15,24,23,1,1
2022-03-28,Binh Duong,Thuan An,16,20,16,4,3
2022-03-28,Binh Duong,Thuan An,17,31,18,13,10
2022-03-28,Binh Duong,Thuan An,18,36,23,13,8
2022-03-28,Binh Duong,Thuan An,19,31,15,16,14
2022-03-28,Binh Duong,Thuan An,20,20,10,10,9
2022-03-28,Binh Duong,Thuan An,21,10,3,7,6
2022-03-28,Binh Duong,Thuan An,23,1,1,0,0
2022-03-28,Can Tho City,Binh Thuy District,6,2,2,0,0
2022-03-28,Can Tho City,Binh Thuy District,8,3,2,1,0
2022-03-28,Can Tho City,Binh Thuy District,9,6,6,0,0
2022-03-28,Can Tho City,Binh Thuy District,10,12,8,4,0
2022-03-28,Can Tho City,Binh Thuy District,11,17,15,2,1
2022-03-28,Can Tho City,Binh Thuy District,12,12,11,1,0
2022-03-28,Can Tho City,Binh Thuy District,13,5,5,0,0
2022-03-28,Can Tho City,Binh Thuy District,14,10,9,1,1
2022-03-28,Can Tho City,Binh Thuy District,15,10,10,0,0
2022-03-28,Can Tho City,Binh Thuy District,16,9,8,1,0
2022-03-28,Can Tho City,Binh Thuy District,17,20,17,3,2
2022-03-28,Can Tho City,Binh Thuy District,18,16,13,3,0
2022-03-28,Can Tho City,Binh Thuy District,19,22,18,4,0
2022-03-28,Can Tho City,Binh Thuy District,20,13,11,2,0
2022-03-28,Can Tho City,Binh Thuy District,21,2,2,0,0
2022-03-28,Can Tho City,Cai Rang District,5,1,0,1,0
2022-03-28,Can Tho City,Cai Rang District,6,2,1,1,0
2022-03-28,Can Tho City,Cai Rang District,7,6,2,4,2
2022-03-28,Can Tho City,Cai Rang District,8,9,2,7,5
2022-03-28,Can Tho City,Cai Rang District,9,4,4,0,0
2022-03-28,Can Tho City,Cai Rang District,10,5,5,0,0
2022-03-28,Can Tho City,Cai Rang District,11,12,9,3,1
2022-03-28,Can Tho City,Cai Rang District,12,9,7,2,0
2022-03-28,Can Tho City,Cai Rang District,13,8,5,3,0
2022-03-28,Can Tho City,Cai Rang District,14,1,1,0,0
2022-03-28,Can Tho City,Cai Rang District,15,11,10,1,0
2022-03-28,Can Tho City,Cai Rang District,16,3,3,0,0
2022-03-28,Can Tho City,Cai Rang District,17,15,15,0,0
2022-03-28,Can Tho City,Cai Rang District,18,7,5,2,1
2022-03-28,Can Tho City,Cai Rang District,19,10,10,0,0
2022-03-28,Can Tho City,Cai Rang District,20,10,9,1,0
2022-03-28,Can Tho City,Cai Rang District,21,5,4,1,0
2022-03-28,Can Tho City,Cai Rang District,23,1,0,1,1
2022-03-28,Can Tho City,Ninh Kieu District,0,4,3,1,0
2022-03-28,Can Tho City,Ninh Kieu District,1,2,2,0,0
2022-03-28,Can Tho City,Ninh Kieu District,5,4,4,0,0
2022-03-28,Can Tho City,Ninh Kieu District,6,45,41,4,2
2022-03-28,Can Tho City,Ninh Kieu District,7,140,129,11,0
2022-03-28,Can Tho City,Ninh Kieu District,8,224,215,9,0
2022-03-28,Can Tho City,Ninh Kieu District,9,268,255,13,0
2022-03-28,Can Tho City,Ninh Kieu District,10,544,518,26,0
2022-03-28,Can Tho City,Ninh Kieu District,11,847,795,52,2
2022-03-28,Can Tho City,Ninh Kieu District,12,561,542,19,0
2022-03-28,Can Tho City,Ninh Kieu District,13,423,405,18,0
2022-03-28,Can Tho City,Ninh Kieu District,14,341,331,10,0
2022-03-28,Can Tho City,Ninh Kieu District,15,350,329,21,0
2022-03-28,Can Tho City,Ninh Kieu District,16,398,381,17,2
2022-03-28,Can Tho City,Ninh Kieu District,17,542,509,33,4
2022-03-28,Can Tho City,Ninh Kieu District,18,550,497,53,9
2022-03-28,Can Tho City,Ninh Kieu District,19,528,482,46,8
2022-03-28,Can Tho City,Ninh Kieu District,20,396,360,36,3
2022-03-28,Can Tho City,Ninh Kieu District,21,211,157,54,17
2022-03-28,Can Tho City,Ninh Kieu District,22,3,3,0,0
2022-03-28,Can Tho City,Ninh Kieu District,23,2,2,0,0
2022-03-28,Dong Nai,Bien Hoa City,1,3,2,1,0
2022-03-28,Dong Nai,Bien Hoa City,2,1,1,0,0
2022-03-28,Dong Nai,Bien Hoa City,3,2,2,0,0
2022-03-28,Dong Nai,Bien Hoa City,4,1,1,0,0
2022-03-28,Dong Nai,Bien Hoa City,5,2,1,1,1
2022-03-28,Dong Nai,Bien Hoa City,6,35,23,12,11
2022-03-28,Dong Nai,Bien Hoa City,7,141,112,29,12
2022-03-28,Dong Nai,Bien Hoa City,8,275,229,46,20
2022-03-28,Dong Nai,Bien Hoa City,9,347,306,41,13
2022-03-28,Dong Nai,Bien Hoa City,10,627,555,72,18
2022-03-28,Dong Nai,Bien Hoa City,11,1005,870,135,52
2022-03-28,Dong Nai,Bien Hoa City,12,775,692,83,26
2022-03-28,Dong Nai,Bien Hoa City,13,777,659,118,68
2022-03-28,Dong Nai,Bien Hoa City,14,646,552,94,44
2022-03-28,Dong Nai,Bien Hoa City,15,440,380,60,13
2022-03-28,Dong Nai,Bien Hoa City,16,420,385,35,10
2022-03-28,Dong Nai,Bien Hoa City,17,526,467,59,18
2022-03-28,Dong Nai,Bien Hoa City,18,551,500,51,18
2022-03-28,Dong Nai,Bien Hoa City,19,526,460,66,19
2022-03-28,Dong Nai,Bien Hoa City,20,451,369,82,36
2022-03-28,Dong Nai,Bien Hoa City,21,189,118,71,43
2022-03-28,Dong Nai,Bien Hoa City,22,3,1,2,0
2022-03-28,Dong Nai,Bien Hoa City,23,1,0,1,0
2022-03-28,Dong Nai,Long Thanh,1,2,0,2,1
2022-03-28,Dong Nai,Long Thanh,11,1,0,1,0
2022-03-28,Dong Nai,Long Thanh,12,1,0,1,1
2022-03-28,Dong Nai,Long Thanh,17,1,0,1,1
2022-03-28,Dong Nai,Long Thanh,18,1,0,1,1
2022-03-28,Dong Nai,Nhon trach,9,1,0,1,1
2022-03-28,Dong Nai,Nhon trach,17,1,0,1,1
2022-03-28,Dong Nai,Nhon trach,23,1,0,1,1
2022-03-28,Dong Nai,Thong Nhat,12,1,1,0,0
2022-03-28,Dong Nai,Thong Nhat,13,1,1,0,0
2022-03-28,Dong Nai,Thong Nhat,16,1,1,0,0
2022-03-28,Dong Nai,Thong Nhat,19,2,2,0,0
2022-03-28,Dong Nai,Thong Nhat,20,1,1,0,0
2022-03-28,Dong Nai,Trang Bom,10,1,0,1,1
2022-03-28,Dong Nai,Trang Bom,14,1,0,1,1
2022-03-28,Dong Nai,Trang Bom,15,1,0,1,1
2022-03-28,Dong Nai,Trang Bom,17,1,1,0,0
2022-03-28,Dong Nai,Trang Bom,21,2,0,2,2
2022-03-28,Hai Phong City,An Duong,7,1,0,1,1
2022-03-28,Hai Phong City,An Duong,8,6,0,6,5
2022-03-28,Hai Phong City,An Duong,9,1,1,0,0
2022-03-28,Hai Phong City,An Duong,10,4,1,3,3
2022-03-28,Hai Phong City,An Duong,11,6,3,3,2
2022-03-28,Hai Phong City,An Duong,12,2,2,0,0
2022-03-28,Hai Phong City,An Duong,14,5,2,3,3
2022-03-28,Hai Phong City,An Duong,15,5,1,4,2
2022-03-28,Hai Phong City,An Duong,16,3,1,2,0
2022-03-28,Hai Phong City,An Duong,17,1,0,1,1
2022-03-28,Hai Phong City,An Duong,18,1,0,1,1
2022-03-28,Hai Phong City,An Duong,20,1,0,1,1
2022-03-28,Hai Phong City,An Duong,21,1,1,0,0
2022-03-28,Hai Phong City,Duong Kinh District,20,1,0,1,1
2022-03-28,Hai Phong City,Hai An District,6,1,1,0,0
2022-03-28,Hai Phong City,Hai An District,7,3,2,1,0
2022-03-28,Hai Phong City,Hai An District,8,20,17,3,1
2022-03-28,Hai Phong City,Hai An District,9,2,2,0,0
2022-03-28,Hai Phong City,Hai An District,10,16,12,4,1
2022-03-28,Hai Phong City,Hai An District,11,48,37,11,4
2022-03-28,Hai Phong City,Hai An District,12,25,22,3,1
2022-03-28,Hai Phong City,Hai An District,13,13,10,3,3
2022-03-28,Hai Phong City,Hai An District,14,10,8,2,1
2022-03-28,Hai Phong City,Hai An District,15,12,10,2,1
2022-03-28,Hai Phong City,Hai An District,16,12,11,1,0
2022-03-28,Hai Phong City,Hai An District,17,20,17,3,2
2022-03-28,Hai Phong City,Hai An District,18,23,19,4,1
2022-03-28,Hai Phong City,Hai An District,19,22,18,4,1
2022-03-28,Hai Phong City,Hai An District,20,14,11,3,0
2022-03-28,Hai Phong City,Hai An District,21,7,4,3,2
2022-03-28,Hai Phong City,Hong Bang District,7,4,2,2,0
2022-03-28,Hai Phong City,Hong Bang District,8,21,19,2,0
2022-03-28,Hai Phong City,Hong Bang District,9,23,19,4,0
2022-03-28,Hai Phong City,Hong Bang District,10,36,32,4,0
2022-03-28,Hai Phong City,Hong Bang District,11,100,70,30,10
2022-03-28,Hai Phong City,Hong Bang District,12,66,53,13,9
2022-03-28,Hai Phong City,Hong Bang District,13,35,30,5,3
2022-03-28,Hai Phong City,Hong Bang District,14,37,33,4,3
2022-03-28,Hai Phong City,Hong Bang District,15,29,25,4,0
2022-03-28,Hai Phong City,Hong Bang District,16,27,21,6,1
2022-03-28,Hai Phong City,Hong Bang District,17,41,37,4,0
2022-03-28,Hai Phong City,Hong Bang District,18,46,43,3,1
2022-03-28,Hai Phong City,Hong Bang District,19,35,30,5,0
2022-03-28,Hai Phong City,Hong Bang District,20,18,17,1,0
2022-03-28,Hai Phong City,Hong Bang District,21,13,7,6,3
2022-03-28,Hai Phong City,Kien An District,9,3,1,2,2
2022-03-28,Hai Phong City,Kien An District,10,4,2,2,2
2022-03-28,Hai Phong City,Kien An District,11,17,10,7,4
2022-03-28,Hai Phong City,Kien An District,12,4,3,1,1
2022-03-28,Hai Phong City,Kien An District,13,9,4,5,3
2022-03-28,Hai Phong City,Kien An District,14,5,2,3,2
2022-03-28,Hai Phong City,Kien An District,15,10,8,2,1
2022-03-28,Hai Phong City,Kien An District,16,8,6,2,0
2022-03-28,Hai Phong City,Kien An District,17,11,8,3,2
2022-03-28,Hai Phong City,Kien An District,18,12,12,0,0
2022-03-28,Hai Phong City,Kien An District,19,3,3,0,0
2022-03-28,Hai Phong City,Kien An District,20,6,2,4,2
2022-03-28,Hai Phong City,Kien An District,21,1,0,1,1
2022-03-28,Hai Phong City,Le Chan District,0,2,1,1,0
2022-03-28,Hai Phong City,Le Chan District,1,1,0,1,0
2022-03-28,Hai Phong City,Le Chan District,5,1,0,1,0
2022-03-28,Hai Phong City,Le Chan District,6,4,3,1,0
2022-03-28,Hai Phong City,Le Chan District,7,26,19,7,2
2022-03-28,Hai Phong City,Le Chan District,8,40,34,6,0
2022-03-28,Hai Phong City,Le Chan District,9,65,59,6,1
2022-03-28,Hai Phong City,Le Chan District,10,119,109,10,2
2022-03-28,Hai Phong City,Le Chan District,11,248,215,33,15
2022-03-28,Hai Phong City,Le Chan District,12,157,139,18,6
2022-03-28,Hai Phong City,Le Chan District,13,82,73,9,3
2022-03-28,Hai Phong City,Le Chan District,14,105,87,18,9
2022-03-28,Hai Phong City,Le Chan District,15,113,100,13,1
2022-03-28,Hai Phong City,Le Chan District,16,113,104,9,0
2022-03-28,Hai Phong City,Le Chan District,17,150,132,18,1
2022-03-28,Hai Phong City,Le Chan District,18,183,162,21,6
2022-03-28,Hai Phong City,Le Chan District,19,168,145,23,4
2022-03-28,Hai Phong City,Le Chan District,20,113,96,17,5
2022-03-28,Hai Phong City,Le Chan District,21,53,40,13,8
2022-03-28,Hai Phong City,Ngo Quyen District,0,1,1,0,0
2022-03-28,Hai Phong City,Ngo Quyen District,3,1,0,1,0
2022-03-28,Hai Phong City,Ngo Quyen District,4,1,1,0,0
2022-03-28,Hai Phong City,Ngo Quyen District,6,1,1,0,0
2022-03-28,Hai Phong City,Ngo Quyen District,7,18,17,1,0
2022-03-28,Hai Phong City,Ngo Quyen District,8,59,48,11,4
2022-03-28,Hai Phong City,Ngo Quyen District,9,57,52,5,0
2022-03-28,Hai Phong City,Ngo Quyen District,10,100,97,3,1
2022-03-28,Hai Phong City,Ngo Quyen District,11,226,195,31,15
2022-03-28,Hai Phong City,Ngo Quyen District,12,125,110,15,4
2022-03-28,Hai Phong City,Ngo Quyen District,13,96,85,11,2
2022-03-28,Hai Phong City,Ngo Quyen District,14,117,100,17,11
2022-03-28,Hai Phong City,Ngo Quyen District,15,113,101,12,2
2022-03-28,Hai Phong City,Ngo Quyen District,16,106,93,13,0
2022-03-28,Hai Phong City,Ngo Quyen District,17,101,91,10,2
2022-03-28,Hai Phong City,Ngo Quyen District,18,137,122,15,4
2022-03-28,Hai Phong City,Ngo Quyen District,19,149,131,18,4
2022-03-28,Hai Phong City,Ngo Quyen District,20,117,94,23,7
2022-03-28,Hai Phong City,Ngo Quyen District,21,53,42,11,3
2022-03-28,Hai Phong City,Ngo Quyen District,22,3,2,1,1
2022-03-28,Hai Phong City,Thuy Nguyen,9,1,0,1,1
2022-03-28,Hai Phong City,Thuy Nguyen,12,3,0,3,1
2022-03-28,Hai Phong City,Thuy Nguyen,15,1,0,1,1
2022-03-28,Hai Phong City,Thuy Nguyen,16,1,0,1,1
2022-03-28,Hai Phong City,Thuy Nguyen,20,2,0,2,2
2022-03-28,Hue City,Hue City,0,2,2,0,0
2022-03-28,Hue City,Hue City,2,1,1,0,0
2022-03-28,Hue City,Hue City,3,1,1,0,0
2022-03-28,Hue City,Hue City,5,6,4,2,0
2022-03-28,Hue City,Hue City,6,56,48,8,4
2022-03-28,Hue City,Hue City,7,206,189,17,2
2022-03-28,Hue City,Hue City,8,289,269,20,1
2022-03-28,Hue City,Hue City,9,247,227,20,1
2022-03-28,Hue City,Hue City,10,321,295,26,1
2022-03-28,Hue City,Hue City,11,645,596,49,3
2022-03-28,Hue City,Hue City,12,433,402,31,0
2022-03-28,Hue City,Hue City,13,266,244,22,0
2022-03-28,Hue City,Hue City,14,235,215,20,2
2022-03-28,Hue City,Hue City,15,351,320,31,0
2022-03-28,Hue City,Hue City,16,313,293,20,1
2022-03-28,Hue City,Hue City,17,434,393,41,1
2022-03-28,Hue City,Hue City,18,609,545,64,2
2022-03-28,Hue City,Hue City,19,569,515,54,0
2022-03-28,Hue City,Hue City,20,395,353,42,5
2022-03-28,Hue City,Hue City,21,244,197,47,6
2022-03-28,Hue City,Hue City,22,3,1,2,0
2022-03-28,Hue City,Hue City,23,1,1,0,0
2022-03-28,Hue City,Huong Thuy,10,1,1,0,0
2022-03-28,Hue City,Huong Thuy,15,1,1,0,0
2022-03-28,Hue City,Huong Thuy,17,2,1,1,1
2022-03-28,Hue City,Huong Thuy,18,1,1,0,0
2022-03-28,Hue City,Huong Tra,18,1,1,0,0
2022-03-28,Hue City,Phu Vang,6,1,1,0,0
2022-03-28,Hue City,Phu Vang,8,3,3,0,0
2022-03-28,Hue City,Phu Vang,9,2,2,0,0
2022-03-28,Hue City,Phu Vang,10,1,1,0,0
2022-03-28,Hue City,Phu Vang,11,1,1,0,0
2022-03-28,Hue City,Phu Vang,13,1,0,1,1
2022-03-28,Hue City,Phu Vang,14,1,1,0,0
2022-03-28,Hue City,Phu Vang,15,1,1,0,0
2022-03-28,Hue City,Phu Vang,16,1,0,1,0
2022-03-28,Hue City,Phu Vang,17,1,1,0,0
2022-03-28,Hue City,Phu Vang,18,2,1,1,0
2022-03-28,Hue City,Phu Vang,19,2,2,0,0
2022-03-28,Hue City,Phu Vang,21,1,0,1,1
2022-03-28,Vung Tau,Ba Ria City,7,3,0,3,1
2022-03-28,Vung Tau,Ba Ria City,8,5,2,3,2
2022-03-28,Vung Tau,Ba Ria City,9,5,3,2,0
2022-03-28,Vung Tau,Ba Ria City,10,7,5,2,0
2022-03-28,Vung Tau,Ba Ria City,11,8,6,2,2
2022-03-28,Vung Tau,Ba Ria City,12,6,5,1,0
2022-03-28,Vung Tau,Ba Ria City,13,9,7,2,0
2022-03-28,Vung Tau,Ba Ria City,14,3,3,0,0
2022-03-28,Vung Tau,Ba Ria City,15,5,2,3,2
2022-03-28,Vung Tau,Ba Ria City,16,6,1,5,5
2022-03-28,Vung Tau,Ba Ria City,17,8,6,2,1
2022-03-28,Vung Tau,Ba Ria City,18,2,2,0,0
2022-03-28,Vung Tau,Ba Ria City,19,6,4,2,2
2022-03-28,Vung Tau,Ba Ria City,20,4,1,3,2
2022-03-28,Vung Tau,Vung Tau City,2,1,0,1,0
2022-03-28,Vung Tau,Vung Tau City,3,1,1,0,0
2022-03-28,Vung Tau,Vung Tau City,5,4,2,2,0
2022-03-28,Vung Tau,Vung Tau City,6,28,22,6,1
2022-03-28,Vung Tau,Vung Tau City,7,100,91,9,1
2022-03-28,Vung Tau,Vung Tau City,8,172,150,22,7
2022-03-28,Vung Tau,Vung Tau City,9,149,132,17,0
2022-03-28,Vung Tau,Vung Tau City,10,185,171,14,4
2022-03-28,Vung Tau,Vung Tau City,11,375,334,41,10
2022-03-28,Vung Tau,Vung Tau City,12,282,254,28,1
2022-03-28,Vung Tau,Vung Tau City,13,184,171,13,1
2022-03-28,Vung Tau,Vung Tau City,14,213,195,18,0
2022-03-28,Vung Tau,Vung Tau City,15,206,186,20,8
2022-03-28,Vung Tau,Vung Tau City,16,171,160,11,0
2022-03-28,Vung Tau,Vung Tau City,17,264,244,20,3
2022-03-28,Vung Tau,Vung Tau City,18,299,277,22,2
2022-03-28,Vung Tau,Vung Tau City,19,254,219,35,11
2022-03-28,Vung Tau,Vung Tau City,20,169,135,34,9
2022-03-28,Vung Tau,Vung Tau City,21,84,62,22,13
2022-03-28,Vung Tau,Vung Tau City,23,1,1,0,0
2022-03-29,Binh Duong,Ben Cat,8,1,0,1,0
2022-03-29,Binh Duong,Ben Cat,11,1,0,1,1
2022-03-29,Binh Duong,Ben Cat,12,2,1,1,1
2022-03-29,Binh Duong,Ben Cat,13,1,0,1,1
2022-03-29,Binh Duong,Ben Cat,16,1,0,1,1
2022-03-29,Binh Duong,Ben Cat,18,1,0,1,1
2022-03-29,Binh Duong,Ben Cat,19,1,0,1,1
2022-03-29,Binh Duong,Di An,6,1,0,1,0
2022-03-29,Binh Duong,Di An,7,3,0,3,3
2022-03-29,Binh Duong,Di An,8,6,2,4,4
2022-03-29,Binh Duong,Di An,9,22,5,17,11
2022-03-29,Binh Duong,Di An,10,26,13,13,12
2022-03-29,Binh Duong,Di An,11,28,11,17,16
2022-03-29,Binh Duong,Di An,12,31,13,18,16
2022-03-29,Binh Duong,Di An,13,27,8,19,13
2022-03-29,Binh Duong,Di An,14,18,13,5,3
2022-03-29,Binh Duong,Di An,15,16,11,5,4
2022-03-29,Binh Duong,Di An,16,19,8,11,10
2022-03-29,Binh Duong,Di An,17,17,5,12,9
2022-03-29,Binh Duong,Di An,18,25,12,13,10
2022-03-29,Binh Duong,Di An,19,33,9,24,23
2022-03-29,Binh Duong,Di An,20,17,8,9,6
2022-03-29,Binh Duong,Di An,21,8,0,8,3
2022-03-29,Binh Duong,Tan Uyen,9,1,0,1,1
2022-03-29,Binh Duong,Tan Uyen,10,1,1,0,0
2022-03-29,Binh Duong,Tan Uyen,11,7,5,2,2
2022-03-29,Binh Duong,Tan Uyen,14,1,1,0,0
2022-03-29,Binh Duong,Tan Uyen,18,6,4,2,2
2022-03-29,Binh Duong,Tan Uyen,19,6,1,5,3
2022-03-29,Binh Duong,Tan Uyen,20,1,0,1,1
2022-03-29,Binh Duong,Thu Dau Mot Town,4,1,0,1,0
2022-03-29,Binh Duong,Thu Dau Mot Town,6,17,14,3,1
2022-03-29,Binh Duong,Thu Dau Mot Town,7,97,90,7,0
2022-03-29,Binh Duong,Thu Dau Mot Town,8,183,169,14,2
2022-03-29,Binh Duong,Thu Dau Mot Town,9,193,176,17,3
2022-03-29,Binh Duong,Thu Dau Mot Town,10,355,333,22,0
2022-03-29,Binh Duong,Thu Dau Mot Town,11,582,547,35,3
2022-03-29,Binh Duong,Thu Dau Mot Town,12,403,373,30,8
2022-03-29,Binh Duong,Thu Dau Mot Town,13,361,343,18,4
2022-03-29,Binh Duong,Thu Dau Mot Town,14,288,271,17,3
2022-03-29,Binh Duong,Thu Dau Mot Town,15,246,237,9,0
2022-03-29,Binh Duong,Thu Dau Mot Town,16,233,218,15,0
2022-03-29,Binh Duong,Thu Dau Mot Town,17,325,303,22,6
2022-03-29,Binh Duong,Thu Dau Mot Town,18,352,327,25,4
2022-03-29,Binh Duong,Thu Dau Mot Town,19,271,256,15,4
2022-03-29,Binh Duong,Thu Dau Mot Town,20,249,223,26,5
2022-03-29,Binh Duong,Thu Dau Mot Town,21,108,94,14,3
2022-03-29,Binh Duong,Thu Dau Mot Town,22,3,1,2,0
2022-03-29,Binh Duong,Thuan An,7,6,4,2,1
2022-03-29,Binh Duong,Thuan An,8,10,6,4,4
2022-03-29,Binh Duong,Thuan An,9,27,21,6,5
2022-03-29,Binh Duong,Thuan An,10,50,42,8,4
2022-03-29,Binh Duong,Thuan An,11,62,42,20,13
2022-03-29,Binh Duong,Thuan An,12,31,24,7,4
2022-03-29,Binh Duong,Thuan An,13,52,40,12,7
2022-03-29,Binh Duong,Thuan An,14,44,31,13,8
2022-03-29,Binh Duong,Thuan An,15,27,16,11,6
2022-03-29,Binh Duong,Thuan An,16,25,15,10,9
2022-03-29,Binh Duong,Thuan An,17,23,18,5,3
2022-03-29,Binh Duong,Thuan An,18,37,26,11,5
2022-03-29,Binh Duong,Thuan An,19,32,26,6,6
2022-03-29,Binh Duong,Thuan An,20,16,10,6,5
2022-03-29,Binh Duong,Thuan An,21,7,3,4,1
2022-03-29,Binh Duong,Thuan An,22,3,1,2,0
2022-03-29,Can Tho City,Binh Thuy District,7,1,1,0,0
2022-03-29,Can Tho City,Binh Thuy District,8,3,2,1,0
2022-03-29,Can Tho City,Binh Thuy District,9,4,3,1,0
2022-03-29,Can Tho City,Binh Thuy District,10,12,11,1,1
2022-03-29,Can Tho City,Binh Thuy District,11,22,18,4,1
2022-03-29,Can Tho City,Binh Thuy District,12,10,9,1,0
2022-03-29,Can Tho City,Binh Thuy District,13,16,15,1,1
2022-03-29,Can Tho City,Binh Thuy District,14,9,9,0,0
2022-03-29,Can Tho City,Binh Thuy District,15,13,12,1,0
2022-03-29,Can Tho City,Binh Thuy District,16,11,9,2,0
2022-03-29,Can Tho City,Binh Thuy District,17,14,13,1,0
2022-03-29,Can Tho City,Binh Thuy District,18,9,8,1,0
2022-03-29,Can Tho City,Binh Thuy District,19,13,10,3,1
2022-03-29,Can Tho City,Binh Thuy District,20,6,5,1,0
2022-03-29,Can Tho City,Cai Rang District,6,3,1,2,2
2022-03-29,Can Tho City,Cai Rang District,7,2,2,0,0
2022-03-29,Can Tho City,Cai Rang District,8,7,5,2,1
2022-03-29,Can Tho City,Cai Rang District,9,8,7,1,0
2022-03-29,Can Tho City,Cai Rang District,10,11,10,1,0
2022-03-29,Can Tho City,Cai Rang District,11,15,15,0,0
2022-03-29,Can Tho City,Cai Rang District,12,7,7,0,0
2022-03-29,Can Tho City,Cai Rang District,13,9,9,0,0
2022-03-29,Can Tho City,Cai Rang District,14,9,8,1,0
2022-03-29,Can Tho City,Cai Rang District,15,11,10,1,1
2022-03-29,Can Tho City,Cai Rang District,16,3,3,0,0
2022-03-29,Can Tho City,Cai Rang District,17,8,7,1,1
2022-03-29,Can Tho City,Cai Rang District,18,8,8,0,0
2022-03-29,Can Tho City,Cai Rang District,19,6,6,0,0
2022-03-29,Can Tho City,Cai Rang District,20,4,2,2,1
2022-03-29,Can Tho City,Cai Rang District,21,3,2,1,0
2022-03-29,Can Tho City,Ninh Kieu District,0,3,2,1,0
2022-03-29,Can Tho City,Ninh Kieu District,1,4,3,1,0
2022-03-29,Can Tho City,Ninh Kieu District,3,1,1,0,0
2022-03-29,Can Tho City,Ninh Kieu District,4,2,2,0,0
2022-03-29,Can Tho City,Ninh Kieu District,6,47,41,6,1
2022-03-29,Can Tho City,Ninh Kieu District,7,121,114,7,0
2022-03-29,Can Tho City,Ninh Kieu District,8,237,215,22,0
2022-03-29,Can Tho City,Ninh Kieu District,9,270,264,6,0
2022-03-29,Can Tho City,Ninh Kieu District,10,534,500,34,0
2022-03-29,Can Tho City,Ninh Kieu District,11,784,750,34,1
2022-03-29,Can Tho City,Ninh Kieu District,12,519,502,17,0
2022-03-29,Can Tho City,Ninh Kieu District,13,452,435,17,0
2022-03-29,Can Tho City,Ninh Kieu District,14,376,357,19,1
2022-03-29,Can Tho City,Ninh Kieu District,15,345,326,19,0
2022-03-29,Can Tho City,Ninh Kieu District,16,439,415,24,0
2022-03-29,Can Tho City,Ninh Kieu District,17,564,532,32,0
2022-03-29,Can Tho City,Ninh Kieu District,18,491,476,15,0
2022-03-29,Can Tho City,Ninh Kieu District,19,422,401,21,0
2022-03-29,Can Tho City,Ninh Kieu District,20,386,359,27,0
2022-03-29,Can Tho City,Ninh Kieu District,21,175,160,15,1
2022-03-29,Can Tho City,Ninh Kieu District,22,4,0,4,0
2022-03-29,Can Tho City,Ninh Kieu District,23,3,2,1,0
2022-03-29,Can Tho City,O Mon District,13,2,0,2,2
2022-03-29,Dong Nai,Bien Hoa City,0,2,2,0,0
2022-03-29,Dong Nai,Bien Hoa City,1,3,3,0,0
2022-03-29,Dong Nai,Bien Hoa City,2,2,1,1,0
2022-03-29,Dong Nai,Bien Hoa City,4,3,3,0,0
2022-03-29,Dong Nai,Bien Hoa City,5,4,3,1,0
2022-03-29,Dong Nai,Bien Hoa City,6,30,17,13,10
2022-03-29,Dong Nai,Bien Hoa City,7,135,111,24,12
2022-03-29,Dong Nai,Bien Hoa City,8,261,221,40,7
2022-03-29,Dong Nai,Bien Hoa City,9,398,334,64,20
2022-03-29,Dong Nai,Bien Hoa City,10,663,598,65,13
2022-03-29,Dong Nai,Bien Hoa City,11,963,882,81,15
2022-03-29,Dong Nai,Bien Hoa City,12,719,655,64,16
2022-03-29,Dong Nai,Bien Hoa City,13,692,633,59,13
2022-03-29,Dong Nai,Bien Hoa City,14,551,503,48,6
2022-03-29,Dong Nai,Bien Hoa City,15,442,401,41,4
2022-03-29,Dong Nai,Bien Hoa City,16,381,358,23,0
2022-03-29,Dong Nai,Bien Hoa City,17,510,473,37,3
2022-03-29,Dong Nai,Bien Hoa City,18,576,516,60,10
2022-03-29,Dong Nai,Bien Hoa City,19,544,504,40,6
2022-03-29,Dong Nai,Bien Hoa City,20,452,387,65,16
2022-03-29,Dong Nai,Bien Hoa City,21,184,129,55,21
2022-03-29,Dong Nai,Bien Hoa City,22,3,1,2,0
2022-03-29,Dong Nai,Bien Hoa City,23,1,0,1,0
2022-03-29,Dong Nai,Long Thanh,9,1,0,1,1
2022-03-29,Dong Nai,Long Thanh,18,2,0,2,2
2022-03-29,Dong Nai,Long Thanh,19,1,0,1,1
2022-03-29,Dong Nai,Long Thanh,21,1,0,1,1
2022-03-29,Dong Nai,Nhon trach,12,1,0,1,0
2022-03-29,Dong Nai,Nhon trach,13,2,0,2,2
2022-03-29,Dong Nai,Thong Nhat,8,1,1,0,0
2022-03-29,Dong Nai,Thong Nhat,9,3,3,0,0
2022-03-29,Dong Nai,Thong Nhat,10,3,3,0,0
2022-03-29,Dong Nai,Thong Nhat,12,1,1,0,0
2022-03-29,Dong Nai,Thong Nhat,13,2,2,0,0
2022-03-29,Dong Nai,Thong Nhat,17,1,1,0,0
2022-03-29,Dong Nai,Thong Nhat,19,1,1,0,0
2022-03-29,Dong Nai,Thong Nhat,20,2,2,0,0
2022-03-29,Dong Nai,Trang Bom,11,1,0,1,1
2022-03-29,Dong Nai,Trang Bom,18,2,0,2,1
2022-03-29,Dong Nai,Trang Bom,19,2,0,2,2
2022-03-29,Hai Phong City,An Duong,7,3,0,3,2
2022-03-29,Hai Phong City,An Duong,8,3,1,2,2
2022-03-29,Hai Phong City,An Duong,9,3,1,2,0
2022-03-29,Hai Phong City,An Duong,10,3,2,1,0
2022-03-29,Hai Phong City,An Duong,11,2,0,2,2
2022-03-29,Hai Phong City,An Duong,12,2,2,0,0
2022-03-29,Hai Phong City,An Duong,14,4,2,2,2
2022-03-29,Hai Phong City,An Duong,15,6,3,3,0
2022-03-29,Hai Phong City,An Duong,16,5,1,4,2
2022-03-29,Hai Phong City,An Duong,17,2,0,2,2
2022-03-29,Hai Phong City,An Duong,18,1,0,1,1
2022-03-29,Hai Phong City,An Duong,19,3,0,3,3
2022-03-29,Hai Phong City,An Duong,21,1,0,1,1
2022-03-29,Hai Phong City,Duong Kinh District,11,2,0,2,1
2022-03-29,Hai Phong City,Duong Kinh District,18,1,0,1,1
2022-03-29,Hai Phong City,Duong Kinh District,20,1,0,1,1
2022-03-29,Hai Phong City,Hai An District,6,1,1,0,0
2022-03-29,Hai Phong City,Hai An District,7,8,3,5,4
2022-03-29,Hai Phong City,Hai An District,8,7,7,0,0
2022-03-29,Hai Phong City,Hai An District,9,14,10,4,2
2022-03-29,Hai Phong City,Hai An District,10,17,13,4,0
2022-03-29,Hai Phong City,Hai An District,11,38,33,5,3
2022-03-29,Hai Phong City,Hai An District,12,25,23,2,0
2022-03-29,Hai Phong City,Hai An District,13,13,9,4,1
2022-03-29,Hai Phong City,Hai An District,14,17,13,4,1
2022-03-29,Hai Phong City,Hai An District,15,13,9,4,1
2022-03-29,Hai Phong City,Hai An District,16,18,17,1,1
2022-03-29,Hai Phong City,Hai An District,17,17,14,3,3
2022-03-29,Hai Phong City,Hai An District,18,25,21,4,1
2022-03-29,Hai Phong City,Hai An District,19,15,11,4,0
2022-03-29,Hai Phong City,Hai An District,20,13,10,3,0
2022-03-29,Hai Phong City,Hai An District,21,10,7,3,1
2022-03-29,Hai Phong City,Hong Bang District,6,1,0,1,0
2022-03-29,Hai Phong City,Hong Bang District,7,15,10,5,2
2022-03-29,Hai Phong City,Hong Bang District,8,27,22,5,2
2022-03-29,Hai Phong City,Hong Bang District,9,17,17,0,0
2022-03-29,Hai Phong City,Hong Bang District,10,44,43,1,0
2022-03-29,Hai Phong City,Hong Bang District,11,90,79,11,2
2022-03-29,Hai Phong City,Hong Bang District,12,44,40,4,0
2022-03-29,Hai Phong City,Hong Bang District,13,42,38,4,1
2022-03-29,Hai Phong City,Hong Bang District,14,30,24,6,4
2022-03-29,Hai Phong City,Hong Bang District,15,32,29,3,0
2022-03-29,Hai Phong City,Hong Bang District,16,26,20,6,1
2022-03-29,Hai Phong City,Hong Bang District,17,38,36,2,0
2022-03-29,Hai Phong City,Hong Bang District,18,50,46,4,2
2022-03-29,Hai Phong City,Hong Bang District,19,30,28,2,1
2022-03-29,Hai Phong City,Hong Bang District,20,28,21,7,3
2022-03-29,Hai Phong City,Hong Bang District,21,13,9,4,1
2022-03-29,Hai Phong City,Kien An District,7,2,0,2,2
2022-03-29,Hai Phong City,Kien An District,8,3,3,0,0
2022-03-29,Hai Phong City,Kien An District,9,6,3,3,3
2022-03-29,Hai Phong City,Kien An District,10,12,8,4,3
2022-03-29,Hai Phong City,Kien An District,11,9,8,1,1
2022-03-29,Hai Phong City,Kien An District,12,16,9,7,5
2022-03-29,Hai Phong City,Kien An District,13,17,7,10,8
2022-03-29,Hai Phong City,Kien An District,14,4,1,3,3
2022-03-29,Hai Phong City,Kien An District,15,6,5,1,1
2022-03-29,Hai Phong City,Kien An District,16,3,3,0,0
2022-03-29,Hai Phong City,Kien An District,17,8,7,1,1
2022-03-29,Hai Phong City,Kien An District,18,10,10,0,0
2022-03-29,Hai Phong City,Kien An District,19,9,8,1,0
2022-03-29,Hai Phong City,Kien An District,20,7,4,3,3
2022-03-29,Hai Phong City,Kien An District,21,5,2,3,3
2022-03-29,Hai Phong City,Le Chan District,2,1,1,0,0
2022-03-29,Hai Phong City,Le Chan District,6,2,1,1,0
2022-03-29,Hai Phong City,Le Chan District,7,25,18,7,3
2022-03-29,Hai Phong City,Le Chan District,8,41,33,8,0
2022-03-29,Hai Phong City,Le Chan District,9,66,57,9,1
2022-03-29,Hai Phong City,Le Chan District,10,144,129,15,0
2022-03-29,Hai Phong City,Le Chan District,11,244,223,21,2
2022-03-29,Hai Phong City,Le Chan District,12,164,152,12,0
2022-03-29,Hai Phong City,Le Chan District,13,102,91,11,0
2022-03-29,Hai Phong City,Le Chan District,14,129,108,21,5
2022-03-29,Hai Phong City,Le Chan District,15,145,114,31,1
2022-03-29,Hai Phong City,Le Chan District,16,110,105,5,0
2022-03-29,Hai Phong City,Le Chan District,17,148,135,13,1
2022-03-29,Hai Phong City,Le Chan District,18,215,190,25,4
2022-03-29,Hai Phong City,Le Chan District,19,180,164,16,2
2022-03-29,Hai Phong City,Le Chan District,20,92,73,19,1
2022-03-29,Hai Phong City,Le Chan District,21,62,48,14,5
2022-03-29,Hai Phong City,Ngo Quyen District,0,2,0,2,0
2022-03-29,Hai Phong City,Ngo Quyen District,1,2,0,2,1
2022-03-29,Hai Phong City,Ngo Quyen District,6,3,2,1,1
2022-03-29,Hai Phong City,Ngo Quyen District,7,24,18,6,2
2022-03-29,Hai Phong City,Ngo Quyen District,8,49,45,4,0
2022-03-29,Hai Phong City,Ngo Quyen District,9,62,53,9,0
2022-03-29,Hai Phong City,Ngo Quyen District,10,95,84,11,1
2022-03-29,Hai Phong City,Ngo Quyen District,11,207,192,15,3
2022-03-29,Hai Phong City,Ngo Quyen District,12,122,116,6,2
2022-03-29,Hai Phong City,Ngo Quyen District,13,107,96,11,3
2022-03-29,Hai Phong City,Ngo Quyen District,14,125,114,11,1
2022-03-29,Hai Phong City,Ngo Quyen District,15,128,114,14,4
2022-03-29,Hai Phong City,Ngo Quyen District,16,138,124,14,3
2022-03-29,Hai Phong City,Ngo Quyen District,17,152,134,18,2
2022-03-29,Hai Phong City,Ngo Quyen District,18,145,131,14,3
2022-03-29,Hai Phong City,Ngo Quyen District,19,139,126,13,0
2022-03-29,Hai Phong City,Ngo Quyen District,20,123,104,19,1
2022-03-29,Hai Phong City,Ngo Quyen District,21,50,38,12,2
2022-03-29,Hai Phong City,Thuy Nguyen,16,1,0,1,1
2022-03-29,Hai Phong City,Thuy Nguyen,17,1,1,0,0
2022-03-29,Hai Phong City,Thuy Nguyen,18,1,0,1,1
2022-03-29,Hue City,Hue City,0,5,5,0,0
2022-03-29,Hue City,Hue City,3,1,1,0,0
2022-03-29,Hue City,Hue City,4,2,2,0,0
2022-03-29,Hue City,Hue City,5,1,1,0,0
2022-03-29,Hue City,Hue City,6,56,51,5,1
2022-03-29,Hue City,Hue City,7,160,154,6,0
2022-03-29,Hue City,Hue City,8,244,223,21,1
2022-03-29,Hue City,Hue City,9,209,193,16,0
2022-03-29,Hue City,Hue City,10,365,334,31,3
2022-03-29,Hue City,Hue City,11,793,725,68,7
2022-03-29,Hue City,Hue City,12,429,396,33,0
2022-03-29,Hue City,Hue City,13,280,260,20,2
2022-03-29,Hue City,Hue City,14,283,261,22,0
2022-03-29,Hue City,Hue City,15,328,301,27,5
2022-03-29,Hue City,Hue City,16,306,279,27,2
2022-03-29,Hue City,Hue City,17,476,445,31,1
2022-03-29,Hue City,Hue City,18,563,525,38,1
2022-03-29,Hue City,Hue City,19,536,504,32,2
2022-03-29,Hue City,Hue City,20,414,377,37,0
2022-03-29,Hue City,Hue City,21,233,196,37,9
2022-03-29,Hue City,Hue City,22,5,2,3,0
2022-03-29,Hue City,Hue City,23,3,2,1,0
2022-03-29,Hue City,Huong Thuy,8,2,0,2,2
2022-03-29,Hue City,Huong Thuy,10,1,1,0,0
2022-03-29,Hue City,Huong Thuy,13,1,1,0,0
2022-03-29,Hue City,Huong Thuy,15,1,1,0,0
2022-03-29,Hue City,Huong Thuy,21,1,1,0,0
2022-03-29,Hue City,Huong Tra,20,1,1,0,0
2022-03-29,Hue City,Phu Vang,3,1,1,0,0
2022-03-29,Hue City,Phu Vang,6,3,1,2,2
2022-03-29,Hue City,Phu Vang,8,1,1,0,0
2022-03-29,Hue City,Phu Vang,10,1,1,0,0
2022-03-29,Hue City,Phu Vang,11,4,3,1,0
2022-03-29,Hue City,Phu Vang,12,4,4,0,0
2022-03-29,Hue City,Phu Vang,13,4,2,2,0
2022-03-29,Hue City,Phu Vang,15,1,1,0,0
2022-03-29,Hue City,Phu Vang,16,1,0,1,0
2022-03-29,Hue City,Phu Vang,17,1,1,0,0
2022-03-29,Hue City,Phu Vang,18,2,2,0,0
2022-03-29,Hue City,Phu Vang,19,1,1,0,0
2022-03-29,Hue City,Phu Vang,21,1,1,0,0
2022-03-29,Vung Tau,Ba Ria City,6,1,0,1,1
2022-03-29,Vung Tau,Ba Ria City,7,2,1,1,1
2022-03-29,Vung Tau,Ba Ria City,8,1,0,1,0
2022-03-29,Vung Tau,Ba Ria City,9,3,3,0,0
2022-03-29,Vung Tau,Ba Ria City,10,7,6,1,1
2022-03-29,Vung Tau,Ba Ria City,11,11,8,3,2
2022-03-29,Vung Tau,Ba Ria City,12,8,7,1,0
2022-03-29,Vung Tau,Ba Ria City,13,9,9,0,0
2022-03-29,Vung Tau,Ba Ria City,14,4,3,1,0
2022-03-29,Vung Tau,Ba Ria City,15,3,3,0,0
2022-03-29,Vung Tau,Ba Ria City,16,3,3,0,0
2022-03-29,Vung Tau,Ba Ria City,17,2,2,0,0
2022-03-29,Vung Tau,Ba Ria City,18,4,1,3,3
2022-03-29,Vung Tau,Ba Ria City,19,6,4,2,2
2022-03-29,Vung Tau,Ba Ria City,20,1,0,1,1
2022-03-29,Vung Tau,Vung Tau City,0,1,0,1,0
2022-03-29,Vung Tau,Vung Tau City,1,2,2,0,0
2022-03-29,Vung Tau,Vung Tau City,2,5,2,3,0
2022-03-29,Vung Tau,Vung Tau City,5,2,2,0,0
2022-03-29,Vung Tau,Vung Tau City,6,29,25,4,0
2022-03-29,Vung Tau,Vung Tau City,7,94,87,7,0
2022-03-29,Vung Tau,Vung Tau City,8,144,133,11,2
2022-03-29,Vung Tau,Vung Tau City,9,125,113,12,0
2022-03-29,Vung Tau,Vung Tau City,10,166,148,18,0
2022-03-29,Vung Tau,Vung Tau City,11,321,304,17,2
2022-03-29,Vung Tau,Vung Tau City,12,254,236,18,0
2022-03-29,Vung Tau,Vung Tau City,13,157,149,8,1
2022-03-29,Vung Tau,Vung Tau City,14,184,164,20,4
2022-03-29,Vung Tau,Vung Tau City,15,183,177,6,0
2022-03-29,Vung Tau,Vung Tau City,16,171,158,13,0
2022-03-29,Vung Tau,Vung Tau City,17,202,192,10,0
2022-03-29,Vung Tau,Vung Tau City,18,259,240,19,1
2022-03-29,Vung Tau,Vung Tau City,19,194,183,11,4
2022-03-29,Vung Tau,Vung Tau City,20,139,120,19,2
2022-03-29,Vung Tau,Vung Tau City,21,76,59,17,2
2022-03-30,Binh Duong,Ben Cat,8,1,0,1,1
2022-03-30,Binh Duong,Ben Cat,9,2,0,2,1
2022-03-30,Binh Duong,Ben Cat,10,2,0,2,2
2022-03-30,Binh Duong,Ben Cat,12,1,0,1,1
2022-03-30,Binh Duong,Ben Cat,17,1,0,1,0
2022-03-30,Binh Duong,Di An,0,1,1,0,0
2022-03-30,Binh Duong,Di An,7,5,0,5,2
2022-03-30,Binh Duong,Di An,8,14,6,8,5
2022-03-30,Binh Duong,Di An,9,15,13,2,1
2022-03-30,Binh Duong,Di An,10,22,19,3,2
2022-03-30,Binh Duong,Di An,11,27,16,11,6
2022-03-30,Binh Duong,Di An,12,24,15,9,8
2022-03-30,Binh Duong,Di An,13,26,17,9,7
2022-03-30,Binh Duong,Di An,14,20,13,7,5
2022-03-30,Binh Duong,Di An,15,19,10,9,6
2022-03-30,Binh Duong,Di An,16,13,8,5,4
2022-03-30,Binh Duong,Di An,17,14,10,4,3
2022-03-30,Binh Duong,Di An,18,21,13,8,8
2022-03-30,Binh Duong,Di An,19,23,15,8,3
2022-03-30,Binh Duong,Di An,20,9,7,2,1
2022-03-30,Binh Duong,Di An,21,4,0,4,2
2022-03-30,Binh Duong,Tan Uyen,9,1,0,1,1
2022-03-30,Binh Duong,Tan Uyen,10,2,1,1,0
2022-03-30,Binh Duong,Tan Uyen,11,2,2,0,0
2022-03-30,Binh Duong,Tan Uyen,12,3,2,1,1
2022-03-30,Binh Duong,Tan Uyen,13,3,1,2,1
2022-03-30,Binh Duong,Tan Uyen,14,3,1,2,2
2022-03-30,Binh Duong,Tan Uyen,15,1,0,1,1
2022-03-30,Binh Duong,Tan Uyen,17,2,1,1,1
2022-03-30,Binh Duong,Tan Uyen,18,4,2,2,0
2022-03-30,Binh Duong,Tan Uyen,19,1,0,1,1
2022-03-30,Binh Duong,Tan Uyen,20,1,0,1,1
2022-03-30,Binh Duong,Thu Dau Mot Town,0,2,1,1,0
2022-03-30,Binh Duong,Thu Dau Mot Town,1,1,1,0,0
2022-03-30,Binh Duong,Thu Dau Mot Town,6,26,24,2,0
2022-03-30,Binh Duong,Thu Dau Mot Town,7,91,83,8,3
2022-03-30,Binh Duong,Thu Dau Mot Town,8,173,156,17,3
2022-03-30,Binh Duong,Thu Dau Mot Town,9,219,203,16,0
2022-03-30,Binh Duong,Thu Dau Mot Town,10,305,285,20,2
2022-03-30,Binh Duong,Thu Dau Mot Town,11,572,544,28,6
2022-03-30,Binh Duong,Thu Dau Mot Town,12,388,365,23,2
2022-03-30,Binh Duong,Thu Dau Mot Town,13,381,351,30,1
2022-03-30,Binh Duong,Thu Dau Mot Town,14,271,260,11,0
2022-03-30,Binh Duong,Thu Dau Mot Town,15,242,234,8,2
2022-03-30,Binh Duong,Thu Dau Mot Town,16,235,226,9,1
2022-03-30,Binh Duong,Thu Dau Mot Town,17,317,293,24,5
2022-03-30,Binh Duong,Thu Dau Mot Town,18,324,294,30,4
2022-03-30,Binh Duong,Thu Dau Mot Town,19,269,254,15,2
2022-03-30,Binh Duong,Thu Dau Mot Town,20,211,192,19,0
2022-03-30,Binh Duong,Thu Dau Mot Town,21,105,60,45,35
2022-03-30,Binh Duong,Thu Dau Mot Town,23,2,0,2,0
2022-03-30,Binh Duong,Thuan An,7,5,1,4,4
2022-03-30,Binh Duong,Thuan An,8,15,6,9,5
2022-03-30,Binh Duong,Thuan An,9,41,22,19,16
2022-03-30,Binh Duong,Thuan An,10,51,30,21,16
2022-03-30,Binh Duong,Thuan An,11,65,40,25,20
2022-03-30,Binh Duong,Thuan An,12,67,45,22,18
2022-03-30,Binh Duong,Thuan An,13,55,40,15,13
2022-03-30,Binh Duong,Thuan An,14,46,37,9,3
2022-03-30,Binh Duong,Thuan An,15,40,26,14,7
2022-03-30,Binh Duong,Thuan An,16,36,27,9,4
2022-03-30,Binh Duong,Thuan An,17,45,31,14,7
2022-03-30,Binh Duong,Thuan An,18,44,29,15,7
2022-03-30,Binh Duong,Thuan An,19,32,25,7,7
2022-03-30,Binh Duong,Thuan An,20,23,14,9,2
2022-03-30,Binh Duong,Thuan An,21,12,5,7,2
2022-03-30,Binh Duong,Thuan An,22,1,0,1,0
2022-03-30,Can Tho City,Binh Thuy District,6,1,1,0,0
2022-03-30,Can Tho City,Binh Thuy District,8,1,1,0,0
2022-03-30,Can Tho City,Binh Thuy District,9,9,8,1,0
2022-03-30,Can Tho City,Binh Thuy District,10,17,17,0,0
2022-03-30,Can Tho City,Binh Thuy District,11,13,8,5,1
2022-03-30,Can Tho City,Binh Thuy District,12,8,8,0,0
2022-03-30,Can Tho City,Binh Thuy District,13,10,10,0,0
2022-03-30,Can Tho City,Binh Thuy District,14,9,8,1,0
2022-03-30,Can Tho City,Binh Thuy District,15,9,7,2,0
2022-03-30,Can Tho City,Binh Thuy District,16,10,8,2,0
2022-03-30,Can Tho City,Binh Thuy District,17,11,11,0,0
2022-03-30,Can Tho City,Binh Thuy District,18,17,15,2,1
2022-03-30,Can Tho City,Binh Thuy District,19,16,14,2,0
2022-03-30,Can Tho City,Binh Thuy District,20,6,3,3,1
2022-03-30,Can Tho City,Binh Thuy District,21,4,2,2,0
2022-03-30,Can Tho City,Binh Thuy District,22,1,0,1,1
2022-03-30,Can Tho City,Cai Rang District,1,1,1,0,0
2022-03-30,Can Tho City,Cai Rang District,6,2,1,1,0
2022-03-30,Can Tho City,Cai Rang District,7,4,3,1,0
2022-03-30,Can Tho City,Cai Rang District,8,3,2,1,1
2022-03-30,Can Tho City,Cai Rang District,9,6,3,3,0
2022-03-30,Can Tho City,Cai Rang District,10,15,12,3,1
2022-03-30,Can Tho City,Cai Rang District,11,8,8,0,0
2022-03-30,Can Tho City,Cai Rang District,12,12,11,1,0
2022-03-30,Can Tho City,Cai Rang District,13,11,9,2,1
2022-03-30,Can Tho City,Cai Rang District,14,11,9,2,0
2022-03-30,Can Tho City,Cai Rang District,15,2,2,0,0
2022-03-30,Can Tho City,Cai Rang District,16,5,4,1,1
2022-03-30,Can Tho City,Cai Rang District,17,6,6,0,0
2022-03-30,Can Tho City,Cai Rang District,18,10,9,1,1
2022-03-30,Can Tho City,Cai Rang District,19,7,7,0,0
2022-03-30,Can Tho City,Cai Rang District,20,7,6,1,0
2022-03-30,Can Tho City,Cai Rang District,21,3,2,1,1
2022-03-30,Can Tho City,Ninh Kieu District,0,2,2,0,0
2022-03-30,Can Tho City,Ninh Kieu District,1,2,1,1,1
2022-03-30,Can Tho City,Ninh Kieu District,5,3,3,0,0
2022-03-30,Can Tho City,Ninh Kieu District,6,54,46,8,1
2022-03-30,Can Tho City,Ninh Kieu District,7,120,110,10,0
2022-03-30,Can Tho City,Ninh Kieu District,8,198,187,11,0
2022-03-30,Can Tho City,Ninh Kieu District,9,246,236,10,0
2022-03-30,Can Tho City,Ninh Kieu District,10,534,509,25,0
2022-03-30,Can Tho City,Ninh Kieu District,11,821,772,49,1
2022-03-30,Can Tho City,Ninh Kieu District,12,590,558,32,0
2022-03-30,Can Tho City,Ninh Kieu District,13,460,432,28,0
2022-03-30,Can Tho City,Ninh Kieu District,14,405,383,22,0
2022-03-30,Can Tho City,Ninh Kieu District,15,317,307,10,0
2022-03-30,Can Tho City,Ninh Kieu District,16,369,353,16,0
2022-03-30,Can Tho City,Ninh Kieu District,17,482,458,24,0
2022-03-30,Can Tho City,Ninh Kieu District,18,529,494,35,0
2022-03-30,Can Tho City,Ninh Kieu District,19,454,423,31,0
2022-03-30,Can Tho City,Ninh Kieu District,20,341,325,16,0
2022-03-30,Can Tho City,Ninh Kieu District,21,201,175,26,4
2022-03-30,Can Tho City,Ninh Kieu District,22,3,2,1,0
2022-03-30,Can Tho City,Ninh Kieu District,23,2,1,1,0
2022-03-30,Dong Nai,Bien Hoa City,0,3,2,1,0
2022-03-30,Dong Nai,Bien Hoa City,1,2,2,0,0
2022-03-30,Dong Nai,Bien Hoa City,2,1,1,0,0
2022-03-30,Dong Nai,Bien Hoa City,4,2,1,1,0
2022-03-30,Dong Nai,Bien Hoa City,5,3,1,2,0
2022-03-30,Dong Nai,Bien Hoa City,6,32,20,12,8
2022-03-30,Dong Nai,Bien Hoa City,7,118,99,19,9
2022-03-30,Dong Nai,Bien Hoa City,8,246,229,17,5
2022-03-30,Dong Nai,Bien Hoa City,9,353,318,35,6
2022-03-30,Dong Nai,Bien Hoa City,10,643,583,60,14
2022-03-30,Dong Nai,Bien Hoa City,11,1015,928,87,18
2022-03-30,Dong Nai,Bien Hoa City,12,667,606,61,10
2022-03-30,Dong Nai,Bien Hoa City,13,663,625,38,7
2022-03-30,Dong Nai,Bien Hoa City,14,601,552,49,7
2022-03-30,Dong Nai,Bien Hoa City,15,426,379,47,9
2022-03-30,Dong Nai,Bien Hoa City,16,436,402,34,5
2022-03-30,Dong Nai,Bien Hoa City,17,557,506,51,11
2022-03-30,Dong Nai,Bien Hoa City,18,606,548,58,11
2022-03-30,Dong Nai,Bien Hoa City,19,527,473,54,14
2022-03-30,Dong Nai,Bien Hoa City,20,446,364,82,45
2022-03-30,Dong Nai,Bien Hoa City,21,235,112,123,87
2022-03-30,Dong Nai,Bien Hoa City,22,4,1,3,0
2022-03-30,Dong Nai,Bien Hoa City,23,1,0,1,1
2022-03-30,Dong Nai,Long Thanh,10,3,0,3,1
2022-03-30,Dong Nai,Long Thanh,17,1,0,1,1
2022-03-30,Dong Nai,Long Thanh,18,2,0,2,2
2022-03-30,Dong Nai,Long Thanh,19,2,0,2,2
2022-03-30,Dong Nai,Nhon trach,9,1,0,1,1
2022-03-30,Dong Nai,Nhon trach,10,1,0,1,0
2022-03-30,Dong Nai,Nhon trach,11,2,0,2,2
2022-03-30,Dong Nai,Nhon trach,14,1,0,1,1
2022-03-30,Dong Nai,Nhon trach,19,1,0,1,1
2022-03-30,Dong Nai,Thong Nhat,7,1,1,0,0
2022-03-30,Dong Nai,Thong Nhat,8,1,1,0,0
2022-03-30,Dong Nai,Thong Nhat,10,4,3,1,0
2022-03-30,Dong Nai,Thong Nhat,11,1,1,0,0
2022-03-30,Dong Nai,Thong Nhat,12,2,2,0,0
2022-03-30,Dong Nai,Thong Nhat,13,1,1,0,0
2022-03-30,Dong Nai,Thong Nhat,14,1,1,0,0
2022-03-30,Dong Nai,Thong Nhat,16,1,1,0,0
2022-03-30,Dong Nai,Thong Nhat,18,1,1,0,0
2022-03-30,Dong Nai,Thong Nhat,20,2,2,0,0
2022-03-30,Dong Nai,Trang Bom,9,2,0,2,2
2022-03-30,Hai Phong City,An Duong,8,2,1,1,1
2022-03-30,Hai Phong City,An Duong,9,6,1,5,4
2022-03-30,Hai Phong City,An Duong,10,6,0,6,6
2022-03-30,Hai Phong City,An Duong,11,6,3,3,3
2022-03-30,Hai Phong City,An Duong,12,1,0,1,1
2022-03-30,Hai Phong City,An Duong,13,7,1,6,4
2022-03-30,Hai Phong City,An Duong,14,8,4,4,3
2022-03-30,Hai Phong City,An Duong,15,3,0,3,3
2022-03-30,Hai Phong City,An Duong,16,2,1,1,1
2022-03-30,Hai Phong City,An Duong,17,6,1,5,2
2022-03-30,Hai Phong City,An Duong,18,5,2,3,3
2022-03-30,Hai Phong City,An Duong,19,3,2,1,0
2022-03-30,Hai Phong City,An Duong,20,1,1,0,0
2022-03-30,Hai Phong City,An Duong,23,2,0,2,0
2022-03-30,Hai Phong City,Do Son District,14,1,0,1,1
2022-03-30,Hai Phong City,Do Son District,15,2,0,2,2
2022-03-30,Hai Phong City,Do Son District,18,1,0,1,1
2022-03-30,Hai Phong City,Do Son District,19,1,0,1,1
2022-03-30,Hai Phong City,Duong Kinh District,13,1,0,1,0
2022-03-30,Hai Phong City,Hai An District,5,1,0,1,1
2022-03-30,Hai Phong City,Hai An District,6,1,1,0,0
2022-03-30,Hai Phong City,Hai An District,7,2,2,0,0
2022-03-30,Hai Phong City,Hai An District,8,9,8,1,1
2022-03-30,Hai Phong City,Hai An District,9,12,10,2,0
2022-03-30,Hai Phong City,Hai An District,10,20,17,3,0
2022-03-30,Hai Phong City,Hai An District,11,55,49,6,0
2022-03-30,Hai Phong City,Hai An District,12,25,22,3,0
2022-03-30,Hai Phong City,Hai An District,13,14,10,4,0
2022-03-30,Hai Phong City,Hai An District,14,15,10,5,3
2022-03-30,Hai Phong City,Hai An District,15,8,6,2,0
2022-03-30,Hai Phong City,Hai An District,16,11,11,0,0
2022-03-30,Hai Phong City,Hai An District,17,14,14,0,0
2022-03-30,Hai Phong City,Hai An District,18,25,22,3,0
2022-03-30,Hai Phong City,Hai An District,19,12,11,1,0
2022-03-30,Hai Phong City,Hai An District,20,15,12,3,1
2022-03-30,Hai Phong City,Hai An District,21,12,10,2,1
2022-03-30,Hai Phong City,Hong Bang District,6,2,0,2,0
2022-03-30,Hai Phong City,Hong Bang District,7,14,11,3,1
2022-03-30,Hai Phong City,Hong Bang District,8,27,24,3,2
2022-03-30,Hai Phong City,Hong Bang District,9,20,17,3,1
2022-03-30,Hai Phong City,Hong Bang District,10,54,49,5,2
2022-03-30,Hai Phong City,Hong Bang District,11,89,74,15,6
2022-03-30,Hai Phong City,Hong Bang District,12,45,37,8,4
2022-03-30,Hai Phong City,Hong Bang District,13,35,34,1,0
2022-03-30,Hai Phong City,Hong Bang District,14,36,30,6,3
2022-03-30,Hai Phong City,Hong Bang District,15,35,32,3,0
2022-03-30,Hai Phong City,Hong Bang District,16,31,29,2,1
2022-03-30,Hai Phong City,Hong Bang District,17,27,25,2,0
2022-03-30,Hai Phong City,Hong Bang District,18,48,40,8,2
2022-03-30,Hai Phong City,Hong Bang District,19,36,29,7,0
2022-03-30,Hai Phong City,Hong Bang District,20,36,30,6,3
2022-03-30,Hai Phong City,Hong Bang District,21,14,9,5,2
2022-03-30,Hai Phong City,Kien An District,3,2,1,1,0
2022-03-30,Hai Phong City,Kien An District,7,2,1,1,1
2022-03-30,Hai Phong City,Kien An District,8,5,2,3,3
2022-03-30,Hai Phong City,Kien An District,9,6,1,5,5
2022-03-30,Hai Phong City,Kien An District,10,5,5,0,0
2022-03-30,Hai Phong City,Kien An District,11,10,8,2,2
2022-03-30,Hai Phong City,Kien An District,12,6,4,2,0
2022-03-30,Hai Phong City,Kien An District,13,11,6,5,3
2022-03-30,Hai Phong City,Kien An District,14,10,2,8,8
2022-03-30,Hai Phong City,Kien An District,15,5,3,2,2
2022-03-30,Hai Phong City,Kien An District,16,7,5,2,2
2022-03-30,Hai Phong City,Kien An District,17,6,4,2,0
2022-03-30,Hai Phong City,Kien An District,18,6,2,4,3
2022-03-30,Hai Phong City,Kien An District,19,12,5,7,5
2022-03-30,Hai Phong City,Kien An District,20,15,6,9,8
2022-03-30,Hai Phong City,Kien An District,21,4,1,3,1
2022-03-30,Hai Phong City,Le Chan District,3,2,1,1,0
2022-03-30,Hai Phong City,Le Chan District,6,2,2,0,0
2022-03-30,Hai Phong City,Le Chan District,7,18,15,3,0
2022-03-30,Hai Phong City,Le Chan District,8,48,41,7,1
2022-03-30,Hai Phong City,Le Chan District,9,65,53,12,0
2022-03-30,Hai Phong City,Le Chan District,10,164,143,21,2
2022-03-30,Hai Phong City,Le Chan District,11,269,246,23,9
2022-03-30,Hai Phong City,Le Chan District,12,160,148,12,7
2022-03-30,Hai Phong City,Le Chan District,13,79,70,9,0
2022-03-30,Hai Phong City,Le Chan District,14,123,97,26,10
2022-03-30,Hai Phong City,Le Chan District,15,107,102,5,1
2022-03-30,Hai Phong City,Le Chan District,16,102,96,6,0
2022-03-30,Hai Phong City,Le Chan District,17,158,142,16,2
2022-03-30,Hai Phong City,Le Chan District,18,173,148,25,5
2022-03-30,Hai Phong City,Le Chan District,19,155,138,17,3
2022-03-30,Hai Phong City,Le Chan District,20,120,108,12,0
2022-03-30,Hai Phong City,Le Chan District,21,51,39,12,3
2022-03-30,Hai Phong City,Le Chan District,23,1,0,1,0
2022-03-30,Hai Phong City,Ngo Quyen District,0,1,0,1,1
2022-03-30,Hai Phong City,Ngo Quyen District,2,1,0,1,0
2022-03-30,Hai Phong City,Ngo Quyen District,3,1,0,1,0
2022-03-30,Hai Phong City,Ngo Quyen District,4,2,0,2,0
2022-03-30,Hai Phong City,Ngo Quyen District,7,12,11,1,1
2022-03-30,Hai Phong City,Ngo Quyen District,8,52,44,8,6
2022-03-30,Hai Phong City,Ngo Quyen District,9,69,62,7,1
2022-03-30,Hai Phong City,Ngo Quyen District,10,117,103,14,2
2022-03-30,Hai Phong City,Ngo Quyen District,11,238,204,34,14
2022-03-30,Hai Phong City,Ngo Quyen District,12,143,127,16,3
2022-03-30,Hai Phong City,Ngo Quyen District,13,84,77,7,1
2022-03-30,Hai Phong City,Ngo Quyen District,14,138,104,34,20
2022-03-30,Hai Phong City,Ngo Quyen District,15,134,120,14,3
2022-03-30,Hai Phong City,Ngo Quyen District,16,94,83,11,0
2022-03-30,Hai Phong City,Ngo Quyen District,17,131,119,12,2
2022-03-30,Hai Phong City,Ngo Quyen District,18,155,141,14,1
2022-03-30,Hai Phong City,Ngo Quyen District,19,150,133,17,1
2022-03-30,Hai Phong City,Ngo Quyen District,20,117,100,17,2
2022-03-30,Hai Phong City,Ngo Quyen District,21,61,43,18,9
2022-03-30,Hai Phong City,Ngo Quyen District,22,2,2,0,0
2022-03-30,Hai Phong City,Thuy Nguyen,9,3,0,3,1
2022-03-30,Hai Phong City,Thuy Nguyen,10,1,0,1,1
2022-03-30,Hai Phong City,Thuy Nguyen,12,1,0,1,1
2022-03-30,Hai Phong City,Thuy Nguyen,13,3,0,3,3
2022-03-30,Hai Phong City,Thuy Nguyen,14,2,0,2,2
2022-03-30,Hai Phong City,Thuy Nguyen,15,1,0,1,1
2022-03-30,Hai Phong City,Thuy Nguyen,17,1,0,1,1
2022-03-30,Hai Phong City,Thuy Nguyen,18,6,0,6,5
2022-03-30,Hai Phong City,Thuy Nguyen,19,2,2,0,0
2022-03-30,Hue City,Hue City,0,7,3,4,0
2022-03-30,Hue City,Hue City,1,2,2,0,0
2022-03-30,Hue City,Hue City,2,1,0,1,0
2022-03-30,Hue City,Hue City,3,2,2,0,0
2022-03-30,Hue City,Hue City,5,5,5,0,0
2022-03-30,Hue City,Hue City,6,61,51,10,0
2022-03-30,Hue City,Hue City,7,178,164,14,0
2022-03-30,Hue City,Hue City,8,261,248,13,0
2022-03-30,Hue City,Hue City,9,208,188,20,3
2022-03-30,Hue City,Hue City,10,367,342,25,0
2022-03-30,Hue City,Hue City,11,797,736,61,5
2022-03-30,Hue City,Hue City,12,442,419,23,0
2022-03-30,Hue City,Hue City,13,282,254,28,2
2022-03-30,Hue City,Hue City,14,340,317,23,1
2022-03-30,Hue City,Hue City,15,340,316,24,2
2022-03-30,Hue City,Hue City,16,392,362,30,3
2022-03-30,Hue City,Hue City,17,618,577,41,2
2022-03-30,Hue City,Hue City,18,704,650,54,0
2022-03-30,Hue City,Hue City,19,592,546,46,3
2022-03-30,Hue City,Hue City,20,416,372,44,3
2022-03-30,Hue City,Hue City,21,215,193,22,2
2022-03-30,Hue City,Hue City,22,3,0,3,0
2022-03-30,Hue City,Hue City,23,1,1,0,0
2022-03-30,Hue City,Huong Thuy,9,1,0,1,0
2022-03-30,Hue City,Huong Thuy,10,1,1,0,0
2022-03-30,Hue City,Huong Thuy,14,1,1,0,0
2022-03-30,Hue City,Huong Thuy,17,1,1,0,0
2022-03-30,Hue City,Huong Thuy,18,2,1,1,0
2022-03-30,Hue City,Huong Thuy,19,1,0,1,1
2022-03-30,Hue City,Huong Tra,12,1,1,0,0
2022-03-30,Hue City,Huong Tra,13,1,1,0,0
2022-03-30,Hue City,Huong Tra,19,1,0,1,1
2022-03-30,Hue City,Phu Vang,6,1,1,0,0
2022-03-30,Hue City,Phu Vang,7,1,0,1,1
2022-03-30,Hue City,Phu Vang,8,2,0,2,2
2022-03-30,Hue City,Phu Vang,9,1,1,0,0
2022-03-30,Hue City,Phu Vang,10,1,1,0,0
2022-03-30,Hue City,Phu Vang,11,1,1,0,0
2022-03-30,Hue City,Phu Vang,12,2,1,1,0
2022-03-30,Hue City,Phu Vang,14,2,2,0,0
2022-03-30,Hue City,Phu Vang,15,1,0,1,1
2022-03-30,Hue City,Phu Vang,16,1,1,0,0
2022-03-30,Hue City,Phu Vang,17,1,1,0,0
2022-03-30,Hue City,Phu Vang,18,1,0,1,1
2022-03-30,Hue City,Phu Vang,19,2,1,1,0
2022-03-30,Hue City,Phu Vang,20,2,0,2,0
2022-03-30,Hue City,Phu Vang,22,1,0,1,1
2022-03-30,Vung Tau,Ba Ria City,7,2,0,2,2
2022-03-30,Vung Tau,Ba Ria City,8,7,4,3,3
2022-03-30,Vung Tau,Ba Ria City,9,4,3,1,0
2022-03-30,Vung Tau,Ba Ria City,10,1,1,0,0
2022-03-30,Vung Tau,Ba Ria City,11,1,1,0,0
2022-03-30,Vung Tau,Ba Ria City,12,4,4,0,0
2022-03-30,Vung Tau,Ba Ria City,13,3,3,0,0
2022-03-30,Vung Tau,Ba Ria City,14,1,1,0,0
2022-03-30,Vung Tau,Ba Ria City,15,1,1,0,0
2022-03-30,Vung Tau,Ba Ria City,16,2,2,0,0
2022-03-30,Vung Tau,Ba Ria City,17,3,3,0,0
2022-03-30,Vung Tau,Ba Ria City,18,6,2,4,4
2022-03-30,Vung Tau,Ba Ria City,19,1,1,0,0
2022-03-30,Vung Tau,Ba Ria City,20,11,0,11,11
2022-03-30,Vung Tau,Ba Ria City,21,1,0,1,1
2022-03-30,Vung Tau,Vung Tau City,3,2,0,2,0
2022-03-30,Vung Tau,Vung Tau City,4,1,1,0,0
2022-03-30,Vung Tau,Vung Tau City,5,2,1,1,0
2022-03-30,Vung Tau,Vung Tau City,6,23,18,5,5
2022-03-30,Vung Tau,Vung Tau City,7,82,76,6,1
2022-03-30,Vung Tau,Vung Tau City,8,145,136,9,1
2022-03-30,Vung Tau,Vung Tau City,9,130,113,17,1
2022-03-30,Vung Tau,Vung Tau City,10,166,149,17,3
2022-03-30,Vung Tau,Vung Tau City,11,312,285,27,3
2022-03-30,Vung Tau,Vung Tau City,12,237,218,19,0
2022-03-30,Vung Tau,Vung Tau City,13,176,159,17,2
2022-03-30,Vung Tau,Vung Tau City,14,221,201,20,3
2022-03-30,Vung Tau,Vung Tau City,15,178,163,15,1
2022-03-30,Vung Tau,Vung Tau City,16,162,151,11,1
2022-03-30,Vung Tau,Vung Tau City,17,230,213,17,2
2022-03-30,Vung Tau,Vung Tau City,18,289,270,19,2
2022-03-30,Vung Tau,Vung Tau City,19,262,196,66,34
2022-03-30,Vung Tau,Vung Tau City,20,215,25,190,170
2022-03-30,Vung Tau,Vung Tau City,21,216,15,201,169
2022-03-30,Vung Tau,Vung Tau City,22,1,0,1,0
2022-03-30,Vung Tau,Vung Tau City,23,2,1,1,1
2022-03-31,Binh Duong,Ben Cat,10,3,1,2,2
2022-03-31,Binh Duong,Ben Cat,12,1,0,1,1
2022-03-31,Binh Duong,Ben Cat,15,2,0,2,2
2022-03-31,Binh Duong,Ben Cat,16,2,0,2,1
2022-03-31,Binh Duong,Ben Cat,17,2,1,1,1
2022-03-31,Binh Duong,Ben Cat,19,2,0,2,2
2022-03-31,Binh Duong,Ben Cat,20,2,1,1,1
2022-03-31,Binh Duong,Di An,6,2,0,2,2
2022-03-31,Binh Duong,Di An,7,8,0,8,4
2022-03-31,Binh Duong,Di An,8,11,6,5,3
2022-03-31,Binh Duong,Di An,9,13,8,5,4
2022-03-31,Binh Duong,Di An,10,28,16,12,11
2022-03-31,Binh Duong,Di An,11,43,24,19,11
2022-03-31,Binh Duong,Di An,12,32,20,12,7
2022-03-31,Binh Duong,Di An,13,18,13,5,3
2022-03-31,Binh Duong,Di An,14,8,7,1,0
2022-03-31,Binh Duong,Di An,15,10,5,5,5
2022-03-31,Binh Duong,Di An,16,17,6,11,8
2022-03-31,Binh Duong,Di An,17,16,9,7,7
2022-03-31,Binh Duong,Di An,18,20,14,6,4
2022-03-31,Binh Duong,Di An,19,16,9,7,5
2022-03-31,Binh Duong,Di An,20,10,1,9,9
2022-03-31,Binh Duong,Di An,21,7,0,7,4
2022-03-31,Binh Duong,Di An,22,1,0,1,1
2022-03-31,Binh Duong,Tan Uyen,8,2,0,2,2
2022-03-31,Binh Duong,Tan Uyen,10,2,1,1,1
2022-03-31,Binh Duong,Tan Uyen,11,6,2,4,3
2022-03-31,Binh Duong,Tan Uyen,13,1,0,1,0
2022-03-31,Binh Duong,Tan Uyen,14,3,1,2,2
2022-03-31,Binh Duong,Tan Uyen,15,3,1,2,0
2022-03-31,Binh Duong,Tan Uyen,16,3,1,2,2
2022-03-31,Binh Duong,Tan Uyen,17,5,2,3,3
2022-03-31,Binh Duong,Tan Uyen,18,2,2,0,0
2022-03-31,Binh Duong,Tan Uyen,19,1,1,0,0
2022-03-31,Binh Duong,Tan Uyen,21,2,0,2,2
2022-03-31,Binh Duong,Thu Dau Mot Town,0,1,0,1,1
2022-03-31,Binh Duong,Thu Dau Mot Town,1,1,1,0,0
2022-03-31,Binh Duong,Thu Dau Mot Town,5,1,1,0,0
2022-03-31,Binh Duong,Thu Dau Mot Town,6,26,21,5,3
2022-03-31,Binh Duong,Thu Dau Mot Town,7,84,73,11,7
2022-03-31,Binh Duong,Thu Dau Mot Town,8,168,160,8,0
2022-03-31,Binh Duong,Thu Dau Mot Town,9,201,187,14,0
2022-03-31,Binh Duong,Thu Dau Mot Town,10,369,351,18,3
2022-03-31,Binh Duong,Thu Dau Mot Town,11,567,537,30,7
2022-03-31,Binh Duong,Thu Dau Mot Town,12,369,344,25,3
2022-03-31,Binh Duong,Thu Dau Mot Town,13,335,321,14,0
2022-03-31,Binh Duong,Thu Dau Mot Town,14,268,255,13,0
2022-03-31,Binh Duong,Thu Dau Mot Town,15,232,216,16,3
2022-03-31,Binh Duong,Thu Dau Mot Town,16,213,187,26,3
2022-03-31,Binh Duong,Thu Dau Mot Town,17,301,290,11,3
2022-03-31,Binh Duong,Thu Dau Mot Town,18,327,306,21,3
2022-03-31,Binh Duong,Thu Dau Mot Town,19,311,294,17,0
2022-03-31,Binh Duong,Thu Dau Mot Town,20,198,178,20,4
2022-03-31,Binh Duong,Thu Dau Mot Town,21,93,79,14,3
2022-03-31,Binh Duong,Thu Dau Mot Town,22,3,2,1,0
2022-03-31,Binh Duong,Thu Dau Mot Town,23,2,0,2,0
2022-03-31,Binh Duong,Thuan An,6,1,0,1,0
2022-03-31,Binh Duong,Thuan An,7,8,1,7,3
2022-03-31,Binh Duong,Thuan An,8,21,14,7,6
2022-03-31,Binh Duong,Thuan An,9,24,15,9,4
2022-03-31,Binh Duong,Thuan An,10,44,33,11,8
2022-03-31,Binh Duong,Thuan An,11,72,46,26,20
2022-03-31,Binh Duong,Thuan An,12,68,45,23,14
2022-03-31,Binh Duong,Thuan An,13,64,36,28,19
2022-03-31,Binh Duong,Thuan An,14,36,21,15,10
2022-03-31,Binh Duong,Thuan An,15,26,19,7,6
2022-03-31,Binh Duong,Thuan An,16,18,11,7,3
2022-03-31,Binh Duong,Thuan An,17,26,23,3,2
2022-03-31,Binh Duong,Thuan An,18,40,35,5,2
2022-03-31,Binh Duong,Thuan An,19,32,19,13,6
2022-03-31,Binh Duong,Thuan An,20,24,12,12,10
2022-03-31,Binh Duong,Thuan An,21,15,5,10,4
2022-03-31,Binh Duong,Thuan An,22,1,0,1,0
2022-03-31,Can Tho City,Binh Thuy District,7,2,1,1,0
2022-03-31,Can Tho City,Binh Thuy District,8,5,4,1,0
2022-03-31,Can Tho City,Binh Thuy District,9,4,3,1,0
2022-03-31,Can Tho City,Binh Thuy District,10,9,8,1,0
2022-03-31,Can Tho City,Binh Thuy District,11,18,13,5,0
2022-03-31,Can Tho City,Binh Thuy District,12,7,6,1,0
2022-03-31,Can Tho City,Binh Thuy District,13,14,14,0,0
2022-03-31,Can Tho City,Binh Thuy District,14,8,7,1,0
2022-03-31,Can Tho City,Binh Thuy District,15,8,7,1,0
2022-03-31,Can Tho City,Binh Thuy District,16,10,8,2,2
2022-03-31,Can Tho City,Binh Thuy District,17,14,12,2,0
2022-03-31,Can Tho City,Binh Thuy District,18,14,14,0,0
2022-03-31,Can Tho City,Binh Thuy District,19,18,16,2,0
2022-03-31,Can Tho City,Binh Thuy District,20,11,10,1,0
2022-03-31,Can Tho City,Binh Thuy District,21,2,1,1,1
2022-03-31,Can Tho City,Cai Rang District,6,1,1,0,0
2022-03-31,Can Tho City,Cai Rang District,7,2,2,0,0
2022-03-31,Can Tho City,Cai Rang District,8,2,2,0,0
2022-03-31,Can Tho City,Cai Rang District,9,4,4,0,0
2022-03-31,Can Tho City,Cai Rang District,10,11,10,1,0
2022-03-31,Can Tho City,Cai Rang District,11,10,8,2,1
2022-03-31,Can Tho City,Cai Rang District,12,11,10,1,0
2022-03-31,Can Tho City,Cai Rang District,13,11,9,2,2
2022-03-31,Can Tho City,Cai Rang District,14,6,5,1,0
2022-03-31,Can Tho City,Cai Rang District,15,8,8,0,0
2022-03-31,Can Tho City,Cai Rang District,16,6,5,1,1
2022-03-31,Can Tho City,Cai Rang District,17,6,5,1,0
2022-03-31,Can Tho City,Cai Rang District,18,13,13,0,0
2022-03-31,Can Tho City,Cai Rang District,19,7,6,1,0
2022-03-31,Can Tho City,Cai Rang District,20,9,8,1,0
2022-03-31,Can Tho City,Cai Rang District,21,2,0,2,2
2022-03-31,Can Tho City,Ninh Kieu District,0,4,2,2,0
2022-03-31,Can Tho City,Ninh Kieu District,3,3,0,3,0
2022-03-31,Can Tho City,Ninh Kieu District,4,1,1,0,0
2022-03-31,Can Tho City,Ninh Kieu District,5,5,4,1,0
2022-03-31,Can Tho City,Ninh Kieu District,6,39,34,5,1
2022-03-31,Can Tho City,Ninh Kieu District,7,143,131,12,3
2022-03-31,Can Tho City,Ninh Kieu District,8,218,204,14,0
2022-03-31,Can Tho City,Ninh Kieu District,9,282,265,17,1
2022-03-31,Can Tho City,Ninh Kieu District,10,573,551,22,0
2022-03-31,Can Tho City,Ninh Kieu District,11,847,809,38,1
2022-03-31,Can Tho City,Ninh Kieu District,12,539,510,29,0
2022-03-31,Can Tho City,Ninh Kieu District,13,423,401,22,0
2022-03-31,Can Tho City,Ninh Kieu District,14,345,330,15,0
2022-03-31,Can Tho City,Ninh Kieu District,15,306,295,11,0
2022-03-31,Can Tho City,Ninh Kieu District,16,285,261,24,0
2022-03-31,Can Tho City,Ninh Kieu District,17,616,565,51,6
2022-03-31,Can Tho City,Ninh Kieu District,18,582,540,42,2
2022-03-31,Can Tho City,Ninh Kieu District,19,448,421,27,1
2022-03-31,Can Tho City,Ninh Kieu District,20,349,317,32,0
2022-03-31,Can Tho City,Ninh Kieu District,21,139,131,8,0
2022-03-31,Can Tho City,Ninh Kieu District,22,5,5,0,0
2022-03-31,Can Tho City,Ninh Kieu District,23,2,2,0,0
2022-03-31,Dong Nai,Bien Hoa City,1,2,1,1,1
2022-03-31,Dong Nai,Bien Hoa City,3,4,3,1,0
2022-03-31,Dong Nai,Bien Hoa City,5,1,1,0,0
2022-03-31,Dong Nai,Bien Hoa City,6,39,24,15,12
2022-03-31,Dong Nai,Bien Hoa City,7,152,121,31,14
2022-03-31,Dong Nai,Bien Hoa City,8,294,257,37,15
2022-03-31,Dong Nai,Bien Hoa City,9,360,321,39,6
2022-03-31,Dong Nai,Bien Hoa City,10,680,601,79,13
2022-03-31,Dong Nai,Bien Hoa City,11,936,849,87,26
2022-03-31,Dong Nai,Bien Hoa City,12,729,668,61,11
2022-03-31,Dong Nai,Bien Hoa City,13,681,634,47,11
2022-03-31,Dong Nai,Bien Hoa City,14,536,498,38,9
2022-03-31,Dong Nai,Bien Hoa City,15,426,374,52,18
2022-03-31,Dong Nai,Bien Hoa City,16,447,388,59,25
2022-03-31,Dong Nai,Bien Hoa City,17,625,536,89,43
2022-03-31,Dong Nai,Bien Hoa City,18,578,521,57,16
2022-03-31,Dong Nai,Bien Hoa City,19,524,473,51,10
2022-03-31,Dong Nai,Bien Hoa City,20,409,340,69,25
2022-03-31,Dong Nai,Bien Hoa City,21,172,126,46,19
2022-03-31,Dong Nai,Bien Hoa City,22,2,1,1,0
2022-03-31,Dong Nai,Cam My,12,1,0,1,1
2022-03-31,Dong Nai,Long Thanh,11,2,0,2,2
2022-03-31,Dong Nai,Long Thanh,12,2,0,2,2
2022-03-31,Dong Nai,Long Thanh,13,1,0,1,1
2022-03-31,Dong Nai,Long Thanh,15,1,0,1,1
2022-03-31,Dong Nai,Long Thanh,17,1,0,1,1
2022-03-31,Dong Nai,Nhon trach,10,1,0,1,1
2022-03-31,Dong Nai,Nhon trach,19,2,0,2,2
2022-03-31,Dong Nai,Thong Nhat,10,1,1,0,0
2022-03-31,Dong Nai,Thong Nhat,11,3,3,0,0
2022-03-31,Dong Nai,Thong Nhat,12,2,2,0,0
2022-03-31,Dong Nai,Thong Nhat,13,3,3,0,0
2022-03-31,Dong Nai,Thong Nhat,14,1,1,0,0
2022-03-31,Dong Nai,Thong Nhat,16,1,1,0,0
2022-03-31,Dong Nai,Thong Nhat,21,1,1,0,0
2022-03-31,Hai Phong City,An Duong,6,4,0,4,2
2022-03-31,Hai Phong City,An Duong,7,1,0,1,1
2022-03-31,Hai Phong City,An Duong,8,5,3,2,2
2022-03-31,Hai Phong City,An Duong,9,5,2,3,3
2022-03-31,Hai Phong City,An Duong,10,6,2,4,4
2022-03-31,Hai Phong City,An Duong,11,7,4,3,3
2022-03-31,Hai Phong City,An Duong,12,6,1,5,5
2022-03-31,Hai Phong City,An Duong,13,3,1,2,2
2022-03-31,Hai Phong City,An Duong,14,6,1,5,5
2022-03-31,Hai Phong City,An Duong,15,8,3,5,4
2022-03-31,Hai Phong City,An Duong,16,5,3,2,1
2022-03-31,Hai Phong City,An Duong,17,8,3,5,3
2022-03-31,Hai Phong City,An Duong,18,4,0,4,3
2022-03-31,Hai Phong City,An Duong,19,4,0,4,3
2022-03-31,Hai Phong City,An Duong,20,3,0,3,3
2022-03-31,Hai Phong City,An Duong,21,2,0,2,1
2022-03-31,Hai Phong City,Duong Kinh District,15,1,1,0,0
2022-03-31,Hai Phong City,Duong Kinh District,20,1,0,1,1
2022-03-31,Hai Phong City,Hai An District,7,6,5,1,0
2022-03-31,Hai Phong City,Hai An District,8,8,8,0,0
2022-03-31,Hai Phong City,Hai An District,9,4,4,0,0
2022-03-31,Hai Phong City,Hai An District,10,23,18,5,1
2022-03-31,Hai Phong City,Hai An District,11,37,29,8,4
2022-03-31,Hai Phong City,Hai An District,12,22,19,3,2
2022-03-31,Hai Phong City,Hai An District,13,16,15,1,1
2022-03-31,Hai Phong City,Hai An District,14,14,12,2,2
2022-03-31,Hai Phong City,Hai An District,15,23,20,3,1
2022-03-31,Hai Phong City,Hai An District,16,10,9,1,0
2022-03-31,Hai Phong City,Hai An District,17,14,12,2,1
2022-03-31,Hai Phong City,Hai An District,18,32,29,3,1
2022-03-31,Hai Phong City,Hai An District,19,15,14,1,0
2022-03-31,Hai Phong City,Hai An District,20,15,15,0,0
2022-03-31,Hai Phong City,Hai An District,21,11,5,6,5
2022-03-31,Hai Phong City,Hong Bang District,0,1,0,1,0
2022-03-31,Hai Phong City,Hong Bang District,1,1,0,1,0
2022-03-31,Hai Phong City,Hong Bang District,7,10,7,3,1
2022-03-31,Hai Phong City,Hong Bang District,8,33,27,6,1
2022-03-31,Hai Phong City,Hong Bang District,9,25,22,3,2
2022-03-31,Hai Phong City,Hong Bang District,10,65,52,13,9
2022-03-31,Hai Phong City,Hong Bang District,11,100,90,10,6
2022-03-31,Hai Phong City,Hong Bang District,12,57,47,10,3
2022-03-31,Hai Phong City,Hong Bang District,13,27,24,3,0
2022-03-31,Hai Phong City,Hong Bang District,14,51,44,7,3
2022-03-31,Hai Phong City,Hong Bang District,15,46,39,7,0
2022-03-31,Hai Phong City,Hong Bang District,16,23,19,4,0
2022-03-31,Hai Phong City,Hong Bang District,17,36,32,4,0
2022-03-31,Hai Phong City,Hong Bang District,18,39,32,7,1
2022-03-31,Hai Phong City,Hong Bang District,19,44,36,8,4
2022-03-31,Hai Phong City,Hong Bang District,20,33,26,7,1
2022-03-31,Hai Phong City,Hong Bang District,21,15,8,7,7
2022-03-31,Hai Phong City,Kien An District,7,2,1,1,1
2022-03-31,Hai Phong City,Kien An District,9,7,2,5,3
2022-03-31,Hai Phong City,Kien An District,10,12,6,6,1
2022-03-31,Hai Phong City,Kien An District,11,11,7,4,4
2022-03-31,Hai Phong City,Kien An District,12,3,2,1,1
2022-03-31,Hai Phong City,Kien An District,13,9,5,4,3
2022-03-31,Hai Phong City,Kien An District,14,5,4,1,1
2022-03-31,Hai Phong City,Kien An District,15,11,6,5,1
2022-03-31,Hai Phong City,Kien An District,16,3,3,0,0
2022-03-31,Hai Phong City,Kien An District,17,4,4,0,0
2022-03-31,Hai Phong City,Kien An District,18,8,8,0,0
2022-03-31,Hai Phong City,Kien An District,19,6,2,4,3
2022-03-31,Hai Phong City,Kien An District,20,8,4,4,2
2022-03-31,Hai Phong City,Kien An District,21,6,1,5,4
2022-03-31,Hai Phong City,Le Chan District,2,1,1,0,0
2022-03-31,Hai Phong City,Le Chan District,6,3,1,2,0
2022-03-31,Hai Phong City,Le Chan District,7,31,28,3,1
2022-03-31,Hai Phong City,Le Chan District,8,50,47,3,0
2022-03-31,Hai Phong City,Le Chan District,9,58,52,6,3
2022-03-31,Hai Phong City,Le Chan District,10,134,118,16,3
2022-03-31,Hai Phong City,Le Chan District,11,245,223,22,9
2022-03-31,Hai Phong City,Le Chan District,12,199,183,16,4
2022-03-31,Hai Phong City,Le Chan District,13,87,83,4,2
2022-03-31,Hai Phong City,Le Chan District,14,136,112,24,11
2022-03-31,Hai Phong City,Le Chan District,15,123,109,14,5
2022-03-31,Hai Phong City,Le Chan District,16,113,101,12,0
2022-03-31,Hai Phong City,Le Chan District,17,138,125,13,1
2022-03-31,Hai Phong City,Le Chan District,18,180,161,19,3
2022-03-31,Hai Phong City,Le Chan District,19,176,155,21,1
2022-03-31,Hai Phong City,Le Chan District,20,108,94,14,2
2022-03-31,Hai Phong City,Le Chan District,21,53,40,13,6
2022-03-31,Hai Phong City,Le Chan District,22,2,0,2,0
2022-03-31,Hai Phong City,Le Chan District,23,2,2,0,0
2022-03-31,Hai Phong City,Ngo Quyen District,2,1,1,0,0
2022-03-31,Hai Phong City,Ngo Quyen District,5,1,1,0,0
2022-03-31,Hai Phong City,Ngo Quyen District,6,2,1,1,0
2022-03-31,Hai Phong City,Ngo Quyen District,7,25,16,9,0
2022-03-31,Hai Phong City,Ngo Quyen District,8,64,61,3,0
2022-03-31,Hai Phong City,Ngo Quyen District,9,61,57,4,0
2022-03-31,Hai Phong City,Ngo Quyen District,10,106,90,16,5
2022-03-31,Hai Phong City,Ngo Quyen District,11,241,218,23,9
2022-03-31,Hai Phong City,Ngo Quyen District,12,161,144,17,7
2022-03-31,Hai Phong City,Ngo Quyen District,13,79,75,4,0
2022-03-31,Hai Phong City,Ngo Quyen District,14,128,111,17,5
2022-03-31,Hai Phong City,Ngo Quyen District,15,121,105,16,0
2022-03-31,Hai Phong City,Ngo Quyen District,16,91,80,11,1
2022-03-31,Hai Phong City,Ngo Quyen District,17,105,101,4,0
2022-03-31,Hai Phong City,Ngo Quyen District,18,149,128,21,2
2022-03-31,Hai Phong City,Ngo Quyen District,19,145,136,9,0
2022-03-31,Hai Phong City,Ngo Quyen District,20,105,98,7,1
2022-03-31,Hai Phong City,Ngo Quyen District,21,57,50,7,3
2022-03-31,Hai Phong City,Thuy Nguyen,5,1,1,0,0
2022-03-31,Hai Phong City,Thuy Nguyen,12,1,0,1,1
2022-03-31,Hai Phong City,Thuy Nguyen,13,1,0,1,1
2022-03-31,Hai Phong City,Thuy Nguyen,14,1,0,1,1
2022-03-31,Hai Phong City,Thuy Nguyen,15,2,0,2,1
2022-03-31,Hai Phong City,Thuy Nguyen,17,2,1,1,1
2022-03-31,Hai Phong City,Thuy Nguyen,18,1,0,1,1
2022-03-31,Hai Phong City,Thuy Nguyen,22,1,0,1,1
2022-03-31,Hue City,Hue City,0,1,1,0,0
2022-03-31,Hue City,Hue City,1,3,2,1,0
2022-03-31,Hue City,Hue City,5,2,2,0,0
2022-03-31,Hue City,Hue City,6,59,53,6,1
2022-03-31,Hue City,Hue City,7,229,213,16,1
2022-03-31,Hue City,Hue City,8,377,351,26,0
2022-03-31,Hue City,Hue City,9,291,272,19,0
2022-03-31,Hue City,Hue City,10,476,443,33,4
2022-03-31,Hue City,Hue City,11,915,824,91,10
2022-03-31,Hue City,Hue City,12,504,470,34,0
2022-03-31,Hue City,Hue City,13,286,259,27,1
2022-03-31,Hue City,Hue City,14,356,329,27,2
2022-03-31,Hue City,Hue City,15,428,395,33,1
2022-03-31,Hue City,Hue City,16,391,353,38,3
2022-03-31,Hue City,Hue City,17,621,558,63,1
2022-03-31,Hue City,Hue City,18,818,710,108,36
2022-03-31,Hue City,Hue City,19,801,660,141,28
2022-03-31,Hue City,Hue City,20,578,464,114,21
2022-03-31,Hue City,Hue City,21,239,199,40,2
2022-03-31,Hue City,Hue City,22,2,0,2,0
2022-03-31,Hue City,Hue City,23,4,2,2,0
2022-03-31,Hue City,Huong Thuy,9,3,3,0,0
2022-03-31,Hue City,Huong Thuy,11,3,3,0,0
2022-03-31,Hue City,Huong Thuy,17,1,1,0,0
2022-03-31,Hue City,Huong Thuy,18,1,0,1,0
2022-03-31,Hue City,Huong Thuy,19,2,2,0,0
2022-03-31,Hue City,Huong Thuy,20,1,0,1,1
2022-03-31,Hue City,Huong Thuy,21,5,0,5,1
2022-03-31,Hue City,Huong Tra,10,1,1,0,0
2022-03-31,Hue City,Huong Tra,14,1,0,1,0
2022-03-31,Hue City,Huong Tra,16,1,1,0,0
2022-03-31,Hue City,Phu Vang,8,3,2,1,1
2022-03-31,Hue City,Phu Vang,9,2,2,0,0
2022-03-31,Hue City,Phu Vang,11,3,3,0,0
2022-03-31,Hue City,Phu Vang,12,1,0,1,0
2022-03-31,Hue City,Phu Vang,13,1,0,1,1
2022-03-31,Hue City,Phu Vang,14,2,2,0,0
2022-03-31,Hue City,Phu Vang,15,1,1,0,0
2022-03-31,Hue City,Phu Vang,17,1,1,0,0
2022-03-31,Hue City,Phu Vang,18,2,1,1,1
2022-03-31,Hue City,Phu Vang,19,3,2,1,1
2022-03-31,Hue City,Phu Vang,20,4,2,2,0
2022-03-31,Vung Tau,Ba Ria City,7,1,0,1,1
2022-03-31,Vung Tau,Ba Ria City,8,4,3,1,1
2022-03-31,Vung Tau,Ba Ria City,9,3,3,0,0
2022-03-31,Vung Tau,Ba Ria City,10,10,6,4,1
2022-03-31,Vung Tau,Ba Ria City,11,7,6,1,0
2022-03-31,Vung Tau,Ba Ria City,12,6,5,1,0
2022-03-31,Vung Tau,Ba Ria City,13,6,4,2,0
2022-03-31,Vung Tau,Ba Ria City,14,7,4,3,3
2022-03-31,Vung Tau,Ba Ria City,15,2,2,0,0
2022-03-31,Vung Tau,Ba Ria City,17,1,1,0,0
2022-03-31,Vung Tau,Ba Ria City,18,2,1,1,1
2022-03-31,Vung Tau,Ba Ria City,19,3,0,3,3
2022-03-31,Vung Tau,Ba Ria City,20,2,0,2,1
2022-03-31,Vung Tau,Vung Tau City,3,1,1,0,0
2022-03-31,Vung Tau,Vung Tau City,6,37,29,8,8
2022-03-31,Vung Tau,Vung Tau City,7,97,81,16,0
2022-03-31,Vung Tau,Vung Tau City,8,163,151,12,1
2022-03-31,Vung Tau,Vung Tau City,9,129,113,16,1
2022-03-31,Vung Tau,Vung Tau City,10,149,139,10,1
2022-03-31,Vung Tau,Vung Tau City,11,310,283,27,0
2022-03-31,Vung Tau,Vung Tau City,12,238,223,15,0
2022-03-31,Vung Tau,Vung Tau City,13,181,169,12,0
2022-03-31,Vung Tau,Vung Tau City,14,207,194,13,3
2022-03-31,Vung Tau,Vung Tau City,15,178,163,15,1
2022-03-31,Vung Tau,Vung Tau City,16,150,139,11,0
2022-03-31,Vung Tau,Vung Tau City,17,256,240,16,2
2022-03-31,Vung Tau,Vung Tau City,18,250,228,22,1
2022-03-31,Vung Tau,Vung Tau City,19,211,196,15,2
2022-03-31,Vung Tau,Vung Tau City,20,169,153,16,2
2022-03-31,Vung Tau,Vung Tau City,21,85,65,20,6
2022-03-31,Vung Tau,Vung Tau City,22,2,0,2,1
2022-03-31,Vung Tau,Vung Tau City,23,1,0,1,0
2022-04-01,Binh Duong,Ben Cat,11,3,0,3,2
2022-04-01,Binh Duong,Ben Cat,13,2,0,2,2
2022-04-01,Binh Duong,Ben Cat,14,2,0,2,1
2022-04-01,Binh Duong,Ben Cat,15,1,0,1,1
2022-04-01,Binh Duong,Ben Cat,19,1,0,1,1
2022-04-01,Binh Duong,Ben Cat,21,1,0,1,1
2022-04-01,Binh Duong,Di An,6,1,0,1,1
2022-04-01,Binh Duong,Di An,7,9,1,8,7
2022-04-01,Binh Duong,Di An,8,16,6,10,7
2022-04-01,Binh Duong,Di An,9,17,6,11,9
2022-04-01,Binh Duong,Di An,10,22,13,9,5
2022-04-01,Binh Duong,Di An,11,32,18,14,12
2022-04-01,Binh Duong,Di An,12,40,15,25,19
2022-04-01,Binh Duong,Di An,13,25,18,7,3
2022-04-01,Binh Duong,Di An,14,27,13,14,9
2022-04-01,Binh Duong,Di An,15,23,10,13,10
2022-04-01,Binh Duong,Di An,16,11,9,2,2
2022-04-01,Binh Duong,Di An,17,10,7,3,1
2022-04-01,Binh Duong,Di An,18,13,8,5,4
2022-04-01,Binh Duong,Di An,19,16,9,7,3
2022-04-01,Binh Duong,Di An,20,11,4,7,4
2022-04-01,Binh Duong,Di An,21,6,0,6,5
2022-04-01,Binh Duong,Di An,22,1,0,1,1
2022-04-01,Binh Duong,Tan Uyen,8,1,0,1,1
2022-04-01,Binh Duong,Tan Uyen,9,3,0,3,3
2022-04-01,Binh Duong,Tan Uyen,10,10,1,9,4
2022-04-01,Binh Duong,Tan Uyen,11,1,1,0,0
2022-04-01,Binh Duong,Tan Uyen,12,1,1,0,0
2022-04-01,Binh Duong,Tan Uyen,13,1,0,1,1
2022-04-01,Binh Duong,Tan Uyen,14,1,1,0,0
2022-04-01,Binh Duong,Tan Uyen,15,1,1,0,0
2022-04-01,Binh Duong,Tan Uyen,17,2,1,1,1
2022-04-01,Binh Duong,Tan Uyen,18,1,1,0,0
2022-04-01,Binh Duong,Tan Uyen,20,1,0,1,1
2022-04-01,Binh Duong,Thu Dau Mot Town,2,1,1,0,0
2022-04-01,Binh Duong,Thu Dau Mot Town,6,24,18,6,5
2022-04-01,Binh Duong,Thu Dau Mot Town,7,81,76,5,1
2022-04-01,Binh Duong,Thu Dau Mot Town,8,173,156,17,2
2022-04-01,Binh Duong,Thu Dau Mot Town,9,208,192,16,3
2022-04-01,Binh Duong,Thu Dau Mot Town,10,360,333,27,8
2022-04-01,Binh Duong,Thu Dau Mot Town,11,578,542,36,3
2022-04-01,Binh Duong,Thu Dau Mot Town,12,405,373,32,2
2022-04-01,Binh Duong,Thu Dau Mot Town,13,390,370,20,1
2022-04-01,Binh Duong,Thu Dau Mot Town,14,309,295,14,0
2022-04-01,Binh Duong,Thu Dau Mot Town,15,250,232,18,2
2022-04-01,Binh Duong,Thu Dau Mot Town,16,242,235,7,0
2022-04-01,Binh Duong,Thu Dau Mot Town,17,351,332,19,2
2022-04-01,Binh Duong,Thu Dau Mot Town,18,366,336,30,4
2022-04-01,Binh Duong,Thu Dau Mot Town,19,311,290,21,5
2022-04-01,Binh Duong,Thu Dau Mot Town,20,212,192,20,4
2022-04-01,Binh Duong,Thu Dau Mot Town,21,90,77,13,1
2022-04-01,Binh Duong,Thu Dau Mot Town,22,1,1,0,0
2022-04-01,Binh Duong,Thuan An,6,1,0,1,0
2022-04-01,Binh Duong,Thuan An,7,5,2,3,2
2022-04-01,Binh Duong,Thuan An,8,22,11,11,9
2022-04-01,Binh Duong,Thuan An,9,28,14,14,11
2022-04-01,Binh Duong,Thuan An,10,42,29,13,9
2022-04-01,Binh Duong,Thuan An,11,75,44,31,20
2022-04-01,Binh Duong,Thuan An,12,55,42,13,7
2022-04-01,Binh Duong,Thuan An,13,38,29,9,6
2022-04-01,Binh Duong,Thuan An,14,30,23,7,4
2022-04-01,Binh Duong,Thuan An,15,30,21,9,5
2022-04-01,Binh Duong,Thuan An,16,30,22,8,5
2022-04-01,Binh Duong,Thuan An,17,32,30,2,0
2022-04-01,Binh Duong,Thuan An,18,37,35,2,1
2022-04-01,Binh Duong,Thuan An,19,25,22,3,3
2022-04-01,Binh Duong,Thuan An,20,19,15,4,2
2022-04-01,Binh Duong,Thuan An,21,12,4,8,6
2022-04-01,Can Tho City,Binh Thuy District,4,1,1,0,0
2022-04-01,Can Tho City,Binh Thuy District,5,1,0,1,0
2022-04-01,Can Tho City,Binh Thuy District,6,2,2,0,0
2022-04-01,Can Tho City,Binh Thuy District,7,2,2,0,0
2022-04-01,Can Tho City,Binh Thuy District,9,3,2,1,0
2022-04-01,Can Tho City,Binh Thuy District,10,5,5,0,0
2022-04-01,Can Tho City,Binh Thuy District,11,15,13,2,0
2022-04-01,Can Tho City,Binh Thuy District,12,19,18,1,0
2022-04-01,Can Tho City,Binh Thuy District,13,9,9,0,0
2022-04-01,Can Tho City,Binh Thuy District,14,12,11,1,0
2022-04-01,Can Tho City,Binh Thuy District,15,8,8,0,0
2022-04-01,Can Tho City,Binh Thuy District,16,12,11,1,1
2022-04-01,Can Tho City,Binh Thuy District,17,16,13,3,0
2022-04-01,Can Tho City,Binh Thuy District,18,17,16,1,0
2022-04-01,Can Tho City,Binh Thuy District,19,10,10,0,0
2022-04-01,Can Tho City,Binh Thuy District,20,9,7,2,1
2022-04-01,Can Tho City,Cai Rang District,6,5,0,5,5
2022-04-01,Can Tho City,Cai Rang District,7,3,1,2,0
2022-04-01,Can Tho City,Cai Rang District,8,4,4,0,0
2022-04-01,Can Tho City,Cai Rang District,9,6,6,0,0
2022-04-01,Can Tho City,Cai Rang District,10,12,12,0,0
2022-04-01,Can Tho City,Cai Rang District,11,11,8,3,1
2022-04-01,Can Tho City,Cai Rang District,12,16,14,2,0
2022-04-01,Can Tho City,Cai Rang District,13,17,15,2,1
2022-04-01,Can Tho City,Cai Rang District,14,8,8,0,0
2022-04-01,Can Tho City,Cai Rang District,15,6,6,0,0
2022-04-01,Can Tho City,Cai Rang District,16,7,6,1,0
2022-04-01,Can Tho City,Cai Rang District,17,12,11,1,0
2022-04-01,Can Tho City,Cai Rang District,18,11,6,5,0
2022-04-01,Can Tho City,Cai Rang District,19,9,8,1,1
2022-04-01,Can Tho City,Cai Rang District,20,9,9,0,0
2022-04-01,Can Tho City,Ninh Kieu District,0,3,1,2,0
2022-04-01,Can Tho City,Ninh Kieu District,1,2,2,0,0
2022-04-01,Can Tho City,Ninh Kieu District,4,2,0,2,0
2022-04-01,Can Tho City,Ninh Kieu District,5,4,2,2,1
2022-04-01,Can Tho City,Ninh Kieu District,6,54,43,11,7
2022-04-01,Can Tho City,Ninh Kieu District,7,113,103,10,0
2022-04-01,Can Tho City,Ninh Kieu District,8,231,214,17,0
2022-04-01,Can Tho City,Ninh Kieu District,9,230,217,13,0
2022-04-01,Can Tho City,Ninh Kieu District,10,520,489,31,0
2022-04-01,Can Tho City,Ninh Kieu District,11,904,852,52,2
2022-04-01,Can Tho City,Ninh Kieu District,12,615,594,21,1
2022-04-01,Can Tho City,Ninh Kieu District,13,521,499,22,0
2022-04-01,Can Tho City,Ninh Kieu District,14,328,312,16,0
2022-04-01,Can Tho City,Ninh Kieu District,15,329,304,25,0
2022-04-01,Can Tho City,Ninh Kieu District,16,479,444,35,0
2022-04-01,Can Tho City,Ninh Kieu District,17,536,509,27,0
2022-04-01,Can Tho City,Ninh Kieu District,18,556,513,43,0
2022-04-01,Can Tho City,Ninh Kieu District,19,475,445,30,0
2022-04-01,Can Tho City,Ninh Kieu District,20,361,325,36,0
2022-04-01,Can Tho City,Ninh Kieu District,21,158,144,14,0
2022-04-01,Can Tho City,Ninh Kieu District,22,4,2,2,0
2022-04-01,Can Tho City,Ninh Kieu District,23,4,2,2,0
2022-04-01,Dong Nai,Bien Hoa City,0,1,0,1,0
2022-04-01,Dong Nai,Bien Hoa City,1,4,3,1,0
2022-04-01,Dong Nai,Bien Hoa City,2,2,1,1,0
2022-04-01,Dong Nai,Bien Hoa City,4,2,2,0,0
2022-04-01,Dong Nai,Bien Hoa City,5,2,2,0,0
2022-04-01,Dong Nai,Bien Hoa City,6,52,11,41,35
2022-04-01,Dong Nai,Bien Hoa City,7,156,122,34,23
2022-04-01,Dong Nai,Bien Hoa City,8,275,231,44,18
2022-04-01,Dong Nai,Bien Hoa City,9,363,329,34,4
2022-04-01,Dong Nai,Bien Hoa City,10,651,575,76,18
2022-04-01,Dong Nai,Bien Hoa City,11,1036,915,121,55
2022-04-01,Dong Nai,Bien Hoa City,12,706,654,52,5
2022-04-01,Dong Nai,Bien Hoa City,13,727,676,51,17
2022-04-01,Dong Nai,Bien Hoa City,14,578,528,50,9
2022-04-01,Dong Nai,Bien Hoa City,15,469,422,47,10
2022-04-01,Dong Nai,Bien Hoa City,16,440,413,27,7
2022-04-01,Dong Nai,Bien Hoa City,17,545,492,53,12
2022-04-01,Dong Nai,Bien Hoa City,18,653,588,65,12
2022-04-01,Dong Nai,Bien Hoa City,19,597,534,63,13
2022-04-01,Dong Nai,Bien Hoa City,20,441,360,81,31
2022-04-01,Dong Nai,Bien Hoa City,21,230,164,66,27
2022-04-01,Dong Nai,Bien Hoa City,22,9,4,5,0
2022-04-01,Dong Nai,Bien Hoa City,23,2,1,1,0
2022-04-01,Dong Nai,Long Khanh,15,1,0,1,1
2022-04-01,Dong Nai,Long Thanh,10,2,0,2,2
2022-04-01,Dong Nai,Long Thanh,11,1,0,1,1
2022-04-01,Dong Nai,Long Thanh,12,1,0,1,1
2022-04-01,Dong Nai,Long Thanh,15,1,0,1,1
2022-04-01,Dong Nai,Long Thanh,20,1,0,1,1
2022-04-01,Dong Nai,Long Thanh,21,2,0,2,2
2022-04-01,Dong Nai,Thong Nhat,8,1,1,0,0
2022-04-01,Dong Nai,Thong Nhat,9,2,2,0,0
2022-04-01,Dong Nai,Thong Nhat,10,3,3,0,0
2022-04-01,Dong Nai,Thong Nhat,11,2,2,0,0
2022-04-01,Dong Nai,Thong Nhat,12,1,1,0,0
2022-04-01,Dong Nai,Thong Nhat,13,2,2,0,0
2022-04-01,Dong Nai,Thong Nhat,15,1,1,0,0
2022-04-01,Dong Nai,Thong Nhat,20,1,1,0,0
2022-04-01,Dong Nai,Trang Bom,10,2,0,2,2
2022-04-01,Dong Nai,Trang Bom,11,2,1,1,1
2022-04-01,Dong Nai,Trang Bom,16,1,0,1,1
2022-04-01,Dong Nai,Vinh Cuu,12,1,0,1,1
2022-04-01,Hai Phong City,An Duong,7,2,0,2,2
2022-04-01,Hai Phong City,An Duong,8,3,2,1,1
2022-04-01,Hai Phong City,An Duong,10,5,2,3,2
2022-04-01,Hai Phong City,An Duong,11,5,2,3,2
2022-04-01,Hai Phong City,An Duong,12,8,3,5,1
2022-04-01,Hai Phong City,An Duong,13,7,4,3,2
2022-04-01,Hai Phong City,An Duong,14,4,3,1,1
2022-04-01,Hai Phong City,An Duong,15,3,1,2,1
2022-04-01,Hai Phong City,An Duong,17,1,0,1,1
2022-04-01,Hai Phong City,An Duong,18,6,2,4,4
2022-04-01,Hai Phong City,An Duong,19,2,1,1,1
2022-04-01,Hai Phong City,An Duong,20,2,1,1,0
2022-04-01,Hai Phong City,Hai An District,7,7,3,4,2
2022-04-01,Hai Phong City,Hai An District,8,11,9,2,0
2022-04-01,Hai Phong City,Hai An District,9,9,7,2,0
2022-04-01,Hai Phong City,Hai An District,10,29,21,8,6
2022-04-01,Hai Phong City,Hai An District,11,39,29,10,9
2022-04-01,Hai Phong City,Hai An District,12,18,18,0,0
2022-04-01,Hai Phong City,Hai An District,13,9,7,2,1
2022-04-01,Hai Phong City,Hai An District,14,17,12,5,2
2022-04-01,Hai Phong City,Hai An District,15,26,23,3,0
2022-04-01,Hai Phong City,Hai An District,16,11,11,0,0
2022-04-01,Hai Phong City,Hai An District,17,17,16,1,0
2022-04-01,Hai Phong City,Hai An District,18,20,15,5,0
2022-04-01,Hai Phong City,Hai An District,19,26,22,4,0
2022-04-01,Hai Phong City,Hai An District,20,12,8,4,2
2022-04-01,Hai Phong City,Hai An District,21,10,5,5,2
2022-04-01,Hai Phong City,Hong Bang District,0,2,0,2,0
2022-04-01,Hai Phong City,Hong Bang District,1,1,0,1,0
2022-04-01,Hai Phong City,Hong Bang District,6,2,1,1,0
2022-04-01,Hai Phong City,Hong Bang District,7,14,12,2,2
2022-04-01,Hai Phong City,Hong Bang District,8,29,22,7,0
2022-04-01,Hai Phong City,Hong Bang District,9,33,26,7,3
2022-04-01,Hai Phong City,Hong Bang District,10,94,62,32,22
2022-04-01,Hai Phong City,Hong Bang District,11,121,86,35,16
2022-04-01,Hai Phong City,Hong Bang District,12,36,33,3,0
2022-04-01,Hai Phong City,Hong Bang District,13,24,22,2,0
2022-04-01,Hai Phong City,Hong Bang District,14,66,55,11,3
2022-04-01,Hai Phong City,Hong Bang District,15,43,35,8,2
2022-04-01,Hai Phong City,Hong Bang District,16,23,18,5,0
2022-04-01,Hai Phong City,Hong Bang District,17,37,33,4,0
2022-04-01,Hai Phong City,Hong Bang District,18,48,45,3,0
2022-04-01,Hai Phong City,Hong Bang District,19,45,42,3,1
2022-04-01,Hai Phong City,Hong Bang District,20,26,24,2,0
2022-04-01,Hai Phong City,Hong Bang District,21,15,9,6,2
2022-04-01,Hai Phong City,Kien An District,7,1,0,1,1
2022-04-01,Hai Phong City,Kien An District,8,1,1,0,0
2022-04-01,Hai Phong City,Kien An District,9,1,0,1,0
2022-04-01,Hai Phong City,Kien An District,10,6,3,3,1
2022-04-01,Hai Phong City,Kien An District,11,19,11,8,6
2022-04-01,Hai Phong City,Kien An District,12,15,9,6,3
2022-04-01,Hai Phong City,Kien An District,13,7,3,4,2
2022-04-01,Hai Phong City,Kien An District,14,5,5,0,0
2022-04-01,Hai Phong City,Kien An District,15,6,5,1,0
2022-04-01,Hai Phong City,Kien An District,16,10,9,1,0
2022-04-01,Hai Phong City,Kien An District,17,6,4,2,1
2022-04-01,Hai Phong City,Kien An District,18,10,4,6,3
2022-04-01,Hai Phong City,Kien An District,19,10,7,3,2
2022-04-01,Hai Phong City,Kien An District,20,7,3,4,4
2022-04-01,Hai Phong City,Kien An District,21,4,3,1,0
2022-04-01,Hai Phong City,Le Chan District,7,29,26,3,1
2022-04-01,Hai Phong City,Le Chan District,8,79,68,11,1
2022-04-01,Hai Phong City,Le Chan District,9,65,53,12,1
2022-04-01,Hai Phong City,Le Chan District,10,182,138,44,29
2022-04-01,Hai Phong City,Le Chan District,11,329,258,71,48
2022-04-01,Hai Phong City,Le Chan District,12,167,147,20,0
2022-04-01,Hai Phong City,Le Chan District,13,98,89,9,1
2022-04-01,Hai Phong City,Le Chan District,14,127,106,21,1
2022-04-01,Hai Phong City,Le Chan District,15,139,124,15,2
2022-04-01,Hai Phong City,Le Chan District,16,109,99,10,0
2022-04-01,Hai Phong City,Le Chan District,17,170,157,13,0
2022-04-01,Hai Phong City,Le Chan District,18,216,193,23,4
2022-04-01,Hai Phong City,Le Chan District,19,200,176,24,9
2022-04-01,Hai Phong City,Le Chan District,20,133,112,21,3
2022-04-01,Hai Phong City,Le Chan District,21,77,58,19,6
2022-04-01,Hai Phong City,Le Chan District,22,4,0,4,1
2022-04-01,Hai Phong City,Ngo Quyen District,0,2,2,0,0
2022-04-01,Hai Phong City,Ngo Quyen District,1,1,0,1,1
2022-04-01,Hai Phong City,Ngo Quyen District,6,1,0,1,0
2022-04-01,Hai Phong City,Ngo Quyen District,7,21,18,3,2
2022-04-01,Hai Phong City,Ngo Quyen District,8,60,53,7,1
2022-04-01,Hai Phong City,Ngo Quyen District,9,72,61,11,1
2022-04-01,Hai Phong City,Ngo Quyen District,10,156,121,35,15
2022-04-01,Hai Phong City,Ngo Quyen District,11,313,253,60,39
2022-04-01,Hai Phong City,Ngo Quyen District,12,128,121,7,0
2022-04-01,Hai Phong City,Ngo Quyen District,13,116,107,9,2
2022-04-01,Hai Phong City,Ngo Quyen District,14,120,111,9,2
2022-04-01,Hai Phong City,Ngo Quyen District,15,142,123,19,3
2022-04-01,Hai Phong City,Ngo Quyen District,16,103,90,13,0
2022-04-01,Hai Phong City,Ngo Quyen District,17,148,135,13,0
2022-04-01,Hai Phong City,Ngo Quyen District,18,191,171,20,3
2022-04-01,Hai Phong City,Ngo Quyen District,19,153,139,14,0
2022-04-01,Hai Phong City,Ngo Quyen District,20,111,95,16,2
2022-04-01,Hai Phong City,Ngo Quyen District,21,82,65,17,2
2022-04-01,Hai Phong City,Ngo Quyen District,22,1,0,1,0
2022-04-01,Hai Phong City,Ngo Quyen District,23,1,0,1,1
2022-04-01,Hai Phong City,Thuy Nguyen,8,1,0,1,1
2022-04-01,Hai Phong City,Thuy Nguyen,11,1,1,0,0
2022-04-01,Hai Phong City,Thuy Nguyen,12,2,1,1,0
2022-04-01,Hai Phong City,Thuy Nguyen,13,1,0,1,1
2022-04-01,Hue City,Hue City,0,5,3,2,0
2022-04-01,Hue City,Hue City,1,1,0,1,0
2022-04-01,Hue City,Hue City,5,4,4,0,0
2022-04-01,Hue City,Hue City,6,68,54,14,2
2022-04-01,Hue City,Hue City,7,218,186,32,1
2022-04-01,Hue City,Hue City,8,392,351,41,1
2022-04-01,Hue City,Hue City,9,304,282,22,0
2022-04-01,Hue City,Hue City,10,497,451,46,4
2022-04-01,Hue City,Hue City,11,1101,925,176,39
2022-04-01,Hue City,Hue City,12,597,523,74,16
2022-04-01,Hue City,Hue City,13,352,328,24,0
2022-04-01,Hue City,Hue City,14,366,337,29,2
2022-04-01,Hue City,Hue City,15,481,430,51,5
2022-04-01,Hue City,Hue City,16,591,524,67,6
2022-04-01,Hue City,Hue City,17,860,744,116,25
2022-04-01,Hue City,Hue City,18,1112,840,272,121
2022-04-01,Hue City,Hue City,19,964,636,328,173
2022-04-01,Hue City,Hue City,20,627,442,185,83
2022-04-01,Hue City,Hue City,21,336,205,131,51
2022-04-01,Hue City,Hue City,22,4,0,4,0
2022-04-01,Hue City,Hue City,23,1,1,0,0
2022-04-01,Hue City,Huong Thuy,10,1,1,0,0
2022-04-01,Hue City,Huong Thuy,11,1,0,1,0
2022-04-01,Hue City,Huong Thuy,12,1,1,0,0
2022-04-01,Hue City,Huong Thuy,15,1,0,1,1
2022-04-01,Hue City,Huong Thuy,16,1,1,0,0
2022-04-01,Hue City,Huong Thuy,17,2,1,1,0
2022-04-01,Hue City,Huong Thuy,18,1,0,1,1
2022-04-01,Hue City,Huong Thuy,21,2,0,2,1
2022-04-01,Hue City,Huong Tra,9,1,0,1,1
2022-04-01,Hue City,Huong Tra,17,1,0,1,0
2022-04-01,Hue City,Huong Tra,19,1,1,0,0
2022-04-01,Hue City,Phu Vang,6,2,0,2,0
2022-04-01,Hue City,Phu Vang,9,1,0,1,1
2022-04-01,Hue City,Phu Vang,10,1,1,0,0
2022-04-01,Hue City,Phu Vang,11,2,2,0,0
2022-04-01,Hue City,Phu Vang,12,4,0,4,3
2022-04-01,Hue City,Phu Vang,14,1,1,0,0
2022-04-01,Hue City,Phu Vang,15,1,1,0,0
2022-04-01,Hue City,Phu Vang,16,2,1,1,0
2022-04-01,Hue City,Phu Vang,17,2,2,0,0
2022-04-01,Hue City,Phu Vang,18,3,3,0,0
2022-04-01,Hue City,Phu Vang,19,1,1,0,0
2022-04-01,Hue City,Phu Vang,20,1,1,0,0
2022-04-01,Hue City,Phu Vang,21,1,0,1,1
2022-04-01,Vung Tau,Ba Ria City,8,4,3,1,1
2022-04-01,Vung Tau,Ba Ria City,9,1,1,0,0
2022-04-01,Vung Tau,Ba Ria City,10,5,5,0,0
2022-04-01,Vung Tau,Ba Ria City,11,3,3,0,0
2022-04-01,Vung Tau,Ba Ria City,12,8,5,3,1
2022-04-01,Vung Tau,Ba Ria City,13,7,4,3,2
2022-04-01,Vung Tau,Ba Ria City,14,4,3,1,0
2022-04-01,Vung Tau,Ba Ria City,15,1,1,0,0
2022-04-01,Vung Tau,Ba Ria City,16,5,3,2,2
2022-04-01,Vung Tau,Ba Ria City,17,4,4,0,0
2022-04-01,Vung Tau,Ba Ria City,18,5,3,2,2
2022-04-01,Vung Tau,Ba Ria City,20,3,0,3,3
2022-04-01,Vung Tau,Ba Ria City,21,1,0,1,1
2022-04-01,Vung Tau,Vung Tau City,1,1,1,0,0
2022-04-01,Vung Tau,Vung Tau City,2,2,1,1,0
2022-04-01,Vung Tau,Vung Tau City,5,2,0,2,1
2022-04-01,Vung Tau,Vung Tau City,6,29,18,11,9
2022-04-01,Vung Tau,Vung Tau City,7,98,88,10,5
2022-04-01,Vung Tau,Vung Tau City,8,138,132,6,1
2022-04-01,Vung Tau,Vung Tau City,9,142,129,13,0
2022-04-01,Vung Tau,Vung Tau City,10,163,144,19,3
2022-04-01,Vung Tau,Vung Tau City,11,380,332,48,9
2022-04-01,Vung Tau,Vung Tau City,12,237,222,15,0
2022-04-01,Vung Tau,Vung Tau City,13,174,157,17,4
2022-04-01,Vung Tau,Vung Tau City,14,228,209,19,6
2022-04-01,Vung Tau,Vung Tau City,15,194,173,21,0
2022-04-01,Vung Tau,Vung Tau City,16,177,163,14,1
2022-04-01,Vung Tau,Vung Tau City,17,250,235,15,1
2022-04-01,Vung Tau,Vung Tau City,18,363,310,53,25
2022-04-01,Vung Tau,Vung Tau City,19,259,226,33,5
2022-04-01,Vung Tau,Vung Tau City,20,167,148,19,3
2022-04-01,Vung Tau,Vung Tau City,21,93,73,20,6
2022-04-01,Vung Tau,Vung Tau City,22,1,0,1,0
2022-04-01,Vung Tau,Vung Tau City,23,1,1,0,0
2022-04-02,Binh Duong,Ben Cat,9,1,0,1,1
2022-04-02,Binh Duong,Ben Cat,11,1,0,1,1
2022-04-02,Binh Duong,Ben Cat,12,1,0,1,1
2022-04-02,Binh Duong,Ben Cat,13,4,1,3,3
2022-04-02,Binh Duong,Ben Cat,14,1,0,1,1
2022-04-02,Binh Duong,Ben Cat,17,1,0,1,0
2022-04-02,Binh Duong,Ben Cat,18,1,0,1,1
2022-04-02,Binh Duong,Ben Cat,19,1,0,1,1
2022-04-02,Binh Duong,Ben Cat,20,3,0,3,2
2022-04-02,Binh Duong,Di An,0,1,1,0,0
2022-04-02,Binh Duong,Di An,2,1,0,1,1
2022-04-02,Binh Duong,Di An,6,1,0,1,1
2022-04-02,Binh Duong,Di An,7,4,2,2,2
2022-04-02,Binh Duong,Di An,8,25,11,14,12
2022-04-02,Binh Duong,Di An,9,19,14,5,5
2022-04-02,Binh Duong,Di An,10,20,14,6,4
2022-04-02,Binh Duong,Di An,11,40,18,22,19
2022-04-02,Binh Duong,Di An,12,25,18,7,4
2022-04-02,Binh Duong,Di An,13,18,15,3,1
2022-04-02,Binh Duong,Di An,14,11,10,1,0
2022-04-02,Binh Duong,Di An,15,18,12,6,2
2022-04-02,Binh Duong,Di An,16,17,11,6,4
2022-04-02,Binh Duong,Di An,17,17,12,5,4
2022-04-02,Binh Duong,Di An,18,28,14,14,9
2022-04-02,Binh Duong,Di An,19,32,18,14,10
2022-04-02,Binh Duong,Di An,20,21,10,11,9
2022-04-02,Binh Duong,Di An,21,1,0,1,1
2022-04-02,Binh Duong,Di An,23,1,0,1,1
2022-04-02,Binh Duong,Tan Uyen,9,2,2,0,0
2022-04-02,Binh Duong,Tan Uyen,10,2,0,2,1
2022-04-02,Binh Duong,Tan Uyen,11,3,0,3,2
2022-04-02,Binh Duong,Tan Uyen,12,1,0,1,1
2022-04-02,Binh Duong,Tan Uyen,13,2,1,1,1
2022-04-02,Binh Duong,Tan Uyen,14,6,1,5,4
2022-04-02,Binh Duong,Tan Uyen,15,2,1,1,0
2022-04-02,Binh Duong,Tan Uyen,16,6,1,5,2
2022-04-02,Binh Duong,Tan Uyen,17,1,1,0,0
2022-04-02,Binh Duong,Tan Uyen,18,3,2,1,1
2022-04-02,Binh Duong,Tan Uyen,19,1,1,0,0
2022-04-02,Binh Duong,Tan Uyen,20,3,0,3,2
2022-04-02,Binh Duong,Tan Uyen,21,1,0,1,1
2022-04-02,Binh Duong,Thu Dau Mot Town,2,1,1,0,0
2022-04-02,Binh Duong,Thu Dau Mot Town,5,1,1,0,0
2022-04-02,Binh Duong,Thu Dau Mot Town,6,38,33,5,2
2022-04-02,Binh Duong,Thu Dau Mot Town,7,114,110,4,1
2022-04-02,Binh Duong,Thu Dau Mot Town,8,170,158,12,2
2022-04-02,Binh Duong,Thu Dau Mot Town,9,268,241,27,3
2022-04-02,Binh Duong,Thu Dau Mot Town,10,357,333,24,4
2022-04-02,Binh Duong,Thu Dau Mot Town,11,559,529,30,4
2022-04-02,Binh Duong,Thu Dau Mot Town,12,422,397,25,4
2022-04-02,Binh Duong,Thu Dau Mot Town,13,369,353,16,4
2022-04-02,Binh Duong,Thu Dau Mot Town,14,307,286,21,1
2022-04-02,Binh Duong,Thu Dau Mot Town,15,259,245,14,2
2022-04-02,Binh Duong,Thu Dau Mot Town,16,303,283,20,1
2022-04-02,Binh Duong,Thu Dau Mot Town,17,334,316,18,7
2022-04-02,Binh Duong,Thu Dau Mot Town,18,380,360,20,5
2022-04-02,Binh Duong,Thu Dau Mot Town,19,328,312,16,5
2022-04-02,Binh Duong,Thu Dau Mot Town,20,226,215,11,1
2022-04-02,Binh Duong,Thu Dau Mot Town,21,96,77,19,5
2022-04-02,Binh Duong,Thu Dau Mot Town,22,2,0,2,0
2022-04-02,Binh Duong,Thuan An,7,10,8,2,1
2022-04-02,Binh Duong,Thuan An,8,14,11,3,2
2022-04-02,Binh Duong,Thuan An,9,28,20,8,2
2022-04-02,Binh Duong,Thuan An,10,50,38,12,9
2022-04-02,Binh Duong,Thuan An,11,62,43,19,16
2022-04-02,Binh Duong,Thuan An,12,52,37,15,11
2022-04-02,Binh Duong,Thuan An,13,42,29,13,8
2022-04-02,Binh Duong,Thuan An,14,39,28,11,7
2022-04-02,Binh Duong,Thuan An,15,37,28,9,2
2022-04-02,Binh Duong,Thuan An,16,24,17,7,2
2022-04-02,Binh Duong,Thuan An,17,39,31,8,6
2022-04-02,Binh Duong,Thuan An,18,32,25,7,3
2022-04-02,Binh Duong,Thuan An,19,32,24,8,4
2022-04-02,Binh Duong,Thuan An,20,37,17,20,13
2022-04-02,Binh Duong,Thuan An,21,19,5,14,9
2022-04-02,Can Tho City,Binh Thuy District,8,6,6,0,0
2022-04-02,Can Tho City,Binh Thuy District,9,7,7,0,0
2022-04-02,Can Tho City,Binh Thuy District,10,12,10,2,0
2022-04-02,Can Tho City,Binh Thuy District,11,13,11,2,0
2022-04-02,Can Tho City,Binh Thuy District,12,15,12,3,0
2022-04-02,Can Tho City,Binh Thuy District,13,11,9,2,0
2022-04-02,Can Tho City,Binh Thuy District,14,11,10,1,0
2022-04-02,Can Tho City,Binh Thuy District,15,5,4,1,0
2022-04-02,Can Tho City,Binh Thuy District,16,13,13,0,0
2022-04-02,Can Tho City,Binh Thuy District,17,15,14,1,1
2022-04-02,Can Tho City,Binh Thuy District,18,18,17,1,0
2022-04-02,Can Tho City,Binh Thuy District,19,14,12,2,0
2022-04-02,Can Tho City,Binh Thuy District,20,7,7,0,0
2022-04-02,Can Tho City,Binh Thuy District,21,3,3,0,0
2022-04-02,Can Tho City,Cai Rang District,0,1,0,1,1
2022-04-02,Can Tho City,Cai Rang District,6,2,0,2,2
2022-04-02,Can Tho City,Cai Rang District,7,3,3,0,0
2022-04-02,Can Tho City,Cai Rang District,8,8,7,1,1
2022-04-02,Can Tho City,Cai Rang District,9,2,2,0,0
2022-04-02,Can Tho City,Cai Rang District,10,9,8,1,0
2022-04-02,Can Tho City,Cai Rang District,11,14,14,0,0
2022-04-02,Can Tho City,Cai Rang District,12,12,12,0,0
2022-04-02,Can Tho City,Cai Rang District,13,7,6,1,1
2022-04-02,Can Tho City,Cai Rang District,14,5,5,0,0
2022-04-02,Can Tho City,Cai Rang District,15,9,9,0,0
2022-04-02,Can Tho City,Cai Rang District,16,10,10,0,0
2022-04-02,Can Tho City,Cai Rang District,17,17,17,0,0
2022-04-02,Can Tho City,Cai Rang District,18,12,10,2,0
2022-04-02,Can Tho City,Cai Rang District,19,15,12,3,0
2022-04-02,Can Tho City,Cai Rang District,20,17,15,2,1
2022-04-02,Can Tho City,Cai Rang District,21,3,2,1,1
2022-04-02,Can Tho City,Ninh Kieu District,0,3,2,1,0
2022-04-02,Can Tho City,Ninh Kieu District,2,3,2,1,0
2022-04-02,Can Tho City,Ninh Kieu District,5,1,1,0,0
2022-04-02,Can Tho City,Ninh Kieu District,6,52,48,4,3
2022-04-02,Can Tho City,Ninh Kieu District,7,142,127,15,0
2022-04-02,Can Tho City,Ninh Kieu District,8,252,238,14,2
2022-04-02,Can Tho City,Ninh Kieu District,9,346,317,29,0
2022-04-02,Can Tho City,Ninh Kieu District,10,531,509,22,0
2022-04-02,Can Tho City,Ninh Kieu District,11,833,793,40,0
2022-04-02,Can Tho City,Ninh Kieu District,12,613,589,24,0
2022-04-02,Can Tho City,Ninh Kieu District,13,492,468,24,0
2022-04-02,Can Tho City,Ninh Kieu District,14,374,350,24,0
2022-04-02,Can Tho City,Ninh Kieu District,15,402,380,22,0
2022-04-02,Can Tho City,Ninh Kieu District,16,432,405,27,0
2022-04-02,Can Tho City,Ninh Kieu District,17,551,521,30,0
2022-04-02,Can Tho City,Ninh Kieu District,18,478,453,25,0
2022-04-02,Can Tho City,Ninh Kieu District,19,469,432,37,0
2022-04-02,Can Tho City,Ninh Kieu District,20,322,298,24,1
2022-04-02,Can Tho City,Ninh Kieu District,21,149,133,16,0
2022-04-02,Can Tho City,Ninh Kieu District,22,2,2,0,0
2022-04-02,Can Tho City,Ninh Kieu District,23,5,5,0,0
2022-04-02,Dong Nai,Bien Hoa City,0,2,1,1,0
2022-04-02,Dong Nai,Bien Hoa City,1,4,2,2,0
2022-04-02,Dong Nai,Bien Hoa City,2,3,3,0,0
2022-04-02,Dong Nai,Bien Hoa City,3,1,1,0,0
2022-04-02,Dong Nai,Bien Hoa City,5,3,2,1,0
2022-04-02,Dong Nai,Bien Hoa City,6,58,32,26,16
2022-04-02,Dong Nai,Bien Hoa City,7,151,128,23,13
2022-04-02,Dong Nai,Bien Hoa City,8,271,246,25,4
2022-04-02,Dong Nai,Bien Hoa City,9,471,423,48,12
2022-04-02,Dong Nai,Bien Hoa City,10,724,657,67,18
2022-04-02,Dong Nai,Bien Hoa City,11,1063,968,95,20
2022-04-02,Dong Nai,Bien Hoa City,12,848,787,61,9
2022-04-02,Dong Nai,Bien Hoa City,13,667,629,38,2
2022-04-02,Dong Nai,Bien Hoa City,14,570,527,43,9
2022-04-02,Dong Nai,Bien Hoa City,15,427,381,46,5
2022-04-02,Dong Nai,Bien Hoa City,16,469,428,41,21
2022-04-02,Dong Nai,Bien Hoa City,17,532,478,54,17
2022-04-02,Dong Nai,Bien Hoa City,18,655,556,99,41
2022-04-02,Dong Nai,Bien Hoa City,19,669,536,133,66
2022-04-02,Dong Nai,Bien Hoa City,20,528,373,155,83
2022-04-02,Dong Nai,Bien Hoa City,21,279,159,120,62
2022-04-02,Dong Nai,Bien Hoa City,22,4,1,3,0
2022-04-02,Dong Nai,Bien Hoa City,23,1,0,1,1
2022-04-02,Dong Nai,Long Khanh,11,1,0,1,1
2022-04-02,Dong Nai,Long Khanh,12,1,0,1,1
2022-04-02,Dong Nai,Long Khanh,14,1,0,1,0
2022-04-02,Dong Nai,Long Thanh,11,1,0,1,0
2022-04-02,Dong Nai,Long Thanh,12,3,0,3,3
2022-04-02,Dong Nai,Long Thanh,14,2,0,2,2
2022-04-02,Dong Nai,Long Thanh,18,1,0,1,1
2022-04-02,Dong Nai,Nhon trach,8,1,0,1,1
2022-04-02,Dong Nai,Nhon trach,11,1,0,1,1
2022-04-02,Dong Nai,Nhon trach,13,2,0,2,2
2022-04-02,Dong Nai,Nhon trach,16,1,0,1,1
2022-04-02,Dong Nai,Nhon trach,17,1,0,1,1
2022-04-02,Dong Nai,Nhon trach,20,2,0,2,2
2022-04-02,Dong Nai,Thong Nhat,8,2,1,1,0
2022-04-02,Dong Nai,Thong Nhat,9,3,3,0,0
2022-04-02,Dong Nai,Thong Nhat,11,1,1,0,0
2022-04-02,Dong Nai,Thong Nhat,12,1,1,0,0
2022-04-02,Dong Nai,Thong Nhat,13,2,2,0,0
2022-04-02,Dong Nai,Thong Nhat,18,2,2,0,0
2022-04-02,Dong Nai,Thong Nhat,19,3,3,0,0
2022-04-02,Dong Nai,Thong Nhat,20,1,1,0,0
2022-04-02,Dong Nai,Trang Bom,15,1,0,1,1
2022-04-02,Dong Nai,Trang Bom,19,1,0,1,1
2022-04-02,Dong Nai,Trang Bom,20,2,0,2,2
2022-04-02,Dong Nai,Trang Bom,21,2,0,2,1
2022-04-02,Hai Phong City,An Duong,7,1,0,1,1
2022-04-02,Hai Phong City,An Duong,8,10,0,10,10
2022-04-02,Hai Phong City,An Duong,9,2,0,2,2
2022-04-02,Hai Phong City,An Duong,10,4,1,3,1
2022-04-02,Hai Phong City,An Duong,11,7,4,3,1
2022-04-02,Hai Phong City,An Duong,12,3,0,3,3
2022-04-02,Hai Phong City,An Duong,13,1,0,1,1
2022-04-02,Hai Phong City,An Duong,14,1,1,0,0
2022-04-02,Hai Phong City,An Duong,15,3,1,2,2
2022-04-02,Hai Phong City,An Duong,16,1,1,0,0
2022-04-02,Hai Phong City,An Duong,17,6,2,4,4
2022-04-02,Hai Phong City,An Duong,18,2,0,2,2
2022-04-02,Hai Phong City,An Duong,19,3,0,3,2
2022-04-02,Hai Phong City,An Duong,20,2,0,2,2
2022-04-02,Hai Phong City,An Duong,21,1,0,1,0
2022-04-02,Hai Phong City,Do Son District,19,1,0,1,1
2022-04-02,Hai Phong City,Do Son District,21,1,0,1,1
2022-04-02,Hai Phong City,Hai An District,3,1,1,0,0
2022-04-02,Hai Phong City,Hai An District,6,2,0,2,2
2022-04-02,Hai Phong City,Hai An District,7,13,4,9,9
2022-04-02,Hai Phong City,Hai An District,8,14,11,3,1
2022-04-02,Hai Phong City,Hai An District,9,10,8,2,2
2022-04-02,Hai Phong City,Hai An District,10,22,19,3,0
2022-04-02,Hai Phong City,Hai An District,11,36,32,4,1
2022-04-02,Hai Phong City,Hai An District,12,27,24,3,0
2022-04-02,Hai Phong City,Hai An District,13,21,18,3,0
2022-04-02,Hai Phong City,Hai An District,14,19,16,3,0
2022-04-02,Hai Phong City,Hai An District,15,10,10,0,0
2022-04-02,Hai Phong City,Hai An District,16,22,19,3,2
2022-04-02,Hai Phong City,Hai An District,17,23,21,2,0
2022-04-02,Hai Phong City,Hai An District,18,30,26,4,3
2022-04-02,Hai Phong City,Hai An District,19,22,17,5,2
2022-04-02,Hai Phong City,Hai An District,20,19,18,1,1
2022-04-02,Hai Phong City,Hai An District,21,18,15,3,1
2022-04-02,Hai Phong City,Hong Bang District,7,11,6,5,3
2022-04-02,Hai Phong City,Hong Bang District,8,14,10,4,3
2022-04-02,Hai Phong City,Hong Bang District,9,31,25,6,3
2022-04-02,Hai Phong City,Hong Bang District,10,70,61,9,1
2022-04-02,Hai Phong City,Hong Bang District,11,111,85,26,16
2022-04-02,Hai Phong City,Hong Bang District,12,52,47,5,3
2022-04-02,Hai Phong City,Hong Bang District,13,47,42,5,3
2022-04-02,Hai Phong City,Hong Bang District,14,41,34,7,2
2022-04-02,Hai Phong City,Hong Bang District,15,31,25,6,3
2022-04-02,Hai Phong City,Hong Bang District,16,37,32,5,2
2022-04-02,Hai Phong City,Hong Bang District,17,42,33,9,6
2022-04-02,Hai Phong City,Hong Bang District,18,62,54,8,5
2022-04-02,Hai Phong City,Hong Bang District,19,45,31,14,8
2022-04-02,Hai Phong City,Hong Bang District,20,41,24,17,12
2022-04-02,Hai Phong City,Hong Bang District,21,17,11,6,4
2022-04-02,Hai Phong City,Kien An District,8,4,2,2,2
2022-04-02,Hai Phong City,Kien An District,9,6,3,3,3
2022-04-02,Hai Phong City,Kien An District,10,15,13,2,2
2022-04-02,Hai Phong City,Kien An District,11,8,5,3,0
2022-04-02,Hai Phong City,Kien An District,12,10,9,1,1
2022-04-02,Hai Phong City,Kien An District,13,11,5,6,2
2022-04-02,Hai Phong City,Kien An District,14,10,7,3,2
2022-04-02,Hai Phong City,Kien An District,15,3,2,1,1
2022-04-02,Hai Phong City,Kien An District,16,4,2,2,1
2022-04-02,Hai Phong City,Kien An District,17,4,3,1,1
2022-04-02,Hai Phong City,Kien An District,18,24,12,12,11
2022-04-02,Hai Phong City,Kien An District,19,7,4,3,1
2022-04-02,Hai Phong City,Kien An District,20,13,9,4,1
2022-04-02,Hai Phong City,Kien An District,21,3,2,1,1
2022-04-02,Hai Phong City,Le Chan District,1,1,0,1,0
2022-04-02,Hai Phong City,Le Chan District,2,3,2,1,1
2022-04-02,Hai Phong City,Le Chan District,3,1,0,1,0
2022-04-02,Hai Phong City,Le Chan District,6,2,1,1,0
2022-04-02,Hai Phong City,Le Chan District,7,39,27,12,7
2022-04-02,Hai Phong City,Le Chan District,8,79,58,21,14
2022-04-02,Hai Phong City,Le Chan District,9,82,67,15,3
2022-04-02,Hai Phong City,Le Chan District,10,167,149,18,1
2022-04-02,Hai Phong City,Le Chan District,11,338,290,48,12
2022-04-02,Hai Phong City,Le Chan District,12,203,177,26,3
2022-04-02,Hai Phong City,Le Chan District,13,125,116,9,1
2022-04-02,Hai Phong City,Le Chan District,14,122,105,17,4
2022-04-02,Hai Phong City,Le Chan District,15,149,133,16,1
2022-04-02,Hai Phong City,Le Chan District,16,129,113,16,4
2022-04-02,Hai Phong City,Le Chan District,17,186,164,22,3
2022-04-02,Hai Phong City,Le Chan District,18,258,214,44,15
2022-04-02,Hai Phong City,Le Chan District,19,176,143,33,13
2022-04-02,Hai Phong City,Le Chan District,20,147,120,27,10
2022-04-02,Hai Phong City,Le Chan District,21,68,53,15,4
2022-04-02,Hai Phong City,Le Chan District,22,1,0,1,0
2022-04-02,Hai Phong City,Le Chan District,23,2,0,2,0
2022-04-02,Hai Phong City,Ngo Quyen District,1,1,1,0,0
2022-04-02,Hai Phong City,Ngo Quyen District,6,1,1,0,0
2022-04-02,Hai Phong City,Ngo Quyen District,7,21,14,7,5
2022-04-02,Hai Phong City,Ngo Quyen District,8,89,71,18,13
2022-04-02,Hai Phong City,Ngo Quyen District,9,98,85,13,2
2022-04-02,Hai Phong City,Ngo Quyen District,10,134,114,20,5
2022-04-02,Hai Phong City,Ngo Quyen District,11,256,219,37,11
2022-04-02,Hai Phong City,Ngo Quyen District,12,175,153,22,1
2022-04-02,Hai Phong City,Ngo Quyen District,13,114,100,14,2
2022-04-02,Hai Phong City,Ngo Quyen District,14,122,113,9,0
2022-04-02,Hai Phong City,Ngo Quyen District,15,143,123,20,2
2022-04-02,Hai Phong City,Ngo Quyen District,16,160,142,18,4
2022-04-02,Hai Phong City,Ngo Quyen District,17,159,142,17,5
2022-04-02,Hai Phong City,Ngo Quyen District,18,195,170,25,9
2022-04-02,Hai Phong City,Ngo Quyen District,19,197,170,27,6
2022-04-02,Hai Phong City,Ngo Quyen District,20,132,113,19,4
2022-04-02,Hai Phong City,Ngo Quyen District,21,61,46,15,1
2022-04-02,Hai Phong City,Thuy Nguyen,9,1,0,1,1
2022-04-02,Hai Phong City,Thuy Nguyen,11,1,0,1,1
2022-04-02,Hai Phong City,Thuy Nguyen,12,5,0,5,4
2022-04-02,Hai Phong City,Thuy Nguyen,14,1,0,1,1
2022-04-02,Hai Phong City,Thuy Nguyen,15,2,0,2,2
2022-04-02,Hai Phong City,Thuy Nguyen,16,3,1,2,2
2022-04-02,Hai Phong City,Thuy Nguyen,17,2,0,2,0
2022-04-02,Hai Phong City,Thuy Nguyen,19,2,0,2,2
2022-04-02,Hue City,Hue City,0,4,2,2,0
2022-04-02,Hue City,Hue City,1,1,1,0,0
2022-04-02,Hue City,Hue City,3,1,0,1,0
2022-04-02,Hue City,Hue City,5,2,2,0,0
2022-04-02,Hue City,Hue City,6,81,56,25,19
2022-04-02,Hue City,Hue City,7,278,224,54,23
2022-04-02,Hue City,Hue City,8,422,377,45,9
2022-04-02,Hue City,Hue City,9,348,311,37,2
2022-04-02,Hue City,Hue City,10,436,401,35,1
2022-04-02,Hue City,Hue City,11,827,749,78,7
2022-04-02,Hue City,Hue City,12,564,506,58,2
2022-04-02,Hue City,Hue City,13,400,366,34,1
2022-04-02,Hue City,Hue City,14,398,359,39,4
2022-04-02,Hue City,Hue City,15,480,444,36,6
2022-04-02,Hue City,Hue City,16,610,539,71,24
2022-04-02,Hue City,Hue City,17,800,696,104,22
2022-04-02,Hue City,Hue City,18,1005,779,226,95
2022-04-02,Hue City,Hue City,19,893,685,208,72
2022-04-02,Hue City,Hue City,20,586,463,123,34
2022-04-02,Hue City,Hue City,21,344,214,130,47
2022-04-02,Hue City,Hue City,22,8,2,6,1
2022-04-02,Hue City,Hue City,23,4,4,0,0
2022-04-02,Hue City,Huong Thuy,8,2,2,0,0
2022-04-02,Hue City,Huong Thuy,9,5,2,3,2
2022-04-02,Hue City,Huong Thuy,10,1,0,1,0
2022-04-02,Hue City,Huong Thuy,11,2,1,1,0
2022-04-02,Hue City,Huong Thuy,12,1,0,1,0
2022-04-02,Hue City,Huong Thuy,13,2,1,1,1
2022-04-02,Hue City,Huong Thuy,14,1,0,1,1
2022-04-02,Hue City,Huong Thuy,15,2,1,1,1
2022-04-02,Hue City,Huong Thuy,16,1,1,0,0
2022-04-02,Hue City,Huong Thuy,19,1,0,1,1
2022-04-02,Hue City,Huong Thuy,20,3,1,2,2
2022-04-02,Hue City,Huong Thuy,21,2,0,2,1
2022-04-02,Hue City,Huong Tra,16,1,1,0,0
2022-04-02,Hue City,Huong Tra,18,2,1,1,0
2022-04-02,Hue City,Phu Vang,6,3,1,2,0
2022-04-02,Hue City,Phu Vang,9,1,0,1,0
2022-04-02,Hue City,Phu Vang,11,2,2,0,0
2022-04-02,Hue City,Phu Vang,12,4,3,1,1
2022-04-02,Hue City,Phu Vang,17,2,0,2,0
2022-04-02,Hue City,Phu Vang,18,6,0,6,2
2022-04-02,Hue City,Phu Vang,19,4,2,2,1
2022-04-02,Hue City,Phu Vang,21,1,1,0,0
2022-04-02,Vung Tau,Ba Ria City,6,1,0,1,1
2022-04-02,Vung Tau,Ba Ria City,7,2,0,2,0
2022-04-02,Vung Tau,Ba Ria City,8,5,3,2,1
2022-04-02,Vung Tau,Ba Ria City,9,13,9,4,4
2022-04-02,Vung Tau,Ba Ria City,10,1,1,0,0
2022-04-02,Vung Tau,Ba Ria City,11,10,6,4,2
2022-04-02,Vung Tau,Ba Ria City,12,11,6,5,2
2022-04-02,Vung Tau,Ba Ria City,13,4,1,3,2
2022-04-02,Vung Tau,Ba Ria City,14,2,1,1,0
2022-04-02,Vung Tau,Ba Ria City,15,1,1,0,0
2022-04-02,Vung Tau,Ba Ria City,16,7,3,4,4
2022-04-02,Vung Tau,Ba Ria City,17,6,3,3,2
2022-04-02,Vung Tau,Ba Ria City,18,7,7,0,0
2022-04-02,Vung Tau,Ba Ria City,19,2,0,2,2
2022-04-02,Vung Tau,Ba Ria City,20,1,0,1,1
2022-04-02,Vung Tau,Ba Ria City,21,1,0,1,1
2022-04-02,Vung Tau,Vung Tau City,6,43,40,3,0
2022-04-02,Vung Tau,Vung Tau City,7,104,99,5,1
2022-04-02,Vung Tau,Vung Tau City,8,183,170,13,2
2022-04-02,Vung Tau,Vung Tau City,9,151,140,11,1
2022-04-02,Vung Tau,Vung Tau City,10,214,194,20,1
2022-04-02,Vung Tau,Vung Tau City,11,370,338,32,7
2022-04-02,Vung Tau,Vung Tau City,12,317,297,20,3
2022-04-02,Vung Tau,Vung Tau City,13,225,214,11,1
2022-04-02,Vung Tau,Vung Tau City,14,210,198,12,0
2022-04-02,Vung Tau,Vung Tau City,15,275,247,28,2
2022-04-02,Vung Tau,Vung Tau City,16,218,201,17,1
2022-04-02,Vung Tau,Vung Tau City,17,278,259,19,4
2022-04-02,Vung Tau,Vung Tau City,18,324,295,29,0
2022-04-02,Vung Tau,Vung Tau City,19,285,257,28,1
2022-04-02,Vung Tau,Vung Tau City,20,213,181,32,3
2022-04-02,Vung Tau,Vung Tau City,21,129,93,36,12
2022-04-02,Vung Tau,Vung Tau City,22,3,2,1,0
2022-04-02,Vung Tau,Vung Tau City,23,1,0,1,0
2022-04-03,Binh Duong,Ben Cat,8,3,0,3,3
2022-04-03,Binh Duong,Ben Cat,10,2,0,2,2
2022-04-03,Binh Duong,Ben Cat,11,2,0,2,2
2022-04-03,Binh Duong,Ben Cat,12,4,0,4,3
2022-04-03,Binh Duong,Ben Cat,13,1,1,0,0
2022-04-03,Binh Duong,Ben Cat,15,1,0,1,1
2022-04-03,Binh Duong,Ben Cat,16,1,1,0,0
2022-04-03,Binh Duong,Ben Cat,17,1,0,1,1
2022-04-03,Binh Duong,Di An,7,8,2,6,4
2022-04-03,Binh Duong,Di An,8,16,9,7,5
2022-04-03,Binh Duong,Di An,9,27,13,14,12
2022-04-03,Binh Duong,Di An,10,49,27,22,19
2022-04-03,Binh Duong,Di An,11,37,25,12,10
2022-04-03,Binh Duong,Di An,12,33,28,5,3
2022-04-03,Binh Duong,Di An,13,29,14,15,9
2022-04-03,Binh Duong,Di An,14,32,24,8,5
2022-04-03,Binh Duong,Di An,15,23,16,7,5
2022-04-03,Binh Duong,Di An,16,15,8,7,6
2022-04-03,Binh Duong,Di An,17,23,13,10,6
2022-04-03,Binh Duong,Di An,18,34,5,29,27
2022-04-03,Binh Duong,Di An,19,33,14,19,16
2022-04-03,Binh Duong,Di An,20,35,13,22,14
2022-04-03,Binh Duong,Di An,21,9,1,8,6
2022-04-03,Binh Duong,Di An,22,1,0,1,0
2022-04-03,Binh Duong,Tan Uyen,8,2,1,1,1
2022-04-03,Binh Duong,Tan Uyen,9,5,0,5,5
2022-04-03,Binh Duong,Tan Uyen,10,2,1,1,0
2022-04-03,Binh Duong,Tan Uyen,11,3,2,1,0
2022-04-03,Binh Duong,Tan Uyen,14,3,0,3,3
2022-04-03,Binh Duong,Tan Uyen,15,1,1,0,0
2022-04-03,Binh Duong,Tan Uyen,16,1,1,0,0
2022-04-03,Binh Duong,Tan Uyen,17,2,0,2,2
2022-04-03,Binh Duong,Tan Uyen,18,1,0,1,1
2022-04-03,Binh Duong,Tan Uyen,19,2,0,2,2
2022-04-03,Binh Duong,Tan Uyen,20,1,0,1,1
2022-04-03,Binh Duong,Tan Uyen,21,2,0,2,1
2022-04-03,Binh Duong,Thu Dau Mot Town,2,1,1,0,0
2022-04-03,Binh Duong,Thu Dau Mot Town,3,1,0,1,1
2022-04-03,Binh Duong,Thu Dau Mot Town,5,3,1,2,0
2022-04-03,Binh Duong,Thu Dau Mot Town,6,33,26,7,5
2022-04-03,Binh Duong,Thu Dau Mot Town,7,125,114,11,3
2022-04-03,Binh Duong,Thu Dau Mot Town,8,233,220,13,2
2022-04-03,Binh Duong,Thu Dau Mot Town,9,261,247,14,0
2022-04-03,Binh Duong,Thu Dau Mot Town,10,381,358,23,1
2022-04-03,Binh Duong,Thu Dau Mot Town,11,601,556,45,2
2022-04-03,Binh Duong,Thu Dau Mot Town,12,497,475,22,1
2022-04-03,Binh Duong,Thu Dau Mot Town,13,372,352,20,2
2022-04-03,Binh Duong,Thu Dau Mot Town,14,348,330,18,2
2022-04-03,Binh Duong,Thu Dau Mot Town,15,288,267,21,3
2022-04-03,Binh Duong,Thu Dau Mot Town,16,265,247,18,4
2022-04-03,Binh Duong,Thu Dau Mot Town,17,359,336,23,1
2022-04-03,Binh Duong,Thu Dau Mot Town,18,420,354,66,33
2022-04-03,Binh Duong,Thu Dau Mot Town,19,461,246,215,180
2022-04-03,Binh Duong,Thu Dau Mot Town,20,357,188,169,136
2022-04-03,Binh Duong,Thu Dau Mot Town,21,192,82,110,83
2022-04-03,Binh Duong,Thu Dau Mot Town,22,2,0,2,0
2022-04-03,Binh Duong,Thuan An,1,1,0,1,0
2022-04-03,Binh Duong,Thuan An,6,1,0,1,1
2022-04-03,Binh Duong,Thuan An,7,3,1,2,2
2022-04-03,Binh Duong,Thuan An,8,16,4,12,7
2022-04-03,Binh Duong,Thuan An,9,34,16,18,15
2022-04-03,Binh Duong,Thuan An,10,58,33,25,17
2022-04-03,Binh Duong,Thuan An,11,79,58,21,12
2022-04-03,Binh Duong,Thuan An,12,56,48,8,5
2022-04-03,Binh Duong,Thuan An,13,59,47,12,8
2022-04-03,Binh Duong,Thuan An,14,57,40,17,12
2022-04-03,Binh Duong,Thuan An,15,37,24,13,10
2022-04-03,Binh Duong,Thuan An,16,44,23,21,19
2022-04-03,Binh Duong,Thuan An,17,47,29,18,12
2022-04-03,Binh Duong,Thuan An,18,48,24,24,23
2022-04-03,Binh Duong,Thuan An,19,78,23,55,46
2022-04-03,Binh Duong,Thuan An,20,50,14,36,32
2022-04-03,Binh Duong,Thuan An,21,21,7,14,10
2022-04-03,Can Tho City,Binh Thuy District,7,2,0,2,1
2022-04-03,Can Tho City,Binh Thuy District,8,3,3,0,0
2022-04-03,Can Tho City,Binh Thuy District,9,10,8,2,0
2022-04-03,Can Tho City,Binh Thuy District,10,6,6,0,0
2022-04-03,Can Tho City,Binh Thuy District,11,8,7,1,0
2022-04-03,Can Tho City,Binh Thuy District,12,15,14,1,0
2022-04-03,Can Tho City,Binh Thuy District,13,14,13,1,0
2022-04-03,Can Tho City,Binh Thuy District,14,15,15,0,0
2022-04-03,Can Tho City,Binh Thuy District,15,16,15,1,0
2022-04-03,Can Tho City,Binh Thuy District,16,14,14,0,0
2022-04-03,Can Tho City,Binh Thuy District,17,10,7,3,0
2022-04-03,Can Tho City,Binh Thuy District,18,19,14,5,0
2022-04-03,Can Tho City,Binh Thuy District,19,12,11,1,0
2022-04-03,Can Tho City,Binh Thuy District,20,9,9,0,0
2022-04-03,Can Tho City,Cai Rang District,1,1,1,0,0
2022-04-03,Can Tho City,Cai Rang District,7,3,3,0,0
2022-04-03,Can Tho City,Cai Rang District,8,5,3,2,0
2022-04-03,Can Tho City,Cai Rang District,9,8,7,1,0
2022-04-03,Can Tho City,Cai Rang District,10,15,14,1,1
2022-04-03,Can Tho City,Cai Rang District,11,17,16,1,1
2022-04-03,Can Tho City,Cai Rang District,12,13,13,0,0
2022-04-03,Can Tho City,Cai Rang District,13,11,11,0,0
2022-04-03,Can Tho City,Cai Rang District,14,8,8,0,0
2022-04-03,Can Tho City,Cai Rang District,15,13,11,2,0
2022-04-03,Can Tho City,Cai Rang District,16,10,8,2,0
2022-04-03,Can Tho City,Cai Rang District,17,13,12,1,0
2022-04-03,Can Tho City,Cai Rang District,18,12,12,0,0
2022-04-03,Can Tho City,Cai Rang District,19,10,9,1,0
2022-04-03,Can Tho City,Cai Rang District,20,19,16,3,0
2022-04-03,Can Tho City,Cai Rang District,21,1,1,0,0
2022-04-03,Can Tho City,Cai Rang District,22,1,0,1,0
2022-04-03,Can Tho City,Ninh Kieu District,0,5,4,1,0
2022-04-03,Can Tho City,Ninh Kieu District,4,1,0,1,0
2022-04-03,Can Tho City,Ninh Kieu District,5,4,2,2,1
2022-04-03,Can Tho City,Ninh Kieu District,6,28,27,1,0
2022-04-03,Can Tho City,Ninh Kieu District,7,135,125,10,2
2022-04-03,Can Tho City,Ninh Kieu District,8,226,209,17,0
2022-04-03,Can Tho City,Ninh Kieu District,9,355,332,23,0
2022-04-03,Can Tho City,Ninh Kieu District,10,593,559,34,0
2022-04-03,Can Tho City,Ninh Kieu District,11,790,755,35,1
2022-04-03,Can Tho City,Ninh Kieu District,12,645,617,28,0
2022-04-03,Can Tho City,Ninh Kieu District,13,530,513,17,0
2022-04-03,Can Tho City,Ninh Kieu District,14,425,400,25,0
2022-04-03,Can Tho City,Ninh Kieu District,15,385,361,24,0
2022-04-03,Can Tho City,Ninh Kieu District,16,435,408,27,0
2022-04-03,Can Tho City,Ninh Kieu District,17,499,479,20,0
2022-04-03,Can Tho City,Ninh Kieu District,18,566,534,32,0
2022-04-03,Can Tho City,Ninh Kieu District,19,466,424,42,7
2022-04-03,Can Tho City,Ninh Kieu District,20,339,314,25,4
2022-04-03,Can Tho City,Ninh Kieu District,21,173,124,49,23
2022-04-03,Can Tho City,Ninh Kieu District,22,1,0,1,0
2022-04-03,Can Tho City,Ninh Kieu District,23,3,2,1,0
2022-04-03,Dong Nai,Bien Hoa City,0,3,2,1,0
2022-04-03,Dong Nai,Bien Hoa City,1,2,2,0,0
2022-04-03,Dong Nai,Bien Hoa City,2,4,2,2,1
2022-04-03,Dong Nai,Bien Hoa City,3,4,1,3,0
2022-04-03,Dong Nai,Bien Hoa City,5,2,2,0,0
2022-04-03,Dong Nai,Bien Hoa City,6,56,32,24,19
2022-04-03,Dong Nai,Bien Hoa City,7,181,124,57,37
2022-04-03,Dong Nai,Bien Hoa City,8,298,249,49,28
2022-04-03,Dong Nai,Bien Hoa City,9,485,407,78,32
2022-04-03,Dong Nai,Bien Hoa City,10,810,694,116,44
2022-04-03,Dong Nai,Bien Hoa City,11,1185,1038,147,65
2022-04-03,Dong Nai,Bien Hoa City,12,1001,878,123,47
2022-04-03,Dong Nai,Bien Hoa City,13,782,686,96,14
2022-04-03,Dong Nai,Bien Hoa City,14,592,524,68,15
2022-04-03,Dong Nai,Bien Hoa City,15,515,452,63,24
2022-04-03,Dong Nai,Bien Hoa City,16,501,436,65,21
2022-04-03,Dong Nai,Bien Hoa City,17,698,543,155,91
2022-04-03,Dong Nai,Bien Hoa City,18,1196,414,782,674
2022-04-03,Dong Nai,Bien Hoa City,19,1091,461,630,531
2022-04-03,Dong Nai,Bien Hoa City,20,767,283,484,414
2022-04-03,Dong Nai,Bien Hoa City,21,258,133,125,64
2022-04-03,Dong Nai,Bien Hoa City,22,2,0,2,0
2022-04-03,Dong Nai,Bien Hoa City,23,1,1,0,0
2022-04-03,Dong Nai,Long Thanh,9,1,0,1,1
2022-04-03,Dong Nai,Long Thanh,10,3,0,3,3
2022-04-03,Dong Nai,Long Thanh,11,3,0,3,3
2022-04-03,Dong Nai,Long Thanh,14,4,0,4,4
2022-04-03,Dong Nai,Long Thanh,16,1,0,1,1
2022-04-03,Dong Nai,Long Thanh,17,3,0,3,2
2022-04-03,Dong Nai,Long Thanh,18,1,0,1,1
2022-04-03,Dong Nai,Long Thanh,19,1,0,1,1
2022-04-03,Dong Nai,Long Thanh,20,1,0,1,0
2022-04-03,Dong Nai,Long Thanh,21,1,0,1,1
2022-04-03,Dong Nai,Nhon trach,12,1,0,1,1
2022-04-03,Dong Nai,Nhon trach,20,1,0,1,0
2022-04-03,Dong Nai,Thong Nhat,10,1,1,0,0
2022-04-03,Dong Nai,Thong Nhat,13,1,1,0,0
2022-04-03,Dong Nai,Thong Nhat,14,1,1,0,0
2022-04-03,Dong Nai,Thong Nhat,15,2,2,0,0
2022-04-03,Dong Nai,Thong Nhat,19,2,0,2,2
2022-04-03,Dong Nai,Thong Nhat,21,1,1,0,0
2022-04-03,Dong Nai,Trang Bom,11,4,0,4,4
2022-04-03,Dong Nai,Trang Bom,12,1,0,1,1
2022-04-03,Dong Nai,Trang Bom,14,1,0,1,1
2022-04-03,Dong Nai,Trang Bom,15,1,0,1,1
2022-04-03,Dong Nai,Trang Bom,18,1,0,1,1
2022-04-03,Dong Nai,Trang Bom,19,1,0,1,1
2022-04-03,Hai Phong City,An Duong,7,2,1,1,0
2022-04-03,Hai Phong City,An Duong,8,3,0,3,3
2022-04-03,Hai Phong City,An Duong,9,5,0,5,5
2022-04-03,Hai Phong City,An Duong,10,11,5,6,5
2022-04-03,Hai Phong City,An Duong,11,7,3,4,2
2022-04-03,Hai Phong City,An Duong,12,6,3,3,3
2022-04-03,Hai Phong City,An Duong,13,4,1,3,1
2022-04-03,Hai Phong City,An Duong,14,6,2,4,3
2022-04-03,Hai Phong City,An Duong,15,4,0,4,2
2022-04-03,Hai Phong City,An Duong,16,5,2,3,3
2022-04-03,Hai Phong City,An Duong,17,3,2,1,1
2022-04-03,Hai Phong City,An Duong,18,1,0,1,1
2022-04-03,Hai Phong City,An Duong,19,2,0,2,2
2022-04-03,Hai Phong City,An Duong,20,2,0,2,2
2022-04-03,Hai Phong City,Do Son District,14,1,0,1,1
2022-04-03,Hai Phong City,Do Son District,17,1,0,1,1
2022-04-03,Hai Phong City,Duong Kinh District,9,1,0,1,1
2022-04-03,Hai Phong City,Duong Kinh District,13,1,0,1,1
2022-04-03,Hai Phong City,Duong Kinh District,14,3,0,3,2
2022-04-03,Hai Phong City,Duong Kinh District,17,1,0,1,1
2022-04-03,Hai Phong City,Hai An District,7,10,4,6,2
2022-04-03,Hai Phong City,Hai An District,8,22,12,10,8
2022-04-03,Hai Phong City,Hai An District,9,17,9,8,5
2022-04-03,Hai Phong City,Hai An District,10,32,24,8,4
2022-04-03,Hai Phong City,Hai An District,11,47,29,18,15
2022-04-03,Hai Phong City,Hai An District,12,38,32,6,5
2022-04-03,Hai Phong City,Hai An District,13,16,12,4,1
2022-04-03,Hai Phong City,Hai An District,14,17,14,3,1
2022-04-03,Hai Phong City,Hai An District,15,19,15,4,1
2022-04-03,Hai Phong City,Hai An District,16,22,18,4,1
2022-04-03,Hai Phong City,Hai An District,17,26,18,8,6
2022-04-03,Hai Phong City,Hai An District,18,29,22,7,3
2022-04-03,Hai Phong City,Hai An District,19,18,14,4,2
2022-04-03,Hai Phong City,Hai An District,20,18,12,6,2
2022-04-03,Hai Phong City,Hai An District,21,14,10,4,2
2022-04-03,Hai Phong City,Hai An District,23,1,1,0,0
2022-04-03,Hai Phong City,Hong Bang District,1,1,0,1,1
2022-04-03,Hai Phong City,Hong Bang District,7,13,6,7,5
2022-04-03,Hai Phong City,Hong Bang District,8,26,14,12,8
2022-04-03,Hai Phong City,Hong Bang District,9,51,23,28,17
2022-04-03,Hai Phong City,Hong Bang District,10,95,58,37,31
2022-04-03,Hai Phong City,Hong Bang District,11,180,81,99,82
2022-04-03,Hai Phong City,Hong Bang District,12,95,64,31,20
2022-04-03,Hai Phong City,Hong Bang District,13,55,51,4,1
2022-04-03,Hai Phong City,Hong Bang District,14,33,26,7,5
2022-04-03,Hai Phong City,Hong Bang District,15,58,46,12,7
2022-04-03,Hai Phong City,Hong Bang District,16,36,25,11,10
2022-04-03,Hai Phong City,Hong Bang District,17,51,44,7,4
2022-04-03,Hai Phong City,Hong Bang District,18,74,53,21,12
2022-04-03,Hai Phong City,Hong Bang District,19,68,41,27,21
2022-04-03,Hai Phong City,Hong Bang District,20,49,27,22,16
2022-04-03,Hai Phong City,Hong Bang District,21,16,8,8,5
2022-04-03,Hai Phong City,Hong Bang District,23,1,1,0,0
2022-04-03,Hai Phong City,Kien An District,6,1,0,1,0
2022-04-03,Hai Phong City,Kien An District,7,5,0,5,5
2022-04-03,Hai Phong City,Kien An District,8,4,2,2,2
2022-04-03,Hai Phong City,Kien An District,9,7,3,4,2
2022-04-03,Hai Phong City,Kien An District,10,16,12,4,3
2022-04-03,Hai Phong City,Kien An District,11,23,17,6,2
2022-04-03,Hai Phong City,Kien An District,12,8,4,4,3
2022-04-03,Hai Phong City,Kien An District,13,10,1,9,7
2022-04-03,Hai Phong City,Kien An District,14,16,8,8,4
2022-04-03,Hai Phong City,Kien An District,15,5,3,2,2
2022-04-03,Hai Phong City,Kien An District,16,10,5,5,2
2022-04-03,Hai Phong City,Kien An District,17,13,7,6,4
2022-04-03,Hai Phong City,Kien An District,18,6,5,1,0
2022-04-03,Hai Phong City,Kien An District,19,13,8,5,4
2022-04-03,Hai Phong City,Kien An District,20,9,5,4,3
2022-04-03,Hai Phong City,Kien An District,21,4,0,4,3
2022-04-03,Hai Phong City,Le Chan District,1,5,2,3,3
2022-04-03,Hai Phong City,Le Chan District,4,1,0,1,1
2022-04-03,Hai Phong City,Le Chan District,6,4,2,2,2
2022-04-03,Hai Phong City,Le Chan District,7,45,27,18,13
2022-04-03,Hai Phong City,Le Chan District,8,101,55,46,30
2022-04-03,Hai Phong City,Le Chan District,9,129,85,44,26
2022-04-03,Hai Phong City,Le Chan District,10,331,193,138,114
2022-04-03,Hai Phong City,Le Chan District,11,519,288,231,177
2022-04-03,Hai Phong City,Le Chan District,12,340,204,136,85
2022-04-03,Hai Phong City,Le Chan District,13,156,142,14,3
2022-04-03,Hai Phong City,Le Chan District,14,163,123,40,21
2022-04-03,Hai Phong City,Le Chan District,15,193,151,42,21
2022-04-03,Hai Phong City,Le Chan District,16,212,171,41,21
2022-04-03,Hai Phong City,Le Chan District,17,221,182,39,11
2022-04-03,Hai Phong City,Le Chan District,18,247,189,58,30
2022-04-03,Hai Phong City,Le Chan District,19,199,133,66,37
2022-04-03,Hai Phong City,Le Chan District,20,147,93,54,35
2022-04-03,Hai Phong City,Le Chan District,21,67,43,24,10
2022-04-03,Hai Phong City,Ngo Quyen District,0,1,1,0,0
2022-04-03,Hai Phong City,Ngo Quyen District,1,2,1,1,1
2022-04-03,Hai Phong City,Ngo Quyen District,6,1,1,0,0
2022-04-03,Hai Phong City,Ngo Quyen District,7,33,17,16,12
2022-04-03,Hai Phong City,Ngo Quyen District,8,89,60,29,22
2022-04-03,Hai Phong City,Ngo Quyen District,9,122,95,27,17
2022-04-03,Hai Phong City,Ngo Quyen District,10,206,137,69,52
2022-04-03,Hai Phong City,Ngo Quyen District,11,410,243,167,119
2022-04-03,Hai Phong City,Ngo Quyen District,12,281,193,88,53
2022-04-03,Hai Phong City,Ngo Quyen District,13,160,139,21,7
2022-04-03,Hai Phong City,Ngo Quyen District,14,148,109,39,21
2022-04-03,Hai Phong City,Ngo Quyen District,15,152,114,38,19
2022-04-03,Hai Phong City,Ngo Quyen District,16,194,154,40,20
2022-04-03,Hai Phong City,Ngo Quyen District,17,183,136,47,26
2022-04-03,Hai Phong City,Ngo Quyen District,18,225,155,70,35
2022-04-03,Hai Phong City,Ngo Quyen District,19,206,160,46,23
2022-04-03,Hai Phong City,Ngo Quyen District,20,155,115,40,19
2022-04-03,Hai Phong City,Ngo Quyen District,21,64,36,28,12
2022-04-03,Hai Phong City,Thuy Nguyen,10,2,0,2,2
2022-04-03,Hai Phong City,Thuy Nguyen,11,2,0,2,2
2022-04-03,Hai Phong City,Thuy Nguyen,12,3,0,3,3
2022-04-03,Hai Phong City,Thuy Nguyen,13,1,0,1,1
2022-04-03,Hai Phong City,Thuy Nguyen,15,2,0,2,2
2022-04-03,Hai Phong City,Thuy Nguyen,16,2,1,1,1
2022-04-03,Hai Phong City,Thuy Nguyen,17,4,1,3,3
2022-04-03,Hai Phong City,Thuy Nguyen,18,2,1,1,1
2022-04-03,Hai Phong City,Thuy Nguyen,19,1,0,1,1
2022-04-03,Hai Phong City,Thuy Nguyen,20,2,0,2,2
2022-04-03,Hai Phong City,Thuy Nguyen,21,3,0,3,3
2022-04-03,Hue City,Hue City,1,3,1,2,0
2022-04-03,Hue City,Hue City,2,2,2,0,0
2022-04-03,Hue City,Hue City,3,1,1,0,0
2022-04-03,Hue City,Hue City,4,1,0,1,0
2022-04-03,Hue City,Hue City,5,3,1,2,0
2022-04-03,Hue City,Hue City,6,74,52,22,13
2022-04-03,Hue City,Hue City,7,270,231,39,8
2022-04-03,Hue City,Hue City,8,426,371,55,12
2022-04-03,Hue City,Hue City,9,379,340,39,0
2022-04-03,Hue City,Hue City,10,562,500,62,2
2022-04-03,Hue City,Hue City,11,758,689,69,4
2022-04-03,Hue City,Hue City,12,606,567,39,0
2022-04-03,Hue City,Hue City,13,378,351,27,0
2022-04-03,Hue City,Hue City,14,382,343,39,3
2022-04-03,Hue City,Hue City,15,507,447,60,4
2022-04-03,Hue City,Hue City,16,566,505,61,3
2022-04-03,Hue City,Hue City,17,736,642,94,10
2022-04-03,Hue City,Hue City,18,907,747,160,53
2022-04-03,Hue City,Hue City,19,710,590,120,39
2022-04-03,Hue City,Hue City,20,479,395,84,12
2022-04-03,Hue City,Hue City,21,227,179,48,8
2022-04-03,Hue City,Hue City,22,4,2,2,0
2022-04-03,Hue City,Hue City,23,1,1,0,0
2022-04-03,Hue City,Huong Thuy,8,1,1,0,0
2022-04-03,Hue City,Huong Thuy,9,2,2,0,0
2022-04-03,Hue City,Huong Thuy,10,1,1,0,0
2022-04-03,Hue City,Huong Thuy,11,1,1,0,0
2022-04-03,Hue City,Huong Thuy,12,2,0,2,0
2022-04-03,Hue City,Huong Thuy,13,1,1,0,0
2022-04-03,Hue City,Huong Thuy,14,1,1,0,0
2022-04-03,Hue City,Huong Thuy,15,1,1,0,0
2022-04-03,Hue City,Huong Thuy,17,2,1,1,1
2022-04-03,Hue City,Huong Thuy,18,2,2,0,0
2022-04-03,Hue City,Huong Tra,15,1,0,1,0
2022-04-03,Hue City,Huong Tra,18,1,1,0,0
2022-04-03,Hue City,Phu Vang,6,1,0,1,0
2022-04-03,Hue City,Phu Vang,7,4,2,2,1
2022-04-03,Hue City,Phu Vang,8,1,0,1,0
2022-04-03,Hue City,Phu Vang,9,1,1,0,0
2022-04-03,Hue City,Phu Vang,10,1,0,1,0
2022-04-03,Hue City,Phu Vang,11,2,2,0,0
2022-04-03,Hue City,Phu Vang,13,3,1,2,0
2022-04-03,Hue City,Phu Vang,19,3,2,1,0
2022-04-03,Hue City,Phu Vang,20,1,0,1,1
2022-04-03,Vung Tau,Ba Ria City,7,1,0,1,1
2022-04-03,Vung Tau,Ba Ria City,8,2,1,1,1
2022-04-03,Vung Tau,Ba Ria City,9,3,1,2,1
2022-04-03,Vung Tau,Ba Ria City,10,6,3,3,1
2022-04-03,Vung Tau,Ba Ria City,11,15,5,10,4
2022-04-03,Vung Tau,Ba Ria City,12,13,3,10,4
2022-04-03,Vung Tau,Ba Ria City,13,13,5,8,5
2022-04-03,Vung Tau,Ba Ria City,14,8,3,5,5
2022-04-03,Vung Tau,Ba Ria City,15,3,3,0,0
2022-04-03,Vung Tau,Ba Ria City,16,4,1,3,3
2022-04-03,Vung Tau,Ba Ria City,17,3,2,1,0
2022-04-03,Vung Tau,Ba Ria City,18,9,2,7,7
2022-04-03,Vung Tau,Ba Ria City,19,7,0,7,7
2022-04-03,Vung Tau,Ba Ria City,20,4,0,4,4
2022-04-03,Vung Tau,Vung Tau City,0,1,0,1,0
2022-04-03,Vung Tau,Vung Tau City,2,1,1,0,0
2022-04-03,Vung Tau,Vung Tau City,4,1,0,1,1
2022-04-03,Vung Tau,Vung Tau City,5,2,2,0,0
2022-04-03,Vung Tau,Vung Tau City,6,48,35,13,9
2022-04-03,Vung Tau,Vung Tau City,7,130,106,24,6
2022-04-03,Vung Tau,Vung Tau City,8,239,201,38,18
2022-04-03,Vung Tau,Vung Tau City,9,289,239,50,17
2022-04-03,Vung Tau,Vung Tau City,10,317,279,38,5
2022-04-03,Vung Tau,Vung Tau City,11,415,367,48,8
2022-04-03,Vung Tau,Vung Tau City,12,390,364,26,4
2022-04-03,Vung Tau,Vung Tau City,13,253,234,19,4
2022-04-03,Vung Tau,Vung Tau City,14,251,232,19,2
2022-04-03,Vung Tau,Vung Tau City,15,222,205,17,2
2022-04-03,Vung Tau,Vung Tau City,16,218,203,15,4
2022-04-03,Vung Tau,Vung Tau City,17,301,266,35,3
2022-04-03,Vung Tau,Vung Tau City,18,376,313,63,25
2022-04-03,Vung Tau,Vung Tau City,19,277,230,47,27
2022-04-03,Vung Tau,Vung Tau City,20,218,172,46,9
2022-04-03,Vung Tau,Vung Tau City,21,94,65,29,11
2022-04-03,Vung Tau,Vung Tau City,22,2,1,1,0
2022-04-03,Vung Tau,Vung Tau City,23,3,3,0,0
2022-04-04,Binh Duong,Ben Cat,12,1,0,1,1
2022-04-04,Binh Duong,Ben Cat,13,1,0,1,1
2022-04-04,Binh Duong,Ben Cat,14,2,0,2,2
2022-04-04,Binh Duong,Ben Cat,19,1,0,1,0
2022-04-04,Binh Duong,Ben Cat,20,3,0,3,3
2022-04-04,Binh Duong,Di An,0,2,1,1,1
2022-04-04,Binh Duong,Di An,6,3,0,3,3
2022-04-04,Binh Duong,Di An,7,6,2,4,4
2022-04-04,Binh Duong,Di An,8,14,6,8,6
2022-04-04,Binh Duong,Di An,9,19,13,6,5
2022-04-04,Binh Duong,Di An,10,40,26,14,5
2022-04-04,Binh Duong,Di An,11,29,22,7,6
2022-04-04,Binh Duong,Di An,12,30,19,11,8
2022-04-04,Binh Duong,Di An,13,43,30,13,9
2022-04-04,Binh Duong,Di An,14,22,18,4,2
2022-04-04,Binh Duong,Di An,15,19,8,11,7
2022-04-04,Binh Duong,Di An,16,12,5,7,6
2022-04-04,Binh Duong,Di An,17,24,16,8,7
2022-04-04,Binh Duong,Di An,18,33,20,13,10
2022-04-04,Binh Duong,Di An,19,32,12,20,18
2022-04-04,Binh Duong,Di An,20,30,9,21,17
2022-04-04,Binh Duong,Di An,21,17,2,15,13
2022-04-04,Binh Duong,Tan Uyen,8,1,0,1,1
2022-04-04,Binh Duong,Tan Uyen,10,4,2,2,2
2022-04-04,Binh Duong,Tan Uyen,11,4,2,2,2
2022-04-04,Binh Duong,Tan Uyen,12,2,1,1,1
2022-04-04,Binh Duong,Tan Uyen,13,2,0,2,2
2022-04-04,Binh Duong,Tan Uyen,14,6,2,4,3
2022-04-04,Binh Duong,Tan Uyen,16,1,0,1,1
2022-04-04,Binh Duong,Tan Uyen,17,5,1,4,4
2022-04-04,Binh Duong,Tan Uyen,18,4,3,1,0
2022-04-04,Binh Duong,Tan Uyen,19,1,0,1,1
2022-04-04,Binh Duong,Tan Uyen,20,3,1,2,2
2022-04-04,Binh Duong,Tan Uyen,21,1,0,1,1
2022-04-04,Binh Duong,Thu Dau Mot Town,0,1,1,0,0
2022-04-04,Binh Duong,Thu Dau Mot Town,1,1,1,0,0
2022-04-04,Binh Duong,Thu Dau Mot Town,2,1,1,0,0
2022-04-04,Binh Duong,Thu Dau Mot Town,3,1,0,1,0
2022-04-04,Binh Duong,Thu Dau Mot Town,4,1,0,1,0
2022-04-04,Binh Duong,Thu Dau Mot Town,5,4,2,2,2
2022-04-04,Binh Duong,Thu Dau Mot Town,6,31,27,4,1
2022-04-04,Binh Duong,Thu Dau Mot Town,7,111,100,11,2
2022-04-04,Binh Duong,Thu Dau Mot Town,8,199,180,19,1
2022-04-04,Binh Duong,Thu Dau Mot Town,9,252,242,10,1
2022-04-04,Binh Duong,Thu Dau Mot Town,10,386,362,24,0
2022-04-04,Binh Duong,Thu Dau Mot Town,11,658,614,44,8
2022-04-04,Binh Duong,Thu Dau Mot Town,12,457,431,26,5
2022-04-04,Binh Duong,Thu Dau Mot Town,13,414,385,29,2
2022-04-04,Binh Duong,Thu Dau Mot Town,14,319,308,11,0
2022-04-04,Binh Duong,Thu Dau Mot Town,15,242,231,11,3
2022-04-04,Binh Duong,Thu Dau Mot Town,16,257,194,63,41
2022-04-04,Binh Duong,Thu Dau Mot Town,17,530,389,141,99
2022-04-04,Binh Duong,Thu Dau Mot Town,18,525,485,40,11
2022-04-04,Binh Duong,Thu Dau Mot Town,19,451,425,26,5
2022-04-04,Binh Duong,Thu Dau Mot Town,20,270,242,28,6
2022-04-04,Binh Duong,Thu Dau Mot Town,21,132,108,24,7
2022-04-04,Binh Duong,Thu Dau Mot Town,22,3,0,3,0
2022-04-04,Binh Duong,Thuan An,0,1,0,1,1
2022-04-04,Binh Duong,Thuan An,1,1,0,1,0
2022-04-04,Binh Duong,Thuan An,6,3,0,3,2
2022-04-04,Binh Duong,Thuan An,7,10,2,8,7
2022-04-04,Binh Duong,Thuan An,8,14,10,4,1
2022-04-04,Binh Duong,Thuan An,9,24,12,12,12
2022-04-04,Binh Duong,Thuan An,10,52,41,11,9
2022-04-04,Binh Duong,Thuan An,11,78,59,19,13
2022-04-04,Binh Duong,Thuan An,12,57,51,6,4
2022-04-04,Binh Duong,Thuan An,13,44,30,14,10
2022-04-04,Binh Duong,Thuan An,14,58,40,18,14
2022-04-04,Binh Duong,Thuan An,15,30,16,14,10
2022-04-04,Binh Duong,Thuan An,16,37,10,27,23
2022-04-04,Binh Duong,Thuan An,17,55,28,27,22
2022-04-04,Binh Duong,Thuan An,18,63,43,20,15
2022-04-04,Binh Duong,Thuan An,19,52,29,23,17
2022-04-04,Binh Duong,Thuan An,20,32,20,12,7
2022-04-04,Binh Duong,Thuan An,21,18,1,17,14
2022-04-04,Can Tho City,Binh Thuy District,0,2,0,2,0
2022-04-04,Can Tho City,Binh Thuy District,1,1,1,0,0
2022-04-04,Can Tho City,Binh Thuy District,2,1,0,1,1
2022-04-04,Can Tho City,Binh Thuy District,7,3,0,3,2
2022-04-04,Can Tho City,Binh Thuy District,8,3,2,1,0
2022-04-04,Can Tho City,Binh Thuy District,9,11,11,0,0
2022-04-04,Can Tho City,Binh Thuy District,10,9,6,3,0
2022-04-04,Can Tho City,Binh Thuy District,11,21,18,3,1
2022-04-04,Can Tho City,Binh Thuy District,12,14,13,1,0
2022-04-04,Can Tho City,Binh Thuy District,13,11,10,1,0
2022-04-04,Can Tho City,Binh Thuy District,14,10,10,0,0
2022-04-04,Can Tho City,Binh Thuy District,15,12,11,1,0
2022-04-04,Can Tho City,Binh Thuy District,16,7,7,0,0
2022-04-04,Can Tho City,Binh Thuy District,17,11,10,1,0
2022-04-04,Can Tho City,Binh Thuy District,18,16,14,2,0
2022-04-04,Can Tho City,Binh Thuy District,19,16,16,0,0
2022-04-04,Can Tho City,Binh Thuy District,20,9,8,1,0
2022-04-04,Can Tho City,Binh Thuy District,21,3,2,1,1
2022-04-04,Can Tho City,Cai Rang District,0,3,2,1,0
2022-04-04,Can Tho City,Cai Rang District,7,3,2,1,1
2022-04-04,Can Tho City,Cai Rang District,8,3,3,0,0
2022-04-04,Can Tho City,Cai Rang District,9,7,6,1,0
2022-04-04,Can Tho City,Cai Rang District,10,9,7,2,1
2022-04-04,Can Tho City,Cai Rang District,11,26,25,1,0
2022-04-04,Can Tho City,Cai Rang District,12,14,11,3,0
2022-04-04,Can Tho City,Cai Rang District,13,13,12,1,0
2022-04-04,Can Tho City,Cai Rang District,14,12,10,2,0
2022-04-04,Can Tho City,Cai Rang District,15,17,12,5,5
2022-04-04,Can Tho City,Cai Rang District,16,16,16,0,0
2022-04-04,Can Tho City,Cai Rang District,17,16,12,4,0
2022-04-04,Can Tho City,Cai Rang District,18,19,18,1,0
2022-04-04,Can Tho City,Cai Rang District,19,19,19,0,0
2022-04-04,Can Tho City,Cai Rang District,20,8,6,2,0
2022-04-04,Can Tho City,Cai Rang District,21,5,2,3,1
2022-04-04,Can Tho City,Cai Rang District,23,1,1,0,0
2022-04-04,Can Tho City,Ninh Kieu District,0,23,15,8,0
2022-04-04,Can Tho City,Ninh Kieu District,1,4,1,3,0
2022-04-04,Can Tho City,Ninh Kieu District,2,4,3,1,0
2022-04-04,Can Tho City,Ninh Kieu District,3,3,2,1,0
2022-04-04,Can Tho City,Ninh Kieu District,4,1,0,1,1
2022-04-04,Can Tho City,Ninh Kieu District,5,3,2,1,1
2022-04-04,Can Tho City,Ninh Kieu District,6,37,36,1,0
2022-04-04,Can Tho City,Ninh Kieu District,7,117,107,10,0
2022-04-04,Can Tho City,Ninh Kieu District,8,263,239,24,0
2022-04-04,Can Tho City,Ninh Kieu District,9,296,269,27,0
2022-04-04,Can Tho City,Ninh Kieu District,10,634,584,50,0
2022-04-04,Can Tho City,Ninh Kieu District,11,995,945,50,0
2022-04-04,Can Tho City,Ninh Kieu District,12,715,681,34,0
2022-04-04,Can Tho City,Ninh Kieu District,13,574,545,29,0
2022-04-04,Can Tho City,Ninh Kieu District,14,432,409,23,0
2022-04-04,Can Tho City,Ninh Kieu District,15,326,309,17,0
2022-04-04,Can Tho City,Ninh Kieu District,16,600,561,39,0
2022-04-04,Can Tho City,Ninh Kieu District,17,723,683,40,1
2022-04-04,Can Tho City,Ninh Kieu District,18,713,673,40,0
2022-04-04,Can Tho City,Ninh Kieu District,19,568,538,30,0
2022-04-04,Can Tho City,Ninh Kieu District,20,434,393,41,0
2022-04-04,Can Tho City,Ninh Kieu District,21,259,227,32,6
2022-04-04,Can Tho City,Ninh Kieu District,22,2,0,2,0
2022-04-04,Can Tho City,Ninh Kieu District,23,5,4,1,0
2022-04-04,Dong Nai,Bien Hoa City,0,3,3,0,0
2022-04-04,Dong Nai,Bien Hoa City,1,4,3,1,0
2022-04-04,Dong Nai,Bien Hoa City,2,2,1,1,0
2022-04-04,Dong Nai,Bien Hoa City,4,1,1,0,0
2022-04-04,Dong Nai,Bien Hoa City,5,3,2,1,0
2022-04-04,Dong Nai,Bien Hoa City,6,41,19,22,18
2022-04-04,Dong Nai,Bien Hoa City,7,162,121,41,23
2022-04-04,Dong Nai,Bien Hoa City,8,279,236,43,11
2022-04-04,Dong Nai,Bien Hoa City,9,378,333,45,3
2022-04-04,Dong Nai,Bien Hoa City,10,706,642,64,9
2022-04-04,Dong Nai,Bien Hoa City,11,1053,952,101,20
2022-04-04,Dong Nai,Bien Hoa City,12,893,822,71,19
2022-04-04,Dong Nai,Bien Hoa City,13,806,734,72,15
2022-04-04,Dong Nai,Bien Hoa City,14,589,541,48,9
2022-04-04,Dong Nai,Bien Hoa City,15,381,296,85,56
2022-04-04,Dong Nai,Bien Hoa City,16,636,413,223,173
2022-04-04,Dong Nai,Bien Hoa City,17,779,636,143,81
2022-04-04,Dong Nai,Bien Hoa City,18,790,648,142,99
2022-04-04,Dong Nai,Bien Hoa City,19,796,582,214,131
2022-04-04,Dong Nai,Bien Hoa City,20,714,362,352,279
2022-04-04,Dong Nai,Bien Hoa City,21,327,145,182,122
2022-04-04,Dong Nai,Bien Hoa City,22,3,1,2,0
2022-04-04,Dong Nai,Bien Hoa City,23,2,1,1,0
2022-04-04,Dong Nai,Long Khanh,11,1,0,1,1
2022-04-04,Dong Nai,Long Khanh,12,1,0,1,1
2022-04-04,Dong Nai,Long Khanh,15,2,0,2,2
2022-04-04,Dong Nai,Long Khanh,16,2,0,2,2
2022-04-04,Dong Nai,Long Thanh,14,2,0,2,2
2022-04-04,Dong Nai,Long Thanh,17,1,0,1,1
2022-04-04,Dong Nai,Long Thanh,18,1,0,1,1
2022-04-04,Dong Nai,Long Thanh,19,1,0,1,0
2022-04-04,Dong Nai,Long Thanh,20,1,0,1,1
2022-04-04,Dong Nai,Nhon trach,10,1,0,1,1
2022-04-04,Dong Nai,Nhon trach,15,1,0,1,1
2022-04-04,Dong Nai,Nhon trach,18,1,0,1,1
2022-04-04,Dong Nai,Nhon trach,19,1,0,1,0
2022-04-04,Dong Nai,Thong Nhat,8,2,2,0,0
2022-04-04,Dong Nai,Thong Nhat,9,1,1,0,0
2022-04-04,Dong Nai,Thong Nhat,11,2,2,0,0
2022-04-04,Dong Nai,Thong Nhat,12,2,2,0,0
2022-04-04,Dong Nai,Thong Nhat,13,4,3,1,0
2022-04-04,Dong Nai,Thong Nhat,15,1,1,0,0
2022-04-04,Dong Nai,Thong Nhat,21,1,1,0,0
2022-04-04,Dong Nai,Trang Bom,10,1,0,1,1
2022-04-04,Dong Nai,Trang Bom,11,1,1,0,0
2022-04-04,Dong Nai,Trang Bom,16,2,1,1,1
2022-04-04,Dong Nai,Trang Bom,21,1,0,1,1
2022-04-04,Hai Phong City,An Duong,0,2,2,0,0
2022-04-04,Hai Phong City,An Duong,8,2,0,2,1
2022-04-04,Hai Phong City,An Duong,9,3,2,1,1
2022-04-04,Hai Phong City,An Duong,10,6,1,5,5
2022-04-04,Hai Phong City,An Duong,11,9,2,7,6
2022-04-04,Hai Phong City,An Duong,12,6,1,5,5
2022-04-04,Hai Phong City,An Duong,13,2,1,1,1
2022-04-04,Hai Phong City,An Duong,14,5,1,4,3
2022-04-04,Hai Phong City,An Duong,15,2,1,1,1
2022-04-04,Hai Phong City,An Duong,16,1,0,1,0
2022-04-04,Hai Phong City,An Duong,17,3,2,1,1
2022-04-04,Hai Phong City,An Duong,18,3,1,2,2
2022-04-04,Hai Phong City,An Duong,19,2,0,2,2
2022-04-04,Hai Phong City,An Duong,21,2,0,2,2
2022-04-04,Hai Phong City,Duong Kinh District,21,1,0,1,1
2022-04-04,Hai Phong City,Hai An District,4,1,0,1,1
2022-04-04,Hai Phong City,Hai An District,7,5,3,2,1
2022-04-04,Hai Phong City,Hai An District,8,11,9,2,2
2022-04-04,Hai Phong City,Hai An District,9,10,6,4,0
2022-04-04,Hai Phong City,Hai An District,10,23,18,5,1
2022-04-04,Hai Phong City,Hai An District,11,43,35,8,4
2022-04-04,Hai Phong City,Hai An District,12,23,18,5,0
2022-04-04,Hai Phong City,Hai An District,13,11,10,1,0
2022-04-04,Hai Phong City,Hai An District,14,18,14,4,2
2022-04-04,Hai Phong City,Hai An District,15,24,21,3,3
2022-04-04,Hai Phong City,Hai An District,16,22,20,2,0
2022-04-04,Hai Phong City,Hai An District,17,21,18,3,0
2022-04-04,Hai Phong City,Hai An District,18,28,26,2,2
2022-04-04,Hai Phong City,Hai An District,19,20,18,2,0
2022-04-04,Hai Phong City,Hai An District,20,10,9,1,0
2022-04-04,Hai Phong City,Hai An District,21,14,11,3,2
2022-04-04,Hai Phong City,Hong Bang District,0,7,2,5,1
2022-04-04,Hai Phong City,Hong Bang District,2,1,0,1,0
2022-04-04,Hai Phong City,Hong Bang District,3,1,0,1,0
2022-04-04,Hai Phong City,Hong Bang District,7,16,12,4,1
2022-04-04,Hai Phong City,Hong Bang District,8,42,29,13,5
2022-04-04,Hai Phong City,Hong Bang District,9,21,18,3,0
2022-04-04,Hai Phong City,Hong Bang District,10,55,48,7,0
2022-04-04,Hai Phong City,Hong Bang District,11,117,98,19,9
2022-04-04,Hai Phong City,Hong Bang District,12,76,65,11,1
2022-04-04,Hai Phong City,Hong Bang District,13,66,62,4,1
2022-04-04,Hai Phong City,Hong Bang District,14,62,52,10,4
2022-04-04,Hai Phong City,Hong Bang District,15,41,38,3,1
2022-04-04,Hai Phong City,Hong Bang District,16,53,50,3,1
2022-04-04,Hai Phong City,Hong Bang District,17,53,50,3,1
2022-04-04,Hai Phong City,Hong Bang District,18,63,55,8,2
2022-04-04,Hai Phong City,Hong Bang District,19,70,61,9,3
2022-04-04,Hai Phong City,Hong Bang District,20,51,46,5,1
2022-04-04,Hai Phong City,Hong Bang District,21,22,11,11,8
2022-04-04,Hai Phong City,Hong Bang District,22,1,1,0,0
2022-04-04,Hai Phong City,Kien An District,7,3,1,2,1
2022-04-04,Hai Phong City,Kien An District,8,5,3,2,2
2022-04-04,Hai Phong City,Kien An District,9,6,2,4,4
2022-04-04,Hai Phong City,Kien An District,10,21,15,6,4
2022-04-04,Hai Phong City,Kien An District,11,17,12,5,2
2022-04-04,Hai Phong City,Kien An District,12,20,15,5,4
2022-04-04,Hai Phong City,Kien An District,13,21,6,15,14
2022-04-04,Hai Phong City,Kien An District,14,18,7,11,7
2022-04-04,Hai Phong City,Kien An District,15,15,8,7,4
2022-04-04,Hai Phong City,Kien An District,16,15,12,3,2
2022-04-04,Hai Phong City,Kien An District,17,9,7,2,2
2022-04-04,Hai Phong City,Kien An District,18,10,7,3,0
2022-04-04,Hai Phong City,Kien An District,19,20,8,12,4
2022-04-04,Hai Phong City,Kien An District,20,24,9,15,10
2022-04-04,Hai Phong City,Kien An District,21,3,2,1,1
2022-04-04,Hai Phong City,Le Chan District,0,10,6,4,0
2022-04-04,Hai Phong City,Le Chan District,1,1,0,1,0
2022-04-04,Hai Phong City,Le Chan District,4,3,1,2,0
2022-04-04,Hai Phong City,Le Chan District,6,6,6,0,0
2022-04-04,Hai Phong City,Le Chan District,7,40,27,13,7
2022-04-04,Hai Phong City,Le Chan District,8,76,57,19,8
2022-04-04,Hai Phong City,Le Chan District,9,83,75,8,0
2022-04-04,Hai Phong City,Le Chan District,10,171,145,26,1
2022-04-04,Hai Phong City,Le Chan District,11,328,302,26,5
2022-04-04,Hai Phong City,Le Chan District,12,245,214,31,1
2022-04-04,Hai Phong City,Le Chan District,13,152,134,18,1
2022-04-04,Hai Phong City,Le Chan District,14,137,119,18,3
2022-04-04,Hai Phong City,Le Chan District,15,189,175,14,0
2022-04-04,Hai Phong City,Le Chan District,16,173,160,13,1
2022-04-04,Hai Phong City,Le Chan District,17,169,160,9,1
2022-04-04,Hai Phong City,Le Chan District,18,266,228,38,1
2022-04-04,Hai Phong City,Le Chan District,19,206,188,18,1
2022-04-04,Hai Phong City,Le Chan District,20,147,128,19,3
2022-04-04,Hai Phong City,Le Chan District,21,83,67,16,8
2022-04-04,Hai Phong City,Le Chan District,22,2,2,0,0
2022-04-04,Hai Phong City,Le Chan District,23,2,1,1,0
2022-04-04,Hai Phong City,Ngo Quyen District,0,1,0,1,0
2022-04-04,Hai Phong City,Ngo Quyen District,4,1,0,1,0
2022-04-04,Hai Phong City,Ngo Quyen District,6,2,2,0,0
2022-04-04,Hai Phong City,Ngo Quyen District,7,22,15,7,5
2022-04-04,Hai Phong City,Ngo Quyen District,8,89,71,18,8
2022-04-04,Hai Phong City,Ngo Quyen District,9,69,58,11,3
2022-04-04,Hai Phong City,Ngo Quyen District,10,152,130,22,4
2022-04-04,Hai Phong City,Ngo Quyen District,11,324,288,36,15
2022-04-04,Hai Phong City,Ngo Quyen District,12,166,149,17,2
2022-04-04,Hai Phong City,Ngo Quyen District,13,194,173,21,1
2022-04-04,Hai Phong City,Ngo Quyen District,14,153,138,15,0
2022-04-04,Hai Phong City,Ngo Quyen District,15,147,130,17,1
2022-04-04,Hai Phong City,Ngo Quyen District,16,187,174,13,2
2022-04-04,Hai Phong City,Ngo Quyen District,17,166,157,9,0
2022-04-04,Hai Phong City,Ngo Quyen District,18,227,198,29,2
2022-04-04,Hai Phong City,Ngo Quyen District,19,231,201,30,5
2022-04-04,Hai Phong City,Ngo Quyen District,20,118,108,10,0
2022-04-04,Hai Phong City,Ngo Quyen District,21,46,40,6,2
2022-04-04,Hai Phong City,Thuy Nguyen,6,1,0,1,0
2022-04-04,Hai Phong City,Thuy Nguyen,10,3,0,3,2
2022-04-04,Hai Phong City,Thuy Nguyen,11,2,0,2,2
2022-04-04,Hai Phong City,Thuy Nguyen,14,1,1,0,0
2022-04-04,Hai Phong City,Thuy Nguyen,15,2,0,2,2
2022-04-04,Hai Phong City,Thuy Nguyen,16,1,0,1,1
2022-04-04,Hai Phong City,Thuy Nguyen,17,3,0,3,3
2022-04-04,Hai Phong City,Thuy Nguyen,18,1,1,0,0
2022-04-04,Hai Phong City,Thuy Nguyen,19,2,0,2,2
2022-04-04,Hai Phong City,Thuy Nguyen,23,1,0,1,0
2022-04-04,Hue City,Hue City,0,44,29,15,2
2022-04-04,Hue City,Hue City,1,8,6,2,1
2022-04-04,Hue City,Hue City,2,2,1,1,0
2022-04-04,Hue City,Hue City,3,1,1,0,0
2022-04-04,Hue City,Hue City,4,1,0,1,1
2022-04-04,Hue City,Hue City,5,5,4,1,0
2022-04-04,Hue City,Hue City,6,66,56,10,2
2022-04-04,Hue City,Hue City,7,179,163,16,3
2022-04-04,Hue City,Hue City,8,309,290,19,2
2022-04-04,Hue City,Hue City,9,261,240,21,2
2022-04-04,Hue City,Hue City,10,334,313,21,0
2022-04-04,Hue City,Hue City,11,722,677,45,2
2022-04-04,Hue City,Hue City,12,504,463,41,0
2022-04-04,Hue City,Hue City,13,314,295,19,1
2022-04-04,Hue City,Hue City,14,334,307,27,2
2022-04-04,Hue City,Hue City,15,398,373,25,3
2022-04-04,Hue City,Hue City,16,440,398,42,4
2022-04-04,Hue City,Hue City,17,656,605,51,0
2022-04-04,Hue City,Hue City,18,770,705,65,2
2022-04-04,Hue City,Hue City,19,758,664,94,16
2022-04-04,Hue City,Hue City,20,588,497,91,22
2022-04-04,Hue City,Hue City,21,295,241,54,8
2022-04-04,Hue City,Hue City,22,5,3,2,0
2022-04-04,Hue City,Hue City,23,1,1,0,0
2022-04-04,Hue City,Huong Thuy,0,2,1,1,0
2022-04-04,Hue City,Huong Thuy,11,1,1,0,0
2022-04-04,Hue City,Huong Thuy,16,1,1,0,0
2022-04-04,Hue City,Huong Thuy,18,2,2,0,0
2022-04-04,Hue City,Huong Thuy,21,1,1,0,0
2022-04-04,Hue City,Huong Tra,11,1,1,0,0
2022-04-04,Hue City,Huong Tra,14,2,0,2,1
2022-04-04,Hue City,Huong Tra,15,2,2,0,0
2022-04-04,Hue City,Phu Vang,8,1,1,0,0
2022-04-04,Hue City,Phu Vang,9,1,1,0,0
2022-04-04,Hue City,Phu Vang,10,2,2,0,0
2022-04-04,Hue City,Phu Vang,12,1,0,1,0
2022-04-04,Hue City,Phu Vang,13,1,0,1,1
2022-04-04,Hue City,Phu Vang,14,3,3,0,0
2022-04-04,Hue City,Phu Vang,15,1,1,0,0
2022-04-04,Hue City,Phu Vang,17,5,4,1,1
2022-04-04,Hue City,Phu Vang,18,3,1,2,1
2022-04-04,Hue City,Phu Vang,19,1,1,0,0
2022-04-04,Hue City,Phu Vang,21,1,1,0,0
2022-04-04,Hue City,Phu Vang,22,1,0,1,0
2022-04-04,Vung Tau,Ba Ria City,7,2,2,0,0
2022-04-04,Vung Tau,Ba Ria City,8,8,1,7,7
2022-04-04,Vung Tau,Ba Ria City,9,4,3,1,1
2022-04-04,Vung Tau,Ba Ria City,10,6,5,1,1
2022-04-04,Vung Tau,Ba Ria City,11,12,10,2,1
2022-04-04,Vung Tau,Ba Ria City,12,12,8,4,2
2022-04-04,Vung Tau,Ba Ria City,13,7,5,2,2
2022-04-04,Vung Tau,Ba Ria City,14,8,7,1,1
2022-04-04,Vung Tau,Ba Ria City,15,8,7,1,0
2022-04-04,Vung Tau,Ba Ria City,16,4,3,1,1
2022-04-04,Vung Tau,Ba Ria City,17,5,4,1,0
2022-04-04,Vung Tau,Ba Ria City,18,2,2,0,0
2022-04-04,Vung Tau,Ba Ria City,19,8,1,7,7
2022-04-04,Vung Tau,Ba Ria City,20,5,0,5,4
2022-04-04,Vung Tau,Ba Ria City,21,3,0,3,3
2022-04-04,Vung Tau,Vung Tau City,0,5,5,0,0
2022-04-04,Vung Tau,Vung Tau City,1,2,2,0,0
2022-04-04,Vung Tau,Vung Tau City,2,1,1,0,0
2022-04-04,Vung Tau,Vung Tau City,5,1,1,0,0
2022-04-04,Vung Tau,Vung Tau City,6,41,34,7,2
2022-04-04,Vung Tau,Vung Tau City,7,86,77,9,1
2022-04-04,Vung Tau,Vung Tau City,8,157,147,10,0
2022-04-04,Vung Tau,Vung Tau City,9,142,136,6,0
2022-04-04,Vung Tau,Vung Tau City,10,194,165,29,13
2022-04-04,Vung Tau,Vung Tau City,11,360,335,25,7
2022-04-04,Vung Tau,Vung Tau City,12,275,253,22,0
2022-04-04,Vung Tau,Vung Tau City,13,205,188,17,3
2022-04-04,Vung Tau,Vung Tau City,14,220,204,16,6
2022-04-04,Vung Tau,Vung Tau City,15,190,175,15,1
2022-04-04,Vung Tau,Vung Tau City,16,205,192,13,0
2022-04-04,Vung Tau,Vung Tau City,17,262,243,19,3
2022-04-04,Vung Tau,Vung Tau City,18,318,272,46,10
2022-04-04,Vung Tau,Vung Tau City,19,266,235,31,6
2022-04-04,Vung Tau,Vung Tau City,20,170,148,22,7
2022-04-04,Vung Tau,Vung Tau City,21,104,77,27,5
2022-04-04,Vung Tau,Vung Tau City,22,1,1,0,0
2022-04-05,Binh Duong,Ben Cat,10,1,0,1,1
2022-04-05,Binh Duong,Ben Cat,13,1,0,1,1
2022-04-05,Binh Duong,Ben Cat,14,1,0,1,1
2022-04-05,Binh Duong,Ben Cat,15,2,0,2,1
2022-04-05,Binh Duong,Ben Cat,17,2,0,2,1
2022-04-05,Binh Duong,Ben Cat,20,1,0,1,1
2022-04-05,Binh Duong,Di An,0,1,0,1,1
2022-04-05,Binh Duong,Di An,1,1,1,0,0
2022-04-05,Binh Duong,Di An,7,9,0,9,5
2022-04-05,Binh Duong,Di An,8,20,4,16,16
2022-04-05,Binh Duong,Di An,9,15,6,9,9
2022-04-05,Binh Duong,Di An,10,14,11,3,1
2022-04-05,Binh Duong,Di An,11,1,0,1,1
2022-04-05,Binh Duong,Di An,12,7,3,4,4
2022-04-05,Binh Duong,Di An,13,23,12,11,10
2022-04-05,Binh Duong,Di An,14,14,9,5,5
2022-04-05,Binh Duong,Di An,15,17,12,5,4
2022-04-05,Binh Duong,Di An,16,20,5,15,15
2022-04-05,Binh Duong,Di An,17,35,9,26,21
2022-04-05,Binh Duong,Di An,18,29,14,15,11
2022-04-05,Binh Duong,Di An,19,16,7,9,7
2022-04-05,Binh Duong,Di An,20,12,2,10,7
2022-04-05,Binh Duong,Di An,21,10,1,9,8
2022-04-05,Binh Duong,Di An,23,1,0,1,0
2022-04-05,Binh Duong,Tan Uyen,8,1,0,1,0
2022-04-05,Binh Duong,Tan Uyen,9,2,1,1,0
2022-04-05,Binh Duong,Tan Uyen,10,4,1,3,3
2022-04-05,Binh Duong,Tan Uyen,12,2,1,1,1
2022-04-05,Binh Duong,Tan Uyen,14,3,1,2,2
2022-04-05,Binh Duong,Tan Uyen,15,2,2,0,0
2022-04-05,Binh Duong,Tan Uyen,17,2,2,0,0
2022-04-05,Binh Duong,Tan Uyen,18,3,1,2,1
2022-04-05,Binh Duong,Tan Uyen,21,1,0,1,1
2022-04-05,Binh Duong,Thu Dau Mot Town,0,1,1,0,0
2022-04-05,Binh Duong,Thu Dau Mot Town,1,2,1,1,0
2022-04-05,Binh Duong,Thu Dau Mot Town,5,2,1,1,1
2022-04-05,Binh Duong,Thu Dau Mot Town,6,33,25,8,2
2022-04-05,Binh Duong,Thu Dau Mot Town,7,123,109,14,1
2022-04-05,Binh Duong,Thu Dau Mot Town,8,193,179,14,1
2022-04-05,Binh Duong,Thu Dau Mot Town,9,211,187,24,8
2022-04-05,Binh Duong,Thu Dau Mot Town,10,340,314,26,3
2022-04-05,Binh Duong,Thu Dau Mot Town,11,22,19,3,0
2022-04-05,Binh Duong,Thu Dau Mot Town,12,210,195,15,3
2022-04-05,Binh Duong,Thu Dau Mot Town,13,406,380,26,6
2022-04-05,Binh Duong,Thu Dau Mot Town,14,332,318,14,2
2022-04-05,Binh Duong,Thu Dau Mot Town,15,241,213,28,5
2022-04-05,Binh Duong,Thu Dau Mot Town,16,230,216,14,2
2022-04-05,Binh Duong,Thu Dau Mot Town,17,357,335,22,5
2022-04-05,Binh Duong,Thu Dau Mot Town,18,337,318,19,2
2022-04-05,Binh Duong,Thu Dau Mot Town,19,306,288,18,0
2022-04-05,Binh Duong,Thu Dau Mot Town,20,208,186,22,5
2022-04-05,Binh Duong,Thu Dau Mot Town,21,100,89,11,2
2022-04-05,Binh Duong,Thu Dau Mot Town,22,5,1,4,0
2022-04-05,Binh Duong,Thuan An,6,4,0,4,2
2022-04-05,Binh Duong,Thuan An,7,6,2,4,4
2022-04-05,Binh Duong,Thuan An,8,19,10,9,3
2022-04-05,Binh Duong,Thuan An,9,38,24,14,12
2022-04-05,Binh Duong,Thuan An,10,48,34,14,12
2022-04-05,Binh Duong,Thuan An,11,3,1,2,2
2022-04-05,Binh Duong,Thuan An,12,30,9,21,11
2022-04-05,Binh Duong,Thuan An,13,58,27,31,25
2022-04-05,Binh Duong,Thuan An,14,45,31,14,8
2022-04-05,Binh Duong,Thuan An,15,36,22,14,11
2022-04-05,Binh Duong,Thuan An,16,30,18,12,10
2022-04-05,Binh Duong,Thuan An,17,24,19,5,4
2022-04-05,Binh Duong,Thuan An,18,57,33,24,16
2022-04-05,Binh Duong,Thuan An,19,21,17,4,2
2022-04-05,Binh Duong,Thuan An,20,33,15,18,13
2022-04-05,Binh Duong,Thuan An,21,10,2,8,8
2022-04-05,Binh Duong,Thuan An,22,1,0,1,0
2022-04-05,Can Tho City,Binh Thuy District,6,1,0,1,0
2022-04-05,Can Tho City,Binh Thuy District,7,2,2,0,0
2022-04-05,Can Tho City,Binh Thuy District,8,3,2,1,0
2022-04-05,Can Tho City,Binh Thuy District,9,8,6,2,0
2022-04-05,Can Tho City,Binh Thuy District,10,11,10,1,0
2022-04-05,Can Tho City,Binh Thuy District,11,1,1,0,0
2022-04-05,Can Tho City,Binh Thuy District,12,3,3,0,0
2022-04-05,Can Tho City,Binh Thuy District,13,9,9,0,0
2022-04-05,Can Tho City,Binh Thuy District,14,11,11,0,0
2022-04-05,Can Tho City,Binh Thuy District,15,23,21,2,0
2022-04-05,Can Tho City,Binh Thuy District,16,11,8,3,1
2022-04-05,Can Tho City,Binh Thuy District,17,19,19,0,0
2022-04-05,Can Tho City,Binh Thuy District,18,15,15,0,0
2022-04-05,Can Tho City,Binh Thuy District,19,11,10,1,0
2022-04-05,Can Tho City,Binh Thuy District,20,12,9,3,2
2022-04-05,Can Tho City,Binh Thuy District,21,3,2,1,0
2022-04-05,Can Tho City,Cai Rang District,6,2,2,0,0
2022-04-05,Can Tho City,Cai Rang District,7,5,4,1,1
2022-04-05,Can Tho City,Cai Rang District,8,3,3,0,0
2022-04-05,Can Tho City,Cai Rang District,9,8,8,0,0
2022-04-05,Can Tho City,Cai Rang District,10,7,7,0,0
2022-04-05,Can Tho City,Cai Rang District,12,3,2,1,1
2022-04-05,Can Tho City,Cai Rang District,13,9,9,0,0
2022-04-05,Can Tho City,Cai Rang District,14,10,6,4,2
2022-04-05,Can Tho City,Cai Rang District,15,8,5,3,2
2022-04-05,Can Tho City,Cai Rang District,16,8,7,1,1
2022-04-05,Can Tho City,Cai Rang District,17,11,10,1,0
2022-04-05,Can Tho City,Cai Rang District,18,17,16,1,0
2022-04-05,Can Tho City,Cai Rang District,19,3,2,1,0
2022-04-05,Can Tho City,Cai Rang District,20,6,6,0,0
2022-04-05,Can Tho City,Cai Rang District,21,4,4,0,0
2022-04-05,Can Tho City,Ninh Kieu District,0,3,2,1,0
2022-04-05,Can Tho City,Ninh Kieu District,1,2,2,0,0
2022-04-05,Can Tho City,Ninh Kieu District,2,2,2,0,0
2022-04-05,Can Tho City,Ninh Kieu District,3,2,2,0,0
2022-04-05,Can Tho City,Ninh Kieu District,5,2,2,0,0
2022-04-05,Can Tho City,Ninh Kieu District,6,56,48,8,1
2022-04-05,Can Tho City,Ninh Kieu District,7,117,108,9,0
2022-04-05,Can Tho City,Ninh Kieu District,8,256,240,16,0
2022-04-05,Can Tho City,Ninh Kieu District,9,304,279,25,0
2022-04-05,Can Tho City,Ninh Kieu District,10,517,491,26,1
2022-04-05,Can Tho City,Ninh Kieu District,11,41,35,6,0
2022-04-05,Can Tho City,Ninh Kieu District,12,267,256,11,0
2022-04-05,Can Tho City,Ninh Kieu District,13,477,447,30,0
2022-04-05,Can Tho City,Ninh Kieu District,14,456,435,21,0
2022-04-05,Can Tho City,Ninh Kieu District,15,400,380,20,0
2022-04-05,Can Tho City,Ninh Kieu District,16,420,393,27,0
2022-04-05,Can Tho City,Ninh Kieu District,17,579,553,26,0
2022-04-05,Can Tho City,Ninh Kieu District,18,595,561,34,0
2022-04-05,Can Tho City,Ninh Kieu District,19,452,419,33,0
2022-04-05,Can Tho City,Ninh Kieu District,20,344,322,22,0
2022-04-05,Can Tho City,Ninh Kieu District,21,174,143,31,5
2022-04-05,Can Tho City,Ninh Kieu District,22,6,3,3,0
2022-04-05,Can Tho City,Ninh Kieu District,23,5,2,3,0
2022-04-05,Dong Nai,Bien Hoa City,0,1,1,0,0
2022-04-05,Dong Nai,Bien Hoa City,2,2,1,1,0
2022-04-05,Dong Nai,Bien Hoa City,3,4,3,1,0
2022-04-05,Dong Nai,Bien Hoa City,4,1,1,0,0
2022-04-05,Dong Nai,Bien Hoa City,5,3,2,1,1
2022-04-05,Dong Nai,Bien Hoa City,6,35,21,14,8
2022-04-05,Dong Nai,Bien Hoa City,7,132,113,19,5
2022-04-05,Dong Nai,Bien Hoa City,8,260,224,36,7
2022-04-05,Dong Nai,Bien Hoa City,9,361,315,46,12
2022-04-05,Dong Nai,Bien Hoa City,10,611,554,57,10
2022-04-05,Dong Nai,Bien Hoa City,11,53,44,9,2
2022-04-05,Dong Nai,Bien Hoa City,12,429,348,81,53
2022-04-05,Dong Nai,Bien Hoa City,13,954,685,269,191
2022-04-05,Dong Nai,Bien Hoa City,14,643,552,91,39
2022-04-05,Dong Nai,Bien Hoa City,15,472,428,44,9
2022-04-05,Dong Nai,Bien Hoa City,16,456,400,56,23
2022-04-05,Dong Nai,Bien Hoa City,17,590,495,95,47
2022-04-05,Dong Nai,Bien Hoa City,18,665,607,58,14
2022-04-05,Dong Nai,Bien Hoa City,19,598,538,60,19
2022-04-05,Dong Nai,Bien Hoa City,20,420,361,59,20
2022-04-05,Dong Nai,Bien Hoa City,21,185,138,47,26
2022-04-05,Dong Nai,Bien Hoa City,22,3,1,2,0
2022-04-05,Dong Nai,Long Khanh,12,1,0,1,1
2022-04-05,Dong Nai,Long Khanh,13,3,0,3,3
2022-04-05,Dong Nai,Long Khanh,14,1,0,1,1
2022-04-05,Dong Nai,Nhon trach,15,1,0,1,1
2022-04-05,Dong Nai,Nhon trach,18,1,0,1,1
2022-04-05,Dong Nai,Nhon trach,20,2,0,2,2
2022-04-05,Dong Nai,Thong Nhat,8,1,1,0,0
2022-04-05,Dong Nai,Thong Nhat,9,1,1,0,0
2022-04-05,Dong Nai,Thong Nhat,10,1,1,0,0
2022-04-05,Dong Nai,Thong Nhat,12,1,0,1,1
2022-04-05,Dong Nai,Thong Nhat,13,7,2,5,4
2022-04-05,Dong Nai,Thong Nhat,14,1,1,0,0
2022-04-05,Dong Nai,Thong Nhat,17,1,1,0,0
2022-04-05,Dong Nai,Thong Nhat,19,1,1,0,0
2022-04-05,Dong Nai,Thong Nhat,20,1,1,0,0
2022-04-05,Dong Nai,Trang Bom,10,1,0,1,1
2022-04-05,Dong Nai,Trang Bom,18,2,1,1,0
2022-04-05,Dong Nai,Trang Bom,19,1,0,1,1
2022-04-05,Dong Nai,Trang Bom,21,1,0,1,1
2022-04-05,Hai Phong City,An Duong,0,1,0,1,1
2022-04-05,Hai Phong City,An Duong,7,1,1,0,0
2022-04-05,Hai Phong City,An Duong,8,2,1,1,1
2022-04-05,Hai Phong City,An Duong,10,4,3,1,1
2022-04-05,Hai Phong City,An Duong,13,5,2,3,2
2022-04-05,Hai Phong City,An Duong,14,10,3,7,7
2022-04-05,Hai Phong City,An Duong,15,6,1,5,5
2022-04-05,Hai Phong City,An Duong,16,2,1,1,0
2022-04-05,Hai Phong City,An Duong,17,1,1,0,0
2022-04-05,Hai Phong City,An Duong,18,1,0,1,1
2022-04-05,Hai Phong City,An Duong,19,9,2,7,4
2022-04-05,Hai Phong City,Do Son District,10,1,0,1,1
2022-04-05,Hai Phong City,Do Son District,14,3,0,3,3
2022-04-05,Hai Phong City,Do Son District,18,2,0,2,1
2022-04-05,Hai Phong City,Duong Kinh District,8,1,0,1,1
2022-04-05,Hai Phong City,Duong Kinh District,9,1,0,1,1
2022-04-05,Hai Phong City,Duong Kinh District,20,1,0,1,1
2022-04-05,Hai Phong City,Duong Kinh District,21,1,0,1,1
2022-04-05,Hai Phong City,Hai An District,6,1,0,1,1
2022-04-05,Hai Phong City,Hai An District,7,4,4,0,0
2022-04-05,Hai Phong City,Hai An District,8,10,8,2,0
2022-04-05,Hai Phong City,Hai An District,9,14,13,1,0
2022-04-05,Hai Phong City,Hai An District,10,21,17,4,0
2022-04-05,Hai Phong City,Hai An District,11,4,3,1,0
2022-04-05,Hai Phong City,Hai An District,12,14,8,6,4
2022-04-05,Hai Phong City,Hai An District,13,16,13,3,3
2022-04-05,Hai Phong City,Hai An District,14,26,19,7,4
2022-04-05,Hai Phong City,Hai An District,15,17,15,2,0
2022-04-05,Hai Phong City,Hai An District,16,15,12,3,1
2022-04-05,Hai Phong City,Hai An District,17,23,20,3,1
2022-04-05,Hai Phong City,Hai An District,18,32,28,4,0
2022-04-05,Hai Phong City,Hai An District,19,21,18,3,1
2022-04-05,Hai Phong City,Hai An District,20,10,5,5,2
2022-04-05,Hai Phong City,Hai An District,21,13,5,8,7
2022-04-05,Hai Phong City,Hai An District,23,1,0,1,0
2022-04-05,Hai Phong City,Hong Bang District,6,1,1,0,0
2022-04-05,Hai Phong City,Hong Bang District,7,16,11,5,1
2022-04-05,Hai Phong City,Hong Bang District,8,31,23,8,6
2022-04-05,Hai Phong City,Hong Bang District,9,26,19,7,1
2022-04-05,Hai Phong City,Hong Bang District,10,66,61,5,1
2022-04-05,Hai Phong City,Hong Bang District,11,7,6,1,1
2022-04-05,Hai Phong City,Hong Bang District,12,35,30,5,4
2022-04-05,Hai Phong City,Hong Bang District,13,68,45,23,19
2022-04-05,Hai Phong City,Hong Bang District,14,75,51,24,10
2022-04-05,Hai Phong City,Hong Bang District,15,55,50,5,0
2022-04-05,Hai Phong City,Hong Bang District,16,34,30,4,2
2022-04-05,Hai Phong City,Hong Bang District,17,25,24,1,0
2022-04-05,Hai Phong City,Hong Bang District,18,45,38,7,2
2022-04-05,Hai Phong City,Hong Bang District,19,60,56,4,0
2022-04-05,Hai Phong City,Hong Bang District,20,31,26,5,1
2022-04-05,Hai Phong City,Hong Bang District,21,12,9,3,2
2022-04-05,Hai Phong City,Hong Bang District,22,1,1,0,0
2022-04-05,Hai Phong City,Kien An District,7,2,2,0,0
2022-04-05,Hai Phong City,Kien An District,8,1,1,0,0
2022-04-05,Hai Phong City,Kien An District,9,4,2,2,0
2022-04-05,Hai Phong City,Kien An District,10,9,5,4,4
2022-04-05,Hai Phong City,Kien An District,12,1,0,1,1
2022-04-05,Hai Phong City,Kien An District,13,7,3,4,3
2022-04-05,Hai Phong City,Kien An District,14,16,7,9,6
2022-04-05,Hai Phong City,Kien An District,15,8,6,2,1
2022-04-05,Hai Phong City,Kien An District,16,3,3,0,0
2022-04-05,Hai Phong City,Kien An District,17,2,2,0,0
2022-04-05,Hai Phong City,Kien An District,18,5,2,3,2
2022-04-05,Hai Phong City,Kien An District,19,9,8,1,1
2022-04-05,Hai Phong City,Kien An District,20,8,8,0,0
2022-04-05,Hai Phong City,Kien An District,21,2,1,1,1
2022-04-05,Hai Phong City,Le Chan District,0,2,1,1,0
2022-04-05,Hai Phong City,Le Chan District,1,1,1,0,0
2022-04-05,Hai Phong City,Le Chan District,2,1,0,1,0
2022-04-05,Hai Phong City,Le Chan District,6,1,0,1,1
2022-04-05,Hai Phong City,Le Chan District,7,27,23,4,0
2022-04-05,Hai Phong City,Le Chan District,8,48,40,8,1
2022-04-05,Hai Phong City,Le Chan District,9,71,60,11,2
2022-04-05,Hai Phong City,Le Chan District,10,161,147,14,0
2022-04-05,Hai Phong City,Le Chan District,11,16,13,3,0
2022-04-05,Hai Phong City,Le Chan District,12,64,58,6,2
2022-04-05,Hai Phong City,Le Chan District,13,135,95,40,13
2022-04-05,Hai Phong City,Le Chan District,14,141,125,16,9
2022-04-05,Hai Phong City,Le Chan District,15,122,109,13,2
2022-04-05,Hai Phong City,Le Chan District,16,138,131,7,0
2022-04-05,Hai Phong City,Le Chan District,17,152,142,10,0
2022-04-05,Hai Phong City,Le Chan District,18,232,202,30,3
2022-04-05,Hai Phong City,Le Chan District,19,186,171,15,1
2022-04-05,Hai Phong City,Le Chan District,20,119,100,19,2
2022-04-05,Hai Phong City,Le Chan District,21,56,41,15,3
2022-04-05,Hai Phong City,Le Chan District,22,1,1,0,0
2022-04-05,Hai Phong City,Ngo Quyen District,0,1,1,0,0
2022-04-05,Hai Phong City,Ngo Quyen District,1,1,0,1,0
2022-04-05,Hai Phong City,Ngo Quyen District,6,4,2,2,0
2022-04-05,Hai Phong City,Ngo Quyen District,7,26,21,5,1
2022-04-05,Hai Phong City,Ngo Quyen District,8,78,66,12,0
2022-04-05,Hai Phong City,Ngo Quyen District,9,70,65,5,0
2022-04-05,Hai Phong City,Ngo Quyen District,10,119,101,18,0
2022-04-05,Hai Phong City,Ngo Quyen District,11,7,6,1,0
2022-04-05,Hai Phong City,Ngo Quyen District,12,69,55,14,7
2022-04-05,Hai Phong City,Ngo Quyen District,13,139,119,20,12
2022-04-05,Hai Phong City,Ngo Quyen District,14,133,110,23,10
2022-04-05,Hai Phong City,Ngo Quyen District,15,141,125,16,1
2022-04-05,Hai Phong City,Ngo Quyen District,16,114,106,8,0
2022-04-05,Hai Phong City,Ngo Quyen District,17,131,114,17,1
2022-04-05,Hai Phong City,Ngo Quyen District,18,136,131,5,2
2022-04-05,Hai Phong City,Ngo Quyen District,19,164,156,8,1
2022-04-05,Hai Phong City,Ngo Quyen District,20,119,114,5,1
2022-04-05,Hai Phong City,Ngo Quyen District,21,67,53,14,4
2022-04-05,Hai Phong City,Ngo Quyen District,22,3,0,3,0
2022-04-05,Hai Phong City,Ngo Quyen District,23,1,1,0,0
2022-04-05,Hai Phong City,Thuy Nguyen,6,1,0,1,0
2022-04-05,Hai Phong City,Thuy Nguyen,17,3,0,3,2
2022-04-05,Hai Phong City,Thuy Nguyen,23,1,0,1,1
2022-04-05,Hue City,Hue City,0,3,3,0,0
2022-04-05,Hue City,Hue City,3,1,1,0,0
2022-04-05,Hue City,Hue City,4,1,1,0,0
2022-04-05,Hue City,Hue City,5,5,4,1,0
2022-04-05,Hue City,Hue City,6,71,58,13,2
2022-04-05,Hue City,Hue City,7,189,176,13,2
2022-04-05,Hue City,Hue City,8,313,292,21,1
2022-04-05,Hue City,Hue City,9,220,203,17,1
2022-04-05,Hue City,Hue City,10,412,384,28,0
2022-04-05,Hue City,Hue City,11,26,22,4,1
2022-04-05,Hue City,Hue City,12,196,178,18,2
2022-04-05,Hue City,Hue City,13,305,285,20,1
2022-04-05,Hue City,Hue City,14,361,343,18,0
2022-04-05,Hue City,Hue City,15,418,393,25,3
2022-04-05,Hue City,Hue City,16,438,393,45,7
2022-04-05,Hue City,Hue City,17,532,495,37,2
2022-04-05,Hue City,Hue City,18,575,545,30,3
2022-04-05,Hue City,Hue City,19,628,568,60,6
2022-04-05,Hue City,Hue City,20,466,395,71,21
2022-04-05,Hue City,Hue City,21,233,194,39,4
2022-04-05,Hue City,Hue City,22,8,2,6,0
2022-04-05,Hue City,Huong Thuy,8,1,1,0,0
2022-04-05,Hue City,Huong Thuy,9,1,0,1,1
2022-04-05,Hue City,Huong Thuy,10,1,1,0,0
2022-04-05,Hue City,Huong Thuy,11,1,1,0,0
2022-04-05,Hue City,Huong Thuy,15,1,1,0,0
2022-04-05,Hue City,Huong Thuy,19,2,0,2,1
2022-04-05,Hue City,Huong Tra,8,1,1,0,0
2022-04-05,Hue City,Phu Vang,6,2,2,0,0
2022-04-05,Hue City,Phu Vang,7,1,1,0,0
2022-04-05,Hue City,Phu Vang,8,4,3,1,0
2022-04-05,Hue City,Phu Vang,9,1,1,0,0
2022-04-05,Hue City,Phu Vang,10,1,1,0,0
2022-04-05,Hue City,Phu Vang,11,1,0,1,0
2022-04-05,Hue City,Phu Vang,13,1,1,0,0
2022-04-05,Hue City,Phu Vang,14,4,3,1,1
2022-04-05,Hue City,Phu Vang,16,5,4,1,1
2022-04-05,Hue City,Phu Vang,18,5,2,3,0
2022-04-05,Hue City,Phu Vang,19,2,1,1,1
2022-04-05,Vung Tau,Ba Ria City,8,4,3,1,1
2022-04-05,Vung Tau,Ba Ria City,9,4,2,2,1
2022-04-05,Vung Tau,Ba Ria City,10,11,9,2,1
2022-04-05,Vung Tau,Ba Ria City,12,2,2,0,0
2022-04-05,Vung Tau,Ba Ria City,13,3,3,0,0
2022-04-05,Vung Tau,Ba Ria City,14,7,4,3,3
2022-04-05,Vung Tau,Ba Ria City,15,8,4,4,1
2022-04-05,Vung Tau,Ba Ria City,16,3,2,1,1
2022-04-05,Vung Tau,Ba Ria City,17,3,3,0,0
2022-04-05,Vung Tau,Ba Ria City,18,5,2,3,0
2022-04-05,Vung Tau,Ba Ria City,19,5,1,4,4
2022-04-05,Vung Tau,Vung Tau City,1,2,2,0,0
2022-04-05,Vung Tau,Vung Tau City,2,1,1,0,0
2022-04-05,Vung Tau,Vung Tau City,4,3,0,3,0
2022-04-05,Vung Tau,Vung Tau City,5,3,1,2,1
2022-04-05,Vung Tau,Vung Tau City,6,38,30,8,3
2022-04-05,Vung Tau,Vung Tau City,7,85,77,8,0
2022-04-05,Vung Tau,Vung Tau City,8,121,111,10,1
2022-04-05,Vung Tau,Vung Tau City,9,133,115,18,1
2022-04-05,Vung Tau,Vung Tau City,10,162,152,10,1
2022-04-05,Vung Tau,Vung Tau City,11,10,9,1,0
2022-04-05,Vung Tau,Vung Tau City,12,158,128,30,15
2022-04-05,Vung Tau,Vung Tau City,13,209,193,16,1
2022-04-05,Vung Tau,Vung Tau City,14,221,203,18,1
2022-04-05,Vung Tau,Vung Tau City,15,208,194,14,6
2022-04-05,Vung Tau,Vung Tau City,16,182,171,11,1
2022-04-05,Vung Tau,Vung Tau City,17,261,245,16,0
2022-04-05,Vung Tau,Vung Tau City,18,242,219,23,1
2022-04-05,Vung Tau,Vung Tau City,19,244,224,20,7
2022-04-05,Vung Tau,Vung Tau City,20,159,142,17,2
2022-04-05,Vung Tau,Vung Tau City,21,88,76,12,4
2022-04-05,Vung Tau,Vung Tau City,22,2,1,1,0
2022-04-05,Vung Tau,Vung Tau City,23,1,0,1,0
2022-04-06,Binh Duong,Ben Cat,11,1,1,0,0
2022-04-06,Binh Duong,Ben Cat,14,1,1,0,0
2022-04-06,Binh Duong,Ben Cat,16,1,0,1,1
2022-04-06,Binh Duong,Ben Cat,19,1,0,1,1
2022-04-06,Binh Duong,Di An,0,1,0,1,1
2022-04-06,Binh Duong,Di An,7,6,2,4,4
2022-04-06,Binh Duong,Di An,8,13,6,7,6
2022-04-06,Binh Duong,Di An,9,18,12,6,4
2022-04-06,Binh Duong,Di An,10,19,14,5,4
2022-04-06,Binh Duong,Di An,11,31,18,13,8
2022-04-06,Binh Duong,Di An,12,37,22,15,10
2022-04-06,Binh Duong,Di An,13,23,14,9,9
2022-04-06,Binh Duong,Di An,14,23,10,13,10
2022-04-06,Binh Duong,Di An,15,17,11,6,4
2022-04-06,Binh Duong,Di An,16,15,9,6,5
2022-04-06,Binh Duong,Di An,17,25,16,9,3
2022-04-06,Binh Duong,Di An,18,23,16,7,5
2022-04-06,Binh Duong,Di An,19,18,9,9,4
2022-04-06,Binh Duong,Di An,20,23,9,14,12
2022-04-06,Binh Duong,Di An,21,13,2,11,6
2022-04-06,Binh Duong,Tan Uyen,9,1,1,0,0
2022-04-06,Binh Duong,Tan Uyen,10,2,1,1,1
2022-04-06,Binh Duong,Tan Uyen,11,2,1,1,1
2022-04-06,Binh Duong,Tan Uyen,12,1,1,0,0
2022-04-06,Binh Duong,Tan Uyen,13,3,1,2,1
2022-04-06,Binh Duong,Tan Uyen,14,2,1,1,1
2022-04-06,Binh Duong,Tan Uyen,16,1,1,0,0
2022-04-06,Binh Duong,Tan Uyen,17,1,1,0,0
2022-04-06,Binh Duong,Tan Uyen,18,1,0,1,1
2022-04-06,Binh Duong,Tan Uyen,19,1,0,1,1
2022-04-06,Binh Duong,Tan Uyen,20,1,1,0,0
2022-04-06,Binh Duong,Tan Uyen,21,1,0,1,0
2022-04-06,Binh Duong,Thu Dau Mot Town,0,1,1,0,0
2022-04-06,Binh Duong,Thu Dau Mot Town,1,2,1,1,0
2022-04-06,Binh Duong,Thu Dau Mot Town,4,1,1,0,0
2022-04-06,Binh Duong,Thu Dau Mot Town,5,3,1,2,1
2022-04-06,Binh Duong,Thu Dau Mot Town,6,38,33,5,4
2022-04-06,Binh Duong,Thu Dau Mot Town,7,99,95,4,1
2022-04-06,Binh Duong,Thu Dau Mot Town,8,176,167,9,0
2022-04-06,Binh Duong,Thu Dau Mot Town,9,198,184,14,0
2022-04-06,Binh Duong,Thu Dau Mot Town,10,373,352,21,4
2022-04-06,Binh Duong,Thu Dau Mot Town,11,614,580,34,5
2022-04-06,Binh Duong,Thu Dau Mot Town,12,417,387,30,1
2022-04-06,Binh Duong,Thu Dau Mot Town,13,409,392,17,2
2022-04-06,Binh Duong,Thu Dau Mot Town,14,329,303,26,4
2022-04-06,Binh Duong,Thu Dau Mot Town,15,286,261,25,3
2022-04-06,Binh Duong,Thu Dau Mot Town,16,256,238,18,1
2022-04-06,Binh Duong,Thu Dau Mot Town,17,310,304,6,1
2022-04-06,Binh Duong,Thu Dau Mot Town,18,351,332,19,2
2022-04-06,Binh Duong,Thu Dau Mot Town,19,279,251,28,7
2022-04-06,Binh Duong,Thu Dau Mot Town,20,231,212,19,3
2022-04-06,Binh Duong,Thu Dau Mot Town,21,89,81,8,4
2022-04-06,Binh Duong,Thu Dau Mot Town,22,1,1,0,0
2022-04-06,Binh Duong,Thu Dau Mot Town,23,1,0,1,0
2022-04-06,Binh Duong,Thuan An,6,2,0,2,2
2022-04-06,Binh Duong,Thuan An,7,4,3,1,1
2022-04-06,Binh Duong,Thuan An,8,14,8,6,1
2022-04-06,Binh Duong,Thuan An,9,35,23,12,8
2022-04-06,Binh Duong,Thuan An,10,61,45,16,11
2022-04-06,Binh Duong,Thuan An,11,85,52,33,20
2022-04-06,Binh Duong,Thuan An,12,59,41,18,13
2022-04-06,Binh Duong,Thuan An,13,51,33,18,15
2022-04-06,Binh Duong,Thuan An,14,44,23,21,16
2022-04-06,Binh Duong,Thuan An,15,44,28,16,12
2022-04-06,Binh Duong,Thuan An,16,29,19,10,2
2022-04-06,Binh Duong,Thuan An,17,32,24,8,6
2022-04-06,Binh Duong,Thuan An,18,44,32,12,4
2022-04-06,Binh Duong,Thuan An,19,32,25,7,4
2022-04-06,Binh Duong,Thuan An,20,16,9,7,4
2022-04-06,Binh Duong,Thuan An,21,18,6,12,9
2022-04-06,Can Tho City,Binh Thuy District,2,1,0,1,0
2022-04-06,Can Tho City,Binh Thuy District,6,1,0,1,1
2022-04-06,Can Tho City,Binh Thuy District,7,2,2,0,0
2022-04-06,Can Tho City,Binh Thuy District,8,8,6,2,0
2022-04-06,Can Tho City,Binh Thuy District,9,5,4,1,0
2022-04-06,Can Tho City,Binh Thuy District,10,15,15,0,0
2022-04-06,Can Tho City,Binh Thuy District,11,14,12,2,0
2022-04-06,Can Tho City,Binh Thuy District,12,13,12,1,0
2022-04-06,Can Tho City,Binh Thuy District,13,8,6,2,0
2022-04-06,Can Tho City,Binh Thuy District,14,10,9,1,0
2022-04-06,Can Tho City,Binh Thuy District,15,9,9,0,0
2022-04-06,Can Tho City,Binh Thuy District,16,11,8,3,3
2022-04-06,Can Tho City,Binh Thuy District,17,15,15,0,0
2022-04-06,Can Tho City,Binh Thuy District,18,14,14,0,0
2022-04-06,Can Tho City,Binh Thuy District,19,13,13,0,0
2022-04-06,Can Tho City,Binh Thuy District,20,4,3,1,0
2022-04-06,Can Tho City,Binh Thuy District,21,2,1,1,0
2022-04-06,Can Tho City,Cai Rang District,2,1,1,0,0
2022-04-06,Can Tho City,Cai Rang District,7,2,2,0,0
2022-04-06,Can Tho City,Cai Rang District,8,3,1,2,0
2022-04-06,Can Tho City,Cai Rang District,9,5,5,0,0
2022-04-06,Can Tho City,Cai Rang District,10,8,8,0,0
2022-04-06,Can Tho City,Cai Rang District,11,13,9,4,0
2022-04-06,Can Tho City,Cai Rang District,12,9,7,2,1
2022-04-06,Can Tho City,Cai Rang District,13,14,13,1,1
2022-04-06,Can Tho City,Cai Rang District,14,10,9,1,0
2022-04-06,Can Tho City,Cai Rang District,15,13,12,1,1
2022-04-06,Can Tho City,Cai Rang District,16,6,6,0,0
2022-04-06,Can Tho City,Cai Rang District,17,17,17,0,0
2022-04-06,Can Tho City,Cai Rang District,18,9,9,0,0
2022-04-06,Can Tho City,Cai Rang District,19,9,7,2,0
2022-04-06,Can Tho City,Cai Rang District,20,3,3,0,0
2022-04-06,Can Tho City,Cai Rang District,21,6,5,1,0
2022-04-06,Can Tho City,Ninh Kieu District,0,6,4,2,0
2022-04-06,Can Tho City,Ninh Kieu District,1,1,0,1,0
2022-04-06,Can Tho City,Ninh Kieu District,2,1,0,1,0
2022-04-06,Can Tho City,Ninh Kieu District,3,1,1,0,0
2022-04-06,Can Tho City,Ninh Kieu District,4,1,1,0,0
2022-04-06,Can Tho City,Ninh Kieu District,5,3,2,1,0
2022-04-06,Can Tho City,Ninh Kieu District,6,65,52,13,6
2022-04-06,Can Tho City,Ninh Kieu District,7,124,119,5,0
2022-04-06,Can Tho City,Ninh Kieu District,8,223,203,20,0
2022-04-06,Can Tho City,Ninh Kieu District,9,315,299,16,0
2022-04-06,Can Tho City,Ninh Kieu District,10,526,505,21,0
2022-04-06,Can Tho City,Ninh Kieu District,11,877,846,31,0
2022-04-06,Can Tho City,Ninh Kieu District,12,591,563,28,0
2022-04-06,Can Tho City,Ninh Kieu District,13,437,420,17,0
2022-04-06,Can Tho City,Ninh Kieu District,14,395,372,23,0
2022-04-06,Can Tho City,Ninh Kieu District,15,346,335,11,0
2022-04-06,Can Tho City,Ninh Kieu District,16,396,368,28,2
2022-04-06,Can Tho City,Ninh Kieu District,17,572,534,38,0
2022-04-06,Can Tho City,Ninh Kieu District,18,575,540,35,1
2022-04-06,Can Tho City,Ninh Kieu District,19,447,422,25,0
2022-04-06,Can Tho City,Ninh Kieu District,20,392,367,25,0
2022-04-06,Can Tho City,Ninh Kieu District,21,185,172,13,0
2022-04-06,Can Tho City,Ninh Kieu District,22,7,3,4,0
2022-04-06,Can Tho City,Ninh Kieu District,23,3,3,0,0
2022-04-06,Dong Nai,Bien Hoa City,0,2,1,1,0
2022-04-06,Dong Nai,Bien Hoa City,1,3,1,2,0
2022-04-06,Dong Nai,Bien Hoa City,2,1,0,1,0
2022-04-06,Dong Nai,Bien Hoa City,4,2,1,1,0
2022-04-06,Dong Nai,Bien Hoa City,5,3,3,0,0
2022-04-06,Dong Nai,Bien Hoa City,6,36,22,14,10
2022-04-06,Dong Nai,Bien Hoa City,7,135,112,23,12
2022-04-06,Dong Nai,Bien Hoa City,8,248,230,18,4
2022-04-06,Dong Nai,Bien Hoa City,9,348,309,39,3
2022-04-06,Dong Nai,Bien Hoa City,10,640,595,45,10
2022-04-06,Dong Nai,Bien Hoa City,11,1032,942,90,28
2022-04-06,Dong Nai,Bien Hoa City,12,747,687,60,10
2022-04-06,Dong Nai,Bien Hoa City,13,763,703,60,9
2022-04-06,Dong Nai,Bien Hoa City,14,544,502,42,4
2022-04-06,Dong Nai,Bien Hoa City,15,457,425,32,6
2022-04-06,Dong Nai,Bien Hoa City,16,418,383,35,4
2022-04-06,Dong Nai,Bien Hoa City,17,523,485,38,11
2022-04-06,Dong Nai,Bien Hoa City,18,569,526,43,8
2022-04-06,Dong Nai,Bien Hoa City,19,506,471,35,5
2022-04-06,Dong Nai,Bien Hoa City,20,420,352,68,24
2022-04-06,Dong Nai,Bien Hoa City,21,191,135,56,22
2022-04-06,Dong Nai,Bien Hoa City,22,1,0,1,0
2022-04-06,Dong Nai,Bien Hoa City,23,3,0,3,1
2022-04-06,Dong Nai,Long Thanh,12,1,0,1,1
2022-04-06,Dong Nai,Long Thanh,13,1,0,1,1
2022-04-06,Dong Nai,Long Thanh,18,1,0,1,1
2022-04-06,Dong Nai,Long Thanh,19,1,0,1,0
2022-04-06,Dong Nai,Nhon trach,11,2,0,2,2
2022-04-06,Dong Nai,Nhon trach,12,1,0,1,1
2022-04-06,Dong Nai,Nhon trach,13,1,0,1,1
2022-04-06,Dong Nai,Nhon trach,16,1,0,1,1
2022-04-06,Dong Nai,Nhon trach,17,1,0,1,1
2022-04-06,Dong Nai,Nhon trach,19,1,0,1,1
2022-04-06,Dong Nai,Nhon trach,20,5,0,5,3
2022-04-06,Dong Nai,Thong Nhat,8,1,1,0,0
2022-04-06,Dong Nai,Thong Nhat,9,1,1,0,0
2022-04-06,Dong Nai,Thong Nhat,10,2,2,0,0
2022-04-06,Dong Nai,Thong Nhat,12,1,1,0,0
2022-04-06,Dong Nai,Thong Nhat,13,1,1,0,0
2022-04-06,Dong Nai,Thong Nhat,18,1,1,0,0
2022-04-06,Dong Nai,Thong Nhat,21,1,1,0,0
2022-04-06,Dong Nai,Trang Bom,13,2,0,2,2
2022-04-06,Dong Nai,Trang Bom,15,1,0,1,1
2022-04-06,Hai Phong City,An Duong,7,2,1,1,1
2022-04-06,Hai Phong City,An Duong,8,1,0,1,1
2022-04-06,Hai Phong City,An Duong,9,2,1,1,1
2022-04-06,Hai Phong City,An Duong,10,7,3,4,1
2022-04-06,Hai Phong City,An Duong,11,2,1,1,0
2022-04-06,Hai Phong City,An Duong,12,8,1,7,7
2022-04-06,Hai Phong City,An Duong,13,6,1,5,5
2022-04-06,Hai Phong City,An Duong,14,9,1,8,7
2022-04-06,Hai Phong City,An Duong,15,5,1,4,4
2022-04-06,Hai Phong City,An Duong,16,1,1,0,0
2022-04-06,Hai Phong City,An Duong,17,1,0,1,0
2022-04-06,Hai Phong City,An Duong,18,3,0,3,1
2022-04-06,Hai Phong City,An Duong,19,4,1,3,2
2022-04-06,Hai Phong City,Do Son District,8,2,0,2,1
2022-04-06,Hai Phong City,Do Son District,11,1,0,1,1
2022-04-06,Hai Phong City,Duong Kinh District,12,1,0,1,1
2022-04-06,Hai Phong City,Duong Kinh District,20,1,0,1,1
2022-04-06,Hai Phong City,Duong Kinh District,21,1,0,1,0
2022-04-06,Hai Phong City,Hai An District,7,3,3,0,0
2022-04-06,Hai Phong City,Hai An District,8,18,10,8,4
2022-04-06,Hai Phong City,Hai An District,9,8,7,1,1
2022-04-06,Hai Phong City,Hai An District,10,21,18,3,0
2022-04-06,Hai Phong City,Hai An District,11,43,40,3,1
2022-04-06,Hai Phong City,Hai An District,12,25,23,2,0
2022-04-06,Hai Phong City,Hai An District,13,15,13,2,1
2022-04-06,Hai Phong City,Hai An District,14,11,10,1,0
2022-04-06,Hai Phong City,Hai An District,15,21,16,5,3
2022-04-06,Hai Phong City,Hai An District,16,20,17,3,0
2022-04-06,Hai Phong City,Hai An District,17,24,21,3,0
2022-04-06,Hai Phong City,Hai An District,18,24,24,0,0
2022-04-06,Hai Phong City,Hai An District,19,17,17,0,0
2022-04-06,Hai Phong City,Hai An District,20,19,12,7,3
2022-04-06,Hai Phong City,Hai An District,21,9,7,2,1
2022-04-06,Hai Phong City,Hai An District,22,1,0,1,0
2022-04-06,Hai Phong City,Hong Bang District,7,11,9,2,1
2022-04-06,Hai Phong City,Hong Bang District,8,31,28,3,3
2022-04-06,Hai Phong City,Hong Bang District,9,25,22,3,0
2022-04-06,Hai Phong City,Hong Bang District,10,56,44,12,0
2022-04-06,Hai Phong City,Hong Bang District,11,116,99,17,3
2022-04-06,Hai Phong City,Hong Bang District,12,52,50,2,1
2022-04-06,Hai Phong City,Hong Bang District,13,35,34,1,0
2022-04-06,Hai Phong City,Hong Bang District,14,41,30,11,6
2022-04-06,Hai Phong City,Hong Bang District,15,45,42,3,0
2022-04-06,Hai Phong City,Hong Bang District,16,36,32,4,1
2022-04-06,Hai Phong City,Hong Bang District,17,39,37,2,1
2022-04-06,Hai Phong City,Hong Bang District,18,52,47,5,0
2022-04-06,Hai Phong City,Hong Bang District,19,45,38,7,1
2022-04-06,Hai Phong City,Hong Bang District,20,25,19,6,0
2022-04-06,Hai Phong City,Hong Bang District,21,15,10,5,2
2022-04-06,Hai Phong City,Hong Bang District,23,1,0,1,0
2022-04-06,Hai Phong City,Kien An District,8,7,1,6,5
2022-04-06,Hai Phong City,Kien An District,9,6,5,1,1
2022-04-06,Hai Phong City,Kien An District,10,6,4,2,1
2022-04-06,Hai Phong City,Kien An District,11,8,7,1,0
2022-04-06,Hai Phong City,Kien An District,12,11,10,1,1
2022-04-06,Hai Phong City,Kien An District,13,10,5,5,5
2022-04-06,Hai Phong City,Kien An District,14,4,3,1,0
2022-04-06,Hai Phong City,Kien An District,15,6,2,4,2
2022-04-06,Hai Phong City,Kien An District,16,2,2,0,0
2022-04-06,Hai Phong City,Kien An District,17,4,3,1,0
2022-04-06,Hai Phong City,Kien An District,18,10,8,2,2
2022-04-06,Hai Phong City,Kien An District,19,8,7,1,0
2022-04-06,Hai Phong City,Kien An District,20,8,6,2,1
2022-04-06,Hai Phong City,Kien An District,21,9,4,5,3
2022-04-06,Hai Phong City,Le Chan District,0,1,1,0,0
2022-04-06,Hai Phong City,Le Chan District,1,1,1,0,0
2022-04-06,Hai Phong City,Le Chan District,5,1,1,0,0
2022-04-06,Hai Phong City,Le Chan District,7,26,24,2,1
2022-04-06,Hai Phong City,Le Chan District,8,76,67,9,1
2022-04-06,Hai Phong City,Le Chan District,9,48,45,3,0
2022-04-06,Hai Phong City,Le Chan District,10,144,132,12,0
2022-04-06,Hai Phong City,Le Chan District,11,270,241,29,8
2022-04-06,Hai Phong City,Le Chan District,12,180,161,19,2
2022-04-06,Hai Phong City,Le Chan District,13,107,96,11,4
2022-04-06,Hai Phong City,Le Chan District,14,132,116,16,2
2022-04-06,Hai Phong City,Le Chan District,15,115,105,10,3
2022-04-06,Hai Phong City,Le Chan District,16,120,106,14,1
2022-04-06,Hai Phong City,Le Chan District,17,147,137,10,1
2022-04-06,Hai Phong City,Le Chan District,18,209,184,25,4
2022-04-06,Hai Phong City,Le Chan District,19,161,141,20,1
2022-04-06,Hai Phong City,Le Chan District,20,121,97,24,2
2022-04-06,Hai Phong City,Le Chan District,21,64,46,18,6
2022-04-06,Hai Phong City,Ngo Quyen District,0,6,4,2,0
2022-04-06,Hai Phong City,Ngo Quyen District,1,5,3,2,0
2022-04-06,Hai Phong City,Ngo Quyen District,6,4,2,2,2
2022-04-06,Hai Phong City,Ngo Quyen District,7,16,16,0,0
2022-04-06,Hai Phong City,Ngo Quyen District,8,77,67,10,1
2022-04-06,Hai Phong City,Ngo Quyen District,9,87,80,7,1
2022-04-06,Hai Phong City,Ngo Quyen District,10,136,117,19,2
2022-04-06,Hai Phong City,Ngo Quyen District,11,268,240,28,8
2022-04-06,Hai Phong City,Ngo Quyen District,12,157,147,10,2
2022-04-06,Hai Phong City,Ngo Quyen District,13,125,113,12,2
2022-04-06,Hai Phong City,Ngo Quyen District,14,144,127,17,2
2022-04-06,Hai Phong City,Ngo Quyen District,15,114,102,12,2
2022-04-06,Hai Phong City,Ngo Quyen District,16,129,114,15,1
2022-04-06,Hai Phong City,Ngo Quyen District,17,136,124,12,0
2022-04-06,Hai Phong City,Ngo Quyen District,18,167,159,8,0
2022-04-06,Hai Phong City,Ngo Quyen District,19,143,128,15,1
2022-04-06,Hai Phong City,Ngo Quyen District,20,143,123,20,2
2022-04-06,Hai Phong City,Ngo Quyen District,21,52,33,19,8
2022-04-06,Hai Phong City,Ngo Quyen District,22,1,1,0,0
2022-04-06,Hai Phong City,Ngo Quyen District,23,1,0,1,0
2022-04-06,Hai Phong City,Thuy Nguyen,6,1,0,1,1
2022-04-06,Hai Phong City,Thuy Nguyen,10,2,0,2,1
2022-04-06,Hai Phong City,Thuy Nguyen,13,1,1,0,0
2022-04-06,Hai Phong City,Thuy Nguyen,17,1,0,1,1
2022-04-06,Hai Phong City,Thuy Nguyen,18,1,0,1,1
2022-04-06,Hue City,Hue City,0,4,4,0,0
2022-04-06,Hue City,Hue City,1,1,1,0,0
2022-04-06,Hue City,Hue City,2,5,3,2,0
2022-04-06,Hue City,Hue City,3,2,1,1,0
2022-04-06,Hue City,Hue City,5,5,4,1,1
2022-04-06,Hue City,Hue City,6,78,58,20,5
2022-04-06,Hue City,Hue City,7,141,129,12,1
2022-04-06,Hue City,Hue City,8,287,273,14,1
2022-04-06,Hue City,Hue City,9,229,210,19,1
2022-04-06,Hue City,Hue City,10,376,354,22,2
2022-04-06,Hue City,Hue City,11,787,740,47,4
2022-04-06,Hue City,Hue City,12,507,480,27,1
2022-04-06,Hue City,Hue City,13,288,270,18,1
2022-04-06,Hue City,Hue City,14,310,291,19,3
2022-04-06,Hue City,Hue City,15,374,347,27,3
2022-04-06,Hue City,Hue City,16,360,341,19,1
2022-04-06,Hue City,Hue City,17,466,438,28,1
2022-04-06,Hue City,Hue City,18,588,558,30,1
2022-04-06,Hue City,Hue City,19,534,501,33,0
2022-04-06,Hue City,Hue City,20,382,354,28,3
2022-04-06,Hue City,Hue City,21,241,209,32,5
2022-04-06,Hue City,Hue City,22,7,2,5,0
2022-04-06,Hue City,Hue City,23,3,3,0,0
2022-04-06,Hue City,Huong Thuy,8,1,0,1,1
2022-04-06,Hue City,Huong Thuy,9,4,1,3,2
2022-04-06,Hue City,Huong Thuy,12,2,1,1,0
2022-04-06,Hue City,Huong Thuy,15,2,0,2,0
2022-04-06,Hue City,Huong Thuy,18,2,1,1,1
2022-04-06,Hue City,Huong Thuy,19,1,1,0,0
2022-04-06,Hue City,Huong Thuy,21,2,0,2,0
2022-04-06,Hue City,Huong Tra,12,1,1,0,0
2022-04-06,Hue City,Huong Tra,20,1,0,1,1
2022-04-06,Hue City,Phu Vang,6,1,1,0,0
2022-04-06,Hue City,Phu Vang,7,6,3,3,1
2022-04-06,Hue City,Phu Vang,8,1,1,0,0
2022-04-06,Hue City,Phu Vang,9,2,0,2,0
2022-04-06,Hue City,Phu Vang,10,1,1,0,0
2022-04-06,Hue City,Phu Vang,11,2,2,0,0
2022-04-06,Hue City,Phu Vang,12,6,2,4,2
2022-04-06,Hue City,Phu Vang,13,1,0,1,1
2022-04-06,Hue City,Phu Vang,16,2,2,0,0
2022-04-06,Hue City,Phu Vang,17,3,2,1,0
2022-04-06,Hue City,Phu Vang,18,3,2,1,0
2022-04-06,Hue City,Phu Vang,20,1,0,1,0
2022-04-06,Hue City,Phu Vang,21,2,2,0,0
2022-04-06,Vung Tau,Ba Ria City,8,3,3,0,0
2022-04-06,Vung Tau,Ba Ria City,9,7,4,3,2
2022-04-06,Vung Tau,Ba Ria City,10,5,4,1,0
2022-04-06,Vung Tau,Ba Ria City,11,3,3,0,0
2022-04-06,Vung Tau,Ba Ria City,12,7,5,2,2
2022-04-06,Vung Tau,Ba Ria City,13,7,5,2,0
2022-04-06,Vung Tau,Ba Ria City,14,5,5,0,0
2022-04-06,Vung Tau,Ba Ria City,15,5,5,0,0
2022-04-06,Vung Tau,Ba Ria City,16,8,6,2,2
2022-04-06,Vung Tau,Ba Ria City,17,5,4,1,0
2022-04-06,Vung Tau,Ba Ria City,18,2,0,2,2
2022-04-06,Vung Tau,Ba Ria City,19,7,1,6,6
2022-04-06,Vung Tau,Ba Ria City,20,1,0,1,1
2022-04-06,Vung Tau,Ba Ria City,21,2,0,2,2
2022-04-06,Vung Tau,Ba Ria City,22,1,0,1,0
2022-04-06,Vung Tau,Vung Tau City,2,1,1,0,0
2022-04-06,Vung Tau,Vung Tau City,5,2,1,1,0
2022-04-06,Vung Tau,Vung Tau City,6,38,36,2,1
2022-04-06,Vung Tau,Vung Tau City,7,83,72,11,2
2022-04-06,Vung Tau,Vung Tau City,8,121,112,9,2
2022-04-06,Vung Tau,Vung Tau City,9,140,131,9,1
2022-04-06,Vung Tau,Vung Tau City,10,146,132,14,3
2022-04-06,Vung Tau,Vung Tau City,11,337,309,28,3
2022-04-06,Vung Tau,Vung Tau City,12,253,234,19,2
2022-04-06,Vung Tau,Vung Tau City,13,171,156,15,1
2022-04-06,Vung Tau,Vung Tau City,14,190,180,10,3
2022-04-06,Vung Tau,Vung Tau City,15,161,147,14,4
2022-04-06,Vung Tau,Vung Tau City,16,153,148,5,0
2022-04-06,Vung Tau,Vung Tau City,17,212,193,19,1
2022-04-06,Vung Tau,Vung Tau City,18,269,253,16,2
2022-04-06,Vung Tau,Vung Tau City,19,239,221,18,0
2022-04-06,Vung Tau,Vung Tau City,20,159,139,20,3
2022-04-06,Vung Tau,Vung Tau City,21,70,53,17,5
2022-04-06,Vung Tau,Vung Tau City,22,1,0,1,0
2022-04-06,Vung Tau,Vung Tau City,23,2,2,0,0
2022-04-07,Binh Duong,Ben Cat,11,1,0,1,1
2022-04-07,Binh Duong,Ben Cat,13,1,0,1,1
2022-04-07,Binh Duong,Ben Cat,14,2,2,0,0
2022-04-07,Binh Duong,Ben Cat,18,1,1,0,0
2022-04-07,Binh Duong,Ben Cat,19,1,0,1,1
2022-04-07,Binh Duong,Ben Cat,20,1,0,1,1
2022-04-07,Binh Duong,Di An,1,1,0,1,1
2022-04-07,Binh Duong,Di An,2,1,0,1,1
2022-04-07,Binh Duong,Di An,6,2,1,1,0
2022-04-07,Binh Duong,Di An,7,4,3,1,1
2022-04-07,Binh Duong,Di An,8,8,5,3,3
2022-04-07,Binh Duong,Di An,9,10,6,4,3
2022-04-07,Binh Duong,Di An,10,16,12,4,3
2022-04-07,Binh Duong,Di An,11,38,21,17,13
2022-04-07,Binh Duong,Di An,12,26,21,5,5
2022-04-07,Binh Duong,Di An,13,19,13,6,6
2022-04-07,Binh Duong,Di An,14,23,9,14,12
2022-04-07,Binh Duong,Di An,15,31,14,17,11
2022-04-07,Binh Duong,Di An,16,20,12,8,4
2022-04-07,Binh Duong,Di An,17,21,14,7,3
2022-04-07,Binh Duong,Di An,18,22,15,7,6
2022-04-07,Binh Duong,Di An,19,17,9,8,4
2022-04-07,Binh Duong,Di An,20,13,2,11,7
2022-04-07,Binh Duong,Di An,21,5,0,5,5
2022-04-07,Binh Duong,Di An,23,1,0,1,1
2022-04-07,Binh Duong,Tan Uyen,8,1,0,1,0
2022-04-07,Binh Duong,Tan Uyen,11,2,1,1,1
2022-04-07,Binh Duong,Tan Uyen,12,1,0,1,1
2022-04-07,Binh Duong,Tan Uyen,13,3,0,3,2
2022-04-07,Binh Duong,Tan Uyen,14,1,1,0,0
2022-04-07,Binh Duong,Tan Uyen,15,2,0,2,2
2022-04-07,Binh Duong,Tan Uyen,16,3,3,0,0
2022-04-07,Binh Duong,Tan Uyen,17,1,0,1,1
2022-04-07,Binh Duong,Tan Uyen,19,4,1,3,1
2022-04-07,Binh Duong,Thu Dau Mot Town,1,3,3,0,0
2022-04-07,Binh Duong,Thu Dau Mot Town,2,1,1,0,0
2022-04-07,Binh Duong,Thu Dau Mot Town,5,1,1,0,0
2022-04-07,Binh Duong,Thu Dau Mot Town,6,24,18,6,2
2022-04-07,Binh Duong,Thu Dau Mot Town,7,89,84,5,1
2022-04-07,Binh Duong,Thu Dau Mot Town,8,163,149,14,2
2022-04-07,Binh Duong,Thu Dau Mot Town,9,200,186,14,3
2022-04-07,Binh Duong,Thu Dau Mot Town,10,265,254,11,1
2022-04-07,Binh Duong,Thu Dau Mot Town,11,579,550,29,2
2022-04-07,Binh Duong,Thu Dau Mot Town,12,390,370,20,1
2022-04-07,Binh Duong,Thu Dau Mot Town,13,322,308,14,2
2022-04-07,Binh Duong,Thu Dau Mot Town,14,324,308,16,1
2022-04-07,Binh Duong,Thu Dau Mot Town,15,238,225,13,1
2022-04-07,Binh Duong,Thu Dau Mot Town,16,255,242,13,1
2022-04-07,Binh Duong,Thu Dau Mot Town,17,302,277,25,2
2022-04-07,Binh Duong,Thu Dau Mot Town,18,298,281,17,1
2022-04-07,Binh Duong,Thu Dau Mot Town,19,274,253,21,4
2022-04-07,Binh Duong,Thu Dau Mot Town,20,188,177,11,2
2022-04-07,Binh Duong,Thu Dau Mot Town,21,99,84,15,3
2022-04-07,Binh Duong,Thuan An,6,3,1,2,2
2022-04-07,Binh Duong,Thuan An,7,6,2,4,4
2022-04-07,Binh Duong,Thuan An,8,15,6,9,8
2022-04-07,Binh Duong,Thuan An,9,22,20,2,1
2022-04-07,Binh Duong,Thuan An,10,51,41,10,4
2022-04-07,Binh Duong,Thuan An,11,69,46,23,18
2022-04-07,Binh Duong,Thuan An,12,56,46,10,6
2022-04-07,Binh Duong,Thuan An,13,52,48,4,1
2022-04-07,Binh Duong,Thuan An,14,38,31,7,6
2022-04-07,Binh Duong,Thuan An,15,42,29,13,8
2022-04-07,Binh Duong,Thuan An,16,33,24,9,5
2022-04-07,Binh Duong,Thuan An,17,25,21,4,2
2022-04-07,Binh Duong,Thuan An,18,28,25,3,3
2022-04-07,Binh Duong,Thuan An,19,26,20,6,3
2022-04-07,Binh Duong,Thuan An,20,26,16,10,5
2022-04-07,Binh Duong,Thuan An,21,10,5,5,4
2022-04-07,Can Tho City,Binh Thuy District,7,1,1,0,0
2022-04-07,Can Tho City,Binh Thuy District,8,3,2,1,0
2022-04-07,Can Tho City,Binh Thuy District,9,3,3,0,0
2022-04-07,Can Tho City,Binh Thuy District,10,15,14,1,0
2022-04-07,Can Tho City,Binh Thuy District,11,16,14,2,0
2022-04-07,Can Tho City,Binh Thuy District,12,11,8,3,0
2022-04-07,Can Tho City,Binh Thuy District,13,8,8,0,0
2022-04-07,Can Tho City,Binh Thuy District,14,18,14,4,0
2022-04-07,Can Tho City,Binh Thuy District,15,12,11,1,0
2022-04-07,Can Tho City,Binh Thuy District,16,6,6,0,0
2022-04-07,Can Tho City,Binh Thuy District,17,13,13,0,0
2022-04-07,Can Tho City,Binh Thuy District,18,15,15,0,0
2022-04-07,Can Tho City,Binh Thuy District,19,9,9,0,0
2022-04-07,Can Tho City,Binh Thuy District,20,8,6,2,0
2022-04-07,Can Tho City,Binh Thuy District,21,4,2,2,1
2022-04-07,Can Tho City,Cai Rang District,6,2,2,0,0
2022-04-07,Can Tho City,Cai Rang District,7,2,2,0,0
2022-04-07,Can Tho City,Cai Rang District,8,4,4,0,0
2022-04-07,Can Tho City,Cai Rang District,9,8,6,2,0
2022-04-07,Can Tho City,Cai Rang District,10,3,3,0,0
2022-04-07,Can Tho City,Cai Rang District,11,9,7,2,0
2022-04-07,Can Tho City,Cai Rang District,12,6,6,0,0
2022-04-07,Can Tho City,Cai Rang District,13,14,10,4,3
2022-04-07,Can Tho City,Cai Rang District,14,6,6,0,0
2022-04-07,Can Tho City,Cai Rang District,15,3,3,0,0
2022-04-07,Can Tho City,Cai Rang District,16,5,4,1,0
2022-04-07,Can Tho City,Cai Rang District,17,13,12,1,0
2022-04-07,Can Tho City,Cai Rang District,18,8,8,0,0
2022-04-07,Can Tho City,Cai Rang District,19,12,12,0,0
2022-04-07,Can Tho City,Cai Rang District,20,8,6,2,1
2022-04-07,Can Tho City,Cai Rang District,21,2,2,0,0
2022-04-07,Can Tho City,Ninh Kieu District,0,1,0,1,0
2022-04-07,Can Tho City,Ninh Kieu District,1,4,4,0,0
2022-04-07,Can Tho City,Ninh Kieu District,2,2,2,0,0
2022-04-07,Can Tho City,Ninh Kieu District,3,1,1,0,0
2022-04-07,Can Tho City,Ninh Kieu District,4,1,0,1,0
2022-04-07,Can Tho City,Ninh Kieu District,5,4,3,1,0
2022-04-07,Can Tho City,Ninh Kieu District,6,40,37,3,0
2022-04-07,Can Tho City,Ninh Kieu District,7,126,116,10,0
2022-04-07,Can Tho City,Ninh Kieu District,8,196,187,9,0
2022-04-07,Can Tho City,Ninh Kieu District,9,289,273,16,0
2022-04-07,Can Tho City,Ninh Kieu District,10,497,473,24,0
2022-04-07,Can Tho City,Ninh Kieu District,11,827,801,26,0
2022-04-07,Can Tho City,Ninh Kieu District,12,521,503,18,0
2022-04-07,Can Tho City,Ninh Kieu District,13,465,439,26,1
2022-04-07,Can Tho City,Ninh Kieu District,14,347,327,20,0
2022-04-07,Can Tho City,Ninh Kieu District,15,368,354,14,0
2022-04-07,Can Tho City,Ninh Kieu District,16,431,399,32,1
2022-04-07,Can Tho City,Ninh Kieu District,17,515,486,29,0
2022-04-07,Can Tho City,Ninh Kieu District,18,451,432,19,0
2022-04-07,Can Tho City,Ninh Kieu District,19,383,363,20,0
2022-04-07,Can Tho City,Ninh Kieu District,20,323,300,23,0
2022-04-07,Can Tho City,Ninh Kieu District,21,160,143,17,0
2022-04-07,Can Tho City,Ninh Kieu District,23,2,2,0,0
2022-04-07,Dong Nai,Bien Hoa City,0,4,3,1,0
2022-04-07,Dong Nai,Bien Hoa City,1,1,1,0,0
2022-04-07,Dong Nai,Bien Hoa City,2,1,1,0,0
2022-04-07,Dong Nai,Bien Hoa City,4,1,1,0,0
2022-04-07,Dong Nai,Bien Hoa City,5,1,1,0,0
2022-04-07,Dong Nai,Bien Hoa City,6,35,24,11,3
2022-04-07,Dong Nai,Bien Hoa City,7,134,120,14,5
2022-04-07,Dong Nai,Bien Hoa City,8,235,209,26,8
2022-04-07,Dong Nai,Bien Hoa City,9,331,308,23,2
2022-04-07,Dong Nai,Bien Hoa City,10,591,537,54,11
2022-04-07,Dong Nai,Bien Hoa City,11,923,839,84,26
2022-04-07,Dong Nai,Bien Hoa City,12,690,644,46,9
2022-04-07,Dong Nai,Bien Hoa City,13,681,630,51,8
2022-04-07,Dong Nai,Bien Hoa City,14,593,551,42,4
2022-04-07,Dong Nai,Bien Hoa City,15,438,410,28,5
2022-04-07,Dong Nai,Bien Hoa City,16,434,396,38,8
2022-04-07,Dong Nai,Bien Hoa City,17,469,434,35,2
2022-04-07,Dong Nai,Bien Hoa City,18,579,532,47,8
2022-04-07,Dong Nai,Bien Hoa City,19,512,463,49,10
2022-04-07,Dong Nai,Bien Hoa City,20,370,312,58,9
2022-04-07,Dong Nai,Bien Hoa City,21,186,131,55,33
2022-04-07,Dong Nai,Bien Hoa City,22,3,0,3,1
2022-04-07,Dong Nai,Bien Hoa City,23,2,2,0,0
2022-04-07,Dong Nai,Long Thanh,9,1,0,1,1
2022-04-07,Dong Nai,Long Thanh,11,1,0,1,1
2022-04-07,Dong Nai,Long Thanh,13,2,0,2,2
2022-04-07,Dong Nai,Long Thanh,14,4,0,4,3
2022-04-07,Dong Nai,Long Thanh,15,3,0,3,2
2022-04-07,Dong Nai,Nhon trach,8,1,0,1,1
2022-04-07,Dong Nai,Nhon trach,9,2,0,2,2
2022-04-07,Dong Nai,Thong Nhat,8,2,2,0,0
2022-04-07,Dong Nai,Thong Nhat,9,2,2,0,0
2022-04-07,Dong Nai,Thong Nhat,10,1,1,0,0
2022-04-07,Dong Nai,Thong Nhat,12,3,3,0,0
2022-04-07,Dong Nai,Thong Nhat,13,4,4,0,0
2022-04-07,Dong Nai,Thong Nhat,14,1,1,0,0
2022-04-07,Dong Nai,Thong Nhat,17,1,1,0,0
2022-04-07,Dong Nai,Thong Nhat,18,1,1,0,0
2022-04-07,Dong Nai,Thong Nhat,19,1,1,0,0
2022-04-07,Dong Nai,Thong Nhat,20,4,3,1,1
2022-04-07,Dong Nai,Thong Nhat,21,2,2,0,0
2022-04-07,Dong Nai,Trang Bom,9,1,0,1,1
2022-04-07,Dong Nai,Trang Bom,10,1,0,1,1
2022-04-07,Dong Nai,Trang Bom,14,1,0,1,1
2022-04-07,Dong Nai,Trang Bom,19,1,0,1,1
2022-04-07,Hai Phong City,An Duong,0,1,0,1,0
2022-04-07,Hai Phong City,An Duong,6,1,0,1,0
2022-04-07,Hai Phong City,An Duong,7,2,0,2,2
2022-04-07,Hai Phong City,An Duong,8,6,1,5,2
2022-04-07,Hai Phong City,An Duong,9,3,3,0,0
2022-04-07,Hai Phong City,An Duong,10,1,0,1,0
2022-04-07,Hai Phong City,An Duong,11,3,2,1,1
2022-04-07,Hai Phong City,An Duong,12,1,0,1,1
2022-04-07,Hai Phong City,An Duong,13,6,5,1,0
2022-04-07,Hai Phong City,An Duong,14,1,0,1,1
2022-04-07,Hai Phong City,An Duong,15,6,0,6,5
2022-04-07,Hai Phong City,An Duong,16,9,4,5,3
2022-04-07,Hai Phong City,An Duong,17,5,3,2,1
2022-04-07,Hai Phong City,An Duong,18,2,1,1,1
2022-04-07,Hai Phong City,An Duong,19,1,0,1,1
2022-04-07,Hai Phong City,An Duong,20,3,1,2,2
2022-04-07,Hai Phong City,Duong Kinh District,9,1,0,1,1
2022-04-07,Hai Phong City,Duong Kinh District,15,1,0,1,1
2022-04-07,Hai Phong City,Duong Kinh District,20,1,0,1,1
2022-04-07,Hai Phong City,Hai An District,6,1,0,1,1
2022-04-07,Hai Phong City,Hai An District,7,6,5,1,1
2022-04-07,Hai Phong City,Hai An District,8,10,8,2,0
2022-04-07,Hai Phong City,Hai An District,9,10,8,2,1
2022-04-07,Hai Phong City,Hai An District,10,19,18,1,0
2022-04-07,Hai Phong City,Hai An District,11,46,38,8,7
2022-04-07,Hai Phong City,Hai An District,12,17,15,2,0
2022-04-07,Hai Phong City,Hai An District,13,5,4,1,0
2022-04-07,Hai Phong City,Hai An District,14,15,14,1,0
2022-04-07,Hai Phong City,Hai An District,15,28,23,5,1
2022-04-07,Hai Phong City,Hai An District,16,16,14,2,0
2022-04-07,Hai Phong City,Hai An District,17,14,14,0,0
2022-04-07,Hai Phong City,Hai An District,18,25,21,4,1
2022-04-07,Hai Phong City,Hai An District,19,21,20,1,0
2022-04-07,Hai Phong City,Hai An District,20,6,6,0,0
2022-04-07,Hai Phong City,Hai An District,21,6,2,4,4
2022-04-07,Hai Phong City,Hong Bang District,1,1,1,0,0
2022-04-07,Hai Phong City,Hong Bang District,6,1,1,0,0
2022-04-07,Hai Phong City,Hong Bang District,7,11,8,3,2
2022-04-07,Hai Phong City,Hong Bang District,8,36,30,6,0
2022-04-07,Hai Phong City,Hong Bang District,9,30,26,4,1
2022-04-07,Hai Phong City,Hong Bang District,10,43,41,2,0
2022-04-07,Hai Phong City,Hong Bang District,11,107,99,8,4
2022-04-07,Hai Phong City,Hong Bang District,12,59,56,3,1
2022-04-07,Hai Phong City,Hong Bang District,13,37,32,5,3
2022-04-07,Hai Phong City,Hong Bang District,14,53,46,7,5
2022-04-07,Hai Phong City,Hong Bang District,15,49,38,11,6
2022-04-07,Hai Phong City,Hong Bang District,16,38,35,3,2
2022-04-07,Hai Phong City,Hong Bang District,17,27,21,6,2
2022-04-07,Hai Phong City,Hong Bang District,18,50,46,4,1
2022-04-07,Hai Phong City,Hong Bang District,19,38,37,1,0
2022-04-07,Hai Phong City,Hong Bang District,20,33,28,5,0
2022-04-07,Hai Phong City,Hong Bang District,21,11,7,4,1
2022-04-07,Hai Phong City,Kien An District,7,4,1,3,3
2022-04-07,Hai Phong City,Kien An District,8,2,1,1,0
2022-04-07,Hai Phong City,Kien An District,9,5,4,1,0
2022-04-07,Hai Phong City,Kien An District,10,3,3,0,0
2022-04-07,Hai Phong City,Kien An District,11,11,8,3,0
2022-04-07,Hai Phong City,Kien An District,12,6,6,0,0
2022-04-07,Hai Phong City,Kien An District,13,3,2,1,0
2022-04-07,Hai Phong City,Kien An District,14,10,5,5,3
2022-04-07,Hai Phong City,Kien An District,15,8,4,4,2
2022-04-07,Hai Phong City,Kien An District,16,8,6,2,0
2022-04-07,Hai Phong City,Kien An District,17,3,3,0,0
2022-04-07,Hai Phong City,Kien An District,18,10,8,2,0
2022-04-07,Hai Phong City,Kien An District,19,7,6,1,0
2022-04-07,Hai Phong City,Kien An District,20,6,4,2,2
2022-04-07,Hai Phong City,Kien An District,21,3,2,1,0
2022-04-07,Hai Phong City,Le Chan District,0,3,3,0,0
2022-04-07,Hai Phong City,Le Chan District,6,4,1,3,1
2022-04-07,Hai Phong City,Le Chan District,7,36,25,11,4
2022-04-07,Hai Phong City,Le Chan District,8,52,47,5,0
2022-04-07,Hai Phong City,Le Chan District,9,69,55,14,0
2022-04-07,Hai Phong City,Le Chan District,10,171,160,11,2
2022-04-07,Hai Phong City,Le Chan District,11,293,259,34,12
2022-04-07,Hai Phong City,Le Chan District,12,175,160,15,4
2022-04-07,Hai Phong City,Le Chan District,13,124,110,14,3
2022-04-07,Hai Phong City,Le Chan District,14,148,126,22,14
2022-04-07,Hai Phong City,Le Chan District,15,173,147,26,6
2022-04-07,Hai Phong City,Le Chan District,16,138,128,10,1
2022-04-07,Hai Phong City,Le Chan District,17,171,154,17,6
2022-04-07,Hai Phong City,Le Chan District,18,201,183,18,3
2022-04-07,Hai Phong City,Le Chan District,19,169,149,20,7
2022-04-07,Hai Phong City,Le Chan District,20,101,84,17,0
2022-04-07,Hai Phong City,Le Chan District,21,56,43,13,2
2022-04-07,Hai Phong City,Ngo Quyen District,2,1,1,0,0
2022-04-07,Hai Phong City,Ngo Quyen District,5,1,0,1,0
2022-04-07,Hai Phong City,Ngo Quyen District,6,1,1,0,0
2022-04-07,Hai Phong City,Ngo Quyen District,7,17,16,1,1
2022-04-07,Hai Phong City,Ngo Quyen District,8,67,55,12,1
2022-04-07,Hai Phong City,Ngo Quyen District,9,68,61,7,0
2022-04-07,Hai Phong City,Ngo Quyen District,10,122,114,8,0
2022-04-07,Hai Phong City,Ngo Quyen District,11,252,228,24,3
2022-04-07,Hai Phong City,Ngo Quyen District,12,149,139,10,0
2022-04-07,Hai Phong City,Ngo Quyen District,13,96,88,8,1
2022-04-07,Hai Phong City,Ngo Quyen District,14,140,120,20,7
2022-04-07,Hai Phong City,Ngo Quyen District,15,131,114,17,4
2022-04-07,Hai Phong City,Ngo Quyen District,16,93,80,13,1
2022-04-07,Hai Phong City,Ngo Quyen District,17,103,93,10,0
2022-04-07,Hai Phong City,Ngo Quyen District,18,141,131,10,1
2022-04-07,Hai Phong City,Ngo Quyen District,19,123,113,10,1
2022-04-07,Hai Phong City,Ngo Quyen District,20,86,80,6,1
2022-04-07,Hai Phong City,Ngo Quyen District,21,33,28,5,1
2022-04-07,Hai Phong City,Ngo Quyen District,22,1,0,1,0
2022-04-07,Hai Phong City,Ngo Quyen District,23,1,1,0,0
2022-04-07,Hai Phong City,Thuy Nguyen,13,2,0,2,2
2022-04-07,Hai Phong City,Thuy Nguyen,14,4,2,2,2
2022-04-07,Hai Phong City,Thuy Nguyen,15,1,0,1,0
2022-04-07,Hai Phong City,Thuy Nguyen,16,1,1,0,0
2022-04-07,Hai Phong City,Thuy Nguyen,19,1,1,0,0
2022-04-07,Hue City,Hue City,0,1,1,0,0
2022-04-07,Hue City,Hue City,1,1,1,0,0
2022-04-07,Hue City,Hue City,4,3,3,0,0
2022-04-07,Hue City,Hue City,5,3,3,0,0
2022-04-07,Hue City,Hue City,6,70,63,7,1
2022-04-07,Hue City,Hue City,7,136,126,10,2
2022-04-07,Hue City,Hue City,8,272,255,17,0
2022-04-07,Hue City,Hue City,9,188,177,11,0
2022-04-07,Hue City,Hue City,10,355,331,24,0
2022-04-07,Hue City,Hue City,11,731,676,55,1
2022-04-07,Hue City,Hue City,12,446,421,25,0
2022-04-07,Hue City,Hue City,13,280,263,17,0
2022-04-07,Hue City,Hue City,14,326,300,26,3
2022-04-07,Hue City,Hue City,15,354,338,16,0
2022-04-07,Hue City,Hue City,16,336,318,18,2
2022-04-07,Hue City,Hue City,17,491,453,38,3
2022-04-07,Hue City,Hue City,18,522,484,38,1
2022-04-07,Hue City,Hue City,19,482,455,27,2
2022-04-07,Hue City,Hue City,20,374,342,32,2
2022-04-07,Hue City,Hue City,21,224,187,37,6
2022-04-07,Hue City,Hue City,23,2,2,0,0
2022-04-07,Hue City,Huong Thuy,6,1,1,0,0
2022-04-07,Hue City,Huong Thuy,10,1,1,0,0
2022-04-07,Hue City,Huong Thuy,16,2,0,2,1
2022-04-07,Hue City,Huong Thuy,17,4,1,3,1
2022-04-07,Hue City,Huong Thuy,18,1,0,1,1
2022-04-07,Hue City,Huong Tra,11,1,1,0,0
2022-04-07,Hue City,Huong Tra,12,1,1,0,0
2022-04-07,Hue City,Phu Vang,7,3,2,1,0
2022-04-07,Hue City,Phu Vang,9,3,3,0,0
2022-04-07,Hue City,Phu Vang,11,4,3,1,0
2022-04-07,Hue City,Phu Vang,13,4,0,4,2
2022-04-07,Hue City,Phu Vang,15,3,1,2,2
2022-04-07,Hue City,Phu Vang,18,3,3,0,0
2022-04-07,Hue City,Phu Vang,19,3,2,1,1
2022-04-07,Hue City,Phu Vang,21,1,0,1,1
2022-04-07,Vung Tau,Ba Ria City,7,2,1,1,1
2022-04-07,Vung Tau,Ba Ria City,8,2,1,1,1
2022-04-07,Vung Tau,Ba Ria City,9,6,3,3,3
2022-04-07,Vung Tau,Ba Ria City,10,5,5,0,0
2022-04-07,Vung Tau,Ba Ria City,11,9,9,0,0
2022-04-07,Vung Tau,Ba Ria City,12,6,4,2,2
2022-04-07,Vung Tau,Ba Ria City,13,3,3,0,0
2022-04-07,Vung Tau,Ba Ria City,14,3,3,0,0
2022-04-07,Vung Tau,Ba Ria City,15,1,1,0,0
2022-04-07,Vung Tau,Ba Ria City,16,5,1,4,4
2022-04-07,Vung Tau,Ba Ria City,17,3,2,1,1
2022-04-07,Vung Tau,Ba Ria City,18,5,3,2,2
2022-04-07,Vung Tau,Ba Ria City,19,1,0,1,1
2022-04-07,Vung Tau,Ba Ria City,20,2,0,2,2
2022-04-07,Vung Tau,Vung Tau City,0,1,0,1,0
2022-04-07,Vung Tau,Vung Tau City,1,1,0,1,0
2022-04-07,Vung Tau,Vung Tau City,2,2,0,2,0
2022-04-07,Vung Tau,Vung Tau City,3,2,0,2,0
2022-04-07,Vung Tau,Vung Tau City,4,1,0,1,0
2022-04-07,Vung Tau,Vung Tau City,5,1,1,0,0
2022-04-07,Vung Tau,Vung Tau City,6,41,37,4,2
2022-04-07,Vung Tau,Vung Tau City,7,64,59,5,2
2022-04-07,Vung Tau,Vung Tau City,8,143,131,12,0
2022-04-07,Vung Tau,Vung Tau City,9,125,116,9,2
2022-04-07,Vung Tau,Vung Tau City,10,159,147,12,0
2022-04-07,Vung Tau,Vung Tau City,11,313,303,10,0
2022-04-07,Vung Tau,Vung Tau City,12,250,237,13,0
2022-04-07,Vung Tau,Vung Tau City,13,189,176,13,0
2022-04-07,Vung Tau,Vung Tau City,14,185,167,18,1
2022-04-07,Vung Tau,Vung Tau City,15,183,167,16,1
2022-04-07,Vung Tau,Vung Tau City,16,153,146,7,0
2022-04-07,Vung Tau,Vung Tau City,17,195,183,12,0
2022-04-07,Vung Tau,Vung Tau City,18,271,251,20,0
2022-04-07,Vung Tau,Vung Tau City,19,227,205,22,3
2022-04-07,Vung Tau,Vung Tau City,20,162,144,18,2
2022-04-07,Vung Tau,Vung Tau City,21,83,61,22,3
2022-04-07,Vung Tau,Vung Tau City,22,6,2,4,0
2022-04-07,Vung Tau,Vung Tau City,23,2,2,0,0
2022-04-08,Binh Duong,Ben Cat,11,1,0,1,1
2022-04-08,Binh Duong,Ben Cat,15,1,0,1,1
2022-04-08,Binh Duong,Ben Cat,17,1,1,0,0
2022-04-08,Binh Duong,Ben Cat,18,1,1,0,0
2022-04-08,Binh Duong,Di An,0,1,0,1,1
2022-04-08,Binh Duong,Di An,6,1,0,1,1
2022-04-08,Binh Duong,Di An,7,5,2,3,2
2022-04-08,Binh Duong,Di An,8,10,6,4,3
2022-04-08,Binh Duong,Di An,9,6,6,0,0
2022-04-08,Binh Duong,Di An,10,28,15,13,7
2022-04-08,Binh Duong,Di An,11,25,21,4,1
2022-04-08,Binh Duong,Di An,12,37,15,22,20
2022-04-08,Binh Duong,Di An,13,32,11,21,19
2022-04-08,Binh Duong,Di An,14,18,8,10,7
2022-04-08,Binh Duong,Di An,15,17,8,9,7
2022-04-08,Binh Duong,Di An,16,20,8,12,10
2022-04-08,Binh Duong,Di An,17,30,13,17,16
2022-04-08,Binh Duong,Di An,18,22,13,9,9
2022-04-08,Binh Duong,Di An,19,32,14,18,12
2022-04-08,Binh Duong,Di An,20,16,11,5,3
2022-04-08,Binh Duong,Di An,21,7,4,3,3
2022-04-08,Binh Duong,Di An,22,2,0,2,2
2022-04-08,Binh Duong,Di An,23,1,0,1,1
2022-04-08,Binh Duong,Tan Uyen,8,1,1,0,0
2022-04-08,Binh Duong,Tan Uyen,10,2,0,2,1
2022-04-08,Binh Duong,Tan Uyen,12,6,0,6,6
2022-04-08,Binh Duong,Tan Uyen,13,4,2,2,1
2022-04-08,Binh Duong,Tan Uyen,17,3,2,1,1
2022-04-08,Binh Duong,Tan Uyen,18,2,0,2,2
2022-04-08,Binh Duong,Tan Uyen,19,3,2,1,1
2022-04-08,Binh Duong,Tan Uyen,20,1,0,1,1
2022-04-08,Binh Duong,Tan Uyen,21,1,1,0,0
2022-04-08,Binh Duong,Thu Dau Mot Town,0,3,0,3,2
2022-04-08,Binh Duong,Thu Dau Mot Town,4,1,1,0,0
2022-04-08,Binh Duong,Thu Dau Mot Town,6,32,25,7,3
2022-04-08,Binh Duong,Thu Dau Mot Town,7,102,87,15,3
2022-04-08,Binh Duong,Thu Dau Mot Town,8,185,176,9,0
2022-04-08,Binh Duong,Thu Dau Mot Town,9,194,172,22,0
2022-04-08,Binh Duong,Thu Dau Mot Town,10,330,308,22,1
2022-04-08,Binh Duong,Thu Dau Mot Town,11,584,551,33,4
2022-04-08,Binh Duong,Thu Dau Mot Town,12,399,374,25,1
2022-04-08,Binh Duong,Thu Dau Mot Town,13,419,394,25,3
2022-04-08,Binh Duong,Thu Dau Mot Town,14,327,309,18,4
2022-04-08,Binh Duong,Thu Dau Mot Town,15,256,242,14,2
2022-04-08,Binh Duong,Thu Dau Mot Town,16,271,255,16,1
2022-04-08,Binh Duong,Thu Dau Mot Town,17,251,237,14,2
2022-04-08,Binh Duong,Thu Dau Mot Town,18,351,333,18,2
2022-04-08,Binh Duong,Thu Dau Mot Town,19,323,310,13,0
2022-04-08,Binh Duong,Thu Dau Mot Town,20,206,181,25,3
2022-04-08,Binh Duong,Thu Dau Mot Town,21,130,113,17,2
2022-04-08,Binh Duong,Thu Dau Mot Town,22,3,0,3,2
2022-04-08,Binh Duong,Thu Dau Mot Town,23,2,1,1,0
2022-04-08,Binh Duong,Thuan An,7,4,1,3,1
2022-04-08,Binh Duong,Thuan An,8,8,5,3,3
2022-04-08,Binh Duong,Thuan An,9,27,16,11,6
2022-04-08,Binh Duong,Thuan An,10,52,32,20,15
2022-04-08,Binh Duong,Thuan An,11,69,45,24,20
2022-04-08,Binh Duong,Thuan An,12,54,38,16,10
2022-04-08,Binh Duong,Thuan An,13,47,34,13,7
2022-04-08,Binh Duong,Thuan An,14,42,32,10,6
2022-04-08,Binh Duong,Thuan An,15,35,18,17,11
2022-04-08,Binh Duong,Thuan An,16,29,26,3,2
2022-04-08,Binh Duong,Thuan An,17,31,25,6,4
2022-04-08,Binh Duong,Thuan An,18,27,22,5,0
2022-04-08,Binh Duong,Thuan An,19,38,32,6,2
2022-04-08,Binh Duong,Thuan An,20,20,16,4,2
2022-04-08,Binh Duong,Thuan An,21,12,3,9,6
2022-04-08,Can Tho City,Binh Thuy District,6,2,2,0,0
2022-04-08,Can Tho City,Binh Thuy District,7,1,1,0,0
2022-04-08,Can Tho City,Binh Thuy District,8,1,1,0,0
2022-04-08,Can Tho City,Binh Thuy District,9,5,5,0,0
2022-04-08,Can Tho City,Binh Thuy District,10,8,7,1,0
2022-04-08,Can Tho City,Binh Thuy District,11,20,15,5,0
2022-04-08,Can Tho City,Binh Thuy District,12,16,15,1,0
2022-04-08,Can Tho City,Binh Thuy District,13,12,11,1,0
2022-04-08,Can Tho City,Binh Thuy District,14,9,6,3,0
2022-04-08,Can Tho City,Binh Thuy District,15,9,6,3,0
2022-04-08,Can Tho City,Binh Thuy District,16,8,8,0,0
2022-04-08,Can Tho City,Binh Thuy District,17,6,6,0,0
2022-04-08,Can Tho City,Binh Thuy District,18,21,21,0,0
2022-04-08,Can Tho City,Binh Thuy District,19,13,13,0,0
2022-04-08,Can Tho City,Binh Thuy District,20,10,9,1,0
2022-04-08,Can Tho City,Binh Thuy District,21,2,2,0,0
2022-04-08,Can Tho City,Cai Rang District,6,1,1,0,0
2022-04-08,Can Tho City,Cai Rang District,7,6,5,1,1
2022-04-08,Can Tho City,Cai Rang District,8,4,3,1,0
2022-04-08,Can Tho City,Cai Rang District,9,5,2,3,0
2022-04-08,Can Tho City,Cai Rang District,10,6,6,0,0
2022-04-08,Can Tho City,Cai Rang District,11,16,15,1,0
2022-04-08,Can Tho City,Cai Rang District,12,11,9,2,1
2022-04-08,Can Tho City,Cai Rang District,13,13,11,2,1
2022-04-08,Can Tho City,Cai Rang District,14,8,7,1,0
2022-04-08,Can Tho City,Cai Rang District,15,8,8,0,0
2022-04-08,Can Tho City,Cai Rang District,16,12,8,4,0
2022-04-08,Can Tho City,Cai Rang District,17,10,9,1,0
2022-04-08,Can Tho City,Cai Rang District,18,8,8,0,0
2022-04-08,Can Tho City,Cai Rang District,19,11,10,1,0
2022-04-08,Can Tho City,Cai Rang District,20,8,8,0,0
2022-04-08,Can Tho City,Cai Rang District,21,2,2,0,0
2022-04-08,Can Tho City,Ninh Kieu District,0,4,3,1,0
2022-04-08,Can Tho City,Ninh Kieu District,1,1,1,0,0
2022-04-08,Can Tho City,Ninh Kieu District,5,3,2,1,1
2022-04-08,Can Tho City,Ninh Kieu District,6,25,24,1,0
2022-04-08,Can Tho City,Ninh Kieu District,7,105,97,8,0
2022-04-08,Can Tho City,Ninh Kieu District,8,174,163,11,0
2022-04-08,Can Tho City,Ninh Kieu District,9,245,233,12,0
2022-04-08,Can Tho City,Ninh Kieu District,10,508,486,22,0
2022-04-08,Can Tho City,Ninh Kieu District,11,814,770,44,3
2022-04-08,Can Tho City,Ninh Kieu District,12,553,533,20,0
2022-04-08,Can Tho City,Ninh Kieu District,13,444,427,17,0
2022-04-08,Can Tho City,Ninh Kieu District,14,374,354,20,0
2022-04-08,Can Tho City,Ninh Kieu District,15,322,307,15,0
2022-04-08,Can Tho City,Ninh Kieu District,16,354,343,11,0
2022-04-08,Can Tho City,Ninh Kieu District,17,460,432,28,0
2022-04-08,Can Tho City,Ninh Kieu District,18,471,443,28,0
2022-04-08,Can Tho City,Ninh Kieu District,19,390,367,23,1
2022-04-08,Can Tho City,Ninh Kieu District,20,287,274,13,0
2022-04-08,Can Tho City,Ninh Kieu District,21,168,154,14,0
2022-04-08,Can Tho City,Ninh Kieu District,22,5,4,1,0
2022-04-08,Can Tho City,Ninh Kieu District,23,2,1,1,0
2022-04-08,Dong Nai,Bien Hoa City,0,7,4,3,1
2022-04-08,Dong Nai,Bien Hoa City,1,1,1,0,0
2022-04-08,Dong Nai,Bien Hoa City,2,1,1,0,0
2022-04-08,Dong Nai,Bien Hoa City,6,24,21,3,2
2022-04-08,Dong Nai,Bien Hoa City,7,117,111,6,1
2022-04-08,Dong Nai,Bien Hoa City,8,229,204,25,4
2022-04-08,Dong Nai,Bien Hoa City,9,329,287,42,12
2022-04-08,Dong Nai,Bien Hoa City,10,653,586,67,19
2022-04-08,Dong Nai,Bien Hoa City,11,994,895,99,24
2022-04-08,Dong Nai,Bien Hoa City,12,777,710,67,4
2022-04-08,Dong Nai,Bien Hoa City,13,746,696,50,15
2022-04-08,Dong Nai,Bien Hoa City,14,608,554,54,13
2022-04-08,Dong Nai,Bien Hoa City,15,422,386,36,6
2022-04-08,Dong Nai,Bien Hoa City,16,447,404,43,3
2022-04-08,Dong Nai,Bien Hoa City,17,608,528,80,30
2022-04-08,Dong Nai,Bien Hoa City,18,662,598,64,13
2022-04-08,Dong Nai,Bien Hoa City,19,634,564,70,12
2022-04-08,Dong Nai,Bien Hoa City,20,518,420,98,42
2022-04-08,Dong Nai,Bien Hoa City,21,217,165,52,28
2022-04-08,Dong Nai,Bien Hoa City,22,11,5,6,0
2022-04-08,Dong Nai,Bien Hoa City,23,3,3,0,0
2022-04-08,Dong Nai,Long Thanh,11,1,0,1,1
2022-04-08,Dong Nai,Long Thanh,15,1,0,1,1
2022-04-08,Dong Nai,Long Thanh,20,1,0,1,1
2022-04-08,Dong Nai,Thong Nhat,7,5,3,2,0
2022-04-08,Dong Nai,Thong Nhat,8,1,1,0,0
2022-04-08,Dong Nai,Thong Nhat,9,1,1,0,0
2022-04-08,Dong Nai,Thong Nhat,11,2,2,0,0
2022-04-08,Dong Nai,Thong Nhat,12,1,1,0,0
2022-04-08,Dong Nai,Thong Nhat,13,3,2,1,0
2022-04-08,Dong Nai,Thong Nhat,14,1,1,0,0
2022-04-08,Dong Nai,Thong Nhat,19,2,1,1,0
2022-04-08,Dong Nai,Thong Nhat,20,3,1,2,2
2022-04-08,Dong Nai,Thong Nhat,21,2,2,0,0
2022-04-08,Dong Nai,Trang Bom,10,1,0,1,1
2022-04-08,Dong Nai,Trang Bom,11,1,0,1,0
2022-04-08,Dong Nai,Trang Bom,13,1,0,1,1
2022-04-08,Dong Nai,Trang Bom,14,1,1,0,0
2022-04-08,Dong Nai,Trang Bom,20,2,0,2,2
2022-04-08,Hai Phong City,An Duong,7,4,0,4,2
2022-04-08,Hai Phong City,An Duong,8,2,1,1,0
2022-04-08,Hai Phong City,An Duong,9,2,0,2,1
2022-04-08,Hai Phong City,An Duong,10,4,3,1,1
2022-04-08,Hai Phong City,An Duong,11,2,2,0,0
2022-04-08,Hai Phong City,An Duong,12,9,2,7,7
2022-04-08,Hai Phong City,An Duong,13,5,0,5,2
2022-04-08,Hai Phong City,An Duong,14,12,3,9,8
2022-04-08,Hai Phong City,An Duong,15,5,2,3,3
2022-04-08,Hai Phong City,An Duong,16,6,2,4,4
2022-04-08,Hai Phong City,An Duong,17,5,3,2,2
2022-04-08,Hai Phong City,An Duong,18,3,1,2,1
2022-04-08,Hai Phong City,An Duong,19,2,1,1,1
2022-04-08,Hai Phong City,An Duong,20,1,1,0,0
2022-04-08,Hai Phong City,An Duong,21,1,1,0,0
2022-04-08,Hai Phong City,Do Son District,13,1,0,1,1
2022-04-08,Hai Phong City,Duong Kinh District,9,1,0,1,1
2022-04-08,Hai Phong City,Duong Kinh District,16,1,0,1,1
2022-04-08,Hai Phong City,Duong Kinh District,18,1,0,1,1
2022-04-08,Hai Phong City,Hai An District,7,1,0,1,1
2022-04-08,Hai Phong City,Hai An District,8,6,6,0,0
2022-04-08,Hai Phong City,Hai An District,9,6,6,0,0
2022-04-08,Hai Phong City,Hai An District,10,15,15,0,0
2022-04-08,Hai Phong City,Hai An District,11,39,32,7,2
2022-04-08,Hai Phong City,Hai An District,12,26,23,3,2
2022-04-08,Hai Phong City,Hai An District,13,20,17,3,2
2022-04-08,Hai Phong City,Hai An District,14,7,7,0,0
2022-04-08,Hai Phong City,Hai An District,15,19,9,10,6
2022-04-08,Hai Phong City,Hai An District,16,14,10,4,1
2022-04-08,Hai Phong City,Hai An District,17,23,17,6,0
2022-04-08,Hai Phong City,Hai An District,18,19,19,0,0
2022-04-08,Hai Phong City,Hai An District,19,16,14,2,0
2022-04-08,Hai Phong City,Hai An District,20,12,12,0,0
2022-04-08,Hai Phong City,Hai An District,21,11,8,3,2
2022-04-08,Hai Phong City,Hai An District,23,1,1,0,0
2022-04-08,Hai Phong City,Hong Bang District,1,1,0,1,0
2022-04-08,Hai Phong City,Hong Bang District,7,15,11,4,2
2022-04-08,Hai Phong City,Hong Bang District,8,34,31,3,1
2022-04-08,Hai Phong City,Hong Bang District,9,35,32,3,1
2022-04-08,Hai Phong City,Hong Bang District,10,49,44,5,2
2022-04-08,Hai Phong City,Hong Bang District,11,96,85,11,3
2022-04-08,Hai Phong City,Hong Bang District,12,43,41,2,1
2022-04-08,Hai Phong City,Hong Bang District,13,46,41,5,0
2022-04-08,Hai Phong City,Hong Bang District,14,51,41,10,5
2022-04-08,Hai Phong City,Hong Bang District,15,37,32,5,2
2022-04-08,Hai Phong City,Hong Bang District,16,29,26,3,1
2022-04-08,Hai Phong City,Hong Bang District,17,31,27,4,1
2022-04-08,Hai Phong City,Hong Bang District,18,61,54,7,4
2022-04-08,Hai Phong City,Hong Bang District,19,49,45,4,0
2022-04-08,Hai Phong City,Hong Bang District,20,33,30,3,1
2022-04-08,Hai Phong City,Hong Bang District,21,16,12,4,4
2022-04-08,Hai Phong City,Hong Bang District,22,2,1,1,0
2022-04-08,Hai Phong City,Kien An District,6,1,0,1,1
2022-04-08,Hai Phong City,Kien An District,7,2,0,2,0
2022-04-08,Hai Phong City,Kien An District,8,6,1,5,5
2022-04-08,Hai Phong City,Kien An District,9,2,2,0,0
2022-04-08,Hai Phong City,Kien An District,10,7,4,3,2
2022-04-08,Hai Phong City,Kien An District,11,10,9,1,1
2022-04-08,Hai Phong City,Kien An District,12,4,3,1,1
2022-04-08,Hai Phong City,Kien An District,13,6,3,3,3
2022-04-08,Hai Phong City,Kien An District,14,4,1,3,3
2022-04-08,Hai Phong City,Kien An District,15,10,7,3,2
2022-04-08,Hai Phong City,Kien An District,16,6,4,2,1
2022-04-08,Hai Phong City,Kien An District,17,3,3,0,0
2022-04-08,Hai Phong City,Kien An District,18,6,3,3,0
2022-04-08,Hai Phong City,Kien An District,19,7,5,2,0
2022-04-08,Hai Phong City,Kien An District,20,7,5,2,2
2022-04-08,Hai Phong City,Kien An District,21,2,0,2,1
2022-04-08,Hai Phong City,Le Chan District,1,1,0,1,0
2022-04-08,Hai Phong City,Le Chan District,6,1,1,0,0
2022-04-08,Hai Phong City,Le Chan District,7,29,25,4,0
2022-04-08,Hai Phong City,Le Chan District,8,63,49,14,1
2022-04-08,Hai Phong City,Le Chan District,9,62,57,5,2
2022-04-08,Hai Phong City,Le Chan District,10,143,131,12,0
2022-04-08,Hai Phong City,Le Chan District,11,307,275,32,8
2022-04-08,Hai Phong City,Le Chan District,12,178,162,16,1
2022-04-08,Hai Phong City,Le Chan District,13,109,95,14,2
2022-04-08,Hai Phong City,Le Chan District,14,122,108,14,5
2022-04-08,Hai Phong City,Le Chan District,15,156,140,16,2
2022-04-08,Hai Phong City,Le Chan District,16,121,110,11,4
2022-04-08,Hai Phong City,Le Chan District,17,170,158,12,4
2022-04-08,Hai Phong City,Le Chan District,18,242,215,27,7
2022-04-08,Hai Phong City,Le Chan District,19,194,171,23,5
2022-04-08,Hai Phong City,Le Chan District,20,128,108,20,1
2022-04-08,Hai Phong City,Le Chan District,21,70,47,23,8
2022-04-08,Hai Phong City,Ngo Quyen District,2,1,1,0,0
2022-04-08,Hai Phong City,Ngo Quyen District,7,15,13,2,1
2022-04-08,Hai Phong City,Ngo Quyen District,8,73,66,7,0
2022-04-08,Hai Phong City,Ngo Quyen District,9,74,60,14,2
2022-04-08,Hai Phong City,Ngo Quyen District,10,106,95,11,0
2022-04-08,Hai Phong City,Ngo Quyen District,11,236,216,20,6
2022-04-08,Hai Phong City,Ngo Quyen District,12,145,128,17,1
2022-04-08,Hai Phong City,Ngo Quyen District,13,107,89,18,5
2022-04-08,Hai Phong City,Ngo Quyen District,14,131,118,13,6
2022-04-08,Hai Phong City,Ngo Quyen District,15,127,107,20,6
2022-04-08,Hai Phong City,Ngo Quyen District,16,96,88,8,0
2022-04-08,Hai Phong City,Ngo Quyen District,17,126,107,19,1
2022-04-08,Hai Phong City,Ngo Quyen District,18,168,151,17,1
2022-04-08,Hai Phong City,Ngo Quyen District,19,138,133,5,0
2022-04-08,Hai Phong City,Ngo Quyen District,20,115,95,20,1
2022-04-08,Hai Phong City,Ngo Quyen District,21,81,60,21,12
2022-04-08,Hai Phong City,Thuy Nguyen,8,2,0,2,1
2022-04-08,Hai Phong City,Thuy Nguyen,12,1,0,1,1
2022-04-08,Hai Phong City,Thuy Nguyen,13,2,0,2,2
2022-04-08,Hai Phong City,Thuy Nguyen,14,1,0,1,1
2022-04-08,Hai Phong City,Thuy Nguyen,16,1,0,1,1
2022-04-08,Hai Phong City,Thuy Nguyen,17,1,0,1,1
2022-04-08,Hue City,Hue City,0,1,1,0,0
2022-04-08,Hue City,Hue City,2,1,0,1,0
2022-04-08,Hue City,Hue City,3,2,1,1,0
2022-04-08,Hue City,Hue City,4,2,1,1,0
2022-04-08,Hue City,Hue City,5,3,1,2,0
2022-04-08,Hue City,Hue City,6,42,40,2,0
2022-04-08,Hue City,Hue City,7,129,126,3,0
2022-04-08,Hue City,Hue City,8,231,220,11,0
2022-04-08,Hue City,Hue City,9,209,198,11,1
2022-04-08,Hue City,Hue City,10,311,297,14,1
2022-04-08,Hue City,Hue City,11,796,744,52,4
2022-04-08,Hue City,Hue City,12,533,500,33,0
2022-04-08,Hue City,Hue City,13,316,299,17,1
2022-04-08,Hue City,Hue City,14,316,297,19,1
2022-04-08,Hue City,Hue City,15,358,330,28,0
2022-04-08,Hue City,Hue City,16,322,297,25,1
2022-04-08,Hue City,Hue City,17,408,380,28,1
2022-04-08,Hue City,Hue City,18,564,526,38,0
2022-04-08,Hue City,Hue City,19,569,523,46,1
2022-04-08,Hue City,Hue City,20,422,379,43,1
2022-04-08,Hue City,Hue City,21,224,198,26,1
2022-04-08,Hue City,Hue City,22,1,0,1,0
2022-04-08,Hue City,Hue City,23,2,2,0,0
2022-04-08,Hue City,Huong Thuy,9,1,1,0,0
2022-04-08,Hue City,Huong Thuy,11,1,1,0,0
2022-04-08,Hue City,Huong Thuy,17,1,1,0,0
2022-04-08,Hue City,Huong Thuy,19,3,3,0,0
2022-04-08,Hue City,Huong Thuy,21,2,1,1,1
2022-04-08,Hue City,Huong Tra,11,1,1,0,0
2022-04-08,Hue City,Huong Tra,19,1,1,0,0
2022-04-08,Hue City,Phu Vang,6,1,1,0,0
2022-04-08,Hue City,Phu Vang,7,2,1,1,1
2022-04-08,Hue City,Phu Vang,8,3,2,1,1
2022-04-08,Hue City,Phu Vang,9,1,1,0,0
2022-04-08,Hue City,Phu Vang,11,2,2,0,0
2022-04-08,Hue City,Phu Vang,12,1,1,0,0
2022-04-08,Hue City,Phu Vang,14,2,1,1,1
2022-04-08,Hue City,Phu Vang,15,2,2,0,0
2022-04-08,Hue City,Phu Vang,16,1,1,0,0
2022-04-08,Hue City,Phu Vang,17,1,1,0,0
2022-04-08,Hue City,Phu Vang,18,1,1,0,0
2022-04-08,Hue City,Phu Vang,19,1,0,1,0
2022-04-08,Hue City,Phu Vang,20,4,4,0,0
2022-04-08,Hue City,Phu Vang,21,3,1,2,1
2022-04-08,Vung Tau,Ba Ria City,7,1,0,1,0
2022-04-08,Vung Tau,Ba Ria City,8,6,3,3,3
2022-04-08,Vung Tau,Ba Ria City,9,2,2,0,0
2022-04-08,Vung Tau,Ba Ria City,10,2,2,0,0
2022-04-08,Vung Tau,Ba Ria City,11,5,4,1,0
2022-04-08,Vung Tau,Ba Ria City,12,2,2,0,0
2022-04-08,Vung Tau,Ba Ria City,13,5,4,1,1
2022-04-08,Vung Tau,Ba Ria City,14,7,6,1,0
2022-04-08,Vung Tau,Ba Ria City,15,18,15,3,1
2022-04-08,Vung Tau,Ba Ria City,16,7,3,4,2
2022-04-08,Vung Tau,Ba Ria City,18,6,5,1,1
2022-04-08,Vung Tau,Ba Ria City,19,3,0,3,0
2022-04-08,Vung Tau,Ba Ria City,20,1,0,1,1
2022-04-08,Vung Tau,Vung Tau City,2,1,1,0,0
2022-04-08,Vung Tau,Vung Tau City,6,40,29,11,2
2022-04-08,Vung Tau,Vung Tau City,7,88,80,8,1
2022-04-08,Vung Tau,Vung Tau City,8,110,104,6,1
2022-04-08,Vung Tau,Vung Tau City,9,141,125,16,1
2022-04-08,Vung Tau,Vung Tau City,10,174,161,13,0
2022-04-08,Vung Tau,Vung Tau City,11,296,280,16,1
2022-04-08,Vung Tau,Vung Tau City,12,234,217,17,2
2022-04-08,Vung Tau,Vung Tau City,13,227,214,13,2
2022-04-08,Vung Tau,Vung Tau City,14,194,179,15,3
2022-04-08,Vung Tau,Vung Tau City,15,190,180,10,1
2022-04-08,Vung Tau,Vung Tau City,16,178,160,18,1
2022-04-08,Vung Tau,Vung Tau City,17,232,220,12,1
2022-04-08,Vung Tau,Vung Tau City,18,320,298,22,1
2022-04-08,Vung Tau,Vung Tau City,19,226,215,11,0
2022-04-08,Vung Tau,Vung Tau City,20,189,173,16,1
2022-04-08,Vung Tau,Vung Tau City,21,80,62,18,11
2022-04-08,Vung Tau,Vung Tau City,22,3,1,2,0
2022-04-08,Vung Tau,Vung Tau City,23,1,1,0,0
2022-04-09,Binh Duong,Ben Cat,10,1,0,1,1
2022-04-09,Binh Duong,Ben Cat,14,1,1,0,0
2022-04-09,Binh Duong,Ben Cat,15,1,0,1,1
2022-04-09,Binh Duong,Ben Cat,19,2,1,1,1
2022-04-09,Binh Duong,Ben Cat,20,1,1,0,0
2022-04-09,Binh Duong,Ben Cat,21,1,0,1,1
2022-04-09,Binh Duong,Di An,5,1,0,1,1
2022-04-09,Binh Duong,Di An,6,1,0,1,1
2022-04-09,Binh Duong,Di An,7,10,4,6,6
2022-04-09,Binh Duong,Di An,8,12,7,5,3
2022-04-09,Binh Duong,Di An,9,23,12,11,10
2022-04-09,Binh Duong,Di An,10,36,18,18,13
2022-04-09,Binh Duong,Di An,11,26,17,9,6
2022-04-09,Binh Duong,Di An,12,31,22,9,6
2022-04-09,Binh Duong,Di An,13,36,12,24,22
2022-04-09,Binh Duong,Di An,14,24,14,10,9
2022-04-09,Binh Duong,Di An,15,24,8,16,12
2022-04-09,Binh Duong,Di An,16,16,8,8,7
2022-04-09,Binh Duong,Di An,17,15,5,10,9
2022-04-09,Binh Duong,Di An,18,20,16,4,0
2022-04-09,Binh Duong,Di An,19,22,9,13,9
2022-04-09,Binh Duong,Di An,20,22,11,11,11
2022-04-09,Binh Duong,Di An,21,7,0,7,6
2022-04-09,Binh Duong,Phu Giao,13,2,0,2,1
2022-04-09,Binh Duong,Phu Giao,23,1,0,1,1
2022-04-09,Binh Duong,Tan Uyen,8,3,0,3,3
2022-04-09,Binh Duong,Tan Uyen,9,3,1,2,2
2022-04-09,Binh Duong,Tan Uyen,10,1,0,1,1
2022-04-09,Binh Duong,Tan Uyen,11,1,0,1,1
2022-04-09,Binh Duong,Tan Uyen,12,2,1,1,1
2022-04-09,Binh Duong,Tan Uyen,13,5,2,3,3
2022-04-09,Binh Duong,Tan Uyen,17,1,1,0,0
2022-04-09,Binh Duong,Tan Uyen,19,1,1,0,0
2022-04-09,Binh Duong,Thu Dau Mot Town,5,1,0,1,0
2022-04-09,Binh Duong,Thu Dau Mot Town,6,44,37,7,0
2022-04-09,Binh Duong,Thu Dau Mot Town,7,120,112,8,2
2022-04-09,Binh Duong,Thu Dau Mot Town,8,206,194,12,0
2022-04-09,Binh Duong,Thu Dau Mot Town,9,245,237,8,0
2022-04-09,Binh Duong,Thu Dau Mot Town,10,378,355,23,0
2022-04-09,Binh Duong,Thu Dau Mot Town,11,583,543,40,3
2022-04-09,Binh Duong,Thu Dau Mot Town,12,440,419,21,3
2022-04-09,Binh Duong,Thu Dau Mot Town,13,383,354,29,1
2022-04-09,Binh Duong,Thu Dau Mot Town,14,354,332,22,0
2022-04-09,Binh Duong,Thu Dau Mot Town,15,261,247,14,0
2022-04-09,Binh Duong,Thu Dau Mot Town,16,261,249,12,1
2022-04-09,Binh Duong,Thu Dau Mot Town,17,293,280,13,1
2022-04-09,Binh Duong,Thu Dau Mot Town,18,374,351,23,1
2022-04-09,Binh Duong,Thu Dau Mot Town,19,346,317,29,7
2022-04-09,Binh Duong,Thu Dau Mot Town,20,249,223,26,4
2022-04-09,Binh Duong,Thu Dau Mot Town,21,121,105,16,1
2022-04-09,Binh Duong,Thu Dau Mot Town,22,1,1,0,0
2022-04-09,Binh Duong,Thu Dau Mot Town,23,3,1,2,1
2022-04-09,Binh Duong,Thuan An,6,2,0,2,2
2022-04-09,Binh Duong,Thuan An,7,10,5,5,4
2022-04-09,Binh Duong,Thuan An,8,13,7,6,3
2022-04-09,Binh Duong,Thuan An,9,36,23,13,8
2022-04-09,Binh Duong,Thuan An,10,50,28,22,17
2022-04-09,Binh Duong,Thuan An,11,64,45,19,15
2022-04-09,Binh Duong,Thuan An,12,65,42,23,7
2022-04-09,Binh Duong,Thuan An,13,46,30,16,10
2022-04-09,Binh Duong,Thuan An,14,37,32,5,4
2022-04-09,Binh Duong,Thuan An,15,32,22,10,5
2022-04-09,Binh Duong,Thuan An,16,37,24,13,6
2022-04-09,Binh Duong,Thuan An,17,32,27,5,3
2022-04-09,Binh Duong,Thuan An,18,41,28,13,7
2022-04-09,Binh Duong,Thuan An,19,35,19,16,14
2022-04-09,Binh Duong,Thuan An,20,40,19,21,14
2022-04-09,Binh Duong,Thuan An,21,22,7,15,6
2022-04-09,Can Tho City,Binh Thuy District,6,2,1,1,0
2022-04-09,Can Tho City,Binh Thuy District,7,2,2,0,0
2022-04-09,Can Tho City,Binh Thuy District,8,3,3,0,0
2022-04-09,Can Tho City,Binh Thuy District,9,8,6,2,2
2022-04-09,Can Tho City,Binh Thuy District,10,5,5,0,0
2022-04-09,Can Tho City,Binh Thuy District,11,15,15,0,0
2022-04-09,Can Tho City,Binh Thuy District,12,20,15,5,2
2022-04-09,Can Tho City,Binh Thuy District,13,13,10,3,3
2022-04-09,Can Tho City,Binh Thuy District,14,5,3,2,0
2022-04-09,Can Tho City,Binh Thuy District,15,10,10,0,0
2022-04-09,Can Tho City,Binh Thuy District,16,6,6,0,0
2022-04-09,Can Tho City,Binh Thuy District,17,15,15,0,0
2022-04-09,Can Tho City,Binh Thuy District,18,15,13,2,0
2022-04-09,Can Tho City,Binh Thuy District,19,20,18,2,0
2022-04-09,Can Tho City,Binh Thuy District,20,3,3,0,0
2022-04-09,Can Tho City,Binh Thuy District,21,5,2,3,1
2022-04-09,Can Tho City,Cai Rang District,7,5,3,2,1
2022-04-09,Can Tho City,Cai Rang District,8,8,5,3,2
2022-04-09,Can Tho City,Cai Rang District,9,9,6,3,2
2022-04-09,Can Tho City,Cai Rang District,10,7,7,0,0
2022-04-09,Can Tho City,Cai Rang District,11,18,17,1,0
2022-04-09,Can Tho City,Cai Rang District,12,17,14,3,0
2022-04-09,Can Tho City,Cai Rang District,13,14,11,3,0
2022-04-09,Can Tho City,Cai Rang District,14,4,2,2,1
2022-04-09,Can Tho City,Cai Rang District,15,8,8,0,0
2022-04-09,Can Tho City,Cai Rang District,16,10,9,1,1
2022-04-09,Can Tho City,Cai Rang District,17,11,10,1,0
2022-04-09,Can Tho City,Cai Rang District,18,11,10,1,0
2022-04-09,Can Tho City,Cai Rang District,19,11,10,1,0
2022-04-09,Can Tho City,Cai Rang District,20,9,6,3,0
2022-04-09,Can Tho City,Cai Rang District,21,3,1,2,2
2022-04-09,Can Tho City,Ninh Kieu District,0,1,1,0,0
2022-04-09,Can Tho City,Ninh Kieu District,1,1,1,0,0
2022-04-09,Can Tho City,Ninh Kieu District,4,2,0,2,0
2022-04-09,Can Tho City,Ninh Kieu District,5,3,2,1,1
2022-04-09,Can Tho City,Ninh Kieu District,6,47,38,9,0
2022-04-09,Can Tho City,Ninh Kieu District,7,129,121,8,0
2022-04-09,Can Tho City,Ninh Kieu District,8,195,182,13,2
2022-04-09,Can Tho City,Ninh Kieu District,9,280,266,14,0
2022-04-09,Can Tho City,Ninh Kieu District,10,425,410,15,0
2022-04-09,Can Tho City,Ninh Kieu District,11,667,635,32,2
2022-04-09,Can Tho City,Ninh Kieu District,12,566,545,21,0
2022-04-09,Can Tho City,Ninh Kieu District,13,489,464,25,0
2022-04-09,Can Tho City,Ninh Kieu District,14,330,307,23,0
2022-04-09,Can Tho City,Ninh Kieu District,15,287,275,12,0
2022-04-09,Can Tho City,Ninh Kieu District,16,332,317,15,0
2022-04-09,Can Tho City,Ninh Kieu District,17,445,429,16,0
2022-04-09,Can Tho City,Ninh Kieu District,18,467,449,18,0
2022-04-09,Can Tho City,Ninh Kieu District,19,393,362,31,1
2022-04-09,Can Tho City,Ninh Kieu District,20,302,286,16,0
2022-04-09,Can Tho City,Ninh Kieu District,21,171,155,16,2
2022-04-09,Can Tho City,Ninh Kieu District,22,1,1,0,0
2022-04-09,Can Tho City,Ninh Kieu District,23,8,4,4,0
2022-04-09,Dong Nai,Bien Hoa City,0,1,1,0,0
2022-04-09,Dong Nai,Bien Hoa City,1,2,2,0,0
2022-04-09,Dong Nai,Bien Hoa City,5,4,3,1,0
2022-04-09,Dong Nai,Bien Hoa City,6,31,15,16,14
2022-04-09,Dong Nai,Bien Hoa City,7,145,114,31,15
2022-04-09,Dong Nai,Bien Hoa City,8,302,261,41,17
2022-04-09,Dong Nai,Bien Hoa City,9,433,399,34,5
2022-04-09,Dong Nai,Bien Hoa City,10,732,668,64,13
2022-04-09,Dong Nai,Bien Hoa City,11,1012,915,97,28
2022-04-09,Dong Nai,Bien Hoa City,12,890,812,78,8
2022-04-09,Dong Nai,Bien Hoa City,13,769,709,60,7
2022-04-09,Dong Nai,Bien Hoa City,14,506,462,44,2
2022-04-09,Dong Nai,Bien Hoa City,15,492,448,44,7
2022-04-09,Dong Nai,Bien Hoa City,16,513,462,51,9
2022-04-09,Dong Nai,Bien Hoa City,17,618,555,63,15
2022-04-09,Dong Nai,Bien Hoa City,18,750,664,86,34
2022-04-09,Dong Nai,Bien Hoa City,19,706,590,116,54
2022-04-09,Dong Nai,Bien Hoa City,20,544,443,101,33
2022-04-09,Dong Nai,Bien Hoa City,21,258,171,87,35
2022-04-09,Dong Nai,Bien Hoa City,22,6,2,4,0
2022-04-09,Dong Nai,Bien Hoa City,23,3,3,0,0
2022-04-09,Dong Nai,Long Khanh,12,1,0,1,1
2022-04-09,Dong Nai,Long Thanh,9,1,0,1,1
2022-04-09,Dong Nai,Long Thanh,10,2,0,2,2
2022-04-09,Dong Nai,Long Thanh,11,1,0,1,1
2022-04-09,Dong Nai,Long Thanh,12,2,0,2,2
2022-04-09,Dong Nai,Long Thanh,13,1,0,1,0
2022-04-09,Dong Nai,Long Thanh,15,1,0,1,1
2022-04-09,Dong Nai,Long Thanh,16,2,0,2,2
2022-04-09,Dong Nai,Long Thanh,19,5,0,5,5
2022-04-09,Dong Nai,Nhon trach,14,1,0,1,1
2022-04-09,Dong Nai,Thong Nhat,8,1,1,0,0
2022-04-09,Dong Nai,Thong Nhat,9,2,2,0,0
2022-04-09,Dong Nai,Thong Nhat,11,1,1,0,0
2022-04-09,Dong Nai,Thong Nhat,14,1,1,0,0
2022-04-09,Dong Nai,Thong Nhat,16,1,1,0,0
2022-04-09,Dong Nai,Thong Nhat,18,2,1,1,0
2022-04-09,Dong Nai,Thong Nhat,19,2,2,0,0
2022-04-09,Dong Nai,Thong Nhat,20,1,0,1,0
2022-04-09,Dong Nai,Thong Nhat,21,1,0,1,1
2022-04-09,Dong Nai,Trang Bom,10,1,0,1,1
2022-04-09,Dong Nai,Trang Bom,11,4,1,3,2
2022-04-09,Dong Nai,Trang Bom,20,1,0,1,1
2022-04-09,Dong Nai,Trang Bom,21,1,0,1,1
2022-04-09,Dong Nai,Vinh Cuu,14,1,0,1,1
2022-04-09,Hai Phong City,An Duong,7,1,0,1,1
2022-04-09,Hai Phong City,An Duong,8,7,0,7,6
2022-04-09,Hai Phong City,An Duong,9,6,0,6,5
2022-04-09,Hai Phong City,An Duong,10,11,4,7,6
2022-04-09,Hai Phong City,An Duong,11,4,3,1,1
2022-04-09,Hai Phong City,An Duong,12,3,2,1,0
2022-04-09,Hai Phong City,An Duong,13,10,5,5,4
2022-04-09,Hai Phong City,An Duong,14,3,0,3,2
2022-04-09,Hai Phong City,An Duong,15,4,3,1,1
2022-04-09,Hai Phong City,An Duong,16,2,1,1,0
2022-04-09,Hai Phong City,An Duong,17,2,1,1,1
2022-04-09,Hai Phong City,An Duong,18,5,4,1,0
2022-04-09,Hai Phong City,An Duong,19,2,0,2,2
2022-04-09,Hai Phong City,An Duong,20,1,0,1,1
2022-04-09,Hai Phong City,An Duong,21,1,0,1,1
2022-04-09,Hai Phong City,Do Son District,10,2,0,2,2
2022-04-09,Hai Phong City,Do Son District,11,3,0,3,3
2022-04-09,Hai Phong City,Do Son District,17,1,0,1,1
2022-04-09,Hai Phong City,Do Son District,20,1,0,1,1
2022-04-09,Hai Phong City,Duong Kinh District,9,1,0,1,1
2022-04-09,Hai Phong City,Duong Kinh District,17,1,0,1,1
2022-04-09,Hai Phong City,Hai An District,7,8,4,4,3
2022-04-09,Hai Phong City,Hai An District,8,12,8,4,3
2022-04-09,Hai Phong City,Hai An District,9,8,6,2,0
2022-04-09,Hai Phong City,Hai An District,10,27,26,1,1
2022-04-09,Hai Phong City,Hai An District,11,52,39,13,5
2022-04-09,Hai Phong City,Hai An District,12,29,23,6,2
2022-04-09,Hai Phong City,Hai An District,13,23,15,8,2
2022-04-09,Hai Phong City,Hai An District,14,10,6,4,0
2022-04-09,Hai Phong City,Hai An District,15,16,13,3,0
2022-04-09,Hai Phong City,Hai An District,16,18,14,4,0
2022-04-09,Hai Phong City,Hai An District,17,19,14,5,0
2022-04-09,Hai Phong City,Hai An District,18,25,21,4,0
2022-04-09,Hai Phong City,Hai An District,19,23,20,3,0
2022-04-09,Hai Phong City,Hai An District,20,22,16,6,1
2022-04-09,Hai Phong City,Hai An District,21,9,4,5,2
2022-04-09,Hai Phong City,Hong Bang District,7,18,10,8,4
2022-04-09,Hai Phong City,Hong Bang District,8,25,21,4,2
2022-04-09,Hai Phong City,Hong Bang District,9,35,29,6,1
2022-04-09,Hai Phong City,Hong Bang District,10,59,53,6,3
2022-04-09,Hai Phong City,Hong Bang District,11,116,99,17,9
2022-04-09,Hai Phong City,Hong Bang District,12,79,72,7,2
2022-04-09,Hai Phong City,Hong Bang District,13,32,29,3,2
2022-04-09,Hai Phong City,Hong Bang District,14,53,46,7,0
2022-04-09,Hai Phong City,Hong Bang District,15,54,45,9,1
2022-04-09,Hai Phong City,Hong Bang District,16,43,38,5,3
2022-04-09,Hai Phong City,Hong Bang District,17,50,42,8,1
2022-04-09,Hai Phong City,Hong Bang District,18,69,56,13,6
2022-04-09,Hai Phong City,Hong Bang District,19,59,48,11,2
2022-04-09,Hai Phong City,Hong Bang District,20,38,30,8,3
2022-04-09,Hai Phong City,Hong Bang District,21,18,12,6,5
2022-04-09,Hai Phong City,Kien An District,7,1,0,1,1
2022-04-09,Hai Phong City,Kien An District,8,5,5,0,0
2022-04-09,Hai Phong City,Kien An District,9,6,2,4,4
2022-04-09,Hai Phong City,Kien An District,10,13,5,8,8
2022-04-09,Hai Phong City,Kien An District,11,19,8,11,8
2022-04-09,Hai Phong City,Kien An District,12,14,9,5,1
2022-04-09,Hai Phong City,Kien An District,13,8,6,2,0
2022-04-09,Hai Phong City,Kien An District,14,12,5,7,7
2022-04-09,Hai Phong City,Kien An District,15,16,11,5,3
2022-04-09,Hai Phong City,Kien An District,16,13,9,4,3
2022-04-09,Hai Phong City,Kien An District,17,9,9,0,0
2022-04-09,Hai Phong City,Kien An District,18,16,11,5,1
2022-04-09,Hai Phong City,Kien An District,19,13,8,5,2
2022-04-09,Hai Phong City,Kien An District,20,13,5,8,5
2022-04-09,Hai Phong City,Kien An District,21,4,1,3,2
2022-04-09,Hai Phong City,Kien An District,22,1,0,1,0
2022-04-09,Hai Phong City,Le Chan District,0,2,1,1,0
2022-04-09,Hai Phong City,Le Chan District,1,1,0,1,0
2022-04-09,Hai Phong City,Le Chan District,6,2,1,1,0
2022-04-09,Hai Phong City,Le Chan District,7,31,27,4,1
2022-04-09,Hai Phong City,Le Chan District,8,84,70,14,2
2022-04-09,Hai Phong City,Le Chan District,9,104,92,12,1
2022-04-09,Hai Phong City,Le Chan District,10,199,170,29,12
2022-04-09,Hai Phong City,Le Chan District,11,318,277,41,18
2022-04-09,Hai Phong City,Le Chan District,12,221,206,15,2
2022-04-09,Hai Phong City,Le Chan District,13,115,105,10,2
2022-04-09,Hai Phong City,Le Chan District,14,154,141,13,1
2022-04-09,Hai Phong City,Le Chan District,15,162,138,24,6
2022-04-09,Hai Phong City,Le Chan District,16,160,134,26,6
2022-04-09,Hai Phong City,Le Chan District,17,159,144,15,2
2022-04-09,Hai Phong City,Le Chan District,18,249,217,32,10
2022-04-09,Hai Phong City,Le Chan District,19,184,150,34,9
2022-04-09,Hai Phong City,Le Chan District,20,149,113,36,14
2022-04-09,Hai Phong City,Le Chan District,21,68,48,20,11
2022-04-09,Hai Phong City,Ngo Quyen District,5,1,1,0,0
2022-04-09,Hai Phong City,Ngo Quyen District,6,1,0,1,1
2022-04-09,Hai Phong City,Ngo Quyen District,7,23,20,3,1
2022-04-09,Hai Phong City,Ngo Quyen District,8,79,64,15,2
2022-04-09,Hai Phong City,Ngo Quyen District,9,95,85,10,0
2022-04-09,Hai Phong City,Ngo Quyen District,10,175,156,19,2
2022-04-09,Hai Phong City,Ngo Quyen District,11,264,220,44,17
2022-04-09,Hai Phong City,Ngo Quyen District,12,192,170,22,3
2022-04-09,Hai Phong City,Ngo Quyen District,13,127,106,21,0
2022-04-09,Hai Phong City,Ngo Quyen District,14,140,119,21,7
2022-04-09,Hai Phong City,Ngo Quyen District,15,152,136,16,3
2022-04-09,Hai Phong City,Ngo Quyen District,16,128,122,6,1
2022-04-09,Hai Phong City,Ngo Quyen District,17,150,142,8,1
2022-04-09,Hai Phong City,Ngo Quyen District,18,188,160,28,10
2022-04-09,Hai Phong City,Ngo Quyen District,19,156,131,25,9
2022-04-09,Hai Phong City,Ngo Quyen District,20,142,114,28,8
2022-04-09,Hai Phong City,Ngo Quyen District,21,84,57,27,10
2022-04-09,Hai Phong City,Ngo Quyen District,22,2,0,2,0
2022-04-09,Hai Phong City,Ngo Quyen District,23,1,1,0,0
2022-04-09,Hai Phong City,Thuy Nguyen,7,1,0,1,1
2022-04-09,Hai Phong City,Thuy Nguyen,9,1,0,1,1
2022-04-09,Hai Phong City,Thuy Nguyen,10,2,0,2,2
2022-04-09,Hai Phong City,Thuy Nguyen,12,2,0,2,1
2022-04-09,Hai Phong City,Thuy Nguyen,13,1,1,0,0
2022-04-09,Hai Phong City,Thuy Nguyen,18,2,0,2,1
2022-04-09,Hai Phong City,Thuy Nguyen,19,2,0,2,2
2022-04-09,Hai Phong City,Thuy Nguyen,20,1,0,1,1
2022-04-09,Hue City,Hue City,0,2,2,0,0
2022-04-09,Hue City,Hue City,2,1,1,0,0
2022-04-09,Hue City,Hue City,5,4,2,2,0
2022-04-09,Hue City,Hue City,6,74,62,12,4
2022-04-09,Hue City,Hue City,7,226,204,22,1
2022-04-09,Hue City,Hue City,8,312,293,19,0
2022-04-09,Hue City,Hue City,9,261,241,20,0
2022-04-09,Hue City,Hue City,10,407,383,24,1
2022-04-09,Hue City,Hue City,11,775,712,63,3
2022-04-09,Hue City,Hue City,12,573,533,40,0
2022-04-09,Hue City,Hue City,13,358,329,29,0
2022-04-09,Hue City,Hue City,14,304,290,14,1
2022-04-09,Hue City,Hue City,15,381,355,26,4
2022-04-09,Hue City,Hue City,16,375,345,30,5
2022-04-09,Hue City,Hue City,17,480,442,38,3
2022-04-09,Hue City,Hue City,18,659,600,59,7
2022-04-09,Hue City,Hue City,19,624,539,85,17
2022-04-09,Hue City,Hue City,20,417,364,53,6
2022-04-09,Hue City,Hue City,21,248,208,40,2
2022-04-09,Hue City,Hue City,22,6,3,3,0
2022-04-09,Hue City,Hue City,23,3,3,0,0
2022-04-09,Hue City,Huong Thuy,8,1,1,0,0
2022-04-09,Hue City,Huong Thuy,11,2,2,0,0
2022-04-09,Hue City,Huong Thuy,12,2,2,0,0
2022-04-09,Hue City,Huong Thuy,13,1,1,0,0
2022-04-09,Hue City,Huong Thuy,14,2,1,1,0
2022-04-09,Hue City,Huong Thuy,21,1,1,0,0
2022-04-09,Hue City,Phu Vang,9,1,1,0,0
2022-04-09,Hue City,Phu Vang,10,1,1,0,0
2022-04-09,Hue City,Phu Vang,11,6,3,3,2
2022-04-09,Hue City,Phu Vang,13,1,1,0,0
2022-04-09,Hue City,Phu Vang,14,3,2,1,0
2022-04-09,Hue City,Phu Vang,15,7,6,1,1
2022-04-09,Hue City,Phu Vang,16,1,1,0,0
2022-04-09,Hue City,Phu Vang,17,3,2,1,1
2022-04-09,Hue City,Phu Vang,18,4,2,2,0
2022-04-09,Hue City,Phu Vang,19,2,1,1,0
2022-04-09,Hue City,Phu Vang,20,2,0,2,1
2022-04-09,Vung Tau,Ba Ria City,7,1,1,0,0
2022-04-09,Vung Tau,Ba Ria City,8,1,1,0,0
2022-04-09,Vung Tau,Ba Ria City,9,3,3,0,0
2022-04-09,Vung Tau,Ba Ria City,10,6,5,1,0
2022-04-09,Vung Tau,Ba Ria City,11,5,4,1,0
2022-04-09,Vung Tau,Ba Ria City,12,5,4,1,0
2022-04-09,Vung Tau,Ba Ria City,13,2,2,0,0
2022-04-09,Vung Tau,Ba Ria City,14,4,3,1,1
2022-04-09,Vung Tau,Ba Ria City,15,5,3,2,0
2022-04-09,Vung Tau,Ba Ria City,16,3,1,2,2
2022-04-09,Vung Tau,Ba Ria City,17,8,3,5,5
2022-04-09,Vung Tau,Ba Ria City,18,3,2,1,1
2022-04-09,Vung Tau,Ba Ria City,19,13,0,13,7
2022-04-09,Vung Tau,Ba Ria City,20,6,0,6,5
2022-04-09,Vung Tau,Ba Ria City,21,7,0,7,3
2022-04-09,Vung Tau,Vung Tau City,2,1,0,1,0
2022-04-09,Vung Tau,Vung Tau City,5,1,1,0,0
2022-04-09,Vung Tau,Vung Tau City,6,36,30,6,2
2022-04-09,Vung Tau,Vung Tau City,7,85,79,6,0
2022-04-09,Vung Tau,Vung Tau City,8,192,177,15,1
2022-04-09,Vung Tau,Vung Tau City,9,170,159,11,1
2022-04-09,Vung Tau,Vung Tau City,10,215,200,15,3
2022-04-09,Vung Tau,Vung Tau City,11,353,332,21,1
2022-04-09,Vung Tau,Vung Tau City,12,350,328,22,1
2022-04-09,Vung Tau,Vung Tau City,13,228,210,18,1
2022-04-09,Vung Tau,Vung Tau City,14,215,201,14,2
2022-04-09,Vung Tau,Vung Tau City,15,212,201,11,2
2022-04-09,Vung Tau,Vung Tau City,16,186,173,13,0
2022-04-09,Vung Tau,Vung Tau City,17,286,271,15,0
2022-04-09,Vung Tau,Vung Tau City,18,400,353,47,12
2022-04-09,Vung Tau,Vung Tau City,19,283,246,37,5
2022-04-09,Vung Tau,Vung Tau City,20,262,216,46,15
2022-04-09,Vung Tau,Vung Tau City,21,136,99,37,14
2022-04-09,Vung Tau,Vung Tau City,23,2,2,0,0
2022-04-10,Binh Duong,Ben Cat,12,1,1,0,0
2022-04-10,Binh Duong,Ben Cat,14,3,0,3,2
2022-04-10,Binh Duong,Ben Cat,15,1,0,1,1
2022-04-10,Binh Duong,Ben Cat,18,2,1,1,1
2022-04-10,Binh Duong,Ben Cat,19,4,1,3,0
2022-04-10,Binh Duong,Di An,6,1,1,0,0
2022-04-10,Binh Duong,Di An,7,7,2,5,2
2022-04-10,Binh Duong,Di An,8,9,4,5,3
2022-04-10,Binh Duong,Di An,9,16,11,5,5
2022-04-10,Binh Duong,Di An,10,24,20,4,2
2022-04-10,Binh Duong,Di An,11,59,27,32,29
2022-04-10,Binh Duong,Di An,12,46,23,23,18
2022-04-10,Binh Duong,Di An,13,30,20,10,9
2022-04-10,Binh Duong,Di An,14,28,13,15,12
2022-04-10,Binh Duong,Di An,15,28,15,13,8
2022-04-10,Binh Duong,Di An,16,23,13,10,3
2022-04-10,Binh Duong,Di An,17,18,9,9,9
2022-04-10,Binh Duong,Di An,18,34,12,22,21
2022-04-10,Binh Duong,Di An,19,42,17,25,17
2022-04-10,Binh Duong,Di An,20,22,11,11,8
2022-04-10,Binh Duong,Di An,21,15,2,13,10
2022-04-10,Binh Duong,Tan Uyen,8,4,0,4,3
2022-04-10,Binh Duong,Tan Uyen,9,1,0,1,1
2022-04-10,Binh Duong,Tan Uyen,10,1,0,1,1
2022-04-10,Binh Duong,Tan Uyen,11,3,3,0,0
2022-04-10,Binh Duong,Tan Uyen,12,2,1,1,0
2022-04-10,Binh Duong,Tan Uyen,14,2,2,0,0
2022-04-10,Binh Duong,Tan Uyen,17,2,2,0,0
2022-04-10,Binh Duong,Tan Uyen,18,9,1,8,7
2022-04-10,Binh Duong,Tan Uyen,20,1,0,1,0
2022-04-10,Binh Duong,Tan Uyen,21,1,0,1,1
2022-04-10,Binh Duong,Thu Dau Mot Town,0,1,0,1,0
2022-04-10,Binh Duong,Thu Dau Mot Town,1,1,1,0,0
2022-04-10,Binh Duong,Thu Dau Mot Town,5,3,3,0,0
2022-04-10,Binh Duong,Thu Dau Mot Town,6,33,26,7,2
2022-04-10,Binh Duong,Thu Dau Mot Town,7,129,115,14,1
2022-04-10,Binh Duong,Thu Dau Mot Town,8,178,162,16,1
2022-04-10,Binh Duong,Thu Dau Mot Town,9,259,243,16,1
2022-04-10,Binh Duong,Thu Dau Mot Town,10,394,362,32,6
2022-04-10,Binh Duong,Thu Dau Mot Town,11,558,515,43,7
2022-04-10,Binh Duong,Thu Dau Mot Town,12,475,450,25,3
2022-04-10,Binh Duong,Thu Dau Mot Town,13,354,336,18,1
2022-04-10,Binh Duong,Thu Dau Mot Town,14,353,329,24,2
2022-04-10,Binh Duong,Thu Dau Mot Town,15,335,309,26,2
2022-04-10,Binh Duong,Thu Dau Mot Town,16,309,279,30,1
2022-04-10,Binh Duong,Thu Dau Mot Town,17,373,352,21,1
2022-04-10,Binh Duong,Thu Dau Mot Town,18,433,385,48,16
2022-04-10,Binh Duong,Thu Dau Mot Town,19,381,337,44,12
2022-04-10,Binh Duong,Thu Dau Mot Town,20,263,229,34,3
2022-04-10,Binh Duong,Thu Dau Mot Town,21,143,126,17,3
2022-04-10,Binh Duong,Thu Dau Mot Town,22,1,0,1,0
2022-04-10,Binh Duong,Thu Dau Mot Town,23,1,0,1,0
2022-04-10,Binh Duong,Thuan An,6,4,0,4,4
2022-04-10,Binh Duong,Thuan An,7,6,3,3,2
2022-04-10,Binh Duong,Thuan An,8,14,7,7,4
2022-04-10,Binh Duong,Thuan An,9,39,28,11,9
2022-04-10,Binh Duong,Thuan An,10,56,41,15,9
2022-04-10,Binh Duong,Thuan An,11,54,46,8,3
2022-04-10,Binh Duong,Thuan An,12,67,40,27,19
2022-04-10,Binh Duong,Thuan An,13,58,38,20,17
2022-04-10,Binh Duong,Thuan An,14,54,32,22,20
2022-04-10,Binh Duong,Thuan An,15,55,38,17,12
2022-04-10,Binh Duong,Thuan An,16,42,34,8,3
2022-04-10,Binh Duong,Thuan An,17,46,32,14,9
2022-04-10,Binh Duong,Thuan An,18,65,30,35,23
2022-04-10,Binh Duong,Thuan An,19,56,25,31,24
2022-04-10,Binh Duong,Thuan An,20,32,9,23,21
2022-04-10,Binh Duong,Thuan An,21,25,11,14,7
2022-04-10,Can Tho City,Binh Thuy District,7,4,2,2,0
2022-04-10,Can Tho City,Binh Thuy District,8,2,2,0,0
2022-04-10,Can Tho City,Binh Thuy District,9,12,12,0,0
2022-04-10,Can Tho City,Binh Thuy District,10,13,11,2,0
2022-04-10,Can Tho City,Binh Thuy District,11,19,16,3,0
2022-04-10,Can Tho City,Binh Thuy District,12,13,13,0,0
2022-04-10,Can Tho City,Binh Thuy District,13,13,10,3,0
2022-04-10,Can Tho City,Binh Thuy District,14,14,9,5,2
2022-04-10,Can Tho City,Binh Thuy District,15,11,10,1,0
2022-04-10,Can Tho City,Binh Thuy District,16,17,17,0,0
2022-04-10,Can Tho City,Binh Thuy District,17,17,16,1,0
2022-04-10,Can Tho City,Binh Thuy District,18,16,13,3,2
2022-04-10,Can Tho City,Binh Thuy District,19,15,15,0,0
2022-04-10,Can Tho City,Binh Thuy District,20,12,11,1,1
2022-04-10,Can Tho City,Binh Thuy District,21,3,2,1,1
2022-04-10,Can Tho City,Cai Rang District,7,1,1,0,0
2022-04-10,Can Tho City,Cai Rang District,8,3,3,0,0
2022-04-10,Can Tho City,Cai Rang District,9,6,5,1,0
2022-04-10,Can Tho City,Cai Rang District,10,7,7,0,0
2022-04-10,Can Tho City,Cai Rang District,11,11,11,0,0
2022-04-10,Can Tho City,Cai Rang District,12,9,8,1,0
2022-04-10,Can Tho City,Cai Rang District,13,10,8,2,1
2022-04-10,Can Tho City,Cai Rang District,14,12,10,2,0
2022-04-10,Can Tho City,Cai Rang District,15,7,4,3,1
2022-04-10,Can Tho City,Cai Rang District,16,9,9,0,0
2022-04-10,Can Tho City,Cai Rang District,17,8,6,2,0
2022-04-10,Can Tho City,Cai Rang District,18,14,13,1,0
2022-04-10,Can Tho City,Cai Rang District,19,8,8,0,0
2022-04-10,Can Tho City,Cai Rang District,20,12,8,4,1
2022-04-10,Can Tho City,Cai Rang District,21,3,1,2,0
2022-04-10,Can Tho City,Cai Rang District,23,1,1,0,0
2022-04-10,Can Tho City,Ninh Kieu District,0,7,4,3,0
2022-04-10,Can Tho City,Ninh Kieu District,1,2,1,1,0
2022-04-10,Can Tho City,Ninh Kieu District,2,1,1,0,0
2022-04-10,Can Tho City,Ninh Kieu District,3,1,1,0,0
2022-04-10,Can Tho City,Ninh Kieu District,4,1,0,1,1
2022-04-10,Can Tho City,Ninh Kieu District,5,1,1,0,0
2022-04-10,Can Tho City,Ninh Kieu District,6,50,39,11,6
2022-04-10,Can Tho City,Ninh Kieu District,7,114,97,17,2
2022-04-10,Can Tho City,Ninh Kieu District,8,199,187,12,0
2022-04-10,Can Tho City,Ninh Kieu District,9,275,260,15,0
2022-04-10,Can Tho City,Ninh Kieu District,10,525,502,23,0
2022-04-10,Can Tho City,Ninh Kieu District,11,670,624,46,4
2022-04-10,Can Tho City,Ninh Kieu District,12,561,534,27,0
2022-04-10,Can Tho City,Ninh Kieu District,13,488,460,28,0
2022-04-10,Can Tho City,Ninh Kieu District,14,399,375,24,2
2022-04-10,Can Tho City,Ninh Kieu District,15,355,328,27,0
2022-04-10,Can Tho City,Ninh Kieu District,16,371,345,26,1
2022-04-10,Can Tho City,Ninh Kieu District,17,433,413,20,0
2022-04-10,Can Tho City,Ninh Kieu District,18,498,439,59,23
2022-04-10,Can Tho City,Ninh Kieu District,19,554,427,127,78
2022-04-10,Can Tho City,Ninh Kieu District,20,346,306,40,4
2022-04-10,Can Tho City,Ninh Kieu District,21,155,140,15,0
2022-04-10,Can Tho City,Ninh Kieu District,22,2,0,2,0
2022-04-10,Can Tho City,Thoi Lai,11,1,0,1,1
2022-04-10,Can Tho City,Thoi Lai,17,1,0,1,1
2022-04-10,Dong Nai,Bien Hoa City,0,5,5,0,0
2022-04-10,Dong Nai,Bien Hoa City,3,3,2,1,0
2022-04-10,Dong Nai,Bien Hoa City,4,2,1,1,1
2022-04-10,Dong Nai,Bien Hoa City,5,1,1,0,0
2022-04-10,Dong Nai,Bien Hoa City,6,31,23,8,5
2022-04-10,Dong Nai,Bien Hoa City,7,141,117,24,12
2022-04-10,Dong Nai,Bien Hoa City,8,285,243,42,13
2022-04-10,Dong Nai,Bien Hoa City,9,478,411,67,19
2022-04-10,Dong Nai,Bien Hoa City,10,860,755,105,35
2022-04-10,Dong Nai,Bien Hoa City,11,1163,984,179,69
2022-04-10,Dong Nai,Bien Hoa City,12,1019,898,121,49
2022-04-10,Dong Nai,Bien Hoa City,13,821,730,91,40
2022-04-10,Dong Nai,Bien Hoa City,14,677,594,83,30
2022-04-10,Dong Nai,Bien Hoa City,15,578,511,67,24
2022-04-10,Dong Nai,Bien Hoa City,16,527,473,54,25
2022-04-10,Dong Nai,Bien Hoa City,17,719,598,121,48
2022-04-10,Dong Nai,Bien Hoa City,18,750,596,154,77
2022-04-10,Dong Nai,Bien Hoa City,19,861,622,239,149
2022-04-10,Dong Nai,Bien Hoa City,20,678,423,255,159
2022-04-10,Dong Nai,Bien Hoa City,21,282,186,96,44
2022-04-10,Dong Nai,Bien Hoa City,22,6,2,4,1
2022-04-10,Dong Nai,Bien Hoa City,23,2,2,0,0
2022-04-10,Dong Nai,Long Khanh,7,1,0,1,1
2022-04-10,Dong Nai,Long Khanh,17,1,0,1,1
2022-04-10,Dong Nai,Long Thanh,10,3,0,3,3
2022-04-10,Dong Nai,Long Thanh,11,2,0,2,2
2022-04-10,Dong Nai,Long Thanh,13,1,0,1,1
2022-04-10,Dong Nai,Long Thanh,14,3,0,3,3
2022-04-10,Dong Nai,Long Thanh,18,1,0,1,1
2022-04-10,Dong Nai,Long Thanh,21,1,0,1,1
2022-04-10,Dong Nai,Nhon trach,13,1,0,1,1
2022-04-10,Dong Nai,Nhon trach,16,1,0,1,1
2022-04-10,Dong Nai,Nhon trach,21,1,0,1,1
2022-04-10,Dong Nai,Thong Nhat,9,1,1,0,0
2022-04-10,Dong Nai,Thong Nhat,10,2,2,0,0
2022-04-10,Dong Nai,Thong Nhat,11,5,4,1,0
2022-04-10,Dong Nai,Thong Nhat,12,1,1,0,0
2022-04-10,Dong Nai,Thong Nhat,13,1,1,0,0
2022-04-10,Dong Nai,Thong Nhat,14,1,1,0,0
2022-04-10,Dong Nai,Thong Nhat,15,2,2,0,0
2022-04-10,Dong Nai,Thong Nhat,17,1,1,0,0
2022-04-10,Dong Nai,Thong Nhat,19,3,3,0,0
2022-04-10,Dong Nai,Thong Nhat,20,5,5,0,0
2022-04-10,Dong Nai,Trang Bom,11,2,0,2,2
2022-04-10,Dong Nai,Trang Bom,12,1,0,1,1
2022-04-10,Dong Nai,Trang Bom,14,2,0,2,2
2022-04-10,Dong Nai,Trang Bom,15,2,0,2,1
2022-04-10,Dong Nai,Trang Bom,16,1,0,1,1
2022-04-10,Dong Nai,Trang Bom,18,3,0,3,3
2022-04-10,Dong Nai,Trang Bom,19,1,0,1,0
2022-04-10,Dong Nai,Trang Bom,20,3,0,3,3
2022-04-10,Hai Phong City,An Duong,7,1,1,0,0
2022-04-10,Hai Phong City,An Duong,8,1,0,1,0
2022-04-10,Hai Phong City,An Duong,9,5,2,3,1
2022-04-10,Hai Phong City,An Duong,10,4,3,1,0
2022-04-10,Hai Phong City,An Duong,11,1,0,1,1
2022-04-10,Hai Phong City,An Duong,12,2,1,1,0
2022-04-10,Hai Phong City,An Duong,13,1,0,1,1
2022-04-10,Hai Phong City,An Duong,14,4,2,2,2
2022-04-10,Hai Phong City,An Duong,15,7,5,2,1
2022-04-10,Hai Phong City,An Duong,16,7,3,4,0
2022-04-10,Hai Phong City,An Duong,17,1,0,1,1
2022-04-10,Hai Phong City,An Duong,19,2,2,0,0
2022-04-10,Hai Phong City,Do Son District,11,2,0,2,1
2022-04-10,Hai Phong City,Do Son District,12,1,0,1,1
2022-04-10,Hai Phong City,Do Son District,15,1,0,1,1
2022-04-10,Hai Phong City,Do Son District,17,2,0,2,2
2022-04-10,Hai Phong City,Do Son District,19,1,0,1,1
2022-04-10,Hai Phong City,Duong Kinh District,14,1,0,1,1
2022-04-10,Hai Phong City,Duong Kinh District,17,3,0,3,0
2022-04-10,Hai Phong City,Hai An District,5,1,0,1,0
2022-04-10,Hai Phong City,Hai An District,7,5,3,2,0
2022-04-10,Hai Phong City,Hai An District,8,8,5,3,1
2022-04-10,Hai Phong City,Hai An District,9,9,7,2,0
2022-04-10,Hai Phong City,Hai An District,10,22,18,4,1
2022-04-10,Hai Phong City,Hai An District,11,53,37,16,7
2022-04-10,Hai Phong City,Hai An District,12,27,22,5,0
2022-04-10,Hai Phong City,Hai An District,13,24,21,3,0
2022-04-10,Hai Phong City,Hai An District,14,10,8,2,0
2022-04-10,Hai Phong City,Hai An District,15,29,20,9,0
2022-04-10,Hai Phong City,Hai An District,16,18,16,2,0
2022-04-10,Hai Phong City,Hai An District,17,13,12,1,1
2022-04-10,Hai Phong City,Hai An District,18,25,20,5,3
2022-04-10,Hai Phong City,Hai An District,19,28,20,8,2
2022-04-10,Hai Phong City,Hai An District,20,22,17,5,3
2022-04-10,Hai Phong City,Hai An District,21,16,8,8,4
2022-04-10,Hai Phong City,Hong Bang District,7,13,10,3,3
2022-04-10,Hai Phong City,Hong Bang District,8,26,20,6,3
2022-04-10,Hai Phong City,Hong Bang District,9,35,31,4,0
2022-04-10,Hai Phong City,Hong Bang District,10,80,67,13,6
2022-04-10,Hai Phong City,Hong Bang District,11,123,84,39,25
2022-04-10,Hai Phong City,Hong Bang District,12,82,62,20,11
2022-04-10,Hai Phong City,Hong Bang District,13,50,43,7,2
2022-04-10,Hai Phong City,Hong Bang District,14,40,33,7,1
2022-04-10,Hai Phong City,Hong Bang District,15,51,37,14,4
2022-04-10,Hai Phong City,Hong Bang District,16,44,36,8,1
2022-04-10,Hai Phong City,Hong Bang District,17,52,43,9,0
2022-04-10,Hai Phong City,Hong Bang District,18,69,47,22,12
2022-04-10,Hai Phong City,Hong Bang District,19,69,38,31,22
2022-04-10,Hai Phong City,Hong Bang District,20,45,21,24,16
2022-04-10,Hai Phong City,Hong Bang District,21,17,5,12,5
2022-04-10,Hai Phong City,Hong Bang District,23,1,1,0,0
2022-04-10,Hai Phong City,Kien An District,8,3,2,1,0
2022-04-10,Hai Phong City,Kien An District,9,8,2,6,5
2022-04-10,Hai Phong City,Kien An District,10,19,6,13,11
2022-04-10,Hai Phong City,Kien An District,11,18,11,7,4
2022-04-10,Hai Phong City,Kien An District,12,13,7,6,2
2022-04-10,Hai Phong City,Kien An District,13,6,5,1,1
2022-04-10,Hai Phong City,Kien An District,14,7,4,3,2
2022-04-10,Hai Phong City,Kien An District,15,15,8,7,1
2022-04-10,Hai Phong City,Kien An District,16,11,7,4,2
2022-04-10,Hai Phong City,Kien An District,17,8,6,2,1
2022-04-10,Hai Phong City,Kien An District,18,8,5,3,2
2022-04-10,Hai Phong City,Kien An District,19,10,8,2,1
2022-04-10,Hai Phong City,Kien An District,20,9,4,5,2
2022-04-10,Hai Phong City,Kien An District,21,1,0,1,1
2022-04-10,Hai Phong City,Le Chan District,0,2,2,0,0
2022-04-10,Hai Phong City,Le Chan District,1,2,1,1,0
2022-04-10,Hai Phong City,Le Chan District,2,1,1,0,0
2022-04-10,Hai Phong City,Le Chan District,6,3,2,1,0
2022-04-10,Hai Phong City,Le Chan District,7,42,26,16,10
2022-04-10,Hai Phong City,Le Chan District,8,78,60,18,6
2022-04-10,Hai Phong City,Le Chan District,9,83,70,13,1
2022-04-10,Hai Phong City,Le Chan District,10,252,200,52,21
2022-04-10,Hai Phong City,Le Chan District,11,339,238,101,51
2022-04-10,Hai Phong City,Le Chan District,12,264,210,54,21
2022-04-10,Hai Phong City,Le Chan District,13,178,147,31,13
2022-04-10,Hai Phong City,Le Chan District,14,161,123,38,11
2022-04-10,Hai Phong City,Le Chan District,15,166,129,37,10
2022-04-10,Hai Phong City,Le Chan District,16,171,148,23,1
2022-04-10,Hai Phong City,Le Chan District,17,175,144,31,6
2022-04-10,Hai Phong City,Le Chan District,18,234,173,61,27
2022-04-10,Hai Phong City,Le Chan District,19,225,153,72,42
2022-04-10,Hai Phong City,Le Chan District,20,170,107,63,28
2022-04-10,Hai Phong City,Le Chan District,21,86,46,40,18
2022-04-10,Hai Phong City,Le Chan District,22,4,2,2,0
2022-04-10,Hai Phong City,Le Chan District,23,2,0,2,0
2022-04-10,Hai Phong City,Ngo Quyen District,0,2,1,1,0
2022-04-10,Hai Phong City,Ngo Quyen District,6,1,1,0,0
2022-04-10,Hai Phong City,Ngo Quyen District,7,33,27,6,1
2022-04-10,Hai Phong City,Ngo Quyen District,8,69,54,15,5
2022-04-10,Hai Phong City,Ngo Quyen District,9,110,95,15,0
2022-04-10,Hai Phong City,Ngo Quyen District,10,194,158,36,15
2022-04-10,Hai Phong City,Ngo Quyen District,11,263,210,53,30
2022-04-10,Hai Phong City,Ngo Quyen District,12,213,165,48,19
2022-04-10,Hai Phong City,Ngo Quyen District,13,135,121,14,3
2022-04-10,Hai Phong City,Ngo Quyen District,14,156,131,25,2
2022-04-10,Hai Phong City,Ngo Quyen District,15,159,142,17,1
2022-04-10,Hai Phong City,Ngo Quyen District,16,146,115,31,3
2022-04-10,Hai Phong City,Ngo Quyen District,17,137,112,25,0
2022-04-10,Hai Phong City,Ngo Quyen District,18,217,163,54,28
2022-04-10,Hai Phong City,Ngo Quyen District,19,217,154,63,33
2022-04-10,Hai Phong City,Ngo Quyen District,20,170,103,67,36
2022-04-10,Hai Phong City,Ngo Quyen District,21,83,46,37,15
2022-04-10,Hai Phong City,Ngo Quyen District,22,1,1,0,0
2022-04-10,Hai Phong City,Thuy Nguyen,8,1,0,1,1
2022-04-10,Hai Phong City,Thuy Nguyen,10,3,0,3,2
2022-04-10,Hai Phong City,Thuy Nguyen,11,4,1,3,2
2022-04-10,Hai Phong City,Thuy Nguyen,12,1,0,1,0
2022-04-10,Hai Phong City,Thuy Nguyen,15,3,0,3,3
2022-04-10,Hai Phong City,Thuy Nguyen,16,3,0,3,3
2022-04-10,Hai Phong City,Thuy Nguyen,17,1,0,1,1
2022-04-10,Hai Phong City,Thuy Nguyen,19,1,0,1,1
2022-04-10,Hai Phong City,Thuy Nguyen,20,1,0,1,1
2022-04-10,Hue City,Hue City,0,1,0,1,0
2022-04-10,Hue City,Hue City,3,1,0,1,0
2022-04-10,Hue City,Hue City,5,1,1,0,0
2022-04-10,Hue City,Hue City,6,48,42,6,0
2022-04-10,Hue City,Hue City,7,167,161,6,0
2022-04-10,Hue City,Hue City,8,294,265,29,0
2022-04-10,Hue City,Hue City,9,314,286,28,1
2022-04-10,Hue City,Hue City,10,448,429,19,0
2022-04-10,Hue City,Hue City,11,784,701,83,9
2022-04-10,Hue City,Hue City,12,608,544,64,3
2022-04-10,Hue City,Hue City,13,382,353,29,2
2022-04-10,Hue City,Hue City,14,346,326,20,4
2022-04-10,Hue City,Hue City,15,385,358,27,5
2022-04-10,Hue City,Hue City,16,419,390,29,2
2022-04-10,Hue City,Hue City,17,546,489,57,1
2022-04-10,Hue City,Hue City,18,696,581,115,32
2022-04-10,Hue City,Hue City,19,714,536,178,86
2022-04-10,Hue City,Hue City,20,471,370,101,25
2022-04-10,Hue City,Hue City,21,309,219,90,27
2022-04-10,Hue City,Hue City,22,6,3,3,1
2022-04-10,Hue City,Hue City,23,3,3,0,0
2022-04-10,Hue City,Huong Thuy,6,1,0,1,1
2022-04-10,Hue City,Huong Thuy,10,1,1,0,0
2022-04-10,Hue City,Huong Thuy,11,1,1,0,0
2022-04-10,Hue City,Huong Thuy,15,2,2,0,0
2022-04-10,Hue City,Huong Thuy,16,1,0,1,0
2022-04-10,Hue City,Huong Thuy,18,1,1,0,0
2022-04-10,Hue City,Huong Thuy,19,1,1,0,0
2022-04-10,Hue City,Huong Thuy,20,1,0,1,1
2022-04-10,Hue City,Huong Tra,6,1,1,0,0
2022-04-10,Hue City,Huong Tra,20,1,1,0,0
2022-04-10,Hue City,Huong Tra,21,3,0,3,3
2022-04-10,Hue City,Phu Vang,6,1,0,1,0
2022-04-10,Hue City,Phu Vang,9,1,0,1,0
2022-04-10,Hue City,Phu Vang,10,3,2,1,0
2022-04-10,Hue City,Phu Vang,12,2,1,1,1
2022-04-10,Hue City,Phu Vang,13,3,3,0,0
2022-04-10,Hue City,Phu Vang,15,1,1,0,0
2022-04-10,Hue City,Phu Vang,16,1,1,0,0
2022-04-10,Hue City,Phu Vang,17,3,2,1,1
2022-04-10,Hue City,Phu Vang,18,3,2,1,0
2022-04-10,Hue City,Phu Vang,19,2,1,1,0
2022-04-10,Hue City,Phu Vang,21,1,0,1,1
2022-04-10,Vung Tau,Ba Ria City,6,1,0,1,1
2022-04-10,Vung Tau,Ba Ria City,8,5,0,5,5
2022-04-10,Vung Tau,Ba Ria City,9,13,6,7,7
2022-04-10,Vung Tau,Ba Ria City,10,14,8,6,4
2022-04-10,Vung Tau,Ba Ria City,11,12,9,3,2
2022-04-10,Vung Tau,Ba Ria City,12,7,6,1,1
2022-04-10,Vung Tau,Ba Ria City,13,7,5,2,1
2022-04-10,Vung Tau,Ba Ria City,14,5,2,3,3
2022-04-10,Vung Tau,Ba Ria City,15,9,2,7,6
2022-04-10,Vung Tau,Ba Ria City,16,7,1,6,6
2022-04-10,Vung Tau,Ba Ria City,17,9,1,8,7
2022-04-10,Vung Tau,Ba Ria City,18,9,0,9,9
2022-04-10,Vung Tau,Ba Ria City,19,11,2,9,7
2022-04-10,Vung Tau,Ba Ria City,20,9,0,9,7
2022-04-10,Vung Tau,Ba Ria City,21,3,0,3,3
2022-04-10,Vung Tau,Tan Thanh,16,3,0,3,3
2022-04-10,Vung Tau,Tan Thanh,17,1,0,1,1
2022-04-10,Vung Tau,Vung Tau City,0,2,2,0,0
2022-04-10,Vung Tau,Vung Tau City,2,1,1,0,0
2022-04-10,Vung Tau,Vung Tau City,6,42,36,6,3
2022-04-10,Vung Tau,Vung Tau City,7,122,107,15,2
2022-04-10,Vung Tau,Vung Tau City,8,205,176,29,7
2022-04-10,Vung Tau,Vung Tau City,9,240,219,21,3
2022-04-10,Vung Tau,Vung Tau City,10,320,294,26,3
2022-04-10,Vung Tau,Vung Tau City,11,450,414,36,4
2022-04-10,Vung Tau,Vung Tau City,12,387,354,33,7
2022-04-10,Vung Tau,Vung Tau City,13,297,278,19,1
2022-04-10,Vung Tau,Vung Tau City,14,284,264,20,1
2022-04-10,Vung Tau,Vung Tau City,15,283,258,25,4
2022-04-10,Vung Tau,Vung Tau City,16,255,241,14,1
2022-04-10,Vung Tau,Vung Tau City,17,339,316,23,3
2022-04-10,Vung Tau,Vung Tau City,18,388,329,59,15
2022-04-10,Vung Tau,Vung Tau City,19,348,285,63,32
2022-04-10,Vung Tau,Vung Tau City,20,238,196,42,12
2022-04-10,Vung Tau,Vung Tau City,21,166,98,68,35
2022-04-10,Vung Tau,Vung Tau City,22,3,1,2,1
2022-04-10,Vung Tau,Vung Tau City,23,3,3,0,0
2022-04-11,Binh Duong,Ben Cat,9,1,0,1,1
2022-04-11,Binh Duong,Ben Cat,10,1,1,0,0
2022-04-11,Binh Duong,Ben Cat,13,1,0,1,1
2022-04-11,Binh Duong,Ben Cat,15,1,0,1,0
2022-04-11,Binh Duong,Ben Cat,17,1,0,1,1
2022-04-11,Binh Duong,Ben Cat,19,1,0,1,1
2022-04-11,Binh Duong,Di An,0,1,1,0,0
2022-04-11,Binh Duong,Di An,2,1,1,0,0
2022-04-11,Binh Duong,Di An,7,2,1,1,1
2022-04-11,Binh Duong,Di An,8,11,7,4,3
2022-04-11,Binh Duong,Di An,9,17,12,5,3
2022-04-11,Binh Duong,Di An,10,25,13,12,10
2022-04-11,Binh Duong,Di An,11,45,18,27,21
2022-04-11,Binh Duong,Di An,12,41,23,18,16
2022-04-11,Binh Duong,Di An,13,26,17,9,3
2022-04-11,Binh Duong,Di An,14,20,10,10,6
2022-04-11,Binh Duong,Di An,15,27,20,7,3
2022-04-11,Binh Duong,Di An,16,19,15,4,3
2022-04-11,Binh Duong,Di An,17,17,9,8,3
2022-04-11,Binh Duong,Di An,18,42,21,21,14
2022-04-11,Binh Duong,Di An,19,23,8,15,11
2022-04-11,Binh Duong,Di An,20,8,5,3,3
2022-04-11,Binh Duong,Di An,21,5,2,3,2
2022-04-11,Binh Duong,Tan Uyen,9,4,2,2,0
2022-04-11,Binh Duong,Tan Uyen,10,2,2,0,0
2022-04-11,Binh Duong,Tan Uyen,11,3,0,3,3
2022-04-11,Binh Duong,Tan Uyen,12,2,2,0,0
2022-04-11,Binh Duong,Tan Uyen,13,4,1,3,2
2022-04-11,Binh Duong,Tan Uyen,14,6,2,4,3
2022-04-11,Binh Duong,Tan Uyen,16,1,1,0,0
2022-04-11,Binh Duong,Tan Uyen,18,3,0,3,3
2022-04-11,Binh Duong,Tan Uyen,19,1,0,1,0
2022-04-11,Binh Duong,Thu Dau Mot Town,0,3,2,1,0
2022-04-11,Binh Duong,Thu Dau Mot Town,1,1,1,0,0
2022-04-11,Binh Duong,Thu Dau Mot Town,5,1,0,1,0
2022-04-11,Binh Duong,Thu Dau Mot Town,6,35,28,7,3
2022-04-11,Binh Duong,Thu Dau Mot Town,7,94,92,2,1
2022-04-11,Binh Duong,Thu Dau Mot Town,8,182,164,18,0
2022-04-11,Binh Duong,Thu Dau Mot Town,9,272,249,23,2
2022-04-11,Binh Duong,Thu Dau Mot Town,10,438,403,35,0
2022-04-11,Binh Duong,Thu Dau Mot Town,11,542,513,29,6
2022-04-11,Binh Duong,Thu Dau Mot Town,12,474,450,24,1
2022-04-11,Binh Duong,Thu Dau Mot Town,13,400,377,23,1
2022-04-11,Binh Duong,Thu Dau Mot Town,14,329,317,12,3
2022-04-11,Binh Duong,Thu Dau Mot Town,15,289,268,21,2
2022-04-11,Binh Duong,Thu Dau Mot Town,16,291,275,16,1
2022-04-11,Binh Duong,Thu Dau Mot Town,17,329,305,24,1
2022-04-11,Binh Duong,Thu Dau Mot Town,18,392,366,26,2
2022-04-11,Binh Duong,Thu Dau Mot Town,19,353,336,17,2
2022-04-11,Binh Duong,Thu Dau Mot Town,20,235,212,23,4
2022-04-11,Binh Duong,Thu Dau Mot Town,21,110,95,15,0
2022-04-11,Binh Duong,Thu Dau Mot Town,22,2,1,1,0
2022-04-11,Binh Duong,Thuan An,6,1,0,1,0
2022-04-11,Binh Duong,Thuan An,7,11,8,3,2
2022-04-11,Binh Duong,Thuan An,8,14,12,2,1
2022-04-11,Binh Duong,Thuan An,9,39,27,12,5
2022-04-11,Binh Duong,Thuan An,10,34,27,7,6
2022-04-11,Binh Duong,Thuan An,11,85,62,23,18
2022-04-11,Binh Duong,Thuan An,12,61,42,19,6
2022-04-11,Binh Duong,Thuan An,13,54,43,11,6
2022-04-11,Binh Duong,Thuan An,14,63,45,18,9
2022-04-11,Binh Duong,Thuan An,15,45,30,15,11
2022-04-11,Binh Duong,Thuan An,16,32,28,4,2
2022-04-11,Binh Duong,Thuan An,17,51,38,13,8
2022-04-11,Binh Duong,Thuan An,18,35,30,5,2
2022-04-11,Binh Duong,Thuan An,19,28,20,8,6
2022-04-11,Binh Duong,Thuan An,20,38,15,23,19
2022-04-11,Binh Duong,Thuan An,21,22,8,14,11
2022-04-11,Can Tho City,Binh Thuy District,2,2,1,1,0
2022-04-11,Can Tho City,Binh Thuy District,7,4,1,3,1
2022-04-11,Can Tho City,Binh Thuy District,8,6,4,2,0
2022-04-11,Can Tho City,Binh Thuy District,9,13,11,2,0
2022-04-11,Can Tho City,Binh Thuy District,10,11,11,0,0
2022-04-11,Can Tho City,Binh Thuy District,11,7,6,1,0
2022-04-11,Can Tho City,Binh Thuy District,12,16,15,1,0
2022-04-11,Can Tho City,Binh Thuy District,13,14,13,1,0
2022-04-11,Can Tho City,Binh Thuy District,14,10,8,2,0
2022-04-11,Can Tho City,Binh Thuy District,15,14,14,0,0
2022-04-11,Can Tho City,Binh Thuy District,16,19,17,2,0
2022-04-11,Can Tho City,Binh Thuy District,17,10,10,0,0
2022-04-11,Can Tho City,Binh Thuy District,18,10,9,1,0
2022-04-11,Can Tho City,Binh Thuy District,19,14,12,2,1
2022-04-11,Can Tho City,Binh Thuy District,20,13,12,1,1
2022-04-11,Can Tho City,Binh Thuy District,21,5,3,2,1
2022-04-11,Can Tho City,Cai Rang District,6,2,0,2,1
2022-04-11,Can Tho City,Cai Rang District,7,3,3,0,0
2022-04-11,Can Tho City,Cai Rang District,8,5,3,2,2
2022-04-11,Can Tho City,Cai Rang District,9,6,5,1,0
2022-04-11,Can Tho City,Cai Rang District,10,13,12,1,1
2022-04-11,Can Tho City,Cai Rang District,11,14,13,1,1
2022-04-11,Can Tho City,Cai Rang District,12,17,17,0,0
2022-04-11,Can Tho City,Cai Rang District,13,9,9,0,0
2022-04-11,Can Tho City,Cai Rang District,14,10,9,1,0
2022-04-11,Can Tho City,Cai Rang District,15,12,8,4,0
2022-04-11,Can Tho City,Cai Rang District,16,10,7,3,1
2022-04-11,Can Tho City,Cai Rang District,17,19,17,2,0
2022-04-11,Can Tho City,Cai Rang District,18,8,8,0,0
2022-04-11,Can Tho City,Cai Rang District,19,13,12,1,0
2022-04-11,Can Tho City,Cai Rang District,20,14,10,4,1
2022-04-11,Can Tho City,Cai Rang District,21,2,1,1,0
2022-04-11,Can Tho City,Ninh Kieu District,2,2,1,1,0
2022-04-11,Can Tho City,Ninh Kieu District,5,1,1,0,0
2022-04-11,Can Tho City,Ninh Kieu District,6,33,30,3,0
2022-04-11,Can Tho City,Ninh Kieu District,7,123,109,14,2
2022-04-11,Can Tho City,Ninh Kieu District,8,226,215,11,1
2022-04-11,Can Tho City,Ninh Kieu District,9,283,265,18,2
2022-04-11,Can Tho City,Ninh Kieu District,10,501,470,31,1
2022-04-11,Can Tho City,Ninh Kieu District,11,714,670,44,1
2022-04-11,Can Tho City,Ninh Kieu District,12,602,577,25,0
2022-04-11,Can Tho City,Ninh Kieu District,13,418,400,18,0
2022-04-11,Can Tho City,Ninh Kieu District,14,376,361,15,0
2022-04-11,Can Tho City,Ninh Kieu District,15,389,374,15,0
2022-04-11,Can Tho City,Ninh Kieu District,16,395,378,17,0
2022-04-11,Can Tho City,Ninh Kieu District,17,515,485,30,0
2022-04-11,Can Tho City,Ninh Kieu District,18,492,464,28,0
2022-04-11,Can Tho City,Ninh Kieu District,19,446,425,21,0
2022-04-11,Can Tho City,Ninh Kieu District,20,351,319,32,0
2022-04-11,Can Tho City,Ninh Kieu District,21,163,144,19,1
2022-04-11,Can Tho City,Ninh Kieu District,22,5,3,2,0
2022-04-11,Can Tho City,Ninh Kieu District,23,4,3,1,0
2022-04-11,Dong Nai,Bien Hoa City,0,4,4,0,0
2022-04-11,Dong Nai,Bien Hoa City,1,2,1,1,0
2022-04-11,Dong Nai,Bien Hoa City,3,3,2,1,0
2022-04-11,Dong Nai,Bien Hoa City,5,1,1,0,0
2022-04-11,Dong Nai,Bien Hoa City,6,35,21,14,11
2022-04-11,Dong Nai,Bien Hoa City,7,156,118,38,11
2022-04-11,Dong Nai,Bien Hoa City,8,295,256,39,10
2022-04-11,Dong Nai,Bien Hoa City,9,473,406,67,12
2022-04-11,Dong Nai,Bien Hoa City,10,786,709,77,14
2022-04-11,Dong Nai,Bien Hoa City,11,1152,1005,147,51
2022-04-11,Dong Nai,Bien Hoa City,12,996,872,124,49
2022-04-11,Dong Nai,Bien Hoa City,13,767,688,79,18
2022-04-11,Dong Nai,Bien Hoa City,14,669,582,87,27
2022-04-11,Dong Nai,Bien Hoa City,15,590,521,69,24
2022-04-11,Dong Nai,Bien Hoa City,16,595,530,65,23
2022-04-11,Dong Nai,Bien Hoa City,17,690,605,85,19
2022-04-11,Dong Nai,Bien Hoa City,18,736,631,105,40
2022-04-11,Dong Nai,Bien Hoa City,19,783,579,204,101
2022-04-11,Dong Nai,Bien Hoa City,20,561,388,173,107
2022-04-11,Dong Nai,Bien Hoa City,21,215,146,69,29
2022-04-11,Dong Nai,Bien Hoa City,22,2,1,1,0
2022-04-11,Dong Nai,Bien Hoa City,23,2,1,1,0
2022-04-11,Dong Nai,Long Khanh,9,1,0,1,1
2022-04-11,Dong Nai,Long Khanh,10,1,0,1,1
2022-04-11,Dong Nai,Long Khanh,15,1,0,1,0
2022-04-11,Dong Nai,Long Thanh,9,1,0,1,1
2022-04-11,Dong Nai,Long Thanh,10,2,0,2,2
2022-04-11,Dong Nai,Long Thanh,11,2,0,2,2
2022-04-11,Dong Nai,Long Thanh,12,1,0,1,1
2022-04-11,Dong Nai,Long Thanh,13,1,1,0,0
2022-04-11,Dong Nai,Long Thanh,15,1,0,1,1
2022-04-11,Dong Nai,Long Thanh,16,5,0,5,5
2022-04-11,Dong Nai,Long Thanh,19,2,0,2,2
2022-04-11,Dong Nai,Long Thanh,20,1,0,1,1
2022-04-11,Dong Nai,Nhon trach,11,2,0,2,2
2022-04-11,Dong Nai,Nhon trach,12,1,0,1,1
2022-04-11,Dong Nai,Nhon trach,16,1,0,1,1
2022-04-11,Dong Nai,Thong Nhat,8,1,1,0,0
2022-04-11,Dong Nai,Thong Nhat,9,3,3,0,0
2022-04-11,Dong Nai,Thong Nhat,10,2,2,0,0
2022-04-11,Dong Nai,Thong Nhat,11,1,1,0,0
2022-04-11,Dong Nai,Thong Nhat,12,3,3,0,0
2022-04-11,Dong Nai,Thong Nhat,15,1,0,1,1
2022-04-11,Dong Nai,Thong Nhat,17,1,1,0,0
2022-04-11,Dong Nai,Thong Nhat,20,2,1,1,1
2022-04-11,Dong Nai,Trang Bom,9,2,0,2,0
2022-04-11,Dong Nai,Trang Bom,10,1,0,1,1
2022-04-11,Dong Nai,Trang Bom,11,1,0,1,1
2022-04-11,Dong Nai,Trang Bom,12,1,0,1,1
2022-04-11,Dong Nai,Trang Bom,13,1,0,1,1
2022-04-11,Dong Nai,Trang Bom,14,1,0,1,1
2022-04-11,Dong Nai,Trang Bom,15,1,0,1,1
2022-04-11,Dong Nai,Trang Bom,18,1,0,1,1
2022-04-11,Hai Phong City,An Duong,7,2,1,1,1
2022-04-11,Hai Phong City,An Duong,8,3,1,2,2
2022-04-11,Hai Phong City,An Duong,9,3,2,1,0
2022-04-11,Hai Phong City,An Duong,10,3,1,2,2
2022-04-11,Hai Phong City,An Duong,11,3,1,2,2
2022-04-11,Hai Phong City,An Duong,14,5,2,3,2
2022-04-11,Hai Phong City,An Duong,16,1,1,0,0
2022-04-11,Hai Phong City,An Duong,17,5,5,0,0
2022-04-11,Hai Phong City,An Duong,18,2,1,1,0
2022-04-11,Hai Phong City,An Duong,19,2,0,2,1
2022-04-11,Hai Phong City,An Duong,21,1,0,1,1
2022-04-11,Hai Phong City,Duong Kinh District,9,1,1,0,0
2022-04-11,Hai Phong City,Duong Kinh District,17,1,0,1,1
2022-04-11,Hai Phong City,Hai An District,6,1,1,0,0
2022-04-11,Hai Phong City,Hai An District,7,8,6,2,1
2022-04-11,Hai Phong City,Hai An District,8,21,14,7,1
2022-04-11,Hai Phong City,Hai An District,9,16,10,6,1
2022-04-11,Hai Phong City,Hai An District,10,33,27,6,4
2022-04-11,Hai Phong City,Hai An District,11,31,25,6,1
2022-04-11,Hai Phong City,Hai An District,12,32,27,5,1
2022-04-11,Hai Phong City,Hai An District,13,19,11,8,0
2022-04-11,Hai Phong City,Hai An District,14,11,8,3,0
2022-04-11,Hai Phong City,Hai An District,15,27,22,5,1
2022-04-11,Hai Phong City,Hai An District,16,9,7,2,0
2022-04-11,Hai Phong City,Hai An District,17,24,20,4,1
2022-04-11,Hai Phong City,Hai An District,18,20,18,2,0
2022-04-11,Hai Phong City,Hai An District,19,13,9,4,2
2022-04-11,Hai Phong City,Hai An District,20,19,9,10,7
2022-04-11,Hai Phong City,Hai An District,21,8,3,5,5
2022-04-11,Hai Phong City,Hong Bang District,0,1,0,1,0
2022-04-11,Hai Phong City,Hong Bang District,7,9,4,5,2
2022-04-11,Hai Phong City,Hong Bang District,8,20,13,7,3
2022-04-11,Hai Phong City,Hong Bang District,9,36,26,10,3
2022-04-11,Hai Phong City,Hong Bang District,10,77,62,15,3
2022-04-11,Hai Phong City,Hong Bang District,11,115,90,25,15
2022-04-11,Hai Phong City,Hong Bang District,12,81,72,9,1
2022-04-11,Hai Phong City,Hong Bang District,13,39,34,5,0
2022-04-11,Hai Phong City,Hong Bang District,14,47,44,3,2
2022-04-11,Hai Phong City,Hong Bang District,15,48,41,7,1
2022-04-11,Hai Phong City,Hong Bang District,16,42,37,5,2
2022-04-11,Hai Phong City,Hong Bang District,17,40,36,4,1
2022-04-11,Hai Phong City,Hong Bang District,18,47,35,12,5
2022-04-11,Hai Phong City,Hong Bang District,19,71,56,15,5
2022-04-11,Hai Phong City,Hong Bang District,20,46,31,15,8
2022-04-11,Hai Phong City,Hong Bang District,21,12,6,6,3
2022-04-11,Hai Phong City,Kien An District,7,4,0,4,3
2022-04-11,Hai Phong City,Kien An District,8,4,2,2,2
2022-04-11,Hai Phong City,Kien An District,9,7,1,6,5
2022-04-11,Hai Phong City,Kien An District,10,10,7,3,3
2022-04-11,Hai Phong City,Kien An District,11,20,18,2,2
2022-04-11,Hai Phong City,Kien An District,12,5,4,1,1
2022-04-11,Hai Phong City,Kien An District,13,7,5,2,1
2022-04-11,Hai Phong City,Kien An District,14,13,7,6,2
2022-04-11,Hai Phong City,Kien An District,15,8,6,2,0
2022-04-11,Hai Phong City,Kien An District,16,8,7,1,1
2022-04-11,Hai Phong City,Kien An District,17,12,9,3,2
2022-04-11,Hai Phong City,Kien An District,18,7,5,2,1
2022-04-11,Hai Phong City,Kien An District,19,13,8,5,3
2022-04-11,Hai Phong City,Kien An District,20,10,6,4,3
2022-04-11,Hai Phong City,Kien An District,21,2,0,2,2
2022-04-11,Hai Phong City,Le Chan District,0,1,1,0,0
2022-04-11,Hai Phong City,Le Chan District,2,1,0,1,0
2022-04-11,Hai Phong City,Le Chan District,5,1,0,1,1
2022-04-11,Hai Phong City,Le Chan District,6,1,1,0,0
2022-04-11,Hai Phong City,Le Chan District,7,32,25,7,4
2022-04-11,Hai Phong City,Le Chan District,8,82,66,16,0
2022-04-11,Hai Phong City,Le Chan District,9,108,89,19,2
2022-04-11,Hai Phong City,Le Chan District,10,235,188,47,14
2022-04-11,Hai Phong City,Le Chan District,11,325,233,92,47
2022-04-11,Hai Phong City,Le Chan District,12,233,190,43,12
2022-04-11,Hai Phong City,Le Chan District,13,151,129,22,1
2022-04-11,Hai Phong City,Le Chan District,14,151,120,31,2
2022-04-11,Hai Phong City,Le Chan District,15,184,150,34,7
2022-04-11,Hai Phong City,Le Chan District,16,180,149,31,1
2022-04-11,Hai Phong City,Le Chan District,17,201,172,29,6
2022-04-11,Hai Phong City,Le Chan District,18,220,186,34,11
2022-04-11,Hai Phong City,Le Chan District,19,161,135,26,6
2022-04-11,Hai Phong City,Le Chan District,20,132,113,19,5
2022-04-11,Hai Phong City,Le Chan District,21,47,38,9,1
2022-04-11,Hai Phong City,Le Chan District,23,2,1,1,0
2022-04-11,Hai Phong City,Ngo Quyen District,0,2,1,1,0
2022-04-11,Hai Phong City,Ngo Quyen District,7,17,14,3,1
2022-04-11,Hai Phong City,Ngo Quyen District,8,74,59,15,4
2022-04-11,Hai Phong City,Ngo Quyen District,9,102,86,16,2
2022-04-11,Hai Phong City,Ngo Quyen District,10,178,143,35,10
2022-04-11,Hai Phong City,Ngo Quyen District,11,271,208,63,28
2022-04-11,Hai Phong City,Ngo Quyen District,12,189,156,33,9
2022-04-11,Hai Phong City,Ngo Quyen District,13,144,114,30,3
2022-04-11,Hai Phong City,Ngo Quyen District,14,138,120,18,3
2022-04-11,Hai Phong City,Ngo Quyen District,15,138,119,19,5
2022-04-11,Hai Phong City,Ngo Quyen District,16,141,122,19,7
2022-04-11,Hai Phong City,Ngo Quyen District,17,158,124,34,10
2022-04-11,Hai Phong City,Ngo Quyen District,18,190,164,26,9
2022-04-11,Hai Phong City,Ngo Quyen District,19,179,131,48,23
2022-04-11,Hai Phong City,Ngo Quyen District,20,112,86,26,13
2022-04-11,Hai Phong City,Ngo Quyen District,21,52,45,7,3
2022-04-11,Hai Phong City,Ngo Quyen District,23,1,0,1,0
2022-04-11,Hai Phong City,Thuy Nguyen,6,1,0,1,0
2022-04-11,Hai Phong City,Thuy Nguyen,9,1,0,1,1
2022-04-11,Hai Phong City,Thuy Nguyen,10,1,1,0,0
2022-04-11,Hai Phong City,Thuy Nguyen,11,3,1,2,1
2022-04-11,Hai Phong City,Thuy Nguyen,13,1,0,1,1
2022-04-11,Hai Phong City,Thuy Nguyen,14,3,1,2,2
2022-04-11,Hai Phong City,Thuy Nguyen,15,2,0,2,2
2022-04-11,Hai Phong City,Thuy Nguyen,16,3,1,2,2
2022-04-11,Hai Phong City,Thuy Nguyen,17,1,0,1,1
2022-04-11,Hai Phong City,Thuy Nguyen,18,1,0,1,1
2022-04-11,Hai Phong City,Thuy Nguyen,19,2,0,2,2
2022-04-11,Hue City,Hue City,0,3,2,1,0
2022-04-11,Hue City,Hue City,1,2,2,0,0
2022-04-11,Hue City,Hue City,3,1,0,1,0
2022-04-11,Hue City,Hue City,5,1,1,0,0
2022-04-11,Hue City,Hue City,6,60,55,5,1
2022-04-11,Hue City,Hue City,7,200,186,14,2
2022-04-11,Hue City,Hue City,8,300,281,19,0
2022-04-11,Hue City,Hue City,9,285,260,25,0
2022-04-11,Hue City,Hue City,10,411,374,37,0
2022-04-11,Hue City,Hue City,11,718,660,58,0
2022-04-11,Hue City,Hue City,12,590,548,42,3
2022-04-11,Hue City,Hue City,13,341,318,23,1
2022-04-11,Hue City,Hue City,14,340,317,23,3
2022-04-11,Hue City,Hue City,15,392,369,23,0
2022-04-11,Hue City,Hue City,16,421,393,28,2
2022-04-11,Hue City,Hue City,17,479,452,27,0
2022-04-11,Hue City,Hue City,18,598,552,46,1
2022-04-11,Hue City,Hue City,19,536,484,52,4
2022-04-11,Hue City,Hue City,20,392,344,48,6
2022-04-11,Hue City,Hue City,21,219,177,42,14
2022-04-11,Hue City,Hue City,22,5,1,4,0
2022-04-11,Hue City,Huong Thuy,7,2,0,2,1
2022-04-11,Hue City,Huong Thuy,9,3,1,2,1
2022-04-11,Hue City,Huong Thuy,10,1,0,1,0
2022-04-11,Hue City,Huong Thuy,12,2,1,1,0
2022-04-11,Hue City,Huong Thuy,14,1,0,1,1
2022-04-11,Hue City,Huong Thuy,15,1,1,0,0
2022-04-11,Hue City,Huong Thuy,19,1,0,1,1
2022-04-11,Hue City,Huong Thuy,20,1,1,0,0
2022-04-11,Hue City,Huong Tra,14,1,1,0,0
2022-04-11,Hue City,Huong Tra,16,2,2,0,0
2022-04-11,Hue City,Huong Tra,17,1,1,0,0
2022-04-11,Hue City,Huong Tra,20,2,1,1,1
2022-04-11,Hue City,Phu Vang,6,1,1,0,0
2022-04-11,Hue City,Phu Vang,7,1,1,0,0
2022-04-11,Hue City,Phu Vang,8,4,4,0,0
2022-04-11,Hue City,Phu Vang,10,3,2,1,0
2022-04-11,Hue City,Phu Vang,11,5,3,2,0
2022-04-11,Hue City,Phu Vang,12,4,4,0,0
2022-04-11,Hue City,Phu Vang,13,1,1,0,0
2022-04-11,Hue City,Phu Vang,14,3,3,0,0
2022-04-11,Hue City,Phu Vang,15,3,1,2,2
2022-04-11,Hue City,Phu Vang,16,4,2,2,1
2022-04-11,Hue City,Phu Vang,17,4,3,1,0
2022-04-11,Hue City,Phu Vang,18,2,0,2,0
2022-04-11,Hue City,Phu Vang,19,2,1,1,1
2022-04-11,Hue City,Phu Vang,20,2,2,0,0
2022-04-11,Hue City,Phu Vang,21,1,0,1,0
2022-04-11,Vung Tau,Ba Ria City,8,5,1,4,3
2022-04-11,Vung Tau,Ba Ria City,9,7,4,3,1
2022-04-11,Vung Tau,Ba Ria City,10,15,4,11,10
2022-04-11,Vung Tau,Ba Ria City,11,21,3,18,15
2022-04-11,Vung Tau,Ba Ria City,12,17,2,15,12
2022-04-11,Vung Tau,Ba Ria City,13,10,1,9,7
2022-04-11,Vung Tau,Ba Ria City,14,16,5,11,7
2022-04-11,Vung Tau,Ba Ria City,15,11,2,9,7
2022-04-11,Vung Tau,Ba Ria City,16,13,1,12,6
2022-04-11,Vung Tau,Ba Ria City,17,12,2,10,8
2022-04-11,Vung Tau,Ba Ria City,18,6,1,5,4
2022-04-11,Vung Tau,Ba Ria City,19,9,1,8,8
2022-04-11,Vung Tau,Ba Ria City,20,5,1,4,3
2022-04-11,Vung Tau,Ba Ria City,21,1,0,1,1
2022-04-11,Vung Tau,Vung Tau City,5,1,1,0,0
2022-04-11,Vung Tau,Vung Tau City,6,37,30,7,3
2022-04-11,Vung Tau,Vung Tau City,7,120,111,9,5
2022-04-11,Vung Tau,Vung Tau City,8,215,199,16,0
2022-04-11,Vung Tau,Vung Tau City,9,254,229,25,1
2022-04-11,Vung Tau,Vung Tau City,10,310,274,36,2
2022-04-11,Vung Tau,Vung Tau City,11,385,356,29,3
2022-04-11,Vung Tau,Vung Tau City,12,305,296,9,0
2022-04-11,Vung Tau,Vung Tau City,13,232,220,12,0
2022-04-11,Vung Tau,Vung Tau City,14,266,249,17,2
2022-04-11,Vung Tau,Vung Tau City,15,217,203,14,0
2022-04-11,Vung Tau,Vung Tau City,16,221,210,11,4
2022-04-11,Vung Tau,Vung Tau City,17,255,238,17,1
2022-04-11,Vung Tau,Vung Tau City,18,320,285,35,4
2022-04-11,Vung Tau,Vung Tau City,19,250,224,26,3
2022-04-11,Vung Tau,Vung Tau City,20,183,159,24,7
2022-04-11,Vung Tau,Vung Tau City,21,86,61,25,9
2022-04-11,Vung Tau,Vung Tau City,23,3,1,2,0
2022-04-12,Binh Duong,Ben Cat,9,1,0,1,1
2022-04-12,Binh Duong,Ben Cat,19,2,1,1,1
2022-04-12,Binh Duong,Di An,6,1,0,1,1
2022-04-12,Binh Duong,Di An,7,12,2,10,10
2022-04-12,Binh Duong,Di An,8,14,6,8,2
2022-04-12,Binh Duong,Di An,9,12,8,4,4
2022-04-12,Binh Duong,Di An,10,9,3,6,6
2022-04-12,Binh Duong,Di An,11,45,10,35,26
2022-04-12,Binh Duong,Di An,12,37,12,25,24
2022-04-12,Binh Duong,Di An,13,40,17,23,20
2022-04-12,Binh Duong,Di An,14,31,10,21,14
2022-04-12,Binh Duong,Di An,15,15,6,9,8
2022-04-12,Binh Duong,Di An,16,21,12,9,5
2022-04-12,Binh Duong,Di An,17,20,14,6,4
2022-04-12,Binh Duong,Di An,18,17,13,4,3
2022-04-12,Binh Duong,Di An,19,16,11,5,5
2022-04-12,Binh Duong,Di An,20,17,13,4,3
2022-04-12,Binh Duong,Di An,21,8,1,7,6
2022-04-12,Binh Duong,Di An,22,1,0,1,0
2022-04-12,Binh Duong,Tan Uyen,8,2,1,1,1
2022-04-12,Binh Duong,Tan Uyen,9,1,0,1,1
2022-04-12,Binh Duong,Tan Uyen,10,1,0,1,1
2022-04-12,Binh Duong,Tan Uyen,11,6,1,5,4
2022-04-12,Binh Duong,Tan Uyen,12,1,0,1,1
2022-04-12,Binh Duong,Tan Uyen,13,4,0,4,3
2022-04-12,Binh Duong,Tan Uyen,14,3,2,1,0
2022-04-12,Binh Duong,Tan Uyen,15,1,1,0,0
2022-04-12,Binh Duong,Tan Uyen,17,4,1,3,2
2022-04-12,Binh Duong,Tan Uyen,18,4,0,4,4
2022-04-12,Binh Duong,Tan Uyen,20,1,1,0,0
2022-04-12,Binh Duong,Tan Uyen,21,1,0,1,0
2022-04-12,Binh Duong,Thu Dau Mot Town,0,2,0,2,1
2022-04-12,Binh Duong,Thu Dau Mot Town,2,1,1,0,0
2022-04-12,Binh Duong,Thu Dau Mot Town,4,1,1,0,0
2022-04-12,Binh Duong,Thu Dau Mot Town,5,3,1,2,0
2022-04-12,Binh Duong,Thu Dau Mot Town,6,33,29,4,3
2022-04-12,Binh Duong,Thu Dau Mot Town,7,88,76,12,3
2022-04-12,Binh Duong,Thu Dau Mot Town,8,162,152,10,0
2022-04-12,Binh Duong,Thu Dau Mot Town,9,224,211,13,1
2022-04-12,Binh Duong,Thu Dau Mot Town,10,310,294,16,0
2022-04-12,Binh Duong,Thu Dau Mot Town,11,643,609,34,4
2022-04-12,Binh Duong,Thu Dau Mot Town,12,439,422,17,2
2022-04-12,Binh Duong,Thu Dau Mot Town,13,380,363,17,3
2022-04-12,Binh Duong,Thu Dau Mot Town,14,320,298,22,3
2022-04-12,Binh Duong,Thu Dau Mot Town,15,249,226,23,1
2022-04-12,Binh Duong,Thu Dau Mot Town,16,261,249,12,1
2022-04-12,Binh Duong,Thu Dau Mot Town,17,303,290,13,0
2022-04-12,Binh Duong,Thu Dau Mot Town,18,310,294,16,2
2022-04-12,Binh Duong,Thu Dau Mot Town,19,297,276,21,6
2022-04-12,Binh Duong,Thu Dau Mot Town,20,199,184,15,0
2022-04-12,Binh Duong,Thu Dau Mot Town,21,116,100,16,1
2022-04-12,Binh Duong,Thu Dau Mot Town,22,3,1,2,0
2022-04-12,Binh Duong,Thuan An,4,1,0,1,1
2022-04-12,Binh Duong,Thuan An,6,2,0,2,2
2022-04-12,Binh Duong,Thuan An,7,10,2,8,8
2022-04-12,Binh Duong,Thuan An,8,12,5,7,5
2022-04-12,Binh Duong,Thuan An,9,30,16,14,10
2022-04-12,Binh Duong,Thuan An,10,54,36,18,15
2022-04-12,Binh Duong,Thuan An,11,71,48,23,12
2022-04-12,Binh Duong,Thuan An,12,52,41,11,8
2022-04-12,Binh Duong,Thuan An,13,57,42,15,11
2022-04-12,Binh Duong,Thuan An,14,38,27,11,7
2022-04-12,Binh Duong,Thuan An,15,34,25,9,6
2022-04-12,Binh Duong,Thuan An,16,31,22,9,2
2022-04-12,Binh Duong,Thuan An,17,26,20,6,1
2022-04-12,Binh Duong,Thuan An,18,28,24,4,2
2022-04-12,Binh Duong,Thuan An,19,30,22,8,3
2022-04-12,Binh Duong,Thuan An,20,23,15,8,4
2022-04-12,Binh Duong,Thuan An,21,17,1,16,14
2022-04-12,Can Tho City,Binh Thuy District,5,1,1,0,0
2022-04-12,Can Tho City,Binh Thuy District,7,2,0,2,0
2022-04-12,Can Tho City,Binh Thuy District,8,5,4,1,0
2022-04-12,Can Tho City,Binh Thuy District,9,7,7,0,0
2022-04-12,Can Tho City,Binh Thuy District,10,11,11,0,0
2022-04-12,Can Tho City,Binh Thuy District,11,11,10,1,0
2022-04-12,Can Tho City,Binh Thuy District,12,16,12,4,0
2022-04-12,Can Tho City,Binh Thuy District,13,8,8,0,0
2022-04-12,Can Tho City,Binh Thuy District,14,16,16,0,0
2022-04-12,Can Tho City,Binh Thuy District,15,14,12,2,0
2022-04-12,Can Tho City,Binh Thuy District,16,11,10,1,1
2022-04-12,Can Tho City,Binh Thuy District,17,13,12,1,0
2022-04-12,Can Tho City,Binh Thuy District,18,14,14,0,0
2022-04-12,Can Tho City,Binh Thuy District,19,12,12,0,0
2022-04-12,Can Tho City,Binh Thuy District,20,8,7,1,0
2022-04-12,Can Tho City,Binh Thuy District,21,1,1,0,0
2022-04-12,Can Tho City,Cai Rang District,6,2,2,0,0
2022-04-12,Can Tho City,Cai Rang District,7,3,3,0,0
2022-04-12,Can Tho City,Cai Rang District,9,7,5,2,1
2022-04-12,Can Tho City,Cai Rang District,10,15,11,4,2
2022-04-12,Can Tho City,Cai Rang District,11,11,8,3,0
2022-04-12,Can Tho City,Cai Rang District,12,19,18,1,0
2022-04-12,Can Tho City,Cai Rang District,13,10,7,3,0
2022-04-12,Can Tho City,Cai Rang District,14,7,7,0,0
2022-04-12,Can Tho City,Cai Rang District,15,6,5,1,1
2022-04-12,Can Tho City,Cai Rang District,16,8,7,1,1
2022-04-12,Can Tho City,Cai Rang District,17,11,11,0,0
2022-04-12,Can Tho City,Cai Rang District,18,10,9,1,0
2022-04-12,Can Tho City,Cai Rang District,19,4,3,1,1
2022-04-12,Can Tho City,Cai Rang District,20,8,8,0,0
2022-04-12,Can Tho City,Cai Rang District,21,5,4,1,0
2022-04-12,Can Tho City,Ninh Kieu District,0,4,4,0,0
2022-04-12,Can Tho City,Ninh Kieu District,1,2,2,0,0
2022-04-12,Can Tho City,Ninh Kieu District,2,1,1,0,0
2022-04-12,Can Tho City,Ninh Kieu District,3,1,0,1,0
2022-04-12,Can Tho City,Ninh Kieu District,4,3,2,1,1
2022-04-12,Can Tho City,Ninh Kieu District,5,4,4,0,0
2022-04-12,Can Tho City,Ninh Kieu District,6,41,36,5,3
2022-04-12,Can Tho City,Ninh Kieu District,7,118,105,13,0
2022-04-12,Can Tho City,Ninh Kieu District,8,190,177,13,0
2022-04-12,Can Tho City,Ninh Kieu District,9,266,250,16,0
2022-04-12,Can Tho City,Ninh Kieu District,10,529,510,19,0
2022-04-12,Can Tho City,Ninh Kieu District,11,784,753,31,1
2022-04-12,Can Tho City,Ninh Kieu District,12,563,544,19,0
2022-04-12,Can Tho City,Ninh Kieu District,13,465,446,19,0
2022-04-12,Can Tho City,Ninh Kieu District,14,387,362,25,0
2022-04-12,Can Tho City,Ninh Kieu District,15,351,337,14,0
2022-04-12,Can Tho City,Ninh Kieu District,16,359,341,18,0
2022-04-12,Can Tho City,Ninh Kieu District,17,525,511,14,0
2022-04-12,Can Tho City,Ninh Kieu District,18,542,518,24,0
2022-04-12,Can Tho City,Ninh Kieu District,19,472,453,19,0
2022-04-12,Can Tho City,Ninh Kieu District,20,352,330,22,0
2022-04-12,Can Tho City,Ninh Kieu District,21,205,179,26,0
2022-04-12,Can Tho City,Ninh Kieu District,22,1,1,0,0
2022-04-12,Can Tho City,Ninh Kieu District,23,2,1,1,0
2022-04-12,Dong Nai,Bien Hoa City,0,2,1,1,1
2022-04-12,Dong Nai,Bien Hoa City,1,1,1,0,0
2022-04-12,Dong Nai,Bien Hoa City,4,1,0,1,1
2022-04-12,Dong Nai,Bien Hoa City,5,4,0,4,1
2022-04-12,Dong Nai,Bien Hoa City,6,33,12,21,17
2022-04-12,Dong Nai,Bien Hoa City,7,141,106,35,13
2022-04-12,Dong Nai,Bien Hoa City,8,232,211,21,7
2022-04-12,Dong Nai,Bien Hoa City,9,367,319,48,9
2022-04-12,Dong Nai,Bien Hoa City,10,651,554,97,47
2022-04-12,Dong Nai,Bien Hoa City,11,1083,752,331,232
2022-04-12,Dong Nai,Bien Hoa City,12,841,714,127,54
2022-04-12,Dong Nai,Bien Hoa City,13,753,666,87,39
2022-04-12,Dong Nai,Bien Hoa City,14,615,547,68,20
2022-04-12,Dong Nai,Bien Hoa City,15,447,396,51,15
2022-04-12,Dong Nai,Bien Hoa City,16,503,434,69,28
2022-04-12,Dong Nai,Bien Hoa City,17,602,523,79,41
2022-04-12,Dong Nai,Bien Hoa City,18,674,600,74,24
2022-04-12,Dong Nai,Bien Hoa City,19,579,525,54,14
2022-04-12,Dong Nai,Bien Hoa City,20,481,392,89,38
2022-04-12,Dong Nai,Bien Hoa City,21,224,136,88,46
2022-04-12,Dong Nai,Bien Hoa City,22,3,1,2,0
2022-04-12,Dong Nai,Bien Hoa City,23,2,0,2,1
2022-04-12,Dong Nai,Long Khanh,11,1,0,1,1
2022-04-12,Dong Nai,Long Thanh,11,1,0,1,1
2022-04-12,Dong Nai,Nhon trach,16,1,0,1,1
2022-04-12,Dong Nai,Thong Nhat,10,1,1,0,0
2022-04-12,Dong Nai,Thong Nhat,12,2,2,0,0
2022-04-12,Dong Nai,Thong Nhat,13,4,3,1,0
2022-04-12,Dong Nai,Thong Nhat,14,2,2,0,0
2022-04-12,Dong Nai,Thong Nhat,15,2,2,0,0
2022-04-12,Dong Nai,Thong Nhat,18,2,2,0,0
2022-04-12,Dong Nai,Thong Nhat,19,2,2,0,0
2022-04-12,Dong Nai,Thong Nhat,21,1,0,1,1
2022-04-12,Dong Nai,Trang Bom,13,2,1,1,1
2022-04-12,Dong Nai,Trang Bom,15,1,0,1,1
2022-04-12,Dong Nai,Trang Bom,18,1,0,1,1
2022-04-12,Hai Phong City,An Duong,8,3,2,1,1
2022-04-12,Hai Phong City,An Duong,9,2,1,1,1
2022-04-12,Hai Phong City,An Duong,10,7,1,6,5
2022-04-12,Hai Phong City,An Duong,11,5,2,3,3
2022-04-12,Hai Phong City,An Duong,12,4,1,3,2
2022-04-12,Hai Phong City,An Duong,13,4,1,3,3
2022-04-12,Hai Phong City,An Duong,14,3,3,0,0
2022-04-12,Hai Phong City,An Duong,15,3,0,3,3
2022-04-12,Hai Phong City,An Duong,16,1,1,0,0
2022-04-12,Hai Phong City,An Duong,18,1,0,1,0
2022-04-12,Hai Phong City,An Duong,19,2,1,1,1
2022-04-12,Hai Phong City,An Duong,20,3,1,2,2
2022-04-12,Hai Phong City,Do Son District,14,2,0,2,2
2022-04-12,Hai Phong City,Do Son District,21,1,0,1,1
2022-04-12,Hai Phong City,Duong Kinh District,14,1,0,1,1
2022-04-12,Hai Phong City,Hai An District,7,6,2,4,4
2022-04-12,Hai Phong City,Hai An District,8,11,8,3,3
2022-04-12,Hai Phong City,Hai An District,9,8,6,2,0
2022-04-12,Hai Phong City,Hai An District,10,19,17,2,1
2022-04-12,Hai Phong City,Hai An District,11,38,34,4,3
2022-04-12,Hai Phong City,Hai An District,12,24,21,3,1
2022-04-12,Hai Phong City,Hai An District,13,9,5,4,3
2022-04-12,Hai Phong City,Hai An District,14,11,8,3,1
2022-04-12,Hai Phong City,Hai An District,15,19,14,5,1
2022-04-12,Hai Phong City,Hai An District,16,12,10,2,2
2022-04-12,Hai Phong City,Hai An District,17,19,14,5,2
2022-04-12,Hai Phong City,Hai An District,18,15,14,1,0
2022-04-12,Hai Phong City,Hai An District,19,20,15,5,1
2022-04-12,Hai Phong City,Hai An District,20,13,11,2,1
2022-04-12,Hai Phong City,Hai An District,21,10,7,3,2
2022-04-12,Hai Phong City,Hai An District,22,1,1,0,0
2022-04-12,Hai Phong City,Hong Bang District,1,1,0,1,1
2022-04-12,Hai Phong City,Hong Bang District,7,18,13,5,2
2022-04-12,Hai Phong City,Hong Bang District,8,28,26,2,0
2022-04-12,Hai Phong City,Hong Bang District,9,31,27,4,1
2022-04-12,Hai Phong City,Hong Bang District,10,46,40,6,1
2022-04-12,Hai Phong City,Hong Bang District,11,108,97,11,5
2022-04-12,Hai Phong City,Hong Bang District,12,66,62,4,0
2022-04-12,Hai Phong City,Hong Bang District,13,38,31,7,5
2022-04-12,Hai Phong City,Hong Bang District,14,39,35,4,3
2022-04-12,Hai Phong City,Hong Bang District,15,45,42,3,0
2022-04-12,Hai Phong City,Hong Bang District,16,32,30,2,1
2022-04-12,Hai Phong City,Hong Bang District,17,31,28,3,0
2022-04-12,Hai Phong City,Hong Bang District,18,64,56,8,2
2022-04-12,Hai Phong City,Hong Bang District,19,45,41,4,0
2022-04-12,Hai Phong City,Hong Bang District,20,39,31,8,1
2022-04-12,Hai Phong City,Hong Bang District,21,20,16,4,3
2022-04-12,Hai Phong City,Kien An District,8,2,0,2,2
2022-04-12,Hai Phong City,Kien An District,9,7,1,6,6
2022-04-12,Hai Phong City,Kien An District,10,12,7,5,5
2022-04-12,Hai Phong City,Kien An District,11,14,9,5,4
2022-04-12,Hai Phong City,Kien An District,12,6,5,1,0
2022-04-12,Hai Phong City,Kien An District,13,5,2,3,2
2022-04-12,Hai Phong City,Kien An District,14,8,5,3,2
2022-04-12,Hai Phong City,Kien An District,15,3,2,1,1
2022-04-12,Hai Phong City,Kien An District,16,3,2,1,1
2022-04-12,Hai Phong City,Kien An District,17,8,4,4,1
2022-04-12,Hai Phong City,Kien An District,18,10,7,3,2
2022-04-12,Hai Phong City,Kien An District,19,18,11,7,3
2022-04-12,Hai Phong City,Kien An District,20,13,8,5,4
2022-04-12,Hai Phong City,Kien An District,21,13,4,9,5
2022-04-12,Hai Phong City,Le Chan District,6,1,1,0,0
2022-04-12,Hai Phong City,Le Chan District,7,21,18,3,3
2022-04-12,Hai Phong City,Le Chan District,8,59,53,6,0
2022-04-12,Hai Phong City,Le Chan District,9,50,47,3,0
2022-04-12,Hai Phong City,Le Chan District,10,110,99,11,1
2022-04-12,Hai Phong City,Le Chan District,11,279,251,28,8
2022-04-12,Hai Phong City,Le Chan District,12,174,157,17,4
2022-04-12,Hai Phong City,Le Chan District,13,111,101,10,3
2022-04-12,Hai Phong City,Le Chan District,14,132,109,23,3
2022-04-12,Hai Phong City,Le Chan District,15,133,123,10,0
2022-04-12,Hai Phong City,Le Chan District,16,115,98,17,1
2022-04-12,Hai Phong City,Le Chan District,17,162,149,13,0
2022-04-12,Hai Phong City,Le Chan District,18,213,196,17,0
2022-04-12,Hai Phong City,Le Chan District,19,175,159,16,1
2022-04-12,Hai Phong City,Le Chan District,20,127,112,15,1
2022-04-12,Hai Phong City,Le Chan District,21,61,41,20,5
2022-04-12,Hai Phong City,Ngo Quyen District,0,2,0,2,0
2022-04-12,Hai Phong City,Ngo Quyen District,5,1,1,0,0
2022-04-12,Hai Phong City,Ngo Quyen District,6,3,3,0,0
2022-04-12,Hai Phong City,Ngo Quyen District,7,16,11,5,5
2022-04-12,Hai Phong City,Ngo Quyen District,8,55,52,3,2
2022-04-12,Hai Phong City,Ngo Quyen District,9,71,69,2,1
2022-04-12,Hai Phong City,Ngo Quyen District,10,74,69,5,3
2022-04-12,Hai Phong City,Ngo Quyen District,11,230,194,36,11
2022-04-12,Hai Phong City,Ngo Quyen District,12,146,133,13,5
2022-04-12,Hai Phong City,Ngo Quyen District,13,88,79,9,1
2022-04-12,Hai Phong City,Ngo Quyen District,14,112,101,11,2
2022-04-12,Hai Phong City,Ngo Quyen District,15,100,92,8,0
2022-04-12,Hai Phong City,Ngo Quyen District,16,122,114,8,0
2022-04-12,Hai Phong City,Ngo Quyen District,17,111,106,5,0
2022-04-12,Hai Phong City,Ngo Quyen District,18,150,131,19,2
2022-04-12,Hai Phong City,Ngo Quyen District,19,152,136,16,0
2022-04-12,Hai Phong City,Ngo Quyen District,20,125,111,14,2
2022-04-12,Hai Phong City,Ngo Quyen District,21,66,48,18,7
2022-04-12,Hai Phong City,Thuy Nguyen,11,4,0,4,2
2022-04-12,Hai Phong City,Thuy Nguyen,12,1,0,1,1
2022-04-12,Hai Phong City,Thuy Nguyen,15,2,0,2,2
2022-04-12,Hai Phong City,Thuy Nguyen,16,2,0,2,2
2022-04-12,Hai Phong City,Thuy Nguyen,18,2,0,2,2
2022-04-12,Hai Phong City,Thuy Nguyen,19,2,0,2,1
2022-04-12,Hai Phong City,Thuy Nguyen,20,1,0,1,1
2022-04-12,Hue City,Hue City,0,3,3,0,0
2022-04-12,Hue City,Hue City,1,1,1,0,0
2022-04-12,Hue City,Hue City,3,1,1,0,0
2022-04-12,Hue City,Hue City,5,2,2,0,0
2022-04-12,Hue City,Hue City,6,52,49,3,1
2022-04-12,Hue City,Hue City,7,153,142,11,0
2022-04-12,Hue City,Hue City,8,250,231,19,0
2022-04-12,Hue City,Hue City,9,227,208,19,1
2022-04-12,Hue City,Hue City,10,324,310,14,2
2022-04-12,Hue City,Hue City,11,825,754,71,2
2022-04-12,Hue City,Hue City,12,512,482,30,0
2022-04-12,Hue City,Hue City,13,316,293,23,1
2022-04-12,Hue City,Hue City,14,347,331,16,0
2022-04-12,Hue City,Hue City,15,335,310,25,3
2022-04-12,Hue City,Hue City,16,338,316,22,3
2022-04-12,Hue City,Hue City,17,453,428,25,1
2022-04-12,Hue City,Hue City,18,608,571,37,1
2022-04-12,Hue City,Hue City,19,550,513,37,1
2022-04-12,Hue City,Hue City,20,447,407,40,1
2022-04-12,Hue City,Hue City,21,259,221,38,2
2022-04-12,Hue City,Hue City,22,2,1,1,0
2022-04-12,Hue City,Hue City,23,1,1,0,0
2022-04-12,Hue City,Huong Thuy,8,3,2,1,0
2022-04-12,Hue City,Huong Thuy,13,1,1,0,0
2022-04-12,Hue City,Huong Thuy,15,1,1,0,0
2022-04-12,Hue City,Huong Thuy,16,2,1,1,1
2022-04-12,Hue City,Huong Thuy,21,2,1,1,1
2022-04-12,Hue City,Huong Tra,11,1,1,0,0
2022-04-12,Hue City,Huong Tra,19,1,1,0,0
2022-04-12,Hue City,Phu Vang,7,2,2,0,0
2022-04-12,Hue City,Phu Vang,9,1,0,1,0
2022-04-12,Hue City,Phu Vang,10,3,3,0,0
2022-04-12,Hue City,Phu Vang,11,3,3,0,0
2022-04-12,Hue City,Phu Vang,12,1,1,0,0
2022-04-12,Hue City,Phu Vang,13,1,1,0,0
2022-04-12,Hue City,Phu Vang,14,1,0,1,0
2022-04-12,Hue City,Phu Vang,15,2,2,0,0
2022-04-12,Hue City,Phu Vang,16,2,2,0,0
2022-04-12,Hue City,Phu Vang,17,2,2,0,0
2022-04-12,Hue City,Phu Vang,18,3,2,1,0
2022-04-12,Hue City,Phu Vang,19,1,0,1,1
2022-04-12,Hue City,Phu Vang,20,4,2,2,0
2022-04-12,Vung Tau,Ba Ria City,8,1,1,0,0
2022-04-12,Vung Tau,Ba Ria City,9,3,2,1,1
2022-04-12,Vung Tau,Ba Ria City,10,8,3,5,2
2022-04-12,Vung Tau,Ba Ria City,11,7,5,2,1
2022-04-12,Vung Tau,Ba Ria City,12,5,4,1,1
2022-04-12,Vung Tau,Ba Ria City,13,9,9,0,0
2022-04-12,Vung Tau,Ba Ria City,14,11,2,9,5
2022-04-12,Vung Tau,Ba Ria City,15,4,2,2,2
2022-04-12,Vung Tau,Ba Ria City,16,1,0,1,1
2022-04-12,Vung Tau,Ba Ria City,18,10,5,5,3
2022-04-12,Vung Tau,Ba Ria City,19,8,3,5,4
2022-04-12,Vung Tau,Ba Ria City,20,2,0,2,2
2022-04-12,Vung Tau,Vung Tau City,0,2,1,1,0
2022-04-12,Vung Tau,Vung Tau City,1,1,0,1,0
2022-04-12,Vung Tau,Vung Tau City,5,1,0,1,1
2022-04-12,Vung Tau,Vung Tau City,6,36,27,9,8
2022-04-12,Vung Tau,Vung Tau City,7,69,65,4,0
2022-04-12,Vung Tau,Vung Tau City,8,130,124,6,0
2022-04-12,Vung Tau,Vung Tau City,9,147,138,9,1
2022-04-12,Vung Tau,Vung Tau City,10,193,182,11,0
2022-04-12,Vung Tau,Vung Tau City,11,338,315,23,1
2022-04-12,Vung Tau,Vung Tau City,12,230,212,18,0
2022-04-12,Vung Tau,Vung Tau City,13,194,187,7,0
2022-04-12,Vung Tau,Vung Tau City,14,242,227,15,0
2022-04-12,Vung Tau,Vung Tau City,15,229,216,13,0
2022-04-12,Vung Tau,Vung Tau City,16,171,161,10,0
2022-04-12,Vung Tau,Vung Tau City,17,222,205,17,0
2022-04-12,Vung Tau,Vung Tau City,18,310,287,23,0
2022-04-12,Vung Tau,Vung Tau City,19,231,215,16,0
2022-04-12,Vung Tau,Vung Tau City,20,187,162,25,6
2022-04-12,Vung Tau,Vung Tau City,21,78,62,16,9
2022-04-12,Vung Tau,Vung Tau City,23,4,2,2,0
2022-04-13,Binh Duong,Ben Cat,9,1,0,1,1
2022-04-13,Binh Duong,Ben Cat,10,1,0,1,1
2022-04-13,Binh Duong,Ben Cat,11,2,0,2,2
2022-04-13,Binh Duong,Di An,6,3,0,3,3
2022-04-13,Binh Duong,Di An,7,9,0,9,8
2022-04-13,Binh Duong,Di An,8,13,6,7,3
2022-04-13,Binh Duong,Di An,9,20,12,8,7
2022-04-13,Binh Duong,Di An,10,30,14,16,14
2022-04-13,Binh Duong,Di An,11,46,20,26,21
2022-04-13,Binh Duong,Di An,12,40,21,19,11
2022-04-13,Binh Duong,Di An,13,24,14,10,9
2022-04-13,Binh Duong,Di An,14,30,14,16,8
2022-04-13,Binh Duong,Di An,15,30,8,22,16
2022-04-13,Binh Duong,Di An,16,31,6,25,23
2022-04-13,Binh Duong,Di An,17,32,14,18,16
2022-04-13,Binh Duong,Di An,18,23,16,7,4
2022-04-13,Binh Duong,Di An,19,16,12,4,2
2022-04-13,Binh Duong,Di An,20,16,13,3,1
2022-04-13,Binh Duong,Di An,21,13,8,5,4
2022-04-13,Binh Duong,Di An,23,1,0,1,1
2022-04-13,Binh Duong,Tan Uyen,9,3,1,2,1
2022-04-13,Binh Duong,Tan Uyen,10,2,0,2,1
2022-04-13,Binh Duong,Tan Uyen,11,1,0,1,1
2022-04-13,Binh Duong,Tan Uyen,12,2,0,2,2
2022-04-13,Binh Duong,Tan Uyen,13,1,0,1,1
2022-04-13,Binh Duong,Tan Uyen,14,5,1,4,4
2022-04-13,Binh Duong,Tan Uyen,15,2,1,1,1
2022-04-13,Binh Duong,Tan Uyen,17,8,4,4,4
2022-04-13,Binh Duong,Tan Uyen,18,4,3,1,1
2022-04-13,Binh Duong,Tan Uyen,19,2,0,2,2
2022-04-13,Binh Duong,Tan Uyen,21,4,0,4,3
2022-04-13,Binh Duong,Thu Dau Mot Town,0,2,2,0,0
2022-04-13,Binh Duong,Thu Dau Mot Town,5,1,1,0,0
2022-04-13,Binh Duong,Thu Dau Mot Town,6,24,22,2,0
2022-04-13,Binh Duong,Thu Dau Mot Town,7,92,89,3,0
2022-04-13,Binh Duong,Thu Dau Mot Town,8,212,198,14,1
2022-04-13,Binh Duong,Thu Dau Mot Town,9,231,211,20,1
2022-04-13,Binh Duong,Thu Dau Mot Town,10,378,358,20,5
2022-04-13,Binh Duong,Thu Dau Mot Town,11,619,585,34,7
2022-04-13,Binh Duong,Thu Dau Mot Town,12,432,398,34,2
2022-04-13,Binh Duong,Thu Dau Mot Town,13,411,385,26,1
2022-04-13,Binh Duong,Thu Dau Mot Town,14,341,328,13,1
2022-04-13,Binh Duong,Thu Dau Mot Town,15,270,257,13,1
2022-04-13,Binh Duong,Thu Dau Mot Town,16,244,231,13,1
2022-04-13,Binh Duong,Thu Dau Mot Town,17,333,311,22,2
2022-04-13,Binh Duong,Thu Dau Mot Town,18,323,310,13,3
2022-04-13,Binh Duong,Thu Dau Mot Town,19,326,310,16,3
2022-04-13,Binh Duong,Thu Dau Mot Town,20,222,203,19,1
2022-04-13,Binh Duong,Thu Dau Mot Town,21,96,77,19,4
2022-04-13,Binh Duong,Thu Dau Mot Town,22,2,2,0,0
2022-04-13,Binh Duong,Thuan An,6,1,0,1,1
2022-04-13,Binh Duong,Thuan An,7,5,1,4,4
2022-04-13,Binh Duong,Thuan An,8,10,8,2,2
2022-04-13,Binh Duong,Thuan An,9,28,12,16,13
2022-04-13,Binh Duong,Thuan An,10,55,36,19,17
2022-04-13,Binh Duong,Thuan An,11,85,44,41,36
2022-04-13,Binh Duong,Thuan An,12,64,39,25,19
2022-04-13,Binh Duong,Thuan An,13,77,47,30,26
2022-04-13,Binh Duong,Thuan An,14,48,23,25,21
2022-04-13,Binh Duong,Thuan An,15,49,30,19,11
2022-04-13,Binh Duong,Thuan An,16,37,26,11,8
2022-04-13,Binh Duong,Thuan An,17,30,26,4,3
2022-04-13,Binh Duong,Thuan An,18,38,35,3,2
2022-04-13,Binh Duong,Thuan An,19,29,17,12,6
2022-04-13,Binh Duong,Thuan An,20,13,8,5,4
2022-04-13,Binh Duong,Thuan An,21,10,4,6,3
2022-04-13,Binh Duong,Thuan An,22,1,0,1,0
2022-04-13,Can Tho City,Binh Thuy District,7,1,0,1,1
2022-04-13,Can Tho City,Binh Thuy District,9,5,5,0,0
2022-04-13,Can Tho City,Binh Thuy District,10,6,5,1,0
2022-04-13,Can Tho City,Binh Thuy District,11,13,12,1,0
2022-04-13,Can Tho City,Binh Thuy District,12,12,10,2,0
2022-04-13,Can Tho City,Binh Thuy District,13,6,6,0,0
2022-04-13,Can Tho City,Binh Thuy District,14,9,7,2,1
2022-04-13,Can Tho City,Binh Thuy District,15,11,9,2,0
2022-04-13,Can Tho City,Binh Thuy District,16,15,15,0,0
2022-04-13,Can Tho City,Binh Thuy District,17,14,13,1,0
2022-04-13,Can Tho City,Binh Thuy District,18,10,8,2,1
2022-04-13,Can Tho City,Binh Thuy District,19,12,11,1,0
2022-04-13,Can Tho City,Binh Thuy District,20,10,9,1,0
2022-04-13,Can Tho City,Binh Thuy District,21,2,2,0,0
2022-04-13,Can Tho City,Cai Rang District,6,1,0,1,1
2022-04-13,Can Tho City,Cai Rang District,7,6,6,0,0
2022-04-13,Can Tho City,Cai Rang District,8,3,3,0,0
2022-04-13,Can Tho City,Cai Rang District,9,4,4,0,0
2022-04-13,Can Tho City,Cai Rang District,10,8,7,1,0
2022-04-13,Can Tho City,Cai Rang District,11,13,11,2,0
2022-04-13,Can Tho City,Cai Rang District,12,10,10,0,0
2022-04-13,Can Tho City,Cai Rang District,13,14,14,0,0
2022-04-13,Can Tho City,Cai Rang District,14,8,7,1,0
2022-04-13,Can Tho City,Cai Rang District,15,4,4,0,0
2022-04-13,Can Tho City,Cai Rang District,16,5,4,1,0
2022-04-13,Can Tho City,Cai Rang District,17,15,13,2,0
2022-04-13,Can Tho City,Cai Rang District,18,14,13,1,1
2022-04-13,Can Tho City,Cai Rang District,19,9,9,0,0
2022-04-13,Can Tho City,Cai Rang District,20,9,9,0,0
2022-04-13,Can Tho City,Cai Rang District,21,2,2,0,0
2022-04-13,Can Tho City,Ninh Kieu District,0,1,0,1,0
2022-04-13,Can Tho City,Ninh Kieu District,1,2,2,0,0
2022-04-13,Can Tho City,Ninh Kieu District,2,1,1,0,0
2022-04-13,Can Tho City,Ninh Kieu District,5,4,4,0,0
2022-04-13,Can Tho City,Ninh Kieu District,6,33,30,3,2
2022-04-13,Can Tho City,Ninh Kieu District,7,125,119,6,1
2022-04-13,Can Tho City,Ninh Kieu District,8,235,217,18,0
2022-04-13,Can Tho City,Ninh Kieu District,9,272,256,16,0
2022-04-13,Can Tho City,Ninh Kieu District,10,592,565,27,0
2022-04-13,Can Tho City,Ninh Kieu District,11,846,813,33,0
2022-04-13,Can Tho City,Ninh Kieu District,12,609,584,25,0
2022-04-13,Can Tho City,Ninh Kieu District,13,488,464,24,0
2022-04-13,Can Tho City,Ninh Kieu District,14,383,359,24,0
2022-04-13,Can Tho City,Ninh Kieu District,15,397,375,22,0
2022-04-13,Can Tho City,Ninh Kieu District,16,389,373,16,0
2022-04-13,Can Tho City,Ninh Kieu District,17,529,510,19,0
2022-04-13,Can Tho City,Ninh Kieu District,18,531,507,24,0
2022-04-13,Can Tho City,Ninh Kieu District,19,444,414,30,0
2022-04-13,Can Tho City,Ninh Kieu District,20,345,323,22,0
2022-04-13,Can Tho City,Ninh Kieu District,21,209,181,28,0
2022-04-13,Can Tho City,Ninh Kieu District,22,5,3,2,0
2022-04-13,Can Tho City,Ninh Kieu District,23,1,1,0,0
2022-04-13,Dong Nai,Bien Hoa City,0,3,2,1,0
2022-04-13,Dong Nai,Bien Hoa City,1,1,0,1,1
2022-04-13,Dong Nai,Bien Hoa City,3,1,1,0,0
2022-04-13,Dong Nai,Bien Hoa City,5,3,2,1,1
2022-04-13,Dong Nai,Bien Hoa City,6,33,16,17,13
2022-04-13,Dong Nai,Bien Hoa City,7,125,107,18,10
2022-04-13,Dong Nai,Bien Hoa City,8,271,233,38,9
2022-04-13,Dong Nai,Bien Hoa City,9,388,346,42,5
2022-04-13,Dong Nai,Bien Hoa City,10,735,657,78,23
2022-04-13,Dong Nai,Bien Hoa City,11,1071,958,113,31
2022-04-13,Dong Nai,Bien Hoa City,12,780,714,66,20
2022-04-13,Dong Nai,Bien Hoa City,13,780,721,59,30
2022-04-13,Dong Nai,Bien Hoa City,14,689,606,83,33
2022-04-13,Dong Nai,Bien Hoa City,15,447,419,28,7
2022-04-13,Dong Nai,Bien Hoa City,16,438,403,35,13
2022-04-13,Dong Nai,Bien Hoa City,17,540,500,40,8
2022-04-13,Dong Nai,Bien Hoa City,18,625,578,47,1
2022-04-13,Dong Nai,Bien Hoa City,19,560,508,52,10
2022-04-13,Dong Nai,Bien Hoa City,20,429,345,84,31
2022-04-13,Dong Nai,Bien Hoa City,21,188,135,53,39
2022-04-13,Dong Nai,Bien Hoa City,22,4,3,1,0
2022-04-13,Dong Nai,Long Khanh,17,1,0,1,1
2022-04-13,Dong Nai,Long Thanh,0,1,0,1,0
2022-04-13,Dong Nai,Long Thanh,10,2,0,2,2
2022-04-13,Dong Nai,Nhon trach,12,1,0,1,1
2022-04-13,Dong Nai,Nhon trach,13,1,0,1,1
2022-04-13,Dong Nai,Nhon trach,18,1,0,1,1
2022-04-13,Dong Nai,Thong Nhat,7,3,2,1,0
2022-04-13,Dong Nai,Thong Nhat,9,1,1,0,0
2022-04-13,Dong Nai,Thong Nhat,10,1,1,0,0
2022-04-13,Dong Nai,Thong Nhat,11,2,2,0,0
2022-04-13,Dong Nai,Thong Nhat,13,3,3,0,0
2022-04-13,Dong Nai,Thong Nhat,15,3,3,0,0
2022-04-13,Dong Nai,Thong Nhat,16,1,1,0,0
2022-04-13,Dong Nai,Thong Nhat,19,1,1,0,0
2022-04-13,Dong Nai,Thong Nhat,20,1,1,0,0
2022-04-13,Dong Nai,Thong Nhat,21,1,1,0,0
2022-04-13,Dong Nai,Trang Bom,15,1,0,1,1
2022-04-13,Dong Nai,Trang Bom,20,3,0,3,2
2022-04-13,Hai Phong City,An Duong,1,2,0,2,2
2022-04-13,Hai Phong City,An Duong,7,3,0,3,3
2022-04-13,Hai Phong City,An Duong,8,2,1,1,1
2022-04-13,Hai Phong City,An Duong,9,2,0,2,2
2022-04-13,Hai Phong City,An Duong,10,3,2,1,1
2022-04-13,Hai Phong City,An Duong,11,11,2,9,4
2022-04-13,Hai Phong City,An Duong,12,9,4,5,1
2022-04-13,Hai Phong City,An Duong,13,1,1,0,0
2022-04-13,Hai Phong City,An Duong,14,2,2,0,0
2022-04-13,Hai Phong City,An Duong,15,2,2,0,0
2022-04-13,Hai Phong City,An Duong,16,3,1,2,2
2022-04-13,Hai Phong City,An Duong,18,1,1,0,0
2022-04-13,Hai Phong City,An Duong,19,2,0,2,0
2022-04-13,Hai Phong City,An Duong,20,2,2,0,0
2022-04-13,Hai Phong City,Do Son District,11,2,0,2,2
2022-04-13,Hai Phong City,Do Son District,12,1,0,1,1
2022-04-13,Hai Phong City,Do Son District,18,3,0,3,2
2022-04-13,Hai Phong City,Do Son District,19,2,0,2,2
2022-04-13,Hai Phong City,Hai An District,7,8,8,0,0
2022-04-13,Hai Phong City,Hai An District,8,8,8,0,0
2022-04-13,Hai Phong City,Hai An District,9,4,4,0,0
2022-04-13,Hai Phong City,Hai An District,10,27,24,3,0
2022-04-13,Hai Phong City,Hai An District,11,47,40,7,1
2022-04-13,Hai Phong City,Hai An District,12,20,18,2,1
2022-04-13,Hai Phong City,Hai An District,13,18,15,3,2
2022-04-13,Hai Phong City,Hai An District,14,22,14,8,4
2022-04-13,Hai Phong City,Hai An District,15,11,11,0,0
2022-04-13,Hai Phong City,Hai An District,16,12,12,0,0
2022-04-13,Hai Phong City,Hai An District,17,24,19,5,1
2022-04-13,Hai Phong City,Hai An District,18,21,19,2,0
2022-04-13,Hai Phong City,Hai An District,19,17,15,2,0
2022-04-13,Hai Phong City,Hai An District,20,19,16,3,0
2022-04-13,Hai Phong City,Hai An District,21,5,5,0,0
2022-04-13,Hai Phong City,Hai An District,22,1,1,0,0
2022-04-13,Hai Phong City,Hong Bang District,6,1,1,0,0
2022-04-13,Hai Phong City,Hong Bang District,7,19,18,1,0
2022-04-13,Hai Phong City,Hong Bang District,8,34,32,2,1
2022-04-13,Hai Phong City,Hong Bang District,9,28,24,4,1
2022-04-13,Hai Phong City,Hong Bang District,10,59,50,9,2
2022-04-13,Hai Phong City,Hong Bang District,11,120,109,11,4
2022-04-13,Hai Phong City,Hong Bang District,12,50,46,4,2
2022-04-13,Hai Phong City,Hong Bang District,13,31,29,2,0
2022-04-13,Hai Phong City,Hong Bang District,14,53,47,6,1
2022-04-13,Hai Phong City,Hong Bang District,15,47,42,5,2
2022-04-13,Hai Phong City,Hong Bang District,16,33,31,2,0
2022-04-13,Hai Phong City,Hong Bang District,17,41,40,1,0
2022-04-13,Hai Phong City,Hong Bang District,18,61,56,5,2
2022-04-13,Hai Phong City,Hong Bang District,19,54,49,5,1
2022-04-13,Hai Phong City,Hong Bang District,20,20,14,6,2
2022-04-13,Hai Phong City,Hong Bang District,21,19,11,8,2
2022-04-13,Hai Phong City,Hong Bang District,22,1,0,1,0
2022-04-13,Hai Phong City,Kien An District,8,2,0,2,2
2022-04-13,Hai Phong City,Kien An District,9,6,3,3,0
2022-04-13,Hai Phong City,Kien An District,10,18,10,8,5
2022-04-13,Hai Phong City,Kien An District,11,15,12,3,3
2022-04-13,Hai Phong City,Kien An District,12,19,10,9,6
2022-04-13,Hai Phong City,Kien An District,13,6,4,2,2
2022-04-13,Hai Phong City,Kien An District,14,14,6,8,6
2022-04-13,Hai Phong City,Kien An District,15,6,5,1,1
2022-04-13,Hai Phong City,Kien An District,16,5,4,1,1
2022-04-13,Hai Phong City,Kien An District,17,11,9,2,2
2022-04-13,Hai Phong City,Kien An District,18,10,9,1,1
2022-04-13,Hai Phong City,Kien An District,19,9,7,2,1
2022-04-13,Hai Phong City,Kien An District,20,5,4,1,1
2022-04-13,Hai Phong City,Kien An District,21,4,1,3,3
2022-04-13,Hai Phong City,Le Chan District,3,1,0,1,0
2022-04-13,Hai Phong City,Le Chan District,6,3,3,0,0
2022-04-13,Hai Phong City,Le Chan District,7,26,21,5,0
2022-04-13,Hai Phong City,Le Chan District,8,67,63,4,0
2022-04-13,Hai Phong City,Le Chan District,9,62,55,7,0
2022-04-13,Hai Phong City,Le Chan District,10,134,119,15,1
2022-04-13,Hai Phong City,Le Chan District,11,302,268,34,9
2022-04-13,Hai Phong City,Le Chan District,12,179,157,22,6
2022-04-13,Hai Phong City,Le Chan District,13,101,89,12,1
2022-04-13,Hai Phong City,Le Chan District,14,134,118,16,1
2022-04-13,Hai Phong City,Le Chan District,15,135,124,11,2
2022-04-13,Hai Phong City,Le Chan District,16,107,98,9,0
2022-04-13,Hai Phong City,Le Chan District,17,144,135,9,1
2022-04-13,Hai Phong City,Le Chan District,18,203,180,23,3
2022-04-13,Hai Phong City,Le Chan District,19,167,152,15,2
2022-04-13,Hai Phong City,Le Chan District,20,124,107,17,0
2022-04-13,Hai Phong City,Le Chan District,21,46,37,9,2
2022-04-13,Hai Phong City,Le Chan District,22,2,1,1,0
2022-04-13,Hai Phong City,Ngo Quyen District,1,1,1,0,0
2022-04-13,Hai Phong City,Ngo Quyen District,2,1,0,1,0
2022-04-13,Hai Phong City,Ngo Quyen District,4,1,0,1,0
2022-04-13,Hai Phong City,Ngo Quyen District,7,21,18,3,2
2022-04-13,Hai Phong City,Ngo Quyen District,8,75,63,12,0
2022-04-13,Hai Phong City,Ngo Quyen District,9,64,59,5,0
2022-04-13,Hai Phong City,Ngo Quyen District,10,116,107,9,1
2022-04-13,Hai Phong City,Ngo Quyen District,11,236,220,16,8
2022-04-13,Hai Phong City,Ngo Quyen District,12,145,137,8,0
2022-04-13,Hai Phong City,Ngo Quyen District,13,101,91,10,2
2022-04-13,Hai Phong City,Ngo Quyen District,14,129,118,11,4
2022-04-13,Hai Phong City,Ngo Quyen District,15,125,113,12,0
2022-04-13,Hai Phong City,Ngo Quyen District,16,114,103,11,1
2022-04-13,Hai Phong City,Ngo Quyen District,17,135,114,21,1
2022-04-13,Hai Phong City,Ngo Quyen District,18,162,148,14,2
2022-04-13,Hai Phong City,Ngo Quyen District,19,152,140,12,1
2022-04-13,Hai Phong City,Ngo Quyen District,20,110,97,13,1
2022-04-13,Hai Phong City,Ngo Quyen District,21,47,39,8,0
2022-04-13,Hai Phong City,Ngo Quyen District,23,1,0,1,1
2022-04-13,Hai Phong City,Thuy Nguyen,8,1,0,1,1
2022-04-13,Hai Phong City,Thuy Nguyen,9,3,0,3,3
2022-04-13,Hai Phong City,Thuy Nguyen,10,1,0,1,1
2022-04-13,Hai Phong City,Thuy Nguyen,11,3,0,3,2
2022-04-13,Hai Phong City,Thuy Nguyen,13,1,0,1,1
2022-04-13,Hai Phong City,Thuy Nguyen,19,1,0,1,1
2022-04-13,Hai Phong City,Thuy Nguyen,20,1,0,1,1
2022-04-13,Hue City,Hue City,4,3,1,2,0
2022-04-13,Hue City,Hue City,5,3,2,1,0
2022-04-13,Hue City,Hue City,6,61,57,4,2
2022-04-13,Hue City,Hue City,7,174,166,8,1
2022-04-13,Hue City,Hue City,8,286,266,20,0
2022-04-13,Hue City,Hue City,9,245,223,22,0
2022-04-13,Hue City,Hue City,10,441,410,31,2
2022-04-13,Hue City,Hue City,11,860,808,52,0
2022-04-13,Hue City,Hue City,12,503,459,44,0
2022-04-13,Hue City,Hue City,13,256,243,13,0
2022-04-13,Hue City,Hue City,14,327,307,20,0
2022-04-13,Hue City,Hue City,15,331,314,17,0
2022-04-13,Hue City,Hue City,16,366,345,21,2
2022-04-13,Hue City,Hue City,17,497,468,29,1
2022-04-13,Hue City,Hue City,18,556,513,43,3
2022-04-13,Hue City,Hue City,19,554,513,41,3
2022-04-13,Hue City,Hue City,20,446,392,54,1
2022-04-13,Hue City,Hue City,21,200,181,19,0
2022-04-13,Hue City,Hue City,22,1,0,1,0
2022-04-13,Hue City,Hue City,23,3,2,1,0
2022-04-13,Hue City,Huong Thuy,11,1,0,1,0
2022-04-13,Hue City,Huong Thuy,12,2,1,1,0
2022-04-13,Hue City,Huong Thuy,16,1,1,0,0
2022-04-13,Hue City,Huong Thuy,17,1,1,0,0
2022-04-13,Hue City,Huong Tra,12,1,1,0,0
2022-04-13,Hue City,Huong Tra,16,1,0,1,1
2022-04-13,Hue City,Huong Tra,17,1,0,1,1
2022-04-13,Hue City,Huong Tra,18,2,2,0,0
2022-04-13,Hue City,Phu Vang,7,2,1,1,1
2022-04-13,Hue City,Phu Vang,8,2,2,0,0
2022-04-13,Hue City,Phu Vang,10,1,1,0,0
2022-04-13,Hue City,Phu Vang,11,1,1,0,0
2022-04-13,Hue City,Phu Vang,12,3,3,0,0
2022-04-13,Hue City,Phu Vang,13,2,0,2,2
2022-04-13,Hue City,Phu Vang,14,1,1,0,0
2022-04-13,Hue City,Phu Vang,15,4,4,0,0
2022-04-13,Hue City,Phu Vang,16,2,2,0,0
2022-04-13,Hue City,Phu Vang,17,2,0,2,1
2022-04-13,Hue City,Phu Vang,18,1,1,0,0
2022-04-13,Hue City,Phu Vang,19,2,1,1,1
2022-04-13,Hue City,Phu Vang,21,1,0,1,0
2022-04-13,Vung Tau,Ba Ria City,8,2,0,2,2
2022-04-13,Vung Tau,Ba Ria City,9,6,2,4,4
2022-04-13,Vung Tau,Ba Ria City,10,7,5,2,1
2022-04-13,Vung Tau,Ba Ria City,11,8,5,3,2
2022-04-13,Vung Tau,Ba Ria City,12,8,5,3,1
2022-04-13,Vung Tau,Ba Ria City,13,1,0,1,0
2022-04-13,Vung Tau,Ba Ria City,14,4,3,1,0
2022-04-13,Vung Tau,Ba Ria City,15,7,3,4,4
2022-04-13,Vung Tau,Ba Ria City,16,3,0,3,3
2022-04-13,Vung Tau,Ba Ria City,17,4,3,1,0
2022-04-13,Vung Tau,Ba Ria City,18,4,1,3,3
2022-04-13,Vung Tau,Ba Ria City,19,5,0,5,5
2022-04-13,Vung Tau,Ba Ria City,20,3,0,3,3
2022-04-13,Vung Tau,Ba Ria City,21,3,0,3,3
2022-04-13,Vung Tau,Vung Tau City,0,1,1,0,0
2022-04-13,Vung Tau,Vung Tau City,2,2,1,1,0
2022-04-13,Vung Tau,Vung Tau City,6,31,28,3,1
2022-04-13,Vung Tau,Vung Tau City,7,59,59,0,0
2022-04-13,Vung Tau,Vung Tau City,8,148,139,9,0
2022-04-13,Vung Tau,Vung Tau City,9,143,125,18,2
2022-04-13,Vung Tau,Vung Tau City,10,170,152,18,2
2022-04-13,Vung Tau,Vung Tau City,11,338,307,31,2
2022-04-13,Vung Tau,Vung Tau City,12,258,238,20,0
2022-04-13,Vung Tau,Vung Tau City,13,205,193,12,2
2022-04-13,Vung Tau,Vung Tau City,14,251,237,14,2
2022-04-13,Vung Tau,Vung Tau City,15,209,197,12,0
2022-04-13,Vung Tau,Vung Tau City,16,174,164,10,0
2022-04-13,Vung Tau,Vung Tau City,17,236,215,21,4
2022-04-13,Vung Tau,Vung Tau City,18,275,261,14,2
2022-04-13,Vung Tau,Vung Tau City,19,242,229,13,0
2022-04-13,Vung Tau,Vung Tau City,20,163,141,22,1
2022-04-13,Vung Tau,Vung Tau City,21,83,76,7,2
2022-04-13,Vung Tau,Vung Tau City,22,1,1,0,0
2022-04-14,Binh Duong,Ben Cat,8,1,0,1,1
2022-04-14,Binh Duong,Ben Cat,10,2,0,2,2
2022-04-14,Binh Duong,Ben Cat,11,2,0,2,2
2022-04-14,Binh Duong,Ben Cat,15,2,0,2,2
2022-04-14,Binh Duong,Ben Cat,16,1,0,1,1
2022-04-14,Binh Duong,Ben Cat,17,1,1,0,0
2022-04-14,Binh Duong,Di An,1,1,1,0,0
2022-04-14,Binh Duong,Di An,5,1,1,0,0
2022-04-14,Binh Duong,Di An,7,6,2,4,2
2022-04-14,Binh Duong,Di An,8,16,7,9,8
2022-04-14,Binh Duong,Di An,9,19,12,7,6
2022-04-14,Binh Duong,Di An,10,30,19,11,7
2022-04-14,Binh Duong,Di An,11,35,17,18,16
2022-04-14,Binh Duong,Di An,12,32,20,12,10
2022-04-14,Binh Duong,Di An,13,31,23,8,6
2022-04-14,Binh Duong,Di An,14,16,10,6,5
2022-04-14,Binh Duong,Di An,15,23,12,11,10
2022-04-14,Binh Duong,Di An,16,23,11,12,9
2022-04-14,Binh Duong,Di An,17,27,15,12,9
2022-04-14,Binh Duong,Di An,18,15,13,2,1
2022-04-14,Binh Duong,Di An,19,20,13,7,3
2022-04-14,Binh Duong,Di An,20,10,7,3,2
2022-04-14,Binh Duong,Di An,21,9,4,5,4
2022-04-14,Binh Duong,Di An,22,1,0,1,1
2022-04-14,Binh Duong,Tan Uyen,8,1,0,1,1
2022-04-14,Binh Duong,Tan Uyen,9,5,1,4,3
2022-04-14,Binh Duong,Tan Uyen,10,1,0,1,1
2022-04-14,Binh Duong,Tan Uyen,11,2,1,1,0
2022-04-14,Binh Duong,Tan Uyen,12,3,1,2,2
2022-04-14,Binh Duong,Tan Uyen,13,6,4,2,2
2022-04-14,Binh Duong,Tan Uyen,14,1,1,0,0
2022-04-14,Binh Duong,Tan Uyen,15,2,2,0,0
2022-04-14,Binh Duong,Tan Uyen,17,3,1,2,2
2022-04-14,Binh Duong,Tan Uyen,18,2,0,2,2
2022-04-14,Binh Duong,Tan Uyen,19,5,4,1,1
2022-04-14,Binh Duong,Tan Uyen,21,1,0,1,1
2022-04-14,Binh Duong,Thu Dau Mot Town,0,2,1,1,0
2022-04-14,Binh Duong,Thu Dau Mot Town,5,2,1,1,0
2022-04-14,Binh Duong,Thu Dau Mot Town,6,32,26,6,2
2022-04-14,Binh Duong,Thu Dau Mot Town,7,105,95,10,1
2022-04-14,Binh Duong,Thu Dau Mot Town,8,157,152,5,0
2022-04-14,Binh Duong,Thu Dau Mot Town,9,218,204,14,1
2022-04-14,Binh Duong,Thu Dau Mot Town,10,361,339,22,5
2022-04-14,Binh Duong,Thu Dau Mot Town,11,664,630,34,5
2022-04-14,Binh Duong,Thu Dau Mot Town,12,441,426,15,2
2022-04-14,Binh Duong,Thu Dau Mot Town,13,424,401,23,2
2022-04-14,Binh Duong,Thu Dau Mot Town,14,310,294,16,3
2022-04-14,Binh Duong,Thu Dau Mot Town,15,242,223,19,3
2022-04-14,Binh Duong,Thu Dau Mot Town,16,251,231,20,5
2022-04-14,Binh Duong,Thu Dau Mot Town,17,335,321,14,2
2022-04-14,Binh Duong,Thu Dau Mot Town,18,363,322,41,19
2022-04-14,Binh Duong,Thu Dau Mot Town,19,331,313,18,3
2022-04-14,Binh Duong,Thu Dau Mot Town,20,223,205,18,0
2022-04-14,Binh Duong,Thu Dau Mot Town,21,93,80,13,3
2022-04-14,Binh Duong,Thu Dau Mot Town,22,3,0,3,0
2022-04-14,Binh Duong,Thuan An,6,4,0,4,1
2022-04-14,Binh Duong,Thuan An,7,6,2,4,2
2022-04-14,Binh Duong,Thuan An,8,28,13,15,9
2022-04-14,Binh Duong,Thuan An,9,30,25,5,4
2022-04-14,Binh Duong,Thuan An,10,65,41,24,18
2022-04-14,Binh Duong,Thuan An,11,79,57,22,12
2022-04-14,Binh Duong,Thuan An,12,52,41,11,6
2022-04-14,Binh Duong,Thuan An,13,60,38,22,17
2022-04-14,Binh Duong,Thuan An,14,65,28,37,21
2022-04-14,Binh Duong,Thuan An,15,37,29,8,5
2022-04-14,Binh Duong,Thuan An,16,34,29,5,4
2022-04-14,Binh Duong,Thuan An,17,26,21,5,2
2022-04-14,Binh Duong,Thuan An,18,45,24,21,16
2022-04-14,Binh Duong,Thuan An,19,54,20,34,26
2022-04-14,Binh Duong,Thuan An,20,47,21,26,19
2022-04-14,Binh Duong,Thuan An,21,14,2,12,7
2022-04-14,Can Tho City,Binh Thuy District,8,3,3,0,0
2022-04-14,Can Tho City,Binh Thuy District,9,9,8,1,0
2022-04-14,Can Tho City,Binh Thuy District,10,10,10,0,0
2022-04-14,Can Tho City,Binh Thuy District,11,20,20,0,0
2022-04-14,Can Tho City,Binh Thuy District,12,11,10,1,0
2022-04-14,Can Tho City,Binh Thuy District,13,15,14,1,0
2022-04-14,Can Tho City,Binh Thuy District,14,8,8,0,0
2022-04-14,Can Tho City,Binh Thuy District,15,9,8,1,0
2022-04-14,Can Tho City,Binh Thuy District,16,10,8,2,2
2022-04-14,Can Tho City,Binh Thuy District,17,17,16,1,0
2022-04-14,Can Tho City,Binh Thuy District,18,10,10,0,0
2022-04-14,Can Tho City,Binh Thuy District,19,10,10,0,0
2022-04-14,Can Tho City,Binh Thuy District,20,4,4,0,0
2022-04-14,Can Tho City,Binh Thuy District,21,1,1,0,0
2022-04-14,Can Tho City,Cai Rang District,2,1,1,0,0
2022-04-14,Can Tho City,Cai Rang District,6,1,0,1,1
2022-04-14,Can Tho City,Cai Rang District,7,4,3,1,0
2022-04-14,Can Tho City,Cai Rang District,8,3,3,0,0
2022-04-14,Can Tho City,Cai Rang District,9,8,7,1,0
2022-04-14,Can Tho City,Cai Rang District,10,10,8,2,0
2022-04-14,Can Tho City,Cai Rang District,11,24,24,0,0
2022-04-14,Can Tho City,Cai Rang District,12,10,9,1,0
2022-04-14,Can Tho City,Cai Rang District,13,11,10,1,0
2022-04-14,Can Tho City,Cai Rang District,14,10,8,2,1
2022-04-14,Can Tho City,Cai Rang District,15,3,2,1,0
2022-04-14,Can Tho City,Cai Rang District,16,9,9,0,0
2022-04-14,Can Tho City,Cai Rang District,17,11,10,1,0
2022-04-14,Can Tho City,Cai Rang District,18,9,8,1,0
2022-04-14,Can Tho City,Cai Rang District,19,12,12,0,0
2022-04-14,Can Tho City,Cai Rang District,20,6,4,2,2
2022-04-14,Can Tho City,Cai Rang District,21,3,2,1,1
2022-04-14,Can Tho City,Ninh Kieu District,0,2,2,0,0
2022-04-14,Can Tho City,Ninh Kieu District,1,1,1,0,0
2022-04-14,Can Tho City,Ninh Kieu District,2,1,0,1,0
2022-04-14,Can Tho City,Ninh Kieu District,3,1,1,0,0
2022-04-14,Can Tho City,Ninh Kieu District,4,5,0,5,0
2022-04-14,Can Tho City,Ninh Kieu District,5,1,1,0,0
2022-04-14,Can Tho City,Ninh Kieu District,6,47,38,9,6
2022-04-14,Can Tho City,Ninh Kieu District,7,121,114,7,0
2022-04-14,Can Tho City,Ninh Kieu District,8,237,223,14,1
2022-04-14,Can Tho City,Ninh Kieu District,9,282,264,18,0
2022-04-14,Can Tho City,Ninh Kieu District,10,529,508,21,0
2022-04-14,Can Tho City,Ninh Kieu District,11,875,835,40,0
2022-04-14,Can Tho City,Ninh Kieu District,12,634,614,20,0
2022-04-14,Can Tho City,Ninh Kieu District,13,497,475,22,0
2022-04-14,Can Tho City,Ninh Kieu District,14,403,390,13,0
2022-04-14,Can Tho City,Ninh Kieu District,15,315,300,15,0
2022-04-14,Can Tho City,Ninh Kieu District,16,355,337,18,0
2022-04-14,Can Tho City,Ninh Kieu District,17,525,502,23,0
2022-04-14,Can Tho City,Ninh Kieu District,18,507,486,21,0
2022-04-14,Can Tho City,Ninh Kieu District,19,420,398,22,0
2022-04-14,Can Tho City,Ninh Kieu District,20,310,287,23,0
2022-04-14,Can Tho City,Ninh Kieu District,21,152,141,11,0
2022-04-14,Can Tho City,Ninh Kieu District,22,2,1,1,0
2022-04-14,Can Tho City,Ninh Kieu District,23,1,1,0,0
2022-04-14,Dong Nai,Bien Hoa City,0,5,4,1,0
2022-04-14,Dong Nai,Bien Hoa City,3,1,1,0,0
2022-04-14,Dong Nai,Bien Hoa City,5,2,1,1,1
2022-04-14,Dong Nai,Bien Hoa City,6,28,14,14,10
2022-04-14,Dong Nai,Bien Hoa City,7,133,112,21,11
2022-04-14,Dong Nai,Bien Hoa City,8,291,254,37,13
2022-04-14,Dong Nai,Bien Hoa City,9,381,335,46,8
2022-04-14,Dong Nai,Bien Hoa City,10,694,623,71,25
2022-04-14,Dong Nai,Bien Hoa City,11,1013,909,104,29
2022-04-14,Dong Nai,Bien Hoa City,12,791,734,57,7
2022-04-14,Dong Nai,Bien Hoa City,13,743,676,67,25
2022-04-14,Dong Nai,Bien Hoa City,14,627,567,60,15
2022-04-14,Dong Nai,Bien Hoa City,15,434,392,42,12
2022-04-14,Dong Nai,Bien Hoa City,16,486,430,56,17
2022-04-14,Dong Nai,Bien Hoa City,17,622,521,101,52
2022-04-14,Dong Nai,Bien Hoa City,18,672,577,95,31
2022-04-14,Dong Nai,Bien Hoa City,19,635,572,63,20
2022-04-14,Dong Nai,Bien Hoa City,20,545,445,100,45
2022-04-14,Dong Nai,Bien Hoa City,21,237,151,86,45
2022-04-14,Dong Nai,Bien Hoa City,22,5,2,3,0
2022-04-14,Dong Nai,Bien Hoa City,23,2,1,1,0
2022-04-14,Dong Nai,Cam My,17,1,0,1,1
2022-04-14,Dong Nai,Long Khanh,14,2,0,2,2
2022-04-14,Dong Nai,Long Thanh,8,1,0,1,0
2022-04-14,Dong Nai,Long Thanh,9,1,0,1,1
2022-04-14,Dong Nai,Long Thanh,12,1,0,1,1
2022-04-14,Dong Nai,Nhon trach,9,3,0,3,3
2022-04-14,Dong Nai,Nhon trach,15,1,0,1,1
2022-04-14,Dong Nai,Nhon trach,16,1,0,1,1
2022-04-14,Dong Nai,Nhon trach,17,1,0,1,1
2022-04-14,Dong Nai,Nhon trach,20,2,0,2,0
2022-04-14,Dong Nai,Thong Nhat,7,2,2,0,0
2022-04-14,Dong Nai,Thong Nhat,8,3,3,0,0
2022-04-14,Dong Nai,Thong Nhat,10,2,2,0,0
2022-04-14,Dong Nai,Thong Nhat,11,1,1,0,0
2022-04-14,Dong Nai,Thong Nhat,12,1,1,0,0
2022-04-14,Dong Nai,Thong Nhat,13,5,4,1,0
2022-04-14,Dong Nai,Thong Nhat,14,1,1,0,0
2022-04-14,Dong Nai,Thong Nhat,17,1,1,0,0
2022-04-14,Dong Nai,Thong Nhat,18,1,1,0,0
2022-04-14,Dong Nai,Thong Nhat,21,2,1,1,0
2022-04-14,Dong Nai,Trang Bom,10,2,0,2,2
2022-04-14,Dong Nai,Trang Bom,12,2,1,1,1
2022-04-14,Dong Nai,Trang Bom,14,1,0,1,1
2022-04-14,Dong Nai,Trang Bom,19,2,0,2,2
2022-04-14,Hai Phong City,An Duong,6,2,0,2,2
2022-04-14,Hai Phong City,An Duong,8,12,2,10,9
2022-04-14,Hai Phong City,An Duong,9,11,2,9,9
2022-04-14,Hai Phong City,An Duong,10,10,2,8,6
2022-04-14,Hai Phong City,An Duong,11,10,4,6,2
2022-04-14,Hai Phong City,An Duong,12,3,1,2,2
2022-04-14,Hai Phong City,An Duong,13,6,1,5,4
2022-04-14,Hai Phong City,An Duong,14,9,2,7,6
2022-04-14,Hai Phong City,An Duong,15,5,2,3,2
2022-04-14,Hai Phong City,An Duong,16,1,0,1,0
2022-04-14,Hai Phong City,An Duong,17,2,1,1,0
2022-04-14,Hai Phong City,An Duong,18,4,0,4,3
2022-04-14,Hai Phong City,An Duong,19,2,0,2,2
2022-04-14,Hai Phong City,An Duong,20,6,1,5,5
2022-04-14,Hai Phong City,An Duong,21,2,0,2,2
2022-04-14,Hai Phong City,Hai An District,7,10,6,4,1
2022-04-14,Hai Phong City,Hai An District,8,5,4,1,1
2022-04-14,Hai Phong City,Hai An District,9,8,4,4,1
2022-04-14,Hai Phong City,Hai An District,10,27,23,4,3
2022-04-14,Hai Phong City,Hai An District,11,44,39,5,2
2022-04-14,Hai Phong City,Hai An District,12,26,20,6,2
2022-04-14,Hai Phong City,Hai An District,13,16,13,3,1
2022-04-14,Hai Phong City,Hai An District,14,15,13,2,0
2022-04-14,Hai Phong City,Hai An District,15,17,16,1,1
2022-04-14,Hai Phong City,Hai An District,16,24,18,6,3
2022-04-14,Hai Phong City,Hai An District,17,17,17,0,0
2022-04-14,Hai Phong City,Hai An District,18,28,23,5,3
2022-04-14,Hai Phong City,Hai An District,19,22,18,4,1
2022-04-14,Hai Phong City,Hai An District,20,17,12,5,1
2022-04-14,Hai Phong City,Hai An District,21,6,6,0,0
2022-04-14,Hai Phong City,Hong Bang District,0,1,1,0,0
2022-04-14,Hai Phong City,Hong Bang District,7,11,11,0,0
2022-04-14,Hai Phong City,Hong Bang District,8,44,42,2,1
2022-04-14,Hai Phong City,Hong Bang District,9,31,29,2,0
2022-04-14,Hai Phong City,Hong Bang District,10,66,53,13,5
2022-04-14,Hai Phong City,Hong Bang District,11,84,79,5,1
2022-04-14,Hai Phong City,Hong Bang District,12,69,60,9,3
2022-04-14,Hai Phong City,Hong Bang District,13,53,45,8,3
2022-04-14,Hai Phong City,Hong Bang District,14,53,43,10,7
2022-04-14,Hai Phong City,Hong Bang District,15,44,40,4,2
2022-04-14,Hai Phong City,Hong Bang District,16,35,32,3,0
2022-04-14,Hai Phong City,Hong Bang District,17,36,31,5,1
2022-04-14,Hai Phong City,Hong Bang District,18,48,45,3,2
2022-04-14,Hai Phong City,Hong Bang District,19,62,52,10,4
2022-04-14,Hai Phong City,Hong Bang District,20,28,24,4,0
2022-04-14,Hai Phong City,Hong Bang District,21,18,9,9,2
2022-04-14,Hai Phong City,Kien An District,8,3,1,2,1
2022-04-14,Hai Phong City,Kien An District,9,8,6,2,1
2022-04-14,Hai Phong City,Kien An District,10,8,7,1,0
2022-04-14,Hai Phong City,Kien An District,11,20,18,2,2
2022-04-14,Hai Phong City,Kien An District,12,5,4,1,0
2022-04-14,Hai Phong City,Kien An District,13,9,1,8,8
2022-04-14,Hai Phong City,Kien An District,14,13,8,5,4
2022-04-14,Hai Phong City,Kien An District,15,13,8,5,5
2022-04-14,Hai Phong City,Kien An District,16,4,4,0,0
2022-04-14,Hai Phong City,Kien An District,17,8,6,2,2
2022-04-14,Hai Phong City,Kien An District,18,7,5,2,2
2022-04-14,Hai Phong City,Kien An District,19,12,8,4,1
2022-04-14,Hai Phong City,Kien An District,20,9,6,3,2
2022-04-14,Hai Phong City,Kien An District,21,4,2,2,1
2022-04-14,Hai Phong City,Le Chan District,1,2,1,1,0
2022-04-14,Hai Phong City,Le Chan District,6,4,3,1,0
2022-04-14,Hai Phong City,Le Chan District,7,24,22,2,0
2022-04-14,Hai Phong City,Le Chan District,8,52,46,6,1
2022-04-14,Hai Phong City,Le Chan District,9,73,66,7,0
2022-04-14,Hai Phong City,Le Chan District,10,139,127,12,1
2022-04-14,Hai Phong City,Le Chan District,11,315,288,27,4
2022-04-14,Hai Phong City,Le Chan District,12,169,147,22,12
2022-04-14,Hai Phong City,Le Chan District,13,109,101,8,3
2022-04-14,Hai Phong City,Le Chan District,14,138,119,19,2
2022-04-14,Hai Phong City,Le Chan District,15,158,135,23,11
2022-04-14,Hai Phong City,Le Chan District,16,132,109,23,1
2022-04-14,Hai Phong City,Le Chan District,17,148,133,15,0
2022-04-14,Hai Phong City,Le Chan District,18,200,177,23,1
2022-04-14,Hai Phong City,Le Chan District,19,164,147,17,0
2022-04-14,Hai Phong City,Le Chan District,20,124,108,16,0
2022-04-14,Hai Phong City,Le Chan District,21,48,38,10,5
2022-04-14,Hai Phong City,Le Chan District,22,3,1,2,0
2022-04-14,Hai Phong City,Ngo Quyen District,0,2,1,1,0
2022-04-14,Hai Phong City,Ngo Quyen District,6,1,0,1,1
2022-04-14,Hai Phong City,Ngo Quyen District,7,22,18,4,1
2022-04-14,Hai Phong City,Ngo Quyen District,8,60,53,7,2
2022-04-14,Hai Phong City,Ngo Quyen District,9,56,53,3,1
2022-04-14,Hai Phong City,Ngo Quyen District,10,127,116,11,0
2022-04-14,Hai Phong City,Ngo Quyen District,11,224,199,25,6
2022-04-14,Hai Phong City,Ngo Quyen District,12,132,120,12,1
2022-04-14,Hai Phong City,Ngo Quyen District,13,104,93,11,4
2022-04-14,Hai Phong City,Ngo Quyen District,14,139,124,15,1
2022-04-14,Hai Phong City,Ngo Quyen District,15,127,115,12,2
2022-04-14,Hai Phong City,Ngo Quyen District,16,107,97,10,0
2022-04-14,Hai Phong City,Ngo Quyen District,17,113,104,9,1
2022-04-14,Hai Phong City,Ngo Quyen District,18,158,144,14,1
2022-04-14,Hai Phong City,Ngo Quyen District,19,125,116,9,1
2022-04-14,Hai Phong City,Ngo Quyen District,20,122,110,12,1
2022-04-14,Hai Phong City,Ngo Quyen District,21,64,51,13,2
2022-04-14,Hai Phong City,Thuy Nguyen,10,1,0,1,1
2022-04-14,Hai Phong City,Thuy Nguyen,11,2,0,2,2
2022-04-14,Hai Phong City,Thuy Nguyen,13,1,0,1,1
2022-04-14,Hai Phong City,Thuy Nguyen,14,3,1,2,2
2022-04-14,Hai Phong City,Thuy Nguyen,17,2,0,2,1
2022-04-14,Hai Phong City,Thuy Nguyen,18,2,0,2,2
2022-04-14,Hai Phong City,Thuy Nguyen,19,3,0,3,2
2022-04-14,Hue City,Hue City,0,2,2,0,0
2022-04-14,Hue City,Hue City,1,1,1,0,0
2022-04-14,Hue City,Hue City,3,2,2,0,0
2022-04-14,Hue City,Hue City,5,1,0,1,0
2022-04-14,Hue City,Hue City,6,62,58,4,0
2022-04-14,Hue City,Hue City,7,180,171,9,2
2022-04-14,Hue City,Hue City,8,248,238,10,0
2022-04-14,Hue City,Hue City,9,253,230,23,0
2022-04-14,Hue City,Hue City,10,371,347,24,0
2022-04-14,Hue City,Hue City,11,832,800,32,2
2022-04-14,Hue City,Hue City,12,512,481,31,0
2022-04-14,Hue City,Hue City,13,301,283,18,0
2022-04-14,Hue City,Hue City,14,353,336,17,0
2022-04-14,Hue City,Hue City,15,367,339,28,3
2022-04-14,Hue City,Hue City,16,349,325,24,2
2022-04-14,Hue City,Hue City,17,468,439,29,2
2022-04-14,Hue City,Hue City,18,568,517,51,3
2022-04-14,Hue City,Hue City,19,530,489,41,0
2022-04-14,Hue City,Hue City,20,356,324,32,3
2022-04-14,Hue City,Hue City,21,205,184,21,1
2022-04-14,Hue City,Hue City,22,1,1,0,0
2022-04-14,Hue City,Hue City,23,1,1,0,0
2022-04-14,Hue City,Huong Thuy,14,1,0,1,1
2022-04-14,Hue City,Huong Thuy,15,2,2,0,0
2022-04-14,Hue City,Huong Thuy,18,1,1,0,0
2022-04-14,Hue City,Huong Thuy,19,2,2,0,0
2022-04-14,Hue City,Huong Tra,18,1,1,0,0
2022-04-14,Hue City,Huong Tra,21,1,0,1,1
2022-04-14,Hue City,Phu Vang,6,1,1,0,0
2022-04-14,Hue City,Phu Vang,9,1,1,0,0
2022-04-14,Hue City,Phu Vang,11,1,1,0,0
2022-04-14,Hue City,Phu Vang,12,1,1,0,0
2022-04-14,Hue City,Phu Vang,13,1,1,0,0
2022-04-14,Hue City,Phu Vang,15,3,3,0,0
2022-04-14,Hue City,Phu Vang,16,4,4,0,0
2022-04-14,Hue City,Phu Vang,17,1,1,0,0
2022-04-14,Hue City,Phu Vang,18,3,3,0,0
2022-04-14,Hue City,Phu Vang,19,5,4,1,0
2022-04-14,Hue City,Phu Vang,20,2,2,0,0
2022-04-14,Vung Tau,Ba Ria City,7,3,0,3,3
2022-04-14,Vung Tau,Ba Ria City,8,8,0,8,8
2022-04-14,Vung Tau,Ba Ria City,9,12,0,12,11
2022-04-14,Vung Tau,Ba Ria City,10,2,2,0,0
2022-04-14,Vung Tau,Ba Ria City,11,10,5,5,2
2022-04-14,Vung Tau,Ba Ria City,12,6,2,4,4
2022-04-14,Vung Tau,Ba Ria City,13,7,3,4,4
2022-04-14,Vung Tau,Ba Ria City,14,12,5,7,7
2022-04-14,Vung Tau,Ba Ria City,15,7,3,4,3
2022-04-14,Vung Tau,Ba Ria City,16,1,1,0,0
2022-04-14,Vung Tau,Ba Ria City,17,3,3,0,0
2022-04-14,Vung Tau,Ba Ria City,18,2,2,0,0
2022-04-14,Vung Tau,Ba Ria City,19,2,2,0,0
2022-04-14,Vung Tau,Ba Ria City,20,5,0,5,3
2022-04-14,Vung Tau,Vung Tau City,0,1,1,0,0
2022-04-14,Vung Tau,Vung Tau City,1,2,2,0,0
2022-04-14,Vung Tau,Vung Tau City,2,1,0,1,0
2022-04-14,Vung Tau,Vung Tau City,5,2,1,1,1
2022-04-14,Vung Tau,Vung Tau City,6,31,23,8,7
2022-04-14,Vung Tau,Vung Tau City,7,79,73,6,0
2022-04-14,Vung Tau,Vung Tau City,8,138,127,11,0
2022-04-14,Vung Tau,Vung Tau City,9,151,142,9,0
2022-04-14,Vung Tau,Vung Tau City,10,170,163,7,0
2022-04-14,Vung Tau,Vung Tau City,11,375,345,30,1
2022-04-14,Vung Tau,Vung Tau City,12,238,226,12,0
2022-04-14,Vung Tau,Vung Tau City,13,173,161,12,0
2022-04-14,Vung Tau,Vung Tau City,14,246,234,12,2
2022-04-14,Vung Tau,Vung Tau City,15,213,197,16,5
2022-04-14,Vung Tau,Vung Tau City,16,179,164,15,1
2022-04-14,Vung Tau,Vung Tau City,17,236,218,18,2
2022-04-14,Vung Tau,Vung Tau City,18,272,245,27,5
2022-04-14,Vung Tau,Vung Tau City,19,257,236,21,9
2022-04-14,Vung Tau,Vung Tau City,20,174,157,17,6
2022-04-14,Vung Tau,Vung Tau City,21,84,61,23,1
2022-04-14,Vung Tau,Vung Tau City,22,4,2,2,0
2022-04-14,Vung Tau,Vung Tau City,23,1,0,1,1
2022-04-15,Binh Duong,Ben Cat,11,1,1,0,0
2022-04-15,Binh Duong,Ben Cat,13,3,0,3,3
2022-04-15,Binh Duong,Di An,6,1,0,1,1
2022-04-15,Binh Duong,Di An,7,6,2,4,4
2022-04-15,Binh Duong,Di An,8,15,5,10,9
2022-04-15,Binh Duong,Di An,9,9,2,7,6
2022-04-15,Binh Duong,Di An,10,31,12,19,15
2022-04-15,Binh Duong,Di An,11,37,19,18,14
2022-04-15,Binh Duong,Di An,12,31,12,19,14
2022-04-15,Binh Duong,Di An,13,39,15,24,17
2022-04-15,Binh Duong,Di An,14,24,12,12,11
2022-04-15,Binh Duong,Di An,15,16,12,4,2
2022-04-15,Binh Duong,Di An,16,41,14,27,23
2022-04-15,Binh Duong,Di An,17,23,15,8,4
2022-04-15,Binh Duong,Di An,18,29,16,13,10
2022-04-15,Binh Duong,Di An,19,39,12,27,22
2022-04-15,Binh Duong,Di An,20,20,4,16,13
2022-04-15,Binh Duong,Di An,21,3,2,1,1
2022-04-15,Binh Duong,Tan Uyen,8,1,0,1,1
2022-04-15,Binh Duong,Tan Uyen,9,6,1,5,5
2022-04-15,Binh Duong,Tan Uyen,10,3,1,2,1
2022-04-15,Binh Duong,Tan Uyen,11,4,1,3,2
2022-04-15,Binh Duong,Tan Uyen,12,2,1,1,0
2022-04-15,Binh Duong,Tan Uyen,13,1,1,0,0
2022-04-15,Binh Duong,Tan Uyen,14,4,3,1,0
2022-04-15,Binh Duong,Tan Uyen,17,2,1,1,0
2022-04-15,Binh Duong,Tan Uyen,18,5,2,3,3
2022-04-15,Binh Duong,Thu Dau Mot Town,1,1,0,1,0
2022-04-15,Binh Duong,Thu Dau Mot Town,2,1,0,1,1
2022-04-15,Binh Duong,Thu Dau Mot Town,5,2,2,0,0
2022-04-15,Binh Duong,Thu Dau Mot Town,6,34,15,19,14
2022-04-15,Binh Duong,Thu Dau Mot Town,7,92,83,9,2
2022-04-15,Binh Duong,Thu Dau Mot Town,8,184,174,10,1
2022-04-15,Binh Duong,Thu Dau Mot Town,9,198,187,11,1
2022-04-15,Binh Duong,Thu Dau Mot Town,10,366,337,29,3
2022-04-15,Binh Duong,Thu Dau Mot Town,11,618,574,44,3
2022-04-15,Binh Duong,Thu Dau Mot Town,12,503,475,28,0
2022-04-15,Binh Duong,Thu Dau Mot Town,13,477,448,29,7
2022-04-15,Binh Duong,Thu Dau Mot Town,14,359,340,19,2
2022-04-15,Binh Duong,Thu Dau Mot Town,15,263,242,21,1
2022-04-15,Binh Duong,Thu Dau Mot Town,16,227,188,39,22
2022-04-15,Binh Duong,Thu Dau Mot Town,17,456,403,53,14
2022-04-15,Binh Duong,Thu Dau Mot Town,18,409,368,41,1
2022-04-15,Binh Duong,Thu Dau Mot Town,19,364,332,32,5
2022-04-15,Binh Duong,Thu Dau Mot Town,20,255,229,26,0
2022-04-15,Binh Duong,Thu Dau Mot Town,21,115,98,17,3
2022-04-15,Binh Duong,Thu Dau Mot Town,22,2,0,2,0
2022-04-15,Binh Duong,Thu Dau Mot Town,23,2,1,1,0
2022-04-15,Binh Duong,Thuan An,1,1,1,0,0
2022-04-15,Binh Duong,Thuan An,7,4,0,4,2
2022-04-15,Binh Duong,Thuan An,8,21,12,9,7
2022-04-15,Binh Duong,Thuan An,9,48,26,22,15
2022-04-15,Binh Duong,Thuan An,10,64,41,23,18
2022-04-15,Binh Duong,Thuan An,11,90,50,40,25
2022-04-15,Binh Duong,Thuan An,12,69,42,27,17
2022-04-15,Binh Duong,Thuan An,13,56,38,18,12
2022-04-15,Binh Duong,Thuan An,14,41,32,9,7
2022-04-15,Binh Duong,Thuan An,15,42,15,27,18
2022-04-15,Binh Duong,Thuan An,16,39,10,29,23
2022-04-15,Binh Duong,Thuan An,17,68,24,44,35
2022-04-15,Binh Duong,Thuan An,18,69,38,31,23
2022-04-15,Binh Duong,Thuan An,19,57,30,27,21
2022-04-15,Binh Duong,Thuan An,20,31,17,14,8
2022-04-15,Binh Duong,Thuan An,21,27,10,17,13
2022-04-15,Can Tho City,Binh Thuy District,6,1,1,0,0
2022-04-15,Can Tho City,Binh Thuy District,7,2,1,1,0
2022-04-15,Can Tho City,Binh Thuy District,8,7,4,3,0
2022-04-15,Can Tho City,Binh Thuy District,9,5,5,0,0
2022-04-15,Can Tho City,Binh Thuy District,10,10,10,0,0
2022-04-15,Can Tho City,Binh Thuy District,11,20,18,2,1
2022-04-15,Can Tho City,Binh Thuy District,12,6,6,0,0
2022-04-15,Can Tho City,Binh Thuy District,13,11,11,0,0
2022-04-15,Can Tho City,Binh Thuy District,14,15,14,1,0
2022-04-15,Can Tho City,Binh Thuy District,15,4,4,0,0
2022-04-15,Can Tho City,Binh Thuy District,16,9,8,1,0
2022-04-15,Can Tho City,Binh Thuy District,17,8,8,0,0
2022-04-15,Can Tho City,Binh Thuy District,18,9,9,0,0
2022-04-15,Can Tho City,Binh Thuy District,19,4,3,1,0
2022-04-15,Can Tho City,Binh Thuy District,20,11,8,3,1
2022-04-15,Can Tho City,Binh Thuy District,21,2,2,0,0
2022-04-15,Can Tho City,Cai Rang District,7,2,1,1,0
2022-04-15,Can Tho City,Cai Rang District,8,2,2,0,0
2022-04-15,Can Tho City,Cai Rang District,9,5,5,0,0
2022-04-15,Can Tho City,Cai Rang District,10,12,12,0,0
2022-04-15,Can Tho City,Cai Rang District,11,14,12,2,0
2022-04-15,Can Tho City,Cai Rang District,12,15,15,0,0
2022-04-15,Can Tho City,Cai Rang District,13,15,15,0,0
2022-04-15,Can Tho City,Cai Rang District,14,14,11,3,0
2022-04-15,Can Tho City,Cai Rang District,15,10,9,1,0
2022-04-15,Can Tho City,Cai Rang District,16,6,4,2,1
2022-04-15,Can Tho City,Cai Rang District,17,15,14,1,0
2022-04-15,Can Tho City,Cai Rang District,18,12,12,0,0
2022-04-15,Can Tho City,Cai Rang District,19,14,13,1,0
2022-04-15,Can Tho City,Cai Rang District,20,5,5,0,0
2022-04-15,Can Tho City,Cai Rang District,21,3,3,0,0
2022-04-15,Can Tho City,Cai Rang District,22,1,0,1,0
2022-04-15,Can Tho City,Cai Rang District,23,1,1,0,0
2022-04-15,Can Tho City,Ninh Kieu District,0,5,3,2,0
2022-04-15,Can Tho City,Ninh Kieu District,1,1,1,0,0
2022-04-15,Can Tho City,Ninh Kieu District,3,1,1,0,0
2022-04-15,Can Tho City,Ninh Kieu District,4,1,1,0,0
2022-04-15,Can Tho City,Ninh Kieu District,5,1,0,1,0
2022-04-15,Can Tho City,Ninh Kieu District,6,39,37,2,0
2022-04-15,Can Tho City,Ninh Kieu District,7,127,117,10,0
2022-04-15,Can Tho City,Ninh Kieu District,8,243,223,20,0
2022-04-15,Can Tho City,Ninh Kieu District,9,300,284,16,0
2022-04-15,Can Tho City,Ninh Kieu District,10,628,600,28,0
2022-04-15,Can Tho City,Ninh Kieu District,11,901,849,52,1
2022-04-15,Can Tho City,Ninh Kieu District,12,655,620,35,0
2022-04-15,Can Tho City,Ninh Kieu District,13,504,485,19,0
2022-04-15,Can Tho City,Ninh Kieu District,14,470,448,22,0
2022-04-15,Can Tho City,Ninh Kieu District,15,365,340,25,0
2022-04-15,Can Tho City,Ninh Kieu District,16,419,404,15,0
2022-04-15,Can Tho City,Ninh Kieu District,17,579,544,35,0
2022-04-15,Can Tho City,Ninh Kieu District,18,550,528,22,0
2022-04-15,Can Tho City,Ninh Kieu District,19,447,429,18,0
2022-04-15,Can Tho City,Ninh Kieu District,20,329,309,20,0
2022-04-15,Can Tho City,Ninh Kieu District,21,181,166,15,0
2022-04-15,Can Tho City,Ninh Kieu District,22,2,2,0,0
2022-04-15,Can Tho City,Ninh Kieu District,23,5,4,1,0
2022-04-15,Dong Nai,Bien Hoa City,0,4,3,1,0
2022-04-15,Dong Nai,Bien Hoa City,1,4,2,2,1
2022-04-15,Dong Nai,Bien Hoa City,2,1,0,1,0
2022-04-15,Dong Nai,Bien Hoa City,4,2,0,2,0
2022-04-15,Dong Nai,Bien Hoa City,5,4,3,1,1
2022-04-15,Dong Nai,Bien Hoa City,6,32,14,18,15
2022-04-15,Dong Nai,Bien Hoa City,7,147,103,44,17
2022-04-15,Dong Nai,Bien Hoa City,8,266,221,45,18
2022-04-15,Dong Nai,Bien Hoa City,9,355,312,43,8
2022-04-15,Dong Nai,Bien Hoa City,10,626,547,79,15
2022-04-15,Dong Nai,Bien Hoa City,11,984,856,128,28
2022-04-15,Dong Nai,Bien Hoa City,12,731,655,76,25
2022-04-15,Dong Nai,Bien Hoa City,13,629,569,60,17
2022-04-15,Dong Nai,Bien Hoa City,14,478,439,39,11
2022-04-15,Dong Nai,Bien Hoa City,15,379,342,37,5
2022-04-15,Dong Nai,Bien Hoa City,16,511,438,73,26
2022-04-15,Dong Nai,Bien Hoa City,17,625,528,97,31
2022-04-15,Dong Nai,Bien Hoa City,18,706,607,99,26
2022-04-15,Dong Nai,Bien Hoa City,19,591,493,98,23
2022-04-15,Dong Nai,Bien Hoa City,20,420,344,76,28
2022-04-15,Dong Nai,Bien Hoa City,21,205,146,59,35
2022-04-15,Dong Nai,Bien Hoa City,22,2,2,0,0
2022-04-15,Dong Nai,Bien Hoa City,23,2,1,1,0
2022-04-15,Dong Nai,Long Khanh,16,1,0,1,1
2022-04-15,Dong Nai,Long Thanh,9,1,0,1,1
2022-04-15,Dong Nai,Nhon trach,11,1,0,1,1
2022-04-15,Dong Nai,Nhon trach,13,3,0,3,3
2022-04-15,Dong Nai,Nhon trach,14,1,0,1,1
2022-04-15,Dong Nai,Nhon trach,15,2,0,2,2
2022-04-15,Dong Nai,Thong Nhat,9,2,2,0,0
2022-04-15,Dong Nai,Thong Nhat,11,2,2,0,0
2022-04-15,Dong Nai,Thong Nhat,13,1,1,0,0
2022-04-15,Dong Nai,Thong Nhat,14,1,1,0,0
2022-04-15,Dong Nai,Thong Nhat,15,1,1,0,0
2022-04-15,Dong Nai,Thong Nhat,16,2,2,0,0
2022-04-15,Dong Nai,Thong Nhat,17,1,0,1,1
2022-04-15,Dong Nai,Thong Nhat,18,1,1,0,0
2022-04-15,Dong Nai,Thong Nhat,19,1,1,0,0
2022-04-15,Dong Nai,Trang Bom,9,4,0,4,4
2022-04-15,Dong Nai,Trang Bom,11,3,0,3,3
2022-04-15,Dong Nai,Trang Bom,12,1,1,0,0
2022-04-15,Dong Nai,Trang Bom,14,1,0,1,1
2022-04-15,Dong Nai,Trang Bom,15,1,0,1,1
2022-04-15,Dong Nai,Trang Bom,16,2,0,2,2
2022-04-15,Dong Nai,Trang Bom,17,1,0,1,0
2022-04-15,Dong Nai,Trang Bom,18,1,0,1,1
2022-04-15,Dong Nai,Vinh Cuu,18,3,0,3,3
2022-04-15,Hai Phong City,An Duong,8,5,2,3,2
2022-04-15,Hai Phong City,An Duong,9,2,2,0,0
2022-04-15,Hai Phong City,An Duong,10,8,3,5,5
2022-04-15,Hai Phong City,An Duong,11,7,4,3,2
2022-04-15,Hai Phong City,An Duong,12,4,2,2,2
2022-04-15,Hai Phong City,An Duong,13,5,1,4,4
2022-04-15,Hai Phong City,An Duong,14,7,1,6,6
2022-04-15,Hai Phong City,An Duong,15,5,0,5,5
2022-04-15,Hai Phong City,An Duong,16,5,3,2,2
2022-04-15,Hai Phong City,An Duong,17,6,4,2,2
2022-04-15,Hai Phong City,An Duong,18,3,1,2,1
2022-04-15,Hai Phong City,Hai An District,6,1,1,0,0
2022-04-15,Hai Phong City,Hai An District,7,5,3,2,0
2022-04-15,Hai Phong City,Hai An District,8,8,5,3,0
2022-04-15,Hai Phong City,Hai An District,9,13,11,2,1
2022-04-15,Hai Phong City,Hai An District,10,21,15,6,3
2022-04-15,Hai Phong City,Hai An District,11,51,38,13,12
2022-04-15,Hai Phong City,Hai An District,12,28,21,7,1
2022-04-15,Hai Phong City,Hai An District,13,13,10,3,1
2022-04-15,Hai Phong City,Hai An District,14,15,11,4,1
2022-04-15,Hai Phong City,Hai An District,15,24,20,4,1
2022-04-15,Hai Phong City,Hai An District,16,16,12,4,0
2022-04-15,Hai Phong City,Hai An District,17,10,9,1,0
2022-04-15,Hai Phong City,Hai An District,18,26,20,6,2
2022-04-15,Hai Phong City,Hai An District,19,27,22,5,2
2022-04-15,Hai Phong City,Hai An District,20,18,14,4,2
2022-04-15,Hai Phong City,Hai An District,21,10,4,6,4
2022-04-15,Hai Phong City,Hong Bang District,0,2,1,1,0
2022-04-15,Hai Phong City,Hong Bang District,3,1,0,1,0
2022-04-15,Hai Phong City,Hong Bang District,6,1,1,0,0
2022-04-15,Hai Phong City,Hong Bang District,7,15,13,2,2
2022-04-15,Hai Phong City,Hong Bang District,8,30,27,3,0
2022-04-15,Hai Phong City,Hong Bang District,9,23,20,3,1
2022-04-15,Hai Phong City,Hong Bang District,10,55,44,11,7
2022-04-15,Hai Phong City,Hong Bang District,11,133,89,44,37
2022-04-15,Hai Phong City,Hong Bang District,12,76,64,12,5
2022-04-15,Hai Phong City,Hong Bang District,13,41,37,4,1
2022-04-15,Hai Phong City,Hong Bang District,14,44,36,8,4
2022-04-15,Hai Phong City,Hong Bang District,15,43,37,6,4
2022-04-15,Hai Phong City,Hong Bang District,16,40,34,6,0
2022-04-15,Hai Phong City,Hong Bang District,17,36,35,1,0
2022-04-15,Hai Phong City,Hong Bang District,18,59,54,5,2
2022-04-15,Hai Phong City,Hong Bang District,19,50,42,8,3
2022-04-15,Hai Phong City,Hong Bang District,20,52,36,16,9
2022-04-15,Hai Phong City,Hong Bang District,21,21,12,9,6
2022-04-15,Hai Phong City,Kien An District,7,1,0,1,1
2022-04-15,Hai Phong City,Kien An District,8,2,0,2,2
2022-04-15,Hai Phong City,Kien An District,9,3,1,2,1
2022-04-15,Hai Phong City,Kien An District,10,7,3,4,2
2022-04-15,Hai Phong City,Kien An District,11,11,7,4,1
2022-04-15,Hai Phong City,Kien An District,12,6,5,1,1
2022-04-15,Hai Phong City,Kien An District,13,4,3,1,1
2022-04-15,Hai Phong City,Kien An District,14,9,5,4,3
2022-04-15,Hai Phong City,Kien An District,15,9,3,6,2
2022-04-15,Hai Phong City,Kien An District,16,9,6,3,2
2022-04-15,Hai Phong City,Kien An District,17,4,3,1,0
2022-04-15,Hai Phong City,Kien An District,18,14,5,9,4
2022-04-15,Hai Phong City,Kien An District,19,9,5,4,2
2022-04-15,Hai Phong City,Kien An District,20,8,6,2,1
2022-04-15,Hai Phong City,Kien An District,21,2,1,1,1
2022-04-15,Hai Phong City,Le Chan District,2,1,0,1,0
2022-04-15,Hai Phong City,Le Chan District,6,4,3,1,0
2022-04-15,Hai Phong City,Le Chan District,7,29,26,3,1
2022-04-15,Hai Phong City,Le Chan District,8,89,78,11,1
2022-04-15,Hai Phong City,Le Chan District,9,82,78,4,0
2022-04-15,Hai Phong City,Le Chan District,10,184,154,30,9
2022-04-15,Hai Phong City,Le Chan District,11,349,242,107,75
2022-04-15,Hai Phong City,Le Chan District,12,204,170,34,13
2022-04-15,Hai Phong City,Le Chan District,13,110,99,11,3
2022-04-15,Hai Phong City,Le Chan District,14,136,112,24,13
2022-04-15,Hai Phong City,Le Chan District,15,147,132,15,1
2022-04-15,Hai Phong City,Le Chan District,16,124,101,23,1
2022-04-15,Hai Phong City,Le Chan District,17,152,136,16,2
2022-04-15,Hai Phong City,Le Chan District,18,238,213,25,2
2022-04-15,Hai Phong City,Le Chan District,19,174,157,17,2
2022-04-15,Hai Phong City,Le Chan District,20,145,124,21,6
2022-04-15,Hai Phong City,Le Chan District,21,60,51,9,1
2022-04-15,Hai Phong City,Le Chan District,22,3,1,2,0
2022-04-15,Hai Phong City,Le Chan District,23,1,0,1,0
2022-04-15,Hai Phong City,Ngo Quyen District,0,1,0,1,0
2022-04-15,Hai Phong City,Ngo Quyen District,1,1,1,0,0
2022-04-15,Hai Phong City,Ngo Quyen District,5,1,0,1,1
2022-04-15,Hai Phong City,Ngo Quyen District,7,27,21,6,2
2022-04-15,Hai Phong City,Ngo Quyen District,8,56,50,6,1
2022-04-15,Hai Phong City,Ngo Quyen District,9,58,54,4,0
2022-04-15,Hai Phong City,Ngo Quyen District,10,128,111,17,3
2022-04-15,Hai Phong City,Ngo Quyen District,11,264,217,47,33
2022-04-15,Hai Phong City,Ngo Quyen District,12,151,137,14,7
2022-04-15,Hai Phong City,Ngo Quyen District,13,93,85,8,3
2022-04-15,Hai Phong City,Ngo Quyen District,14,119,96,23,13
2022-04-15,Hai Phong City,Ngo Quyen District,15,125,114,11,2
2022-04-15,Hai Phong City,Ngo Quyen District,16,98,94,4,0
2022-04-15,Hai Phong City,Ngo Quyen District,17,137,124,13,0
2022-04-15,Hai Phong City,Ngo Quyen District,18,167,147,20,7
2022-04-15,Hai Phong City,Ngo Quyen District,19,181,158,23,2
2022-04-15,Hai Phong City,Ngo Quyen District,20,134,120,14,2
2022-04-15,Hai Phong City,Ngo Quyen District,21,71,51,20,7
2022-04-15,Hai Phong City,Thuy Nguyen,7,2,0,2,2
2022-04-15,Hai Phong City,Thuy Nguyen,8,1,0,1,1
2022-04-15,Hai Phong City,Thuy Nguyen,10,1,1,0,0
2022-04-15,Hai Phong City,Thuy Nguyen,15,1,0,1,1
2022-04-15,Hai Phong City,Thuy Nguyen,16,2,0,2,2
2022-04-15,Hai Phong City,Thuy Nguyen,18,3,0,3,3
2022-04-15,Hai Phong City,Thuy Nguyen,19,1,0,1,1
2022-04-15,Hue City,Hue City,0,7,4,3,0
2022-04-15,Hue City,Hue City,1,4,3,1,0
2022-04-15,Hue City,Hue City,2,2,2,0,0
2022-04-15,Hue City,Hue City,3,1,1,0,0
2022-04-15,Hue City,Hue City,5,1,1,0,0
2022-04-15,Hue City,Hue City,6,60,53,7,2
2022-04-15,Hue City,Hue City,7,167,150,17,0
2022-04-15,Hue City,Hue City,8,279,260,19,1
2022-04-15,Hue City,Hue City,9,251,229,22,1
2022-04-15,Hue City,Hue City,10,439,408,31,1
2022-04-15,Hue City,Hue City,11,947,877,70,2
2022-04-15,Hue City,Hue City,12,521,491,30,0
2022-04-15,Hue City,Hue City,13,350,321,29,1
2022-04-15,Hue City,Hue City,14,381,349,32,1
2022-04-15,Hue City,Hue City,15,395,377,18,0
2022-04-15,Hue City,Hue City,16,335,306,29,2
2022-04-15,Hue City,Hue City,17,458,434,24,0
2022-04-15,Hue City,Hue City,18,597,553,44,0
2022-04-15,Hue City,Hue City,19,640,575,65,0
2022-04-15,Hue City,Hue City,20,422,380,42,1
2022-04-15,Hue City,Hue City,21,225,189,36,3
2022-04-15,Hue City,Hue City,22,3,2,1,0
2022-04-15,Hue City,Hue City,23,4,4,0,0
2022-04-15,Hue City,Huong Thuy,9,1,1,0,0
2022-04-15,Hue City,Huong Thuy,11,1,0,1,0
2022-04-15,Hue City,Huong Thuy,12,1,1,0,0
2022-04-15,Hue City,Huong Thuy,14,5,1,4,4
2022-04-15,Hue City,Huong Thuy,18,2,2,0,0
2022-04-15,Hue City,Huong Thuy,19,1,1,0,0
2022-04-15,Hue City,Huong Thuy,20,1,0,1,1
2022-04-15,Hue City,Huong Thuy,21,1,0,1,1
2022-04-15,Hue City,Huong Tra,20,1,1,0,0
2022-04-15,Hue City,Phu Vang,6,1,1,0,0
2022-04-15,Hue City,Phu Vang,7,2,2,0,0
2022-04-15,Hue City,Phu Vang,10,3,3,0,0
2022-04-15,Hue City,Phu Vang,11,2,2,0,0
2022-04-15,Hue City,Phu Vang,12,4,3,1,0
2022-04-15,Hue City,Phu Vang,13,2,1,1,1
2022-04-15,Hue City,Phu Vang,15,3,3,0,0
2022-04-15,Hue City,Phu Vang,16,2,2,0,0
2022-04-15,Hue City,Phu Vang,17,3,3,0,0
2022-04-15,Hue City,Phu Vang,18,2,2,0,0
2022-04-15,Hue City,Phu Vang,19,4,4,0,0
2022-04-15,Hue City,Phu Vang,20,2,1,1,1
2022-04-15,Hue City,Phu Vang,21,1,1,0,0
2022-04-15,Vung Tau,Ba Ria City,7,1,0,1,1
2022-04-15,Vung Tau,Ba Ria City,8,3,0,3,3
2022-04-15,Vung Tau,Ba Ria City,9,4,2,2,2
2022-04-15,Vung Tau,Ba Ria City,10,5,2,3,0
2022-04-15,Vung Tau,Ba Ria City,11,9,4,5,4
2022-04-15,Vung Tau,Ba Ria City,12,13,5,8,7
2022-04-15,Vung Tau,Ba Ria City,13,10,6,4,3
2022-04-15,Vung Tau,Ba Ria City,14,9,5,4,4
2022-04-15,Vung Tau,Ba Ria City,15,8,6,2,0
2022-04-15,Vung Tau,Ba Ria City,16,6,6,0,0
2022-04-15,Vung Tau,Ba Ria City,17,4,0,4,3
2022-04-15,Vung Tau,Ba Ria City,18,4,3,1,1
2022-04-15,Vung Tau,Ba Ria City,19,5,2,3,2
2022-04-15,Vung Tau,Ba Ria City,20,1,0,1,1
2022-04-15,Vung Tau,Vung Tau City,0,1,1,0,0
2022-04-15,Vung Tau,Vung Tau City,2,1,0,1,0
2022-04-15,Vung Tau,Vung Tau City,5,1,0,1,0
2022-04-15,Vung Tau,Vung Tau City,6,38,29,9,8
2022-04-15,Vung Tau,Vung Tau City,7,88,80,8,1
2022-04-15,Vung Tau,Vung Tau City,8,141,128,13,0
2022-04-15,Vung Tau,Vung Tau City,9,150,135,15,0
2022-04-15,Vung Tau,Vung Tau City,10,170,150,20,1
2022-04-15,Vung Tau,Vung Tau City,11,372,328,44,6
2022-04-15,Vung Tau,Vung Tau City,12,253,232,21,3
2022-04-15,Vung Tau,Vung Tau City,13,194,163,31,7
2022-04-15,Vung Tau,Vung Tau City,14,212,192,20,5
2022-04-15,Vung Tau,Vung Tau City,15,200,182,18,5
2022-04-15,Vung Tau,Vung Tau City,16,152,138,14,3
2022-04-15,Vung Tau,Vung Tau City,17,266,247,19,0
2022-04-15,Vung Tau,Vung Tau City,18,316,283,33,5
2022-04-15,Vung Tau,Vung Tau City,19,261,241,20,5
2022-04-15,Vung Tau,Vung Tau City,20,214,158,56,34
2022-04-15,Vung Tau,Vung Tau City,21,189,39,150,120
2022-04-15,Vung Tau,Vung Tau City,23,2,2,0,0
2022-04-16,Binh Duong,Ben Cat,10,1,1,0,0
2022-04-16,Binh Duong,Ben Cat,14,1,0,1,1
2022-04-16,Binh Duong,Ben Cat,20,1,0,1,1
2022-04-16,Binh Duong,Ben Cat,21,1,0,1,0
2022-04-16,Binh Duong,Di An,6,4,0,4,4
2022-04-16,Binh Duong,Di An,7,3,1,2,1
2022-04-16,Binh Duong,Di An,8,18,8,10,8
2022-04-16,Binh Duong,Di An,9,42,16,26,22
2022-04-16,Binh Duong,Di An,10,36,12,24,18
2022-04-16,Binh Duong,Di An,11,64,18,46,39
2022-04-16,Binh Duong,Di An,12,48,20,28,22
2022-04-16,Binh Duong,Di An,13,24,13,11,10
2022-04-16,Binh Duong,Di An,14,21,11,10,8
2022-04-16,Binh Duong,Di An,15,26,15,11,9
2022-04-16,Binh Duong,Di An,16,24,12,12,8
2022-04-16,Binh Duong,Di An,17,17,11,6,5
2022-04-16,Binh Duong,Di An,18,31,22,9,5
2022-04-16,Binh Duong,Di An,19,37,18,19,15
2022-04-16,Binh Duong,Di An,20,19,10,9,4
2022-04-16,Binh Duong,Di An,21,6,0,6,5
2022-04-16,Binh Duong,Tan Uyen,9,1,0,1,1
2022-04-16,Binh Duong,Tan Uyen,10,1,1,0,0
2022-04-16,Binh Duong,Tan Uyen,11,1,0,1,1
2022-04-16,Binh Duong,Tan Uyen,12,5,3,2,1
2022-04-16,Binh Duong,Tan Uyen,13,2,1,1,1
2022-04-16,Binh Duong,Tan Uyen,15,2,0,2,1
2022-04-16,Binh Duong,Tan Uyen,18,1,0,1,1
2022-04-16,Binh Duong,Tan Uyen,19,3,0,3,3
2022-04-16,Binh Duong,Tan Uyen,20,7,1,6,5
2022-04-16,Binh Duong,Tan Uyen,21,3,0,3,3
2022-04-16,Binh Duong,Thu Dau Mot Town,1,4,1,3,0
2022-04-16,Binh Duong,Thu Dau Mot Town,4,1,1,0,0
2022-04-16,Binh Duong,Thu Dau Mot Town,6,47,36,11,5
2022-04-16,Binh Duong,Thu Dau Mot Town,7,153,131,22,8
2022-04-16,Binh Duong,Thu Dau Mot Town,8,229,205,24,3
2022-04-16,Binh Duong,Thu Dau Mot Town,9,287,269,18,2
2022-04-16,Binh Duong,Thu Dau Mot Town,10,408,378,30,2
2022-04-16,Binh Duong,Thu Dau Mot Town,11,592,538,54,18
2022-04-16,Binh Duong,Thu Dau Mot Town,12,449,404,45,27
2022-04-16,Binh Duong,Thu Dau Mot Town,13,319,301,18,2
2022-04-16,Binh Duong,Thu Dau Mot Town,14,211,170,41,24
2022-04-16,Binh Duong,Thu Dau Mot Town,15,338,300,38,14
2022-04-16,Binh Duong,Thu Dau Mot Town,16,314,290,24,1
2022-04-16,Binh Duong,Thu Dau Mot Town,17,405,367,38,12
2022-04-16,Binh Duong,Thu Dau Mot Town,18,433,404,29,11
2022-04-16,Binh Duong,Thu Dau Mot Town,19,413,377,36,12
2022-04-16,Binh Duong,Thu Dau Mot Town,20,297,266,31,9
2022-04-16,Binh Duong,Thu Dau Mot Town,21,129,106,23,8
2022-04-16,Binh Duong,Thu Dau Mot Town,23,1,0,1,1
2022-04-16,Binh Duong,Thuan An,7,10,2,8,7
2022-04-16,Binh Duong,Thuan An,8,19,8,11,8
2022-04-16,Binh Duong,Thuan An,9,53,18,35,29
2022-04-16,Binh Duong,Thuan An,10,87,34,53,45
2022-04-16,Binh Duong,Thuan An,11,76,39,37,25
2022-04-16,Binh Duong,Thuan An,12,73,38,35,31
2022-04-16,Binh Duong,Thuan An,13,47,11,36,32
2022-04-16,Binh Duong,Thuan An,14,37,6,31,27
2022-04-16,Binh Duong,Thuan An,15,58,21,37,31
2022-04-16,Binh Duong,Thuan An,16,54,28,26,17
2022-04-16,Binh Duong,Thuan An,17,50,26,24,21
2022-04-16,Binh Duong,Thuan An,18,47,24,23,18
2022-04-16,Binh Duong,Thuan An,19,77,35,42,34
2022-04-16,Binh Duong,Thuan An,20,37,20,17,12
2022-04-16,Binh Duong,Thuan An,21,27,8,19,13
2022-04-16,Can Tho City,Binh Thuy District,7,1,1,0,0
2022-04-16,Can Tho City,Binh Thuy District,8,4,3,1,0
2022-04-16,Can Tho City,Binh Thuy District,9,2,2,0,0
2022-04-16,Can Tho City,Binh Thuy District,10,21,15,6,0
2022-04-16,Can Tho City,Binh Thuy District,11,16,15,1,0
2022-04-16,Can Tho City,Binh Thuy District,12,16,16,0,0
2022-04-16,Can Tho City,Binh Thuy District,13,12,11,1,0
2022-04-16,Can Tho City,Binh Thuy District,14,7,5,2,1
2022-04-16,Can Tho City,Binh Thuy District,15,12,11,1,1
2022-04-16,Can Tho City,Binh Thuy District,16,8,8,0,0
2022-04-16,Can Tho City,Binh Thuy District,17,16,15,1,0
2022-04-16,Can Tho City,Binh Thuy District,18,10,9,1,0
2022-04-16,Can Tho City,Binh Thuy District,19,12,11,1,0
2022-04-16,Can Tho City,Binh Thuy District,20,7,4,3,1
2022-04-16,Can Tho City,Binh Thuy District,21,3,3,0,0
2022-04-16,Can Tho City,Cai Rang District,6,1,1,0,0
2022-04-16,Can Tho City,Cai Rang District,7,1,1,0,0
2022-04-16,Can Tho City,Cai Rang District,8,2,1,1,1
2022-04-16,Can Tho City,Cai Rang District,9,7,6,1,0
2022-04-16,Can Tho City,Cai Rang District,10,11,10,1,0
2022-04-16,Can Tho City,Cai Rang District,11,21,16,5,1
2022-04-16,Can Tho City,Cai Rang District,12,14,14,0,0
2022-04-16,Can Tho City,Cai Rang District,13,10,10,0,0
2022-04-16,Can Tho City,Cai Rang District,14,6,6,0,0
2022-04-16,Can Tho City,Cai Rang District,15,9,6,3,0
2022-04-16,Can Tho City,Cai Rang District,16,15,15,0,0
2022-04-16,Can Tho City,Cai Rang District,17,16,15,1,1
2022-04-16,Can Tho City,Cai Rang District,18,18,15,3,1
2022-04-16,Can Tho City,Cai Rang District,19,17,17,0,0
2022-04-16,Can Tho City,Cai Rang District,20,11,10,1,0
2022-04-16,Can Tho City,Cai Rang District,21,3,3,0,0
2022-04-16,Can Tho City,Ninh Kieu District,0,5,3,2,0
2022-04-16,Can Tho City,Ninh Kieu District,1,3,1,2,0
2022-04-16,Can Tho City,Ninh Kieu District,2,4,1,3,0
2022-04-16,Can Tho City,Ninh Kieu District,3,1,1,0,0
2022-04-16,Can Tho City,Ninh Kieu District,5,1,1,0,0
2022-04-16,Can Tho City,Ninh Kieu District,6,60,56,4,0
2022-04-16,Can Tho City,Ninh Kieu District,7,132,126,6,0
2022-04-16,Can Tho City,Ninh Kieu District,8,252,237,15,1
2022-04-16,Can Tho City,Ninh Kieu District,9,336,311,25,0
2022-04-16,Can Tho City,Ninh Kieu District,10,569,551,18,2
2022-04-16,Can Tho City,Ninh Kieu District,11,837,800,37,1
2022-04-16,Can Tho City,Ninh Kieu District,12,655,629,26,0
2022-04-16,Can Tho City,Ninh Kieu District,13,522,496,26,0
2022-04-16,Can Tho City,Ninh Kieu District,14,434,421,13,0
2022-04-16,Can Tho City,Ninh Kieu District,15,319,300,19,0
2022-04-16,Can Tho City,Ninh Kieu District,16,506,471,35,2
2022-04-16,Can Tho City,Ninh Kieu District,17,582,561,21,3
2022-04-16,Can Tho City,Ninh Kieu District,18,587,549,38,1
2022-04-16,Can Tho City,Ninh Kieu District,19,472,442,30,0
2022-04-16,Can Tho City,Ninh Kieu District,20,347,327,20,2
2022-04-16,Can Tho City,Ninh Kieu District,21,209,186,23,2
2022-04-16,Can Tho City,Ninh Kieu District,22,7,4,3,1
2022-04-16,Dong Nai,Bien Hoa City,0,2,2,0,0
2022-04-16,Dong Nai,Bien Hoa City,1,4,3,1,0
2022-04-16,Dong Nai,Bien Hoa City,2,1,0,1,0
2022-04-16,Dong Nai,Bien Hoa City,3,1,0,1,1
2022-04-16,Dong Nai,Bien Hoa City,4,1,0,1,1
2022-04-16,Dong Nai,Bien Hoa City,5,3,2,1,0
2022-04-16,Dong Nai,Bien Hoa City,6,38,19,19,13
2022-04-16,Dong Nai,Bien Hoa City,7,158,133,25,13
2022-04-16,Dong Nai,Bien Hoa City,8,318,278,40,8
2022-04-16,Dong Nai,Bien Hoa City,9,552,452,100,49
2022-04-16,Dong Nai,Bien Hoa City,10,842,636,206,114
2022-04-16,Dong Nai,Bien Hoa City,11,1182,1007,175,83
2022-04-16,Dong Nai,Bien Hoa City,12,939,815,124,52
2022-04-16,Dong Nai,Bien Hoa City,13,715,595,120,74
2022-04-16,Dong Nai,Bien Hoa City,14,599,545,54,20
2022-04-16,Dong Nai,Bien Hoa City,15,478,438,40,5
2022-04-16,Dong Nai,Bien Hoa City,16,574,511,63,22
2022-04-16,Dong Nai,Bien Hoa City,17,734,619,115,47
2022-04-16,Dong Nai,Bien Hoa City,18,868,657,211,135
2022-04-16,Dong Nai,Bien Hoa City,19,827,577,250,188
2022-04-16,Dong Nai,Bien Hoa City,20,626,422,204,131
2022-04-16,Dong Nai,Bien Hoa City,21,285,148,137,78
2022-04-16,Dong Nai,Bien Hoa City,22,1,0,1,0
2022-04-16,Dong Nai,Bien Hoa City,23,2,0,2,1
2022-04-16,Dong Nai,Long Thanh,9,2,0,2,2
2022-04-16,Dong Nai,Long Thanh,10,2,0,2,2
2022-04-16,Dong Nai,Long Thanh,11,1,0,1,1
2022-04-16,Dong Nai,Long Thanh,12,2,0,2,2
2022-04-16,Dong Nai,Long Thanh,13,2,0,2,1
2022-04-16,Dong Nai,Long Thanh,14,1,0,1,1
2022-04-16,Dong Nai,Long Thanh,15,2,0,2,0
2022-04-16,Dong Nai,Long Thanh,16,2,0,2,2
2022-04-16,Dong Nai,Long Thanh,18,4,0,4,2
2022-04-16,Dong Nai,Nhon trach,11,1,0,1,1
2022-04-16,Dong Nai,Nhon trach,14,2,0,2,2
2022-04-16,Dong Nai,Nhon trach,19,1,0,1,1
2022-04-16,Dong Nai,Thong Nhat,8,4,3,1,0
2022-04-16,Dong Nai,Thong Nhat,9,2,2,0,0
2022-04-16,Dong Nai,Thong Nhat,10,1,1,0,0
2022-04-16,Dong Nai,Thong Nhat,11,4,4,0,0
2022-04-16,Dong Nai,Thong Nhat,12,3,3,0,0
2022-04-16,Dong Nai,Thong Nhat,13,2,2,0,0
2022-04-16,Dong Nai,Thong Nhat,15,2,2,0,0
2022-04-16,Dong Nai,Thong Nhat,16,1,1,0,0
2022-04-16,Dong Nai,Thong Nhat,17,1,1,0,0
2022-04-16,Dong Nai,Thong Nhat,18,1,1,0,0
2022-04-16,Dong Nai,Thong Nhat,20,3,3,0,0
2022-04-16,Dong Nai,Trang Bom,10,2,1,1,1
2022-04-16,Dong Nai,Trang Bom,11,3,0,3,3
2022-04-16,Dong Nai,Trang Bom,12,1,0,1,1
2022-04-16,Dong Nai,Trang Bom,16,1,0,1,1
2022-04-16,Dong Nai,Trang Bom,18,1,0,1,1
2022-04-16,Dong Nai,Trang Bom,19,3,1,2,2
2022-04-16,Dong Nai,Trang Bom,20,1,0,1,1
2022-04-16,Hai Phong City,An Duong,8,4,1,3,1
2022-04-16,Hai Phong City,An Duong,9,3,2,1,1
2022-04-16,Hai Phong City,An Duong,10,4,1,3,2
2022-04-16,Hai Phong City,An Duong,11,3,2,1,1
2022-04-16,Hai Phong City,An Duong,12,9,2,7,7
2022-04-16,Hai Phong City,An Duong,13,1,0,1,1
2022-04-16,Hai Phong City,An Duong,14,1,0,1,1
2022-04-16,Hai Phong City,An Duong,15,6,4,2,2
2022-04-16,Hai Phong City,An Duong,16,6,4,2,0
2022-04-16,Hai Phong City,An Duong,17,2,1,1,1
2022-04-16,Hai Phong City,An Duong,18,1,0,1,0
2022-04-16,Hai Phong City,An Duong,20,2,0,2,2
2022-04-16,Hai Phong City,Duong Kinh District,19,1,0,1,1
2022-04-16,Hai Phong City,Hai An District,0,1,1,0,0
2022-04-16,Hai Phong City,Hai An District,7,4,1,3,2
2022-04-16,Hai Phong City,Hai An District,8,11,3,8,6
2022-04-16,Hai Phong City,Hai An District,9,6,6,0,0
2022-04-16,Hai Phong City,Hai An District,10,24,13,11,6
2022-04-16,Hai Phong City,Hai An District,11,67,24,43,36
2022-04-16,Hai Phong City,Hai An District,12,57,24,33,28
2022-04-16,Hai Phong City,Hai An District,13,23,16,7,4
2022-04-16,Hai Phong City,Hai An District,14,16,10,6,4
2022-04-16,Hai Phong City,Hai An District,15,16,11,5,2
2022-04-16,Hai Phong City,Hai An District,16,20,16,4,0
2022-04-16,Hai Phong City,Hai An District,17,16,15,1,0
2022-04-16,Hai Phong City,Hai An District,18,28,22,6,4
2022-04-16,Hai Phong City,Hai An District,19,31,21,10,2
2022-04-16,Hai Phong City,Hai An District,20,4,3,1,1
2022-04-16,Hai Phong City,Hai An District,21,7,1,6,3
2022-04-16,Hai Phong City,Hong Bang District,6,1,0,1,1
2022-04-16,Hai Phong City,Hong Bang District,7,7,1,6,4
2022-04-16,Hai Phong City,Hong Bang District,8,29,16,13,10
2022-04-16,Hai Phong City,Hong Bang District,9,34,26,8,2
2022-04-16,Hai Phong City,Hong Bang District,10,67,34,33,27
2022-04-16,Hai Phong City,Hong Bang District,11,151,59,92,85
2022-04-16,Hai Phong City,Hong Bang District,12,103,59,44,31
2022-04-16,Hai Phong City,Hong Bang District,13,69,55,14,7
2022-04-16,Hai Phong City,Hong Bang District,14,48,39,9,6
2022-04-16,Hai Phong City,Hong Bang District,15,52,43,9,6
2022-04-16,Hai Phong City,Hong Bang District,16,34,29,5,2
2022-04-16,Hai Phong City,Hong Bang District,17,60,45,15,11
2022-04-16,Hai Phong City,Hong Bang District,18,63,43,20,15
2022-04-16,Hai Phong City,Hong Bang District,19,65,51,14,11
2022-04-16,Hai Phong City,Hong Bang District,20,34,26,8,4
2022-04-16,Hai Phong City,Hong Bang District,21,23,16,7,3
2022-04-16,Hai Phong City,Kien An District,6,1,0,1,1
2022-04-16,Hai Phong City,Kien An District,8,5,1,4,3
2022-04-16,Hai Phong City,Kien An District,9,5,4,1,0
2022-04-16,Hai Phong City,Kien An District,10,17,7,10,7
2022-04-16,Hai Phong City,Kien An District,11,27,6,21,15
2022-04-16,Hai Phong City,Kien An District,12,14,5,9,7
2022-04-16,Hai Phong City,Kien An District,13,5,2,3,3
2022-04-16,Hai Phong City,Kien An District,14,15,4,11,11
2022-04-16,Hai Phong City,Kien An District,15,13,4,9,8
2022-04-16,Hai Phong City,Kien An District,16,14,6,8,4
2022-04-16,Hai Phong City,Kien An District,17,8,5,3,2
2022-04-16,Hai Phong City,Kien An District,18,11,5,6,5
2022-04-16,Hai Phong City,Kien An District,19,7,2,5,4
2022-04-16,Hai Phong City,Kien An District,20,18,1,17,17
2022-04-16,Hai Phong City,Kien An District,21,3,0,3,3
2022-04-16,Hai Phong City,Le Chan District,0,1,1,0,0
2022-04-16,Hai Phong City,Le Chan District,5,1,0,1,0
2022-04-16,Hai Phong City,Le Chan District,7,37,19,18,15
2022-04-16,Hai Phong City,Le Chan District,8,77,49,28,22
2022-04-16,Hai Phong City,Le Chan District,9,90,75,15,3
2022-04-16,Hai Phong City,Le Chan District,10,228,151,77,55
2022-04-16,Hai Phong City,Le Chan District,11,503,201,302,256
2022-04-16,Hai Phong City,Le Chan District,12,373,206,167,125
2022-04-16,Hai Phong City,Le Chan District,13,153,119,34,16
2022-04-16,Hai Phong City,Le Chan District,14,162,132,30,17
2022-04-16,Hai Phong City,Le Chan District,15,168,139,29,10
2022-04-16,Hai Phong City,Le Chan District,16,153,134,19,5
2022-04-16,Hai Phong City,Le Chan District,17,216,184,32,15
2022-04-16,Hai Phong City,Le Chan District,18,285,198,87,45
2022-04-16,Hai Phong City,Le Chan District,19,216,173,43,23
2022-04-16,Hai Phong City,Le Chan District,20,153,128,25,9
2022-04-16,Hai Phong City,Le Chan District,21,72,49,23,10
2022-04-16,Hai Phong City,Le Chan District,22,2,0,2,1
2022-04-16,Hai Phong City,Le Chan District,23,1,1,0,0
2022-04-16,Hai Phong City,Ngo Quyen District,0,2,1,1,1
2022-04-16,Hai Phong City,Ngo Quyen District,6,2,0,2,1
2022-04-16,Hai Phong City,Ngo Quyen District,7,29,8,21,16
2022-04-16,Hai Phong City,Ngo Quyen District,8,64,44,20,11
2022-04-16,Hai Phong City,Ngo Quyen District,9,103,79,24,10
2022-04-16,Hai Phong City,Ngo Quyen District,10,168,112,56,40
2022-04-16,Hai Phong City,Ngo Quyen District,11,331,141,190,167
2022-04-16,Hai Phong City,Ngo Quyen District,12,286,150,136,101
2022-04-16,Hai Phong City,Ngo Quyen District,13,121,97,24,15
2022-04-16,Hai Phong City,Ngo Quyen District,14,132,104,28,17
2022-04-16,Hai Phong City,Ngo Quyen District,15,144,109,35,18
2022-04-16,Hai Phong City,Ngo Quyen District,16,122,102,20,0
2022-04-16,Hai Phong City,Ngo Quyen District,17,185,164,21,7
2022-04-16,Hai Phong City,Ngo Quyen District,18,227,176,51,31
2022-04-16,Hai Phong City,Ngo Quyen District,19,186,157,29,19
2022-04-16,Hai Phong City,Ngo Quyen District,20,145,120,25,10
2022-04-16,Hai Phong City,Ngo Quyen District,21,75,56,19,6
2022-04-16,Hai Phong City,Thuy Nguyen,8,1,0,1,1
2022-04-16,Hai Phong City,Thuy Nguyen,9,1,0,1,1
2022-04-16,Hai Phong City,Thuy Nguyen,10,1,0,1,1
2022-04-16,Hai Phong City,Thuy Nguyen,11,3,0,3,3
2022-04-16,Hai Phong City,Thuy Nguyen,12,1,0,1,1
2022-04-16,Hai Phong City,Thuy Nguyen,13,1,0,1,1
2022-04-16,Hai Phong City,Thuy Nguyen,15,1,0,1,1
2022-04-16,Hai Phong City,Thuy Nguyen,16,4,0,4,3
2022-04-16,Hai Phong City,Thuy Nguyen,17,2,0,2,2
2022-04-16,Hai Phong City,Thuy Nguyen,20,1,0,1,1
2022-04-16,Hue City,Hue City,0,2,2,0,0
2022-04-16,Hue City,Hue City,1,1,1,0,0
2022-04-16,Hue City,Hue City,3,1,1,0,0
2022-04-16,Hue City,Hue City,5,2,1,1,0
2022-04-16,Hue City,Hue City,6,80,61,19,3
2022-04-16,Hue City,Hue City,7,188,180,8,0
2022-04-16,Hue City,Hue City,8,302,277,25,1
2022-04-16,Hue City,Hue City,9,278,245,33,1
2022-04-16,Hue City,Hue City,10,437,412,25,0
2022-04-16,Hue City,Hue City,11,861,791,70,3
2022-04-16,Hue City,Hue City,12,582,533,49,0
2022-04-16,Hue City,Hue City,13,345,324,21,1
2022-04-16,Hue City,Hue City,14,357,339,18,0
2022-04-16,Hue City,Hue City,15,393,361,32,4
2022-04-16,Hue City,Hue City,16,372,358,14,0
2022-04-16,Hue City,Hue City,17,417,397,20,2
2022-04-16,Hue City,Hue City,18,620,580,40,3
2022-04-16,Hue City,Hue City,19,585,539,46,1
2022-04-16,Hue City,Hue City,20,449,396,53,4
2022-04-16,Hue City,Hue City,21,243,205,38,11
2022-04-16,Hue City,Hue City,22,3,0,3,0
2022-04-16,Hue City,Huong Thuy,10,1,1,0,0
2022-04-16,Hue City,Huong Thuy,11,2,2,0,0
2022-04-16,Hue City,Huong Thuy,18,2,1,1,1
2022-04-16,Hue City,Huong Thuy,20,1,1,0,0
2022-04-16,Hue City,Huong Tra,7,1,1,0,0
2022-04-16,Hue City,Huong Tra,10,1,1,0,0
2022-04-16,Hue City,Huong Tra,18,1,1,0,0
2022-04-16,Hue City,Phu Vang,6,1,1,0,0
2022-04-16,Hue City,Phu Vang,8,3,3,0,0
2022-04-16,Hue City,Phu Vang,9,1,0,1,0
2022-04-16,Hue City,Phu Vang,10,4,2,2,1
2022-04-16,Hue City,Phu Vang,11,3,2,1,0
2022-04-16,Hue City,Phu Vang,12,2,2,0,0
2022-04-16,Hue City,Phu Vang,13,1,1,0,0
2022-04-16,Hue City,Phu Vang,14,1,1,0,0
2022-04-16,Hue City,Phu Vang,16,1,1,0,0
2022-04-16,Hue City,Phu Vang,17,2,1,1,0
2022-04-16,Hue City,Phu Vang,18,1,1,0,0
2022-04-16,Hue City,Phu Vang,19,2,2,0,0
2022-04-16,Hue City,Phu Vang,20,2,1,1,0
2022-04-16,Hue City,Phu Vang,21,4,3,1,0
2022-04-16,Vung Tau,Ba Ria City,8,4,0,4,3
2022-04-16,Vung Tau,Ba Ria City,9,4,2,2,2
2022-04-16,Vung Tau,Ba Ria City,10,6,5,1,1
2022-04-16,Vung Tau,Ba Ria City,11,11,7,4,1
2022-04-16,Vung Tau,Ba Ria City,12,5,3,2,2
2022-04-16,Vung Tau,Ba Ria City,13,14,8,6,2
2022-04-16,Vung Tau,Ba Ria City,14,5,3,2,2
2022-04-16,Vung Tau,Ba Ria City,15,1,1,0,0
2022-04-16,Vung Tau,Ba Ria City,16,6,0,6,4
2022-04-16,Vung Tau,Ba Ria City,17,8,3,5,4
2022-04-16,Vung Tau,Ba Ria City,18,13,6,7,7
2022-04-16,Vung Tau,Ba Ria City,19,3,2,1,1
2022-04-16,Vung Tau,Ba Ria City,20,2,0,2,1
2022-04-16,Vung Tau,Ba Ria City,21,3,0,3,2
2022-04-16,Vung Tau,Vung Tau City,4,1,0,1,0
2022-04-16,Vung Tau,Vung Tau City,5,1,1,0,0
2022-04-16,Vung Tau,Vung Tau City,6,28,23,5,3
2022-04-16,Vung Tau,Vung Tau City,7,94,87,7,1
2022-04-16,Vung Tau,Vung Tau City,8,190,175,15,4
2022-04-16,Vung Tau,Vung Tau City,9,148,133,15,0
2022-04-16,Vung Tau,Vung Tau City,10,211,202,9,1
2022-04-16,Vung Tau,Vung Tau City,11,410,380,30,4
2022-04-16,Vung Tau,Vung Tau City,12,309,288,21,2
2022-04-16,Vung Tau,Vung Tau City,13,242,230,12,1
2022-04-16,Vung Tau,Vung Tau City,14,251,233,18,4
2022-04-16,Vung Tau,Vung Tau City,15,201,184,17,0
2022-04-16,Vung Tau,Vung Tau City,16,224,212,12,0
2022-04-16,Vung Tau,Vung Tau City,17,325,297,28,3
2022-04-16,Vung Tau,Vung Tau City,18,378,330,48,17
2022-04-16,Vung Tau,Vung Tau City,19,259,233,26,3
2022-04-16,Vung Tau,Vung Tau City,20,250,186,64,21
2022-04-16,Vung Tau,Vung Tau City,21,158,83,75,49
2022-04-16,Vung Tau,Vung Tau City,22,3,2,1,0
2022-04-16,Vung Tau,Vung Tau City,23,3,1,2,1
2022-04-17,Binh Duong,Ben Cat,10,5,1,4,4
2022-04-17,Binh Duong,Ben Cat,11,4,1,3,3
2022-04-17,Binh Duong,Ben Cat,12,1,1,0,0
2022-04-17,Binh Duong,Ben Cat,14,1,1,0,0
2022-04-17,Binh Duong,Ben Cat,19,1,1,0,0
2022-04-17,Binh Duong,Ben Cat,20,1,0,1,1
2022-04-17,Binh Duong,Di An,7,5,1,4,1
2022-04-17,Binh Duong,Di An,8,6,4,2,1
2022-04-17,Binh Duong,Di An,9,20,10,10,8
2022-04-17,Binh Duong,Di An,10,43,18,25,16
2022-04-17,Binh Duong,Di An,11,45,20,25,22
2022-04-17,Binh Duong,Di An,12,65,29,36,31
2022-04-17,Binh Duong,Di An,13,43,12,31,23
2022-04-17,Binh Duong,Di An,14,39,8,31,23
2022-04-17,Binh Duong,Di An,15,28,11,17,11
2022-04-17,Binh Duong,Di An,16,30,16,14,9
2022-04-17,Binh Duong,Di An,17,23,12,11,8
2022-04-17,Binh Duong,Di An,18,27,17,10,8
2022-04-17,Binh Duong,Di An,19,35,11,24,19
2022-04-17,Binh Duong,Di An,20,27,8,19,14
2022-04-17,Binh Duong,Di An,21,7,4,3,2
2022-04-17,Binh Duong,Tan Uyen,7,1,0,1,1
2022-04-17,Binh Duong,Tan Uyen,8,2,0,2,2
2022-04-17,Binh Duong,Tan Uyen,9,3,1,2,1
2022-04-17,Binh Duong,Tan Uyen,10,2,1,1,1
2022-04-17,Binh Duong,Tan Uyen,11,3,1,2,1
2022-04-17,Binh Duong,Tan Uyen,12,2,0,2,1
2022-04-17,Binh Duong,Tan Uyen,13,3,3,0,0
2022-04-17,Binh Duong,Tan Uyen,14,5,3,2,2
2022-04-17,Binh Duong,Tan Uyen,15,1,0,1,1
2022-04-17,Binh Duong,Tan Uyen,16,1,1,0,0
2022-04-17,Binh Duong,Tan Uyen,18,1,0,1,1
2022-04-17,Binh Duong,Tan Uyen,19,4,0,4,3
2022-04-17,Binh Duong,Tan Uyen,20,4,0,4,4
2022-04-17,Binh Duong,Thu Dau Mot Town,0,1,0,1,0
2022-04-17,Binh Duong,Thu Dau Mot Town,5,3,1,2,2
2022-04-17,Binh Duong,Thu Dau Mot Town,6,47,35,12,4
2022-04-17,Binh Duong,Thu Dau Mot Town,7,124,117,7,2
2022-04-17,Binh Duong,Thu Dau Mot Town,8,219,205,14,0
2022-04-17,Binh Duong,Thu Dau Mot Town,9,312,289,23,0
2022-04-17,Binh Duong,Thu Dau Mot Town,10,420,396,24,2
2022-04-17,Binh Duong,Thu Dau Mot Town,11,621,572,49,6
2022-04-17,Binh Duong,Thu Dau Mot Town,12,520,491,29,4
2022-04-17,Binh Duong,Thu Dau Mot Town,13,410,378,32,2
2022-04-17,Binh Duong,Thu Dau Mot Town,14,349,329,20,4
2022-04-17,Binh Duong,Thu Dau Mot Town,15,333,310,23,2
2022-04-17,Binh Duong,Thu Dau Mot Town,16,330,307,23,4
2022-04-17,Binh Duong,Thu Dau Mot Town,17,377,363,14,0
2022-04-17,Binh Duong,Thu Dau Mot Town,18,411,373,38,6
2022-04-17,Binh Duong,Thu Dau Mot Town,19,365,325,40,10
2022-04-17,Binh Duong,Thu Dau Mot Town,20,244,222,22,1
2022-04-17,Binh Duong,Thu Dau Mot Town,21,112,100,12,1
2022-04-17,Binh Duong,Thuan An,2,1,0,1,0
2022-04-17,Binh Duong,Thuan An,6,1,0,1,0
2022-04-17,Binh Duong,Thuan An,7,8,4,4,1
2022-04-17,Binh Duong,Thuan An,8,16,7,9,6
2022-04-17,Binh Duong,Thuan An,9,36,19,17,12
2022-04-17,Binh Duong,Thuan An,10,49,34,15,10
2022-04-17,Binh Duong,Thuan An,11,85,52,33,28
2022-04-17,Binh Duong,Thuan An,12,106,48,58,46
2022-04-17,Binh Duong,Thuan An,13,77,44,33,22
2022-04-17,Binh Duong,Thuan An,14,61,39,22,15
2022-04-17,Binh Duong,Thuan An,15,43,31,12,8
2022-04-17,Binh Duong,Thuan An,16,36,26,10,7
2022-04-17,Binh Duong,Thuan An,17,53,32,21,15
2022-04-17,Binh Duong,Thuan An,18,39,23,16,11
2022-04-17,Binh Duong,Thuan An,19,75,29,46,37
2022-04-17,Binh Duong,Thuan An,20,42,25,17,16
2022-04-17,Binh Duong,Thuan An,21,8,2,6,6
2022-04-17,Can Tho City,Binh Thuy District,7,6,5,1,0
2022-04-17,Can Tho City,Binh Thuy District,8,3,3,0,0
2022-04-17,Can Tho City,Binh Thuy District,9,11,8,3,0
2022-04-17,Can Tho City,Binh Thuy District,10,13,11,2,0
2022-04-17,Can Tho City,Binh Thuy District,11,23,23,0,0
2022-04-17,Can Tho City,Binh Thuy District,12,12,12,0,0
2022-04-17,Can Tho City,Binh Thuy District,13,12,12,0,0
2022-04-17,Can Tho City,Binh Thuy District,14,11,10,1,0
2022-04-17,Can Tho City,Binh Thuy District,15,15,14,1,0
2022-04-17,Can Tho City,Binh Thuy District,16,15,13,2,1
2022-04-17,Can Tho City,Binh Thuy District,17,17,17,0,0
2022-04-17,Can Tho City,Binh Thuy District,18,18,17,1,0
2022-04-17,Can Tho City,Binh Thuy District,19,11,11,0,0
2022-04-17,Can Tho City,Binh Thuy District,20,11,10,1,0
2022-04-17,Can Tho City,Binh Thuy District,21,1,0,1,0
2022-04-17,Can Tho City,Cai Rang District,6,1,1,0,0
2022-04-17,Can Tho City,Cai Rang District,7,1,1,0,0
2022-04-17,Can Tho City,Cai Rang District,9,13,11,2,1
2022-04-17,Can Tho City,Cai Rang District,10,13,13,0,0
2022-04-17,Can Tho City,Cai Rang District,11,24,20,4,0
2022-04-17,Can Tho City,Cai Rang District,12,17,17,0,0
2022-04-17,Can Tho City,Cai Rang District,13,20,16,4,0
2022-04-17,Can Tho City,Cai Rang District,14,9,9,0,0
2022-04-17,Can Tho City,Cai Rang District,15,10,9,1,1
2022-04-17,Can Tho City,Cai Rang District,16,7,5,2,0
2022-04-17,Can Tho City,Cai Rang District,17,7,6,1,0
2022-04-17,Can Tho City,Cai Rang District,18,17,17,0,0
2022-04-17,Can Tho City,Cai Rang District,19,10,8,2,0
2022-04-17,Can Tho City,Cai Rang District,20,7,6,1,0
2022-04-17,Can Tho City,Cai Rang District,21,1,1,0,0
2022-04-17,Can Tho City,Ninh Kieu District,0,1,1,0,0
2022-04-17,Can Tho City,Ninh Kieu District,1,2,2,0,0
2022-04-17,Can Tho City,Ninh Kieu District,2,1,0,1,0
2022-04-17,Can Tho City,Ninh Kieu District,5,1,1,0,0
2022-04-17,Can Tho City,Ninh Kieu District,6,45,39,6,0
2022-04-17,Can Tho City,Ninh Kieu District,7,141,134,7,2
2022-04-17,Can Tho City,Ninh Kieu District,8,263,241,22,0
2022-04-17,Can Tho City,Ninh Kieu District,9,350,323,27,0
2022-04-17,Can Tho City,Ninh Kieu District,10,623,588,35,1
2022-04-17,Can Tho City,Ninh Kieu District,11,811,754,57,4
2022-04-17,Can Tho City,Ninh Kieu District,12,678,631,47,0
2022-04-17,Can Tho City,Ninh Kieu District,13,497,474,23,0
2022-04-17,Can Tho City,Ninh Kieu District,14,445,425,20,0
2022-04-17,Can Tho City,Ninh Kieu District,15,405,383,22,1
2022-04-17,Can Tho City,Ninh Kieu District,16,425,400,25,1
2022-04-17,Can Tho City,Ninh Kieu District,17,544,525,19,0
2022-04-17,Can Tho City,Ninh Kieu District,18,634,602,32,0
2022-04-17,Can Tho City,Ninh Kieu District,19,481,458,23,0
2022-04-17,Can Tho City,Ninh Kieu District,20,333,305,28,0
2022-04-17,Can Tho City,Ninh Kieu District,21,163,144,19,1
2022-04-17,Can Tho City,Ninh Kieu District,22,2,1,1,0
2022-04-17,Can Tho City,Ninh Kieu District,23,4,4,0,0
2022-04-17,Dong Nai,Bien Hoa City,0,3,3,0,0
2022-04-17,Dong Nai,Bien Hoa City,1,1,1,0,0
2022-04-17,Dong Nai,Bien Hoa City,3,1,0,1,1
2022-04-17,Dong Nai,Bien Hoa City,4,2,2,0,0
2022-04-17,Dong Nai,Bien Hoa City,5,2,2,0,0
2022-04-17,Dong Nai,Bien Hoa City,6,45,16,29,24
2022-04-17,Dong Nai,Bien Hoa City,7,171,115,56,35
2022-04-17,Dong Nai,Bien Hoa City,8,337,229,108,59
2022-04-17,Dong Nai,Bien Hoa City,9,597,427,170,94
2022-04-17,Dong Nai,Bien Hoa City,10,873,635,238,170
2022-04-17,Dong Nai,Bien Hoa City,11,1394,970,424,283
2022-04-17,Dong Nai,Bien Hoa City,12,1196,903,293,187
2022-04-17,Dong Nai,Bien Hoa City,13,894,768,126,61
2022-04-17,Dong Nai,Bien Hoa City,14,726,592,134,73
2022-04-17,Dong Nai,Bien Hoa City,15,674,506,168,109
2022-04-17,Dong Nai,Bien Hoa City,16,642,477,165,104
2022-04-17,Dong Nai,Bien Hoa City,17,706,584,122,63
2022-04-17,Dong Nai,Bien Hoa City,18,843,642,201,122
2022-04-17,Dong Nai,Bien Hoa City,19,776,570,206,135
2022-04-17,Dong Nai,Bien Hoa City,20,589,400,189,100
2022-04-17,Dong Nai,Bien Hoa City,21,215,137,78,33
2022-04-17,Dong Nai,Bien Hoa City,22,6,2,4,0
2022-04-17,Dong Nai,Bien Hoa City,23,1,0,1,1
2022-04-17,Dong Nai,Long Thanh,10,6,0,6,5
2022-04-17,Dong Nai,Long Thanh,11,2,0,2,2
2022-04-17,Dong Nai,Long Thanh,12,1,0,1,1
2022-04-17,Dong Nai,Long Thanh,13,2,0,2,2
2022-04-17,Dong Nai,Long Thanh,14,2,0,2,1
2022-04-17,Dong Nai,Long Thanh,15,1,0,1,1
2022-04-17,Dong Nai,Long Thanh,16,3,0,3,3
2022-04-17,Dong Nai,Nhon trach,13,2,0,2,1
2022-04-17,Dong Nai,Nhon trach,14,1,0,1,1
2022-04-17,Dong Nai,Nhon trach,16,1,0,1,1
2022-04-17,Dong Nai,Nhon trach,19,2,0,2,2
2022-04-17,Dong Nai,Thong Nhat,7,1,1,0,0
2022-04-17,Dong Nai,Thong Nhat,8,4,4,0,0
2022-04-17,Dong Nai,Thong Nhat,9,3,2,1,1
2022-04-17,Dong Nai,Thong Nhat,10,2,1,1,1
2022-04-17,Dong Nai,Thong Nhat,12,2,2,0,0
2022-04-17,Dong Nai,Thong Nhat,14,5,5,0,0
2022-04-17,Dong Nai,Thong Nhat,17,2,2,0,0
2022-04-17,Dong Nai,Thong Nhat,18,3,3,0,0
2022-04-17,Dong Nai,Thong Nhat,19,1,1,0,0
2022-04-17,Dong Nai,Thong Nhat,21,1,1,0,0
2022-04-17,Dong Nai,Trang Bom,9,1,0,1,1
2022-04-17,Dong Nai,Trang Bom,10,2,0,2,2
2022-04-17,Dong Nai,Trang Bom,11,2,0,2,2
2022-04-17,Dong Nai,Trang Bom,13,2,0,2,1
2022-04-17,Dong Nai,Trang Bom,14,3,0,3,3
2022-04-17,Dong Nai,Trang Bom,15,1,0,1,1
2022-04-17,Dong Nai,Trang Bom,16,2,1,1,1
2022-04-17,Dong Nai,Trang Bom,20,1,0,1,1
2022-04-17,Hai Phong City,An Duong,8,4,2,2,1
2022-04-17,Hai Phong City,An Duong,9,5,1,4,4
2022-04-17,Hai Phong City,An Duong,10,6,3,3,2
2022-04-17,Hai Phong City,An Duong,11,6,1,5,4
2022-04-17,Hai Phong City,An Duong,12,5,1,4,3
2022-04-17,Hai Phong City,An Duong,13,3,2,1,1
2022-04-17,Hai Phong City,An Duong,14,4,1,3,3
2022-04-17,Hai Phong City,An Duong,15,2,2,0,0
2022-04-17,Hai Phong City,An Duong,16,4,1,3,3
2022-04-17,Hai Phong City,An Duong,17,3,2,1,0
2022-04-17,Hai Phong City,An Duong,18,2,1,1,1
2022-04-17,Hai Phong City,Do Son District,18,1,0,1,0
2022-04-17,Hai Phong City,Do Son District,19,1,0,1,1
2022-04-17,Hai Phong City,Duong Kinh District,19,1,0,1,1
2022-04-17,Hai Phong City,Hai An District,7,8,3,5,2
2022-04-17,Hai Phong City,Hai An District,8,16,7,9,6
2022-04-17,Hai Phong City,Hai An District,9,26,18,8,1
2022-04-17,Hai Phong City,Hai An District,10,20,17,3,1
2022-04-17,Hai Phong City,Hai An District,11,42,36,6,2
2022-04-17,Hai Phong City,Hai An District,12,32,27,5,1
2022-04-17,Hai Phong City,Hai An District,13,14,12,2,0
2022-04-17,Hai Phong City,Hai An District,14,15,10,5,0
2022-04-17,Hai Phong City,Hai An District,15,13,9,4,0
2022-04-17,Hai Phong City,Hai An District,16,18,16,2,1
2022-04-17,Hai Phong City,Hai An District,17,20,16,4,1
2022-04-17,Hai Phong City,Hai An District,18,32,27,5,1
2022-04-17,Hai Phong City,Hai An District,19,16,13,3,0
2022-04-17,Hai Phong City,Hai An District,20,20,14,6,4
2022-04-17,Hai Phong City,Hai An District,21,10,7,3,1
2022-04-17,Hai Phong City,Hong Bang District,7,11,7,4,3
2022-04-17,Hai Phong City,Hong Bang District,8,21,17,4,3
2022-04-17,Hai Phong City,Hong Bang District,9,38,29,9,5
2022-04-17,Hai Phong City,Hong Bang District,10,79,53,26,18
2022-04-17,Hai Phong City,Hong Bang District,11,123,82,41,28
2022-04-17,Hai Phong City,Hong Bang District,12,68,54,14,2
2022-04-17,Hai Phong City,Hong Bang District,13,41,36,5,1
2022-04-17,Hai Phong City,Hong Bang District,14,35,31,4,1
2022-04-17,Hai Phong City,Hong Bang District,15,41,36,5,0
2022-04-17,Hai Phong City,Hong Bang District,16,43,38,5,1
2022-04-17,Hai Phong City,Hong Bang District,17,44,37,7,6
2022-04-17,Hai Phong City,Hong Bang District,18,61,49,12,5
2022-04-17,Hai Phong City,Hong Bang District,19,53,46,7,3
2022-04-17,Hai Phong City,Hong Bang District,20,22,18,4,1
2022-04-17,Hai Phong City,Hong Bang District,21,9,9,0,0
2022-04-17,Hai Phong City,Kien An District,7,4,0,4,4
2022-04-17,Hai Phong City,Kien An District,8,15,5,10,8
2022-04-17,Hai Phong City,Kien An District,9,16,8,8,8
2022-04-17,Hai Phong City,Kien An District,10,26,13,13,11
2022-04-17,Hai Phong City,Kien An District,11,18,14,4,1
2022-04-17,Hai Phong City,Kien An District,12,11,10,1,1
2022-04-17,Hai Phong City,Kien An District,13,7,5,2,1
2022-04-17,Hai Phong City,Kien An District,14,15,4,11,9
2022-04-17,Hai Phong City,Kien An District,15,6,5,1,0
2022-04-17,Hai Phong City,Kien An District,16,9,8,1,1
2022-04-17,Hai Phong City,Kien An District,17,11,7,4,2
2022-04-17,Hai Phong City,Kien An District,18,10,7,3,1
2022-04-17,Hai Phong City,Kien An District,19,14,9,5,3
2022-04-17,Hai Phong City,Kien An District,20,16,11,5,5
2022-04-17,Hai Phong City,Le Chan District,0,1,1,0,0
2022-04-17,Hai Phong City,Le Chan District,1,2,0,2,1
2022-04-17,Hai Phong City,Le Chan District,6,2,2,0,0
2022-04-17,Hai Phong City,Le Chan District,7,28,19,9,7
2022-04-17,Hai Phong City,Le Chan District,8,72,55,17,12
2022-04-17,Hai Phong City,Le Chan District,9,123,85,38,21
2022-04-17,Hai Phong City,Le Chan District,10,261,181,80,50
2022-04-17,Hai Phong City,Le Chan District,11,408,286,122,71
2022-04-17,Hai Phong City,Le Chan District,12,226,199,27,12
2022-04-17,Hai Phong City,Le Chan District,13,122,110,12,0
2022-04-17,Hai Phong City,Le Chan District,14,136,116,20,0
2022-04-17,Hai Phong City,Le Chan District,15,179,151,28,1
2022-04-17,Hai Phong City,Le Chan District,16,185,162,23,4
2022-04-17,Hai Phong City,Le Chan District,17,207,172,35,18
2022-04-17,Hai Phong City,Le Chan District,18,246,199,47,17
2022-04-17,Hai Phong City,Le Chan District,19,176,148,28,11
2022-04-17,Hai Phong City,Le Chan District,20,127,104,23,4
2022-04-17,Hai Phong City,Le Chan District,21,61,44,17,5
2022-04-17,Hai Phong City,Ngo Quyen District,1,2,1,1,1
2022-04-17,Hai Phong City,Ngo Quyen District,2,1,0,1,0
2022-04-17,Hai Phong City,Ngo Quyen District,3,1,1,0,0
2022-04-17,Hai Phong City,Ngo Quyen District,6,2,0,2,1
2022-04-17,Hai Phong City,Ngo Quyen District,7,26,13,13,8
2022-04-17,Hai Phong City,Ngo Quyen District,8,71,54,17,13
2022-04-17,Hai Phong City,Ngo Quyen District,9,83,70,13,5
2022-04-17,Hai Phong City,Ngo Quyen District,10,167,129,38,20
2022-04-17,Hai Phong City,Ngo Quyen District,11,271,216,55,32
2022-04-17,Hai Phong City,Ngo Quyen District,12,185,170,15,6
2022-04-17,Hai Phong City,Ngo Quyen District,13,110,101,9,0
2022-04-17,Hai Phong City,Ngo Quyen District,14,123,107,16,0
2022-04-17,Hai Phong City,Ngo Quyen District,15,138,124,14,1
2022-04-17,Hai Phong City,Ngo Quyen District,16,168,144,24,4
2022-04-17,Hai Phong City,Ngo Quyen District,17,161,140,21,4
2022-04-17,Hai Phong City,Ngo Quyen District,18,187,154,33,9
2022-04-17,Hai Phong City,Ngo Quyen District,19,174,151,23,9
2022-04-17,Hai Phong City,Ngo Quyen District,20,129,111,18,5
2022-04-17,Hai Phong City,Ngo Quyen District,21,41,35,6,1
2022-04-17,Hai Phong City,Thuy Nguyen,12,1,0,1,1
2022-04-17,Hai Phong City,Thuy Nguyen,14,1,0,1,1
2022-04-17,Hai Phong City,Thuy Nguyen,15,1,1,0,0
2022-04-17,Hai Phong City,Thuy Nguyen,16,1,0,1,0
2022-04-17,Hai Phong City,Thuy Nguyen,18,2,1,1,1
2022-04-17,Hue City,Hue City,0,6,5,1,0
2022-04-17,Hue City,Hue City,1,3,2,1,0
2022-04-17,Hue City,Hue City,6,62,59,3,0
2022-04-17,Hue City,Hue City,7,205,194,11,0
2022-04-17,Hue City,Hue City,8,308,290,18,2
2022-04-17,Hue City,Hue City,9,306,279,27,0
2022-04-17,Hue City,Hue City,10,474,440,34,0
2022-04-17,Hue City,Hue City,11,873,795,78,9
2022-04-17,Hue City,Hue City,12,673,608,65,2
2022-04-17,Hue City,Hue City,13,358,333,25,1
2022-04-17,Hue City,Hue City,14,342,311,31,0
2022-04-17,Hue City,Hue City,15,383,361,22,2
2022-04-17,Hue City,Hue City,16,371,346,25,0
2022-04-17,Hue City,Hue City,17,498,461,37,2
2022-04-17,Hue City,Hue City,18,658,609,49,5
2022-04-17,Hue City,Hue City,19,563,512,51,7
2022-04-17,Hue City,Hue City,20,392,344,48,3
2022-04-17,Hue City,Hue City,21,233,194,39,10
2022-04-17,Hue City,Huong Thuy,9,3,1,2,0
2022-04-17,Hue City,Huong Thuy,12,1,1,0,0
2022-04-17,Hue City,Huong Thuy,17,1,0,1,0
2022-04-17,Hue City,Huong Thuy,18,1,1,0,0
2022-04-17,Hue City,Huong Thuy,19,2,0,2,2
2022-04-17,Hue City,Huong Tra,12,2,2,0,0
2022-04-17,Hue City,Huong Tra,16,1,1,0,0
2022-04-17,Hue City,Huong Tra,19,1,1,0,0
2022-04-17,Hue City,Phu Vang,6,1,1,0,0
2022-04-17,Hue City,Phu Vang,7,9,7,2,1
2022-04-17,Hue City,Phu Vang,8,1,1,0,0
2022-04-17,Hue City,Phu Vang,9,2,0,2,1
2022-04-17,Hue City,Phu Vang,11,5,3,2,0
2022-04-17,Hue City,Phu Vang,12,3,2,1,0
2022-04-17,Hue City,Phu Vang,13,1,1,0,0
2022-04-17,Hue City,Phu Vang,14,1,1,0,0
2022-04-17,Hue City,Phu Vang,15,2,1,1,1
2022-04-17,Hue City,Phu Vang,17,3,1,2,0
2022-04-17,Hue City,Phu Vang,18,3,2,1,0
2022-04-17,Hue City,Phu Vang,19,4,3,1,0
2022-04-17,Hue City,Phu Vang,21,2,1,1,0
2022-04-17,Vung Tau,Ba Ria City,8,5,0,5,5
2022-04-17,Vung Tau,Ba Ria City,9,14,1,13,11
2022-04-17,Vung Tau,Ba Ria City,10,6,0,6,6
2022-04-17,Vung Tau,Ba Ria City,11,13,0,13,13
2022-04-17,Vung Tau,Ba Ria City,12,13,0,13,12
2022-04-17,Vung Tau,Ba Ria City,13,17,0,17,14
2022-04-17,Vung Tau,Ba Ria City,14,17,0,17,15
2022-04-17,Vung Tau,Ba Ria City,15,8,0,8,8
2022-04-17,Vung Tau,Ba Ria City,16,16,0,16,16
2022-04-17,Vung Tau,Ba Ria City,17,13,0,13,13
2022-04-17,Vung Tau,Ba Ria City,18,4,0,4,4
2022-04-17,Vung Tau,Ba Ria City,19,5,0,5,4
2022-04-17,Vung Tau,Ba Ria City,20,4,0,4,4
2022-04-17,Vung Tau,Ba Ria City,21,2,0,2,0
2022-04-17,Vung Tau,Tan Thanh,12,2,0,2,2
2022-04-17,Vung Tau,Vung Tau City,0,1,1,0,0
2022-04-17,Vung Tau,Vung Tau City,1,1,0,1,0
2022-04-17,Vung Tau,Vung Tau City,2,1,1,0,0
2022-04-17,Vung Tau,Vung Tau City,5,2,2,0,0
2022-04-17,Vung Tau,Vung Tau City,6,51,35,16,13
2022-04-17,Vung Tau,Vung Tau City,7,116,100,16,3
2022-04-17,Vung Tau,Vung Tau City,8,241,208,33,10
2022-04-17,Vung Tau,Vung Tau City,9,263,231,32,14
2022-04-17,Vung Tau,Vung Tau City,10,321,283,38,17
2022-04-17,Vung Tau,Vung Tau City,11,423,378,45,8
2022-04-17,Vung Tau,Vung Tau City,12,343,323,20,3
2022-04-17,Vung Tau,Vung Tau City,13,266,245,21,2
2022-04-17,Vung Tau,Vung Tau City,14,243,208,35,9
2022-04-17,Vung Tau,Vung Tau City,15,239,218,21,0
2022-04-17,Vung Tau,Vung Tau City,16,215,195,20,4
2022-04-17,Vung Tau,Vung Tau City,17,276,247,29,7
2022-04-17,Vung Tau,Vung Tau City,18,371,316,55,17
2022-04-17,Vung Tau,Vung Tau City,19,323,273,50,14
2022-04-17,Vung Tau,Vung Tau City,20,184,159,25,4
2022-04-17,Vung Tau,Vung Tau City,21,106,79,27,13
2022-04-17,Vung Tau,Vung Tau City,22,1,1,0,0
2022-04-18,Binh Duong,Ben Cat,12,1,0,1,1
2022-04-18,Binh Duong,Ben Cat,18,1,0,1,1
2022-04-18,Binh Duong,Di An,7,7,2,5,4
2022-04-18,Binh Duong,Di An,8,8,3,5,4
2022-04-18,Binh Duong,Di An,9,19,8,11,8
2022-04-18,Binh Duong,Di An,10,29,11,18,8
2022-04-18,Binh Duong,Di An,11,27,21,6,4
2022-04-18,Binh Duong,Di An,12,32,20,12,6
2022-04-18,Binh Duong,Di An,13,21,14,7,6
2022-04-18,Binh Duong,Di An,14,22,13,9,4
2022-04-18,Binh Duong,Di An,15,28,19,9,4
2022-04-18,Binh Duong,Di An,16,22,13,9,9
2022-04-18,Binh Duong,Di An,17,23,10,13,8
2022-04-18,Binh Duong,Di An,18,23,14,9,4
2022-04-18,Binh Duong,Di An,19,19,16,3,1
2022-04-18,Binh Duong,Di An,20,14,14,0,0
2022-04-18,Binh Duong,Di An,21,10,5,5,3
2022-04-18,Binh Duong,Di An,23,1,0,1,1
2022-04-18,Binh Duong,Tan Uyen,7,3,0,3,3
2022-04-18,Binh Duong,Tan Uyen,9,1,0,1,1
2022-04-18,Binh Duong,Tan Uyen,10,2,1,1,1
2022-04-18,Binh Duong,Tan Uyen,11,3,2,1,0
2022-04-18,Binh Duong,Tan Uyen,13,3,1,2,2
2022-04-18,Binh Duong,Tan Uyen,14,4,0,4,3
2022-04-18,Binh Duong,Tan Uyen,15,2,1,1,1
2022-04-18,Binh Duong,Tan Uyen,16,1,0,1,1
2022-04-18,Binh Duong,Tan Uyen,17,1,1,0,0
2022-04-18,Binh Duong,Tan Uyen,18,4,1,3,3
2022-04-18,Binh Duong,Tan Uyen,19,7,4,3,2
2022-04-18,Binh Duong,Thu Dau Mot Town,5,1,1,0,0
2022-04-18,Binh Duong,Thu Dau Mot Town,6,26,19,7,3
2022-04-18,Binh Duong,Thu Dau Mot Town,7,91,82,9,2
2022-04-18,Binh Duong,Thu Dau Mot Town,8,211,200,11,1
2022-04-18,Binh Duong,Thu Dau Mot Town,9,222,206,16,5
2022-04-18,Binh Duong,Thu Dau Mot Town,10,344,316,28,6
2022-04-18,Binh Duong,Thu Dau Mot Town,11,606,571,35,6
2022-04-18,Binh Duong,Thu Dau Mot Town,12,411,386,25,3
2022-04-18,Binh Duong,Thu Dau Mot Town,13,365,343,22,3
2022-04-18,Binh Duong,Thu Dau Mot Town,14,337,313,24,3
2022-04-18,Binh Duong,Thu Dau Mot Town,15,233,221,12,4
2022-04-18,Binh Duong,Thu Dau Mot Town,16,258,243,15,4
2022-04-18,Binh Duong,Thu Dau Mot Town,17,339,321,18,3
2022-04-18,Binh Duong,Thu Dau Mot Town,18,321,298,23,1
2022-04-18,Binh Duong,Thu Dau Mot Town,19,282,267,15,3
2022-04-18,Binh Duong,Thu Dau Mot Town,20,224,202,22,3
2022-04-18,Binh Duong,Thu Dau Mot Town,21,110,94,16,3
2022-04-18,Binh Duong,Thuan An,6,2,0,2,1
2022-04-18,Binh Duong,Thuan An,7,5,2,3,3
2022-04-18,Binh Duong,Thuan An,8,12,6,6,1
2022-04-18,Binh Duong,Thuan An,9,32,16,16,13
2022-04-18,Binh Duong,Thuan An,10,54,37,17,12
2022-04-18,Binh Duong,Thuan An,11,87,47,40,32
2022-04-18,Binh Duong,Thuan An,12,62,43,19,15
2022-04-18,Binh Duong,Thuan An,13,62,40,22,14
2022-04-18,Binh Duong,Thuan An,14,51,24,27,18
2022-04-18,Binh Duong,Thuan An,15,43,23,20,18
2022-04-18,Binh Duong,Thuan An,16,32,25,7,5
2022-04-18,Binh Duong,Thuan An,17,31,26,5,2
2022-04-18,Binh Duong,Thuan An,18,39,33,6,3
2022-04-18,Binh Duong,Thuan An,19,30,27,3,0
2022-04-18,Binh Duong,Thuan An,20,21,15,6,4
2022-04-18,Binh Duong,Thuan An,21,9,4,5,2
2022-04-18,Can Tho City,Binh Thuy District,0,1,0,1,0
2022-04-18,Can Tho City,Binh Thuy District,9,5,4,1,1
2022-04-18,Can Tho City,Binh Thuy District,10,8,6,2,0
2022-04-18,Can Tho City,Binh Thuy District,11,12,10,2,0
2022-04-18,Can Tho City,Binh Thuy District,12,11,8,3,0
2022-04-18,Can Tho City,Binh Thuy District,13,10,7,3,0
2022-04-18,Can Tho City,Binh Thuy District,14,5,5,0,0
2022-04-18,Can Tho City,Binh Thuy District,15,9,6,3,3
2022-04-18,Can Tho City,Binh Thuy District,16,13,12,1,0
2022-04-18,Can Tho City,Binh Thuy District,17,16,14,2,1
2022-04-18,Can Tho City,Binh Thuy District,18,16,14,2,1
2022-04-18,Can Tho City,Binh Thuy District,19,10,9,1,0
2022-04-18,Can Tho City,Binh Thuy District,20,10,9,1,0
2022-04-18,Can Tho City,Binh Thuy District,21,7,5,2,1
2022-04-18,Can Tho City,Cai Rang District,7,7,4,3,3
2022-04-18,Can Tho City,Cai Rang District,8,1,1,0,0
2022-04-18,Can Tho City,Cai Rang District,9,5,5,0,0
2022-04-18,Can Tho City,Cai Rang District,10,3,3,0,0
2022-04-18,Can Tho City,Cai Rang District,11,15,12,3,0
2022-04-18,Can Tho City,Cai Rang District,12,16,14,2,1
2022-04-18,Can Tho City,Cai Rang District,13,10,8,2,2
2022-04-18,Can Tho City,Cai Rang District,14,12,10,2,1
2022-04-18,Can Tho City,Cai Rang District,15,11,9,2,1
2022-04-18,Can Tho City,Cai Rang District,16,11,11,0,0
2022-04-18,Can Tho City,Cai Rang District,17,18,14,4,0
2022-04-18,Can Tho City,Cai Rang District,18,12,12,0,0
2022-04-18,Can Tho City,Cai Rang District,19,8,6,2,0
2022-04-18,Can Tho City,Cai Rang District,20,7,4,3,1
2022-04-18,Can Tho City,Ninh Kieu District,0,7,4,3,0
2022-04-18,Can Tho City,Ninh Kieu District,2,2,2,0,0
2022-04-18,Can Tho City,Ninh Kieu District,3,1,1,0,0
2022-04-18,Can Tho City,Ninh Kieu District,4,3,2,1,1
2022-04-18,Can Tho City,Ninh Kieu District,5,1,1,0,0
2022-04-18,Can Tho City,Ninh Kieu District,6,51,42,9,4
2022-04-18,Can Tho City,Ninh Kieu District,7,126,120,6,0
2022-04-18,Can Tho City,Ninh Kieu District,8,215,205,10,0
2022-04-18,Can Tho City,Ninh Kieu District,9,247,233,14,0
2022-04-18,Can Tho City,Ninh Kieu District,10,541,513,28,0
2022-04-18,Can Tho City,Ninh Kieu District,11,867,832,35,0
2022-04-18,Can Tho City,Ninh Kieu District,12,560,541,19,0
2022-04-18,Can Tho City,Ninh Kieu District,13,472,449,23,0
2022-04-18,Can Tho City,Ninh Kieu District,14,391,375,16,0
2022-04-18,Can Tho City,Ninh Kieu District,15,323,299,24,0
2022-04-18,Can Tho City,Ninh Kieu District,16,369,346,23,0
2022-04-18,Can Tho City,Ninh Kieu District,17,484,468,16,0
2022-04-18,Can Tho City,Ninh Kieu District,18,493,469,24,0
2022-04-18,Can Tho City,Ninh Kieu District,19,392,364,28,0
2022-04-18,Can Tho City,Ninh Kieu District,20,361,335,26,1
2022-04-18,Can Tho City,Ninh Kieu District,21,180,157,23,0
2022-04-18,Can Tho City,Ninh Kieu District,22,3,1,2,0
2022-04-18,Can Tho City,Ninh Kieu District,23,1,1,0,0
2022-04-18,Can Tho City,Phong Dien,9,1,0,1,1
2022-04-18,Dong Nai,Bien Hoa City,0,4,2,2,1
2022-04-18,Dong Nai,Bien Hoa City,1,5,3,2,1
2022-04-18,Dong Nai,Bien Hoa City,2,1,1,0,0
2022-04-18,Dong Nai,Bien Hoa City,3,1,1,0,0
2022-04-18,Dong Nai,Bien Hoa City,4,4,2,2,1
2022-04-18,Dong Nai,Bien Hoa City,5,1,1,0,0
2022-04-18,Dong Nai,Bien Hoa City,6,24,14,10,9
2022-04-18,Dong Nai,Bien Hoa City,7,134,103,31,15
2022-04-18,Dong Nai,Bien Hoa City,8,297,248,49,26
2022-04-18,Dong Nai,Bien Hoa City,9,385,345,40,5
2022-04-18,Dong Nai,Bien Hoa City,10,664,591,73,18
2022-04-18,Dong Nai,Bien Hoa City,11,999,901,98,26
2022-04-18,Dong Nai,Bien Hoa City,12,736,673,63,18
2022-04-18,Dong Nai,Bien Hoa City,13,710,643,67,15
2022-04-18,Dong Nai,Bien Hoa City,14,613,553,60,25
2022-04-18,Dong Nai,Bien Hoa City,15,502,443,59,10
2022-04-18,Dong Nai,Bien Hoa City,16,416,375,41,7
2022-04-18,Dong Nai,Bien Hoa City,17,588,516,72,24
2022-04-18,Dong Nai,Bien Hoa City,18,714,592,122,44
2022-04-18,Dong Nai,Bien Hoa City,19,646,574,72,25
2022-04-18,Dong Nai,Bien Hoa City,20,438,371,67,19
2022-04-18,Dong Nai,Bien Hoa City,21,206,134,72,37
2022-04-18,Dong Nai,Bien Hoa City,23,2,2,0,0
2022-04-18,Dong Nai,Long Khanh,12,1,0,1,1
2022-04-18,Dong Nai,Long Thanh,9,1,0,1,1
2022-04-18,Dong Nai,Long Thanh,10,1,0,1,1
2022-04-18,Dong Nai,Long Thanh,11,1,0,1,1
2022-04-18,Dong Nai,Long Thanh,13,1,0,1,1
2022-04-18,Dong Nai,Long Thanh,14,1,0,1,1
2022-04-18,Dong Nai,Nhon trach,8,1,0,1,1
2022-04-18,Dong Nai,Nhon trach,19,1,0,1,0
2022-04-18,Dong Nai,Thong Nhat,7,1,1,0,0
2022-04-18,Dong Nai,Thong Nhat,8,3,3,0,0
2022-04-18,Dong Nai,Thong Nhat,10,2,2,0,0
2022-04-18,Dong Nai,Thong Nhat,11,1,1,0,0
2022-04-18,Dong Nai,Thong Nhat,13,2,2,0,0
2022-04-18,Dong Nai,Thong Nhat,14,3,3,0,0
2022-04-18,Dong Nai,Thong Nhat,15,1,1,0,0
2022-04-18,Dong Nai,Thong Nhat,18,1,1,0,0
2022-04-18,Dong Nai,Trang Bom,10,1,0,1,1
2022-04-18,Dong Nai,Trang Bom,15,3,0,3,3
2022-04-18,Dong Nai,Trang Bom,21,1,0,1,1
2022-04-18,Hai Phong City,An Duong,7,1,1,0,0
2022-04-18,Hai Phong City,An Duong,8,4,1,3,3
2022-04-18,Hai Phong City,An Duong,10,2,1,1,1
2022-04-18,Hai Phong City,An Duong,11,3,1,2,1
2022-04-18,Hai Phong City,An Duong,12,4,1,3,2
2022-04-18,Hai Phong City,An Duong,13,4,1,3,3
2022-04-18,Hai Phong City,An Duong,14,12,4,8,6
2022-04-18,Hai Phong City,An Duong,15,5,1,4,3
2022-04-18,Hai Phong City,An Duong,16,2,1,1,1
2022-04-18,Hai Phong City,An Duong,17,10,3,7,5
2022-04-18,Hai Phong City,An Duong,18,2,2,0,0
2022-04-18,Hai Phong City,An Duong,19,1,1,0,0
2022-04-18,Hai Phong City,Do Son District,11,1,0,1,1
2022-04-18,Hai Phong City,Hai An District,7,6,2,4,2
2022-04-18,Hai Phong City,Hai An District,8,9,7,2,0
2022-04-18,Hai Phong City,Hai An District,9,13,10,3,0
2022-04-18,Hai Phong City,Hai An District,10,8,7,1,1
2022-04-18,Hai Phong City,Hai An District,11,32,30,2,0
2022-04-18,Hai Phong City,Hai An District,12,23,19,4,0
2022-04-18,Hai Phong City,Hai An District,13,9,7,2,0
2022-04-18,Hai Phong City,Hai An District,14,13,8,5,2
2022-04-18,Hai Phong City,Hai An District,15,15,14,1,0
2022-04-18,Hai Phong City,Hai An District,16,14,14,0,0
2022-04-18,Hai Phong City,Hai An District,17,23,17,6,0
2022-04-18,Hai Phong City,Hai An District,18,22,20,2,0
2022-04-18,Hai Phong City,Hai An District,19,19,15,4,0
2022-04-18,Hai Phong City,Hai An District,20,13,9,4,1
2022-04-18,Hai Phong City,Hai An District,21,10,4,6,3
2022-04-18,Hai Phong City,Hong Bang District,0,1,0,1,1
2022-04-18,Hai Phong City,Hong Bang District,7,8,7,1,0
2022-04-18,Hai Phong City,Hong Bang District,8,21,20,1,0
2022-04-18,Hai Phong City,Hong Bang District,9,18,17,1,1
2022-04-18,Hai Phong City,Hong Bang District,10,43,37,6,2
2022-04-18,Hai Phong City,Hong Bang District,11,104,87,17,4
2022-04-18,Hai Phong City,Hong Bang District,12,56,51,5,0
2022-04-18,Hai Phong City,Hong Bang District,13,44,42,2,0
2022-04-18,Hai Phong City,Hong Bang District,14,23,21,2,0
2022-04-18,Hai Phong City,Hong Bang District,15,29,29,0,0
2022-04-18,Hai Phong City,Hong Bang District,16,31,24,7,2
2022-04-18,Hai Phong City,Hong Bang District,17,43,35,8,0
2022-04-18,Hai Phong City,Hong Bang District,18,47,40,7,1
2022-04-18,Hai Phong City,Hong Bang District,19,53,43,10,1
2022-04-18,Hai Phong City,Hong Bang District,20,31,28,3,1
2022-04-18,Hai Phong City,Hong Bang District,21,11,5,6,4
2022-04-18,Hai Phong City,Kien An District,1,1,0,1,1
2022-04-18,Hai Phong City,Kien An District,7,1,0,1,1
2022-04-18,Hai Phong City,Kien An District,8,3,1,2,1
2022-04-18,Hai Phong City,Kien An District,9,4,2,2,0
2022-04-18,Hai Phong City,Kien An District,10,4,3,1,1
2022-04-18,Hai Phong City,Kien An District,11,20,12,8,2
2022-04-18,Hai Phong City,Kien An District,12,11,4,7,4
2022-04-18,Hai Phong City,Kien An District,13,10,7,3,2
2022-04-18,Hai Phong City,Kien An District,14,9,6,3,2
2022-04-18,Hai Phong City,Kien An District,15,13,5,8,1
2022-04-18,Hai Phong City,Kien An District,16,4,4,0,0
2022-04-18,Hai Phong City,Kien An District,17,3,3,0,0
2022-04-18,Hai Phong City,Kien An District,18,15,13,2,1
2022-04-18,Hai Phong City,Kien An District,19,11,9,2,2
2022-04-18,Hai Phong City,Kien An District,20,9,5,4,4
2022-04-18,Hai Phong City,Kien An District,21,3,0,3,1
2022-04-18,Hai Phong City,Le Chan District,0,2,2,0,0
2022-04-18,Hai Phong City,Le Chan District,6,1,1,0,0
2022-04-18,Hai Phong City,Le Chan District,7,21,16,5,3
2022-04-18,Hai Phong City,Le Chan District,8,44,42,2,0
2022-04-18,Hai Phong City,Le Chan District,9,41,39,2,0
2022-04-18,Hai Phong City,Le Chan District,10,118,107,11,2
2022-04-18,Hai Phong City,Le Chan District,11,280,245,35,5
2022-04-18,Hai Phong City,Le Chan District,12,176,162,14,0
2022-04-18,Hai Phong City,Le Chan District,13,99,93,6,1
2022-04-18,Hai Phong City,Le Chan District,14,110,101,9,1
2022-04-18,Hai Phong City,Le Chan District,15,119,107,12,0
2022-04-18,Hai Phong City,Le Chan District,16,128,120,8,1
2022-04-18,Hai Phong City,Le Chan District,17,144,122,22,3
2022-04-18,Hai Phong City,Le Chan District,18,183,166,17,3
2022-04-18,Hai Phong City,Le Chan District,19,175,162,13,2
2022-04-18,Hai Phong City,Le Chan District,20,134,114,20,4
2022-04-18,Hai Phong City,Le Chan District,21,81,61,20,7
2022-04-18,Hai Phong City,Le Chan District,22,1,0,1,0
2022-04-18,Hai Phong City,Ngo Quyen District,0,1,0,1,0
2022-04-18,Hai Phong City,Ngo Quyen District,1,4,1,3,1
2022-04-18,Hai Phong City,Ngo Quyen District,5,1,1,0,0
2022-04-18,Hai Phong City,Ngo Quyen District,6,3,1,2,0
2022-04-18,Hai Phong City,Ngo Quyen District,7,25,15,10,8
2022-04-18,Hai Phong City,Ngo Quyen District,8,49,43,6,4
2022-04-18,Hai Phong City,Ngo Quyen District,9,45,38,7,1
2022-04-18,Hai Phong City,Ngo Quyen District,10,98,89,9,0
2022-04-18,Hai Phong City,Ngo Quyen District,11,205,186,19,0
2022-04-18,Hai Phong City,Ngo Quyen District,12,148,136,12,2
2022-04-18,Hai Phong City,Ngo Quyen District,13,82,78,4,0
2022-04-18,Hai Phong City,Ngo Quyen District,14,99,90,9,0
2022-04-18,Hai Phong City,Ngo Quyen District,15,124,109,15,0
2022-04-18,Hai Phong City,Ngo Quyen District,16,76,70,6,0
2022-04-18,Hai Phong City,Ngo Quyen District,17,131,121,10,0
2022-04-18,Hai Phong City,Ngo Quyen District,18,160,143,17,2
2022-04-18,Hai Phong City,Ngo Quyen District,19,123,118,5,0
2022-04-18,Hai Phong City,Ngo Quyen District,20,99,88,11,0
2022-04-18,Hai Phong City,Ngo Quyen District,21,64,49,15,4
2022-04-18,Hai Phong City,Thuy Nguyen,10,1,0,1,1
2022-04-18,Hai Phong City,Thuy Nguyen,11,1,0,1,1
2022-04-18,Hai Phong City,Thuy Nguyen,18,1,0,1,1
2022-04-18,Hue City,Hue City,0,1,1,0,0
2022-04-18,Hue City,Hue City,3,1,0,1,0
2022-04-18,Hue City,Hue City,4,2,2,0,0
2022-04-18,Hue City,Hue City,6,65,58,7,0
2022-04-18,Hue City,Hue City,7,169,160,9,0
2022-04-18,Hue City,Hue City,8,275,262,13,1
2022-04-18,Hue City,Hue City,9,237,222,15,0
2022-04-18,Hue City,Hue City,10,340,320,20,1
2022-04-18,Hue City,Hue City,11,814,771,43,2
2022-04-18,Hue City,Hue City,12,446,424,22,0
2022-04-18,Hue City,Hue City,13,297,283,14,0
2022-04-18,Hue City,Hue City,14,331,308,23,3
2022-04-18,Hue City,Hue City,15,311,287,24,3
2022-04-18,Hue City,Hue City,16,321,299,22,2
2022-04-18,Hue City,Hue City,17,462,427,35,1
2022-04-18,Hue City,Hue City,18,569,531,38,0
2022-04-18,Hue City,Hue City,19,528,486,42,0
2022-04-18,Hue City,Hue City,20,389,358,31,0
2022-04-18,Hue City,Hue City,21,219,185,34,3
2022-04-18,Hue City,Hue City,22,7,1,6,1
2022-04-18,Hue City,Hue City,23,1,1,0,0
2022-04-18,Hue City,Huong Thuy,9,1,1,0,0
2022-04-18,Hue City,Huong Thuy,10,1,0,1,1
2022-04-18,Hue City,Huong Thuy,12,2,1,1,1
2022-04-18,Hue City,Huong Thuy,13,1,0,1,0
2022-04-18,Hue City,Huong Thuy,14,1,1,0,0
2022-04-18,Hue City,Huong Thuy,18,2,2,0,0
2022-04-18,Hue City,Huong Thuy,21,1,1,0,0
2022-04-18,Hue City,Huong Tra,8,1,1,0,0
2022-04-18,Hue City,Huong Tra,9,1,1,0,0
2022-04-18,Hue City,Huong Tra,13,1,1,0,0
2022-04-18,Hue City,Huong Tra,20,1,1,0,0
2022-04-18,Hue City,Phu Vang,6,1,0,1,1
2022-04-18,Hue City,Phu Vang,9,2,2,0,0
2022-04-18,Hue City,Phu Vang,11,3,2,1,0
2022-04-18,Hue City,Phu Vang,12,3,3,0,0
2022-04-18,Hue City,Phu Vang,15,2,2,0,0
2022-04-18,Hue City,Phu Vang,16,2,2,0,0
2022-04-18,Hue City,Phu Vang,17,1,1,0,0
2022-04-18,Hue City,Phu Vang,18,4,3,1,0
2022-04-18,Hue City,Phu Vang,19,2,1,1,0
2022-04-18,Hue City,Phu Vang,21,1,1,0,0
2022-04-18,Vung Tau,Ba Ria City,7,1,0,1,1
2022-04-18,Vung Tau,Ba Ria City,8,1,0,1,0
2022-04-18,Vung Tau,Ba Ria City,9,4,2,2,1
2022-04-18,Vung Tau,Ba Ria City,10,8,2,6,6
2022-04-18,Vung Tau,Ba Ria City,11,6,3,3,1
2022-04-18,Vung Tau,Ba Ria City,12,8,5,3,2
2022-04-18,Vung Tau,Ba Ria City,13,7,6,1,0
2022-04-18,Vung Tau,Ba Ria City,14,4,2,2,0
2022-04-18,Vung Tau,Ba Ria City,15,5,2,3,3
2022-04-18,Vung Tau,Ba Ria City,16,7,3,4,3
2022-04-18,Vung Tau,Ba Ria City,17,2,0,2,2
2022-04-18,Vung Tau,Ba Ria City,18,12,3,9,4
2022-04-18,Vung Tau,Ba Ria City,19,6,2,4,3
2022-04-18,Vung Tau,Ba Ria City,20,1,0,1,1
2022-04-18,Vung Tau,Vung Tau City,1,1,0,1,0
2022-04-18,Vung Tau,Vung Tau City,6,28,24,4,1
2022-04-18,Vung Tau,Vung Tau City,7,88,83,5,1
2022-04-18,Vung Tau,Vung Tau City,8,155,144,11,0
2022-04-18,Vung Tau,Vung Tau City,9,137,124,13,2
2022-04-18,Vung Tau,Vung Tau City,10,196,185,11,2
2022-04-18,Vung Tau,Vung Tau City,11,359,333,26,1
2022-04-18,Vung Tau,Vung Tau City,12,249,236,13,0
2022-04-18,Vung Tau,Vung Tau City,13,220,203,17,1
2022-04-18,Vung Tau,Vung Tau City,14,189,179,10,3
2022-04-18,Vung Tau,Vung Tau City,15,191,180,11,2
2022-04-18,Vung Tau,Vung Tau City,16,173,153,20,1
2022-04-18,Vung Tau,Vung Tau City,17,264,234,30,3
2022-04-18,Vung Tau,Vung Tau City,18,276,253,23,0
2022-04-18,Vung Tau,Vung Tau City,19,238,224,14,0
2022-04-18,Vung Tau,Vung Tau City,20,189,167,22,4
2022-04-18,Vung Tau,Vung Tau City,21,85,60,25,7
2022-04-18,Vung Tau,Vung Tau City,23,1,1,0,0
2022-04-19,Binh Duong,Ben Cat,11,1,1,0,0
2022-04-19,Binh Duong,Ben Cat,12,2,0,2,2
2022-04-19,Binh Duong,Ben Cat,15,2,0,2,1
2022-04-19,Binh Duong,Ben Cat,18,1,0,1,1
2022-04-19,Binh Duong,Ben Cat,20,1,1,0,0
2022-04-19,Binh Duong,Di An,2,1,0,1,1
2022-04-19,Binh Duong,Di An,7,5,1,4,3
2022-04-19,Binh Duong,Di An,8,11,3,8,8
2022-04-19,Binh Duong,Di An,9,10,7,3,3
2022-04-19,Binh Duong,Di An,10,18,11,7,6
2022-04-19,Binh Duong,Di An,11,28,19,9,9
2022-04-19,Binh Duong,Di An,12,19,13,6,5
2022-04-19,Binh Duong,Di An,13,28,14,14,12
2022-04-19,Binh Duong,Di An,14,34,14,20,10
2022-04-19,Binh Duong,Di An,15,16,7,9,8
2022-04-19,Binh Duong,Di An,16,21,9,12,11
2022-04-19,Binh Duong,Di An,17,32,19,13,8
2022-04-19,Binh Duong,Di An,18,29,15,14,10
2022-04-19,Binh Duong,Di An,19,29,14,15,9
2022-04-19,Binh Duong,Di An,20,20,10,10,6
2022-04-19,Binh Duong,Di An,21,17,3,14,12
2022-04-19,Binh Duong,Tan Uyen,8,1,0,1,1
2022-04-19,Binh Duong,Tan Uyen,10,4,2,2,2
2022-04-19,Binh Duong,Tan Uyen,11,5,1,4,4
2022-04-19,Binh Duong,Tan Uyen,12,2,2,0,0
2022-04-19,Binh Duong,Tan Uyen,15,2,2,0,0
2022-04-19,Binh Duong,Tan Uyen,17,2,0,2,2
2022-04-19,Binh Duong,Tan Uyen,19,2,1,1,1
2022-04-19,Binh Duong,Tan Uyen,20,4,3,1,1
2022-04-19,Binh Duong,Thu Dau Mot Town,0,1,0,1,0
2022-04-19,Binh Duong,Thu Dau Mot Town,5,1,1,0,0
2022-04-19,Binh Duong,Thu Dau Mot Town,6,30,28,2,1
2022-04-19,Binh Duong,Thu Dau Mot Town,7,115,108,7,1
2022-04-19,Binh Duong,Thu Dau Mot Town,8,211,194,17,1
2022-04-19,Binh Duong,Thu Dau Mot Town,9,237,221,16,0
2022-04-19,Binh Duong,Thu Dau Mot Town,10,371,346,25,2
2022-04-19,Binh Duong,Thu Dau Mot Town,11,635,596,39,4
2022-04-19,Binh Duong,Thu Dau Mot Town,12,435,414,21,2
2022-04-19,Binh Duong,Thu Dau Mot Town,13,420,395,25,7
2022-04-19,Binh Duong,Thu Dau Mot Town,14,344,326,18,3
2022-04-19,Binh Duong,Thu Dau Mot Town,15,226,215,11,1
2022-04-19,Binh Duong,Thu Dau Mot Town,16,245,226,19,2
2022-04-19,Binh Duong,Thu Dau Mot Town,17,340,321,19,2
2022-04-19,Binh Duong,Thu Dau Mot Town,18,356,336,20,2
2022-04-19,Binh Duong,Thu Dau Mot Town,19,317,298,19,3
2022-04-19,Binh Duong,Thu Dau Mot Town,20,231,214,17,3
2022-04-19,Binh Duong,Thu Dau Mot Town,21,121,93,28,6
2022-04-19,Binh Duong,Thuan An,2,1,0,1,0
2022-04-19,Binh Duong,Thuan An,6,1,0,1,0
2022-04-19,Binh Duong,Thuan An,7,6,3,3,2
2022-04-19,Binh Duong,Thuan An,8,24,9,15,12
2022-04-19,Binh Duong,Thuan An,9,29,16,13,10
2022-04-19,Binh Duong,Thuan An,10,64,30,34,17
2022-04-19,Binh Duong,Thuan An,11,74,48,26,15
2022-04-19,Binh Duong,Thuan An,12,71,45,26,20
2022-04-19,Binh Duong,Thuan An,13,63,37,26,18
2022-04-19,Binh Duong,Thuan An,14,46,36,10,7
2022-04-19,Binh Duong,Thuan An,15,36,24,12,5
2022-04-19,Binh Duong,Thuan An,16,23,19,4,2
2022-04-19,Binh Duong,Thuan An,17,22,16,6,4
2022-04-19,Binh Duong,Thuan An,18,35,31,4,4
2022-04-19,Binh Duong,Thuan An,19,31,24,7,2
2022-04-19,Binh Duong,Thuan An,20,34,22,12,7
2022-04-19,Binh Duong,Thuan An,21,18,10,8,6
2022-04-19,Can Tho City,Binh Thuy District,0,1,1,0,0
2022-04-19,Can Tho City,Binh Thuy District,7,1,1,0,0
2022-04-19,Can Tho City,Binh Thuy District,8,3,2,1,0
2022-04-19,Can Tho City,Binh Thuy District,9,5,4,1,1
2022-04-19,Can Tho City,Binh Thuy District,10,10,5,5,3
2022-04-19,Can Tho City,Binh Thuy District,11,17,16,1,0
2022-04-19,Can Tho City,Binh Thuy District,12,14,14,0,0
2022-04-19,Can Tho City,Binh Thuy District,13,9,9,0,0
2022-04-19,Can Tho City,Binh Thuy District,14,11,11,0,0
2022-04-19,Can Tho City,Binh Thuy District,15,13,13,0,0
2022-04-19,Can Tho City,Binh Thuy District,16,7,7,0,0
2022-04-19,Can Tho City,Binh Thuy District,17,16,15,1,0
2022-04-19,Can Tho City,Binh Thuy District,18,21,20,1,0
2022-04-19,Can Tho City,Binh Thuy District,19,12,11,1,0
2022-04-19,Can Tho City,Binh Thuy District,20,10,10,0,0
2022-04-19,Can Tho City,Binh Thuy District,21,10,8,2,0
2022-04-19,Can Tho City,Cai Rang District,7,4,2,2,0
2022-04-19,Can Tho City,Cai Rang District,8,7,4,3,1
2022-04-19,Can Tho City,Cai Rang District,9,5,5,0,0
2022-04-19,Can Tho City,Cai Rang District,10,5,5,0,0
2022-04-19,Can Tho City,Cai Rang District,11,15,13,2,0
2022-04-19,Can Tho City,Cai Rang District,12,13,10,3,0
2022-04-19,Can Tho City,Cai Rang District,13,8,7,1,0
2022-04-19,Can Tho City,Cai Rang District,14,8,8,0,0
2022-04-19,Can Tho City,Cai Rang District,15,6,6,0,0
2022-04-19,Can Tho City,Cai Rang District,16,9,6,3,1
2022-04-19,Can Tho City,Cai Rang District,17,14,12,2,1
2022-04-19,Can Tho City,Cai Rang District,18,16,16,0,0
2022-04-19,Can Tho City,Cai Rang District,19,4,3,1,0
2022-04-19,Can Tho City,Cai Rang District,20,6,6,0,0
2022-04-19,Can Tho City,Cai Rang District,21,3,3,0,0
2022-04-19,Can Tho City,Ninh Kieu District,0,5,5,0,0
2022-04-19,Can Tho City,Ninh Kieu District,1,2,2,0,0
2022-04-19,Can Tho City,Ninh Kieu District,2,8,5,3,0
2022-04-19,Can Tho City,Ninh Kieu District,3,2,1,1,0
2022-04-19,Can Tho City,Ninh Kieu District,4,2,2,0,0
2022-04-19,Can Tho City,Ninh Kieu District,5,4,4,0,0
2022-04-19,Can Tho City,Ninh Kieu District,6,44,40,4,0
2022-04-19,Can Tho City,Ninh Kieu District,7,122,114,8,0
2022-04-19,Can Tho City,Ninh Kieu District,8,192,180,12,2
2022-04-19,Can Tho City,Ninh Kieu District,9,268,252,16,0
2022-04-19,Can Tho City,Ninh Kieu District,10,563,537,26,0
2022-04-19,Can Tho City,Ninh Kieu District,11,918,866,52,0
2022-04-19,Can Tho City,Ninh Kieu District,12,599,578,21,0
2022-04-19,Can Tho City,Ninh Kieu District,13,532,503,29,0
2022-04-19,Can Tho City,Ninh Kieu District,14,428,412,16,0
2022-04-19,Can Tho City,Ninh Kieu District,15,302,293,9,0
2022-04-19,Can Tho City,Ninh Kieu District,16,394,369,25,0
2022-04-19,Can Tho City,Ninh Kieu District,17,638,608,30,0
2022-04-19,Can Tho City,Ninh Kieu District,18,624,599,25,0
2022-04-19,Can Tho City,Ninh Kieu District,19,497,475,22,0
2022-04-19,Can Tho City,Ninh Kieu District,20,380,361,19,0
2022-04-19,Can Tho City,Ninh Kieu District,21,193,174,19,0
2022-04-19,Can Tho City,Ninh Kieu District,22,1,1,0,0
2022-04-19,Dong Nai,Bien Hoa City,0,4,2,2,0
2022-04-19,Dong Nai,Bien Hoa City,1,2,1,1,0
2022-04-19,Dong Nai,Bien Hoa City,2,2,1,1,1
2022-04-19,Dong Nai,Bien Hoa City,4,2,1,1,0
2022-04-19,Dong Nai,Bien Hoa City,5,3,2,1,1
2022-04-19,Dong Nai,Bien Hoa City,6,39,20,19,18
2022-04-19,Dong Nai,Bien Hoa City,7,139,123,16,6
2022-04-19,Dong Nai,Bien Hoa City,8,250,217,33,10
2022-04-19,Dong Nai,Bien Hoa City,9,368,336,32,6
2022-04-19,Dong Nai,Bien Hoa City,10,649,591,58,13
2022-04-19,Dong Nai,Bien Hoa City,11,977,894,83,20
2022-04-19,Dong Nai,Bien Hoa City,12,705,647,58,13
2022-04-19,Dong Nai,Bien Hoa City,13,755,692,63,17
2022-04-19,Dong Nai,Bien Hoa City,14,591,547,44,12
2022-04-19,Dong Nai,Bien Hoa City,15,513,464,49,7
2022-04-19,Dong Nai,Bien Hoa City,16,467,421,46,19
2022-04-19,Dong Nai,Bien Hoa City,17,560,491,69,17
2022-04-19,Dong Nai,Bien Hoa City,18,649,595,54,13
2022-04-19,Dong Nai,Bien Hoa City,19,563,514,49,16
2022-04-19,Dong Nai,Bien Hoa City,20,458,401,57,11
2022-04-19,Dong Nai,Bien Hoa City,21,177,124,53,21
2022-04-19,Dong Nai,Bien Hoa City,22,2,1,1,0
2022-04-19,Dong Nai,Long Khanh,13,2,0,2,2
2022-04-19,Dong Nai,Long Thanh,11,5,0,5,5
2022-04-19,Dong Nai,Long Thanh,12,4,0,4,4
2022-04-19,Dong Nai,Long Thanh,13,1,0,1,1
2022-04-19,Dong Nai,Long Thanh,14,1,0,1,1
2022-04-19,Dong Nai,Long Thanh,16,2,0,2,2
2022-04-19,Dong Nai,Nhon trach,15,1,0,1,1
2022-04-19,Dong Nai,Nhon trach,16,2,0,2,2
2022-04-19,Dong Nai,Nhon trach,17,3,0,3,3
2022-04-19,Dong Nai,Nhon trach,18,3,0,3,2
2022-04-19,Dong Nai,Nhon trach,19,1,0,1,1
2022-04-19,Dong Nai,Thong Nhat,7,1,1,0,0
2022-04-19,Dong Nai,Thong Nhat,10,3,3,0,0
2022-04-19,Dong Nai,Thong Nhat,11,1,1,0,0
2022-04-19,Dong Nai,Thong Nhat,13,3,1,2,0
2022-04-19,Dong Nai,Thong Nhat,14,2,2,0,0
2022-04-19,Dong Nai,Thong Nhat,19,1,1,0,0
2022-04-19,Dong Nai,Trang Bom,11,1,0,1,1
2022-04-19,Dong Nai,Trang Bom,20,1,0,1,1
2022-04-19,Dong Nai,Vinh Cuu,11,1,0,1,1
2022-04-19,Hai Phong City,An Duong,7,1,0,1,1
2022-04-19,Hai Phong City,An Duong,8,3,0,3,2
2022-04-19,Hai Phong City,An Duong,9,1,0,1,1
2022-04-19,Hai Phong City,An Duong,10,6,4,2,1
2022-04-19,Hai Phong City,An Duong,11,6,3,3,3
2022-04-19,Hai Phong City,An Duong,12,7,5,2,1
2022-04-19,Hai Phong City,An Duong,13,2,1,1,0
2022-04-19,Hai Phong City,An Duong,14,1,0,1,1
2022-04-19,Hai Phong City,An Duong,15,6,3,3,2
2022-04-19,Hai Phong City,An Duong,17,1,1,0,0
2022-04-19,Hai Phong City,An Duong,19,2,1,1,0
2022-04-19,Hai Phong City,An Duong,20,1,0,1,1
2022-04-19,Hai Phong City,An Duong,21,1,0,1,1
2022-04-19,Hai Phong City,Hai An District,7,7,3,4,2
2022-04-19,Hai Phong City,Hai An District,8,12,10,2,0
2022-04-19,Hai Phong City,Hai An District,9,8,8,0,0
2022-04-19,Hai Phong City,Hai An District,10,19,16,3,3
2022-04-19,Hai Phong City,Hai An District,11,42,40,2,0
2022-04-19,Hai Phong City,Hai An District,12,24,20,4,0
2022-04-19,Hai Phong City,Hai An District,13,13,12,1,0
2022-04-19,Hai Phong City,Hai An District,14,8,6,2,0
2022-04-19,Hai Phong City,Hai An District,15,8,8,0,0
2022-04-19,Hai Phong City,Hai An District,16,16,9,7,6
2022-04-19,Hai Phong City,Hai An District,17,15,14,1,0
2022-04-19,Hai Phong City,Hai An District,18,27,22,5,0
2022-04-19,Hai Phong City,Hai An District,19,21,18,3,1
2022-04-19,Hai Phong City,Hai An District,20,11,9,2,1
2022-04-19,Hai Phong City,Hai An District,21,10,9,1,0
2022-04-19,Hai Phong City,Hong Bang District,2,1,0,1,0
2022-04-19,Hai Phong City,Hong Bang District,7,17,16,1,0
2022-04-19,Hai Phong City,Hong Bang District,8,27,25,2,1
2022-04-19,Hai Phong City,Hong Bang District,9,24,18,6,0
2022-04-19,Hai Phong City,Hong Bang District,10,40,34,6,0
2022-04-19,Hai Phong City,Hong Bang District,11,92,78,14,5
2022-04-19,Hai Phong City,Hong Bang District,12,50,47,3,2
2022-04-19,Hai Phong City,Hong Bang District,13,49,42,7,2
2022-04-19,Hai Phong City,Hong Bang District,14,53,47,6,1
2022-04-19,Hai Phong City,Hong Bang District,15,32,26,6,4
2022-04-19,Hai Phong City,Hong Bang District,16,30,27,3,1
2022-04-19,Hai Phong City,Hong Bang District,17,41,37,4,0
2022-04-19,Hai Phong City,Hong Bang District,18,55,51,4,0
2022-04-19,Hai Phong City,Hong Bang District,19,59,49,10,4
2022-04-19,Hai Phong City,Hong Bang District,20,34,26,8,3
2022-04-19,Hai Phong City,Hong Bang District,21,12,12,0,0
2022-04-19,Hai Phong City,Kien An District,7,2,0,2,2
2022-04-19,Hai Phong City,Kien An District,8,3,2,1,0
2022-04-19,Hai Phong City,Kien An District,9,4,3,1,1
2022-04-19,Hai Phong City,Kien An District,10,7,6,1,1
2022-04-19,Hai Phong City,Kien An District,11,16,11,5,1
2022-04-19,Hai Phong City,Kien An District,12,8,6,2,1
2022-04-19,Hai Phong City,Kien An District,13,10,7,3,2
2022-04-19,Hai Phong City,Kien An District,14,7,4,3,2
2022-04-19,Hai Phong City,Kien An District,15,12,7,5,4
2022-04-19,Hai Phong City,Kien An District,16,4,3,1,0
2022-04-19,Hai Phong City,Kien An District,17,11,10,1,0
2022-04-19,Hai Phong City,Kien An District,18,8,6,2,2
2022-04-19,Hai Phong City,Kien An District,19,11,7,4,3
2022-04-19,Hai Phong City,Kien An District,20,8,4,4,3
2022-04-19,Hai Phong City,Le Chan District,0,1,0,1,1
2022-04-19,Hai Phong City,Le Chan District,6,2,1,1,0
2022-04-19,Hai Phong City,Le Chan District,7,19,18,1,0
2022-04-19,Hai Phong City,Le Chan District,8,52,49,3,0
2022-04-19,Hai Phong City,Le Chan District,9,62,53,9,1
2022-04-19,Hai Phong City,Le Chan District,10,139,127,12,0
2022-04-19,Hai Phong City,Le Chan District,11,254,226,28,6
2022-04-19,Hai Phong City,Le Chan District,12,177,162,15,2
2022-04-19,Hai Phong City,Le Chan District,13,94,87,7,1
2022-04-19,Hai Phong City,Le Chan District,14,122,111,11,1
2022-04-19,Hai Phong City,Le Chan District,15,131,117,14,1
2022-04-19,Hai Phong City,Le Chan District,16,158,149,9,3
2022-04-19,Hai Phong City,Le Chan District,17,146,137,9,0
2022-04-19,Hai Phong City,Le Chan District,18,196,178,18,0
2022-04-19,Hai Phong City,Le Chan District,19,188,169,19,6
2022-04-19,Hai Phong City,Le Chan District,20,138,121,17,0
2022-04-19,Hai Phong City,Le Chan District,21,61,53,8,2
2022-04-19,Hai Phong City,Le Chan District,23,1,1,0,0
2022-04-19,Hai Phong City,Ngo Quyen District,0,3,2,1,0
2022-04-19,Hai Phong City,Ngo Quyen District,5,1,1,0,0
2022-04-19,Hai Phong City,Ngo Quyen District,6,1,1,0,0
2022-04-19,Hai Phong City,Ngo Quyen District,7,25,18,7,1
2022-04-19,Hai Phong City,Ngo Quyen District,8,65,55,10,0
2022-04-19,Hai Phong City,Ngo Quyen District,9,67,55,12,1
2022-04-19,Hai Phong City,Ngo Quyen District,10,118,110,8,1
2022-04-19,Hai Phong City,Ngo Quyen District,11,230,212,18,2
2022-04-19,Hai Phong City,Ngo Quyen District,12,135,125,10,0
2022-04-19,Hai Phong City,Ngo Quyen District,13,99,89,10,1
2022-04-19,Hai Phong City,Ngo Quyen District,14,140,130,10,2
2022-04-19,Hai Phong City,Ngo Quyen District,15,128,108,20,1
2022-04-19,Hai Phong City,Ngo Quyen District,16,92,75,17,0
2022-04-19,Hai Phong City,Ngo Quyen District,17,120,106,14,0
2022-04-19,Hai Phong City,Ngo Quyen District,18,147,131,16,2
2022-04-19,Hai Phong City,Ngo Quyen District,19,145,128,17,1
2022-04-19,Hai Phong City,Ngo Quyen District,20,120,114,6,0
2022-04-19,Hai Phong City,Ngo Quyen District,21,59,47,12,0
2022-04-19,Hai Phong City,Ngo Quyen District,22,1,1,0,0
2022-04-19,Hai Phong City,Thuy Nguyen,10,3,1,2,2
2022-04-19,Hai Phong City,Thuy Nguyen,11,2,1,1,1
2022-04-19,Hai Phong City,Thuy Nguyen,12,1,0,1,1
2022-04-19,Hai Phong City,Thuy Nguyen,14,2,0,2,2
2022-04-19,Hai Phong City,Thuy Nguyen,21,1,0,1,1
2022-04-19,Hue City,Hue City,0,1,1,0,0
2022-04-19,Hue City,Hue City,5,3,0,3,1
2022-04-19,Hue City,Hue City,6,86,73,13,6
2022-04-19,Hue City,Hue City,7,186,178,8,0
2022-04-19,Hue City,Hue City,8,309,291,18,1
2022-04-19,Hue City,Hue City,9,254,240,14,0
2022-04-19,Hue City,Hue City,10,353,332,21,1
2022-04-19,Hue City,Hue City,11,866,794,72,7
2022-04-19,Hue City,Hue City,12,572,535,37,1
2022-04-19,Hue City,Hue City,13,310,296,14,0
2022-04-19,Hue City,Hue City,14,346,328,18,0
2022-04-19,Hue City,Hue City,15,348,328,20,3
2022-04-19,Hue City,Hue City,16,432,403,29,0
2022-04-19,Hue City,Hue City,17,634,593,41,3
2022-04-19,Hue City,Hue City,18,722,662,60,1
2022-04-19,Hue City,Hue City,19,605,572,33,1
2022-04-19,Hue City,Hue City,20,521,439,82,21
2022-04-19,Hue City,Hue City,21,229,187,42,9
2022-04-19,Hue City,Hue City,22,3,2,1,0
2022-04-19,Hue City,Hue City,23,4,4,0,0
2022-04-19,Hue City,Huong Thuy,6,1,0,1,1
2022-04-19,Hue City,Huong Thuy,9,1,1,0,0
2022-04-19,Hue City,Huong Thuy,11,2,0,2,0
2022-04-19,Hue City,Huong Thuy,12,1,1,0,0
2022-04-19,Hue City,Huong Thuy,15,1,1,0,0
2022-04-19,Hue City,Huong Thuy,16,2,0,2,2
2022-04-19,Hue City,Huong Thuy,17,1,1,0,0
2022-04-19,Hue City,Huong Thuy,21,1,0,1,0
2022-04-19,Hue City,Huong Tra,10,1,1,0,0
2022-04-19,Hue City,Huong Tra,11,1,1,0,0
2022-04-19,Hue City,Huong Tra,17,1,1,0,0
2022-04-19,Hue City,Phu Vang,6,1,1,0,0
2022-04-19,Hue City,Phu Vang,7,1,1,0,0
2022-04-19,Hue City,Phu Vang,9,1,1,0,0
2022-04-19,Hue City,Phu Vang,10,3,1,2,0
2022-04-19,Hue City,Phu Vang,11,3,1,2,0
2022-04-19,Hue City,Phu Vang,12,1,1,0,0
2022-04-19,Hue City,Phu Vang,13,2,2,0,0
2022-04-19,Hue City,Phu Vang,15,1,1,0,0
2022-04-19,Hue City,Phu Vang,16,2,2,0,0
2022-04-19,Hue City,Phu Vang,17,2,1,1,1
2022-04-19,Hue City,Phu Vang,18,3,2,1,0
2022-04-19,Hue City,Phu Vang,19,3,1,2,0
2022-04-19,Hue City,Phu Vang,20,3,2,1,0
2022-04-19,Hue City,Phu Vang,21,1,1,0,0
2022-04-19,Vung Tau,Ba Ria City,8,3,1,2,2
2022-04-19,Vung Tau,Ba Ria City,9,11,4,7,7
2022-04-19,Vung Tau,Ba Ria City,10,7,6,1,0
2022-04-19,Vung Tau,Ba Ria City,11,6,3,3,0
2022-04-19,Vung Tau,Ba Ria City,12,9,6,3,1
2022-04-19,Vung Tau,Ba Ria City,13,7,1,6,5
2022-04-19,Vung Tau,Ba Ria City,14,6,4,2,2
2022-04-19,Vung Tau,Ba Ria City,15,3,2,1,0
2022-04-19,Vung Tau,Ba Ria City,16,5,3,2,1
2022-04-19,Vung Tau,Ba Ria City,17,4,2,2,2
2022-04-19,Vung Tau,Ba Ria City,18,6,2,4,4
2022-04-19,Vung Tau,Ba Ria City,19,6,0,6,6
2022-04-19,Vung Tau,Ba Ria City,20,10,0,10,8
2022-04-19,Vung Tau,Ba Ria City,21,3,0,3,3
2022-04-19,Vung Tau,Long Dien,13,2,0,2,1
2022-04-19,Vung Tau,Vung Tau City,1,2,2,0,0
2022-04-19,Vung Tau,Vung Tau City,3,1,1,0,0
2022-04-19,Vung Tau,Vung Tau City,5,2,1,1,1
2022-04-19,Vung Tau,Vung Tau City,6,29,23,6,1
2022-04-19,Vung Tau,Vung Tau City,7,92,86,6,0
2022-04-19,Vung Tau,Vung Tau City,8,119,107,12,2
2022-04-19,Vung Tau,Vung Tau City,9,134,127,7,0
2022-04-19,Vung Tau,Vung Tau City,10,148,135,13,0
2022-04-19,Vung Tau,Vung Tau City,11,327,299,28,1
2022-04-19,Vung Tau,Vung Tau City,12,270,255,15,0
2022-04-19,Vung Tau,Vung Tau City,13,201,191,10,1
2022-04-19,Vung Tau,Vung Tau City,14,197,187,10,3
2022-04-19,Vung Tau,Vung Tau City,15,190,180,10,0
2022-04-19,Vung Tau,Vung Tau City,16,190,174,16,2
2022-04-19,Vung Tau,Vung Tau City,17,224,214,10,0
2022-04-19,Vung Tau,Vung Tau City,18,252,235,17,1
2022-04-19,Vung Tau,Vung Tau City,19,228,215,13,0
2022-04-19,Vung Tau,Vung Tau City,20,182,158,24,1
2022-04-19,Vung Tau,Vung Tau City,21,96,70,26,4
2022-04-19,Vung Tau,Vung Tau City,22,1,0,1,0
2022-04-19,Vung Tau,Vung Tau City,23,1,1,0,0
2022-04-20,Binh Duong,Ben Cat,9,5,1,4,3
2022-04-20,Binh Duong,Ben Cat,14,1,0,1,1
2022-04-20,Binh Duong,Ben Cat,15,1,0,1,1
2022-04-20,Binh Duong,Ben Cat,20,1,0,1,0
2022-04-20,Binh Duong,Di An,6,1,0,1,1
2022-04-20,Binh Duong,Di An,7,2,1,1,1
2022-04-20,Binh Duong,Di An,8,9,7,2,2
2022-04-20,Binh Duong,Di An,9,15,9,6,6
2022-04-20,Binh Duong,Di An,10,16,10,6,3
2022-04-20,Binh Duong,Di An,11,27,16,11,10
2022-04-20,Binh Duong,Di An,12,29,21,8,4
2022-04-20,Binh Duong,Di An,13,27,18,9,7
2022-04-20,Binh Duong,Di An,14,19,12,7,6
2022-04-20,Binh Duong,Di An,15,27,13,14,11
2022-04-20,Binh Duong,Di An,16,11,6,5,4
2022-04-20,Binh Duong,Di An,17,16,12,4,4
2022-04-20,Binh Duong,Di An,18,28,22,6,6
2022-04-20,Binh Duong,Di An,19,19,14,5,4
2022-04-20,Binh Duong,Di An,20,22,12,10,7
2022-04-20,Binh Duong,Di An,21,12,4,8,7
2022-04-20,Binh Duong,Tan Uyen,8,1,0,1,1
2022-04-20,Binh Duong,Tan Uyen,9,1,1,0,0
2022-04-20,Binh Duong,Tan Uyen,10,4,1,3,1
2022-04-20,Binh Duong,Tan Uyen,11,8,4,4,3
2022-04-20,Binh Duong,Tan Uyen,13,2,1,1,1
2022-04-20,Binh Duong,Tan Uyen,14,3,2,1,1
2022-04-20,Binh Duong,Tan Uyen,17,2,1,1,1
2022-04-20,Binh Duong,Tan Uyen,18,1,0,1,1
2022-04-20,Binh Duong,Tan Uyen,19,2,1,1,1
2022-04-20,Binh Duong,Tan Uyen,20,1,1,0,0
2022-04-20,Binh Duong,Tan Uyen,21,1,0,1,1
2022-04-20,Binh Duong,Thu Dau Mot Town,4,1,0,1,0
2022-04-20,Binh Duong,Thu Dau Mot Town,6,31,26,5,1
2022-04-20,Binh Duong,Thu Dau Mot Town,7,102,95,7,0
2022-04-20,Binh Duong,Thu Dau Mot Town,8,186,177,9,2
2022-04-20,Binh Duong,Thu Dau Mot Town,9,224,215,9,0
2022-04-20,Binh Duong,Thu Dau Mot Town,10,396,379,17,3
2022-04-20,Binh Duong,Thu Dau Mot Town,11,595,569,26,0
2022-04-20,Binh Duong,Thu Dau Mot Town,12,405,391,14,1
2022-04-20,Binh Duong,Thu Dau Mot Town,13,375,356,19,3
2022-04-20,Binh Duong,Thu Dau Mot Town,14,265,252,13,2
2022-04-20,Binh Duong,Thu Dau Mot Town,15,185,169,16,3
2022-04-20,Binh Duong,Thu Dau Mot Town,16,273,255,18,3
2022-04-20,Binh Duong,Thu Dau Mot Town,17,386,365,21,0
2022-04-20,Binh Duong,Thu Dau Mot Town,18,363,348,15,1
2022-04-20,Binh Duong,Thu Dau Mot Town,19,340,319,21,1
2022-04-20,Binh Duong,Thu Dau Mot Town,20,264,244,20,5
2022-04-20,Binh Duong,Thu Dau Mot Town,21,99,80,19,3
2022-04-20,Binh Duong,Thu Dau Mot Town,23,1,1,0,0
2022-04-20,Binh Duong,Thuan An,6,2,0,2,2
2022-04-20,Binh Duong,Thuan An,7,13,1,12,9
2022-04-20,Binh Duong,Thuan An,8,24,14,10,9
2022-04-20,Binh Duong,Thuan An,9,34,25,9,5
2022-04-20,Binh Duong,Thuan An,10,63,42,21,18
2022-04-20,Binh Duong,Thuan An,11,78,51,27,26
2022-04-20,Binh Duong,Thuan An,12,65,47,18,13
2022-04-20,Binh Duong,Thuan An,13,90,51,39,27
2022-04-20,Binh Duong,Thuan An,14,39,33,6,5
2022-04-20,Binh Duong,Thuan An,15,25,12,13,8
2022-04-20,Binh Duong,Thuan An,16,27,20,7,2
2022-04-20,Binh Duong,Thuan An,17,30,25,5,4
2022-04-20,Binh Duong,Thuan An,18,35,28,7,3
2022-04-20,Binh Duong,Thuan An,19,31,28,3,3
2022-04-20,Binh Duong,Thuan An,20,26,19,7,4
2022-04-20,Binh Duong,Thuan An,21,18,4,14,9
2022-04-20,Can Tho City,Binh Thuy District,6,2,1,1,0
2022-04-20,Can Tho City,Binh Thuy District,7,1,1,0,0
2022-04-20,Can Tho City,Binh Thuy District,8,5,4,1,0
2022-04-20,Can Tho City,Binh Thuy District,9,7,5,2,0
2022-04-20,Can Tho City,Binh Thuy District,10,8,8,0,0
2022-04-20,Can Tho City,Binh Thuy District,11,18,17,1,0
2022-04-20,Can Tho City,Binh Thuy District,12,10,10,0,0
2022-04-20,Can Tho City,Binh Thuy District,13,19,16,3,0
2022-04-20,Can Tho City,Binh Thuy District,14,9,9,0,0
2022-04-20,Can Tho City,Binh Thuy District,15,11,11,0,0
2022-04-20,Can Tho City,Binh Thuy District,16,8,8,0,0
2022-04-20,Can Tho City,Binh Thuy District,17,9,9,0,0
2022-04-20,Can Tho City,Binh Thuy District,18,17,16,1,0
2022-04-20,Can Tho City,Binh Thuy District,19,13,12,1,0
2022-04-20,Can Tho City,Binh Thuy District,20,5,4,1,0
2022-04-20,Can Tho City,Binh Thuy District,21,2,2,0,0
2022-04-20,Can Tho City,Binh Thuy District,22,1,0,1,0
2022-04-20,Can Tho City,Cai Rang District,7,3,1,2,2
2022-04-20,Can Tho City,Cai Rang District,8,5,5,0,0
2022-04-20,Can Tho City,Cai Rang District,9,7,7,0,0
2022-04-20,Can Tho City,Cai Rang District,10,14,12,2,0
2022-04-20,Can Tho City,Cai Rang District,11,23,21,2,0
2022-04-20,Can Tho City,Cai Rang District,12,10,9,1,0
2022-04-20,Can Tho City,Cai Rang District,13,13,11,2,0
2022-04-20,Can Tho City,Cai Rang District,14,10,9,1,1
2022-04-20,Can Tho City,Cai Rang District,15,12,11,1,0
2022-04-20,Can Tho City,Cai Rang District,16,9,9,0,0
2022-04-20,Can Tho City,Cai Rang District,17,6,6,0,0
2022-04-20,Can Tho City,Cai Rang District,18,12,10,2,1
2022-04-20,Can Tho City,Cai Rang District,19,13,12,1,0
2022-04-20,Can Tho City,Cai Rang District,20,9,6,3,0
2022-04-20,Can Tho City,Cai Rang District,21,4,2,2,1
2022-04-20,Can Tho City,Ninh Kieu District,1,1,1,0,0
2022-04-20,Can Tho City,Ninh Kieu District,4,1,1,0,0
2022-04-20,Can Tho City,Ninh Kieu District,5,2,2,0,0
2022-04-20,Can Tho City,Ninh Kieu District,6,43,37,6,2
2022-04-20,Can Tho City,Ninh Kieu District,7,133,128,5,0
2022-04-20,Can Tho City,Ninh Kieu District,8,223,208,15,0
2022-04-20,Can Tho City,Ninh Kieu District,9,313,295,18,0
2022-04-20,Can Tho City,Ninh Kieu District,10,628,598,30,0
2022-04-20,Can Tho City,Ninh Kieu District,11,892,851,41,3
2022-04-20,Can Tho City,Ninh Kieu District,12,621,588,33,0
2022-04-20,Can Tho City,Ninh Kieu District,13,481,467,14,0
2022-04-20,Can Tho City,Ninh Kieu District,14,383,361,22,1
2022-04-20,Can Tho City,Ninh Kieu District,15,385,365,20,0
2022-04-20,Can Tho City,Ninh Kieu District,16,439,416,23,0
2022-04-20,Can Tho City,Ninh Kieu District,17,548,523,25,0
2022-04-20,Can Tho City,Ninh Kieu District,18,552,523,29,0
2022-04-20,Can Tho City,Ninh Kieu District,19,509,481,28,0
2022-04-20,Can Tho City,Ninh Kieu District,20,350,334,16,0
2022-04-20,Can Tho City,Ninh Kieu District,21,209,188,21,0
2022-04-20,Can Tho City,Ninh Kieu District,22,2,1,1,0
2022-04-20,Can Tho City,Ninh Kieu District,23,1,1,0,0
2022-04-20,Dong Nai,Bien Hoa City,0,1,1,0,0
2022-04-20,Dong Nai,Bien Hoa City,1,1,1,0,0
2022-04-20,Dong Nai,Bien Hoa City,2,1,1,0,0
2022-04-20,Dong Nai,Bien Hoa City,4,1,1,0,0
2022-04-20,Dong Nai,Bien Hoa City,5,2,1,1,1
2022-04-20,Dong Nai,Bien Hoa City,6,36,24,12,10
2022-04-20,Dong Nai,Bien Hoa City,7,119,99,20,10
2022-04-20,Dong Nai,Bien Hoa City,8,278,257,21,2
2022-04-20,Dong Nai,Bien Hoa City,9,371,343,28,2
2022-04-20,Dong Nai,Bien Hoa City,10,708,646,62,14
2022-04-20,Dong Nai,Bien Hoa City,11,1055,967,88,20
2022-04-20,Dong Nai,Bien Hoa City,12,791,734,57,8
2022-04-20,Dong Nai,Bien Hoa City,13,726,682,44,8
2022-04-20,Dong Nai,Bien Hoa City,14,589,532,57,11
2022-04-20,Dong Nai,Bien Hoa City,15,486,433,53,11
2022-04-20,Dong Nai,Bien Hoa City,16,455,400,55,21
2022-04-20,Dong Nai,Bien Hoa City,17,565,512,53,16
2022-04-20,Dong Nai,Bien Hoa City,18,701,624,77,14
2022-04-20,Dong Nai,Bien Hoa City,19,574,537,37,5
2022-04-20,Dong Nai,Bien Hoa City,20,439,393,46,12
2022-04-20,Dong Nai,Bien Hoa City,21,231,166,65,21
2022-04-20,Dong Nai,Bien Hoa City,22,3,2,1,0
2022-04-20,Dong Nai,Bien Hoa City,23,4,3,1,0
2022-04-20,Dong Nai,Long Khanh,12,1,0,1,1
2022-04-20,Dong Nai,Long Khanh,17,1,0,1,1
2022-04-20,Dong Nai,Long Thanh,9,1,0,1,0
2022-04-20,Dong Nai,Long Thanh,11,1,0,1,1
2022-04-20,Dong Nai,Long Thanh,12,1,0,1,1
2022-04-20,Dong Nai,Long Thanh,15,1,0,1,1
2022-04-20,Dong Nai,Long Thanh,18,3,0,3,3
2022-04-20,Dong Nai,Long Thanh,21,2,0,2,1
2022-04-20,Dong Nai,Nhon trach,11,1,0,1,1
2022-04-20,Dong Nai,Nhon trach,16,1,0,1,1
2022-04-20,Dong Nai,Thong Nhat,7,2,2,0,0
2022-04-20,Dong Nai,Thong Nhat,8,1,1,0,0
2022-04-20,Dong Nai,Thong Nhat,9,2,2,0,0
2022-04-20,Dong Nai,Thong Nhat,10,4,4,0,0
2022-04-20,Dong Nai,Thong Nhat,11,1,1,0,0
2022-04-20,Dong Nai,Thong Nhat,12,1,1,0,0
2022-04-20,Dong Nai,Thong Nhat,13,5,4,1,0
2022-04-20,Dong Nai,Thong Nhat,14,2,2,0,0
2022-04-20,Dong Nai,Thong Nhat,16,1,1,0,0
2022-04-20,Dong Nai,Thong Nhat,17,1,1,0,0
2022-04-20,Dong Nai,Thong Nhat,18,1,1,0,0
2022-04-20,Dong Nai,Trang Bom,9,1,0,1,0
2022-04-20,Dong Nai,Trang Bom,10,1,0,1,1
2022-04-20,Dong Nai,Trang Bom,12,1,0,1,1
2022-04-20,Dong Nai,Trang Bom,19,2,0,2,2
2022-04-20,Dong Nai,Trang Bom,20,1,0,1,1
2022-04-20,Hai Phong City,An Duong,8,6,0,6,5
2022-04-20,Hai Phong City,An Duong,9,4,0,4,3
2022-04-20,Hai Phong City,An Duong,10,3,2,1,0
2022-04-20,Hai Phong City,An Duong,12,5,3,2,2
2022-04-20,Hai Phong City,An Duong,13,3,1,2,2
2022-04-20,Hai Phong City,An Duong,14,3,2,1,1
2022-04-20,Hai Phong City,An Duong,15,7,2,5,3
2022-04-20,Hai Phong City,An Duong,16,4,2,2,1
2022-04-20,Hai Phong City,An Duong,17,3,3,0,0
2022-04-20,Hai Phong City,An Duong,18,1,1,0,0
2022-04-20,Hai Phong City,An Duong,19,1,1,0,0
2022-04-20,Hai Phong City,An Duong,20,1,1,0,0
2022-04-20,Hai Phong City,An Duong,21,2,1,1,0
2022-04-20,Hai Phong City,Do Son District,12,1,0,1,1
2022-04-20,Hai Phong City,Do Son District,16,1,0,1,1
2022-04-20,Hai Phong City,Duong Kinh District,16,1,0,1,1
2022-04-20,Hai Phong City,Hai An District,7,6,5,1,0
2022-04-20,Hai Phong City,Hai An District,8,8,7,1,1
2022-04-20,Hai Phong City,Hai An District,9,7,6,1,0
2022-04-20,Hai Phong City,Hai An District,10,16,16,0,0
2022-04-20,Hai Phong City,Hai An District,11,44,38,6,1
2022-04-20,Hai Phong City,Hai An District,12,21,20,1,0
2022-04-20,Hai Phong City,Hai An District,13,8,5,3,0
2022-04-20,Hai Phong City,Hai An District,14,19,13,6,3
2022-04-20,Hai Phong City,Hai An District,15,15,14,1,0
2022-04-20,Hai Phong City,Hai An District,16,20,18,2,1
2022-04-20,Hai Phong City,Hai An District,17,20,17,3,2
2022-04-20,Hai Phong City,Hai An District,18,41,38,3,1
2022-04-20,Hai Phong City,Hai An District,19,20,16,4,2
2022-04-20,Hai Phong City,Hai An District,20,9,7,2,0
2022-04-20,Hai Phong City,Hai An District,21,6,4,2,1
2022-04-20,Hai Phong City,Hong Bang District,3,1,1,0,0
2022-04-20,Hai Phong City,Hong Bang District,6,1,1,0,0
2022-04-20,Hai Phong City,Hong Bang District,7,12,10,2,1
2022-04-20,Hai Phong City,Hong Bang District,8,32,28,4,0
2022-04-20,Hai Phong City,Hong Bang District,9,27,25,2,0
2022-04-20,Hai Phong City,Hong Bang District,10,59,50,9,4
2022-04-20,Hai Phong City,Hong Bang District,11,88,81,7,2
2022-04-20,Hai Phong City,Hong Bang District,12,53,52,1,0
2022-04-20,Hai Phong City,Hong Bang District,13,34,31,3,2
2022-04-20,Hai Phong City,Hong Bang District,14,48,40,8,4
2022-04-20,Hai Phong City,Hong Bang District,15,47,44,3,1
2022-04-20,Hai Phong City,Hong Bang District,16,32,27,5,0
2022-04-20,Hai Phong City,Hong Bang District,17,25,21,4,0
2022-04-20,Hai Phong City,Hong Bang District,18,53,48,5,1
2022-04-20,Hai Phong City,Hong Bang District,19,54,44,10,1
2022-04-20,Hai Phong City,Hong Bang District,20,36,27,9,1
2022-04-20,Hai Phong City,Hong Bang District,21,12,7,5,3
2022-04-20,Hai Phong City,Kien An District,7,1,0,1,1
2022-04-20,Hai Phong City,Kien An District,8,4,0,4,3
2022-04-20,Hai Phong City,Kien An District,9,2,1,1,1
2022-04-20,Hai Phong City,Kien An District,10,8,1,7,7
2022-04-20,Hai Phong City,Kien An District,11,19,11,8,6
2022-04-20,Hai Phong City,Kien An District,12,10,6,4,1
2022-04-20,Hai Phong City,Kien An District,13,8,3,5,4
2022-04-20,Hai Phong City,Kien An District,14,3,3,0,0
2022-04-20,Hai Phong City,Kien An District,15,5,2,3,1
2022-04-20,Hai Phong City,Kien An District,16,7,6,1,1
2022-04-20,Hai Phong City,Kien An District,17,7,4,3,2
2022-04-20,Hai Phong City,Kien An District,18,14,10,4,3
2022-04-20,Hai Phong City,Kien An District,19,13,10,3,1
2022-04-20,Hai Phong City,Kien An District,20,7,5,2,0
2022-04-20,Hai Phong City,Kien An District,21,3,1,2,2
2022-04-20,Hai Phong City,Le Chan District,0,1,1,0,0
2022-04-20,Hai Phong City,Le Chan District,2,1,1,0,0
2022-04-20,Hai Phong City,Le Chan District,6,2,0,2,2
2022-04-20,Hai Phong City,Le Chan District,7,25,24,1,0
2022-04-20,Hai Phong City,Le Chan District,8,55,54,1,0
2022-04-20,Hai Phong City,Le Chan District,9,70,63,7,0
2022-04-20,Hai Phong City,Le Chan District,10,147,134,13,0
2022-04-20,Hai Phong City,Le Chan District,11,292,266,26,5
2022-04-20,Hai Phong City,Le Chan District,12,163,139,24,2
2022-04-20,Hai Phong City,Le Chan District,13,89,83,6,0
2022-04-20,Hai Phong City,Le Chan District,14,111,96,15,7
2022-04-20,Hai Phong City,Le Chan District,15,137,121,16,1
2022-04-20,Hai Phong City,Le Chan District,16,117,104,13,1
2022-04-20,Hai Phong City,Le Chan District,17,155,144,11,1
2022-04-20,Hai Phong City,Le Chan District,18,178,167,11,1
2022-04-20,Hai Phong City,Le Chan District,19,187,165,22,1
2022-04-20,Hai Phong City,Le Chan District,20,141,120,21,1
2022-04-20,Hai Phong City,Le Chan District,21,57,45,12,1
2022-04-20,Hai Phong City,Le Chan District,22,4,2,2,0
2022-04-20,Hai Phong City,Le Chan District,23,1,1,0,0
2022-04-20,Hai Phong City,Ngo Quyen District,0,2,1,1,0
2022-04-20,Hai Phong City,Ngo Quyen District,6,2,1,1,1
2022-04-20,Hai Phong City,Ngo Quyen District,7,31,27,4,2
2022-04-20,Hai Phong City,Ngo Quyen District,8,52,46,6,1
2022-04-20,Hai Phong City,Ngo Quyen District,9,68,59,9,0
2022-04-20,Hai Phong City,Ngo Quyen District,10,123,108,15,1
2022-04-20,Hai Phong City,Ngo Quyen District,11,190,177,13,3
2022-04-20,Hai Phong City,Ngo Quyen District,12,154,140,14,1
2022-04-20,Hai Phong City,Ngo Quyen District,13,88,81,7,2
2022-04-20,Hai Phong City,Ngo Quyen District,14,101,92,9,2
2022-04-20,Hai Phong City,Ngo Quyen District,15,100,94,6,0
2022-04-20,Hai Phong City,Ngo Quyen District,16,102,92,10,0
2022-04-20,Hai Phong City,Ngo Quyen District,17,143,131,12,2
2022-04-20,Hai Phong City,Ngo Quyen District,18,155,141,14,1
2022-04-20,Hai Phong City,Ngo Quyen District,19,107,101,6,0
2022-04-20,Hai Phong City,Ngo Quyen District,20,126,111,15,2
2022-04-20,Hai Phong City,Ngo Quyen District,21,54,42,12,0
2022-04-20,Hai Phong City,Ngo Quyen District,22,2,0,2,0
2022-04-20,Hai Phong City,Ngo Quyen District,23,1,0,1,0
2022-04-20,Hai Phong City,Thuy Nguyen,10,1,0,1,1
2022-04-20,Hai Phong City,Thuy Nguyen,12,1,0,1,1
2022-04-20,Hai Phong City,Thuy Nguyen,15,1,0,1,1
2022-04-20,Hai Phong City,Thuy Nguyen,19,2,0,2,1
2022-04-20,Hue City,Hue City,0,2,2,0,0
2022-04-20,Hue City,Hue City,1,1,1,0,0
2022-04-20,Hue City,Hue City,5,4,3,1,0
2022-04-20,Hue City,Hue City,6,61,56,5,0
2022-04-20,Hue City,Hue City,7,189,169,20,1
2022-04-20,Hue City,Hue City,8,295,285,10,0
2022-04-20,Hue City,Hue City,9,206,188,18,1
2022-04-20,Hue City,Hue City,10,368,339,29,0
2022-04-20,Hue City,Hue City,11,741,688,53,2
2022-04-20,Hue City,Hue City,12,467,441,26,1
2022-04-20,Hue City,Hue City,13,323,298,25,0
2022-04-20,Hue City,Hue City,14,336,307,29,4
2022-04-20,Hue City,Hue City,15,406,379,27,3
2022-04-20,Hue City,Hue City,16,442,416,26,2
2022-04-20,Hue City,Hue City,17,570,535,35,2
2022-04-20,Hue City,Hue City,18,665,616,49,3
2022-04-20,Hue City,Hue City,19,606,561,45,0
2022-04-20,Hue City,Hue City,20,412,361,51,1
2022-04-20,Hue City,Hue City,21,245,213,32,2
2022-04-20,Hue City,Hue City,22,3,2,1,0
2022-04-20,Hue City,Hue City,23,2,1,1,0
2022-04-20,Hue City,Huong Thuy,7,1,0,1,0
2022-04-20,Hue City,Huong Thuy,8,1,0,1,1
2022-04-20,Hue City,Huong Thuy,12,3,3,0,0
2022-04-20,Hue City,Huong Thuy,17,3,3,0,0
2022-04-20,Hue City,Huong Tra,8,1,1,0,0
2022-04-20,Hue City,Huong Tra,11,1,1,0,0
2022-04-20,Hue City,Phu Vang,6,1,0,1,1
2022-04-20,Hue City,Phu Vang,7,1,1,0,0
2022-04-20,Hue City,Phu Vang,9,1,1,0,0
2022-04-20,Hue City,Phu Vang,11,4,4,0,0
2022-04-20,Hue City,Phu Vang,12,1,1,0,0
2022-04-20,Hue City,Phu Vang,14,2,2,0,0
2022-04-20,Hue City,Phu Vang,15,5,3,2,0
2022-04-20,Hue City,Phu Vang,16,1,0,1,1
2022-04-20,Hue City,Phu Vang,17,2,2,0,0
2022-04-20,Hue City,Phu Vang,18,1,1,0,0
2022-04-20,Hue City,Phu Vang,19,1,0,1,1
2022-04-20,Hue City,Phu Vang,21,2,0,2,0
2022-04-20,Vung Tau,Ba Ria City,9,3,1,2,1
2022-04-20,Vung Tau,Ba Ria City,10,4,3,1,0
2022-04-20,Vung Tau,Ba Ria City,11,5,5,0,0
2022-04-20,Vung Tau,Ba Ria City,12,8,5,3,1
2022-04-20,Vung Tau,Ba Ria City,13,7,3,4,4
2022-04-20,Vung Tau,Ba Ria City,14,6,4,2,2
2022-04-20,Vung Tau,Ba Ria City,15,8,3,5,5
2022-04-20,Vung Tau,Ba Ria City,16,4,3,1,0
2022-04-20,Vung Tau,Ba Ria City,17,13,2,11,8
2022-04-20,Vung Tau,Ba Ria City,18,1,0,1,1
2022-04-20,Vung Tau,Ba Ria City,19,8,0,8,6
2022-04-20,Vung Tau,Ba Ria City,20,5,0,5,5
2022-04-20,Vung Tau,Ba Ria City,21,7,0,7,7
2022-04-20,Vung Tau,Vung Tau City,0,2,2,0,0
2022-04-20,Vung Tau,Vung Tau City,2,1,1,0,0
2022-04-20,Vung Tau,Vung Tau City,4,1,1,0,0
2022-04-20,Vung Tau,Vung Tau City,5,1,1,0,0
2022-04-20,Vung Tau,Vung Tau City,6,34,30,4,1
2022-04-20,Vung Tau,Vung Tau City,7,101,87,14,1
2022-04-20,Vung Tau,Vung Tau City,8,149,137,12,1
2022-04-20,Vung Tau,Vung Tau City,9,137,128,9,2
2022-04-20,Vung Tau,Vung Tau City,10,166,154,12,2
2022-04-20,Vung Tau,Vung Tau City,11,333,316,17,2
2022-04-20,Vung Tau,Vung Tau City,12,249,232,17,0
2022-04-20,Vung Tau,Vung Tau City,13,203,182,21,9
2022-04-20,Vung Tau,Vung Tau City,14,250,238,12,0
2022-04-20,Vung Tau,Vung Tau City,15,180,165,15,0
2022-04-20,Vung Tau,Vung Tau City,16,165,152,13,4
2022-04-20,Vung Tau,Vung Tau City,17,225,211,14,5
2022-04-20,Vung Tau,Vung Tau City,18,297,273,24,2
2022-04-20,Vung Tau,Vung Tau City,19,264,241,23,1
2022-04-20,Vung Tau,Vung Tau City,20,191,172,19,3
2022-04-20,Vung Tau,Vung Tau City,21,106,79,27,2
2022-04-21,Binh Duong,Ben Cat,11,3,0,3,3
2022-04-21,Binh Duong,Ben Cat,12,2,1,1,1
2022-04-21,Binh Duong,Ben Cat,17,2,0,2,2
2022-04-21,Binh Duong,Ben Cat,18,3,0,3,3
2022-04-21,Binh Duong,Ben Cat,19,1,1,0,0
2022-04-21,Binh Duong,Di An,6,2,0,2,2
2022-04-21,Binh Duong,Di An,7,10,3,7,6
2022-04-21,Binh Duong,Di An,8,20,6,14,14
2022-04-21,Binh Duong,Di An,9,27,16,11,6
2022-04-21,Binh Duong,Di An,10,16,13,3,1
2022-04-21,Binh Duong,Di An,11,28,17,11,8
2022-04-21,Binh Duong,Di An,12,26,16,10,7
2022-04-21,Binh Duong,Di An,13,28,14,14,9
2022-04-21,Binh Duong,Di An,14,17,10,7,5
2022-04-21,Binh Duong,Di An,15,20,14,6,5
2022-04-21,Binh Duong,Di An,16,24,16,8,6
2022-04-21,Binh Duong,Di An,17,24,18,6,3
2022-04-21,Binh Duong,Di An,18,24,19,5,0
2022-04-21,Binh Duong,Di An,19,16,13,3,1
2022-04-21,Binh Duong,Di An,20,10,7,3,2
2022-04-21,Binh Duong,Di An,21,9,3,6,5
2022-04-21,Binh Duong,Tan Uyen,8,2,1,1,1
2022-04-21,Binh Duong,Tan Uyen,10,1,1,0,0
2022-04-21,Binh Duong,Tan Uyen,11,4,0,4,4
2022-04-21,Binh Duong,Tan Uyen,12,5,1,4,4
2022-04-21,Binh Duong,Tan Uyen,13,6,0,6,6
2022-04-21,Binh Duong,Tan Uyen,14,2,1,1,1
2022-04-21,Binh Duong,Tan Uyen,15,2,1,1,1
2022-04-21,Binh Duong,Tan Uyen,17,4,2,2,2
2022-04-21,Binh Duong,Tan Uyen,18,1,0,1,0
2022-04-21,Binh Duong,Tan Uyen,19,4,1,3,3
2022-04-21,Binh Duong,Tan Uyen,20,1,0,1,1
2022-04-21,Binh Duong,Tan Uyen,21,1,0,1,1
2022-04-21,Binh Duong,Thu Dau Mot Town,3,1,0,1,0
2022-04-21,Binh Duong,Thu Dau Mot Town,4,1,1,0,0
2022-04-21,Binh Duong,Thu Dau Mot Town,5,2,1,1,1
2022-04-21,Binh Duong,Thu Dau Mot Town,6,52,42,10,3
2022-04-21,Binh Duong,Thu Dau Mot Town,7,106,98,8,0
2022-04-21,Binh Duong,Thu Dau Mot Town,8,186,173,13,4
2022-04-21,Binh Duong,Thu Dau Mot Town,9,232,215,17,2
2022-04-21,Binh Duong,Thu Dau Mot Town,10,420,396,24,7
2022-04-21,Binh Duong,Thu Dau Mot Town,11,640,598,42,6
2022-04-21,Binh Duong,Thu Dau Mot Town,12,439,413,26,2
2022-04-21,Binh Duong,Thu Dau Mot Town,13,433,410,23,3
2022-04-21,Binh Duong,Thu Dau Mot Town,14,318,303,15,1
2022-04-21,Binh Duong,Thu Dau Mot Town,15,242,228,14,0
2022-04-21,Binh Duong,Thu Dau Mot Town,16,257,241,16,0
2022-04-21,Binh Duong,Thu Dau Mot Town,17,342,326,16,0
2022-04-21,Binh Duong,Thu Dau Mot Town,18,364,342,22,1
2022-04-21,Binh Duong,Thu Dau Mot Town,19,340,310,30,0
2022-04-21,Binh Duong,Thu Dau Mot Town,20,245,228,17,4
2022-04-21,Binh Duong,Thu Dau Mot Town,21,103,89,14,1
2022-04-21,Binh Duong,Thu Dau Mot Town,22,2,1,1,1
2022-04-21,Binh Duong,Thuan An,7,8,4,4,4
2022-04-21,Binh Duong,Thuan An,8,24,9,15,7
2022-04-21,Binh Duong,Thuan An,9,30,26,4,3
2022-04-21,Binh Duong,Thuan An,10,69,54,15,9
2022-04-21,Binh Duong,Thuan An,11,84,63,21,12
2022-04-21,Binh Duong,Thuan An,12,60,51,9,4
2022-04-21,Binh Duong,Thuan An,13,63,47,16,11
2022-04-21,Binh Duong,Thuan An,14,37,29,8,7
2022-04-21,Binh Duong,Thuan An,15,38,26,12,3
2022-04-21,Binh Duong,Thuan An,16,32,20,12,8
2022-04-21,Binh Duong,Thuan An,17,39,30,9,4
2022-04-21,Binh Duong,Thuan An,18,33,24,9,6
2022-04-21,Binh Duong,Thuan An,19,34,24,10,8
2022-04-21,Binh Duong,Thuan An,20,29,17,12,9
2022-04-21,Binh Duong,Thuan An,21,11,4,7,3
2022-04-21,Can Tho City,Binh Thuy District,6,2,2,0,0
2022-04-21,Can Tho City,Binh Thuy District,7,3,3,0,0
2022-04-21,Can Tho City,Binh Thuy District,8,2,2,0,0
2022-04-21,Can Tho City,Binh Thuy District,9,7,7,0,0
2022-04-21,Can Tho City,Binh Thuy District,10,13,9,4,0
2022-04-21,Can Tho City,Binh Thuy District,11,17,14,3,0
2022-04-21,Can Tho City,Binh Thuy District,12,11,10,1,0
2022-04-21,Can Tho City,Binh Thuy District,13,14,14,0,0
2022-04-21,Can Tho City,Binh Thuy District,14,13,11,2,1
2022-04-21,Can Tho City,Binh Thuy District,15,14,11,3,3
2022-04-21,Can Tho City,Binh Thuy District,16,15,13,2,0
2022-04-21,Can Tho City,Binh Thuy District,17,19,19,0,0
2022-04-21,Can Tho City,Binh Thuy District,18,11,10,1,0
2022-04-21,Can Tho City,Binh Thuy District,19,17,16,1,0
2022-04-21,Can Tho City,Binh Thuy District,20,12,11,1,0
2022-04-21,Can Tho City,Binh Thuy District,21,1,0,1,0
2022-04-21,Can Tho City,Binh Thuy District,22,1,0,1,0
2022-04-21,Can Tho City,Cai Rang District,6,1,1,0,0
2022-04-21,Can Tho City,Cai Rang District,7,3,2,1,0
2022-04-21,Can Tho City,Cai Rang District,8,4,4,0,0
2022-04-21,Can Tho City,Cai Rang District,9,7,6,1,0
2022-04-21,Can Tho City,Cai Rang District,10,10,9,1,0
2022-04-21,Can Tho City,Cai Rang District,11,18,17,1,0
2022-04-21,Can Tho City,Cai Rang District,12,12,11,1,0
2022-04-21,Can Tho City,Cai Rang District,13,14,14,0,0
2022-04-21,Can Tho City,Cai Rang District,14,7,7,0,0
2022-04-21,Can Tho City,Cai Rang District,15,14,11,3,0
2022-04-21,Can Tho City,Cai Rang District,16,6,5,1,0
2022-04-21,Can Tho City,Cai Rang District,17,8,8,0,0
2022-04-21,Can Tho City,Cai Rang District,18,11,10,1,0
2022-04-21,Can Tho City,Cai Rang District,19,17,16,1,0
2022-04-21,Can Tho City,Cai Rang District,20,12,10,2,0
2022-04-21,Can Tho City,Cai Rang District,21,7,6,1,0
2022-04-21,Can Tho City,Ninh Kieu District,0,3,1,2,0
2022-04-21,Can Tho City,Ninh Kieu District,1,6,6,0,0
2022-04-21,Can Tho City,Ninh Kieu District,4,1,1,0,0
2022-04-21,Can Tho City,Ninh Kieu District,5,3,3,0,0
2022-04-21,Can Tho City,Ninh Kieu District,6,52,46,6,3
2022-04-21,Can Tho City,Ninh Kieu District,7,154,140,14,1
2022-04-21,Can Tho City,Ninh Kieu District,8,203,190,13,0
2022-04-21,Can Tho City,Ninh Kieu District,9,282,266,16,0
2022-04-21,Can Tho City,Ninh Kieu District,10,569,543,26,0
2022-04-21,Can Tho City,Ninh Kieu District,11,905,869,36,2
2022-04-21,Can Tho City,Ninh Kieu District,12,630,599,31,0
2022-04-21,Can Tho City,Ninh Kieu District,13,496,473,23,0
2022-04-21,Can Tho City,Ninh Kieu District,14,401,384,17,0
2022-04-21,Can Tho City,Ninh Kieu District,15,399,374,25,1
2022-04-21,Can Tho City,Ninh Kieu District,16,431,415,16,0
2022-04-21,Can Tho City,Ninh Kieu District,17,534,506,28,0
2022-04-21,Can Tho City,Ninh Kieu District,18,605,572,33,0
2022-04-21,Can Tho City,Ninh Kieu District,19,432,407,25,0
2022-04-21,Can Tho City,Ninh Kieu District,20,336,319,17,0
2022-04-21,Can Tho City,Ninh Kieu District,21,193,182,11,0
2022-04-21,Can Tho City,Ninh Kieu District,22,2,2,0,0
2022-04-21,Can Tho City,Ninh Kieu District,23,1,0,1,0
2022-04-21,Dong Nai,Bien Hoa City,0,4,0,4,0
2022-04-21,Dong Nai,Bien Hoa City,1,4,3,1,0
2022-04-21,Dong Nai,Bien Hoa City,2,2,2,0,0
2022-04-21,Dong Nai,Bien Hoa City,4,1,1,0,0
2022-04-21,Dong Nai,Bien Hoa City,5,2,2,0,0
2022-04-21,Dong Nai,Bien Hoa City,6,35,17,18,16
2022-04-21,Dong Nai,Bien Hoa City,7,160,128,32,15
2022-04-21,Dong Nai,Bien Hoa City,8,250,229,21,1
2022-04-21,Dong Nai,Bien Hoa City,9,411,366,45,5
2022-04-21,Dong Nai,Bien Hoa City,10,689,625,64,13
2022-04-21,Dong Nai,Bien Hoa City,11,1077,978,99,21
2022-04-21,Dong Nai,Bien Hoa City,12,731,671,60,21
2022-04-21,Dong Nai,Bien Hoa City,13,693,630,63,14
2022-04-21,Dong Nai,Bien Hoa City,14,585,531,54,11
2022-04-21,Dong Nai,Bien Hoa City,15,417,380,37,8
2022-04-21,Dong Nai,Bien Hoa City,16,422,385,37,6
2022-04-21,Dong Nai,Bien Hoa City,17,588,538,50,15
2022-04-21,Dong Nai,Bien Hoa City,18,616,575,41,7
2022-04-21,Dong Nai,Bien Hoa City,19,582,543,39,5
2022-04-21,Dong Nai,Bien Hoa City,20,437,388,49,13
2022-04-21,Dong Nai,Bien Hoa City,21,186,140,46,12
2022-04-21,Dong Nai,Bien Hoa City,22,1,0,1,0
2022-04-21,Dong Nai,Long Thanh,11,3,0,3,3
2022-04-21,Dong Nai,Long Thanh,12,1,0,1,1
2022-04-21,Dong Nai,Long Thanh,13,4,0,4,4
2022-04-21,Dong Nai,Long Thanh,14,1,0,1,1
2022-04-21,Dong Nai,Long Thanh,15,1,0,1,1
2022-04-21,Dong Nai,Long Thanh,18,1,0,1,1
2022-04-21,Dong Nai,Long Thanh,19,1,0,1,1
2022-04-21,Dong Nai,Long Thanh,20,2,0,2,2
2022-04-21,Dong Nai,Thong Nhat,9,2,2,0,0
2022-04-21,Dong Nai,Thong Nhat,10,1,1,0,0
2022-04-21,Dong Nai,Thong Nhat,11,1,1,0,0
2022-04-21,Dong Nai,Thong Nhat,13,2,2,0,0
2022-04-21,Dong Nai,Thong Nhat,14,4,4,0,0
2022-04-21,Dong Nai,Thong Nhat,15,1,1,0,0
2022-04-21,Dong Nai,Thong Nhat,20,2,2,0,0
2022-04-21,Dong Nai,Trang Bom,9,1,0,1,1
2022-04-21,Dong Nai,Trang Bom,15,1,1,0,0
2022-04-21,Dong Nai,Trang Bom,19,1,0,1,1
2022-04-21,Dong Nai,Vinh Cuu,15,2,0,2,2
2022-04-21,Hai Phong City,An Duong,7,1,0,1,1
2022-04-21,Hai Phong City,An Duong,8,2,0,2,2
2022-04-21,Hai Phong City,An Duong,9,5,3,2,1
2022-04-21,Hai Phong City,An Duong,10,1,1,0,0
2022-04-21,Hai Phong City,An Duong,11,2,1,1,1
2022-04-21,Hai Phong City,An Duong,12,4,3,1,1
2022-04-21,Hai Phong City,An Duong,13,4,1,3,3
2022-04-21,Hai Phong City,An Duong,15,3,1,2,2
2022-04-21,Hai Phong City,An Duong,16,2,0,2,2
2022-04-21,Hai Phong City,An Duong,17,3,1,2,1
2022-04-21,Hai Phong City,An Duong,18,3,1,2,1
2022-04-21,Hai Phong City,An Duong,19,4,2,2,0
2022-04-21,Hai Phong City,An Duong,20,2,0,2,2
2022-04-21,Hai Phong City,An Duong,21,1,1,0,0
2022-04-21,Hai Phong City,Hai An District,7,3,3,0,0
2022-04-21,Hai Phong City,Hai An District,8,9,8,1,0
2022-04-21,Hai Phong City,Hai An District,9,6,5,1,0
2022-04-21,Hai Phong City,Hai An District,10,18,17,1,1
2022-04-21,Hai Phong City,Hai An District,11,47,38,9,4
2022-04-21,Hai Phong City,Hai An District,12,23,17,6,2
2022-04-21,Hai Phong City,Hai An District,13,7,5,2,1
2022-04-21,Hai Phong City,Hai An District,14,19,18,1,1
2022-04-21,Hai Phong City,Hai An District,15,18,11,7,0
2022-04-21,Hai Phong City,Hai An District,16,15,13,2,1
2022-04-21,Hai Phong City,Hai An District,17,17,16,1,0
2022-04-21,Hai Phong City,Hai An District,18,33,31,2,0
2022-04-21,Hai Phong City,Hai An District,19,15,13,2,1
2022-04-21,Hai Phong City,Hai An District,20,17,12,5,1
2022-04-21,Hai Phong City,Hai An District,21,6,4,2,2
2022-04-21,Hai Phong City,Hong Bang District,6,1,1,0,0
2022-04-21,Hai Phong City,Hong Bang District,7,10,6,4,3
2022-04-21,Hai Phong City,Hong Bang District,8,24,20,4,1
2022-04-21,Hai Phong City,Hong Bang District,9,38,34,4,1
2022-04-21,Hai Phong City,Hong Bang District,10,42,41,1,0
2022-04-21,Hai Phong City,Hong Bang District,11,84,76,8,0
2022-04-21,Hai Phong City,Hong Bang District,12,57,50,7,0
2022-04-21,Hai Phong City,Hong Bang District,13,37,34,3,2
2022-04-21,Hai Phong City,Hong Bang District,14,20,16,4,0
2022-04-21,Hai Phong City,Hong Bang District,15,40,34,6,0
2022-04-21,Hai Phong City,Hong Bang District,16,28,27,1,0
2022-04-21,Hai Phong City,Hong Bang District,17,52,40,12,2
2022-04-21,Hai Phong City,Hong Bang District,18,64,53,11,4
2022-04-21,Hai Phong City,Hong Bang District,19,48,44,4,0
2022-04-21,Hai Phong City,Hong Bang District,20,20,19,1,0
2022-04-21,Hai Phong City,Hong Bang District,21,11,7,4,3
2022-04-21,Hai Phong City,Kien An District,7,2,0,2,1
2022-04-21,Hai Phong City,Kien An District,8,5,1,4,4
2022-04-21,Hai Phong City,Kien An District,9,3,3,0,0
2022-04-21,Hai Phong City,Kien An District,10,12,7,5,3
2022-04-21,Hai Phong City,Kien An District,11,10,9,1,0
2022-04-21,Hai Phong City,Kien An District,12,11,7,4,4
2022-04-21,Hai Phong City,Kien An District,13,5,4,1,1
2022-04-21,Hai Phong City,Kien An District,14,6,5,1,1
2022-04-21,Hai Phong City,Kien An District,15,14,5,9,7
2022-04-21,Hai Phong City,Kien An District,16,11,5,6,5
2022-04-21,Hai Phong City,Kien An District,17,2,2,0,0
2022-04-21,Hai Phong City,Kien An District,18,13,9,4,3
2022-04-21,Hai Phong City,Kien An District,19,10,8,2,2
2022-04-21,Hai Phong City,Kien An District,20,5,3,2,2
2022-04-21,Hai Phong City,Kien An District,21,1,1,0,0
2022-04-21,Hai Phong City,Le Chan District,1,1,1,0,0
2022-04-21,Hai Phong City,Le Chan District,2,2,1,1,0
2022-04-21,Hai Phong City,Le Chan District,6,1,1,0,0
2022-04-21,Hai Phong City,Le Chan District,7,31,24,7,2
2022-04-21,Hai Phong City,Le Chan District,8,59,53,6,0
2022-04-21,Hai Phong City,Le Chan District,9,66,55,11,0
2022-04-21,Hai Phong City,Le Chan District,10,146,129,17,1
2022-04-21,Hai Phong City,Le Chan District,11,248,225,23,5
2022-04-21,Hai Phong City,Le Chan District,12,193,173,20,0
2022-04-21,Hai Phong City,Le Chan District,13,107,95,12,0
2022-04-21,Hai Phong City,Le Chan District,14,109,101,8,1
2022-04-21,Hai Phong City,Le Chan District,15,139,121,18,0
2022-04-21,Hai Phong City,Le Chan District,16,126,118,8,0
2022-04-21,Hai Phong City,Le Chan District,17,180,163,17,1
2022-04-21,Hai Phong City,Le Chan District,18,212,189,23,6
2022-04-21,Hai Phong City,Le Chan District,19,173,156,17,0
2022-04-21,Hai Phong City,Le Chan District,20,120,104,16,3
2022-04-21,Hai Phong City,Le Chan District,21,57,42,15,5
2022-04-21,Hai Phong City,Le Chan District,22,2,1,1,0
2022-04-21,Hai Phong City,Ngo Quyen District,4,3,2,1,0
2022-04-21,Hai Phong City,Ngo Quyen District,6,1,1,0,0
2022-04-21,Hai Phong City,Ngo Quyen District,7,21,18,3,1
2022-04-21,Hai Phong City,Ngo Quyen District,8,55,51,4,0
2022-04-21,Hai Phong City,Ngo Quyen District,9,52,50,2,0
2022-04-21,Hai Phong City,Ngo Quyen District,10,108,100,8,0
2022-04-21,Hai Phong City,Ngo Quyen District,11,211,187,24,4
2022-04-21,Hai Phong City,Ngo Quyen District,12,147,131,16,0
2022-04-21,Hai Phong City,Ngo Quyen District,13,97,88,9,0
2022-04-21,Hai Phong City,Ngo Quyen District,14,104,98,6,0
2022-04-21,Hai Phong City,Ngo Quyen District,15,94,88,6,0
2022-04-21,Hai Phong City,Ngo Quyen District,16,84,81,3,0
2022-04-21,Hai Phong City,Ngo Quyen District,17,121,111,10,1
2022-04-21,Hai Phong City,Ngo Quyen District,18,151,138,13,4
2022-04-21,Hai Phong City,Ngo Quyen District,19,128,115,13,1
2022-04-21,Hai Phong City,Ngo Quyen District,20,95,82,13,1
2022-04-21,Hai Phong City,Ngo Quyen District,21,58,47,11,4
2022-04-21,Hai Phong City,Thuy Nguyen,8,1,0,1,1
2022-04-21,Hai Phong City,Thuy Nguyen,11,1,0,1,1
2022-04-21,Hai Phong City,Thuy Nguyen,12,3,0,3,3
2022-04-21,Hai Phong City,Thuy Nguyen,13,1,0,1,1
2022-04-21,Hai Phong City,Thuy Nguyen,18,2,0,2,2
2022-04-21,Hai Phong City,Thuy Nguyen,19,1,0,1,1
2022-04-21,Hai Phong City,Thuy Nguyen,20,2,0,2,2
2022-04-21,Hue City,Hue City,0,4,2,2,0
2022-04-21,Hue City,Hue City,1,2,1,1,0
2022-04-21,Hue City,Hue City,2,1,1,0,0
2022-04-21,Hue City,Hue City,3,1,1,0,0
2022-04-21,Hue City,Hue City,5,1,0,1,0
2022-04-21,Hue City,Hue City,6,63,53,10,1
2022-04-21,Hue City,Hue City,7,166,152,14,0
2022-04-21,Hue City,Hue City,8,254,236,18,0
2022-04-21,Hue City,Hue City,9,215,204,11,0
2022-04-21,Hue City,Hue City,10,322,299,23,5
2022-04-21,Hue City,Hue City,11,738,691,47,2
2022-04-21,Hue City,Hue City,12,461,439,22,1
2022-04-21,Hue City,Hue City,13,279,256,23,0
2022-04-21,Hue City,Hue City,14,307,288,19,2
2022-04-21,Hue City,Hue City,15,348,331,17,0
2022-04-21,Hue City,Hue City,16,376,345,31,0
2022-04-21,Hue City,Hue City,17,529,487,42,2
2022-04-21,Hue City,Hue City,18,789,724,65,8
2022-04-21,Hue City,Hue City,19,664,609,55,2
2022-04-21,Hue City,Hue City,20,474,419,55,9
2022-04-21,Hue City,Hue City,21,228,199,29,2
2022-04-21,Hue City,Hue City,22,4,3,1,0
2022-04-21,Hue City,Huong Thuy,10,1,1,0,0
2022-04-21,Hue City,Huong Thuy,11,1,1,0,0
2022-04-21,Hue City,Huong Thuy,15,1,0,1,1
2022-04-21,Hue City,Huong Thuy,17,1,1,0,0
2022-04-21,Hue City,Huong Thuy,18,3,0,3,0
2022-04-21,Hue City,Huong Thuy,20,1,1,0,0
2022-04-21,Hue City,Huong Thuy,21,3,1,2,1
2022-04-21,Hue City,Huong Tra,19,1,0,1,0
2022-04-21,Hue City,Phu Vang,6,1,1,0,0
2022-04-21,Hue City,Phu Vang,7,2,2,0,0
2022-04-21,Hue City,Phu Vang,8,1,1,0,0
2022-04-21,Hue City,Phu Vang,10,4,3,1,0
2022-04-21,Hue City,Phu Vang,11,8,7,1,0
2022-04-21,Hue City,Phu Vang,12,2,1,1,1
2022-04-21,Hue City,Phu Vang,13,2,2,0,0
2022-04-21,Hue City,Phu Vang,16,2,2,0,0
2022-04-21,Hue City,Phu Vang,17,4,2,2,1
2022-04-21,Hue City,Phu Vang,18,2,1,1,0
2022-04-21,Hue City,Phu Vang,19,4,2,2,0
2022-04-21,Hue City,Phu Vang,20,1,1,0,0
2022-04-21,Hue City,Phu Vang,21,3,3,0,0
2022-04-21,Vung Tau,Ba Ria City,7,1,0,1,1
2022-04-21,Vung Tau,Ba Ria City,8,6,2,4,2
2022-04-21,Vung Tau,Ba Ria City,9,14,2,12,10
2022-04-21,Vung Tau,Ba Ria City,10,4,3,1,1
2022-04-21,Vung Tau,Ba Ria City,11,8,4,4,3
2022-04-21,Vung Tau,Ba Ria City,12,6,4,2,2
2022-04-21,Vung Tau,Ba Ria City,13,6,2,4,4
2022-04-21,Vung Tau,Ba Ria City,14,7,3,4,4
2022-04-21,Vung Tau,Ba Ria City,15,6,1,5,3
2022-04-21,Vung Tau,Ba Ria City,16,10,1,9,8
2022-04-21,Vung Tau,Ba Ria City,17,13,3,10,8
2022-04-21,Vung Tau,Ba Ria City,18,8,1,7,7
2022-04-21,Vung Tau,Ba Ria City,19,2,1,1,1
2022-04-21,Vung Tau,Ba Ria City,20,2,0,2,2
2022-04-21,Vung Tau,Ba Ria City,21,1,0,1,1
2022-04-21,Vung Tau,Vung Tau City,2,1,1,0,0
2022-04-21,Vung Tau,Vung Tau City,5,1,1,0,0
2022-04-21,Vung Tau,Vung Tau City,6,34,29,5,4
2022-04-21,Vung Tau,Vung Tau City,7,106,95,11,3
2022-04-21,Vung Tau,Vung Tau City,8,137,126,11,1
2022-04-21,Vung Tau,Vung Tau City,9,145,139,6,0
2022-04-21,Vung Tau,Vung Tau City,10,166,151,15,1
2022-04-21,Vung Tau,Vung Tau City,11,381,348,33,3
2022-04-21,Vung Tau,Vung Tau City,12,241,226,15,0
2022-04-21,Vung Tau,Vung Tau City,13,202,181,21,1
2022-04-21,Vung Tau,Vung Tau City,14,206,191,15,3
2022-04-21,Vung Tau,Vung Tau City,15,203,192,11,1
2022-04-21,Vung Tau,Vung Tau City,16,171,163,8,2
2022-04-21,Vung Tau,Vung Tau City,17,253,240,13,1
2022-04-21,Vung Tau,Vung Tau City,18,281,260,21,1
2022-04-21,Vung Tau,Vung Tau City,19,268,245,23,1
2022-04-21,Vung Tau,Vung Tau City,20,167,147,20,3
2022-04-21,Vung Tau,Vung Tau City,21,89,71,18,8
2022-04-21,Vung Tau,Vung Tau City,22,1,0,1,0
2022-04-21,Vung Tau,Vung Tau City,23,4,3,1,0
2022-04-22,Binh Duong,Ben Cat,7,1,0,1,1
2022-04-22,Binh Duong,Ben Cat,12,2,2,0,0
2022-04-22,Binh Duong,Ben Cat,13,2,1,1,1
2022-04-22,Binh Duong,Ben Cat,15,1,0,1,1
2022-04-22,Binh Duong,Ben Cat,18,1,0,1,1
2022-04-22,Binh Duong,Ben Cat,19,3,0,3,2
2022-04-22,Binh Duong,Di An,6,1,0,1,1
2022-04-22,Binh Duong,Di An,7,4,1,3,2
2022-04-22,Binh Duong,Di An,8,13,7,6,4
2022-04-22,Binh Duong,Di An,9,13,11,2,2
2022-04-22,Binh Duong,Di An,10,33,19,14,7
2022-04-22,Binh Duong,Di An,11,44,24,20,16
2022-04-22,Binh Duong,Di An,12,39,27,12,7
2022-04-22,Binh Duong,Di An,13,26,20,6,5
2022-04-22,Binh Duong,Di An,14,29,7,22,9
2022-04-22,Binh Duong,Di An,15,18,13,5,4
2022-04-22,Binh Duong,Di An,16,18,9,9,8
2022-04-22,Binh Duong,Di An,17,35,16,19,11
2022-04-22,Binh Duong,Di An,18,31,20,11,8
2022-04-22,Binh Duong,Di An,19,24,13,11,9
2022-04-22,Binh Duong,Di An,20,13,7,6,2
2022-04-22,Binh Duong,Di An,21,9,1,8,7
2022-04-22,Binh Duong,Di An,22,1,1,0,0
2022-04-22,Binh Duong,Di An,23,1,0,1,1
2022-04-22,Binh Duong,Tan Uyen,8,1,0,1,1
2022-04-22,Binh Duong,Tan Uyen,10,2,1,1,0
2022-04-22,Binh Duong,Tan Uyen,11,5,5,0,0
2022-04-22,Binh Duong,Tan Uyen,12,1,1,0,0
2022-04-22,Binh Duong,Tan Uyen,13,1,1,0,0
2022-04-22,Binh Duong,Tan Uyen,16,1,1,0,0
2022-04-22,Binh Duong,Tan Uyen,18,3,3,0,0
2022-04-22,Binh Duong,Tan Uyen,20,4,3,1,1
2022-04-22,Binh Duong,Tan Uyen,21,2,0,2,2
2022-04-22,Binh Duong,Thu Dau Mot Town,1,1,1,0,0
2022-04-22,Binh Duong,Thu Dau Mot Town,5,3,2,1,0
2022-04-22,Binh Duong,Thu Dau Mot Town,6,31,26,5,1
2022-04-22,Binh Duong,Thu Dau Mot Town,7,109,106,3,1
2022-04-22,Binh Duong,Thu Dau Mot Town,8,238,212,26,3
2022-04-22,Binh Duong,Thu Dau Mot Town,9,224,211,13,3
2022-04-22,Binh Duong,Thu Dau Mot Town,10,369,352,17,1
2022-04-22,Binh Duong,Thu Dau Mot Town,11,655,618,37,5
2022-04-22,Binh Duong,Thu Dau Mot Town,12,468,432,36,1
2022-04-22,Binh Duong,Thu Dau Mot Town,13,465,418,47,2
2022-04-22,Binh Duong,Thu Dau Mot Town,14,354,324,30,1
2022-04-22,Binh Duong,Thu Dau Mot Town,15,276,258,18,2
2022-04-22,Binh Duong,Thu Dau Mot Town,16,244,227,17,0
2022-04-22,Binh Duong,Thu Dau Mot Town,17,358,336,22,3
2022-04-22,Binh Duong,Thu Dau Mot Town,18,341,319,22,2
2022-04-22,Binh Duong,Thu Dau Mot Town,19,330,299,31,1
2022-04-22,Binh Duong,Thu Dau Mot Town,20,268,241,27,8
2022-04-22,Binh Duong,Thu Dau Mot Town,21,110,100,10,2
2022-04-22,Binh Duong,Thuan An,4,1,0,1,0
2022-04-22,Binh Duong,Thuan An,7,13,5,8,5
2022-04-22,Binh Duong,Thuan An,8,21,13,8,3
2022-04-22,Binh Duong,Thuan An,9,35,21,14,9
2022-04-22,Binh Duong,Thuan An,10,68,49,19,9
2022-04-22,Binh Duong,Thuan An,11,68,56,12,9
2022-04-22,Binh Duong,Thuan An,12,63,53,10,7
2022-04-22,Binh Duong,Thuan An,13,48,43,5,1
2022-04-22,Binh Duong,Thuan An,14,68,45,23,10
2022-04-22,Binh Duong,Thuan An,15,33,24,9,7
2022-04-22,Binh Duong,Thuan An,16,31,28,3,2
2022-04-22,Binh Duong,Thuan An,17,40,31,9,6
2022-04-22,Binh Duong,Thuan An,18,59,46,13,8
2022-04-22,Binh Duong,Thuan An,19,32,28,4,2
2022-04-22,Binh Duong,Thuan An,20,23,16,7,5
2022-04-22,Binh Duong,Thuan An,21,12,1,11,6
2022-04-22,Binh Duong,Thuan An,22,1,0,1,0
2022-04-22,Can Tho City,Binh Thuy District,5,1,1,0,0
2022-04-22,Can Tho City,Binh Thuy District,6,1,1,0,0
2022-04-22,Can Tho City,Binh Thuy District,7,2,1,1,1
2022-04-22,Can Tho City,Binh Thuy District,8,3,3,0,0
2022-04-22,Can Tho City,Binh Thuy District,9,5,5,0,0
2022-04-22,Can Tho City,Binh Thuy District,10,6,6,0,0
2022-04-22,Can Tho City,Binh Thuy District,11,20,17,3,0
2022-04-22,Can Tho City,Binh Thuy District,12,13,12,1,0
2022-04-22,Can Tho City,Binh Thuy District,13,14,14,0,0
2022-04-22,Can Tho City,Binh Thuy District,14,9,8,1,1
2022-04-22,Can Tho City,Binh Thuy District,15,16,15,1,0
2022-04-22,Can Tho City,Binh Thuy District,16,11,9,2,0
2022-04-22,Can Tho City,Binh Thuy District,17,16,14,2,0
2022-04-22,Can Tho City,Binh Thuy District,18,10,9,1,0
2022-04-22,Can Tho City,Binh Thuy District,19,10,9,1,0
2022-04-22,Can Tho City,Binh Thuy District,20,12,10,2,0
2022-04-22,Can Tho City,Binh Thuy District,21,2,2,0,0
2022-04-22,Can Tho City,Cai Rang District,1,1,1,0,0
2022-04-22,Can Tho City,Cai Rang District,7,4,4,0,0
2022-04-22,Can Tho City,Cai Rang District,8,5,5,0,0
2022-04-22,Can Tho City,Cai Rang District,9,7,7,0,0
2022-04-22,Can Tho City,Cai Rang District,10,17,14,3,0
2022-04-22,Can Tho City,Cai Rang District,11,16,16,0,0
2022-04-22,Can Tho City,Cai Rang District,12,19,18,1,1
2022-04-22,Can Tho City,Cai Rang District,13,17,16,1,0
2022-04-22,Can Tho City,Cai Rang District,14,5,4,1,0
2022-04-22,Can Tho City,Cai Rang District,15,5,4,1,0
2022-04-22,Can Tho City,Cai Rang District,16,11,10,1,0
2022-04-22,Can Tho City,Cai Rang District,17,15,13,2,0
2022-04-22,Can Tho City,Cai Rang District,18,13,12,1,0
2022-04-22,Can Tho City,Cai Rang District,19,9,8,1,0
2022-04-22,Can Tho City,Cai Rang District,20,13,11,2,1
2022-04-22,Can Tho City,Cai Rang District,21,5,4,1,0
2022-04-22,Can Tho City,Ninh Kieu District,0,4,3,1,0
2022-04-22,Can Tho City,Ninh Kieu District,1,6,2,4,0
2022-04-22,Can Tho City,Ninh Kieu District,4,2,2,0,0
2022-04-22,Can Tho City,Ninh Kieu District,5,1,1,0,0
2022-04-22,Can Tho City,Ninh Kieu District,6,51,46,5,1
2022-04-22,Can Tho City,Ninh Kieu District,7,137,132,5,0
2022-04-22,Can Tho City,Ninh Kieu District,8,243,225,18,0
2022-04-22,Can Tho City,Ninh Kieu District,9,331,310,21,0
2022-04-22,Can Tho City,Ninh Kieu District,10,592,577,15,0
2022-04-22,Can Tho City,Ninh Kieu District,11,941,898,43,2
2022-04-22,Can Tho City,Ninh Kieu District,12,650,616,34,0
2022-04-22,Can Tho City,Ninh Kieu District,13,535,498,37,0
2022-04-22,Can Tho City,Ninh Kieu District,14,452,433,19,0
2022-04-22,Can Tho City,Ninh Kieu District,15,375,349,26,0
2022-04-22,Can Tho City,Ninh Kieu District,16,395,382,13,1
2022-04-22,Can Tho City,Ninh Kieu District,17,599,574,25,0
2022-04-22,Can Tho City,Ninh Kieu District,18,597,571,26,0
2022-04-22,Can Tho City,Ninh Kieu District,19,476,461,15,0
2022-04-22,Can Tho City,Ninh Kieu District,20,388,360,28,1
2022-04-22,Can Tho City,Ninh Kieu District,21,231,209,22,0
2022-04-22,Can Tho City,Ninh Kieu District,22,8,4,4,0
2022-04-22,Can Tho City,Ninh Kieu District,23,2,1,1,1
2022-04-22,Dong Nai,Bien Hoa City,0,1,0,1,0
2022-04-22,Dong Nai,Bien Hoa City,2,1,1,0,0
2022-04-22,Dong Nai,Bien Hoa City,4,4,3,1,0
2022-04-22,Dong Nai,Bien Hoa City,5,1,1,0,0
2022-04-22,Dong Nai,Bien Hoa City,6,39,31,8,7
2022-04-22,Dong Nai,Bien Hoa City,7,129,112,17,2
2022-04-22,Dong Nai,Bien Hoa City,8,294,268,26,2
2022-04-22,Dong Nai,Bien Hoa City,9,410,371,39,6
2022-04-22,Dong Nai,Bien Hoa City,10,706,652,54,16
2022-04-22,Dong Nai,Bien Hoa City,11,1071,966,105,22
2022-04-22,Dong Nai,Bien Hoa City,12,829,758,71,13
2022-04-22,Dong Nai,Bien Hoa City,13,827,754,73,29
2022-04-22,Dong Nai,Bien Hoa City,14,633,572,61,13
2022-04-22,Dong Nai,Bien Hoa City,15,505,459,46,7
2022-04-22,Dong Nai,Bien Hoa City,16,475,430,45,14
2022-04-22,Dong Nai,Bien Hoa City,17,592,526,66,26
2022-04-22,Dong Nai,Bien Hoa City,18,646,588,58,11
2022-04-22,Dong Nai,Bien Hoa City,19,629,593,36,5
2022-04-22,Dong Nai,Bien Hoa City,20,492,431,61,11
2022-04-22,Dong Nai,Bien Hoa City,21,220,173,47,19
2022-04-22,Dong Nai,Bien Hoa City,22,2,1,1,0
2022-04-22,Dong Nai,Bien Hoa City,23,3,2,1,1
2022-04-22,Dong Nai,Cam My,15,1,0,1,0
2022-04-22,Dong Nai,Long Khanh,13,1,0,1,1
2022-04-22,Dong Nai,Long Thanh,9,1,0,1,1
2022-04-22,Dong Nai,Long Thanh,12,3,0,3,3
2022-04-22,Dong Nai,Long Thanh,16,1,0,1,1
2022-04-22,Dong Nai,Long Thanh,18,1,0,1,1
2022-04-22,Dong Nai,Nhon trach,10,1,0,1,1
2022-04-22,Dong Nai,Nhon trach,12,1,0,1,1
2022-04-22,Dong Nai,Nhon trach,16,1,0,1,1
2022-04-22,Dong Nai,Thong Nhat,10,1,1,0,0
2022-04-22,Dong Nai,Thong Nhat,11,2,2,0,0
2022-04-22,Dong Nai,Thong Nhat,12,1,1,0,0
2022-04-22,Dong Nai,Thong Nhat,13,1,1,0,0
2022-04-22,Dong Nai,Thong Nhat,15,2,2,0,0
2022-04-22,Dong Nai,Thong Nhat,19,1,1,0,0
2022-04-22,Dong Nai,Trang Bom,10,1,0,1,1
2022-04-22,Dong Nai,Trang Bom,13,2,1,1,1
2022-04-22,Dong Nai,Trang Bom,18,4,0,4,4
2022-04-22,Dong Nai,Trang Bom,19,1,0,1,1
2022-04-22,Dong Nai,Trang Bom,20,1,0,1,0
2022-04-22,Dong Nai,Trang Bom,21,1,0,1,1
2022-04-22,Hai Phong City,An Duong,8,1,0,1,0
2022-04-22,Hai Phong City,An Duong,9,2,1,1,1
2022-04-22,Hai Phong City,An Duong,10,4,2,2,2
2022-04-22,Hai Phong City,An Duong,11,10,4,6,5
2022-04-22,Hai Phong City,An Duong,12,2,2,0,0
2022-04-22,Hai Phong City,An Duong,13,3,0,3,2
2022-04-22,Hai Phong City,An Duong,14,9,3,6,3
2022-04-22,Hai Phong City,An Duong,15,5,2,3,2
2022-04-22,Hai Phong City,An Duong,17,4,1,3,2
2022-04-22,Hai Phong City,An Duong,18,4,2,2,2
2022-04-22,Hai Phong City,An Duong,19,3,0,3,3
2022-04-22,Hai Phong City,An Duong,20,1,0,1,1
2022-04-22,Hai Phong City,Duong Kinh District,15,1,0,1,1
2022-04-22,Hai Phong City,Duong Kinh District,20,1,0,1,1
2022-04-22,Hai Phong City,Duong Kinh District,21,1,0,1,1
2022-04-22,Hai Phong City,Hai An District,7,6,3,3,2
2022-04-22,Hai Phong City,Hai An District,8,10,6,4,2
2022-04-22,Hai Phong City,Hai An District,9,11,5,6,0
2022-04-22,Hai Phong City,Hai An District,10,21,17,4,1
2022-04-22,Hai Phong City,Hai An District,11,42,40,2,1
2022-04-22,Hai Phong City,Hai An District,12,31,26,5,1
2022-04-22,Hai Phong City,Hai An District,13,15,11,4,1
2022-04-22,Hai Phong City,Hai An District,14,22,18,4,3
2022-04-22,Hai Phong City,Hai An District,15,12,10,2,1
2022-04-22,Hai Phong City,Hai An District,16,9,9,0,0
2022-04-22,Hai Phong City,Hai An District,17,20,16,4,1
2022-04-22,Hai Phong City,Hai An District,18,25,23,2,1
2022-04-22,Hai Phong City,Hai An District,19,27,22,5,2
2022-04-22,Hai Phong City,Hai An District,20,12,9,3,1
2022-04-22,Hai Phong City,Hai An District,21,6,2,4,0
2022-04-22,Hai Phong City,Hong Bang District,6,2,1,1,1
2022-04-22,Hai Phong City,Hong Bang District,7,14,11,3,2
2022-04-22,Hai Phong City,Hong Bang District,8,25,24,1,0
2022-04-22,Hai Phong City,Hong Bang District,9,19,19,0,0
2022-04-22,Hai Phong City,Hong Bang District,10,51,45,6,0
2022-04-22,Hai Phong City,Hong Bang District,11,82,74,8,1
2022-04-22,Hai Phong City,Hong Bang District,12,41,39,2,1
2022-04-22,Hai Phong City,Hong Bang District,13,30,27,3,1
2022-04-22,Hai Phong City,Hong Bang District,14,40,32,8,1
2022-04-22,Hai Phong City,Hong Bang District,15,33,30,3,0
2022-04-22,Hai Phong City,Hong Bang District,16,32,31,1,0
2022-04-22,Hai Phong City,Hong Bang District,17,48,40,8,0
2022-04-22,Hai Phong City,Hong Bang District,18,49,48,1,0
2022-04-22,Hai Phong City,Hong Bang District,19,58,50,8,4
2022-04-22,Hai Phong City,Hong Bang District,20,28,27,1,0
2022-04-22,Hai Phong City,Hong Bang District,21,19,15,4,2
2022-04-22,Hai Phong City,Hong Bang District,23,1,1,0,0
2022-04-22,Hai Phong City,Kien An District,6,1,0,1,1
2022-04-22,Hai Phong City,Kien An District,7,3,0,3,3
2022-04-22,Hai Phong City,Kien An District,8,4,2,2,2
2022-04-22,Hai Phong City,Kien An District,9,6,3,3,3
2022-04-22,Hai Phong City,Kien An District,10,5,2,3,0
2022-04-22,Hai Phong City,Kien An District,11,20,12,8,7
2022-04-22,Hai Phong City,Kien An District,12,14,11,3,2
2022-04-22,Hai Phong City,Kien An District,13,3,1,2,2
2022-04-22,Hai Phong City,Kien An District,14,4,3,1,0
2022-04-22,Hai Phong City,Kien An District,15,11,4,7,6
2022-04-22,Hai Phong City,Kien An District,16,8,4,4,3
2022-04-22,Hai Phong City,Kien An District,17,2,2,0,0
2022-04-22,Hai Phong City,Kien An District,18,4,4,0,0
2022-04-22,Hai Phong City,Kien An District,19,10,5,5,5
2022-04-22,Hai Phong City,Kien An District,20,14,5,9,6
2022-04-22,Hai Phong City,Kien An District,21,1,1,0,0
2022-04-22,Hai Phong City,Le Chan District,1,2,1,1,0
2022-04-22,Hai Phong City,Le Chan District,7,23,19,4,1
2022-04-22,Hai Phong City,Le Chan District,8,55,51,4,0
2022-04-22,Hai Phong City,Le Chan District,9,64,59,5,0
2022-04-22,Hai Phong City,Le Chan District,10,118,104,14,1
2022-04-22,Hai Phong City,Le Chan District,11,282,266,16,2
2022-04-22,Hai Phong City,Le Chan District,12,172,155,17,0
2022-04-22,Hai Phong City,Le Chan District,13,118,105,13,1
2022-04-22,Hai Phong City,Le Chan District,14,121,101,20,4
2022-04-22,Hai Phong City,Le Chan District,15,143,126,17,0
2022-04-22,Hai Phong City,Le Chan District,16,131,120,11,1
2022-04-22,Hai Phong City,Le Chan District,17,159,140,19,0
2022-04-22,Hai Phong City,Le Chan District,18,198,176,22,1
2022-04-22,Hai Phong City,Le Chan District,19,188,168,20,3
2022-04-22,Hai Phong City,Le Chan District,20,131,114,17,1
2022-04-22,Hai Phong City,Le Chan District,21,81,62,19,4
2022-04-22,Hai Phong City,Le Chan District,23,3,1,2,0
2022-04-22,Hai Phong City,Ngo Quyen District,0,1,1,0,0
2022-04-22,Hai Phong City,Ngo Quyen District,6,1,0,1,1
2022-04-22,Hai Phong City,Ngo Quyen District,7,17,11,6,4
2022-04-22,Hai Phong City,Ngo Quyen District,8,47,43,4,0
2022-04-22,Hai Phong City,Ngo Quyen District,9,51,48,3,0
2022-04-22,Hai Phong City,Ngo Quyen District,10,113,106,7,0
2022-04-22,Hai Phong City,Ngo Quyen District,11,236,219,17,4
2022-04-22,Hai Phong City,Ngo Quyen District,12,150,140,10,0
2022-04-22,Hai Phong City,Ngo Quyen District,13,86,78,8,0
2022-04-22,Hai Phong City,Ngo Quyen District,14,111,98,13,2
2022-04-22,Hai Phong City,Ngo Quyen District,15,106,97,9,1
2022-04-22,Hai Phong City,Ngo Quyen District,16,112,105,7,0
2022-04-22,Hai Phong City,Ngo Quyen District,17,132,121,11,0
2022-04-22,Hai Phong City,Ngo Quyen District,18,131,122,9,1
2022-04-22,Hai Phong City,Ngo Quyen District,19,155,134,21,3
2022-04-22,Hai Phong City,Ngo Quyen District,20,102,90,12,0
2022-04-22,Hai Phong City,Ngo Quyen District,21,56,42,14,5
2022-04-22,Hai Phong City,Ngo Quyen District,23,3,1,2,1
2022-04-22,Hai Phong City,Thuy Nguyen,10,1,0,1,1
2022-04-22,Hai Phong City,Thuy Nguyen,11,1,0,1,0
2022-04-22,Hai Phong City,Thuy Nguyen,12,4,0,4,4
2022-04-22,Hai Phong City,Thuy Nguyen,14,1,1,0,0
2022-04-22,Hai Phong City,Thuy Nguyen,17,2,0,2,2
2022-04-22,Hai Phong City,Thuy Nguyen,20,1,0,1,1
2022-04-22,Hue City,Hue City,0,5,2,3,0
2022-04-22,Hue City,Hue City,1,4,2,2,0
2022-04-22,Hue City,Hue City,2,1,0,1,0
2022-04-22,Hue City,Hue City,3,4,3,1,0
2022-04-22,Hue City,Hue City,5,2,1,1,0
2022-04-22,Hue City,Hue City,6,53,50,3,0
2022-04-22,Hue City,Hue City,7,186,170,16,1
2022-04-22,Hue City,Hue City,8,282,266,16,0
2022-04-22,Hue City,Hue City,9,236,215,21,0
2022-04-22,Hue City,Hue City,10,405,373,32,1
2022-04-22,Hue City,Hue City,11,860,808,52,1
2022-04-22,Hue City,Hue City,12,605,566,39,3
2022-04-22,Hue City,Hue City,13,296,275,21,1
2022-04-22,Hue City,Hue City,14,379,348,31,0
2022-04-22,Hue City,Hue City,15,409,384,25,2
2022-04-22,Hue City,Hue City,16,376,353,23,2
2022-04-22,Hue City,Hue City,17,551,514,37,5
2022-04-22,Hue City,Hue City,18,603,565,38,1
2022-04-22,Hue City,Hue City,19,611,570,41,2
2022-04-22,Hue City,Hue City,20,439,386,53,1
2022-04-22,Hue City,Hue City,21,257,214,43,9
2022-04-22,Hue City,Hue City,22,3,2,1,0
2022-04-22,Hue City,Hue City,23,2,0,2,0
2022-04-22,Hue City,Huong Thuy,9,1,1,0,0
2022-04-22,Hue City,Huong Thuy,11,1,1,0,0
2022-04-22,Hue City,Huong Thuy,12,1,1,0,0
2022-04-22,Hue City,Huong Thuy,17,1,0,1,0
2022-04-22,Hue City,Huong Thuy,19,1,1,0,0
2022-04-22,Hue City,Huong Thuy,21,2,1,1,0
2022-04-22,Hue City,Huong Tra,7,2,1,1,1
2022-04-22,Hue City,Huong Tra,8,1,1,0,0
2022-04-22,Hue City,Huong Tra,10,1,0,1,1
2022-04-22,Hue City,Huong Tra,17,1,0,1,0
2022-04-22,Hue City,Huong Tra,19,1,0,1,0
2022-04-22,Hue City,Phu Vang,6,2,2,0,0
2022-04-22,Hue City,Phu Vang,9,1,0,1,0
2022-04-22,Hue City,Phu Vang,11,3,3,0,0
2022-04-22,Hue City,Phu Vang,12,4,2,2,0
2022-04-22,Hue City,Phu Vang,13,2,1,1,1
2022-04-22,Hue City,Phu Vang,14,1,1,0,0
2022-04-22,Hue City,Phu Vang,15,1,0,1,1
2022-04-22,Hue City,Phu Vang,16,1,0,1,0
2022-04-22,Hue City,Phu Vang,17,2,2,0,0
2022-04-22,Hue City,Phu Vang,18,2,2,0,0
2022-04-22,Hue City,Phu Vang,20,1,1,0,0
2022-04-22,Vung Tau,Ba Ria City,7,1,0,1,1
2022-04-22,Vung Tau,Ba Ria City,8,3,0,3,3
2022-04-22,Vung Tau,Ba Ria City,9,3,3,0,0
2022-04-22,Vung Tau,Ba Ria City,10,8,6,2,2
2022-04-22,Vung Tau,Ba Ria City,11,15,8,7,3
2022-04-22,Vung Tau,Ba Ria City,12,6,6,0,0
2022-04-22,Vung Tau,Ba Ria City,13,6,4,2,0
2022-04-22,Vung Tau,Ba Ria City,14,7,2,5,1
2022-04-22,Vung Tau,Ba Ria City,15,3,3,0,0
2022-04-22,Vung Tau,Ba Ria City,16,7,3,4,3
2022-04-22,Vung Tau,Ba Ria City,17,7,4,3,2
2022-04-22,Vung Tau,Ba Ria City,18,4,3,1,0
2022-04-22,Vung Tau,Ba Ria City,19,4,1,3,0
2022-04-22,Vung Tau,Ba Ria City,20,3,0,3,1
2022-04-22,Vung Tau,Ba Ria City,21,1,0,1,1
2022-04-22,Vung Tau,Vung Tau City,1,1,0,1,0
2022-04-22,Vung Tau,Vung Tau City,6,37,34,3,1
2022-04-22,Vung Tau,Vung Tau City,7,89,80,9,1
2022-04-22,Vung Tau,Vung Tau City,8,123,114,9,1
2022-04-22,Vung Tau,Vung Tau City,9,167,155,12,0
2022-04-22,Vung Tau,Vung Tau City,10,173,159,14,1
2022-04-22,Vung Tau,Vung Tau City,11,356,326,30,1
2022-04-22,Vung Tau,Vung Tau City,12,261,250,11,1
2022-04-22,Vung Tau,Vung Tau City,13,187,177,10,0
2022-04-22,Vung Tau,Vung Tau City,14,198,188,10,1
2022-04-22,Vung Tau,Vung Tau City,15,181,174,7,0
2022-04-22,Vung Tau,Vung Tau City,16,183,159,24,4
2022-04-22,Vung Tau,Vung Tau City,17,242,224,18,0
2022-04-22,Vung Tau,Vung Tau City,18,311,285,26,1
2022-04-22,Vung Tau,Vung Tau City,19,263,240,23,3
2022-04-22,Vung Tau,Vung Tau City,20,211,190,21,3
2022-04-22,Vung Tau,Vung Tau City,21,85,73,12,2
2022-04-22,Vung Tau,Vung Tau City,22,1,1,0,0
2022-04-22,Vung Tau,Vung Tau City,23,1,1,0,0
2022-04-23,Binh Duong,Ben Cat,11,1,1,0,0
2022-04-23,Binh Duong,Ben Cat,12,1,0,1,1
2022-04-23,Binh Duong,Ben Cat,15,4,2,2,1
2022-04-23,Binh Duong,Ben Cat,18,1,0,1,1
2022-04-23,Binh Duong,Ben Cat,19,2,0,2,0
2022-04-23,Binh Duong,Di An,7,12,0,12,12
2022-04-23,Binh Duong,Di An,8,26,8,18,13
2022-04-23,Binh Duong,Di An,9,27,11,16,12
2022-04-23,Binh Duong,Di An,10,35,17,18,10
2022-04-23,Binh Duong,Di An,11,46,29,17,13
2022-04-23,Binh Duong,Di An,12,32,24,8,4
2022-04-23,Binh Duong,Di An,13,33,16,17,12
2022-04-23,Binh Duong,Di An,14,25,13,12,11
2022-04-23,Binh Duong,Di An,15,21,15,6,5
2022-04-23,Binh Duong,Di An,16,22,11,11,7
2022-04-23,Binh Duong,Di An,17,14,11,3,2
2022-04-23,Binh Duong,Di An,18,30,20,10,7
2022-04-23,Binh Duong,Di An,19,30,19,11,9
2022-04-23,Binh Duong,Di An,20,20,15,5,4
2022-04-23,Binh Duong,Di An,21,11,6,5,2
2022-04-23,Binh Duong,Tan Uyen,8,3,2,1,1
2022-04-23,Binh Duong,Tan Uyen,9,2,1,1,1
2022-04-23,Binh Duong,Tan Uyen,10,3,3,0,0
2022-04-23,Binh Duong,Tan Uyen,11,2,2,0,0
2022-04-23,Binh Duong,Tan Uyen,12,1,0,1,1
2022-04-23,Binh Duong,Tan Uyen,13,2,0,2,2
2022-04-23,Binh Duong,Tan Uyen,14,2,0,2,1
2022-04-23,Binh Duong,Tan Uyen,16,2,0,2,0
2022-04-23,Binh Duong,Tan Uyen,17,3,0,3,3
2022-04-23,Binh Duong,Tan Uyen,18,6,1,5,5
2022-04-23,Binh Duong,Tan Uyen,19,2,2,0,0
2022-04-23,Binh Duong,Tan Uyen,20,1,0,1,1
2022-04-23,Binh Duong,Tan Uyen,21,3,0,3,3
2022-04-23,Binh Duong,Thu Dau Mot Town,5,1,0,1,1
2022-04-23,Binh Duong,Thu Dau Mot Town,6,29,26,3,3
2022-04-23,Binh Duong,Thu Dau Mot Town,7,154,147,7,1
2022-04-23,Binh Duong,Thu Dau Mot Town,8,230,218,12,0
2022-04-23,Binh Duong,Thu Dau Mot Town,9,263,240,23,0
2022-04-23,Binh Duong,Thu Dau Mot Town,10,426,398,28,3
2022-04-23,Binh Duong,Thu Dau Mot Town,11,673,634,39,1
2022-04-23,Binh Duong,Thu Dau Mot Town,12,534,496,38,0
2022-04-23,Binh Duong,Thu Dau Mot Town,13,452,428,24,1
2022-04-23,Binh Duong,Thu Dau Mot Town,14,375,343,32,0
2022-04-23,Binh Duong,Thu Dau Mot Town,15,277,260,17,0
2022-04-23,Binh Duong,Thu Dau Mot Town,16,274,257,17,3
2022-04-23,Binh Duong,Thu Dau Mot Town,17,321,308,13,1
2022-04-23,Binh Duong,Thu Dau Mot Town,18,429,408,21,3
2022-04-23,Binh Duong,Thu Dau Mot Town,19,357,340,17,1
2022-04-23,Binh Duong,Thu Dau Mot Town,20,252,232,20,2
2022-04-23,Binh Duong,Thu Dau Mot Town,21,125,109,16,4
2022-04-23,Binh Duong,Thu Dau Mot Town,23,1,0,1,0
2022-04-23,Binh Duong,Thuan An,6,1,1,0,0
2022-04-23,Binh Duong,Thuan An,7,7,3,4,3
2022-04-23,Binh Duong,Thuan An,8,19,12,7,3
2022-04-23,Binh Duong,Thuan An,9,36,29,7,4
2022-04-23,Binh Duong,Thuan An,10,63,40,23,13
2022-04-23,Binh Duong,Thuan An,11,62,52,10,7
2022-04-23,Binh Duong,Thuan An,12,58,44,14,8
2022-04-23,Binh Duong,Thuan An,13,54,45,9,5
2022-04-23,Binh Duong,Thuan An,14,58,42,16,7
2022-04-23,Binh Duong,Thuan An,15,44,30,14,7
2022-04-23,Binh Duong,Thuan An,16,37,29,8,3
2022-04-23,Binh Duong,Thuan An,17,32,29,3,1
2022-04-23,Binh Duong,Thuan An,18,45,35,10,7
2022-04-23,Binh Duong,Thuan An,19,51,38,13,11
2022-04-23,Binh Duong,Thuan An,20,44,29,15,9
2022-04-23,Binh Duong,Thuan An,21,18,3,15,12
2022-04-23,Can Tho City,Binh Thuy District,1,1,0,1,0
2022-04-23,Can Tho City,Binh Thuy District,6,3,2,1,0
2022-04-23,Can Tho City,Binh Thuy District,7,3,2,1,1
2022-04-23,Can Tho City,Binh Thuy District,8,8,6,2,0
2022-04-23,Can Tho City,Binh Thuy District,9,8,8,0,0
2022-04-23,Can Tho City,Binh Thuy District,10,10,10,0,0
2022-04-23,Can Tho City,Binh Thuy District,11,14,12,2,0
2022-04-23,Can Tho City,Binh Thuy District,12,19,16,3,0
2022-04-23,Can Tho City,Binh Thuy District,13,9,7,2,1
2022-04-23,Can Tho City,Binh Thuy District,14,11,10,1,0
2022-04-23,Can Tho City,Binh Thuy District,15,13,13,0,0
2022-04-23,Can Tho City,Binh Thuy District,16,14,12,2,0
2022-04-23,Can Tho City,Binh Thuy District,17,12,12,0,0
2022-04-23,Can Tho City,Binh Thuy District,18,13,13,0,0
2022-04-23,Can Tho City,Binh Thuy District,19,10,10,0,0
2022-04-23,Can Tho City,Binh Thuy District,20,6,6,0,0
2022-04-23,Can Tho City,Binh Thuy District,21,5,2,3,0
2022-04-23,Can Tho City,Cai Rang District,6,1,0,1,1
2022-04-23,Can Tho City,Cai Rang District,7,7,7,0,0
2022-04-23,Can Tho City,Cai Rang District,8,10,10,0,0
2022-04-23,Can Tho City,Cai Rang District,9,7,5,2,0
2022-04-23,Can Tho City,Cai Rang District,10,8,7,1,0
2022-04-23,Can Tho City,Cai Rang District,11,16,15,1,0
2022-04-23,Can Tho City,Cai Rang District,12,14,12,2,1
2022-04-23,Can Tho City,Cai Rang District,13,12,12,0,0
2022-04-23,Can Tho City,Cai Rang District,14,9,9,0,0
2022-04-23,Can Tho City,Cai Rang District,15,14,12,2,2
2022-04-23,Can Tho City,Cai Rang District,16,14,14,0,0
2022-04-23,Can Tho City,Cai Rang District,17,19,17,2,0
2022-04-23,Can Tho City,Cai Rang District,18,14,12,2,0
2022-04-23,Can Tho City,Cai Rang District,19,13,13,0,0
2022-04-23,Can Tho City,Cai Rang District,20,9,8,1,0
2022-04-23,Can Tho City,Cai Rang District,21,2,1,1,1
2022-04-23,Can Tho City,Ninh Kieu District,0,5,2,3,0
2022-04-23,Can Tho City,Ninh Kieu District,1,2,2,0,0
2022-04-23,Can Tho City,Ninh Kieu District,2,1,1,0,0
2022-04-23,Can Tho City,Ninh Kieu District,3,3,3,0,0
2022-04-23,Can Tho City,Ninh Kieu District,5,1,0,1,1
2022-04-23,Can Tho City,Ninh Kieu District,6,39,36,3,0
2022-04-23,Can Tho City,Ninh Kieu District,7,141,133,8,0
2022-04-23,Can Tho City,Ninh Kieu District,8,246,228,18,0
2022-04-23,Can Tho City,Ninh Kieu District,9,345,325,20,1
2022-04-23,Can Tho City,Ninh Kieu District,10,593,573,20,0
2022-04-23,Can Tho City,Ninh Kieu District,11,844,802,42,3
2022-04-23,Can Tho City,Ninh Kieu District,12,696,680,16,0
2022-04-23,Can Tho City,Ninh Kieu District,13,516,490,26,0
2022-04-23,Can Tho City,Ninh Kieu District,14,437,418,19,0
2022-04-23,Can Tho City,Ninh Kieu District,15,355,335,20,0
2022-04-23,Can Tho City,Ninh Kieu District,16,425,414,11,0
2022-04-23,Can Tho City,Ninh Kieu District,17,507,482,25,0
2022-04-23,Can Tho City,Ninh Kieu District,18,529,506,23,0
2022-04-23,Can Tho City,Ninh Kieu District,19,494,463,31,0
2022-04-23,Can Tho City,Ninh Kieu District,20,388,354,34,1
2022-04-23,Can Tho City,Ninh Kieu District,21,201,184,17,0
2022-04-23,Can Tho City,Ninh Kieu District,22,6,4,2,0
2022-04-23,Dong Nai,Bien Hoa City,0,1,0,1,1
2022-04-23,Dong Nai,Bien Hoa City,1,1,0,1,0
2022-04-23,Dong Nai,Bien Hoa City,2,2,2,0,0
2022-04-23,Dong Nai,Bien Hoa City,4,2,2,0,0
2022-04-23,Dong Nai,Bien Hoa City,5,4,4,0,0
2022-04-23,Dong Nai,Bien Hoa City,6,59,29,30,25
2022-04-23,Dong Nai,Bien Hoa City,7,184,152,32,14
2022-04-23,Dong Nai,Bien Hoa City,8,313,278,35,8
2022-04-23,Dong Nai,Bien Hoa City,9,504,448,56,6
2022-04-23,Dong Nai,Bien Hoa City,10,832,765,67,18
2022-04-23,Dong Nai,Bien Hoa City,11,1205,1088,117,40
2022-04-23,Dong Nai,Bien Hoa City,12,954,875,79,14
2022-04-23,Dong Nai,Bien Hoa City,13,780,730,50,4
2022-04-23,Dong Nai,Bien Hoa City,14,578,521,57,17
2022-04-23,Dong Nai,Bien Hoa City,15,556,504,52,17
2022-04-23,Dong Nai,Bien Hoa City,16,520,459,61,18
2022-04-23,Dong Nai,Bien Hoa City,17,688,613,75,23
2022-04-23,Dong Nai,Bien Hoa City,18,753,668,85,27
2022-04-23,Dong Nai,Bien Hoa City,19,755,647,108,45
2022-04-23,Dong Nai,Bien Hoa City,20,533,442,91,55
2022-04-23,Dong Nai,Bien Hoa City,21,281,171,110,57
2022-04-23,Dong Nai,Bien Hoa City,22,3,0,3,0
2022-04-23,Dong Nai,Bien Hoa City,23,1,0,1,0
2022-04-23,Dong Nai,Long Khanh,13,2,0,2,2
2022-04-23,Dong Nai,Long Khanh,16,1,0,1,1
2022-04-23,Dong Nai,Long Khanh,19,1,0,1,0
2022-04-23,Dong Nai,Long Thanh,11,4,0,4,3
2022-04-23,Dong Nai,Long Thanh,12,2,0,2,2
2022-04-23,Dong Nai,Long Thanh,13,5,0,5,4
2022-04-23,Dong Nai,Long Thanh,14,1,0,1,1
2022-04-23,Dong Nai,Long Thanh,18,1,0,1,1
2022-04-23,Dong Nai,Long Thanh,19,2,0,2,1
2022-04-23,Dong Nai,Long Thanh,21,1,0,1,1
2022-04-23,Dong Nai,Nhon trach,12,1,0,1,1
2022-04-23,Dong Nai,Nhon trach,18,1,0,1,1
2022-04-23,Dong Nai,Nhon trach,20,3,0,3,2
2022-04-23,Dong Nai,Nhon trach,21,1,0,1,1
2022-04-23,Dong Nai,Thong Nhat,8,3,3,0,0
2022-04-23,Dong Nai,Thong Nhat,9,1,1,0,0
2022-04-23,Dong Nai,Thong Nhat,10,1,1,0,0
2022-04-23,Dong Nai,Thong Nhat,11,1,1,0,0
2022-04-23,Dong Nai,Thong Nhat,12,1,1,0,0
2022-04-23,Dong Nai,Thong Nhat,13,3,3,0,0
2022-04-23,Dong Nai,Thong Nhat,14,1,1,0,0
2022-04-23,Dong Nai,Thong Nhat,15,2,2,0,0
2022-04-23,Dong Nai,Thong Nhat,17,1,1,0,0
2022-04-23,Dong Nai,Thong Nhat,18,2,2,0,0
2022-04-23,Dong Nai,Thong Nhat,19,1,1,0,0
2022-04-23,Dong Nai,Thong Nhat,21,3,2,1,1
2022-04-23,Dong Nai,Trang Bom,10,1,0,1,1
2022-04-23,Dong Nai,Trang Bom,11,2,0,2,2
2022-04-23,Dong Nai,Trang Bom,12,2,1,1,1
2022-04-23,Dong Nai,Trang Bom,19,1,0,1,1
2022-04-23,Hai Phong City,An Duong,7,1,1,0,0
2022-04-23,Hai Phong City,An Duong,8,1,0,1,1
2022-04-23,Hai Phong City,An Duong,9,6,2,4,3
2022-04-23,Hai Phong City,An Duong,10,3,2,1,1
2022-04-23,Hai Phong City,An Duong,11,1,0,1,1
2022-04-23,Hai Phong City,An Duong,13,2,1,1,1
2022-04-23,Hai Phong City,An Duong,14,2,0,2,2
2022-04-23,Hai Phong City,An Duong,15,2,2,0,0
2022-04-23,Hai Phong City,An Duong,16,2,1,1,1
2022-04-23,Hai Phong City,An Duong,17,1,0,1,1
2022-04-23,Hai Phong City,An Duong,18,2,1,1,1
2022-04-23,Hai Phong City,An Duong,19,2,0,2,2
2022-04-23,Hai Phong City,An Duong,20,2,2,0,0
2022-04-23,Hai Phong City,An Duong,21,2,0,2,2
2022-04-23,Hai Phong City,Duong Kinh District,16,2,0,2,2
2022-04-23,Hai Phong City,Duong Kinh District,19,1,0,1,1
2022-04-23,Hai Phong City,Hai An District,7,5,4,1,1
2022-04-23,Hai Phong City,Hai An District,8,15,13,2,1
2022-04-23,Hai Phong City,Hai An District,9,9,9,0,0
2022-04-23,Hai Phong City,Hai An District,10,23,21,2,0
2022-04-23,Hai Phong City,Hai An District,11,42,36,6,1
2022-04-23,Hai Phong City,Hai An District,12,25,22,3,0
2022-04-23,Hai Phong City,Hai An District,13,14,13,1,0
2022-04-23,Hai Phong City,Hai An District,14,14,12,2,0
2022-04-23,Hai Phong City,Hai An District,15,13,11,2,0
2022-04-23,Hai Phong City,Hai An District,16,15,13,2,0
2022-04-23,Hai Phong City,Hai An District,17,24,20,4,0
2022-04-23,Hai Phong City,Hai An District,18,28,26,2,0
2022-04-23,Hai Phong City,Hai An District,19,23,18,5,4
2022-04-23,Hai Phong City,Hai An District,20,15,9,6,3
2022-04-23,Hai Phong City,Hai An District,21,6,3,3,0
2022-04-23,Hai Phong City,Hong Bang District,6,1,0,1,0
2022-04-23,Hai Phong City,Hong Bang District,7,13,8,5,3
2022-04-23,Hai Phong City,Hong Bang District,8,27,26,1,1
2022-04-23,Hai Phong City,Hong Bang District,9,24,22,2,1
2022-04-23,Hai Phong City,Hong Bang District,10,72,67,5,2
2022-04-23,Hai Phong City,Hong Bang District,11,99,87,12,5
2022-04-23,Hai Phong City,Hong Bang District,12,74,67,7,2
2022-04-23,Hai Phong City,Hong Bang District,13,29,29,0,0
2022-04-23,Hai Phong City,Hong Bang District,14,37,36,1,1
2022-04-23,Hai Phong City,Hong Bang District,15,36,31,5,2
2022-04-23,Hai Phong City,Hong Bang District,16,24,22,2,1
2022-04-23,Hai Phong City,Hong Bang District,17,38,33,5,3
2022-04-23,Hai Phong City,Hong Bang District,18,71,55,16,10
2022-04-23,Hai Phong City,Hong Bang District,19,60,47,13,9
2022-04-23,Hai Phong City,Hong Bang District,20,32,27,5,3
2022-04-23,Hai Phong City,Hong Bang District,21,22,17,5,3
2022-04-23,Hai Phong City,Kien An District,7,1,1,0,0
2022-04-23,Hai Phong City,Kien An District,8,3,1,2,2
2022-04-23,Hai Phong City,Kien An District,9,4,2,2,2
2022-04-23,Hai Phong City,Kien An District,10,8,2,6,6
2022-04-23,Hai Phong City,Kien An District,11,10,8,2,0
2022-04-23,Hai Phong City,Kien An District,12,9,8,1,0
2022-04-23,Hai Phong City,Kien An District,13,8,2,6,4
2022-04-23,Hai Phong City,Kien An District,15,9,6,3,2
2022-04-23,Hai Phong City,Kien An District,16,6,4,2,1
2022-04-23,Hai Phong City,Kien An District,17,8,7,1,1
2022-04-23,Hai Phong City,Kien An District,18,11,7,4,3
2022-04-23,Hai Phong City,Kien An District,19,14,2,12,8
2022-04-23,Hai Phong City,Kien An District,20,3,0,3,3
2022-04-23,Hai Phong City,Kien An District,21,5,4,1,0
2022-04-23,Hai Phong City,Le Chan District,1,1,0,1,0
2022-04-23,Hai Phong City,Le Chan District,3,1,1,0,0
2022-04-23,Hai Phong City,Le Chan District,5,1,1,0,0
2022-04-23,Hai Phong City,Le Chan District,6,2,1,1,1
2022-04-23,Hai Phong City,Le Chan District,7,38,21,17,11
2022-04-23,Hai Phong City,Le Chan District,8,72,62,10,1
2022-04-23,Hai Phong City,Le Chan District,9,73,67,6,1
2022-04-23,Hai Phong City,Le Chan District,10,156,145,11,2
2022-04-23,Hai Phong City,Le Chan District,11,295,260,35,12
2022-04-23,Hai Phong City,Le Chan District,12,209,188,21,3
2022-04-23,Hai Phong City,Le Chan District,13,120,112,8,0
2022-04-23,Hai Phong City,Le Chan District,14,133,123,10,0
2022-04-23,Hai Phong City,Le Chan District,15,126,122,4,0
2022-04-23,Hai Phong City,Le Chan District,16,147,136,11,0
2022-04-23,Hai Phong City,Le Chan District,17,192,168,24,5
2022-04-23,Hai Phong City,Le Chan District,18,275,229,46,20
2022-04-23,Hai Phong City,Le Chan District,19,199,170,29,12
2022-04-23,Hai Phong City,Le Chan District,20,148,130,18,4
2022-04-23,Hai Phong City,Le Chan District,21,100,71,29,7
2022-04-23,Hai Phong City,Le Chan District,22,1,0,1,0
2022-04-23,Hai Phong City,Le Chan District,23,1,0,1,1
2022-04-23,Hai Phong City,Ngo Quyen District,0,2,2,0,0
2022-04-23,Hai Phong City,Ngo Quyen District,1,1,0,1,0
2022-04-23,Hai Phong City,Ngo Quyen District,5,1,0,1,0
2022-04-23,Hai Phong City,Ngo Quyen District,6,1,1,0,0
2022-04-23,Hai Phong City,Ngo Quyen District,7,25,21,4,1
2022-04-23,Hai Phong City,Ngo Quyen District,8,79,67,12,5
2022-04-23,Hai Phong City,Ngo Quyen District,9,76,68,8,1
2022-04-23,Hai Phong City,Ngo Quyen District,10,125,106,19,1
2022-04-23,Hai Phong City,Ngo Quyen District,11,255,221,34,6
2022-04-23,Hai Phong City,Ngo Quyen District,12,160,149,11,0
2022-04-23,Hai Phong City,Ngo Quyen District,13,106,98,8,0
2022-04-23,Hai Phong City,Ngo Quyen District,14,102,88,14,1
2022-04-23,Hai Phong City,Ngo Quyen District,15,125,116,9,0
2022-04-23,Hai Phong City,Ngo Quyen District,16,108,98,10,2
2022-04-23,Hai Phong City,Ngo Quyen District,17,135,122,13,0
2022-04-23,Hai Phong City,Ngo Quyen District,18,203,170,33,11
2022-04-23,Hai Phong City,Ngo Quyen District,19,189,163,26,5
2022-04-23,Hai Phong City,Ngo Quyen District,20,159,136,23,2
2022-04-23,Hai Phong City,Ngo Quyen District,21,76,60,16,3
2022-04-23,Hai Phong City,Thuy Nguyen,10,1,0,1,1
2022-04-23,Hai Phong City,Thuy Nguyen,11,3,0,3,3
2022-04-23,Hai Phong City,Thuy Nguyen,12,1,1,0,0
2022-04-23,Hai Phong City,Thuy Nguyen,13,1,0,1,1
2022-04-23,Hai Phong City,Thuy Nguyen,14,2,0,2,2
2022-04-23,Hai Phong City,Thuy Nguyen,15,3,0,3,3
2022-04-23,Hai Phong City,Thuy Nguyen,16,3,0,3,3
2022-04-23,Hai Phong City,Thuy Nguyen,17,1,0,1,1
2022-04-23,Hai Phong City,Thuy Nguyen,21,1,0,1,0
2022-04-23,Hue City,Hue City,1,3,3,0,0
2022-04-23,Hue City,Hue City,2,1,1,0,0
2022-04-23,Hue City,Hue City,5,1,1,0,0
2022-04-23,Hue City,Hue City,6,69,63,6,2
2022-04-23,Hue City,Hue City,7,207,187,20,1
2022-04-23,Hue City,Hue City,8,315,291,24,1
2022-04-23,Hue City,Hue City,9,260,248,12,0
2022-04-23,Hue City,Hue City,10,444,423,21,0
2022-04-23,Hue City,Hue City,11,913,859,54,1
2022-04-23,Hue City,Hue City,12,571,543,28,0
2022-04-23,Hue City,Hue City,13,385,358,27,1
2022-04-23,Hue City,Hue City,14,382,359,23,1
2022-04-23,Hue City,Hue City,15,381,352,29,3
2022-04-23,Hue City,Hue City,16,380,350,30,2
2022-04-23,Hue City,Hue City,17,474,437,37,1
2022-04-23,Hue City,Hue City,18,645,594,51,1
2022-04-23,Hue City,Hue City,19,663,601,62,5
2022-04-23,Hue City,Hue City,20,465,412,53,10
2022-04-23,Hue City,Hue City,21,285,238,47,4
2022-04-23,Hue City,Hue City,22,7,1,6,0
2022-04-23,Hue City,Hue City,23,3,2,1,0
2022-04-23,Hue City,Huong Thuy,7,1,1,0,0
2022-04-23,Hue City,Huong Thuy,8,1,0,1,0
2022-04-23,Hue City,Huong Thuy,11,1,0,1,0
2022-04-23,Hue City,Huong Thuy,15,1,0,1,0
2022-04-23,Hue City,Huong Thuy,17,2,2,0,0
2022-04-23,Hue City,Huong Thuy,18,1,1,0,0
2022-04-23,Hue City,Huong Thuy,21,1,0,1,1
2022-04-23,Hue City,Phu Vang,6,1,0,1,1
2022-04-23,Hue City,Phu Vang,7,1,1,0,0
2022-04-23,Hue City,Phu Vang,8,2,1,1,1
2022-04-23,Hue City,Phu Vang,9,1,1,0,0
2022-04-23,Hue City,Phu Vang,10,1,1,0,0
2022-04-23,Hue City,Phu Vang,11,1,1,0,0
2022-04-23,Hue City,Phu Vang,12,2,0,2,0
2022-04-23,Hue City,Phu Vang,13,1,1,0,0
2022-04-23,Hue City,Phu Vang,14,3,3,0,0
2022-04-23,Hue City,Phu Vang,15,1,1,0,0
2022-04-23,Hue City,Phu Vang,17,6,5,1,0
2022-04-23,Hue City,Phu Vang,18,4,3,1,0
2022-04-23,Hue City,Phu Vang,19,4,3,1,0
2022-04-23,Vung Tau,Ba Ria City,6,1,0,1,1
2022-04-23,Vung Tau,Ba Ria City,7,3,0,3,3
2022-04-23,Vung Tau,Ba Ria City,8,2,2,0,0
2022-04-23,Vung Tau,Ba Ria City,9,8,4,4,3
2022-04-23,Vung Tau,Ba Ria City,10,9,8,1,0
2022-04-23,Vung Tau,Ba Ria City,11,10,6,4,4
2022-04-23,Vung Tau,Ba Ria City,12,6,5,1,1
2022-04-23,Vung Tau,Ba Ria City,13,7,5,2,2
2022-04-23,Vung Tau,Ba Ria City,14,7,5,2,1
2022-04-23,Vung Tau,Ba Ria City,15,4,3,1,1
2022-04-23,Vung Tau,Ba Ria City,16,5,4,1,0
2022-04-23,Vung Tau,Ba Ria City,17,2,1,1,0
2022-04-23,Vung Tau,Ba Ria City,18,6,5,1,0
2022-04-23,Vung Tau,Ba Ria City,19,5,5,0,0
2022-04-23,Vung Tau,Ba Ria City,20,3,2,1,1
2022-04-23,Vung Tau,Ba Ria City,21,3,0,3,0
2022-04-23,Vung Tau,Vung Tau City,2,1,1,0,0
2022-04-23,Vung Tau,Vung Tau City,5,1,1,0,0
2022-04-23,Vung Tau,Vung Tau City,6,25,24,1,0
2022-04-23,Vung Tau,Vung Tau City,7,123,109,14,1
2022-04-23,Vung Tau,Vung Tau City,8,191,173,18,2
2022-04-23,Vung Tau,Vung Tau City,9,180,163,17,0
2022-04-23,Vung Tau,Vung Tau City,10,233,216,17,1
2022-04-23,Vung Tau,Vung Tau City,11,429,397,32,1
2022-04-23,Vung Tau,Vung Tau City,12,343,320,23,0
2022-04-23,Vung Tau,Vung Tau City,13,227,214,13,2
2022-04-23,Vung Tau,Vung Tau City,14,274,250,24,2
2022-04-23,Vung Tau,Vung Tau City,15,199,185,14,1
2022-04-23,Vung Tau,Vung Tau City,16,190,179,11,1
2022-04-23,Vung Tau,Vung Tau City,17,230,217,13,2
2022-04-23,Vung Tau,Vung Tau City,18,342,314,28,1
2022-04-23,Vung Tau,Vung Tau City,19,318,284,34,7
2022-04-23,Vung Tau,Vung Tau City,20,254,210,44,13
2022-04-23,Vung Tau,Vung Tau City,21,149,107,42,18
2022-04-24,Binh Duong,Ben Cat,9,1,1,0,0
2022-04-24,Binh Duong,Ben Cat,10,3,0,3,3
2022-04-24,Binh Duong,Ben Cat,11,3,2,1,0
2022-04-24,Binh Duong,Ben Cat,12,1,0,1,1
2022-04-24,Binh Duong,Ben Cat,13,2,1,1,1
2022-04-24,Binh Duong,Ben Cat,14,1,0,1,1
2022-04-24,Binh Duong,Ben Cat,15,1,0,1,0
2022-04-24,Binh Duong,Ben Cat,16,1,0,1,1
2022-04-24,Binh Duong,Ben Cat,19,1,1,0,0
2022-04-24,Binh Duong,Ben Cat,20,1,0,1,1
2022-04-24,Binh Duong,Di An,6,2,0,2,2
2022-04-24,Binh Duong,Di An,7,1,1,0,0
2022-04-24,Binh Duong,Di An,8,7,4,3,2
2022-04-24,Binh Duong,Di An,9,31,19,12,10
2022-04-24,Binh Duong,Di An,10,45,16,29,26
2022-04-24,Binh Duong,Di An,11,57,27,30,26
2022-04-24,Binh Duong,Di An,12,54,32,22,19
2022-04-24,Binh Duong,Di An,13,29,24,5,2
2022-04-24,Binh Duong,Di An,14,33,22,11,9
2022-04-24,Binh Duong,Di An,15,27,16,11,9
2022-04-24,Binh Duong,Di An,16,31,16,15,12
2022-04-24,Binh Duong,Di An,17,29,15,14,10
2022-04-24,Binh Duong,Di An,18,41,26,15,9
2022-04-24,Binh Duong,Di An,19,23,12,11,8
2022-04-24,Binh Duong,Di An,20,24,8,16,13
2022-04-24,Binh Duong,Di An,21,7,1,6,5
2022-04-24,Binh Duong,Tan Uyen,7,3,0,3,2
2022-04-24,Binh Duong,Tan Uyen,8,1,0,1,1
2022-04-24,Binh Duong,Tan Uyen,9,1,0,1,1
2022-04-24,Binh Duong,Tan Uyen,10,4,0,4,3
2022-04-24,Binh Duong,Tan Uyen,11,4,2,2,2
2022-04-24,Binh Duong,Tan Uyen,12,2,2,0,0
2022-04-24,Binh Duong,Tan Uyen,14,4,0,4,3
2022-04-24,Binh Duong,Tan Uyen,15,3,0,3,1
2022-04-24,Binh Duong,Tan Uyen,16,1,0,1,0
2022-04-24,Binh Duong,Tan Uyen,17,2,0,2,2
2022-04-24,Binh Duong,Tan Uyen,18,1,0,1,1
2022-04-24,Binh Duong,Tan Uyen,19,3,1,2,2
2022-04-24,Binh Duong,Tan Uyen,21,3,0,3,3
2022-04-24,Binh Duong,Thu Dau Mot Town,0,1,0,1,0
2022-04-24,Binh Duong,Thu Dau Mot Town,6,44,37,7,2
2022-04-24,Binh Duong,Thu Dau Mot Town,7,123,118,5,2
2022-04-24,Binh Duong,Thu Dau Mot Town,8,238,221,17,7
2022-04-24,Binh Duong,Thu Dau Mot Town,9,300,281,19,1
2022-04-24,Binh Duong,Thu Dau Mot Town,10,483,457,26,1
2022-04-24,Binh Duong,Thu Dau Mot Town,11,628,595,33,2
2022-04-24,Binh Duong,Thu Dau Mot Town,12,553,515,38,1
2022-04-24,Binh Duong,Thu Dau Mot Town,13,391,377,14,1
2022-04-24,Binh Duong,Thu Dau Mot Town,14,391,371,20,2
2022-04-24,Binh Duong,Thu Dau Mot Town,15,270,235,35,15
2022-04-24,Binh Duong,Thu Dau Mot Town,16,367,299,68,31
2022-04-24,Binh Duong,Thu Dau Mot Town,17,373,354,19,2
2022-04-24,Binh Duong,Thu Dau Mot Town,18,444,398,46,2
2022-04-24,Binh Duong,Thu Dau Mot Town,19,384,357,27,1
2022-04-24,Binh Duong,Thu Dau Mot Town,20,272,242,30,5
2022-04-24,Binh Duong,Thu Dau Mot Town,21,136,112,24,3
2022-04-24,Binh Duong,Thu Dau Mot Town,22,2,0,2,0
2022-04-24,Binh Duong,Thuan An,6,6,0,6,5
2022-04-24,Binh Duong,Thuan An,7,9,1,8,6
2022-04-24,Binh Duong,Thuan An,8,10,4,6,5
2022-04-24,Binh Duong,Thuan An,9,40,30,10,5
2022-04-24,Binh Duong,Thuan An,10,54,37,17,14
2022-04-24,Binh Duong,Thuan An,11,60,34,26,12
2022-04-24,Binh Duong,Thuan An,12,84,49,35,28
2022-04-24,Binh Duong,Thuan An,13,79,52,27,16
2022-04-24,Binh Duong,Thuan An,14,55,42,13,8
2022-04-24,Binh Duong,Thuan An,15,49,30,19,15
2022-04-24,Binh Duong,Thuan An,16,46,26,20,16
2022-04-24,Binh Duong,Thuan An,17,65,36,29,18
2022-04-24,Binh Duong,Thuan An,18,59,40,19,16
2022-04-24,Binh Duong,Thuan An,19,40,18,22,18
2022-04-24,Binh Duong,Thuan An,20,37,13,24,19
2022-04-24,Binh Duong,Thuan An,21,19,5,14,10
2022-04-24,Can Tho City,Binh Thuy District,6,4,1,3,0
2022-04-24,Can Tho City,Binh Thuy District,7,2,2,0,0
2022-04-24,Can Tho City,Binh Thuy District,8,3,3,0,0
2022-04-24,Can Tho City,Binh Thuy District,9,11,10,1,0
2022-04-24,Can Tho City,Binh Thuy District,10,9,9,0,0
2022-04-24,Can Tho City,Binh Thuy District,11,26,24,2,0
2022-04-24,Can Tho City,Binh Thuy District,12,13,13,0,0
2022-04-24,Can Tho City,Binh Thuy District,13,12,10,2,1
2022-04-24,Can Tho City,Binh Thuy District,14,11,9,2,0
2022-04-24,Can Tho City,Binh Thuy District,15,11,11,0,0
2022-04-24,Can Tho City,Binh Thuy District,16,16,16,0,0
2022-04-24,Can Tho City,Binh Thuy District,17,18,18,0,0
2022-04-24,Can Tho City,Binh Thuy District,18,19,18,1,0
2022-04-24,Can Tho City,Binh Thuy District,19,11,10,1,0
2022-04-24,Can Tho City,Binh Thuy District,20,10,6,4,2
2022-04-24,Can Tho City,Binh Thuy District,21,3,2,1,0
2022-04-24,Can Tho City,Cai Rang District,6,1,1,0,0
2022-04-24,Can Tho City,Cai Rang District,7,5,5,0,0
2022-04-24,Can Tho City,Cai Rang District,8,5,4,1,1
2022-04-24,Can Tho City,Cai Rang District,9,9,8,1,0
2022-04-24,Can Tho City,Cai Rang District,10,13,13,0,0
2022-04-24,Can Tho City,Cai Rang District,11,14,13,1,0
2022-04-24,Can Tho City,Cai Rang District,12,8,8,0,0
2022-04-24,Can Tho City,Cai Rang District,13,11,11,0,0
2022-04-24,Can Tho City,Cai Rang District,14,7,7,0,0
2022-04-24,Can Tho City,Cai Rang District,15,8,8,0,0
2022-04-24,Can Tho City,Cai Rang District,16,12,10,2,0
2022-04-24,Can Tho City,Cai Rang District,17,14,12,2,0
2022-04-24,Can Tho City,Cai Rang District,18,8,8,0,0
2022-04-24,Can Tho City,Cai Rang District,19,13,11,2,0
2022-04-24,Can Tho City,Cai Rang District,20,7,5,2,1
2022-04-24,Can Tho City,Cai Rang District,21,6,3,3,3
2022-04-24,Can Tho City,Ninh Kieu District,1,2,0,2,0
2022-04-24,Can Tho City,Ninh Kieu District,2,3,1,2,0
2022-04-24,Can Tho City,Ninh Kieu District,3,1,1,0,0
2022-04-24,Can Tho City,Ninh Kieu District,5,4,1,3,1
2022-04-24,Can Tho City,Ninh Kieu District,6,44,38,6,2
2022-04-24,Can Tho City,Ninh Kieu District,7,144,135,9,1
2022-04-24,Can Tho City,Ninh Kieu District,8,260,243,17,0
2022-04-24,Can Tho City,Ninh Kieu District,9,355,330,25,0
2022-04-24,Can Tho City,Ninh Kieu District,10,668,633,35,0
2022-04-24,Can Tho City,Ninh Kieu District,11,902,858,44,3
2022-04-24,Can Tho City,Ninh Kieu District,12,759,713,46,0
2022-04-24,Can Tho City,Ninh Kieu District,13,517,502,15,0
2022-04-24,Can Tho City,Ninh Kieu District,14,442,417,25,0
2022-04-24,Can Tho City,Ninh Kieu District,15,428,401,27,0
2022-04-24,Can Tho City,Ninh Kieu District,16,484,468,16,0
2022-04-24,Can Tho City,Ninh Kieu District,17,526,503,23,0
2022-04-24,Can Tho City,Ninh Kieu District,18,578,551,27,0
2022-04-24,Can Tho City,Ninh Kieu District,19,491,461,30,0
2022-04-24,Can Tho City,Ninh Kieu District,20,358,328,30,2
2022-04-24,Can Tho City,Ninh Kieu District,21,208,192,16,0
2022-04-24,Can Tho City,Ninh Kieu District,22,2,0,2,0
2022-04-24,Can Tho City,Ninh Kieu District,23,1,0,1,0
2022-04-24,Dong Nai,Bien Hoa City,1,2,2,0,0
2022-04-24,Dong Nai,Bien Hoa City,2,8,6,2,1
2022-04-24,Dong Nai,Bien Hoa City,5,1,0,1,1
2022-04-24,Dong Nai,Bien Hoa City,6,56,33,23,15
2022-04-24,Dong Nai,Bien Hoa City,7,187,152,35,10
2022-04-24,Dong Nai,Bien Hoa City,8,357,281,76,36
2022-04-24,Dong Nai,Bien Hoa City,9,588,506,82,29
2022-04-24,Dong Nai,Bien Hoa City,10,1008,873,135,53
2022-04-24,Dong Nai,Bien Hoa City,11,1273,1107,166,72
2022-04-24,Dong Nai,Bien Hoa City,12,1132,993,139,41
2022-04-24,Dong Nai,Bien Hoa City,13,791,688,103,41
2022-04-24,Dong Nai,Bien Hoa City,14,622,581,41,8
2022-04-24,Dong Nai,Bien Hoa City,15,616,506,110,37
2022-04-24,Dong Nai,Bien Hoa City,16,583,493,90,30
2022-04-24,Dong Nai,Bien Hoa City,17,642,566,76,31
2022-04-24,Dong Nai,Bien Hoa City,18,844,678,166,68
2022-04-24,Dong Nai,Bien Hoa City,19,818,619,199,128
2022-04-24,Dong Nai,Bien Hoa City,20,576,413,163,78
2022-04-24,Dong Nai,Bien Hoa City,21,252,142,110,50
2022-04-24,Dong Nai,Bien Hoa City,22,1,0,1,0
2022-04-24,Dong Nai,Long Thanh,10,5,0,5,5
2022-04-24,Dong Nai,Long Thanh,11,1,0,1,1
2022-04-24,Dong Nai,Long Thanh,14,1,0,1,1
2022-04-24,Dong Nai,Long Thanh,17,1,0,1,1
2022-04-24,Dong Nai,Long Thanh,20,1,0,1,1
2022-04-24,Dong Nai,Long Thanh,21,1,0,1,1
2022-04-24,Dong Nai,Nhon trach,10,1,0,1,0
2022-04-24,Dong Nai,Nhon trach,17,1,0,1,1
2022-04-24,Dong Nai,Nhon trach,20,1,0,1,1
2022-04-24,Dong Nai,Nhon trach,21,1,0,1,1
2022-04-24,Dong Nai,Thong Nhat,7,1,1,0,0
2022-04-24,Dong Nai,Thong Nhat,8,1,1,0,0
2022-04-24,Dong Nai,Thong Nhat,9,2,2,0,0
2022-04-24,Dong Nai,Thong Nhat,11,2,1,1,1
2022-04-24,Dong Nai,Thong Nhat,12,4,2,2,0
2022-04-24,Dong Nai,Thong Nhat,13,1,1,0,0
2022-04-24,Dong Nai,Thong Nhat,16,1,1,0,0
2022-04-24,Dong Nai,Thong Nhat,19,4,2,2,2
2022-04-24,Dong Nai,Thong Nhat,21,1,1,0,0
2022-04-24,Dong Nai,Trang Bom,9,3,0,3,3
2022-04-24,Dong Nai,Trang Bom,10,1,1,0,0
2022-04-24,Dong Nai,Trang Bom,11,2,0,2,2
2022-04-24,Dong Nai,Trang Bom,12,3,1,2,2
2022-04-24,Dong Nai,Trang Bom,13,3,0,3,3
2022-04-24,Dong Nai,Trang Bom,14,1,0,1,1
2022-04-24,Dong Nai,Trang Bom,16,1,0,1,1
2022-04-24,Hai Phong City,An Duong,7,1,0,1,0
2022-04-24,Hai Phong City,An Duong,8,2,2,0,0
2022-04-24,Hai Phong City,An Duong,9,4,2,2,2
2022-04-24,Hai Phong City,An Duong,10,3,2,1,1
2022-04-24,Hai Phong City,An Duong,11,6,2,4,2
2022-04-24,Hai Phong City,An Duong,12,4,1,3,3
2022-04-24,Hai Phong City,An Duong,13,3,1,2,1
2022-04-24,Hai Phong City,An Duong,14,4,1,3,3
2022-04-24,Hai Phong City,An Duong,16,1,0,1,1
2022-04-24,Hai Phong City,An Duong,17,10,2,8,5
2022-04-24,Hai Phong City,An Duong,18,4,0,4,1
2022-04-24,Hai Phong City,An Duong,20,2,1,1,0
2022-04-24,Hai Phong City,An Duong,21,2,0,2,2
2022-04-24,Hai Phong City,Duong Kinh District,15,1,0,1,1
2022-04-24,Hai Phong City,Duong Kinh District,16,1,0,1,1
2022-04-24,Hai Phong City,Hai An District,0,2,2,0,0
2022-04-24,Hai Phong City,Hai An District,7,3,0,3,2
2022-04-24,Hai Phong City,Hai An District,8,16,8,8,6
2022-04-24,Hai Phong City,Hai An District,9,18,14,4,2
2022-04-24,Hai Phong City,Hai An District,10,26,22,4,2
2022-04-24,Hai Phong City,Hai An District,11,41,31,10,5
2022-04-24,Hai Phong City,Hai An District,12,32,28,4,1
2022-04-24,Hai Phong City,Hai An District,13,23,18,5,0
2022-04-24,Hai Phong City,Hai An District,14,18,10,8,2
2022-04-24,Hai Phong City,Hai An District,15,12,11,1,1
2022-04-24,Hai Phong City,Hai An District,16,22,20,2,0
2022-04-24,Hai Phong City,Hai An District,17,25,22,3,0
2022-04-24,Hai Phong City,Hai An District,18,25,18,7,3
2022-04-24,Hai Phong City,Hai An District,19,24,21,3,0
2022-04-24,Hai Phong City,Hai An District,20,21,16,5,3
2022-04-24,Hai Phong City,Hai An District,21,11,8,3,3
2022-04-24,Hai Phong City,Hong Bang District,6,1,0,1,1
2022-04-24,Hai Phong City,Hong Bang District,7,8,7,1,1
2022-04-24,Hai Phong City,Hong Bang District,8,18,10,8,4
2022-04-24,Hai Phong City,Hong Bang District,9,30,23,7,4
2022-04-24,Hai Phong City,Hong Bang District,10,71,56,15,6
2022-04-24,Hai Phong City,Hong Bang District,11,126,97,29,20
2022-04-24,Hai Phong City,Hong Bang District,12,75,65,10,8
2022-04-24,Hai Phong City,Hong Bang District,13,46,40,6,0
2022-04-24,Hai Phong City,Hong Bang District,14,33,33,0,0
2022-04-24,Hai Phong City,Hong Bang District,15,56,51,5,1
2022-04-24,Hai Phong City,Hong Bang District,16,36,28,8,1
2022-04-24,Hai Phong City,Hong Bang District,17,39,35,4,1
2022-04-24,Hai Phong City,Hong Bang District,18,70,62,8,4
2022-04-24,Hai Phong City,Hong Bang District,19,65,50,15,5
2022-04-24,Hai Phong City,Hong Bang District,20,37,29,8,5
2022-04-24,Hai Phong City,Hong Bang District,21,16,13,3,3
2022-04-24,Hai Phong City,Kien An District,7,11,1,10,7
2022-04-24,Hai Phong City,Kien An District,8,6,4,2,0
2022-04-24,Hai Phong City,Kien An District,9,18,5,13,9
2022-04-24,Hai Phong City,Kien An District,10,14,6,8,6
2022-04-24,Hai Phong City,Kien An District,11,28,10,18,14
2022-04-24,Hai Phong City,Kien An District,12,19,7,12,11
2022-04-24,Hai Phong City,Kien An District,13,11,3,8,6
2022-04-24,Hai Phong City,Kien An District,14,3,2,1,0
2022-04-24,Hai Phong City,Kien An District,15,6,2,4,3
2022-04-24,Hai Phong City,Kien An District,16,5,4,1,1
2022-04-24,Hai Phong City,Kien An District,17,11,8,3,2
2022-04-24,Hai Phong City,Kien An District,18,18,11,7,1
2022-04-24,Hai Phong City,Kien An District,19,10,9,1,1
2022-04-24,Hai Phong City,Kien An District,20,7,3,4,2
2022-04-24,Hai Phong City,Kien An District,21,4,2,2,1
2022-04-24,Hai Phong City,Le Chan District,1,1,0,1,1
2022-04-24,Hai Phong City,Le Chan District,6,1,0,1,0
2022-04-24,Hai Phong City,Le Chan District,7,39,27,12,7
2022-04-24,Hai Phong City,Le Chan District,8,100,78,22,13
2022-04-24,Hai Phong City,Le Chan District,9,101,84,17,8
2022-04-24,Hai Phong City,Le Chan District,10,216,172,44,20
2022-04-24,Hai Phong City,Le Chan District,11,389,294,95,65
2022-04-24,Hai Phong City,Le Chan District,12,226,195,31,17
2022-04-24,Hai Phong City,Le Chan District,13,139,122,17,2
2022-04-24,Hai Phong City,Le Chan District,14,134,120,14,0
2022-04-24,Hai Phong City,Le Chan District,15,157,136,21,2
2022-04-24,Hai Phong City,Le Chan District,16,148,132,16,2
2022-04-24,Hai Phong City,Le Chan District,17,203,177,26,2
2022-04-24,Hai Phong City,Le Chan District,18,230,201,29,6
2022-04-24,Hai Phong City,Le Chan District,19,185,149,36,18
2022-04-24,Hai Phong City,Le Chan District,20,160,129,31,16
2022-04-24,Hai Phong City,Le Chan District,21,68,55,13,5
2022-04-24,Hai Phong City,Le Chan District,23,1,0,1,0
2022-04-24,Hai Phong City,Ngo Quyen District,4,1,0,1,0
2022-04-24,Hai Phong City,Ngo Quyen District,6,2,0,2,2
2022-04-24,Hai Phong City,Ngo Quyen District,7,36,19,17,9
2022-04-24,Hai Phong City,Ngo Quyen District,8,68,49,19,8
2022-04-24,Hai Phong City,Ngo Quyen District,9,94,77,17,3
2022-04-24,Hai Phong City,Ngo Quyen District,10,169,151,18,3
2022-04-24,Hai Phong City,Ngo Quyen District,11,274,228,46,30
2022-04-24,Hai Phong City,Ngo Quyen District,12,213,179,34,14
2022-04-24,Hai Phong City,Ngo Quyen District,13,116,107,9,0
2022-04-24,Hai Phong City,Ngo Quyen District,14,93,83,10,0
2022-04-24,Hai Phong City,Ngo Quyen District,15,138,124,14,1
2022-04-24,Hai Phong City,Ngo Quyen District,16,145,132,13,0
2022-04-24,Hai Phong City,Ngo Quyen District,17,162,134,28,3
2022-04-24,Hai Phong City,Ngo Quyen District,18,196,173,23,6
2022-04-24,Hai Phong City,Ngo Quyen District,19,166,144,22,10
2022-04-24,Hai Phong City,Ngo Quyen District,20,113,96,17,2
2022-04-24,Hai Phong City,Ngo Quyen District,21,75,49,26,12
2022-04-24,Hai Phong City,Thuy Nguyen,10,1,0,1,1
2022-04-24,Hai Phong City,Thuy Nguyen,11,1,0,1,0
2022-04-24,Hai Phong City,Thuy Nguyen,12,1,0,1,1
2022-04-24,Hai Phong City,Thuy Nguyen,17,2,0,2,2
2022-04-24,Hai Phong City,Thuy Nguyen,18,3,0,3,2
2022-04-24,Hai Phong City,Thuy Nguyen,19,1,0,1,1
2022-04-24,Hai Phong City,Thuy Nguyen,20,2,0,2,2
2022-04-24,Hai Phong City,Thuy Nguyen,21,1,0,1,1
2022-04-24,Hue City,Hue City,0,2,2,0,0
2022-04-24,Hue City,Hue City,1,2,2,0,0
2022-04-24,Hue City,Hue City,3,1,1,0,0
2022-04-24,Hue City,Hue City,5,1,1,0,0
2022-04-24,Hue City,Hue City,6,78,67,11,0
2022-04-24,Hue City,Hue City,7,235,218,17,3
2022-04-24,Hue City,Hue City,8,306,292,14,0
2022-04-24,Hue City,Hue City,9,305,285,20,0
2022-04-24,Hue City,Hue City,10,529,493,36,1
2022-04-24,Hue City,Hue City,11,948,888,60,1
2022-04-24,Hue City,Hue City,12,663,608,55,0
2022-04-24,Hue City,Hue City,13,362,338,24,0
2022-04-24,Hue City,Hue City,14,348,329,19,2
2022-04-24,Hue City,Hue City,15,411,386,25,1
2022-04-24,Hue City,Hue City,16,418,392,26,4
2022-04-24,Hue City,Hue City,17,443,410,33,4
2022-04-24,Hue City,Hue City,18,711,651,60,4
2022-04-24,Hue City,Hue City,19,696,587,109,27
2022-04-24,Hue City,Hue City,20,520,432,88,24
2022-04-24,Hue City,Hue City,21,258,201,57,7
2022-04-24,Hue City,Hue City,22,2,0,2,0
2022-04-24,Hue City,Huong Thuy,8,1,1,0,0
2022-04-24,Hue City,Huong Thuy,9,2,2,0,0
2022-04-24,Hue City,Huong Thuy,12,1,1,0,0
2022-04-24,Hue City,Huong Thuy,13,1,0,1,1
2022-04-24,Hue City,Huong Thuy,14,1,1,0,0
2022-04-24,Hue City,Huong Thuy,17,1,1,0,0
2022-04-24,Hue City,Huong Thuy,18,2,0,2,2
2022-04-24,Hue City,Huong Thuy,19,1,0,1,1
2022-04-24,Hue City,Huong Thuy,20,1,1,0,0
2022-04-24,Hue City,Huong Tra,10,3,2,1,0
2022-04-24,Hue City,Huong Tra,12,1,1,0,0
2022-04-24,Hue City,Huong Tra,18,2,0,2,0
2022-04-24,Hue City,Phu Vang,7,3,2,1,0
2022-04-24,Hue City,Phu Vang,8,1,1,0,0
2022-04-24,Hue City,Phu Vang,9,5,4,1,1
2022-04-24,Hue City,Phu Vang,10,2,2,0,0
2022-04-24,Hue City,Phu Vang,11,3,3,0,0
2022-04-24,Hue City,Phu Vang,12,1,1,0,0
2022-04-24,Hue City,Phu Vang,13,1,1,0,0
2022-04-24,Hue City,Phu Vang,14,1,0,1,1
2022-04-24,Hue City,Phu Vang,15,2,2,0,0
2022-04-24,Hue City,Phu Vang,16,3,3,0,0
2022-04-24,Hue City,Phu Vang,17,3,3,0,0
2022-04-24,Hue City,Phu Vang,18,4,1,3,1
2022-04-24,Hue City,Phu Vang,19,4,3,1,0
2022-04-24,Hue City,Phu Vang,21,1,0,1,1
2022-04-24,Vung Tau,Ba Ria City,7,6,0,6,5
2022-04-24,Vung Tau,Ba Ria City,8,2,0,2,1
2022-04-24,Vung Tau,Ba Ria City,9,3,2,1,1
2022-04-24,Vung Tau,Ba Ria City,10,5,2,3,3
2022-04-24,Vung Tau,Ba Ria City,11,9,6,3,1
2022-04-24,Vung Tau,Ba Ria City,12,6,3,3,3
2022-04-24,Vung Tau,Ba Ria City,13,11,5,6,2
2022-04-24,Vung Tau,Ba Ria City,14,4,2,2,2
2022-04-24,Vung Tau,Ba Ria City,15,6,2,4,2
2022-04-24,Vung Tau,Ba Ria City,16,8,5,3,2
2022-04-24,Vung Tau,Ba Ria City,17,9,7,2,1
2022-04-24,Vung Tau,Ba Ria City,18,4,2,2,2
2022-04-24,Vung Tau,Ba Ria City,19,6,2,4,3
2022-04-24,Vung Tau,Ba Ria City,20,1,0,1,1
2022-04-24,Vung Tau,Ba Ria City,21,1,0,1,1
2022-04-24,Vung Tau,Vung Tau City,2,1,1,0,0
2022-04-24,Vung Tau,Vung Tau City,6,44,38,6,1
2022-04-24,Vung Tau,Vung Tau City,7,136,127,9,3
2022-04-24,Vung Tau,Vung Tau City,8,260,234,26,2
2022-04-24,Vung Tau,Vung Tau City,9,221,201,20,0
2022-04-24,Vung Tau,Vung Tau City,10,329,300,29,3
2022-04-24,Vung Tau,Vung Tau City,11,491,455,36,8
2022-04-24,Vung Tau,Vung Tau City,12,370,348,22,5
2022-04-24,Vung Tau,Vung Tau City,13,236,218,18,0
2022-04-24,Vung Tau,Vung Tau City,14,194,178,16,2
2022-04-24,Vung Tau,Vung Tau City,15,241,229,12,1
2022-04-24,Vung Tau,Vung Tau City,16,220,201,19,3
2022-04-24,Vung Tau,Vung Tau City,17,261,245,16,2
2022-04-24,Vung Tau,Vung Tau City,18,367,330,37,14
2022-04-24,Vung Tau,Vung Tau City,19,290,253,37,4
2022-04-24,Vung Tau,Vung Tau City,20,201,178,23,5
2022-04-24,Vung Tau,Vung Tau City,21,103,75,28,8
2022-04-24,Vung Tau,Vung Tau City,22,1,0,1,0
2022-04-25,Binh Duong,Ben Cat,11,1,0,1,1
2022-04-25,Binh Duong,Ben Cat,12,1,0,1,1
2022-04-25,Binh Duong,Ben Cat,16,1,0,1,1
2022-04-25,Binh Duong,Di An,6,1,0,1,1
2022-04-25,Binh Duong,Di An,7,6,1,5,5
2022-04-25,Binh Duong,Di An,8,14,7,7,4
2022-04-25,Binh Duong,Di An,9,15,10,5,5
2022-04-25,Binh Duong,Di An,10,31,19,12,10
2022-04-25,Binh Duong,Di An,11,44,20,24,18
2022-04-25,Binh Duong,Di An,12,54,27,27,26
2022-04-25,Binh Duong,Di An,13,26,16,10,9
2022-04-25,Binh Duong,Di An,14,25,11,14,11
2022-04-25,Binh Duong,Di An,15,23,13,10,5
2022-04-25,Binh Duong,Di An,16,34,13,21,14
2022-04-25,Binh Duong,Di An,17,27,14,13,11
2022-04-25,Binh Duong,Di An,18,39,22,17,12
2022-04-25,Binh Duong,Di An,19,19,9,10,9
2022-04-25,Binh Duong,Di An,20,22,9,13,9
2022-04-25,Binh Duong,Di An,21,10,3,7,5
2022-04-25,Binh Duong,Tan Uyen,9,1,0,1,0
2022-04-25,Binh Duong,Tan Uyen,10,2,1,1,1
2022-04-25,Binh Duong,Tan Uyen,11,4,2,2,1
2022-04-25,Binh Duong,Tan Uyen,12,4,1,3,3
2022-04-25,Binh Duong,Tan Uyen,13,3,0,3,3
2022-04-25,Binh Duong,Tan Uyen,14,4,0,4,3
2022-04-25,Binh Duong,Tan Uyen,15,2,0,2,2
2022-04-25,Binh Duong,Tan Uyen,16,1,1,0,0
2022-04-25,Binh Duong,Tan Uyen,17,3,2,1,1
2022-04-25,Binh Duong,Tan Uyen,18,2,0,2,1
2022-04-25,Binh Duong,Tan Uyen,19,2,0,2,2
2022-04-25,Binh Duong,Tan Uyen,20,1,0,1,1
2022-04-25,Binh Duong,Thu Dau Mot Town,5,4,2,2,1
2022-04-25,Binh Duong,Thu Dau Mot Town,6,34,31,3,2
2022-04-25,Binh Duong,Thu Dau Mot Town,7,103,97,6,1
2022-04-25,Binh Duong,Thu Dau Mot Town,8,205,191,14,3
2022-04-25,Binh Duong,Thu Dau Mot Town,9,254,233,21,2
2022-04-25,Binh Duong,Thu Dau Mot Town,10,364,340,24,1
2022-04-25,Binh Duong,Thu Dau Mot Town,11,650,617,33,7
2022-04-25,Binh Duong,Thu Dau Mot Town,12,478,450,28,1
2022-04-25,Binh Duong,Thu Dau Mot Town,13,394,373,21,3
2022-04-25,Binh Duong,Thu Dau Mot Town,14,377,354,23,3
2022-04-25,Binh Duong,Thu Dau Mot Town,15,280,261,19,0
2022-04-25,Binh Duong,Thu Dau Mot Town,16,302,282,20,2
2022-04-25,Binh Duong,Thu Dau Mot Town,17,313,295,18,1
2022-04-25,Binh Duong,Thu Dau Mot Town,18,347,332,15,2
2022-04-25,Binh Duong,Thu Dau Mot Town,19,340,318,22,5
2022-04-25,Binh Duong,Thu Dau Mot Town,20,256,232,24,3
2022-04-25,Binh Duong,Thu Dau Mot Town,21,107,93,14,2
2022-04-25,Binh Duong,Thuan An,2,1,0,1,0
2022-04-25,Binh Duong,Thuan An,6,3,0,3,2
2022-04-25,Binh Duong,Thuan An,7,5,1,4,3
2022-04-25,Binh Duong,Thuan An,8,21,13,8,4
2022-04-25,Binh Duong,Thuan An,9,25,19,6,2
2022-04-25,Binh Duong,Thuan An,10,52,37,15,9
2022-04-25,Binh Duong,Thuan An,11,83,54,29,21
2022-04-25,Binh Duong,Thuan An,12,101,60,41,28
2022-04-25,Binh Duong,Thuan An,13,88,53,35,29
2022-04-25,Binh Duong,Thuan An,14,71,32,39,26
2022-04-25,Binh Duong,Thuan An,15,31,23,8,7
2022-04-25,Binh Duong,Thuan An,16,29,14,15,14
2022-04-25,Binh Duong,Thuan An,17,48,33,15,10
2022-04-25,Binh Duong,Thuan An,18,40,27,13,12
2022-04-25,Binh Duong,Thuan An,19,44,36,8,4
2022-04-25,Binh Duong,Thuan An,20,33,14,19,11
2022-04-25,Binh Duong,Thuan An,21,14,5,9,7
2022-04-25,Can Tho City,Binh Thuy District,0,1,1,0,0
2022-04-25,Can Tho City,Binh Thuy District,6,2,0,2,2
2022-04-25,Can Tho City,Binh Thuy District,7,1,0,1,0
2022-04-25,Can Tho City,Binh Thuy District,8,3,3,0,0
2022-04-25,Can Tho City,Binh Thuy District,9,9,6,3,1
2022-04-25,Can Tho City,Binh Thuy District,10,14,13,1,0
2022-04-25,Can Tho City,Binh Thuy District,11,11,10,1,0
2022-04-25,Can Tho City,Binh Thuy District,12,19,17,2,0
2022-04-25,Can Tho City,Binh Thuy District,13,7,5,2,0
2022-04-25,Can Tho City,Binh Thuy District,14,15,12,3,2
2022-04-25,Can Tho City,Binh Thuy District,15,9,8,1,0
2022-04-25,Can Tho City,Binh Thuy District,16,12,11,1,0
2022-04-25,Can Tho City,Binh Thuy District,17,19,17,2,0
2022-04-25,Can Tho City,Binh Thuy District,18,26,26,0,0
2022-04-25,Can Tho City,Binh Thuy District,19,8,7,1,0
2022-04-25,Can Tho City,Binh Thuy District,20,10,8,2,0
2022-04-25,Can Tho City,Binh Thuy District,21,5,1,4,1
2022-04-25,Can Tho City,Cai Rang District,5,1,0,1,0
2022-04-25,Can Tho City,Cai Rang District,6,3,2,1,1
2022-04-25,Can Tho City,Cai Rang District,7,3,3,0,0
2022-04-25,Can Tho City,Cai Rang District,8,9,7,2,1
2022-04-25,Can Tho City,Cai Rang District,9,5,3,2,2
2022-04-25,Can Tho City,Cai Rang District,10,13,10,3,1
2022-04-25,Can Tho City,Cai Rang District,11,14,11,3,1
2022-04-25,Can Tho City,Cai Rang District,12,12,10,2,0
2022-04-25,Can Tho City,Cai Rang District,13,10,10,0,0
2022-04-25,Can Tho City,Cai Rang District,14,9,7,2,1
2022-04-25,Can Tho City,Cai Rang District,15,4,4,0,0
2022-04-25,Can Tho City,Cai Rang District,16,5,5,0,0
2022-04-25,Can Tho City,Cai Rang District,17,12,12,0,0
2022-04-25,Can Tho City,Cai Rang District,18,8,6,2,0
2022-04-25,Can Tho City,Cai Rang District,19,12,12,0,0
2022-04-25,Can Tho City,Cai Rang District,20,2,2,0,0
2022-04-25,Can Tho City,Cai Rang District,21,2,1,1,1
2022-04-25,Can Tho City,Ninh Kieu District,0,2,0,2,0
2022-04-25,Can Tho City,Ninh Kieu District,1,4,3,1,0
2022-04-25,Can Tho City,Ninh Kieu District,2,1,1,0,0
2022-04-25,Can Tho City,Ninh Kieu District,3,1,1,0,0
2022-04-25,Can Tho City,Ninh Kieu District,5,2,0,2,0
2022-04-25,Can Tho City,Ninh Kieu District,6,44,38,6,0
2022-04-25,Can Tho City,Ninh Kieu District,7,128,124,4,0
2022-04-25,Can Tho City,Ninh Kieu District,8,209,198,11,0
2022-04-25,Can Tho City,Ninh Kieu District,9,273,252,21,0
2022-04-25,Can Tho City,Ninh Kieu District,10,573,553,20,0
2022-04-25,Can Tho City,Ninh Kieu District,11,888,847,41,4
2022-04-25,Can Tho City,Ninh Kieu District,12,660,619,41,2
2022-04-25,Can Tho City,Ninh Kieu District,13,510,483,27,0
2022-04-25,Can Tho City,Ninh Kieu District,14,424,403,21,0
2022-04-25,Can Tho City,Ninh Kieu District,15,443,417,26,1
2022-04-25,Can Tho City,Ninh Kieu District,16,433,406,27,0
2022-04-25,Can Tho City,Ninh Kieu District,17,556,527,29,0
2022-04-25,Can Tho City,Ninh Kieu District,18,640,613,27,0
2022-04-25,Can Tho City,Ninh Kieu District,19,508,479,29,1
2022-04-25,Can Tho City,Ninh Kieu District,20,396,373,23,0
2022-04-25,Can Tho City,Ninh Kieu District,21,232,211,21,1
2022-04-25,Can Tho City,Ninh Kieu District,22,4,3,1,0
2022-04-25,Can Tho City,Ninh Kieu District,23,1,0,1,0
2022-04-25,Can Tho City,Phong Dien,12,1,1,0,0
2022-04-25,Dong Nai,Bien Hoa City,0,3,2,1,0
2022-04-25,Dong Nai,Bien Hoa City,5,3,0,3,3
2022-04-25,Dong Nai,Bien Hoa City,6,35,21,14,10
2022-04-25,Dong Nai,Bien Hoa City,7,154,122,32,13
2022-04-25,Dong Nai,Bien Hoa City,8,286,253,33,12
2022-04-25,Dong Nai,Bien Hoa City,9,359,312,47,6
2022-04-25,Dong Nai,Bien Hoa City,10,732,633,99,29
2022-04-25,Dong Nai,Bien Hoa City,11,1035,931,104,30
2022-04-25,Dong Nai,Bien Hoa City,12,793,721,72,10
2022-04-25,Dong Nai,Bien Hoa City,13,786,724,62,12
2022-04-25,Dong Nai,Bien Hoa City,14,667,615,52,13
2022-04-25,Dong Nai,Bien Hoa City,15,518,470,48,12
2022-04-25,Dong Nai,Bien Hoa City,16,502,455,47,7
2022-04-25,Dong Nai,Bien Hoa City,17,533,479,54,8
2022-04-25,Dong Nai,Bien Hoa City,18,674,625,49,10
2022-04-25,Dong Nai,Bien Hoa City,19,599,560,39,3
2022-04-25,Dong Nai,Bien Hoa City,20,454,407,47,6
2022-04-25,Dong Nai,Bien Hoa City,21,218,158,60,30
2022-04-25,Dong Nai,Bien Hoa City,22,2,0,2,0
2022-04-25,Dong Nai,Bien Hoa City,23,2,1,1,0
2022-04-25,Dong Nai,Long Thanh,13,1,0,1,1
2022-04-25,Dong Nai,Long Thanh,15,1,0,1,0
2022-04-25,Dong Nai,Long Thanh,16,2,0,2,1
2022-04-25,Dong Nai,Long Thanh,17,3,0,3,3
2022-04-25,Dong Nai,Long Thanh,20,1,0,1,1
2022-04-25,Dong Nai,Nhon trach,9,1,0,1,1
2022-04-25,Dong Nai,Nhon trach,13,3,0,3,3
2022-04-25,Dong Nai,Nhon trach,15,1,0,1,1
2022-04-25,Dong Nai,Nhon trach,16,1,0,1,1
2022-04-25,Dong Nai,Thong Nhat,9,3,3,0,0
2022-04-25,Dong Nai,Thong Nhat,10,2,1,1,0
2022-04-25,Dong Nai,Thong Nhat,11,2,2,0,0
2022-04-25,Dong Nai,Thong Nhat,13,3,2,1,1
2022-04-25,Dong Nai,Thong Nhat,16,1,1,0,0
2022-04-25,Dong Nai,Thong Nhat,17,1,1,0,0
2022-04-25,Dong Nai,Thong Nhat,18,1,1,0,0
2022-04-25,Dong Nai,Thong Nhat,19,2,2,0,0
2022-04-25,Dong Nai,Trang Bom,2,1,0,1,1
2022-04-25,Dong Nai,Trang Bom,8,2,0,2,2
2022-04-25,Dong Nai,Trang Bom,9,1,0,1,1
2022-04-25,Dong Nai,Trang Bom,10,1,0,1,1
2022-04-25,Dong Nai,Trang Bom,11,1,0,1,1
2022-04-25,Dong Nai,Trang Bom,15,1,0,1,1
2022-04-25,Dong Nai,Trang Bom,16,2,0,2,2
2022-04-25,Hai Phong City,An Duong,8,1,0,1,1
2022-04-25,Hai Phong City,An Duong,9,7,1,6,4
2022-04-25,Hai Phong City,An Duong,10,4,2,2,2
2022-04-25,Hai Phong City,An Duong,11,2,2,0,0
2022-04-25,Hai Phong City,An Duong,12,9,3,6,5
2022-04-25,Hai Phong City,An Duong,13,4,4,0,0
2022-04-25,Hai Phong City,An Duong,14,3,0,3,2
2022-04-25,Hai Phong City,An Duong,15,7,2,5,5
2022-04-25,Hai Phong City,An Duong,16,3,1,2,1
2022-04-25,Hai Phong City,An Duong,17,8,4,4,3
2022-04-25,Hai Phong City,An Duong,18,1,1,0,0
2022-04-25,Hai Phong City,An Duong,19,5,0,5,4
2022-04-25,Hai Phong City,An Duong,20,1,1,0,0
2022-04-25,Hai Phong City,An Duong,21,3,2,1,1
2022-04-25,Hai Phong City,Duong Kinh District,20,2,0,2,2
2022-04-25,Hai Phong City,Hai An District,7,3,2,1,0
2022-04-25,Hai Phong City,Hai An District,8,9,5,4,3
2022-04-25,Hai Phong City,Hai An District,9,6,6,0,0
2022-04-25,Hai Phong City,Hai An District,10,24,20,4,2
2022-04-25,Hai Phong City,Hai An District,11,46,41,5,3
2022-04-25,Hai Phong City,Hai An District,12,25,21,4,1
2022-04-25,Hai Phong City,Hai An District,13,12,11,1,1
2022-04-25,Hai Phong City,Hai An District,14,11,8,3,0
2022-04-25,Hai Phong City,Hai An District,15,15,11,4,0
2022-04-25,Hai Phong City,Hai An District,16,20,17,3,0
2022-04-25,Hai Phong City,Hai An District,17,13,11,2,0
2022-04-25,Hai Phong City,Hai An District,18,29,26,3,2
2022-04-25,Hai Phong City,Hai An District,19,17,15,2,1
2022-04-25,Hai Phong City,Hai An District,20,8,7,1,0
2022-04-25,Hai Phong City,Hai An District,21,9,5,4,1
2022-04-25,Hai Phong City,Hai An District,22,1,0,1,0
2022-04-25,Hai Phong City,Hong Bang District,0,2,1,1,0
2022-04-25,Hai Phong City,Hong Bang District,6,1,0,1,0
2022-04-25,Hai Phong City,Hong Bang District,7,8,7,1,0
2022-04-25,Hai Phong City,Hong Bang District,8,23,23,0,0
2022-04-25,Hai Phong City,Hong Bang District,9,23,22,1,0
2022-04-25,Hai Phong City,Hong Bang District,10,37,34,3,0
2022-04-25,Hai Phong City,Hong Bang District,11,86,79,7,2
2022-04-25,Hai Phong City,Hong Bang District,12,58,51,7,1
2022-04-25,Hai Phong City,Hong Bang District,13,38,36,2,2
2022-04-25,Hai Phong City,Hong Bang District,14,50,46,4,2
2022-04-25,Hai Phong City,Hong Bang District,15,21,20,1,0
2022-04-25,Hai Phong City,Hong Bang District,16,35,33,2,0
2022-04-25,Hai Phong City,Hong Bang District,17,43,38,5,0
2022-04-25,Hai Phong City,Hong Bang District,18,64,58,6,0
2022-04-25,Hai Phong City,Hong Bang District,19,50,43,7,0
2022-04-25,Hai Phong City,Hong Bang District,20,55,44,11,4
2022-04-25,Hai Phong City,Hong Bang District,21,21,13,8,7
2022-04-25,Hai Phong City,Kien An District,1,1,1,0,0
2022-04-25,Hai Phong City,Kien An District,7,3,2,1,0
2022-04-25,Hai Phong City,Kien An District,9,9,4,5,3
2022-04-25,Hai Phong City,Kien An District,10,6,6,0,0
2022-04-25,Hai Phong City,Kien An District,11,17,13,4,2
2022-04-25,Hai Phong City,Kien An District,12,9,7,2,1
2022-04-25,Hai Phong City,Kien An District,13,6,4,2,1
2022-04-25,Hai Phong City,Kien An District,14,2,1,1,1
2022-04-25,Hai Phong City,Kien An District,15,8,8,0,0
2022-04-25,Hai Phong City,Kien An District,16,4,4,0,0
2022-04-25,Hai Phong City,Kien An District,17,9,8,1,1
2022-04-25,Hai Phong City,Kien An District,18,9,7,2,2
2022-04-25,Hai Phong City,Kien An District,19,3,2,1,1
2022-04-25,Hai Phong City,Kien An District,20,10,7,3,2
2022-04-25,Hai Phong City,Kien An District,21,3,2,1,1
2022-04-25,Hai Phong City,Le Chan District,0,1,0,1,1
2022-04-25,Hai Phong City,Le Chan District,1,1,0,1,0
2022-04-25,Hai Phong City,Le Chan District,3,2,1,1,1
2022-04-25,Hai Phong City,Le Chan District,6,1,1,0,0
2022-04-25,Hai Phong City,Le Chan District,7,24,21,3,0
2022-04-25,Hai Phong City,Le Chan District,8,62,56,6,0
2022-04-25,Hai Phong City,Le Chan District,9,75,62,13,0
2022-04-25,Hai Phong City,Le Chan District,10,117,102,15,1
2022-04-25,Hai Phong City,Le Chan District,11,249,219,30,7
2022-04-25,Hai Phong City,Le Chan District,12,178,165,13,1
2022-04-25,Hai Phong City,Le Chan District,13,110,94,16,3
2022-04-25,Hai Phong City,Le Chan District,14,131,114,17,3
2022-04-25,Hai Phong City,Le Chan District,15,141,129,12,0
2022-04-25,Hai Phong City,Le Chan District,16,123,110,13,0
2022-04-25,Hai Phong City,Le Chan District,17,151,133,18,0
2022-04-25,Hai Phong City,Le Chan District,18,243,226,17,1
2022-04-25,Hai Phong City,Le Chan District,19,151,137,14,2
2022-04-25,Hai Phong City,Le Chan District,20,152,136,16,2
2022-04-25,Hai Phong City,Le Chan District,21,74,58,16,2
2022-04-25,Hai Phong City,Le Chan District,22,1,1,0,0
2022-04-25,Hai Phong City,Ngo Quyen District,0,2,1,1,0
2022-04-25,Hai Phong City,Ngo Quyen District,6,1,1,0,0
2022-04-25,Hai Phong City,Ngo Quyen District,7,22,14,8,2
2022-04-25,Hai Phong City,Ngo Quyen District,8,55,51,4,3
2022-04-25,Hai Phong City,Ngo Quyen District,9,65,53,12,0
2022-04-25,Hai Phong City,Ngo Quyen District,10,88,84,4,0
2022-04-25,Hai Phong City,Ngo Quyen District,11,214,194,20,4
2022-04-25,Hai Phong City,Ngo Quyen District,12,123,117,6,1
2022-04-25,Hai Phong City,Ngo Quyen District,13,106,99,7,0
2022-04-25,Hai Phong City,Ngo Quyen District,14,105,98,7,0
2022-04-25,Hai Phong City,Ngo Quyen District,15,143,135,8,2
2022-04-25,Hai Phong City,Ngo Quyen District,16,140,125,15,1
2022-04-25,Hai Phong City,Ngo Quyen District,17,164,153,11,1
2022-04-25,Hai Phong City,Ngo Quyen District,18,148,131,17,2
2022-04-25,Hai Phong City,Ngo Quyen District,19,162,138,24,2
2022-04-25,Hai Phong City,Ngo Quyen District,20,127,116,11,0
2022-04-25,Hai Phong City,Ngo Quyen District,21,70,53,17,3
2022-04-25,Hai Phong City,Ngo Quyen District,22,2,0,2,1
2022-04-25,Hai Phong City,Ngo Quyen District,23,1,0,1,0
2022-04-25,Hai Phong City,Thuy Nguyen,10,2,0,2,2
2022-04-25,Hai Phong City,Thuy Nguyen,11,1,0,1,1
2022-04-25,Hai Phong City,Thuy Nguyen,12,1,0,1,1
2022-04-25,Hai Phong City,Thuy Nguyen,15,1,0,1,1
2022-04-25,Hai Phong City,Thuy Nguyen,18,1,1,0,0
2022-04-25,Hue City,Hue City,0,8,4,4,0
2022-04-25,Hue City,Hue City,1,2,1,1,0
2022-04-25,Hue City,Hue City,2,1,0,1,0
2022-04-25,Hue City,Hue City,3,1,1,0,0
2022-04-25,Hue City,Hue City,4,1,0,1,0
2022-04-25,Hue City,Hue City,5,2,1,1,0
2022-04-25,Hue City,Hue City,6,77,69,8,2
2022-04-25,Hue City,Hue City,7,161,152,9,0
2022-04-25,Hue City,Hue City,8,287,272,15,0
2022-04-25,Hue City,Hue City,9,280,269,11,0
2022-04-25,Hue City,Hue City,10,448,414,34,1
2022-04-25,Hue City,Hue City,11,964,875,89,4
2022-04-25,Hue City,Hue City,12,611,555,56,0
2022-04-25,Hue City,Hue City,13,356,332,24,0
2022-04-25,Hue City,Hue City,14,391,366,25,0
2022-04-25,Hue City,Hue City,15,410,378,32,0
2022-04-25,Hue City,Hue City,16,387,359,28,5
2022-04-25,Hue City,Hue City,17,508,470,38,1
2022-04-25,Hue City,Hue City,18,634,586,48,1
2022-04-25,Hue City,Hue City,19,614,568,46,0
2022-04-25,Hue City,Hue City,20,466,426,40,5
2022-04-25,Hue City,Hue City,21,273,242,31,2
2022-04-25,Hue City,Hue City,22,2,1,1,0
2022-04-25,Hue City,Hue City,23,1,0,1,0
2022-04-25,Hue City,Huong Thuy,9,2,1,1,1
2022-04-25,Hue City,Huong Thuy,11,1,1,0,0
2022-04-25,Hue City,Huong Thuy,14,2,1,1,1
2022-04-25,Hue City,Huong Thuy,16,3,2,1,0
2022-04-25,Hue City,Huong Thuy,17,3,2,1,1
2022-04-25,Hue City,Huong Thuy,18,5,1,4,4
2022-04-25,Hue City,Huong Thuy,20,2,0,2,0
2022-04-25,Hue City,Huong Thuy,21,1,0,1,0
2022-04-25,Hue City,Huong Tra,8,1,1,0,0
2022-04-25,Hue City,Huong Tra,18,1,0,1,1
2022-04-25,Hue City,Phu Vang,7,1,1,0,0
2022-04-25,Hue City,Phu Vang,9,1,1,0,0
2022-04-25,Hue City,Phu Vang,10,2,2,0,0
2022-04-25,Hue City,Phu Vang,11,4,3,1,0
2022-04-25,Hue City,Phu Vang,12,1,1,0,0
2022-04-25,Hue City,Phu Vang,13,3,3,0,0
2022-04-25,Hue City,Phu Vang,15,1,1,0,0
2022-04-25,Hue City,Phu Vang,16,3,3,0,0
2022-04-25,Hue City,Phu Vang,17,1,1,0,0
2022-04-25,Hue City,Phu Vang,18,5,3,2,0
2022-04-25,Hue City,Phu Vang,20,1,1,0,0
2022-04-25,Hue City,Phu Vang,21,1,1,0,0
2022-04-25,Vung Tau,Ba Ria City,8,4,0,4,3
2022-04-25,Vung Tau,Ba Ria City,9,2,2,0,0
2022-04-25,Vung Tau,Ba Ria City,10,7,3,4,3
2022-04-25,Vung Tau,Ba Ria City,11,11,8,3,0
2022-04-25,Vung Tau,Ba Ria City,12,8,6,2,2
2022-04-25,Vung Tau,Ba Ria City,13,5,2,3,2
2022-04-25,Vung Tau,Ba Ria City,14,5,3,2,0
2022-04-25,Vung Tau,Ba Ria City,15,4,3,1,1
2022-04-25,Vung Tau,Ba Ria City,16,1,1,0,0
2022-04-25,Vung Tau,Ba Ria City,17,7,7,0,0
2022-04-25,Vung Tau,Ba Ria City,18,3,3,0,0
2022-04-25,Vung Tau,Ba Ria City,19,1,0,1,1
2022-04-25,Vung Tau,Ba Ria City,20,3,0,3,3
2022-04-25,Vung Tau,Tan Thanh,14,1,0,1,1
2022-04-25,Vung Tau,Vung Tau City,0,3,2,1,1
2022-04-25,Vung Tau,Vung Tau City,2,1,1,0,0
2022-04-25,Vung Tau,Vung Tau City,5,1,0,1,1
2022-04-25,Vung Tau,Vung Tau City,6,32,27,5,2
2022-04-25,Vung Tau,Vung Tau City,7,93,78,15,6
2022-04-25,Vung Tau,Vung Tau City,8,138,123,15,2
2022-04-25,Vung Tau,Vung Tau City,9,163,148,15,0
2022-04-25,Vung Tau,Vung Tau City,10,203,188,15,1
2022-04-25,Vung Tau,Vung Tau City,11,352,325,27,5
2022-04-25,Vung Tau,Vung Tau City,12,308,277,31,1
2022-04-25,Vung Tau,Vung Tau City,13,200,181,19,2
2022-04-25,Vung Tau,Vung Tau City,14,223,210,13,1
2022-04-25,Vung Tau,Vung Tau City,15,215,201,14,2
2022-04-25,Vung Tau,Vung Tau City,16,172,166,6,0
2022-04-25,Vung Tau,Vung Tau City,17,198,180,18,1
2022-04-25,Vung Tau,Vung Tau City,18,298,276,22,6
2022-04-25,Vung Tau,Vung Tau City,19,251,227,24,2
2022-04-25,Vung Tau,Vung Tau City,20,191,172,19,7
2022-04-25,Vung Tau,Vung Tau City,21,108,90,18,4
2022-04-25,Vung Tau,Vung Tau City,23,1,1,0,0
2022-04-26,Binh Duong,Ben Cat,8,1,0,1,0
2022-04-26,Binh Duong,Ben Cat,9,1,0,1,1
2022-04-26,Binh Duong,Ben Cat,14,2,0,2,2
2022-04-26,Binh Duong,Ben Cat,15,2,0,2,2
2022-04-26,Binh Duong,Ben Cat,16,1,0,1,1
2022-04-26,Binh Duong,Ben Cat,19,1,1,0,0
2022-04-26,Binh Duong,Ben Cat,20,1,0,1,0
2022-04-26,Binh Duong,Di An,0,1,1,0,0
2022-04-26,Binh Duong,Di An,6,2,0,2,2
2022-04-26,Binh Duong,Di An,7,7,2,5,5
2022-04-26,Binh Duong,Di An,8,6,2,4,4
2022-04-26,Binh Duong,Di An,9,16,10,6,4
2022-04-26,Binh Duong,Di An,10,28,18,10,5
2022-04-26,Binh Duong,Di An,11,24,20,4,2
2022-04-26,Binh Duong,Di An,12,39,27,12,8
2022-04-26,Binh Duong,Di An,13,24,17,7,5
2022-04-26,Binh Duong,Di An,14,30,22,8,7
2022-04-26,Binh Duong,Di An,15,25,21,4,2
2022-04-26,Binh Duong,Di An,16,30,22,8,5
2022-04-26,Binh Duong,Di An,17,16,11,5,4
2022-04-26,Binh Duong,Di An,18,29,19,10,6
2022-04-26,Binh Duong,Di An,19,34,21,13,7
2022-04-26,Binh Duong,Di An,20,18,9,9,7
2022-04-26,Binh Duong,Di An,21,9,2,7,4
2022-04-26,Binh Duong,Tan Uyen,9,2,0,2,2
2022-04-26,Binh Duong,Tan Uyen,10,1,1,0,0
2022-04-26,Binh Duong,Tan Uyen,11,2,0,2,2
2022-04-26,Binh Duong,Tan Uyen,13,2,2,0,0
2022-04-26,Binh Duong,Tan Uyen,15,1,0,1,1
2022-04-26,Binh Duong,Tan Uyen,18,1,0,1,1
2022-04-26,Binh Duong,Tan Uyen,19,4,1,3,3
2022-04-26,Binh Duong,Tan Uyen,20,2,2,0,0
2022-04-26,Binh Duong,Thu Dau Mot Town,4,1,0,1,0
2022-04-26,Binh Duong,Thu Dau Mot Town,5,2,2,0,0
2022-04-26,Binh Duong,Thu Dau Mot Town,6,32,30,2,1
2022-04-26,Binh Duong,Thu Dau Mot Town,7,102,98,4,1
2022-04-26,Binh Duong,Thu Dau Mot Town,8,206,192,14,0
2022-04-26,Binh Duong,Thu Dau Mot Town,9,226,216,10,2
2022-04-26,Binh Duong,Thu Dau Mot Town,10,359,341,18,1
2022-04-26,Binh Duong,Thu Dau Mot Town,11,615,580,35,2
2022-04-26,Binh Duong,Thu Dau Mot Town,12,470,444,26,4
2022-04-26,Binh Duong,Thu Dau Mot Town,13,436,416,20,4
2022-04-26,Binh Duong,Thu Dau Mot Town,14,343,324,19,1
2022-04-26,Binh Duong,Thu Dau Mot Town,15,275,257,18,2
2022-04-26,Binh Duong,Thu Dau Mot Town,16,283,266,17,1
2022-04-26,Binh Duong,Thu Dau Mot Town,17,356,339,17,3
2022-04-26,Binh Duong,Thu Dau Mot Town,18,371,349,22,3
2022-04-26,Binh Duong,Thu Dau Mot Town,19,362,344,18,6
2022-04-26,Binh Duong,Thu Dau Mot Town,20,267,219,48,24
2022-04-26,Binh Duong,Thu Dau Mot Town,21,149,128,21,10
2022-04-26,Binh Duong,Thu Dau Mot Town,23,2,1,1,1
2022-04-26,Binh Duong,Thuan An,1,1,1,0,0
2022-04-26,Binh Duong,Thuan An,6,1,0,1,1
2022-04-26,Binh Duong,Thuan An,7,5,1,4,4
2022-04-26,Binh Duong,Thuan An,8,11,7,4,4
2022-04-26,Binh Duong,Thuan An,9,28,23,5,3
2022-04-26,Binh Duong,Thuan An,10,56,45,11,8
2022-04-26,Binh Duong,Thuan An,11,79,54,25,20
2022-04-26,Binh Duong,Thuan An,12,62,39,23,15
2022-04-26,Binh Duong,Thuan An,13,58,42,16,6
2022-04-26,Binh Duong,Thuan An,14,59,35,24,14
2022-04-26,Binh Duong,Thuan An,15,38,30,8,5
2022-04-26,Binh Duong,Thuan An,16,30,22,8,3
2022-04-26,Binh Duong,Thuan An,17,47,43,4,2
2022-04-26,Binh Duong,Thuan An,18,41,33,8,6
2022-04-26,Binh Duong,Thuan An,19,42,38,4,2
2022-04-26,Binh Duong,Thuan An,20,33,27,6,5
2022-04-26,Binh Duong,Thuan An,21,16,9,7,5
2022-04-26,Binh Duong,Thuan An,23,1,0,1,0
2022-04-26,Can Tho City,Binh Thuy District,1,1,0,1,0
2022-04-26,Can Tho City,Binh Thuy District,7,1,1,0,0
2022-04-26,Can Tho City,Binh Thuy District,8,5,2,3,0
2022-04-26,Can Tho City,Binh Thuy District,9,4,3,1,1
2022-04-26,Can Tho City,Binh Thuy District,10,15,15,0,0
2022-04-26,Can Tho City,Binh Thuy District,11,18,16,2,0
2022-04-26,Can Tho City,Binh Thuy District,12,11,11,0,0
2022-04-26,Can Tho City,Binh Thuy District,13,6,6,0,0
2022-04-26,Can Tho City,Binh Thuy District,14,17,14,3,0
2022-04-26,Can Tho City,Binh Thuy District,15,7,6,1,0
2022-04-26,Can Tho City,Binh Thuy District,16,13,13,0,0
2022-04-26,Can Tho City,Binh Thuy District,17,10,10,0,0
2022-04-26,Can Tho City,Binh Thuy District,18,34,28,6,2
2022-04-26,Can Tho City,Binh Thuy District,19,16,14,2,0
2022-04-26,Can Tho City,Binh Thuy District,20,7,5,2,0
2022-04-26,Can Tho City,Binh Thuy District,21,4,2,2,0
2022-04-26,Can Tho City,Cai Rang District,7,6,5,1,1
2022-04-26,Can Tho City,Cai Rang District,8,6,4,2,1
2022-04-26,Can Tho City,Cai Rang District,9,5,5,0,0
2022-04-26,Can Tho City,Cai Rang District,10,13,11,2,0
2022-04-26,Can Tho City,Cai Rang District,11,21,19,2,1
2022-04-26,Can Tho City,Cai Rang District,12,14,12,2,0
2022-04-26,Can Tho City,Cai Rang District,13,17,17,0,0
2022-04-26,Can Tho City,Cai Rang District,14,7,6,1,0
2022-04-26,Can Tho City,Cai Rang District,15,7,6,1,0
2022-04-26,Can Tho City,Cai Rang District,16,2,2,0,0
2022-04-26,Can Tho City,Cai Rang District,17,13,13,0,0
2022-04-26,Can Tho City,Cai Rang District,18,13,13,0,0
2022-04-26,Can Tho City,Cai Rang District,19,10,9,1,0
2022-04-26,Can Tho City,Cai Rang District,20,7,5,2,2
2022-04-26,Can Tho City,Cai Rang District,21,6,5,1,0
2022-04-26,Can Tho City,Ninh Kieu District,0,2,1,1,0
2022-04-26,Can Tho City,Ninh Kieu District,1,1,0,1,0
2022-04-26,Can Tho City,Ninh Kieu District,3,2,2,0,0
2022-04-26,Can Tho City,Ninh Kieu District,5,4,3,1,1
2022-04-26,Can Tho City,Ninh Kieu District,6,45,41,4,1
2022-04-26,Can Tho City,Ninh Kieu District,7,129,118,11,0
2022-04-26,Can Tho City,Ninh Kieu District,8,210,193,17,1
2022-04-26,Can Tho City,Ninh Kieu District,9,300,285,15,0
2022-04-26,Can Tho City,Ninh Kieu District,10,575,543,32,0
2022-04-26,Can Tho City,Ninh Kieu District,11,889,846,43,1
2022-04-26,Can Tho City,Ninh Kieu District,12,613,591,22,0
2022-04-26,Can Tho City,Ninh Kieu District,13,560,545,15,0
2022-04-26,Can Tho City,Ninh Kieu District,14,468,450,18,0
2022-04-26,Can Tho City,Ninh Kieu District,15,414,395,19,0
2022-04-26,Can Tho City,Ninh Kieu District,16,474,451,23,0
2022-04-26,Can Tho City,Ninh Kieu District,17,531,507,24,1
2022-04-26,Can Tho City,Ninh Kieu District,18,724,660,64,22
2022-04-26,Can Tho City,Ninh Kieu District,19,581,546,35,3
2022-04-26,Can Tho City,Ninh Kieu District,20,389,358,31,0
2022-04-26,Can Tho City,Ninh Kieu District,21,265,236,29,0
2022-04-26,Can Tho City,Ninh Kieu District,22,7,4,3,0
2022-04-26,Can Tho City,Ninh Kieu District,23,5,5,0,0
2022-04-26,Dong Nai,Bien Hoa City,0,4,3,1,0
2022-04-26,Dong Nai,Bien Hoa City,1,1,0,1,0
2022-04-26,Dong Nai,Bien Hoa City,2,3,2,1,0
2022-04-26,Dong Nai,Bien Hoa City,3,1,0,1,1
2022-04-26,Dong Nai,Bien Hoa City,4,1,0,1,1
2022-04-26,Dong Nai,Bien Hoa City,6,33,23,10,9
2022-04-26,Dong Nai,Bien Hoa City,7,151,132,19,10
2022-04-26,Dong Nai,Bien Hoa City,8,251,228,23,5
2022-04-26,Dong Nai,Bien Hoa City,9,384,350,34,3
2022-04-26,Dong Nai,Bien Hoa City,10,722,662,60,9
2022-04-26,Dong Nai,Bien Hoa City,11,1012,932,80,4
2022-04-26,Dong Nai,Bien Hoa City,12,763,701,62,12
2022-04-26,Dong Nai,Bien Hoa City,13,802,748,54,18
2022-04-26,Dong Nai,Bien Hoa City,14,655,614,41,5
2022-04-26,Dong Nai,Bien Hoa City,15,499,452,47,11
2022-04-26,Dong Nai,Bien Hoa City,16,522,484,38,11
2022-04-26,Dong Nai,Bien Hoa City,17,516,484,32,10
2022-04-26,Dong Nai,Bien Hoa City,18,717,661,56,9
2022-04-26,Dong Nai,Bien Hoa City,19,628,576,52,8
2022-04-26,Dong Nai,Bien Hoa City,20,484,424,60,17
2022-04-26,Dong Nai,Bien Hoa City,21,202,41,161,122
2022-04-26,Dong Nai,Bien Hoa City,22,3,1,2,0
2022-04-26,Dong Nai,Bien Hoa City,23,2,1,1,0
2022-04-26,Dong Nai,Long Khanh,15,1,0,1,0
2022-04-26,Dong Nai,Long Thanh,11,1,0,1,1
2022-04-26,Dong Nai,Nhon trach,16,2,0,2,2
2022-04-26,Dong Nai,Nhon trach,17,1,0,1,1
2022-04-26,Dong Nai,Thong Nhat,8,1,1,0,0
2022-04-26,Dong Nai,Thong Nhat,10,2,2,0,0
2022-04-26,Dong Nai,Thong Nhat,11,3,3,0,0
2022-04-26,Dong Nai,Thong Nhat,12,1,1,0,0
2022-04-26,Dong Nai,Thong Nhat,13,1,1,0,0
2022-04-26,Dong Nai,Trang Bom,10,2,0,2,2
2022-04-26,Dong Nai,Trang Bom,11,1,1,0,0
2022-04-26,Dong Nai,Trang Bom,14,1,1,0,0
2022-04-26,Dong Nai,Trang Bom,19,1,0,1,1
2022-04-26,Hai Phong City,An Duong,7,1,0,1,0
2022-04-26,Hai Phong City,An Duong,8,1,1,0,0
2022-04-26,Hai Phong City,An Duong,10,2,2,0,0
2022-04-26,Hai Phong City,An Duong,11,10,4,6,5
2022-04-26,Hai Phong City,An Duong,12,7,1,6,6
2022-04-26,Hai Phong City,An Duong,13,2,1,1,1
2022-04-26,Hai Phong City,An Duong,14,3,2,1,1
2022-04-26,Hai Phong City,An Duong,15,6,4,2,1
2022-04-26,Hai Phong City,An Duong,16,6,4,2,2
2022-04-26,Hai Phong City,An Duong,17,1,1,0,0
2022-04-26,Hai Phong City,An Duong,19,3,1,2,2
2022-04-26,Hai Phong City,An Duong,20,5,2,3,3
2022-04-26,Hai Phong City,Duong Kinh District,9,1,0,1,1
2022-04-26,Hai Phong City,Duong Kinh District,17,2,0,2,1
2022-04-26,Hai Phong City,Duong Kinh District,21,1,0,1,0
2022-04-26,Hai Phong City,Hai An District,6,1,0,1,1
2022-04-26,Hai Phong City,Hai An District,7,6,3,3,2
2022-04-26,Hai Phong City,Hai An District,8,11,10,1,0
2022-04-26,Hai Phong City,Hai An District,9,8,6,2,1
2022-04-26,Hai Phong City,Hai An District,10,18,14,4,0
2022-04-26,Hai Phong City,Hai An District,11,37,31,6,1
2022-04-26,Hai Phong City,Hai An District,12,23,22,1,0
2022-04-26,Hai Phong City,Hai An District,13,6,6,0,0
2022-04-26,Hai Phong City,Hai An District,14,16,13,3,2
2022-04-26,Hai Phong City,Hai An District,15,25,19,6,0
2022-04-26,Hai Phong City,Hai An District,16,12,9,3,1
2022-04-26,Hai Phong City,Hai An District,17,15,13,2,1
2022-04-26,Hai Phong City,Hai An District,18,33,30,3,0
2022-04-26,Hai Phong City,Hai An District,19,22,20,2,0
2022-04-26,Hai Phong City,Hai An District,20,19,13,6,1
2022-04-26,Hai Phong City,Hai An District,21,10,8,2,2
2022-04-26,Hai Phong City,Hai An District,22,1,0,1,0
2022-04-26,Hai Phong City,Hong Bang District,5,1,1,0,0
2022-04-26,Hai Phong City,Hong Bang District,6,1,0,1,1
2022-04-26,Hai Phong City,Hong Bang District,7,13,9,4,1
2022-04-26,Hai Phong City,Hong Bang District,8,36,29,7,3
2022-04-26,Hai Phong City,Hong Bang District,9,23,23,0,0
2022-04-26,Hai Phong City,Hong Bang District,10,30,26,4,0
2022-04-26,Hai Phong City,Hong Bang District,11,79,71,8,2
2022-04-26,Hai Phong City,Hong Bang District,12,52,49,3,1
2022-04-26,Hai Phong City,Hong Bang District,13,31,29,2,0
2022-04-26,Hai Phong City,Hong Bang District,14,38,33,5,1
2022-04-26,Hai Phong City,Hong Bang District,15,27,26,1,1
2022-04-26,Hai Phong City,Hong Bang District,16,40,37,3,1
2022-04-26,Hai Phong City,Hong Bang District,17,46,41,5,0
2022-04-26,Hai Phong City,Hong Bang District,18,68,65,3,1
2022-04-26,Hai Phong City,Hong Bang District,19,49,41,8,2
2022-04-26,Hai Phong City,Hong Bang District,20,54,41,13,2
2022-04-26,Hai Phong City,Hong Bang District,21,18,15,3,0
2022-04-26,Hai Phong City,Hong Bang District,22,1,1,0,0
2022-04-26,Hai Phong City,Kien An District,8,3,2,1,1
2022-04-26,Hai Phong City,Kien An District,9,9,6,3,3
2022-04-26,Hai Phong City,Kien An District,10,11,7,4,2
2022-04-26,Hai Phong City,Kien An District,11,16,10,6,4
2022-04-26,Hai Phong City,Kien An District,12,11,5,6,6
2022-04-26,Hai Phong City,Kien An District,13,11,3,8,8
2022-04-26,Hai Phong City,Kien An District,14,5,2,3,2
2022-04-26,Hai Phong City,Kien An District,15,10,6,4,3
2022-04-26,Hai Phong City,Kien An District,16,2,1,1,0
2022-04-26,Hai Phong City,Kien An District,17,4,4,0,0
2022-04-26,Hai Phong City,Kien An District,18,12,10,2,2
2022-04-26,Hai Phong City,Kien An District,19,11,8,3,2
2022-04-26,Hai Phong City,Kien An District,20,15,5,10,3
2022-04-26,Hai Phong City,Kien An District,21,7,3,4,1
2022-04-26,Hai Phong City,Le Chan District,0,1,0,1,1
2022-04-26,Hai Phong City,Le Chan District,7,35,27,8,5
2022-04-26,Hai Phong City,Le Chan District,8,69,61,8,0
2022-04-26,Hai Phong City,Le Chan District,9,72,65,7,0
2022-04-26,Hai Phong City,Le Chan District,10,141,129,12,1
2022-04-26,Hai Phong City,Le Chan District,11,271,253,18,5
2022-04-26,Hai Phong City,Le Chan District,12,170,162,8,0
2022-04-26,Hai Phong City,Le Chan District,13,126,117,9,1
2022-04-26,Hai Phong City,Le Chan District,14,121,107,14,2
2022-04-26,Hai Phong City,Le Chan District,15,150,134,16,0
2022-04-26,Hai Phong City,Le Chan District,16,127,110,17,0
2022-04-26,Hai Phong City,Le Chan District,17,156,145,11,1
2022-04-26,Hai Phong City,Le Chan District,18,202,185,17,2
2022-04-26,Hai Phong City,Le Chan District,19,192,177,15,2
2022-04-26,Hai Phong City,Le Chan District,20,142,127,15,3
2022-04-26,Hai Phong City,Le Chan District,21,75,63,12,4
2022-04-26,Hai Phong City,Le Chan District,22,1,0,1,0
2022-04-26,Hai Phong City,Le Chan District,23,5,0,5,0
2022-04-26,Hai Phong City,Ngo Quyen District,0,1,0,1,0
2022-04-26,Hai Phong City,Ngo Quyen District,1,1,1,0,0
2022-04-26,Hai Phong City,Ngo Quyen District,6,1,1,0,0
2022-04-26,Hai Phong City,Ngo Quyen District,7,23,13,10,3
2022-04-26,Hai Phong City,Ngo Quyen District,8,56,47,9,0
2022-04-26,Hai Phong City,Ngo Quyen District,9,97,84,13,1
2022-04-26,Hai Phong City,Ngo Quyen District,10,131,115,16,0
2022-04-26,Hai Phong City,Ngo Quyen District,11,203,188,15,2
2022-04-26,Hai Phong City,Ngo Quyen District,12,132,123,9,0
2022-04-26,Hai Phong City,Ngo Quyen District,13,102,93,9,0
2022-04-26,Hai Phong City,Ngo Quyen District,14,133,119,14,0
2022-04-26,Hai Phong City,Ngo Quyen District,15,131,113,18,0
2022-04-26,Hai Phong City,Ngo Quyen District,16,129,112,17,1
2022-04-26,Hai Phong City,Ngo Quyen District,17,146,134,12,1
2022-04-26,Hai Phong City,Ngo Quyen District,18,160,143,17,3
2022-04-26,Hai Phong City,Ngo Quyen District,19,179,160,19,4
2022-04-26,Hai Phong City,Ngo Quyen District,20,122,105,17,1
2022-04-26,Hai Phong City,Ngo Quyen District,21,64,48,16,2
2022-04-26,Hai Phong City,Thuy Nguyen,9,2,0,2,2
2022-04-26,Hai Phong City,Thuy Nguyen,10,1,0,1,1
2022-04-26,Hai Phong City,Thuy Nguyen,11,6,0,6,4
2022-04-26,Hai Phong City,Thuy Nguyen,12,3,0,3,2
2022-04-26,Hai Phong City,Thuy Nguyen,14,2,0,2,1
2022-04-26,Hai Phong City,Thuy Nguyen,19,2,0,2,2
2022-04-26,Hai Phong City,Thuy Nguyen,20,1,0,1,1
2022-04-26,Hue City,Hue City,0,6,5,1,0
2022-04-26,Hue City,Hue City,1,3,1,2,0
2022-04-26,Hue City,Hue City,5,1,0,1,0
2022-04-26,Hue City,Hue City,6,73,68,5,1
2022-04-26,Hue City,Hue City,7,214,196,18,2
2022-04-26,Hue City,Hue City,8,285,264,21,0
2022-04-26,Hue City,Hue City,9,238,224,14,0
2022-04-26,Hue City,Hue City,10,465,444,21,0
2022-04-26,Hue City,Hue City,11,1010,953,57,4
2022-04-26,Hue City,Hue City,12,563,529,34,0
2022-04-26,Hue City,Hue City,13,427,410,17,0
2022-04-26,Hue City,Hue City,14,423,397,26,3
2022-04-26,Hue City,Hue City,15,409,372,37,3
2022-04-26,Hue City,Hue City,16,460,426,34,3
2022-04-26,Hue City,Hue City,17,484,447,37,3
2022-04-26,Hue City,Hue City,18,629,590,39,5
2022-04-26,Hue City,Hue City,19,691,623,68,1
2022-04-26,Hue City,Hue City,20,516,471,45,1
2022-04-26,Hue City,Hue City,21,270,239,31,4
2022-04-26,Hue City,Hue City,22,6,4,2,0
2022-04-26,Hue City,Hue City,23,2,1,1,0
2022-04-26,Hue City,Huong Thuy,8,1,1,0,0
2022-04-26,Hue City,Huong Thuy,11,2,2,0,0
2022-04-26,Hue City,Huong Thuy,14,1,1,0,0
2022-04-26,Hue City,Huong Thuy,17,4,3,1,0
2022-04-26,Hue City,Huong Thuy,21,1,1,0,0
2022-04-26,Hue City,Huong Tra,13,1,1,0,0
2022-04-26,Hue City,Phu Vang,8,1,1,0,0
2022-04-26,Hue City,Phu Vang,10,1,1,0,0
2022-04-26,Hue City,Phu Vang,15,1,0,1,1
2022-04-26,Hue City,Phu Vang,17,2,1,1,1
2022-04-26,Hue City,Phu Vang,18,6,5,1,0
2022-04-26,Hue City,Phu Vang,19,1,1,0,0
2022-04-26,Hue City,Phu Vang,20,1,1,0,0
2022-04-26,Hue City,Phu Vang,21,1,0,1,1
2022-04-26,Vung Tau,Ba Ria City,8,3,0,3,3
2022-04-26,Vung Tau,Ba Ria City,9,6,2,4,3
2022-04-26,Vung Tau,Ba Ria City,10,11,8,3,2
2022-04-26,Vung Tau,Ba Ria City,11,10,9,1,1
2022-04-26,Vung Tau,Ba Ria City,12,3,2,1,0
2022-04-26,Vung Tau,Ba Ria City,13,9,7,2,2
2022-04-26,Vung Tau,Ba Ria City,14,7,7,0,0
2022-04-26,Vung Tau,Ba Ria City,15,7,5,2,0
2022-04-26,Vung Tau,Ba Ria City,16,6,4,2,1
2022-04-26,Vung Tau,Ba Ria City,17,3,2,1,0
2022-04-26,Vung Tau,Ba Ria City,18,5,3,2,0
2022-04-26,Vung Tau,Ba Ria City,19,7,2,5,4
2022-04-26,Vung Tau,Ba Ria City,20,3,1,2,2
2022-04-26,Vung Tau,Ba Ria City,21,2,0,2,2
2022-04-26,Vung Tau,Vung Tau City,1,1,1,0,0
2022-04-26,Vung Tau,Vung Tau City,2,1,1,0,0
2022-04-26,Vung Tau,Vung Tau City,3,1,1,0,0
2022-04-26,Vung Tau,Vung Tau City,6,39,30,9,5
2022-04-26,Vung Tau,Vung Tau City,7,88,80,8,0
2022-04-26,Vung Tau,Vung Tau City,8,148,136,12,0
2022-04-26,Vung Tau,Vung Tau City,9,142,135,7,0
2022-04-26,Vung Tau,Vung Tau City,10,177,166,11,1
2022-04-26,Vung Tau,Vung Tau City,11,374,343,31,3
2022-04-26,Vung Tau,Vung Tau City,12,285,271,14,1
2022-04-26,Vung Tau,Vung Tau City,13,214,200,14,3
2022-04-26,Vung Tau,Vung Tau City,14,242,229,13,4
2022-04-26,Vung Tau,Vung Tau City,15,201,187,14,2
2022-04-26,Vung Tau,Vung Tau City,16,210,186,24,5
2022-04-26,Vung Tau,Vung Tau City,17,264,249,15,1
2022-04-26,Vung Tau,Vung Tau City,18,302,287,15,1
2022-04-26,Vung Tau,Vung Tau City,19,259,236,23,6
2022-04-26,Vung Tau,Vung Tau City,20,215,189,26,6
2022-04-26,Vung Tau,Vung Tau City,21,107,68,39,23
2022-04-26,Vung Tau,Vung Tau City,22,2,1,1,0
2022-04-27,Binh Duong,Ben Cat,10,1,0,1,1
2022-04-27,Binh Duong,Ben Cat,12,1,0,1,1
2022-04-27,Binh Duong,Ben Cat,13,1,0,1,0
2022-04-27,Binh Duong,Ben Cat,16,1,0,1,1
2022-04-27,Binh Duong,Ben Cat,19,1,0,1,0
2022-04-27,Binh Duong,Di An,7,3,2,1,1
2022-04-27,Binh Duong,Di An,8,11,3,8,8
2022-04-27,Binh Duong,Di An,9,14,12,2,0
2022-04-27,Binh Duong,Di An,10,29,18,11,10
2022-04-27,Binh Duong,Di An,11,34,18,16,11
2022-04-27,Binh Duong,Di An,12,39,27,12,8
2022-04-27,Binh Duong,Di An,13,32,26,6,6
2022-04-27,Binh Duong,Di An,14,17,11,6,4
2022-04-27,Binh Duong,Di An,15,25,15,10,10
2022-04-27,Binh Duong,Di An,16,19,11,8,6
2022-04-27,Binh Duong,Di An,17,38,20,18,16
2022-04-27,Binh Duong,Di An,18,28,18,10,8
2022-04-27,Binh Duong,Di An,19,18,15,3,0
2022-04-27,Binh Duong,Di An,20,16,14,2,2
2022-04-27,Binh Duong,Di An,21,7,3,4,3
2022-04-27,Binh Duong,Tan Uyen,8,2,1,1,1
2022-04-27,Binh Duong,Tan Uyen,9,1,0,1,1
2022-04-27,Binh Duong,Tan Uyen,10,4,2,2,1
2022-04-27,Binh Duong,Tan Uyen,11,3,2,1,1
2022-04-27,Binh Duong,Tan Uyen,12,1,0,1,1
2022-04-27,Binh Duong,Tan Uyen,13,3,3,0,0
2022-04-27,Binh Duong,Tan Uyen,14,1,1,0,0
2022-04-27,Binh Duong,Tan Uyen,17,1,1,0,0
2022-04-27,Binh Duong,Tan Uyen,18,1,1,0,0
2022-04-27,Binh Duong,Tan Uyen,19,2,2,0,0
2022-04-27,Binh Duong,Tan Uyen,20,3,0,3,2
2022-04-27,Binh Duong,Tan Uyen,21,1,0,1,1
2022-04-27,Binh Duong,Thu Dau Mot Town,5,4,1,3,2
2022-04-27,Binh Duong,Thu Dau Mot Town,6,44,36,8,4
2022-04-27,Binh Duong,Thu Dau Mot Town,7,100,89,11,1
2022-04-27,Binh Duong,Thu Dau Mot Town,8,200,186,14,1
2022-04-27,Binh Duong,Thu Dau Mot Town,9,202,196,6,1
2022-04-27,Binh Duong,Thu Dau Mot Town,10,377,340,37,7
2022-04-27,Binh Duong,Thu Dau Mot Town,11,677,641,36,3
2022-04-27,Binh Duong,Thu Dau Mot Town,12,419,397,22,0
2022-04-27,Binh Duong,Thu Dau Mot Town,13,399,372,27,1
2022-04-27,Binh Duong,Thu Dau Mot Town,14,320,292,28,4
2022-04-27,Binh Duong,Thu Dau Mot Town,15,289,270,19,0
2022-04-27,Binh Duong,Thu Dau Mot Town,16,278,258,20,6
2022-04-27,Binh Duong,Thu Dau Mot Town,17,369,353,16,0
2022-04-27,Binh Duong,Thu Dau Mot Town,18,339,318,21,0
2022-04-27,Binh Duong,Thu Dau Mot Town,19,347,323,24,2
2022-04-27,Binh Duong,Thu Dau Mot Town,20,286,264,22,2
2022-04-27,Binh Duong,Thu Dau Mot Town,21,137,105,32,12
2022-04-27,Binh Duong,Thu Dau Mot Town,22,1,0,1,0
2022-04-27,Binh Duong,Thu Dau Mot Town,23,1,1,0,0
2022-04-27,Binh Duong,Thuan An,7,5,1,4,3
2022-04-27,Binh Duong,Thuan An,8,24,12,12,9
2022-04-27,Binh Duong,Thuan An,9,33,21,12,5
2022-04-27,Binh Duong,Thuan An,10,47,38,9,5
2022-04-27,Binh Duong,Thuan An,11,78,44,34,25
2022-04-27,Binh Duong,Thuan An,12,66,46,20,16
2022-04-27,Binh Duong,Thuan An,13,68,43,25,19
2022-04-27,Binh Duong,Thuan An,14,48,34,14,10
2022-04-27,Binh Duong,Thuan An,15,38,25,13,12
2022-04-27,Binh Duong,Thuan An,16,26,24,2,0
2022-04-27,Binh Duong,Thuan An,17,33,30,3,2
2022-04-27,Binh Duong,Thuan An,18,24,21,3,2
2022-04-27,Binh Duong,Thuan An,19,25,22,3,1
2022-04-27,Binh Duong,Thuan An,20,34,23,11,9
2022-04-27,Binh Duong,Thuan An,21,15,11,4,3
2022-04-27,Can Tho City,Binh Thuy District,1,1,1,0,0
2022-04-27,Can Tho City,Binh Thuy District,7,2,1,1,0
2022-04-27,Can Tho City,Binh Thuy District,8,3,2,1,0
2022-04-27,Can Tho City,Binh Thuy District,9,5,5,0,0
2022-04-27,Can Tho City,Binh Thuy District,10,11,9,2,0
2022-04-27,Can Tho City,Binh Thuy District,11,16,14,2,0
2022-04-27,Can Tho City,Binh Thuy District,12,9,7,2,0
2022-04-27,Can Tho City,Binh Thuy District,13,12,10,2,1
2022-04-27,Can Tho City,Binh Thuy District,14,10,10,0,0
2022-04-27,Can Tho City,Binh Thuy District,15,9,8,1,0
2022-04-27,Can Tho City,Binh Thuy District,16,14,12,2,0
2022-04-27,Can Tho City,Binh Thuy District,17,15,14,1,0
2022-04-27,Can Tho City,Binh Thuy District,18,10,10,0,0
2022-04-27,Can Tho City,Binh Thuy District,19,18,17,1,0
2022-04-27,Can Tho City,Binh Thuy District,20,4,4,0,0
2022-04-27,Can Tho City,Binh Thuy District,21,7,3,4,1
2022-04-27,Can Tho City,Cai Rang District,7,6,6,0,0
2022-04-27,Can Tho City,Cai Rang District,8,5,3,2,1
2022-04-27,Can Tho City,Cai Rang District,9,6,6,0,0
2022-04-27,Can Tho City,Cai Rang District,10,13,9,4,2
2022-04-27,Can Tho City,Cai Rang District,11,12,10,2,1
2022-04-27,Can Tho City,Cai Rang District,12,6,5,1,1
2022-04-27,Can Tho City,Cai Rang District,13,9,9,0,0
2022-04-27,Can Tho City,Cai Rang District,14,8,7,1,1
2022-04-27,Can Tho City,Cai Rang District,15,6,6,0,0
2022-04-27,Can Tho City,Cai Rang District,16,6,6,0,0
2022-04-27,Can Tho City,Cai Rang District,17,7,7,0,0
2022-04-27,Can Tho City,Cai Rang District,18,9,7,2,0
2022-04-27,Can Tho City,Cai Rang District,19,1,1,0,0
2022-04-27,Can Tho City,Cai Rang District,20,14,10,4,3
2022-04-27,Can Tho City,Cai Rang District,21,7,5,2,1
2022-04-27,Can Tho City,Ninh Kieu District,0,4,4,0,0
2022-04-27,Can Tho City,Ninh Kieu District,2,2,2,0,0
2022-04-27,Can Tho City,Ninh Kieu District,3,1,1,0,0
2022-04-27,Can Tho City,Ninh Kieu District,5,4,4,0,0
2022-04-27,Can Tho City,Ninh Kieu District,6,49,44,5,0
2022-04-27,Can Tho City,Ninh Kieu District,7,120,109,11,0
2022-04-27,Can Tho City,Ninh Kieu District,8,225,214,11,0
2022-04-27,Can Tho City,Ninh Kieu District,9,262,252,10,0
2022-04-27,Can Tho City,Ninh Kieu District,10,595,569,26,0
2022-04-27,Can Tho City,Ninh Kieu District,11,917,879,38,3
2022-04-27,Can Tho City,Ninh Kieu District,12,654,617,37,0
2022-04-27,Can Tho City,Ninh Kieu District,13,516,487,29,0
2022-04-27,Can Tho City,Ninh Kieu District,14,434,408,26,1
2022-04-27,Can Tho City,Ninh Kieu District,15,388,367,21,0
2022-04-27,Can Tho City,Ninh Kieu District,16,456,429,27,0
2022-04-27,Can Tho City,Ninh Kieu District,17,554,535,19,0
2022-04-27,Can Tho City,Ninh Kieu District,18,586,563,23,0
2022-04-27,Can Tho City,Ninh Kieu District,19,494,472,22,1
2022-04-27,Can Tho City,Ninh Kieu District,20,407,380,27,0
2022-04-27,Can Tho City,Ninh Kieu District,21,234,203,31,0
2022-04-27,Can Tho City,Ninh Kieu District,22,4,3,1,0
2022-04-27,Can Tho City,Ninh Kieu District,23,4,4,0,0
2022-04-27,Dong Nai,Bien Hoa City,0,2,1,1,0
2022-04-27,Dong Nai,Bien Hoa City,1,2,1,1,0
2022-04-27,Dong Nai,Bien Hoa City,3,1,1,0,0
2022-04-27,Dong Nai,Bien Hoa City,6,35,16,19,8
2022-04-27,Dong Nai,Bien Hoa City,7,154,127,27,10
2022-04-27,Dong Nai,Bien Hoa City,8,286,259,27,3
2022-04-27,Dong Nai,Bien Hoa City,9,375,339,36,4
2022-04-27,Dong Nai,Bien Hoa City,10,669,623,46,4
2022-04-27,Dong Nai,Bien Hoa City,11,1103,1004,99,26
2022-04-27,Dong Nai,Bien Hoa City,12,817,752,65,10
2022-04-27,Dong Nai,Bien Hoa City,13,768,718,50,12
2022-04-27,Dong Nai,Bien Hoa City,14,645,597,48,6
2022-04-27,Dong Nai,Bien Hoa City,15,512,465,47,7
2022-04-27,Dong Nai,Bien Hoa City,16,506,448,58,11
2022-04-27,Dong Nai,Bien Hoa City,17,603,564,39,10
2022-04-27,Dong Nai,Bien Hoa City,18,675,635,40,5
2022-04-27,Dong Nai,Bien Hoa City,19,626,584,42,1
2022-04-27,Dong Nai,Bien Hoa City,20,481,430,51,13
2022-04-27,Dong Nai,Bien Hoa City,21,240,146,94,58
2022-04-27,Dong Nai,Bien Hoa City,22,5,1,4,1
2022-04-27,Dong Nai,Long Khanh,11,1,0,1,1
2022-04-27,Dong Nai,Long Khanh,12,2,0,2,2
2022-04-27,Dong Nai,Long Khanh,13,1,0,1,1
2022-04-27,Dong Nai,Long Khanh,14,1,0,1,1
2022-04-27,Dong Nai,Long Thanh,14,1,0,1,1
2022-04-27,Dong Nai,Long Thanh,15,1,1,0,0
2022-04-27,Dong Nai,Long Thanh,20,3,0,3,3
2022-04-27,Dong Nai,Nhon trach,11,1,0,1,1
2022-04-27,Dong Nai,Trang Bom,10,1,0,1,1
2022-04-27,Dong Nai,Trang Bom,15,1,0,1,1
2022-04-27,Dong Nai,Trang Bom,20,1,0,1,1
2022-04-27,Hai Phong City,An Duong,7,3,1,2,1
2022-04-27,Hai Phong City,An Duong,8,1,0,1,0
2022-04-27,Hai Phong City,An Duong,9,4,1,3,2
2022-04-27,Hai Phong City,An Duong,10,4,2,2,2
2022-04-27,Hai Phong City,An Duong,11,4,2,2,1
2022-04-27,Hai Phong City,An Duong,12,3,1,2,0
2022-04-27,Hai Phong City,An Duong,13,1,1,0,0
2022-04-27,Hai Phong City,An Duong,14,5,2,3,3
2022-04-27,Hai Phong City,An Duong,15,5,1,4,4
2022-04-27,Hai Phong City,An Duong,16,5,4,1,1
2022-04-27,Hai Phong City,An Duong,17,4,2,2,1
2022-04-27,Hai Phong City,An Duong,18,3,3,0,0
2022-04-27,Hai Phong City,An Duong,19,3,1,2,1
2022-04-27,Hai Phong City,Hai An District,0,2,1,1,0
2022-04-27,Hai Phong City,Hai An District,5,1,1,0,0
2022-04-27,Hai Phong City,Hai An District,7,5,4,1,1
2022-04-27,Hai Phong City,Hai An District,8,8,7,1,1
2022-04-27,Hai Phong City,Hai An District,9,10,9,1,0
2022-04-27,Hai Phong City,Hai An District,10,19,17,2,1
2022-04-27,Hai Phong City,Hai An District,11,41,34,7,0
2022-04-27,Hai Phong City,Hai An District,12,27,25,2,0
2022-04-27,Hai Phong City,Hai An District,13,16,16,0,0
2022-04-27,Hai Phong City,Hai An District,14,18,14,4,0
2022-04-27,Hai Phong City,Hai An District,15,17,12,5,0
2022-04-27,Hai Phong City,Hai An District,16,11,8,3,0
2022-04-27,Hai Phong City,Hai An District,17,12,10,2,0
2022-04-27,Hai Phong City,Hai An District,18,28,27,1,0
2022-04-27,Hai Phong City,Hai An District,19,22,20,2,0
2022-04-27,Hai Phong City,Hai An District,20,16,13,3,1
2022-04-27,Hai Phong City,Hai An District,21,9,8,1,0
2022-04-27,Hai Phong City,Hong Bang District,7,9,4,5,3
2022-04-27,Hai Phong City,Hong Bang District,8,40,33,7,3
2022-04-27,Hai Phong City,Hong Bang District,9,27,24,3,0
2022-04-27,Hai Phong City,Hong Bang District,10,51,48,3,1
2022-04-27,Hai Phong City,Hong Bang District,11,115,97,18,5
2022-04-27,Hai Phong City,Hong Bang District,12,57,51,6,0
2022-04-27,Hai Phong City,Hong Bang District,13,40,35,5,1
2022-04-27,Hai Phong City,Hong Bang District,14,44,36,8,1
2022-04-27,Hai Phong City,Hong Bang District,15,34,28,6,3
2022-04-27,Hai Phong City,Hong Bang District,16,44,37,7,0
2022-04-27,Hai Phong City,Hong Bang District,17,39,35,4,0
2022-04-27,Hai Phong City,Hong Bang District,18,63,54,9,2
2022-04-27,Hai Phong City,Hong Bang District,19,57,46,11,2
2022-04-27,Hai Phong City,Hong Bang District,20,41,32,9,2
2022-04-27,Hai Phong City,Hong Bang District,21,18,12,6,2
2022-04-27,Hai Phong City,Hong Bang District,22,1,0,1,1
2022-04-27,Hai Phong City,Kien An District,7,1,0,1,0
2022-04-27,Hai Phong City,Kien An District,8,3,0,3,3
2022-04-27,Hai Phong City,Kien An District,9,5,1,4,4
2022-04-27,Hai Phong City,Kien An District,10,6,4,2,2
2022-04-27,Hai Phong City,Kien An District,11,16,8,8,7
2022-04-27,Hai Phong City,Kien An District,12,11,6,5,4
2022-04-27,Hai Phong City,Kien An District,13,6,4,2,1
2022-04-27,Hai Phong City,Kien An District,14,10,6,4,4
2022-04-27,Hai Phong City,Kien An District,15,6,3,3,3
2022-04-27,Hai Phong City,Kien An District,16,6,6,0,0
2022-04-27,Hai Phong City,Kien An District,17,7,7,0,0
2022-04-27,Hai Phong City,Kien An District,18,17,13,4,1
2022-04-27,Hai Phong City,Kien An District,19,11,6,5,0
2022-04-27,Hai Phong City,Kien An District,20,10,3,7,7
2022-04-27,Hai Phong City,Kien An District,21,4,2,2,1
2022-04-27,Hai Phong City,Le Chan District,0,1,0,1,0
2022-04-27,Hai Phong City,Le Chan District,1,1,1,0,0
2022-04-27,Hai Phong City,Le Chan District,6,1,1,0,0
2022-04-27,Hai Phong City,Le Chan District,7,36,23,13,8
2022-04-27,Hai Phong City,Le Chan District,8,70,57,13,3
2022-04-27,Hai Phong City,Le Chan District,9,69,63,6,0
2022-04-27,Hai Phong City,Le Chan District,10,126,110,16,1
2022-04-27,Hai Phong City,Le Chan District,11,278,249,29,14
2022-04-27,Hai Phong City,Le Chan District,12,141,132,9,1
2022-04-27,Hai Phong City,Le Chan District,13,115,100,15,1
2022-04-27,Hai Phong City,Le Chan District,14,129,121,8,3
2022-04-27,Hai Phong City,Le Chan District,15,164,146,18,4
2022-04-27,Hai Phong City,Le Chan District,16,146,133,13,1
2022-04-27,Hai Phong City,Le Chan District,17,158,144,14,0
2022-04-27,Hai Phong City,Le Chan District,18,198,172,26,5
2022-04-27,Hai Phong City,Le Chan District,19,199,180,19,2
2022-04-27,Hai Phong City,Le Chan District,20,144,130,14,1
2022-04-27,Hai Phong City,Le Chan District,21,69,52,17,7
2022-04-27,Hai Phong City,Le Chan District,22,2,1,1,0
2022-04-27,Hai Phong City,Le Chan District,23,1,1,0,0
2022-04-27,Hai Phong City,Ngo Quyen District,0,1,0,1,0
2022-04-27,Hai Phong City,Ngo Quyen District,6,3,2,1,0
2022-04-27,Hai Phong City,Ngo Quyen District,7,30,23,7,5
2022-04-27,Hai Phong City,Ngo Quyen District,8,68,61,7,2
2022-04-27,Hai Phong City,Ngo Quyen District,9,47,46,1,0
2022-04-27,Hai Phong City,Ngo Quyen District,10,91,79,12,2
2022-04-27,Hai Phong City,Ngo Quyen District,11,212,197,15,2
2022-04-27,Hai Phong City,Ngo Quyen District,12,140,130,10,0
2022-04-27,Hai Phong City,Ngo Quyen District,13,90,85,5,2
2022-04-27,Hai Phong City,Ngo Quyen District,14,118,109,9,3
2022-04-27,Hai Phong City,Ngo Quyen District,15,139,123,16,1
2022-04-27,Hai Phong City,Ngo Quyen District,16,108,101,7,0
2022-04-27,Hai Phong City,Ngo Quyen District,17,132,120,12,1
2022-04-27,Hai Phong City,Ngo Quyen District,18,152,138,14,3
2022-04-27,Hai Phong City,Ngo Quyen District,19,148,136,12,1
2022-04-27,Hai Phong City,Ngo Quyen District,20,131,119,12,0
2022-04-27,Hai Phong City,Ngo Quyen District,21,70,47,23,4
2022-04-27,Hai Phong City,Thuy Nguyen,10,1,0,1,0
2022-04-27,Hai Phong City,Thuy Nguyen,11,2,1,1,1
2022-04-27,Hai Phong City,Thuy Nguyen,13,2,1,1,1
2022-04-27,Hai Phong City,Thuy Nguyen,14,1,0,1,1
2022-04-27,Hai Phong City,Thuy Nguyen,15,2,0,2,2
2022-04-27,Hai Phong City,Thuy Nguyen,16,1,0,1,1
2022-04-27,Hue City,Hue City,0,1,1,0,0
2022-04-27,Hue City,Hue City,5,2,2,0,0
2022-04-27,Hue City,Hue City,6,62,60,2,2
2022-04-27,Hue City,Hue City,7,202,193,9,1
2022-04-27,Hue City,Hue City,8,268,248,20,0
2022-04-27,Hue City,Hue City,9,298,273,25,0
2022-04-27,Hue City,Hue City,10,533,497,36,0
2022-04-27,Hue City,Hue City,11,1064,980,84,5
2022-04-27,Hue City,Hue City,12,601,563,38,2
2022-04-27,Hue City,Hue City,13,343,321,22,2
2022-04-27,Hue City,Hue City,14,386,360,26,1
2022-04-27,Hue City,Hue City,15,403,387,16,0
2022-04-27,Hue City,Hue City,16,366,351,15,3
2022-04-27,Hue City,Hue City,17,522,485,37,1
2022-04-27,Hue City,Hue City,18,616,572,44,1
2022-04-27,Hue City,Hue City,19,606,556,50,2
2022-04-27,Hue City,Hue City,20,466,420,46,5
2022-04-27,Hue City,Hue City,21,261,230,31,4
2022-04-27,Hue City,Hue City,22,5,4,1,0
2022-04-27,Hue City,Hue City,23,3,3,0,0
2022-04-27,Hue City,Huong Thuy,9,1,1,0,0
2022-04-27,Hue City,Huong Thuy,11,1,1,0,0
2022-04-27,Hue City,Huong Thuy,14,4,3,1,0
2022-04-27,Hue City,Huong Thuy,18,1,1,0,0
2022-04-27,Hue City,Huong Thuy,19,1,1,0,0
2022-04-27,Hue City,Huong Thuy,20,1,1,0,0
2022-04-27,Hue City,Huong Tra,11,1,1,0,0
2022-04-27,Hue City,Huong Tra,19,2,0,2,0
2022-04-27,Hue City,Phu Vang,9,1,0,1,0
2022-04-27,Hue City,Phu Vang,11,1,1,0,0
2022-04-27,Hue City,Phu Vang,13,4,3,1,1
2022-04-27,Hue City,Phu Vang,18,1,1,0,0
2022-04-27,Hue City,Phu Vang,19,2,1,1,0
2022-04-27,Vung Tau,Ba Ria City,6,2,0,2,2
2022-04-27,Vung Tau,Ba Ria City,7,3,0,3,3
2022-04-27,Vung Tau,Ba Ria City,8,5,2,3,2
2022-04-27,Vung Tau,Ba Ria City,9,2,2,0,0
2022-04-27,Vung Tau,Ba Ria City,10,3,3,0,0
2022-04-27,Vung Tau,Ba Ria City,11,12,3,9,8
2022-04-27,Vung Tau,Ba Ria City,12,4,2,2,2
2022-04-27,Vung Tau,Ba Ria City,13,8,2,6,4
2022-04-27,Vung Tau,Ba Ria City,14,2,2,0,0
2022-04-27,Vung Tau,Ba Ria City,15,3,2,1,0
2022-04-27,Vung Tau,Ba Ria City,16,4,1,3,3
2022-04-27,Vung Tau,Ba Ria City,17,1,0,1,1
2022-04-27,Vung Tau,Ba Ria City,18,3,0,3,3
2022-04-27,Vung Tau,Ba Ria City,19,4,0,4,4
2022-04-27,Vung Tau,Ba Ria City,20,1,0,1,1
2022-04-27,Vung Tau,Vung Tau City,0,1,1,0,0
2022-04-27,Vung Tau,Vung Tau City,1,1,0,1,0
2022-04-27,Vung Tau,Vung Tau City,6,41,31,10,6
2022-04-27,Vung Tau,Vung Tau City,7,103,96,7,1
2022-04-27,Vung Tau,Vung Tau City,8,158,143,15,2
2022-04-27,Vung Tau,Vung Tau City,9,152,135,17,0
2022-04-27,Vung Tau,Vung Tau City,10,181,162,19,2
2022-04-27,Vung Tau,Vung Tau City,11,366,337,29,8
2022-04-27,Vung Tau,Vung Tau City,12,273,254,19,2
2022-04-27,Vung Tau,Vung Tau City,13,256,234,22,3
2022-04-27,Vung Tau,Vung Tau City,14,242,224,18,1
2022-04-27,Vung Tau,Vung Tau City,15,171,163,8,3
2022-04-27,Vung Tau,Vung Tau City,16,162,147,15,2
2022-04-27,Vung Tau,Vung Tau City,17,226,211,15,2
2022-04-27,Vung Tau,Vung Tau City,18,285,256,29,10
2022-04-27,Vung Tau,Vung Tau City,19,274,252,22,7
2022-04-27,Vung Tau,Vung Tau City,20,166,148,18,3
2022-04-27,Vung Tau,Vung Tau City,21,90,70,20,4
2022-04-27,Vung Tau,Vung Tau City,23,1,1,0,0
2022-04-28,Binh Duong,Ben Cat,8,1,0,1,1
2022-04-28,Binh Duong,Ben Cat,9,2,0,2,2
2022-04-28,Binh Duong,Ben Cat,10,2,0,2,2
2022-04-28,Binh Duong,Ben Cat,11,2,0,2,2
2022-04-28,Binh Duong,Ben Cat,12,2,0,2,2
2022-04-28,Binh Duong,Ben Cat,13,3,0,3,3
2022-04-28,Binh Duong,Ben Cat,19,1,0,1,1
2022-04-28,Binh Duong,Di An,1,1,1,0,0
2022-04-28,Binh Duong,Di An,6,7,0,7,7
2022-04-28,Binh Duong,Di An,7,6,1,5,4
2022-04-28,Binh Duong,Di An,8,6,4,2,1
2022-04-28,Binh Duong,Di An,9,12,6,6,4
2022-04-28,Binh Duong,Di An,10,31,13,18,13
2022-04-28,Binh Duong,Di An,11,28,18,10,7
2022-04-28,Binh Duong,Di An,12,27,17,10,3
2022-04-28,Binh Duong,Di An,13,27,19,8,4
2022-04-28,Binh Duong,Di An,14,29,22,7,7
2022-04-28,Binh Duong,Di An,15,12,9,3,2
2022-04-28,Binh Duong,Di An,16,20,13,7,5
2022-04-28,Binh Duong,Di An,17,19,14,5,1
2022-04-28,Binh Duong,Di An,18,27,18,9,6
2022-04-28,Binh Duong,Di An,19,19,12,7,5
2022-04-28,Binh Duong,Di An,20,16,11,5,1
2022-04-28,Binh Duong,Di An,21,9,4,5,5
2022-04-28,Binh Duong,Di An,23,1,0,1,0
2022-04-28,Binh Duong,Tan Uyen,9,2,0,2,2
2022-04-28,Binh Duong,Tan Uyen,10,6,0,6,4
2022-04-28,Binh Duong,Tan Uyen,11,9,6,3,0
2022-04-28,Binh Duong,Tan Uyen,12,1,1,0,0
2022-04-28,Binh Duong,Tan Uyen,13,2,2,0,0
2022-04-28,Binh Duong,Tan Uyen,14,1,1,0,0
2022-04-28,Binh Duong,Tan Uyen,15,2,0,2,0
2022-04-28,Binh Duong,Tan Uyen,16,1,0,1,1
2022-04-28,Binh Duong,Tan Uyen,17,1,1,0,0
2022-04-28,Binh Duong,Tan Uyen,21,3,1,2,1
2022-04-28,Binh Duong,Thu Dau Mot Town,0,1,0,1,0
2022-04-28,Binh Duong,Thu Dau Mot Town,1,2,2,0,0
2022-04-28,Binh Duong,Thu Dau Mot Town,3,1,0,1,0
2022-04-28,Binh Duong,Thu Dau Mot Town,4,1,1,0,0
2022-04-28,Binh Duong,Thu Dau Mot Town,5,1,1,0,0
2022-04-28,Binh Duong,Thu Dau Mot Town,6,27,22,5,4
2022-04-28,Binh Duong,Thu Dau Mot Town,7,119,107,12,6
2022-04-28,Binh Duong,Thu Dau Mot Town,8,201,187,14,2
2022-04-28,Binh Duong,Thu Dau Mot Town,9,225,210,15,1
2022-04-28,Binh Duong,Thu Dau Mot Town,10,348,330,18,2
2022-04-28,Binh Duong,Thu Dau Mot Town,11,582,559,23,2
2022-04-28,Binh Duong,Thu Dau Mot Town,12,423,398,25,4
2022-04-28,Binh Duong,Thu Dau Mot Town,13,400,377,23,1
2022-04-28,Binh Duong,Thu Dau Mot Town,14,340,316,24,4
2022-04-28,Binh Duong,Thu Dau Mot Town,15,258,236,22,1
2022-04-28,Binh Duong,Thu Dau Mot Town,16,268,246,22,1
2022-04-28,Binh Duong,Thu Dau Mot Town,17,335,324,11,0
2022-04-28,Binh Duong,Thu Dau Mot Town,18,363,333,30,5
2022-04-28,Binh Duong,Thu Dau Mot Town,19,293,276,17,3
2022-04-28,Binh Duong,Thu Dau Mot Town,20,241,222,19,4
2022-04-28,Binh Duong,Thu Dau Mot Town,21,107,87,20,5
2022-04-28,Binh Duong,Thu Dau Mot Town,22,3,1,2,0
2022-04-28,Binh Duong,Thu Dau Mot Town,23,2,0,2,0
2022-04-28,Binh Duong,Thuan An,5,1,0,1,0
2022-04-28,Binh Duong,Thuan An,6,2,1,1,0
2022-04-28,Binh Duong,Thuan An,7,6,3,3,2
2022-04-28,Binh Duong,Thuan An,8,19,14,5,5
2022-04-28,Binh Duong,Thuan An,9,39,32,7,4
2022-04-28,Binh Duong,Thuan An,10,49,46,3,3
2022-04-28,Binh Duong,Thuan An,11,74,47,27,16
2022-04-28,Binh Duong,Thuan An,12,67,51,16,11
2022-04-28,Binh Duong,Thuan An,13,86,59,27,18
2022-04-28,Binh Duong,Thuan An,14,41,26,15,12
2022-04-28,Binh Duong,Thuan An,15,44,33,11,8
2022-04-28,Binh Duong,Thuan An,16,42,32,10,7
2022-04-28,Binh Duong,Thuan An,17,33,29,4,2
2022-04-28,Binh Duong,Thuan An,18,34,31,3,0
2022-04-28,Binh Duong,Thuan An,19,40,31,9,4
2022-04-28,Binh Duong,Thuan An,20,21,17,4,0
2022-04-28,Binh Duong,Thuan An,21,20,11,9,5
2022-04-28,Can Tho City,Binh Thuy District,7,1,1,0,0
2022-04-28,Can Tho City,Binh Thuy District,8,4,4,0,0
2022-04-28,Can Tho City,Binh Thuy District,9,10,10,0,0
2022-04-28,Can Tho City,Binh Thuy District,10,13,11,2,1
2022-04-28,Can Tho City,Binh Thuy District,11,13,10,3,0
2022-04-28,Can Tho City,Binh Thuy District,12,19,15,4,0
2022-04-28,Can Tho City,Binh Thuy District,13,20,20,0,0
2022-04-28,Can Tho City,Binh Thuy District,14,9,9,0,0
2022-04-28,Can Tho City,Binh Thuy District,15,7,5,2,0
2022-04-28,Can Tho City,Binh Thuy District,16,10,10,0,0
2022-04-28,Can Tho City,Binh Thuy District,17,13,12,1,0
2022-04-28,Can Tho City,Binh Thuy District,18,19,18,1,0
2022-04-28,Can Tho City,Binh Thuy District,19,14,14,0,0
2022-04-28,Can Tho City,Binh Thuy District,20,8,8,0,0
2022-04-28,Can Tho City,Binh Thuy District,21,3,3,0,0
2022-04-28,Can Tho City,Cai Rang District,6,3,1,2,2
2022-04-28,Can Tho City,Cai Rang District,7,4,4,0,0
2022-04-28,Can Tho City,Cai Rang District,8,5,5,0,0
2022-04-28,Can Tho City,Cai Rang District,9,5,4,1,1
2022-04-28,Can Tho City,Cai Rang District,10,6,5,1,0
2022-04-28,Can Tho City,Cai Rang District,11,10,10,0,0
2022-04-28,Can Tho City,Cai Rang District,12,7,7,0,0
2022-04-28,Can Tho City,Cai Rang District,13,6,5,1,1
2022-04-28,Can Tho City,Cai Rang District,14,7,7,0,0
2022-04-28,Can Tho City,Cai Rang District,15,7,6,1,0
2022-04-28,Can Tho City,Cai Rang District,16,8,8,0,0
2022-04-28,Can Tho City,Cai Rang District,17,6,6,0,0
2022-04-28,Can Tho City,Cai Rang District,18,10,10,0,0
2022-04-28,Can Tho City,Cai Rang District,19,8,8,0,0
2022-04-28,Can Tho City,Cai Rang District,20,17,16,1,0
2022-04-28,Can Tho City,Cai Rang District,21,3,3,0,0
2022-04-28,Can Tho City,Cai Rang District,22,1,0,1,0
2022-04-28,Can Tho City,Ninh Kieu District,0,3,3,0,0
2022-04-28,Can Tho City,Ninh Kieu District,1,2,1,1,0
2022-04-28,Can Tho City,Ninh Kieu District,2,3,3,0,0
2022-04-28,Can Tho City,Ninh Kieu District,3,1,1,0,0
2022-04-28,Can Tho City,Ninh Kieu District,5,6,4,2,2
2022-04-28,Can Tho City,Ninh Kieu District,6,55,50,5,4
2022-04-28,Can Tho City,Ninh Kieu District,7,118,104,14,0
2022-04-28,Can Tho City,Ninh Kieu District,8,261,248,13,0
2022-04-28,Can Tho City,Ninh Kieu District,9,304,287,17,0
2022-04-28,Can Tho City,Ninh Kieu District,10,564,537,27,0
2022-04-28,Can Tho City,Ninh Kieu District,11,903,866,37,2
2022-04-28,Can Tho City,Ninh Kieu District,12,651,615,36,0
2022-04-28,Can Tho City,Ninh Kieu District,13,528,495,33,0
2022-04-28,Can Tho City,Ninh Kieu District,14,431,414,17,0
2022-04-28,Can Tho City,Ninh Kieu District,15,393,379,14,1
2022-04-28,Can Tho City,Ninh Kieu District,16,432,412,20,0
2022-04-28,Can Tho City,Ninh Kieu District,17,549,522,27,0
2022-04-28,Can Tho City,Ninh Kieu District,18,516,489,27,0
2022-04-28,Can Tho City,Ninh Kieu District,19,480,451,29,0
2022-04-28,Can Tho City,Ninh Kieu District,20,367,345,22,0
2022-04-28,Can Tho City,Ninh Kieu District,21,215,192,23,0
2022-04-28,Can Tho City,Ninh Kieu District,22,7,3,4,0
2022-04-28,Can Tho City,Ninh Kieu District,23,4,4,0,0
2022-04-28,Dong Nai,Bien Hoa City,0,5,3,2,0
2022-04-28,Dong Nai,Bien Hoa City,1,1,1,0,0
2022-04-28,Dong Nai,Bien Hoa City,3,1,0,1,0
2022-04-28,Dong Nai,Bien Hoa City,4,2,2,0,0
2022-04-28,Dong Nai,Bien Hoa City,6,50,27,23,19
2022-04-28,Dong Nai,Bien Hoa City,7,154,139,15,7
2022-04-28,Dong Nai,Bien Hoa City,8,268,235,33,1
2022-04-28,Dong Nai,Bien Hoa City,9,419,374,45,2
2022-04-28,Dong Nai,Bien Hoa City,10,734,671,63,10
2022-04-28,Dong Nai,Bien Hoa City,11,1099,1002,97,26
2022-04-28,Dong Nai,Bien Hoa City,12,851,775,76,11
2022-04-28,Dong Nai,Bien Hoa City,13,831,752,79,13
2022-04-28,Dong Nai,Bien Hoa City,14,615,557,58,14
2022-04-28,Dong Nai,Bien Hoa City,15,481,449,32,3
2022-04-28,Dong Nai,Bien Hoa City,16,510,461,49,7
2022-04-28,Dong Nai,Bien Hoa City,17,577,516,61,12
2022-04-28,Dong Nai,Bien Hoa City,18,689,625,64,13
2022-04-28,Dong Nai,Bien Hoa City,19,636,586,50,10
2022-04-28,Dong Nai,Bien Hoa City,20,430,366,64,17
2022-04-28,Dong Nai,Bien Hoa City,21,219,165,54,18
2022-04-28,Dong Nai,Bien Hoa City,22,4,1,3,1
2022-04-28,Dong Nai,Bien Hoa City,23,1,0,1,0
2022-04-28,Dong Nai,Long Thanh,8,1,0,1,1
2022-04-28,Dong Nai,Long Thanh,10,1,0,1,1
2022-04-28,Dong Nai,Long Thanh,11,1,0,1,1
2022-04-28,Dong Nai,Long Thanh,14,1,0,1,0
2022-04-28,Dong Nai,Long Thanh,15,2,0,2,1
2022-04-28,Dong Nai,Long Thanh,16,2,0,2,2
2022-04-28,Dong Nai,Long Thanh,19,1,0,1,1
2022-04-28,Dong Nai,Nhon trach,3,1,0,1,0
2022-04-28,Dong Nai,Nhon trach,9,1,0,1,1
2022-04-28,Dong Nai,Nhon trach,14,1,0,1,1
2022-04-28,Dong Nai,Trang Bom,10,1,1,0,0
2022-04-28,Dong Nai,Trang Bom,11,1,0,1,1
2022-04-28,Dong Nai,Trang Bom,19,1,0,1,1
2022-04-28,Hai Phong City,An Duong,8,2,1,1,1
2022-04-28,Hai Phong City,An Duong,9,4,3,1,1
2022-04-28,Hai Phong City,An Duong,10,1,1,0,0
2022-04-28,Hai Phong City,An Duong,11,2,1,1,1
2022-04-28,Hai Phong City,An Duong,12,5,4,1,1
2022-04-28,Hai Phong City,An Duong,13,3,1,2,2
2022-04-28,Hai Phong City,An Duong,14,13,2,11,9
2022-04-28,Hai Phong City,An Duong,15,7,1,6,6
2022-04-28,Hai Phong City,An Duong,16,4,3,1,1
2022-04-28,Hai Phong City,An Duong,17,3,2,1,1
2022-04-28,Hai Phong City,An Duong,18,4,2,2,1
2022-04-28,Hai Phong City,An Duong,19,4,3,1,0
2022-04-28,Hai Phong City,An Duong,20,4,1,3,3
2022-04-28,Hai Phong City,An Duong,22,2,0,2,1
2022-04-28,Hai Phong City,Do Son District,12,2,0,2,1
2022-04-28,Hai Phong City,Duong Kinh District,8,1,0,1,1
2022-04-28,Hai Phong City,Duong Kinh District,16,1,0,1,1
2022-04-28,Hai Phong City,Hai An District,7,1,1,0,0
2022-04-28,Hai Phong City,Hai An District,8,15,13,2,2
2022-04-28,Hai Phong City,Hai An District,9,16,12,4,0
2022-04-28,Hai Phong City,Hai An District,10,29,21,8,4
2022-04-28,Hai Phong City,Hai An District,11,38,33,5,0
2022-04-28,Hai Phong City,Hai An District,12,25,17,8,3
2022-04-28,Hai Phong City,Hai An District,13,21,18,3,1
2022-04-28,Hai Phong City,Hai An District,14,22,16,6,2
2022-04-28,Hai Phong City,Hai An District,15,25,17,8,5
2022-04-28,Hai Phong City,Hai An District,16,14,11,3,1
2022-04-28,Hai Phong City,Hai An District,17,27,22,5,0
2022-04-28,Hai Phong City,Hai An District,18,20,17,3,0
2022-04-28,Hai Phong City,Hai An District,19,17,15,2,0
2022-04-28,Hai Phong City,Hai An District,20,21,15,6,1
2022-04-28,Hai Phong City,Hai An District,21,6,2,4,3
2022-04-28,Hai Phong City,Hai An District,23,1,1,0,0
2022-04-28,Hai Phong City,Hong Bang District,0,1,1,0,0
2022-04-28,Hai Phong City,Hong Bang District,7,14,9,5,5
2022-04-28,Hai Phong City,Hong Bang District,8,37,27,10,1
2022-04-28,Hai Phong City,Hong Bang District,9,21,19,2,0
2022-04-28,Hai Phong City,Hong Bang District,10,47,44,3,1
2022-04-28,Hai Phong City,Hong Bang District,11,90,79,11,2
2022-04-28,Hai Phong City,Hong Bang District,12,55,49,6,2
2022-04-28,Hai Phong City,Hong Bang District,13,42,39,3,0
2022-04-28,Hai Phong City,Hong Bang District,14,52,39,13,5
2022-04-28,Hai Phong City,Hong Bang District,15,43,36,7,0
2022-04-28,Hai Phong City,Hong Bang District,16,32,24,8,1
2022-04-28,Hai Phong City,Hong Bang District,17,35,28,7,0
2022-04-28,Hai Phong City,Hong Bang District,18,43,38,5,2
2022-04-28,Hai Phong City,Hong Bang District,19,48,38,10,4
2022-04-28,Hai Phong City,Hong Bang District,20,30,28,2,1
2022-04-28,Hai Phong City,Hong Bang District,21,15,10,5,1
2022-04-28,Hai Phong City,Hong Bang District,22,2,0,2,0
2022-04-28,Hai Phong City,Hong Bang District,23,3,1,2,0
2022-04-28,Hai Phong City,Kien An District,7,1,0,1,0
2022-04-28,Hai Phong City,Kien An District,8,3,1,2,2
2022-04-28,Hai Phong City,Kien An District,9,1,0,1,1
2022-04-28,Hai Phong City,Kien An District,10,5,5,0,0
2022-04-28,Hai Phong City,Kien An District,11,17,5,12,12
2022-04-28,Hai Phong City,Kien An District,12,9,4,5,5
2022-04-28,Hai Phong City,Kien An District,13,9,3,6,4
2022-04-28,Hai Phong City,Kien An District,14,3,0,3,3
2022-04-28,Hai Phong City,Kien An District,15,8,2,6,5
2022-04-28,Hai Phong City,Kien An District,16,5,4,1,1
2022-04-28,Hai Phong City,Kien An District,17,5,3,2,2
2022-04-28,Hai Phong City,Kien An District,18,10,7,3,3
2022-04-28,Hai Phong City,Kien An District,19,4,2,2,1
2022-04-28,Hai Phong City,Kien An District,20,5,2,3,2
2022-04-28,Hai Phong City,Kien An District,21,7,2,5,4
2022-04-28,Hai Phong City,Le Chan District,1,3,0,3,1
2022-04-28,Hai Phong City,Le Chan District,2,1,0,1,1
2022-04-28,Hai Phong City,Le Chan District,7,34,18,16,12
2022-04-28,Hai Phong City,Le Chan District,8,70,58,12,4
2022-04-28,Hai Phong City,Le Chan District,9,71,60,11,1
2022-04-28,Hai Phong City,Le Chan District,10,153,143,10,2
2022-04-28,Hai Phong City,Le Chan District,11,293,255,38,10
2022-04-28,Hai Phong City,Le Chan District,12,188,167,21,1
2022-04-28,Hai Phong City,Le Chan District,13,109,98,11,2
2022-04-28,Hai Phong City,Le Chan District,14,112,103,9,1
2022-04-28,Hai Phong City,Le Chan District,15,149,130,19,1
2022-04-28,Hai Phong City,Le Chan District,16,146,131,15,0
2022-04-28,Hai Phong City,Le Chan District,17,150,137,13,0
2022-04-28,Hai Phong City,Le Chan District,18,232,202,30,8
2022-04-28,Hai Phong City,Le Chan District,19,178,162,16,5
2022-04-28,Hai Phong City,Le Chan District,20,139,124,15,2
2022-04-28,Hai Phong City,Le Chan District,21,61,49,12,4
2022-04-28,Hai Phong City,Le Chan District,22,2,1,1,0
2022-04-28,Hai Phong City,Le Chan District,23,1,0,1,0
2022-04-28,Hai Phong City,Ngo Quyen District,5,1,1,0,0
2022-04-28,Hai Phong City,Ngo Quyen District,6,1,1,0,0
2022-04-28,Hai Phong City,Ngo Quyen District,7,29,16,13,9
2022-04-28,Hai Phong City,Ngo Quyen District,8,76,64,12,5
2022-04-28,Hai Phong City,Ngo Quyen District,9,55,52,3,0
2022-04-28,Hai Phong City,Ngo Quyen District,10,127,120,7,2
2022-04-28,Hai Phong City,Ngo Quyen District,11,216,199,17,6
2022-04-28,Hai Phong City,Ngo Quyen District,12,156,148,8,1
2022-04-28,Hai Phong City,Ngo Quyen District,13,106,97,9,2
2022-04-28,Hai Phong City,Ngo Quyen District,14,115,102,13,3
2022-04-28,Hai Phong City,Ngo Quyen District,15,115,106,9,0
2022-04-28,Hai Phong City,Ngo Quyen District,16,93,83,10,0
2022-04-28,Hai Phong City,Ngo Quyen District,17,125,111,14,1
2022-04-28,Hai Phong City,Ngo Quyen District,18,156,138,18,3
2022-04-28,Hai Phong City,Ngo Quyen District,19,158,138,20,3
2022-04-28,Hai Phong City,Ngo Quyen District,20,130,119,11,2
2022-04-28,Hai Phong City,Ngo Quyen District,21,61,46,15,1
2022-04-28,Hai Phong City,Ngo Quyen District,22,2,0,2,1
2022-04-28,Hai Phong City,Thuy Nguyen,10,2,0,2,2
2022-04-28,Hai Phong City,Thuy Nguyen,11,1,1,0,0
2022-04-28,Hai Phong City,Thuy Nguyen,12,1,0,1,1
2022-04-28,Hai Phong City,Thuy Nguyen,13,3,0,3,3
2022-04-28,Hai Phong City,Thuy Nguyen,15,3,0,3,2
2022-04-28,Hai Phong City,Thuy Nguyen,19,2,0,2,2
2022-04-28,Hue City,Hue City,0,2,1,1,0
2022-04-28,Hue City,Hue City,2,1,1,0,0
2022-04-28,Hue City,Hue City,3,2,2,0,0
2022-04-28,Hue City,Hue City,5,3,2,1,0
2022-04-28,Hue City,Hue City,6,51,48,3,1
2022-04-28,Hue City,Hue City,7,194,178,16,0
2022-04-28,Hue City,Hue City,8,290,273,17,0
2022-04-28,Hue City,Hue City,9,259,243,16,2
2022-04-28,Hue City,Hue City,10,489,464,25,2
2022-04-28,Hue City,Hue City,11,982,911,71,2
2022-04-28,Hue City,Hue City,12,564,533,31,2
2022-04-28,Hue City,Hue City,13,329,308,21,0
2022-04-28,Hue City,Hue City,14,369,345,24,3
2022-04-28,Hue City,Hue City,15,364,339,25,1
2022-04-28,Hue City,Hue City,16,396,365,31,3
2022-04-28,Hue City,Hue City,17,476,444,32,6
2022-04-28,Hue City,Hue City,18,603,572,31,1
2022-04-28,Hue City,Hue City,19,603,550,53,4
2022-04-28,Hue City,Hue City,20,401,367,34,3
2022-04-28,Hue City,Hue City,21,258,219,39,3
2022-04-28,Hue City,Hue City,22,6,2,4,0
2022-04-28,Hue City,Hue City,23,1,1,0,0
2022-04-28,Hue City,Huong Thuy,11,1,1,0,0
2022-04-28,Hue City,Huong Thuy,14,1,0,1,1
2022-04-28,Hue City,Huong Thuy,18,2,2,0,0
2022-04-28,Hue City,Huong Thuy,20,1,1,0,0
2022-04-28,Hue City,Huong Tra,7,1,1,0,0
2022-04-28,Hue City,Huong Tra,10,1,1,0,0
2022-04-28,Hue City,Huong Tra,15,1,1,0,0
2022-04-28,Hue City,Phu Vang,7,1,1,0,0
2022-04-28,Hue City,Phu Vang,8,1,0,1,1
2022-04-28,Hue City,Phu Vang,10,1,1,0,0
2022-04-28,Hue City,Phu Vang,11,3,1,2,2
2022-04-28,Hue City,Phu Vang,14,3,1,2,1
2022-04-28,Hue City,Phu Vang,16,1,1,0,0
2022-04-28,Hue City,Phu Vang,17,1,1,0,0
2022-04-28,Hue City,Phu Vang,18,1,0,1,1
2022-04-28,Hue City,Phu Vang,19,4,4,0,0
2022-04-28,Hue City,Phu Vang,20,2,2,0,0
2022-04-28,Vung Tau,Ba Ria City,7,2,0,2,2
2022-04-28,Vung Tau,Ba Ria City,8,6,2,4,4
2022-04-28,Vung Tau,Ba Ria City,9,2,1,1,1
2022-04-28,Vung Tau,Ba Ria City,10,8,2,6,1
2022-04-28,Vung Tau,Ba Ria City,11,5,5,0,0
2022-04-28,Vung Tau,Ba Ria City,12,9,6,3,1
2022-04-28,Vung Tau,Ba Ria City,13,4,3,1,1
2022-04-28,Vung Tau,Ba Ria City,14,6,5,1,0
2022-04-28,Vung Tau,Ba Ria City,15,1,0,1,0
2022-04-28,Vung Tau,Ba Ria City,16,3,3,0,0
2022-04-28,Vung Tau,Ba Ria City,17,8,4,4,4
2022-04-28,Vung Tau,Ba Ria City,18,7,2,5,4
2022-04-28,Vung Tau,Ba Ria City,19,2,0,2,2
2022-04-28,Vung Tau,Ba Ria City,20,7,0,7,6
2022-04-28,Vung Tau,Vung Tau City,0,1,1,0,0
2022-04-28,Vung Tau,Vung Tau City,1,1,1,0,0
2022-04-28,Vung Tau,Vung Tau City,6,35,34,1,1
2022-04-28,Vung Tau,Vung Tau City,7,95,85,10,0
2022-04-28,Vung Tau,Vung Tau City,8,146,136,10,0
2022-04-28,Vung Tau,Vung Tau City,9,190,157,33,13
2022-04-28,Vung Tau,Vung Tau City,10,184,171,13,2
2022-04-28,Vung Tau,Vung Tau City,11,364,342,22,5
2022-04-28,Vung Tau,Vung Tau City,12,265,250,15,2
2022-04-28,Vung Tau,Vung Tau City,13,223,211,12,1
2022-04-28,Vung Tau,Vung Tau City,14,217,206,11,1
2022-04-28,Vung Tau,Vung Tau City,15,232,213,19,4
2022-04-28,Vung Tau,Vung Tau City,16,195,177,18,3
2022-04-28,Vung Tau,Vung Tau City,17,246,219,27,3
2022-04-28,Vung Tau,Vung Tau City,18,330,300,30,7
2022-04-28,Vung Tau,Vung Tau City,19,283,256,27,6
2022-04-28,Vung Tau,Vung Tau City,20,202,169,33,8
2022-04-28,Vung Tau,Vung Tau City,21,110,74,36,24
2022-04-28,Vung Tau,Vung Tau City,22,3,2,1,0
2022-04-28,Vung Tau,Vung Tau City,23,1,0,1,0
2022-04-29,Binh Duong,Ben Cat,14,1,1,0,0
2022-04-29,Binh Duong,Ben Cat,17,1,0,1,1
2022-04-29,Binh Duong,Ben Cat,18,1,0,1,1
2022-04-29,Binh Duong,Ben Cat,19,1,0,1,1
2022-04-29,Binh Duong,Ben Cat,20,3,0,3,2
2022-04-29,Binh Duong,Ben Cat,21,1,0,1,1
2022-04-29,Binh Duong,Di An,0,1,0,1,0
2022-04-29,Binh Duong,Di An,7,4,2,2,2
2022-04-29,Binh Duong,Di An,8,11,6,5,2
2022-04-29,Binh Duong,Di An,9,14,8,6,2
2022-04-29,Binh Duong,Di An,10,28,5,23,21
2022-04-29,Binh Duong,Di An,11,53,8,45,34
2022-04-29,Binh Duong,Di An,12,47,14,33,30
2022-04-29,Binh Duong,Di An,13,36,9,27,24
2022-04-29,Binh Duong,Di An,14,29,16,13,8
2022-04-29,Binh Duong,Di An,15,22,16,6,6
2022-04-29,Binh Duong,Di An,16,19,12,7,6
2022-04-29,Binh Duong,Di An,17,29,13,16,12
2022-04-29,Binh Duong,Di An,18,31,8,23,19
2022-04-29,Binh Duong,Di An,19,55,6,49,42
2022-04-29,Binh Duong,Di An,20,47,9,38,31
2022-04-29,Binh Duong,Di An,21,24,1,23,21
2022-04-29,Binh Duong,Tan Uyen,8,1,0,1,0
2022-04-29,Binh Duong,Tan Uyen,10,1,1,0,0
2022-04-29,Binh Duong,Tan Uyen,11,2,0,2,2
2022-04-29,Binh Duong,Tan Uyen,13,2,1,1,0
2022-04-29,Binh Duong,Tan Uyen,14,3,2,1,1
2022-04-29,Binh Duong,Tan Uyen,15,6,2,4,2
2022-04-29,Binh Duong,Tan Uyen,16,1,1,0,0
2022-04-29,Binh Duong,Tan Uyen,17,2,1,1,1
2022-04-29,Binh Duong,Tan Uyen,18,3,0,3,3
2022-04-29,Binh Duong,Tan Uyen,19,8,0,8,7
2022-04-29,Binh Duong,Tan Uyen,20,4,1,3,3
2022-04-29,Binh Duong,Tan Uyen,21,5,1,4,4
2022-04-29,Binh Duong,Thu Dau Mot Town,0,1,0,1,1
2022-04-29,Binh Duong,Thu Dau Mot Town,1,2,1,1,0
2022-04-29,Binh Duong,Thu Dau Mot Town,2,2,0,2,0
2022-04-29,Binh Duong,Thu Dau Mot Town,3,1,1,0,0
2022-04-29,Binh Duong,Thu Dau Mot Town,5,2,1,1,0
2022-04-29,Binh Duong,Thu Dau Mot Town,6,37,32,5,2
2022-04-29,Binh Duong,Thu Dau Mot Town,7,112,100,12,3
2022-04-29,Binh Duong,Thu Dau Mot Town,8,223,207,16,5
2022-04-29,Binh Duong,Thu Dau Mot Town,9,244,230,14,1
2022-04-29,Binh Duong,Thu Dau Mot Town,10,393,361,32,4
2022-04-29,Binh Duong,Thu Dau Mot Town,11,754,347,407,343
2022-04-29,Binh Duong,Thu Dau Mot Town,12,568,499,69,41
2022-04-29,Binh Duong,Thu Dau Mot Town,13,426,407,19,3
2022-04-29,Binh Duong,Thu Dau Mot Town,14,339,321,18,1
2022-04-29,Binh Duong,Thu Dau Mot Town,15,234,219,15,4
2022-04-29,Binh Duong,Thu Dau Mot Town,16,240,227,13,3
2022-04-29,Binh Duong,Thu Dau Mot Town,17,437,356,81,56
2022-04-29,Binh Duong,Thu Dau Mot Town,18,457,193,264,221
2022-04-29,Binh Duong,Thu Dau Mot Town,19,577,159,418,358
2022-04-29,Binh Duong,Thu Dau Mot Town,20,672,143,529,465
2022-04-29,Binh Duong,Thu Dau Mot Town,21,409,64,345,302
2022-04-29,Binh Duong,Thu Dau Mot Town,22,6,1,5,0
2022-04-29,Binh Duong,Thuan An,1,1,0,1,0
2022-04-29,Binh Duong,Thuan An,6,2,0,2,2
2022-04-29,Binh Duong,Thuan An,7,4,0,4,4
2022-04-29,Binh Duong,Thuan An,8,14,8,6,5
2022-04-29,Binh Duong,Thuan An,9,29,13,16,14
2022-04-29,Binh Duong,Thuan An,10,86,41,45,31
2022-04-29,Binh Duong,Thuan An,11,122,14,108,93
2022-04-29,Binh Duong,Thuan An,12,120,34,86,80
2022-04-29,Binh Duong,Thuan An,13,87,43,44,40
2022-04-29,Binh Duong,Thuan An,14,54,42,12,9
2022-04-29,Binh Duong,Thuan An,15,37,25,12,7
2022-04-29,Binh Duong,Thuan An,16,32,21,11,8
2022-04-29,Binh Duong,Thuan An,17,60,18,42,34
2022-04-29,Binh Duong,Thuan An,18,71,14,57,49
2022-04-29,Binh Duong,Thuan An,19,88,10,78,73
2022-04-29,Binh Duong,Thuan An,20,108,7,101,99
2022-04-29,Binh Duong,Thuan An,21,55,2,53,43
2022-04-29,Binh Duong,Thuan An,22,1,0,1,0
2022-04-29,Can Tho City,Binh Thuy District,7,1,0,1,0
2022-04-29,Can Tho City,Binh Thuy District,8,2,1,1,0
2022-04-29,Can Tho City,Binh Thuy District,9,10,10,0,0
2022-04-29,Can Tho City,Binh Thuy District,10,13,12,1,0
2022-04-29,Can Tho City,Binh Thuy District,11,9,1,8,6
2022-04-29,Can Tho City,Binh Thuy District,12,10,9,1,0
2022-04-29,Can Tho City,Binh Thuy District,13,11,10,1,1
2022-04-29,Can Tho City,Binh Thuy District,14,9,9,0,0
2022-04-29,Can Tho City,Binh Thuy District,15,11,10,1,0
2022-04-29,Can Tho City,Binh Thuy District,16,12,12,0,0
2022-04-29,Can Tho City,Binh Thuy District,17,12,12,0,0
2022-04-29,Can Tho City,Binh Thuy District,18,19,16,3,0
2022-04-29,Can Tho City,Binh Thuy District,19,14,10,4,0
2022-04-29,Can Tho City,Binh Thuy District,20,10,9,1,0
2022-04-29,Can Tho City,Cai Rang District,6,2,2,0,0
2022-04-29,Can Tho City,Cai Rang District,7,4,4,0,0
2022-04-29,Can Tho City,Cai Rang District,8,5,4,1,0
2022-04-29,Can Tho City,Cai Rang District,9,4,3,1,0
2022-04-29,Can Tho City,Cai Rang District,10,6,6,0,0
2022-04-29,Can Tho City,Cai Rang District,11,26,4,22,18
2022-04-29,Can Tho City,Cai Rang District,12,23,15,8,4
2022-04-29,Can Tho City,Cai Rang District,13,9,8,1,0
2022-04-29,Can Tho City,Cai Rang District,14,5,5,0,0
2022-04-29,Can Tho City,Cai Rang District,15,11,10,1,0
2022-04-29,Can Tho City,Cai Rang District,16,6,5,1,0
2022-04-29,Can Tho City,Cai Rang District,17,12,10,2,0
2022-04-29,Can Tho City,Cai Rang District,18,8,7,1,0
2022-04-29,Can Tho City,Cai Rang District,19,7,6,1,1
2022-04-29,Can Tho City,Cai Rang District,20,10,8,2,1
2022-04-29,Can Tho City,Cai Rang District,21,3,1,2,0
2022-04-29,Can Tho City,Ninh Kieu District,0,4,4,0,0
2022-04-29,Can Tho City,Ninh Kieu District,1,3,2,1,0
2022-04-29,Can Tho City,Ninh Kieu District,2,1,0,1,0
2022-04-29,Can Tho City,Ninh Kieu District,3,1,1,0,0
2022-04-29,Can Tho City,Ninh Kieu District,5,4,2,2,1
2022-04-29,Can Tho City,Ninh Kieu District,6,43,39,4,1
2022-04-29,Can Tho City,Ninh Kieu District,7,153,134,19,1
2022-04-29,Can Tho City,Ninh Kieu District,8,258,243,15,0
2022-04-29,Can Tho City,Ninh Kieu District,9,289,274,15,0
2022-04-29,Can Tho City,Ninh Kieu District,10,511,484,27,0
2022-04-29,Can Tho City,Ninh Kieu District,11,801,404,397,332
2022-04-29,Can Tho City,Ninh Kieu District,12,961,682,279,200
2022-04-29,Can Tho City,Ninh Kieu District,13,629,555,74,29
2022-04-29,Can Tho City,Ninh Kieu District,14,447,423,24,0
2022-04-29,Can Tho City,Ninh Kieu District,15,356,332,24,1
2022-04-29,Can Tho City,Ninh Kieu District,16,445,416,29,2
2022-04-29,Can Tho City,Ninh Kieu District,17,492,451,41,7
2022-04-29,Can Tho City,Ninh Kieu District,18,523,469,54,0
2022-04-29,Can Tho City,Ninh Kieu District,19,405,379,26,1
2022-04-29,Can Tho City,Ninh Kieu District,20,335,306,29,0
2022-04-29,Can Tho City,Ninh Kieu District,21,194,169,25,1
2022-04-29,Can Tho City,Ninh Kieu District,22,4,0,4,0
2022-04-29,Can Tho City,Ninh Kieu District,23,1,0,1,0
2022-04-29,Dong Nai,Bien Hoa City,0,4,2,2,2
2022-04-29,Dong Nai,Bien Hoa City,1,1,0,1,0
2022-04-29,Dong Nai,Bien Hoa City,2,2,1,1,1
2022-04-29,Dong Nai,Bien Hoa City,3,1,1,0,0
2022-04-29,Dong Nai,Bien Hoa City,4,2,2,0,0
2022-04-29,Dong Nai,Bien Hoa City,5,1,1,0,0
2022-04-29,Dong Nai,Bien Hoa City,6,26,16,10,6
2022-04-29,Dong Nai,Bien Hoa City,7,146,117,29,20
2022-04-29,Dong Nai,Bien Hoa City,8,344,238,106,70
2022-04-29,Dong Nai,Bien Hoa City,9,524,370,154,108
2022-04-29,Dong Nai,Bien Hoa City,10,892,634,258,184
2022-04-29,Dong Nai,Bien Hoa City,11,1485,551,934,816
2022-04-29,Dong Nai,Bien Hoa City,12,1242,850,392,288
2022-04-29,Dong Nai,Bien Hoa City,13,895,725,170,100
2022-04-29,Dong Nai,Bien Hoa City,14,751,587,164,100
2022-04-29,Dong Nai,Bien Hoa City,15,528,450,78,40
2022-04-29,Dong Nai,Bien Hoa City,16,584,477,107,45
2022-04-29,Dong Nai,Bien Hoa City,17,815,531,284,224
2022-04-29,Dong Nai,Bien Hoa City,18,1116,509,607,510
2022-04-29,Dong Nai,Bien Hoa City,19,1319,451,868,753
2022-04-29,Dong Nai,Bien Hoa City,20,1180,236,944,824
2022-04-29,Dong Nai,Bien Hoa City,21,550,85,465,398
2022-04-29,Dong Nai,Bien Hoa City,22,9,1,8,1
2022-04-29,Dong Nai,Long Thanh,9,1,0,1,0
2022-04-29,Dong Nai,Long Thanh,10,2,0,2,2
2022-04-29,Dong Nai,Long Thanh,12,4,0,4,3
2022-04-29,Dong Nai,Long Thanh,14,4,0,4,4
2022-04-29,Dong Nai,Long Thanh,16,1,1,0,0
2022-04-29,Dong Nai,Long Thanh,19,2,0,2,1
2022-04-29,Dong Nai,Long Thanh,20,4,0,4,4
2022-04-29,Dong Nai,Nhon trach,13,2,0,2,2
2022-04-29,Dong Nai,Trang Bom,10,1,0,1,1
2022-04-29,Dong Nai,Trang Bom,11,1,0,1,1
2022-04-29,Dong Nai,Trang Bom,12,1,0,1,1
2022-04-29,Dong Nai,Trang Bom,13,1,0,1,1
2022-04-29,Dong Nai,Trang Bom,14,3,0,3,3
2022-04-29,Dong Nai,Trang Bom,15,2,0,2,2
2022-04-29,Dong Nai,Trang Bom,19,2,0,2,2
2022-04-29,Dong Nai,Trang Bom,20,1,0,1,1
2022-04-29,Dong Nai,Trang Bom,21,1,0,1,1
2022-04-29,Hai Phong City,An Duong,7,4,1,3,2
2022-04-29,Hai Phong City,An Duong,8,1,1,0,0
2022-04-29,Hai Phong City,An Duong,9,4,0,4,3
2022-04-29,Hai Phong City,An Duong,10,5,0,5,3
2022-04-29,Hai Phong City,An Duong,11,7,1,6,5
2022-04-29,Hai Phong City,An Duong,12,1,1,0,0
2022-04-29,Hai Phong City,An Duong,13,6,2,4,4
2022-04-29,Hai Phong City,An Duong,14,4,1,3,3
2022-04-29,Hai Phong City,An Duong,15,9,5,4,4
2022-04-29,Hai Phong City,An Duong,16,2,2,0,0
2022-04-29,Hai Phong City,An Duong,18,2,1,1,0
2022-04-29,Hai Phong City,An Duong,20,3,1,2,1
2022-04-29,Hai Phong City,An Duong,21,2,0,2,2
2022-04-29,Hai Phong City,Do Son District,12,1,0,1,1
2022-04-29,Hai Phong City,Duong Kinh District,21,1,0,1,1
2022-04-29,Hai Phong City,Hai An District,7,10,4,6,4
2022-04-29,Hai Phong City,Hai An District,8,15,9,6,5
2022-04-29,Hai Phong City,Hai An District,9,8,5,3,2
2022-04-29,Hai Phong City,Hai An District,10,28,22,6,2
2022-04-29,Hai Phong City,Hai An District,11,75,23,52,42
2022-04-29,Hai Phong City,Hai An District,12,42,24,18,14
2022-04-29,Hai Phong City,Hai An District,13,23,19,4,0
2022-04-29,Hai Phong City,Hai An District,14,21,12,9,7
2022-04-29,Hai Phong City,Hai An District,15,27,21,6,5
2022-04-29,Hai Phong City,Hai An District,16,18,15,3,1
2022-04-29,Hai Phong City,Hai An District,17,13,12,1,0
2022-04-29,Hai Phong City,Hai An District,18,25,23,2,1
2022-04-29,Hai Phong City,Hai An District,19,23,16,7,4
2022-04-29,Hai Phong City,Hai An District,20,26,16,10,6
2022-04-29,Hai Phong City,Hai An District,21,10,8,2,1
2022-04-29,Hai Phong City,Hong Bang District,7,19,14,5,4
2022-04-29,Hai Phong City,Hong Bang District,8,34,30,4,2
2022-04-29,Hai Phong City,Hong Bang District,9,28,26,2,0
2022-04-29,Hai Phong City,Hong Bang District,10,73,62,11,4
2022-04-29,Hai Phong City,Hong Bang District,11,124,51,73,62
2022-04-29,Hai Phong City,Hong Bang District,12,91,65,26,15
2022-04-29,Hai Phong City,Hong Bang District,13,55,39,16,13
2022-04-29,Hai Phong City,Hong Bang District,14,44,32,12,5
2022-04-29,Hai Phong City,Hong Bang District,15,43,37,6,4
2022-04-29,Hai Phong City,Hong Bang District,16,42,37,5,3
2022-04-29,Hai Phong City,Hong Bang District,17,44,41,3,2
2022-04-29,Hai Phong City,Hong Bang District,18,52,47,5,2
2022-04-29,Hai Phong City,Hong Bang District,19,61,41,20,11
2022-04-29,Hai Phong City,Hong Bang District,20,52,33,19,6
2022-04-29,Hai Phong City,Hong Bang District,21,25,15,10,7
2022-04-29,Hai Phong City,Kien An District,6,1,0,1,1
2022-04-29,Hai Phong City,Kien An District,7,3,0,3,3
2022-04-29,Hai Phong City,Kien An District,8,5,3,2,1
2022-04-29,Hai Phong City,Kien An District,9,7,4,3,0
2022-04-29,Hai Phong City,Kien An District,10,11,9,2,0
2022-04-29,Hai Phong City,Kien An District,11,20,7,13,11
2022-04-29,Hai Phong City,Kien An District,12,11,8,3,1
2022-04-29,Hai Phong City,Kien An District,13,5,4,1,1
2022-04-29,Hai Phong City,Kien An District,14,6,3,3,2
2022-04-29,Hai Phong City,Kien An District,15,6,2,4,3
2022-04-29,Hai Phong City,Kien An District,16,8,6,2,2
2022-04-29,Hai Phong City,Kien An District,17,5,1,4,1
2022-04-29,Hai Phong City,Kien An District,18,15,8,7,7
2022-04-29,Hai Phong City,Kien An District,19,15,5,10,10
2022-04-29,Hai Phong City,Kien An District,20,7,3,4,3
2022-04-29,Hai Phong City,Kien An District,21,2,1,1,1
2022-04-29,Hai Phong City,Le Chan District,6,1,1,0,0
2022-04-29,Hai Phong City,Le Chan District,7,42,25,17,7
2022-04-29,Hai Phong City,Le Chan District,8,72,64,8,4
2022-04-29,Hai Phong City,Le Chan District,9,69,60,9,2
2022-04-29,Hai Phong City,Le Chan District,10,173,155,18,4
2022-04-29,Hai Phong City,Le Chan District,11,393,160,233,197
2022-04-29,Hai Phong City,Le Chan District,12,253,182,71,46
2022-04-29,Hai Phong City,Le Chan District,13,134,112,22,10
2022-04-29,Hai Phong City,Le Chan District,14,157,127,30,20
2022-04-29,Hai Phong City,Le Chan District,15,149,123,26,18
2022-04-29,Hai Phong City,Le Chan District,16,147,128,19,2
2022-04-29,Hai Phong City,Le Chan District,17,188,166,22,7
2022-04-29,Hai Phong City,Le Chan District,18,221,199,22,4
2022-04-29,Hai Phong City,Le Chan District,19,226,178,48,28
2022-04-29,Hai Phong City,Le Chan District,20,163,121,42,24
2022-04-29,Hai Phong City,Le Chan District,21,78,49,29,16
2022-04-29,Hai Phong City,Le Chan District,22,1,0,1,0
2022-04-29,Hai Phong City,Ngo Quyen District,1,1,0,1,1
2022-04-29,Hai Phong City,Ngo Quyen District,2,1,1,0,0
2022-04-29,Hai Phong City,Ngo Quyen District,6,3,0,3,3
2022-04-29,Hai Phong City,Ngo Quyen District,7,34,22,12,10
2022-04-29,Hai Phong City,Ngo Quyen District,8,77,68,9,0
2022-04-29,Hai Phong City,Ngo Quyen District,9,81,77,4,1
2022-04-29,Hai Phong City,Ngo Quyen District,10,135,123,12,3
2022-04-29,Hai Phong City,Ngo Quyen District,11,317,115,202,178
2022-04-29,Hai Phong City,Ngo Quyen District,12,219,174,45,33
2022-04-29,Hai Phong City,Ngo Quyen District,13,132,111,21,7
2022-04-29,Hai Phong City,Ngo Quyen District,14,158,126,32,17
2022-04-29,Hai Phong City,Ngo Quyen District,15,136,117,19,8
2022-04-29,Hai Phong City,Ngo Quyen District,16,97,86,11,0
2022-04-29,Hai Phong City,Ngo Quyen District,17,124,106,18,4
2022-04-29,Hai Phong City,Ngo Quyen District,18,160,140,20,5
2022-04-29,Hai Phong City,Ngo Quyen District,19,172,140,32,17
2022-04-29,Hai Phong City,Ngo Quyen District,20,122,96,26,10
2022-04-29,Hai Phong City,Ngo Quyen District,21,67,48,19,8
2022-04-29,Hai Phong City,Ngo Quyen District,22,1,1,0,0
2022-04-29,Hai Phong City,Thuy Nguyen,12,1,0,1,1
2022-04-29,Hai Phong City,Thuy Nguyen,17,1,0,1,1
2022-04-29,Hai Phong City,Thuy Nguyen,19,1,1,0,0
2022-04-29,Hue City,Hue City,1,1,0,1,1
2022-04-29,Hue City,Hue City,2,2,1,1,0
2022-04-29,Hue City,Hue City,3,1,1,0,0
2022-04-29,Hue City,Hue City,5,2,2,0,0
2022-04-29,Hue City,Hue City,6,60,56,4,3
2022-04-29,Hue City,Hue City,7,213,198,15,0
2022-04-29,Hue City,Hue City,8,299,278,21,0
2022-04-29,Hue City,Hue City,9,273,249,24,0
2022-04-29,Hue City,Hue City,10,496,467,29,1
2022-04-29,Hue City,Hue City,11,1242,600,642,564
2022-04-29,Hue City,Hue City,12,817,744,73,22
2022-04-29,Hue City,Hue City,13,382,357,25,0
2022-04-29,Hue City,Hue City,14,412,373,39,3
2022-04-29,Hue City,Hue City,15,389,368,21,5
2022-04-29,Hue City,Hue City,16,415,381,34,6
2022-04-29,Hue City,Hue City,17,545,518,27,4
2022-04-29,Hue City,Hue City,18,616,570,46,2
2022-04-29,Hue City,Hue City,19,594,521,73,4
2022-04-29,Hue City,Hue City,20,521,380,141,50
2022-04-29,Hue City,Hue City,21,277,235,42,19
2022-04-29,Hue City,Hue City,22,6,2,4,0
2022-04-29,Hue City,Hue City,23,3,2,1,0
2022-04-29,Hue City,Huong Thuy,8,2,0,2,1
2022-04-29,Hue City,Huong Thuy,9,2,2,0,0
2022-04-29,Hue City,Huong Thuy,11,1,0,1,1
2022-04-29,Hue City,Huong Thuy,15,1,1,0,0
2022-04-29,Hue City,Huong Thuy,17,1,1,0,0
2022-04-29,Hue City,Huong Thuy,19,1,0,1,1
2022-04-29,Hue City,Huong Tra,18,2,2,0,0
2022-04-29,Hue City,Phu Vang,7,1,0,1,1
2022-04-29,Hue City,Phu Vang,8,2,2,0,0
2022-04-29,Hue City,Phu Vang,9,2,1,1,0
2022-04-29,Hue City,Phu Vang,10,2,1,1,0
2022-04-29,Hue City,Phu Vang,11,3,1,2,1
2022-04-29,Hue City,Phu Vang,12,4,2,2,2
2022-04-29,Hue City,Phu Vang,13,2,1,1,1
2022-04-29,Hue City,Phu Vang,14,1,0,1,0
2022-04-29,Hue City,Phu Vang,15,2,2,0,0
2022-04-29,Hue City,Phu Vang,17,3,2,1,1
2022-04-29,Hue City,Phu Vang,18,5,4,1,0
2022-04-29,Hue City,Phu Vang,19,2,1,1,0
2022-04-29,Hue City,Phu Vang,20,1,1,0,0
2022-04-29,Vung Tau,Ba Ria City,7,1,0,1,1
2022-04-29,Vung Tau,Ba Ria City,8,8,0,8,7
2022-04-29,Vung Tau,Ba Ria City,9,9,0,9,6
2022-04-29,Vung Tau,Ba Ria City,10,8,4,4,4
2022-04-29,Vung Tau,Ba Ria City,11,20,6,14,10
2022-04-29,Vung Tau,Ba Ria City,12,11,7,4,3
2022-04-29,Vung Tau,Ba Ria City,13,14,5,9,6
2022-04-29,Vung Tau,Ba Ria City,14,6,6,0,0
2022-04-29,Vung Tau,Ba Ria City,15,2,2,0,0
2022-04-29,Vung Tau,Ba Ria City,16,6,4,2,0
2022-04-29,Vung Tau,Ba Ria City,17,3,0,3,2
2022-04-29,Vung Tau,Ba Ria City,18,10,3,7,5
2022-04-29,Vung Tau,Ba Ria City,19,13,0,13,10
2022-04-29,Vung Tau,Ba Ria City,20,13,0,13,11
2022-04-29,Vung Tau,Ba Ria City,21,9,0,9,8
2022-04-29,Vung Tau,Vung Tau City,3,1,0,1,1
2022-04-29,Vung Tau,Vung Tau City,4,1,1,0,0
2022-04-29,Vung Tau,Vung Tau City,5,4,1,3,2
2022-04-29,Vung Tau,Vung Tau City,6,24,19,5,4
2022-04-29,Vung Tau,Vung Tau City,7,142,77,65,59
2022-04-29,Vung Tau,Vung Tau City,8,289,91,198,168
2022-04-29,Vung Tau,Vung Tau City,9,327,139,188,150
2022-04-29,Vung Tau,Vung Tau City,10,309,172,137,103
2022-04-29,Vung Tau,Vung Tau City,11,576,158,418,361
2022-04-29,Vung Tau,Vung Tau City,12,394,311,83,46
2022-04-29,Vung Tau,Vung Tau City,13,239,207,32,19
2022-04-29,Vung Tau,Vung Tau City,14,245,220,25,7
2022-04-29,Vung Tau,Vung Tau City,15,209,191,18,2
2022-04-29,Vung Tau,Vung Tau City,16,195,181,14,0
2022-04-29,Vung Tau,Vung Tau City,17,300,266,34,14
2022-04-29,Vung Tau,Vung Tau City,18,330,295,35,5
2022-04-29,Vung Tau,Vung Tau City,19,295,257,38,15
2022-04-29,Vung Tau,Vung Tau City,20,315,143,172,134
2022-04-29,Vung Tau,Vung Tau City,21,242,49,193,156
2022-04-29,Vung Tau,Vung Tau City,23,1,1,0,0
2022-04-30,Binh Duong,Ben Cat,11,2,0,2,0
2022-04-30,Binh Duong,Ben Cat,13,2,0,2,0
2022-04-30,Binh Duong,Ben Cat,17,1,1,0,0
2022-04-30,Binh Duong,Ben Cat,19,1,0,1,1
2022-04-30,Binh Duong,Di An,5,1,0,1,0
2022-04-30,Binh Duong,Di An,6,1,0,1,1
2022-04-30,Binh Duong,Di An,7,6,1,5,5
2022-04-30,Binh Duong,Di An,8,13,5,8,5
2022-04-30,Binh Duong,Di An,9,21,11,10,7
2022-04-30,Binh Duong,Di An,10,29,18,11,9
2022-04-30,Binh Duong,Di An,11,43,32,11,4
2022-04-30,Binh Duong,Di An,12,44,31,13,9
2022-04-30,Binh Duong,Di An,13,27,18,9,6
2022-04-30,Binh Duong,Di An,14,20,10,10,9
2022-04-30,Binh Duong,Di An,15,34,10,24,20
2022-04-30,Binh Duong,Di An,16,25,16,9,7
2022-04-30,Binh Duong,Di An,17,32,17,15,10
2022-04-30,Binh Duong,Di An,18,39,19,20,14
2022-04-30,Binh Duong,Di An,19,48,17,31,22
2022-04-30,Binh Duong,Di An,20,36,12,24,20
2022-04-30,Binh Duong,Di An,21,23,4,19,17
2022-04-30,Binh Duong,Tan Uyen,8,1,0,1,1
2022-04-30,Binh Duong,Tan Uyen,10,1,1,0,0
2022-04-30,Binh Duong,Tan Uyen,11,7,4,3,2
2022-04-30,Binh Duong,Tan Uyen,12,4,4,0,0
2022-04-30,Binh Duong,Tan Uyen,13,3,2,1,1
2022-04-30,Binh Duong,Tan Uyen,14,1,0,1,1
2022-04-30,Binh Duong,Tan Uyen,15,3,0,3,3
2022-04-30,Binh Duong,Tan Uyen,16,1,0,1,0
2022-04-30,Binh Duong,Tan Uyen,17,3,2,1,1
2022-04-30,Binh Duong,Tan Uyen,18,4,2,2,2
2022-04-30,Binh Duong,Tan Uyen,19,2,1,1,1
2022-04-30,Binh Duong,Tan Uyen,20,1,1,0,0
2022-04-30,Binh Duong,Tan Uyen,21,1,0,1,1
2022-04-30,Binh Duong,Thu Dau Mot Town,1,1,1,0,0
2022-04-30,Binh Duong,Thu Dau Mot Town,4,1,1,0,0
2022-04-30,Binh Duong,Thu Dau Mot Town,6,43,34,9,7
2022-04-30,Binh Duong,Thu Dau Mot Town,7,136,126,10,3
2022-04-30,Binh Duong,Thu Dau Mot Town,8,213,192,21,4
2022-04-30,Binh Duong,Thu Dau Mot Town,9,268,236,32,10
2022-04-30,Binh Duong,Thu Dau Mot Town,10,404,364,40,14
2022-04-30,Binh Duong,Thu Dau Mot Town,11,550,500,50,5
2022-04-30,Binh Duong,Thu Dau Mot Town,12,480,453,27,7
2022-04-30,Binh Duong,Thu Dau Mot Town,13,398,372,26,7
2022-04-30,Binh Duong,Thu Dau Mot Town,14,342,316,26,6
2022-04-30,Binh Duong,Thu Dau Mot Town,15,275,214,61,38
2022-04-30,Binh Duong,Thu Dau Mot Town,16,343,314,29,9
2022-04-30,Binh Duong,Thu Dau Mot Town,17,364,332,32,9
2022-04-30,Binh Duong,Thu Dau Mot Town,18,412,372,40,9
2022-04-30,Binh Duong,Thu Dau Mot Town,19,385,329,56,15
2022-04-30,Binh Duong,Thu Dau Mot Town,20,283,252,31,7
2022-04-30,Binh Duong,Thu Dau Mot Town,21,109,86,23,9
2022-04-30,Binh Duong,Thu Dau Mot Town,22,3,0,3,0
2022-04-30,Binh Duong,Thuan An,6,2,0,2,2
2022-04-30,Binh Duong,Thuan An,7,8,2,6,4
2022-04-30,Binh Duong,Thuan An,8,23,8,15,9
2022-04-30,Binh Duong,Thuan An,9,38,25,13,11
2022-04-30,Binh Duong,Thuan An,10,50,41,9,4
2022-04-30,Binh Duong,Thuan An,11,81,55,26,16
2022-04-30,Binh Duong,Thuan An,12,77,49,28,19
2022-04-30,Binh Duong,Thuan An,13,56,40,16,15
2022-04-30,Binh Duong,Thuan An,14,53,20,33,22
2022-04-30,Binh Duong,Thuan An,15,62,32,30,25
2022-04-30,Binh Duong,Thuan An,16,65,50,15,13
2022-04-30,Binh Duong,Thuan An,17,60,42,18,9
2022-04-30,Binh Duong,Thuan An,18,56,41,15,8
2022-04-30,Binh Duong,Thuan An,19,49,26,23,17
2022-04-30,Binh Duong,Thuan An,20,55,22,33,23
2022-04-30,Binh Duong,Thuan An,21,26,11,15,11
2022-04-30,Can Tho City,Binh Thuy District,7,3,3,0,0
2022-04-30,Can Tho City,Binh Thuy District,8,7,6,1,0
2022-04-30,Can Tho City,Binh Thuy District,9,6,6,0,0
2022-04-30,Can Tho City,Binh Thuy District,10,10,9,1,0
2022-04-30,Can Tho City,Binh Thuy District,11,14,13,1,0
2022-04-30,Can Tho City,Binh Thuy District,12,10,10,0,0
2022-04-30,Can Tho City,Binh Thuy District,13,16,15,1,0
2022-04-30,Can Tho City,Binh Thuy District,14,10,10,0,0
2022-04-30,Can Tho City,Binh Thuy District,15,9,8,1,0
2022-04-30,Can Tho City,Binh Thuy District,16,13,12,1,0
2022-04-30,Can Tho City,Binh Thuy District,17,11,11,0,0
2022-04-30,Can Tho City,Binh Thuy District,18,12,10,2,0
2022-04-30,Can Tho City,Binh Thuy District,19,28,24,4,4
2022-04-30,Can Tho City,Binh Thuy District,20,9,6,3,0
2022-04-30,Can Tho City,Binh Thuy District,21,4,3,1,0
2022-04-30,Can Tho City,Binh Thuy District,23,1,1,0,0
2022-04-30,Can Tho City,Cai Rang District,7,1,1,0,0
2022-04-30,Can Tho City,Cai Rang District,8,14,11,3,2
2022-04-30,Can Tho City,Cai Rang District,9,11,10,1,0
2022-04-30,Can Tho City,Cai Rang District,10,12,10,2,0
2022-04-30,Can Tho City,Cai Rang District,11,11,10,1,1
2022-04-30,Can Tho City,Cai Rang District,12,15,13,2,0
2022-04-30,Can Tho City,Cai Rang District,13,13,8,5,1
2022-04-30,Can Tho City,Cai Rang District,14,11,10,1,1
2022-04-30,Can Tho City,Cai Rang District,15,10,8,2,1
2022-04-30,Can Tho City,Cai Rang District,16,9,9,0,0
2022-04-30,Can Tho City,Cai Rang District,17,11,10,1,0
2022-04-30,Can Tho City,Cai Rang District,18,24,23,1,0
2022-04-30,Can Tho City,Cai Rang District,19,15,12,3,1
2022-04-30,Can Tho City,Cai Rang District,20,8,7,1,0
2022-04-30,Can Tho City,Cai Rang District,21,1,1,0,0
2022-04-30,Can Tho City,Ninh Kieu District,0,4,4,0,0
2022-04-30,Can Tho City,Ninh Kieu District,2,1,1,0,0
2022-04-30,Can Tho City,Ninh Kieu District,3,2,1,1,0
2022-04-30,Can Tho City,Ninh Kieu District,5,4,3,1,0
2022-04-30,Can Tho City,Ninh Kieu District,6,39,35,4,1
2022-04-30,Can Tho City,Ninh Kieu District,7,131,124,7,0
2022-04-30,Can Tho City,Ninh Kieu District,8,236,218,18,0
2022-04-30,Can Tho City,Ninh Kieu District,9,322,301,21,0
2022-04-30,Can Tho City,Ninh Kieu District,10,429,402,27,1
2022-04-30,Can Tho City,Ninh Kieu District,11,612,578,34,4
2022-04-30,Can Tho City,Ninh Kieu District,12,542,516,26,0
2022-04-30,Can Tho City,Ninh Kieu District,13,397,380,17,0
2022-04-30,Can Tho City,Ninh Kieu District,14,353,333,20,0
2022-04-30,Can Tho City,Ninh Kieu District,15,309,292,17,0
2022-04-30,Can Tho City,Ninh Kieu District,16,362,345,17,0
2022-04-30,Can Tho City,Ninh Kieu District,17,460,426,34,0
2022-04-30,Can Tho City,Ninh Kieu District,18,544,497,47,8
2022-04-30,Can Tho City,Ninh Kieu District,19,466,407,59,14
2022-04-30,Can Tho City,Ninh Kieu District,20,314,284,30,1
2022-04-30,Can Tho City,Ninh Kieu District,21,149,127,22,0
2022-04-30,Can Tho City,Ninh Kieu District,22,4,2,2,0
2022-04-30,Can Tho City,Ninh Kieu District,23,1,0,1,0
2022-04-30,Can Tho City,Phong Dien,17,1,0,1,0
2022-04-30,Can Tho City,Thoi Lai,14,2,0,2,2
2022-04-30,Dong Nai,Bien Hoa City,0,3,1,2,0
2022-04-30,Dong Nai,Bien Hoa City,1,2,1,1,0
2022-04-30,Dong Nai,Bien Hoa City,2,2,2,0,0
2022-04-30,Dong Nai,Bien Hoa City,5,1,0,1,1
2022-04-30,Dong Nai,Bien Hoa City,6,51,31,20,11
2022-04-30,Dong Nai,Bien Hoa City,7,148,114,34,15
2022-04-30,Dong Nai,Bien Hoa City,8,292,240,52,20
2022-04-30,Dong Nai,Bien Hoa City,9,496,436,60,17
2022-04-30,Dong Nai,Bien Hoa City,10,802,738,64,10
2022-04-30,Dong Nai,Bien Hoa City,11,1152,1030,122,14
2022-04-30,Dong Nai,Bien Hoa City,12,1078,991,87,17
2022-04-30,Dong Nai,Bien Hoa City,13,874,749,125,54
2022-04-30,Dong Nai,Bien Hoa City,14,625,515,110,66
2022-04-30,Dong Nai,Bien Hoa City,15,725,549,176,113
2022-04-30,Dong Nai,Bien Hoa City,16,815,593,222,154
2022-04-30,Dong Nai,Bien Hoa City,17,802,690,112,44
2022-04-30,Dong Nai,Bien Hoa City,18,917,773,144,62
2022-04-30,Dong Nai,Bien Hoa City,19,859,657,202,119
2022-04-30,Dong Nai,Bien Hoa City,20,607,452,155,89
2022-04-30,Dong Nai,Bien Hoa City,21,283,179,104,42
2022-04-30,Dong Nai,Bien Hoa City,22,3,0,3,0
2022-04-30,Dong Nai,Bien Hoa City,23,1,1,0,0
2022-04-30,Dong Nai,Cam My,13,1,0,1,1
2022-04-30,Dong Nai,Long Thanh,8,1,0,1,1
2022-04-30,Dong Nai,Long Thanh,9,3,0,3,2
2022-04-30,Dong Nai,Long Thanh,10,3,0,3,2
2022-04-30,Dong Nai,Long Thanh,11,4,0,4,3
2022-04-30,Dong Nai,Long Thanh,16,1,0,1,1
2022-04-30,Dong Nai,Long Thanh,17,1,0,1,1
2022-04-30,Dong Nai,Long Thanh,19,2,0,2,2
2022-04-30,Dong Nai,Long Thanh,20,2,0,2,1
2022-04-30,Dong Nai,Long Thanh,21,1,0,1,1
2022-04-30,Dong Nai,Nhon trach,14,2,0,2,2
2022-04-30,Dong Nai,Nhon trach,15,1,0,1,1
2022-04-30,Dong Nai,Nhon trach,16,2,0,2,2
2022-04-30,Dong Nai,Trang Bom,9,1,0,1,0
2022-04-30,Dong Nai,Trang Bom,10,5,2,3,1
2022-04-30,Dong Nai,Trang Bom,13,2,0,2,2
2022-04-30,Dong Nai,Trang Bom,15,2,0,2,2
2022-04-30,Dong Nai,Trang Bom,18,1,0,1,0
2022-04-30,Dong Nai,Trang Bom,19,2,0,2,2
2022-04-30,Dong Nai,Trang Bom,21,2,0,2,0
2022-04-30,Hai Phong City,An Duong,8,2,2,0,0
2022-04-30,Hai Phong City,An Duong,10,5,2,3,1
2022-04-30,Hai Phong City,An Duong,11,4,2,2,2
2022-04-30,Hai Phong City,An Duong,12,5,3,2,1
2022-04-30,Hai Phong City,An Duong,13,9,5,4,4
2022-04-30,Hai Phong City,An Duong,14,1,1,0,0
2022-04-30,Hai Phong City,An Duong,15,4,3,1,1
2022-04-30,Hai Phong City,An Duong,16,4,2,2,1
2022-04-30,Hai Phong City,An Duong,18,2,2,0,0
2022-04-30,Hai Phong City,An Duong,19,6,1,5,5
2022-04-30,Hai Phong City,An Duong,20,1,0,1,1
2022-04-30,Hai Phong City,An Duong,21,1,1,0,0
2022-04-30,Hai Phong City,An Duong,22,1,0,1,1
2022-04-30,Hai Phong City,An Duong,23,1,0,1,1
2022-04-30,Hai Phong City,Do Son District,13,1,0,1,1
2022-04-30,Hai Phong City,Do Son District,14,1,0,1,1
2022-04-30,Hai Phong City,Do Son District,19,1,0,1,1
2022-04-30,Hai Phong City,Do Son District,20,1,0,1,1
2022-04-30,Hai Phong City,Duong Kinh District,10,2,0,2,2
2022-04-30,Hai Phong City,Duong Kinh District,14,1,0,1,0
2022-04-30,Hai Phong City,Duong Kinh District,20,1,0,1,1
2022-04-30,Hai Phong City,Hai An District,7,8,5,3,1
2022-04-30,Hai Phong City,Hai An District,8,12,11,1,0
2022-04-30,Hai Phong City,Hai An District,9,15,11,4,0
2022-04-30,Hai Phong City,Hai An District,10,23,14,9,0
2022-04-30,Hai Phong City,Hai An District,11,49,41,8,3
2022-04-30,Hai Phong City,Hai An District,12,28,23,5,0
2022-04-30,Hai Phong City,Hai An District,13,18,11,7,1
2022-04-30,Hai Phong City,Hai An District,14,17,10,7,3
2022-04-30,Hai Phong City,Hai An District,15,20,15,5,0
2022-04-30,Hai Phong City,Hai An District,16,22,16,6,2
2022-04-30,Hai Phong City,Hai An District,17,13,9,4,0
2022-04-30,Hai Phong City,Hai An District,18,24,21,3,0
2022-04-30,Hai Phong City,Hai An District,19,23,15,8,4
2022-04-30,Hai Phong City,Hai An District,20,27,16,11,10
2022-04-30,Hai Phong City,Hai An District,21,9,4,5,1
2022-04-30,Hai Phong City,Hong Bang District,0,1,0,1,0
2022-04-30,Hai Phong City,Hong Bang District,1,1,1,0,0
2022-04-30,Hai Phong City,Hong Bang District,6,2,0,2,0
2022-04-30,Hai Phong City,Hong Bang District,7,11,6,5,2
2022-04-30,Hai Phong City,Hong Bang District,8,11,10,1,0
2022-04-30,Hai Phong City,Hong Bang District,9,39,35,4,0
2022-04-30,Hai Phong City,Hong Bang District,10,95,83,12,3
2022-04-30,Hai Phong City,Hong Bang District,11,134,97,37,24
2022-04-30,Hai Phong City,Hong Bang District,12,94,74,20,6
2022-04-30,Hai Phong City,Hong Bang District,13,54,49,5,2
2022-04-30,Hai Phong City,Hong Bang District,14,47,41,6,2
2022-04-30,Hai Phong City,Hong Bang District,15,44,41,3,0
2022-04-30,Hai Phong City,Hong Bang District,16,42,31,11,4
2022-04-30,Hai Phong City,Hong Bang District,17,55,49,6,0
2022-04-30,Hai Phong City,Hong Bang District,18,70,60,10,4
2022-04-30,Hai Phong City,Hong Bang District,19,70,53,17,11
2022-04-30,Hai Phong City,Hong Bang District,20,50,38,12,10
2022-04-30,Hai Phong City,Hong Bang District,21,29,15,14,9
2022-04-30,Hai Phong City,Kien An District,7,2,1,1,1
2022-04-30,Hai Phong City,Kien An District,8,6,2,4,3
2022-04-30,Hai Phong City,Kien An District,9,7,4,3,2
2022-04-30,Hai Phong City,Kien An District,10,17,13,4,3
2022-04-30,Hai Phong City,Kien An District,11,28,17,11,9
2022-04-30,Hai Phong City,Kien An District,12,16,10,6,5
2022-04-30,Hai Phong City,Kien An District,13,17,12,5,1
2022-04-30,Hai Phong City,Kien An District,14,9,3,6,5
2022-04-30,Hai Phong City,Kien An District,15,17,4,13,10
2022-04-30,Hai Phong City,Kien An District,16,13,4,9,7
2022-04-30,Hai Phong City,Kien An District,17,18,8,10,9
2022-04-30,Hai Phong City,Kien An District,18,10,2,8,4
2022-04-30,Hai Phong City,Kien An District,19,23,9,14,10
2022-04-30,Hai Phong City,Kien An District,20,11,2,9,7
2022-04-30,Hai Phong City,Kien An District,21,3,0,3,1
2022-04-30,Hai Phong City,Le Chan District,6,4,2,2,1
2022-04-30,Hai Phong City,Le Chan District,7,45,33,12,5
2022-04-30,Hai Phong City,Le Chan District,8,66,56,10,0
2022-04-30,Hai Phong City,Le Chan District,9,107,91,16,3
2022-04-30,Hai Phong City,Le Chan District,10,188,162,26,5
2022-04-30,Hai Phong City,Le Chan District,11,357,270,87,48
2022-04-30,Hai Phong City,Le Chan District,12,232,181,51,15
2022-04-30,Hai Phong City,Le Chan District,13,168,143,25,4
2022-04-30,Hai Phong City,Le Chan District,14,137,120,17,5
2022-04-30,Hai Phong City,Le Chan District,15,150,130,20,7
2022-04-30,Hai Phong City,Le Chan District,16,151,130,21,3
2022-04-30,Hai Phong City,Le Chan District,17,186,168,18,2
2022-04-30,Hai Phong City,Le Chan District,18,253,212,41,11
2022-04-30,Hai Phong City,Le Chan District,19,222,153,69,24
2022-04-30,Hai Phong City,Le Chan District,20,181,118,63,33
2022-04-30,Hai Phong City,Le Chan District,21,93,57,36,18
2022-04-30,Hai Phong City,Ngo Quyen District,2,1,0,1,0
2022-04-30,Hai Phong City,Ngo Quyen District,6,1,1,0,0
2022-04-30,Hai Phong City,Ngo Quyen District,7,24,21,3,1
2022-04-30,Hai Phong City,Ngo Quyen District,8,78,69,9,1
2022-04-30,Hai Phong City,Ngo Quyen District,9,81,69,12,1
2022-04-30,Hai Phong City,Ngo Quyen District,10,205,186,19,2
2022-04-30,Hai Phong City,Ngo Quyen District,11,310,259,51,23
2022-04-30,Hai Phong City,Ngo Quyen District,12,227,200,27,5
2022-04-30,Hai Phong City,Ngo Quyen District,13,122,103,19,1
2022-04-30,Hai Phong City,Ngo Quyen District,14,125,116,9,2
2022-04-30,Hai Phong City,Ngo Quyen District,15,152,133,19,7
2022-04-30,Hai Phong City,Ngo Quyen District,16,151,133,18,10
2022-04-30,Hai Phong City,Ngo Quyen District,17,189,165,24,2
2022-04-30,Hai Phong City,Ngo Quyen District,18,163,142,21,5
2022-04-30,Hai Phong City,Ngo Quyen District,19,182,141,41,19
2022-04-30,Hai Phong City,Ngo Quyen District,20,136,105,31,15
2022-04-30,Hai Phong City,Ngo Quyen District,21,101,67,34,17
2022-04-30,Hai Phong City,Thuy Nguyen,9,2,0,2,2
2022-04-30,Hai Phong City,Thuy Nguyen,10,1,1,0,0
2022-04-30,Hai Phong City,Thuy Nguyen,11,1,1,0,0
2022-04-30,Hai Phong City,Thuy Nguyen,12,7,0,7,7
2022-04-30,Hai Phong City,Thuy Nguyen,13,1,0,1,1
2022-04-30,Hai Phong City,Thuy Nguyen,14,1,0,1,1
2022-04-30,Hai Phong City,Thuy Nguyen,15,1,0,1,0
2022-04-30,Hai Phong City,Thuy Nguyen,16,4,0,4,2
2022-04-30,Hai Phong City,Thuy Nguyen,17,2,0,2,2
2022-04-30,Hue City,Hue City,1,3,2,1,0
2022-04-30,Hue City,Hue City,5,3,3,0,0
2022-04-30,Hue City,Hue City,6,50,46,4,0
2022-04-30,Hue City,Hue City,7,214,201,13,0
2022-04-30,Hue City,Hue City,8,297,269,28,0
2022-04-30,Hue City,Hue City,9,306,286,20,1
2022-04-30,Hue City,Hue City,10,430,395,35,0
2022-04-30,Hue City,Hue City,11,818,755,63,10
2022-04-30,Hue City,Hue City,12,586,549,37,0
2022-04-30,Hue City,Hue City,13,391,359,32,0
2022-04-30,Hue City,Hue City,14,346,327,19,0
2022-04-30,Hue City,Hue City,15,469,414,55,6
2022-04-30,Hue City,Hue City,16,569,517,52,1
2022-04-30,Hue City,Hue City,17,638,583,55,0
2022-04-30,Hue City,Hue City,18,649,576,73,2
2022-04-30,Hue City,Hue City,19,599,518,81,8
2022-04-30,Hue City,Hue City,20,475,380,95,37
2022-04-30,Hue City,Hue City,21,266,201,65,21
2022-04-30,Hue City,Hue City,22,3,1,2,0
2022-04-30,Hue City,Hue City,23,3,3,0,0
2022-04-30,Hue City,Huong Thuy,6,1,1,0,0
2022-04-30,Hue City,Huong Thuy,8,1,1,0,0
2022-04-30,Hue City,Huong Thuy,10,1,0,1,0
2022-04-30,Hue City,Huong Thuy,11,1,1,0,0
2022-04-30,Hue City,Huong Thuy,12,1,0,1,0
2022-04-30,Hue City,Huong Thuy,13,1,0,1,1
2022-04-30,Hue City,Huong Thuy,14,1,1,0,0
2022-04-30,Hue City,Huong Thuy,15,3,2,1,1
2022-04-30,Hue City,Huong Thuy,16,1,0,1,0
2022-04-30,Hue City,Huong Thuy,18,2,2,0,0
2022-04-30,Hue City,Huong Thuy,19,1,0,1,0
2022-04-30,Hue City,Huong Tra,7,1,1,0,0
2022-04-30,Hue City,Huong Tra,13,2,1,1,1
2022-04-30,Hue City,Huong Tra,18,1,0,1,0
2022-04-30,Hue City,Phu Vang,11,4,2,2,1
2022-04-30,Hue City,Phu Vang,12,2,1,1,1
2022-04-30,Hue City,Phu Vang,13,4,1,3,3
2022-04-30,Hue City,Phu Vang,14,1,1,0,0
2022-04-30,Hue City,Phu Vang,15,1,1,0,0
2022-04-30,Hue City,Phu Vang,18,4,3,1,0
2022-04-30,Hue City,Phu Vang,19,5,3,2,1
2022-04-30,Hue City,Phu Vang,20,6,4,2,1
2022-04-30,Hue City,Phu Vang,21,2,0,2,1
2022-04-30,Vung Tau,Ba Ria City,7,3,0,3,3
2022-04-30,Vung Tau,Ba Ria City,8,2,0,2,2
2022-04-30,Vung Tau,Ba Ria City,9,1,0,1,1
2022-04-30,Vung Tau,Ba Ria City,10,11,4,7,5
2022-04-30,Vung Tau,Ba Ria City,11,13,5,8,4
2022-04-30,Vung Tau,Ba Ria City,12,10,4,6,4
2022-04-30,Vung Tau,Ba Ria City,13,10,8,2,2
2022-04-30,Vung Tau,Ba Ria City,14,6,3,3,2
2022-04-30,Vung Tau,Ba Ria City,15,7,6,1,0
2022-04-30,Vung Tau,Ba Ria City,16,8,6,2,2
2022-04-30,Vung Tau,Ba Ria City,17,8,4,4,3
2022-04-30,Vung Tau,Ba Ria City,18,13,4,9,9
2022-04-30,Vung Tau,Ba Ria City,19,12,1,11,11
2022-04-30,Vung Tau,Ba Ria City,20,8,0,8,8
2022-04-30,Vung Tau,Ba Ria City,21,5,0,5,4
2022-04-30,Vung Tau,Vung Tau City,0,1,1,0,0
2022-04-30,Vung Tau,Vung Tau City,1,1,1,0,0
2022-04-30,Vung Tau,Vung Tau City,2,1,1,0,0
2022-04-30,Vung Tau,Vung Tau City,5,3,2,1,0
2022-04-30,Vung Tau,Vung Tau City,6,33,31,2,1
2022-04-30,Vung Tau,Vung Tau City,7,93,89,4,2
2022-04-30,Vung Tau,Vung Tau City,8,179,170,9,1
2022-04-30,Vung Tau,Vung Tau City,9,220,204,16,4
2022-04-30,Vung Tau,Vung Tau City,10,257,239,18,2
2022-04-30,Vung Tau,Vung Tau City,11,393,358,35,2
2022-04-30,Vung Tau,Vung Tau City,12,395,374,21,4
2022-04-30,Vung Tau,Vung Tau City,13,296,272,24,1
2022-04-30,Vung Tau,Vung Tau City,14,258,233,25,3
2022-04-30,Vung Tau,Vung Tau City,15,277,256,21,6
2022-04-30,Vung Tau,Vung Tau City,16,240,222,18,7
2022-04-30,Vung Tau,Vung Tau City,17,333,305,28,5
2022-04-30,Vung Tau,Vung Tau City,18,417,367,50,13
2022-04-30,Vung Tau,Vung Tau City,19,335,295,40,6
2022-04-30,Vung Tau,Vung Tau City,20,293,229,64,29
2022-04-30,Vung Tau,Vung Tau City,21,157,108,49,28
2022-04-30,Vung Tau,Vung Tau City,22,3,3,0,0
2022-05-01,Binh Duong,Ben Cat,9,1,0,1,1
2022-05-01,Binh Duong,Ben Cat,10,3,0,3,3
2022-05-01,Binh Duong,Ben Cat,12,3,0,3,2
2022-05-01,Binh Duong,Ben Cat,13,1,0,1,1
2022-05-01,Binh Duong,Ben Cat,14,1,0,1,1
2022-05-01,Binh Duong,Ben Cat,17,1,1,0,0
2022-05-01,Binh Duong,Ben Cat,18,1,0,1,1
2022-05-01,Binh Duong,Ben Cat,19,1,0,1,1
2022-05-01,Binh Duong,Ben Cat,20,2,0,2,2
2022-05-01,Binh Duong,Di An,8,9,5,4,4
2022-05-01,Binh Duong,Di An,9,30,12,18,12
2022-05-01,Binh Duong,Di An,10,38,18,20,17
2022-05-01,Binh Duong,Di An,11,57,34,23,19
2022-05-01,Binh Duong,Di An,12,52,23,29,22
2022-05-01,Binh Duong,Di An,13,37,21,16,13
2022-05-01,Binh Duong,Di An,14,19,15,4,3
2022-05-01,Binh Duong,Di An,15,25,11,14,13
2022-05-01,Binh Duong,Di An,16,36,12,24,23
2022-05-01,Binh Duong,Di An,17,22,12,10,9
2022-05-01,Binh Duong,Di An,18,33,15,18,15
2022-05-01,Binh Duong,Di An,19,29,8,21,17
2022-05-01,Binh Duong,Di An,20,24,10,14,13
2022-05-01,Binh Duong,Di An,21,5,0,5,5
2022-05-01,Binh Duong,Di An,22,2,0,2,0
2022-05-01,Binh Duong,Tan Uyen,7,3,0,3,3
2022-05-01,Binh Duong,Tan Uyen,8,1,1,0,0
2022-05-01,Binh Duong,Tan Uyen,9,2,0,2,1
2022-05-01,Binh Duong,Tan Uyen,10,8,2,6,5
2022-05-01,Binh Duong,Tan Uyen,11,8,2,6,6
2022-05-01,Binh Duong,Tan Uyen,12,6,2,4,3
2022-05-01,Binh Duong,Tan Uyen,13,4,3,1,1
2022-05-01,Binh Duong,Tan Uyen,14,4,4,0,0
2022-05-01,Binh Duong,Tan Uyen,15,3,0,3,3
2022-05-01,Binh Duong,Tan Uyen,16,3,3,0,0
2022-05-01,Binh Duong,Tan Uyen,17,6,3,3,2
2022-05-01,Binh Duong,Tan Uyen,18,2,0,2,1
2022-05-01,Binh Duong,Tan Uyen,19,4,3,1,0
2022-05-01,Binh Duong,Tan Uyen,20,5,0,5,5
2022-05-01,Binh Duong,Thu Dau Mot Town,0,1,1,0,0
2022-05-01,Binh Duong,Thu Dau Mot Town,4,1,0,1,1
2022-05-01,Binh Duong,Thu Dau Mot Town,6,28,21,7,7
2022-05-01,Binh Duong,Thu Dau Mot Town,7,94,86,8,3
2022-05-01,Binh Duong,Thu Dau Mot Town,8,166,152,14,1
2022-05-01,Binh Duong,Thu Dau Mot Town,9,263,239,24,2
2022-05-01,Binh Duong,Thu Dau Mot Town,10,366,318,48,14
2022-05-01,Binh Duong,Thu Dau Mot Town,11,498,453,45,11
2022-05-01,Binh Duong,Thu Dau Mot Town,12,453,429,24,1
2022-05-01,Binh Duong,Thu Dau Mot Town,13,310,295,15,4
2022-05-01,Binh Duong,Thu Dau Mot Town,14,334,315,19,3
2022-05-01,Binh Duong,Thu Dau Mot Town,15,326,300,26,3
2022-05-01,Binh Duong,Thu Dau Mot Town,16,373,353,20,5
2022-05-01,Binh Duong,Thu Dau Mot Town,17,363,331,32,1
2022-05-01,Binh Duong,Thu Dau Mot Town,18,424,386,38,9
2022-05-01,Binh Duong,Thu Dau Mot Town,19,390,345,45,14
2022-05-01,Binh Duong,Thu Dau Mot Town,20,301,232,69,42
2022-05-01,Binh Duong,Thu Dau Mot Town,21,114,95,19,9
2022-05-01,Binh Duong,Thu Dau Mot Town,22,1,0,1,0
2022-05-01,Binh Duong,Thuan An,6,2,0,2,1
2022-05-01,Binh Duong,Thuan An,7,9,1,8,7
2022-05-01,Binh Duong,Thuan An,8,17,11,6,5
2022-05-01,Binh Duong,Thuan An,9,43,22,21,15
2022-05-01,Binh Duong,Thuan An,10,62,33,29,20
2022-05-01,Binh Duong,Thuan An,11,90,54,36,26
2022-05-01,Binh Duong,Thuan An,12,87,54,33,20
2022-05-01,Binh Duong,Thuan An,13,61,44,17,10
2022-05-01,Binh Duong,Thuan An,14,61,37,24,18
2022-05-01,Binh Duong,Thuan An,15,47,31,16,16
2022-05-01,Binh Duong,Thuan An,16,67,38,29,24
2022-05-01,Binh Duong,Thuan An,17,42,33,9,4
2022-05-01,Binh Duong,Thuan An,18,67,43,24,14
2022-05-01,Binh Duong,Thuan An,19,57,37,20,16
2022-05-01,Binh Duong,Thuan An,20,41,13,28,24
2022-05-01,Binh Duong,Thuan An,21,24,7,17,13
2022-05-01,Binh Duong,Thuan An,22,1,0,1,0
2022-05-01,Can Tho City,Binh Thuy District,7,2,1,1,0
2022-05-01,Can Tho City,Binh Thuy District,8,5,5,0,0
2022-05-01,Can Tho City,Binh Thuy District,9,10,9,1,0
2022-05-01,Can Tho City,Binh Thuy District,10,7,6,1,0
2022-05-01,Can Tho City,Binh Thuy District,11,21,17,4,0
2022-05-01,Can Tho City,Binh Thuy District,12,16,14,2,1
2022-05-01,Can Tho City,Binh Thuy District,13,15,13,2,0
2022-05-01,Can Tho City,Binh Thuy District,14,19,17,2,0
2022-05-01,Can Tho City,Binh Thuy District,15,21,20,1,0
2022-05-01,Can Tho City,Binh Thuy District,16,11,10,1,1
2022-05-01,Can Tho City,Binh Thuy District,17,17,15,2,0
2022-05-01,Can Tho City,Binh Thuy District,18,19,17,2,1
2022-05-01,Can Tho City,Binh Thuy District,19,15,14,1,1
2022-05-01,Can Tho City,Binh Thuy District,20,10,7,3,0
2022-05-01,Can Tho City,Binh Thuy District,21,9,2,7,3
2022-05-01,Can Tho City,Cai Rang District,0,1,0,1,0
2022-05-01,Can Tho City,Cai Rang District,6,1,1,0,0
2022-05-01,Can Tho City,Cai Rang District,7,4,2,2,0
2022-05-01,Can Tho City,Cai Rang District,8,12,9,3,1
2022-05-01,Can Tho City,Cai Rang District,9,8,6,2,1
2022-05-01,Can Tho City,Cai Rang District,10,6,5,1,0
2022-05-01,Can Tho City,Cai Rang District,11,12,10,2,1
2022-05-01,Can Tho City,Cai Rang District,12,9,9,0,0
2022-05-01,Can Tho City,Cai Rang District,13,9,8,1,0
2022-05-01,Can Tho City,Cai Rang District,14,6,5,1,1
2022-05-01,Can Tho City,Cai Rang District,15,5,3,2,0
2022-05-01,Can Tho City,Cai Rang District,16,9,9,0,0
2022-05-01,Can Tho City,Cai Rang District,17,17,15,2,0
2022-05-01,Can Tho City,Cai Rang District,18,10,7,3,0
2022-05-01,Can Tho City,Cai Rang District,19,9,8,1,0
2022-05-01,Can Tho City,Cai Rang District,20,7,6,1,0
2022-05-01,Can Tho City,Cai Rang District,21,4,3,1,0
2022-05-01,Can Tho City,Ninh Kieu District,0,1,0,1,0
2022-05-01,Can Tho City,Ninh Kieu District,1,3,2,1,1
2022-05-01,Can Tho City,Ninh Kieu District,2,1,1,0,0
2022-05-01,Can Tho City,Ninh Kieu District,3,1,1,0,0
2022-05-01,Can Tho City,Ninh Kieu District,4,1,1,0,0
2022-05-01,Can Tho City,Ninh Kieu District,6,43,32,11,5
2022-05-01,Can Tho City,Ninh Kieu District,7,110,99,11,1
2022-05-01,Can Tho City,Ninh Kieu District,8,201,186,15,0
2022-05-01,Can Tho City,Ninh Kieu District,9,278,258,20,0
2022-05-01,Can Tho City,Ninh Kieu District,10,407,383,24,0
2022-05-01,Can Tho City,Ninh Kieu District,11,584,543,41,3
2022-05-01,Can Tho City,Ninh Kieu District,12,474,451,23,0
2022-05-01,Can Tho City,Ninh Kieu District,13,417,396,21,0
2022-05-01,Can Tho City,Ninh Kieu District,14,368,341,27,2
2022-05-01,Can Tho City,Ninh Kieu District,15,360,338,22,1
2022-05-01,Can Tho City,Ninh Kieu District,16,393,361,32,1
2022-05-01,Can Tho City,Ninh Kieu District,17,423,401,22,1
2022-05-01,Can Tho City,Ninh Kieu District,18,460,425,35,0
2022-05-01,Can Tho City,Ninh Kieu District,19,451,422,29,1
2022-05-01,Can Tho City,Ninh Kieu District,20,316,293,23,4
2022-05-01,Can Tho City,Ninh Kieu District,21,181,157,24,5
2022-05-01,Can Tho City,Ninh Kieu District,22,2,1,1,0
2022-05-01,Can Tho City,Ninh Kieu District,23,6,5,1,0
2022-05-01,Can Tho City,Thoi Lai,8,1,0,1,1
2022-05-01,Can Tho City,Thoi Lai,15,1,0,1,1
2022-05-01,Can Tho City,Thoi Lai,16,1,0,1,1
2022-05-01,Can Tho City,Thoi Lai,18,1,0,1,0
2022-05-01,Dong Nai,Bien Hoa City,1,4,2,2,0
2022-05-01,Dong Nai,Bien Hoa City,2,1,1,0,0
2022-05-01,Dong Nai,Bien Hoa City,4,3,1,2,1
2022-05-01,Dong Nai,Bien Hoa City,5,4,2,2,1
2022-05-01,Dong Nai,Bien Hoa City,6,43,19,24,16
2022-05-01,Dong Nai,Bien Hoa City,7,119,98,21,10
2022-05-01,Dong Nai,Bien Hoa City,8,271,232,39,15
2022-05-01,Dong Nai,Bien Hoa City,9,485,427,58,8
2022-05-01,Dong Nai,Bien Hoa City,10,796,698,98,41
2022-05-01,Dong Nai,Bien Hoa City,11,1159,988,171,65
2022-05-01,Dong Nai,Bien Hoa City,12,947,870,77,16
2022-05-01,Dong Nai,Bien Hoa City,13,758,687,71,11
2022-05-01,Dong Nai,Bien Hoa City,14,675,580,95,40
2022-05-01,Dong Nai,Bien Hoa City,15,574,493,81,31
2022-05-01,Dong Nai,Bien Hoa City,16,676,541,135,75
2022-05-01,Dong Nai,Bien Hoa City,17,827,721,106,40
2022-05-01,Dong Nai,Bien Hoa City,18,850,704,146,67
2022-05-01,Dong Nai,Bien Hoa City,19,925,621,304,205
2022-05-01,Dong Nai,Bien Hoa City,20,773,413,360,264
2022-05-01,Dong Nai,Bien Hoa City,21,308,179,129,86
2022-05-01,Dong Nai,Bien Hoa City,23,2,1,1,0
2022-05-01,Dong Nai,Long Thanh,8,2,0,2,0
2022-05-01,Dong Nai,Long Thanh,9,2,0,2,2
2022-05-01,Dong Nai,Long Thanh,10,3,0,3,3
2022-05-01,Dong Nai,Long Thanh,11,3,0,3,3
2022-05-01,Dong Nai,Long Thanh,13,3,0,3,2
2022-05-01,Dong Nai,Long Thanh,14,4,0,4,4
2022-05-01,Dong Nai,Long Thanh,16,1,0,1,1
2022-05-01,Dong Nai,Long Thanh,18,2,0,2,2
2022-05-01,Dong Nai,Long Thanh,19,4,0,4,3
2022-05-01,Dong Nai,Nhon trach,8,2,0,2,2
2022-05-01,Dong Nai,Nhon trach,10,1,0,1,1
2022-05-01,Dong Nai,Nhon trach,14,1,0,1,0
2022-05-01,Dong Nai,Nhon trach,19,1,0,1,1
2022-05-01,Dong Nai,Nhon trach,20,1,0,1,1
2022-05-01,Dong Nai,Trang Bom,11,4,0,4,4
2022-05-01,Dong Nai,Trang Bom,13,3,0,3,2
2022-05-01,Dong Nai,Trang Bom,15,1,0,1,0
2022-05-01,Dong Nai,Trang Bom,19,1,0,1,1
2022-05-01,Dong Nai,Trang Bom,20,1,0,1,0
2022-05-01,Hai Phong City,An Duong,7,1,0,1,1
2022-05-01,Hai Phong City,An Duong,8,2,0,2,2
2022-05-01,Hai Phong City,An Duong,9,1,0,1,1
2022-05-01,Hai Phong City,An Duong,10,4,2,2,1
2022-05-01,Hai Phong City,An Duong,11,8,4,4,2
2022-05-01,Hai Phong City,An Duong,12,7,2,5,2
2022-05-01,Hai Phong City,An Duong,14,4,1,3,2
2022-05-01,Hai Phong City,An Duong,15,6,1,5,3
2022-05-01,Hai Phong City,An Duong,16,3,3,0,0
2022-05-01,Hai Phong City,An Duong,17,4,0,4,2
2022-05-01,Hai Phong City,An Duong,18,4,0,4,3
2022-05-01,Hai Phong City,An Duong,19,1,0,1,1
2022-05-01,Hai Phong City,An Duong,20,3,0,3,2
2022-05-01,Hai Phong City,Do Son District,13,1,0,1,1
2022-05-01,Hai Phong City,Do Son District,15,1,0,1,1
2022-05-01,Hai Phong City,Do Son District,16,1,0,1,1
2022-05-01,Hai Phong City,Duong Kinh District,19,1,0,1,1
2022-05-01,Hai Phong City,Hai An District,4,1,0,1,1
2022-05-01,Hai Phong City,Hai An District,6,2,0,2,2
2022-05-01,Hai Phong City,Hai An District,7,6,0,6,5
2022-05-01,Hai Phong City,Hai An District,8,7,5,2,0
2022-05-01,Hai Phong City,Hai An District,9,11,7,4,0
2022-05-01,Hai Phong City,Hai An District,10,19,15,4,1
2022-05-01,Hai Phong City,Hai An District,11,24,19,5,1
2022-05-01,Hai Phong City,Hai An District,12,29,25,4,1
2022-05-01,Hai Phong City,Hai An District,13,10,7,3,0
2022-05-01,Hai Phong City,Hai An District,14,14,10,4,2
2022-05-01,Hai Phong City,Hai An District,15,23,19,4,1
2022-05-01,Hai Phong City,Hai An District,16,26,19,7,2
2022-05-01,Hai Phong City,Hai An District,17,27,20,7,2
2022-05-01,Hai Phong City,Hai An District,18,34,25,9,4
2022-05-01,Hai Phong City,Hai An District,19,31,19,12,9
2022-05-01,Hai Phong City,Hai An District,20,16,9,7,5
2022-05-01,Hai Phong City,Hai An District,21,15,10,5,1
2022-05-01,Hai Phong City,Hong Bang District,3,1,0,1,1
2022-05-01,Hai Phong City,Hong Bang District,6,1,0,1,1
2022-05-01,Hai Phong City,Hong Bang District,7,15,6,9,9
2022-05-01,Hai Phong City,Hong Bang District,8,22,14,8,7
2022-05-01,Hai Phong City,Hong Bang District,9,31,27,4,0
2022-05-01,Hai Phong City,Hong Bang District,10,80,68,12,3
2022-05-01,Hai Phong City,Hong Bang District,11,125,112,13,3
2022-05-01,Hai Phong City,Hong Bang District,12,77,67,10,4
2022-05-01,Hai Phong City,Hong Bang District,13,56,44,12,1
2022-05-01,Hai Phong City,Hong Bang District,14,38,30,8,3
2022-05-01,Hai Phong City,Hong Bang District,15,56,35,21,8
2022-05-01,Hai Phong City,Hong Bang District,16,42,24,18,7
2022-05-01,Hai Phong City,Hong Bang District,17,70,55,15,10
2022-05-01,Hai Phong City,Hong Bang District,18,108,61,47,36
2022-05-01,Hai Phong City,Hong Bang District,19,79,36,43,35
2022-05-01,Hai Phong City,Hong Bang District,20,45,30,15,8
2022-05-01,Hai Phong City,Hong Bang District,21,31,19,12,8
2022-05-01,Hai Phong City,Kien An District,7,1,0,1,1
2022-05-01,Hai Phong City,Kien An District,8,4,0,4,3
2022-05-01,Hai Phong City,Kien An District,9,8,2,6,6
2022-05-01,Hai Phong City,Kien An District,10,24,11,13,12
2022-05-01,Hai Phong City,Kien An District,11,17,10,7,6
2022-05-01,Hai Phong City,Kien An District,12,14,10,4,2
2022-05-01,Hai Phong City,Kien An District,13,14,8,6,2
2022-05-01,Hai Phong City,Kien An District,14,8,3,5,3
2022-05-01,Hai Phong City,Kien An District,15,8,5,3,3
2022-05-01,Hai Phong City,Kien An District,16,15,3,12,10
2022-05-01,Hai Phong City,Kien An District,17,15,4,11,9
2022-05-01,Hai Phong City,Kien An District,18,7,4,3,3
2022-05-01,Hai Phong City,Kien An District,19,16,6,10,9
2022-05-01,Hai Phong City,Kien An District,20,10,2,8,6
2022-05-01,Hai Phong City,Kien An District,21,6,0,6,5
2022-05-01,Hai Phong City,Le Chan District,1,1,1,0,0
2022-05-01,Hai Phong City,Le Chan District,3,1,0,1,0
2022-05-01,Hai Phong City,Le Chan District,6,1,1,0,0
2022-05-01,Hai Phong City,Le Chan District,7,53,18,35,31
2022-05-01,Hai Phong City,Le Chan District,8,87,71,16,7
2022-05-01,Hai Phong City,Le Chan District,9,114,94,20,0
2022-05-01,Hai Phong City,Le Chan District,10,200,164,36,5
2022-05-01,Hai Phong City,Le Chan District,11,274,233,41,6
2022-05-01,Hai Phong City,Le Chan District,12,194,160,34,6
2022-05-01,Hai Phong City,Le Chan District,13,140,119,21,4
2022-05-01,Hai Phong City,Le Chan District,14,128,103,25,7
2022-05-01,Hai Phong City,Le Chan District,15,179,137,42,25
2022-05-01,Hai Phong City,Le Chan District,16,189,138,51,15
2022-05-01,Hai Phong City,Le Chan District,17,217,170,47,15
2022-05-01,Hai Phong City,Le Chan District,18,311,173,138,99
2022-05-01,Hai Phong City,Le Chan District,19,269,140,129,93
2022-05-01,Hai Phong City,Le Chan District,20,178,118,60,44
2022-05-01,Hai Phong City,Le Chan District,21,84,42,42,21
2022-05-01,Hai Phong City,Le Chan District,22,5,0,5,2
2022-05-01,Hai Phong City,Le Chan District,23,1,0,1,0
2022-05-01,Hai Phong City,Ngo Quyen District,1,1,0,1,1
2022-05-01,Hai Phong City,Ngo Quyen District,6,5,2,3,1
2022-05-01,Hai Phong City,Ngo Quyen District,7,41,18,23,14
2022-05-01,Hai Phong City,Ngo Quyen District,8,85,59,26,9
2022-05-01,Hai Phong City,Ngo Quyen District,9,88,66,22,7
2022-05-01,Hai Phong City,Ngo Quyen District,10,174,160,14,3
2022-05-01,Hai Phong City,Ngo Quyen District,11,257,226,31,13
2022-05-01,Hai Phong City,Ngo Quyen District,12,190,165,25,3
2022-05-01,Hai Phong City,Ngo Quyen District,13,127,121,6,1
2022-05-01,Hai Phong City,Ngo Quyen District,14,155,123,32,11
2022-05-01,Hai Phong City,Ngo Quyen District,15,154,118,36,17
2022-05-01,Hai Phong City,Ngo Quyen District,16,147,108,39,14
2022-05-01,Hai Phong City,Ngo Quyen District,17,197,156,41,17
2022-05-01,Hai Phong City,Ngo Quyen District,18,260,177,83,53
2022-05-01,Hai Phong City,Ngo Quyen District,19,269,167,102,72
2022-05-01,Hai Phong City,Ngo Quyen District,20,193,121,72,45
2022-05-01,Hai Phong City,Ngo Quyen District,21,102,69,33,16
2022-05-01,Hai Phong City,Ngo Quyen District,22,1,0,1,0
2022-05-01,Hai Phong City,Thuy Nguyen,0,1,0,1,1
2022-05-01,Hai Phong City,Thuy Nguyen,10,2,0,2,2
2022-05-01,Hai Phong City,Thuy Nguyen,11,2,1,1,0
2022-05-01,Hai Phong City,Thuy Nguyen,14,3,1,2,2
2022-05-01,Hai Phong City,Thuy Nguyen,16,3,0,3,2
2022-05-01,Hai Phong City,Thuy Nguyen,17,1,0,1,1
2022-05-01,Hai Phong City,Thuy Nguyen,18,3,0,3,3
2022-05-01,Hai Phong City,Thuy Nguyen,19,1,0,1,1
2022-05-01,Hai Phong City,Thuy Nguyen,21,2,0,2,1
2022-05-01,Hue City,Hue City,0,2,0,2,0
2022-05-01,Hue City,Hue City,1,2,0,2,0
2022-05-01,Hue City,Hue City,2,1,1,0,0
2022-05-01,Hue City,Hue City,3,1,1,0,0
2022-05-01,Hue City,Hue City,5,2,1,1,0
2022-05-01,Hue City,Hue City,6,87,64,23,13
2022-05-01,Hue City,Hue City,7,205,187,18,2
2022-05-01,Hue City,Hue City,8,360,330,30,1
2022-05-01,Hue City,Hue City,9,336,294,42,0
2022-05-01,Hue City,Hue City,10,436,397,39,0
2022-05-01,Hue City,Hue City,11,743,686,57,2
2022-05-01,Hue City,Hue City,12,584,528,56,3
2022-05-01,Hue City,Hue City,13,397,351,46,1
2022-05-01,Hue City,Hue City,14,372,340,32,0
2022-05-01,Hue City,Hue City,15,587,502,85,25
2022-05-01,Hue City,Hue City,16,763,597,166,59
2022-05-01,Hue City,Hue City,17,942,722,220,111
2022-05-01,Hue City,Hue City,18,1256,695,561,410
2022-05-01,Hue City,Hue City,19,1140,556,584,439
2022-05-01,Hue City,Hue City,20,887,422,465,337
2022-05-01,Hue City,Hue City,21,372,211,161,90
2022-05-01,Hue City,Hue City,22,7,1,6,2
2022-05-01,Hue City,Hue City,23,1,0,1,1
2022-05-01,Hue City,Huong Thuy,9,2,1,1,1
2022-05-01,Hue City,Huong Thuy,10,1,1,0,0
2022-05-01,Hue City,Huong Thuy,11,1,1,0,0
2022-05-01,Hue City,Huong Thuy,12,1,0,1,1
2022-05-01,Hue City,Huong Thuy,13,1,0,1,0
2022-05-01,Hue City,Huong Thuy,16,2,2,0,0
2022-05-01,Hue City,Huong Thuy,17,3,1,2,0
2022-05-01,Hue City,Huong Thuy,18,4,1,3,0
2022-05-01,Hue City,Huong Thuy,19,2,1,1,0
2022-05-01,Hue City,Huong Thuy,21,1,0,1,1
2022-05-01,Hue City,Huong Tra,9,1,1,0,0
2022-05-01,Hue City,Huong Tra,10,2,0,2,1
2022-05-01,Hue City,Huong Tra,16,2,1,1,1
2022-05-01,Hue City,Phu Vang,6,2,1,1,1
2022-05-01,Hue City,Phu Vang,7,2,2,0,0
2022-05-01,Hue City,Phu Vang,8,2,2,0,0
2022-05-01,Hue City,Phu Vang,9,2,1,1,1
2022-05-01,Hue City,Phu Vang,10,5,4,1,1
2022-05-01,Hue City,Phu Vang,11,2,2,0,0
2022-05-01,Hue City,Phu Vang,12,2,1,1,1
2022-05-01,Hue City,Phu Vang,13,1,1,0,0
2022-05-01,Hue City,Phu Vang,14,1,1,0,0
2022-05-01,Hue City,Phu Vang,15,2,2,0,0
2022-05-01,Hue City,Phu Vang,16,3,3,0,0
2022-05-01,Hue City,Phu Vang,17,1,0,1,1
2022-05-01,Hue City,Phu Vang,18,11,4,7,5
2022-05-01,Hue City,Phu Vang,19,8,2,6,5
2022-05-01,Hue City,Phu Vang,20,2,0,2,2
2022-05-01,Hue City,Phu Vang,21,5,1,4,1
2022-05-01,Vung Tau,Ba Ria City,6,2,0,2,2
2022-05-01,Vung Tau,Ba Ria City,7,5,0,5,5
2022-05-01,Vung Tau,Ba Ria City,8,4,1,3,2
2022-05-01,Vung Tau,Ba Ria City,9,7,3,4,4
2022-05-01,Vung Tau,Ba Ria City,10,7,5,2,2
2022-05-01,Vung Tau,Ba Ria City,11,13,7,6,3
2022-05-01,Vung Tau,Ba Ria City,12,21,10,11,9
2022-05-01,Vung Tau,Ba Ria City,13,11,5,6,4
2022-05-01,Vung Tau,Ba Ria City,14,9,6,3,3
2022-05-01,Vung Tau,Ba Ria City,15,18,5,13,11
2022-05-01,Vung Tau,Ba Ria City,16,12,5,7,7
2022-05-01,Vung Tau,Ba Ria City,17,7,4,3,2
2022-05-01,Vung Tau,Ba Ria City,18,10,9,1,1
2022-05-01,Vung Tau,Ba Ria City,19,8,3,5,4
2022-05-01,Vung Tau,Ba Ria City,20,4,0,4,4
2022-05-01,Vung Tau,Ba Ria City,21,8,0,8,8
2022-05-01,Vung Tau,Tan Thanh,10,2,0,2,2
2022-05-01,Vung Tau,Tan Thanh,13,1,0,1,1
2022-05-01,Vung Tau,Vung Tau City,1,1,1,0,0
2022-05-01,Vung Tau,Vung Tau City,3,1,1,0,0
2022-05-01,Vung Tau,Vung Tau City,5,5,3,2,0
2022-05-01,Vung Tau,Vung Tau City,6,33,26,7,3
2022-05-01,Vung Tau,Vung Tau City,7,104,95,9,3
2022-05-01,Vung Tau,Vung Tau City,8,227,204,23,3
2022-05-01,Vung Tau,Vung Tau City,9,274,250,24,8
2022-05-01,Vung Tau,Vung Tau City,10,327,311,16,1
2022-05-01,Vung Tau,Vung Tau City,11,417,392,25,3
2022-05-01,Vung Tau,Vung Tau City,12,355,328,27,4
2022-05-01,Vung Tau,Vung Tau City,13,299,272,27,3
2022-05-01,Vung Tau,Vung Tau City,14,262,244,18,1
2022-05-01,Vung Tau,Vung Tau City,15,270,255,15,4
2022-05-01,Vung Tau,Vung Tau City,16,289,258,31,13
2022-05-01,Vung Tau,Vung Tau City,17,323,293,30,2
2022-05-01,Vung Tau,Vung Tau City,18,404,361,43,7
2022-05-01,Vung Tau,Vung Tau City,19,351,288,63,23
2022-05-01,Vung Tau,Vung Tau City,20,272,223,49,18
2022-05-01,Vung Tau,Vung Tau City,21,146,108,38,19
2022-05-01,Vung Tau,Vung Tau City,22,3,3,0,0
2022-05-01,Vung Tau,Vung Tau City,23,1,0,1,0
2022-05-01,Vung Tau,Xuyen Moc,18,1,1,0,0
2022-05-02,Binh Duong,Ben Cat,9,2,0,2,2
2022-05-02,Binh Duong,Ben Cat,11,1,1,0,0
2022-05-02,Binh Duong,Ben Cat,12,1,0,1,1
2022-05-02,Binh Duong,Ben Cat,13,1,0,1,1
2022-05-02,Binh Duong,Ben Cat,14,4,1,3,3
2022-05-02,Binh Duong,Ben Cat,15,2,1,1,1
2022-05-02,Binh Duong,Ben Cat,16,1,1,0,0
2022-05-02,Binh Duong,Di An,6,1,0,1,1
2022-05-02,Binh Duong,Di An,7,4,1,3,3
2022-05-02,Binh Duong,Di An,8,11,2,9,9
2022-05-02,Binh Duong,Di An,9,18,7,11,8
2022-05-02,Binh Duong,Di An,10,45,6,39,35
2022-05-02,Binh Duong,Di An,11,80,19,61,46
2022-05-02,Binh Duong,Di An,12,55,27,28,22
2022-05-02,Binh Duong,Di An,13,36,17,19,16
2022-05-02,Binh Duong,Di An,14,38,17,21,19
2022-05-02,Binh Duong,Di An,15,28,18,10,9
2022-05-02,Binh Duong,Di An,16,32,14,18,16
2022-05-02,Binh Duong,Di An,17,32,20,12,10
2022-05-02,Binh Duong,Di An,18,30,17,13,11
2022-05-02,Binh Duong,Di An,19,38,11,27,17
2022-05-02,Binh Duong,Di An,20,26,4,22,17
2022-05-02,Binh Duong,Di An,21,10,1,9,8
2022-05-02,Binh Duong,Tan Uyen,1,1,0,1,1
2022-05-02,Binh Duong,Tan Uyen,7,2,0,2,1
2022-05-02,Binh Duong,Tan Uyen,8,2,0,2,2
2022-05-02,Binh Duong,Tan Uyen,9,2,0,2,2
2022-05-02,Binh Duong,Tan Uyen,10,9,6,3,1
2022-05-02,Binh Duong,Tan Uyen,11,6,4,2,2
2022-05-02,Binh Duong,Tan Uyen,12,3,0,3,3
2022-05-02,Binh Duong,Tan Uyen,13,4,1,3,3
2022-05-02,Binh Duong,Tan Uyen,14,5,2,3,3
2022-05-02,Binh Duong,Tan Uyen,15,7,4,3,3
2022-05-02,Binh Duong,Tan Uyen,16,4,1,3,2
2022-05-02,Binh Duong,Tan Uyen,17,1,0,1,0
2022-05-02,Binh Duong,Tan Uyen,18,5,3,2,2
2022-05-02,Binh Duong,Tan Uyen,19,4,1,3,3
2022-05-02,Binh Duong,Thu Dau Mot Town,0,1,1,0,0
2022-05-02,Binh Duong,Thu Dau Mot Town,3,2,0,2,0
2022-05-02,Binh Duong,Thu Dau Mot Town,5,1,0,1,1
2022-05-02,Binh Duong,Thu Dau Mot Town,6,31,19,12,7
2022-05-02,Binh Duong,Thu Dau Mot Town,7,117,98,19,8
2022-05-02,Binh Duong,Thu Dau Mot Town,8,213,179,34,16
2022-05-02,Binh Duong,Thu Dau Mot Town,9,247,223,24,2
2022-05-02,Binh Duong,Thu Dau Mot Town,10,437,407,30,5
2022-05-02,Binh Duong,Thu Dau Mot Town,11,551,515,36,2
2022-05-02,Binh Duong,Thu Dau Mot Town,12,477,442,35,4
2022-05-02,Binh Duong,Thu Dau Mot Town,13,401,377,24,6
2022-05-02,Binh Duong,Thu Dau Mot Town,14,369,346,23,3
2022-05-02,Binh Duong,Thu Dau Mot Town,15,353,325,28,7
2022-05-02,Binh Duong,Thu Dau Mot Town,16,326,299,27,6
2022-05-02,Binh Duong,Thu Dau Mot Town,17,394,367,27,4
2022-05-02,Binh Duong,Thu Dau Mot Town,18,423,390,33,6
2022-05-02,Binh Duong,Thu Dau Mot Town,19,359,325,34,9
2022-05-02,Binh Duong,Thu Dau Mot Town,20,242,210,32,10
2022-05-02,Binh Duong,Thu Dau Mot Town,21,128,99,29,10
2022-05-02,Binh Duong,Thu Dau Mot Town,22,3,0,3,0
2022-05-02,Binh Duong,Thuan An,7,7,1,6,5
2022-05-02,Binh Duong,Thuan An,8,22,14,8,6
2022-05-02,Binh Duong,Thuan An,9,34,21,13,6
2022-05-02,Binh Duong,Thuan An,10,61,34,27,22
2022-05-02,Binh Duong,Thuan An,11,77,41,36,29
2022-05-02,Binh Duong,Thuan An,12,81,48,33,24
2022-05-02,Binh Duong,Thuan An,13,67,33,34,28
2022-05-02,Binh Duong,Thuan An,14,67,49,18,13
2022-05-02,Binh Duong,Thuan An,15,43,37,6,4
2022-05-02,Binh Duong,Thuan An,16,48,29,19,17
2022-05-02,Binh Duong,Thuan An,17,37,29,8,4
2022-05-02,Binh Duong,Thuan An,18,45,33,12,8
2022-05-02,Binh Duong,Thuan An,19,45,32,13,11
2022-05-02,Binh Duong,Thuan An,20,37,14,23,16
2022-05-02,Binh Duong,Thuan An,21,33,7,26,22
2022-05-02,Can Tho City,Binh Thuy District,7,2,2,0,0
2022-05-02,Can Tho City,Binh Thuy District,8,6,5,1,0
2022-05-02,Can Tho City,Binh Thuy District,9,11,9,2,0
2022-05-02,Can Tho City,Binh Thuy District,10,10,6,4,0
2022-05-02,Can Tho City,Binh Thuy District,11,25,20,5,0
2022-05-02,Can Tho City,Binh Thuy District,12,6,6,0,0
2022-05-02,Can Tho City,Binh Thuy District,13,22,21,1,1
2022-05-02,Can Tho City,Binh Thuy District,14,15,13,2,0
2022-05-02,Can Tho City,Binh Thuy District,15,11,11,0,0
2022-05-02,Can Tho City,Binh Thuy District,16,10,9,1,0
2022-05-02,Can Tho City,Binh Thuy District,17,16,12,4,3
2022-05-02,Can Tho City,Binh Thuy District,18,17,17,0,0
2022-05-02,Can Tho City,Binh Thuy District,19,15,14,1,1
2022-05-02,Can Tho City,Binh Thuy District,20,11,10,1,1
2022-05-02,Can Tho City,Binh Thuy District,21,2,1,1,0
2022-05-02,Can Tho City,Cai Rang District,7,4,3,1,1
2022-05-02,Can Tho City,Cai Rang District,8,4,3,1,0
2022-05-02,Can Tho City,Cai Rang District,9,5,2,3,1
2022-05-02,Can Tho City,Cai Rang District,10,12,9,3,2
2022-05-02,Can Tho City,Cai Rang District,11,11,9,2,1
2022-05-02,Can Tho City,Cai Rang District,12,9,7,2,0
2022-05-02,Can Tho City,Cai Rang District,13,10,8,2,2
2022-05-02,Can Tho City,Cai Rang District,14,14,14,0,0
2022-05-02,Can Tho City,Cai Rang District,15,5,5,0,0
2022-05-02,Can Tho City,Cai Rang District,16,10,10,0,0
2022-05-02,Can Tho City,Cai Rang District,17,11,10,1,1
2022-05-02,Can Tho City,Cai Rang District,18,16,13,3,2
2022-05-02,Can Tho City,Cai Rang District,19,16,13,3,1
2022-05-02,Can Tho City,Cai Rang District,20,7,4,3,1
2022-05-02,Can Tho City,Cai Rang District,21,3,3,0,0
2022-05-02,Can Tho City,Ninh Kieu District,0,3,2,1,0
2022-05-02,Can Tho City,Ninh Kieu District,1,3,1,2,0
2022-05-02,Can Tho City,Ninh Kieu District,2,2,1,1,0
2022-05-02,Can Tho City,Ninh Kieu District,3,1,0,1,0
2022-05-02,Can Tho City,Ninh Kieu District,5,4,3,1,1
2022-05-02,Can Tho City,Ninh Kieu District,6,61,47,14,4
2022-05-02,Can Tho City,Ninh Kieu District,7,114,100,14,2
2022-05-02,Can Tho City,Ninh Kieu District,8,229,214,15,1
2022-05-02,Can Tho City,Ninh Kieu District,9,312,290,22,0
2022-05-02,Can Tho City,Ninh Kieu District,10,473,442,31,0
2022-05-02,Can Tho City,Ninh Kieu District,11,635,591,44,5
2022-05-02,Can Tho City,Ninh Kieu District,12,547,522,25,0
2022-05-02,Can Tho City,Ninh Kieu District,13,458,429,29,0
2022-05-02,Can Tho City,Ninh Kieu District,14,356,341,15,0
2022-05-02,Can Tho City,Ninh Kieu District,15,356,341,15,1
2022-05-02,Can Tho City,Ninh Kieu District,16,378,356,22,0
2022-05-02,Can Tho City,Ninh Kieu District,17,484,460,24,1
2022-05-02,Can Tho City,Ninh Kieu District,18,542,478,64,10
2022-05-02,Can Tho City,Ninh Kieu District,19,508,460,48,16
2022-05-02,Can Tho City,Ninh Kieu District,20,418,355,63,25
2022-05-02,Can Tho City,Ninh Kieu District,21,164,148,16,3
2022-05-02,Can Tho City,Ninh Kieu District,22,7,2,5,0
2022-05-02,Can Tho City,Ninh Kieu District,23,1,1,0,0
2022-05-02,Can Tho City,Phong Dien,13,1,0,1,1
2022-05-02,Can Tho City,Phong Dien,16,1,0,1,1
2022-05-02,Can Tho City,Thoi Lai,8,1,0,1,1
2022-05-02,Dong Nai,Bien Hoa City,0,4,2,2,0
2022-05-02,Dong Nai,Bien Hoa City,1,1,0,1,0
2022-05-02,Dong Nai,Bien Hoa City,2,1,0,1,0
2022-05-02,Dong Nai,Bien Hoa City,3,2,1,1,0
2022-05-02,Dong Nai,Bien Hoa City,4,1,0,1,0
2022-05-02,Dong Nai,Bien Hoa City,5,7,3,4,1
2022-05-02,Dong Nai,Bien Hoa City,6,38,16,22,15
2022-05-02,Dong Nai,Bien Hoa City,7,133,92,41,21
2022-05-02,Dong Nai,Bien Hoa City,8,296,250,46,27
2022-05-02,Dong Nai,Bien Hoa City,9,528,452,76,25
2022-05-02,Dong Nai,Bien Hoa City,10,913,753,160,65
2022-05-02,Dong Nai,Bien Hoa City,11,1058,943,115,45
2022-05-02,Dong Nai,Bien Hoa City,12,1008,912,96,23
2022-05-02,Dong Nai,Bien Hoa City,13,773,706,67,8
2022-05-02,Dong Nai,Bien Hoa City,14,733,652,81,21
2022-05-02,Dong Nai,Bien Hoa City,15,621,551,70,20
2022-05-02,Dong Nai,Bien Hoa City,16,622,545,77,29
2022-05-02,Dong Nai,Bien Hoa City,17,724,645,79,23
2022-05-02,Dong Nai,Bien Hoa City,18,788,704,84,21
2022-05-02,Dong Nai,Bien Hoa City,19,828,628,200,107
2022-05-02,Dong Nai,Bien Hoa City,20,633,466,167,100
2022-05-02,Dong Nai,Bien Hoa City,21,251,145,106,58
2022-05-02,Dong Nai,Bien Hoa City,22,2,1,1,0
2022-05-02,Dong Nai,Bien Hoa City,23,2,0,2,0
2022-05-02,Dong Nai,Long Thanh,8,1,0,1,1
2022-05-02,Dong Nai,Long Thanh,9,1,0,1,1
2022-05-02,Dong Nai,Long Thanh,10,1,0,1,1
2022-05-02,Dong Nai,Long Thanh,11,2,0,2,1
2022-05-02,Dong Nai,Long Thanh,13,1,0,1,1
2022-05-02,Dong Nai,Long Thanh,14,2,0,2,2
2022-05-02,Dong Nai,Long Thanh,15,1,0,1,1
2022-05-02,Dong Nai,Long Thanh,17,8,0,8,5
2022-05-02,Dong Nai,Long Thanh,18,1,0,1,1
2022-05-02,Dong Nai,Nhon trach,15,1,0,1,1
2022-05-02,Dong Nai,Trang Bom,12,2,0,2,1
2022-05-02,Dong Nai,Trang Bom,13,2,0,2,2
2022-05-02,Dong Nai,Trang Bom,14,1,0,1,1
2022-05-02,Dong Nai,Trang Bom,15,3,0,3,2
2022-05-02,Dong Nai,Trang Bom,16,1,0,1,1
2022-05-02,Dong Nai,Trang Bom,18,1,0,1,1
2022-05-02,Dong Nai,Trang Bom,20,1,0,1,1
2022-05-02,Dong Nai,Vinh Cuu,10,1,0,1,1
2022-05-02,Hai Phong City,An Duong,8,1,0,1,0
2022-05-02,Hai Phong City,An Duong,9,1,1,0,0
2022-05-02,Hai Phong City,An Duong,10,3,0,3,3
2022-05-02,Hai Phong City,An Duong,11,12,2,10,9
2022-05-02,Hai Phong City,An Duong,12,5,0,5,5
2022-05-02,Hai Phong City,An Duong,13,3,2,1,1
2022-05-02,Hai Phong City,An Duong,14,4,2,2,2
2022-05-02,Hai Phong City,An Duong,15,3,1,2,2
2022-05-02,Hai Phong City,An Duong,16,5,3,2,1
2022-05-02,Hai Phong City,An Duong,17,5,1,4,2
2022-05-02,Hai Phong City,An Duong,18,5,1,4,4
2022-05-02,Hai Phong City,An Duong,19,5,1,4,4
2022-05-02,Hai Phong City,An Duong,20,4,1,3,2
2022-05-02,Hai Phong City,An Duong,21,2,0,2,2
2022-05-02,Hai Phong City,Do Son District,10,1,0,1,1
2022-05-02,Hai Phong City,Do Son District,11,3,0,3,2
2022-05-02,Hai Phong City,Do Son District,12,1,0,1,1
2022-05-02,Hai Phong City,Do Son District,20,2,0,2,2
2022-05-02,Hai Phong City,Duong Kinh District,18,1,0,1,0
2022-05-02,Hai Phong City,Hai An District,1,2,2,0,0
2022-05-02,Hai Phong City,Hai An District,6,1,0,1,0
2022-05-02,Hai Phong City,Hai An District,7,10,2,8,5
2022-05-02,Hai Phong City,Hai An District,8,18,12,6,6
2022-05-02,Hai Phong City,Hai An District,9,6,5,1,0
2022-05-02,Hai Phong City,Hai An District,10,32,24,8,5
2022-05-02,Hai Phong City,Hai An District,11,50,32,18,9
2022-05-02,Hai Phong City,Hai An District,12,26,19,7,5
2022-05-02,Hai Phong City,Hai An District,13,23,17,6,2
2022-05-02,Hai Phong City,Hai An District,14,10,9,1,0
2022-05-02,Hai Phong City,Hai An District,15,20,12,8,6
2022-05-02,Hai Phong City,Hai An District,16,28,17,11,9
2022-05-02,Hai Phong City,Hai An District,17,17,14,3,2
2022-05-02,Hai Phong City,Hai An District,18,37,20,17,8
2022-05-02,Hai Phong City,Hai An District,19,34,17,17,11
2022-05-02,Hai Phong City,Hai An District,20,25,18,7,2
2022-05-02,Hai Phong City,Hai An District,21,11,6,5,1
2022-05-02,Hai Phong City,Hai An District,22,1,0,1,1
2022-05-02,Hai Phong City,Hong Bang District,6,1,0,1,1
2022-05-02,Hai Phong City,Hong Bang District,7,17,9,8,3
2022-05-02,Hai Phong City,Hong Bang District,8,20,10,10,6
2022-05-02,Hai Phong City,Hong Bang District,9,27,15,12,7
2022-05-02,Hai Phong City,Hong Bang District,10,80,48,32,22
2022-05-02,Hai Phong City,Hong Bang District,11,119,72,47,40
2022-05-02,Hai Phong City,Hong Bang District,12,75,47,28,22
2022-05-02,Hai Phong City,Hong Bang District,13,58,48,10,7
2022-05-02,Hai Phong City,Hong Bang District,14,55,39,16,11
2022-05-02,Hai Phong City,Hong Bang District,15,52,31,21,15
2022-05-02,Hai Phong City,Hong Bang District,16,42,29,13,6
2022-05-02,Hai Phong City,Hong Bang District,17,48,35,13,5
2022-05-02,Hai Phong City,Hong Bang District,18,87,47,40,31
2022-05-02,Hai Phong City,Hong Bang District,19,85,37,48,42
2022-05-02,Hai Phong City,Hong Bang District,20,54,28,26,20
2022-05-02,Hai Phong City,Hong Bang District,21,29,15,14,11
2022-05-02,Hai Phong City,Kien An District,7,1,0,1,1
2022-05-02,Hai Phong City,Kien An District,8,4,0,4,4
2022-05-02,Hai Phong City,Kien An District,9,13,3,10,10
2022-05-02,Hai Phong City,Kien An District,10,27,15,12,8
2022-05-02,Hai Phong City,Kien An District,11,18,12,6,4
2022-05-02,Hai Phong City,Kien An District,12,11,6,5,4
2022-05-02,Hai Phong City,Kien An District,13,6,2,4,4
2022-05-02,Hai Phong City,Kien An District,14,8,2,6,6
2022-05-02,Hai Phong City,Kien An District,15,24,4,20,14
2022-05-02,Hai Phong City,Kien An District,16,9,5,4,4
2022-05-02,Hai Phong City,Kien An District,17,3,1,2,2
2022-05-02,Hai Phong City,Kien An District,18,5,3,2,1
2022-05-02,Hai Phong City,Kien An District,19,18,4,14,13
2022-05-02,Hai Phong City,Kien An District,20,9,5,4,4
2022-05-02,Hai Phong City,Kien An District,21,7,1,6,4
2022-05-02,Hai Phong City,Le Chan District,0,1,1,0,0
2022-05-02,Hai Phong City,Le Chan District,5,2,2,0,0
2022-05-02,Hai Phong City,Le Chan District,6,3,2,1,1
2022-05-02,Hai Phong City,Le Chan District,7,46,27,19,13
2022-05-02,Hai Phong City,Le Chan District,8,78,52,26,18
2022-05-02,Hai Phong City,Le Chan District,9,107,84,23,9
2022-05-02,Hai Phong City,Le Chan District,10,229,151,78,51
2022-05-02,Hai Phong City,Le Chan District,11,391,204,187,146
2022-05-02,Hai Phong City,Le Chan District,12,300,226,74,47
2022-05-02,Hai Phong City,Le Chan District,13,170,124,46,13
2022-05-02,Hai Phong City,Le Chan District,14,181,139,42,25
2022-05-02,Hai Phong City,Le Chan District,15,216,142,74,50
2022-05-02,Hai Phong City,Le Chan District,16,212,144,68,35
2022-05-02,Hai Phong City,Le Chan District,17,199,152,47,27
2022-05-02,Hai Phong City,Le Chan District,18,273,160,113,86
2022-05-02,Hai Phong City,Le Chan District,19,317,162,155,128
2022-05-02,Hai Phong City,Le Chan District,20,195,119,76,53
2022-05-02,Hai Phong City,Le Chan District,21,101,61,40,17
2022-05-02,Hai Phong City,Le Chan District,22,4,1,3,1
2022-05-02,Hai Phong City,Le Chan District,23,2,0,2,0
2022-05-02,Hai Phong City,Ngo Quyen District,0,1,0,1,1
2022-05-02,Hai Phong City,Ngo Quyen District,7,27,16,11,9
2022-05-02,Hai Phong City,Ngo Quyen District,8,58,39,19,18
2022-05-02,Hai Phong City,Ngo Quyen District,9,89,75,14,10
2022-05-02,Hai Phong City,Ngo Quyen District,10,183,127,56,37
2022-05-02,Hai Phong City,Ngo Quyen District,11,312,205,107,77
2022-05-02,Hai Phong City,Ngo Quyen District,12,202,156,46,27
2022-05-02,Hai Phong City,Ngo Quyen District,13,135,108,27,4
2022-05-02,Hai Phong City,Ngo Quyen District,14,144,108,36,18
2022-05-02,Hai Phong City,Ngo Quyen District,15,153,117,36,20
2022-05-02,Hai Phong City,Ngo Quyen District,16,196,131,65,35
2022-05-02,Hai Phong City,Ngo Quyen District,17,167,127,40,15
2022-05-02,Hai Phong City,Ngo Quyen District,18,253,139,114,87
2022-05-02,Hai Phong City,Ngo Quyen District,19,248,147,101,74
2022-05-02,Hai Phong City,Ngo Quyen District,20,172,107,65,42
2022-05-02,Hai Phong City,Ngo Quyen District,21,83,52,31,19
2022-05-02,Hai Phong City,Ngo Quyen District,23,3,0,3,1
2022-05-02,Hai Phong City,Thuy Nguyen,9,1,0,1,1
2022-05-02,Hai Phong City,Thuy Nguyen,10,1,0,1,1
2022-05-02,Hai Phong City,Thuy Nguyen,13,2,0,2,2
2022-05-02,Hai Phong City,Thuy Nguyen,15,3,0,3,3
2022-05-02,Hai Phong City,Thuy Nguyen,16,2,0,2,2
2022-05-02,Hai Phong City,Thuy Nguyen,17,1,0,1,1
2022-05-02,Hai Phong City,Thuy Nguyen,18,1,0,1,1
2022-05-02,Hai Phong City,Thuy Nguyen,19,2,0,2,2
2022-05-02,Hai Phong City,Thuy Nguyen,20,4,0,4,4
2022-05-02,Hue City,Hue City,0,5,4,1,1
2022-05-02,Hue City,Hue City,2,1,1,0,0
2022-05-02,Hue City,Hue City,5,3,3,0,0
2022-05-02,Hue City,Hue City,6,82,59,23,11
2022-05-02,Hue City,Hue City,7,365,206,159,136
2022-05-02,Hue City,Hue City,8,684,360,324,251
2022-05-02,Hue City,Hue City,9,491,402,89,33
2022-05-02,Hue City,Hue City,10,510,467,43,4
2022-05-02,Hue City,Hue City,11,840,756,84,16
2022-05-02,Hue City,Hue City,12,643,583,60,2
2022-05-02,Hue City,Hue City,13,474,435,39,2
2022-05-02,Hue City,Hue City,14,483,416,67,16
2022-05-02,Hue City,Hue City,15,596,505,91,36
2022-05-02,Hue City,Hue City,16,691,579,112,37
2022-05-02,Hue City,Hue City,17,790,662,128,43
2022-05-02,Hue City,Hue City,18,795,675,120,38
2022-05-02,Hue City,Hue City,19,667,559,108,24
2022-05-02,Hue City,Hue City,20,470,399,71,20
2022-05-02,Hue City,Hue City,21,275,210,65,14
2022-05-02,Hue City,Hue City,22,6,2,4,0
2022-05-02,Hue City,Hue City,23,1,1,0,0
2022-05-02,Hue City,Huong Thuy,8,1,1,0,0
2022-05-02,Hue City,Huong Thuy,12,2,2,0,0
2022-05-02,Hue City,Huong Thuy,13,1,1,0,0
2022-05-02,Hue City,Huong Thuy,14,1,0,1,0
2022-05-02,Hue City,Huong Thuy,16,1,1,0,0
2022-05-02,Hue City,Huong Thuy,17,3,1,2,2
2022-05-02,Hue City,Huong Tra,7,1,1,0,0
2022-05-02,Hue City,Huong Tra,11,1,0,1,1
2022-05-02,Hue City,Huong Tra,13,1,0,1,0
2022-05-02,Hue City,Huong Tra,16,1,0,1,0
2022-05-02,Hue City,Huong Tra,19,1,0,1,0
2022-05-02,Hue City,Phu Vang,6,2,2,0,0
2022-05-02,Hue City,Phu Vang,7,1,0,1,1
2022-05-02,Hue City,Phu Vang,8,5,2,3,3
2022-05-02,Hue City,Phu Vang,9,5,3,2,1
2022-05-02,Hue City,Phu Vang,10,4,2,2,1
2022-05-02,Hue City,Phu Vang,11,3,2,1,0
2022-05-02,Hue City,Phu Vang,12,4,3,1,0
2022-05-02,Hue City,Phu Vang,13,6,4,2,1
2022-05-02,Hue City,Phu Vang,14,2,1,1,0
2022-05-02,Hue City,Phu Vang,15,3,1,2,0
2022-05-02,Hue City,Phu Vang,16,6,0,6,5
2022-05-02,Hue City,Phu Vang,17,4,2,2,0
2022-05-02,Hue City,Phu Vang,18,3,2,1,0
2022-05-02,Hue City,Phu Vang,19,1,1,0,0
2022-05-02,Hue City,Phu Vang,20,2,1,1,1
2022-05-02,Hue City,Phu Vang,21,2,0,2,0
2022-05-02,Vung Tau,Ba Ria City,7,3,1,2,2
2022-05-02,Vung Tau,Ba Ria City,8,2,0,2,2
2022-05-02,Vung Tau,Ba Ria City,9,3,3,0,0
2022-05-02,Vung Tau,Ba Ria City,10,14,6,8,7
2022-05-02,Vung Tau,Ba Ria City,11,16,2,14,12
2022-05-02,Vung Tau,Ba Ria City,12,14,4,10,7
2022-05-02,Vung Tau,Ba Ria City,13,6,4,2,1
2022-05-02,Vung Tau,Ba Ria City,14,6,0,6,6
2022-05-02,Vung Tau,Ba Ria City,15,13,1,12,11
2022-05-02,Vung Tau,Ba Ria City,16,5,1,4,4
2022-05-02,Vung Tau,Ba Ria City,17,13,1,12,12
2022-05-02,Vung Tau,Ba Ria City,18,9,3,6,5
2022-05-02,Vung Tau,Ba Ria City,19,16,3,13,11
2022-05-02,Vung Tau,Ba Ria City,20,5,1,4,3
2022-05-02,Vung Tau,Ba Ria City,21,10,1,9,9
2022-05-02,Vung Tau,Vung Tau City,0,1,0,1,1
2022-05-02,Vung Tau,Vung Tau City,3,1,0,1,0
2022-05-02,Vung Tau,Vung Tau City,5,1,0,1,0
2022-05-02,Vung Tau,Vung Tau City,6,37,20,17,15
2022-05-02,Vung Tau,Vung Tau City,7,168,115,53,37
2022-05-02,Vung Tau,Vung Tau City,8,204,180,24,19
2022-05-02,Vung Tau,Vung Tau City,9,304,237,67,39
2022-05-02,Vung Tau,Vung Tau City,10,332,248,84,48
2022-05-02,Vung Tau,Vung Tau City,11,484,402,82,50
2022-05-02,Vung Tau,Vung Tau City,12,366,327,39,13
2022-05-02,Vung Tau,Vung Tau City,13,283,253,30,7
2022-05-02,Vung Tau,Vung Tau City,14,284,263,21,6
2022-05-02,Vung Tau,Vung Tau City,15,238,222,16,2
2022-05-02,Vung Tau,Vung Tau City,16,278,254,24,4
2022-05-02,Vung Tau,Vung Tau City,17,376,294,82,56
2022-05-02,Vung Tau,Vung Tau City,18,463,329,134,83
2022-05-02,Vung Tau,Vung Tau City,19,389,272,117,80
2022-05-02,Vung Tau,Vung Tau City,20,306,151,155,126
2022-05-02,Vung Tau,Vung Tau City,21,224,61,163,141
2022-05-02,Vung Tau,Vung Tau City,22,2,1,1,0
2022-05-02,Vung Tau,Vung Tau City,23,3,2,1,0
2022-05-03,Binh Duong,Ben Cat,11,2,1,1,0
2022-05-03,Binh Duong,Ben Cat,12,1,0,1,1
2022-05-03,Binh Duong,Ben Cat,13,1,0,1,1
2022-05-03,Binh Duong,Ben Cat,19,2,0,2,2
2022-05-03,Binh Duong,Ben Cat,20,2,0,2,2
2022-05-03,Binh Duong,Di An,7,3,1,2,2
2022-05-03,Binh Duong,Di An,8,9,6,3,3
2022-05-03,Binh Duong,Di An,9,21,7,14,13
2022-05-03,Binh Duong,Di An,10,47,19,28,15
2022-05-03,Binh Duong,Di An,11,56,33,23,21
2022-05-03,Binh Duong,Di An,12,49,31,18,16
2022-05-03,Binh Duong,Di An,13,35,18,17,13
2022-05-03,Binh Duong,Di An,14,37,15,22,19
2022-05-03,Binh Duong,Di An,15,25,17,8,7
2022-05-03,Binh Duong,Di An,16,23,17,6,3
2022-05-03,Binh Duong,Di An,17,25,9,16,14
2022-05-03,Binh Duong,Di An,18,38,3,35,33
2022-05-03,Binh Duong,Di An,19,32,5,27,24
2022-05-03,Binh Duong,Di An,20,44,3,41,33
2022-05-03,Binh Duong,Di An,21,16,3,13,11
2022-05-03,Binh Duong,Phu Giao,11,1,0,1,0
2022-05-03,Binh Duong,Tan Uyen,10,4,0,4,3
2022-05-03,Binh Duong,Tan Uyen,11,3,2,1,1
2022-05-03,Binh Duong,Tan Uyen,12,2,1,1,1
2022-05-03,Binh Duong,Tan Uyen,13,3,0,3,3
2022-05-03,Binh Duong,Tan Uyen,14,1,0,1,1
2022-05-03,Binh Duong,Tan Uyen,15,1,0,1,1
2022-05-03,Binh Duong,Tan Uyen,16,1,0,1,0
2022-05-03,Binh Duong,Tan Uyen,17,4,1,3,3
2022-05-03,Binh Duong,Tan Uyen,18,2,1,1,1
2022-05-03,Binh Duong,Tan Uyen,19,5,1,4,4
2022-05-03,Binh Duong,Tan Uyen,20,1,0,1,1
2022-05-03,Binh Duong,Thu Dau Mot Town,0,1,1,0,0
2022-05-03,Binh Duong,Thu Dau Mot Town,5,1,1,0,0
2022-05-03,Binh Duong,Thu Dau Mot Town,6,35,32,3,2
2022-05-03,Binh Duong,Thu Dau Mot Town,7,99,97,2,1
2022-05-03,Binh Duong,Thu Dau Mot Town,8,216,211,5,0
2022-05-03,Binh Duong,Thu Dau Mot Town,9,249,230,19,3
2022-05-03,Binh Duong,Thu Dau Mot Town,10,374,346,28,1
2022-05-03,Binh Duong,Thu Dau Mot Town,11,539,509,30,5
2022-05-03,Binh Duong,Thu Dau Mot Town,12,487,464,23,5
2022-05-03,Binh Duong,Thu Dau Mot Town,13,401,375,26,5
2022-05-03,Binh Duong,Thu Dau Mot Town,14,362,337,25,2
2022-05-03,Binh Duong,Thu Dau Mot Town,15,295,276,19,3
2022-05-03,Binh Duong,Thu Dau Mot Town,16,333,299,34,16
2022-05-03,Binh Duong,Thu Dau Mot Town,17,311,206,105,70
2022-05-03,Binh Duong,Thu Dau Mot Town,18,632,355,277,228
2022-05-03,Binh Duong,Thu Dau Mot Town,19,665,280,385,324
2022-05-03,Binh Duong,Thu Dau Mot Town,20,534,180,354,291
2022-05-03,Binh Duong,Thu Dau Mot Town,21,267,89,178,132
2022-05-03,Binh Duong,Thu Dau Mot Town,22,2,0,2,1
2022-05-03,Binh Duong,Thu Dau Mot Town,23,1,1,0,0
2022-05-03,Binh Duong,Thuan An,6,4,1,3,2
2022-05-03,Binh Duong,Thuan An,7,13,3,10,8
2022-05-03,Binh Duong,Thuan An,8,20,11,9,8
2022-05-03,Binh Duong,Thuan An,9,26,16,10,7
2022-05-03,Binh Duong,Thuan An,10,49,27,22,18
2022-05-03,Binh Duong,Thuan An,11,90,41,49,41
2022-05-03,Binh Duong,Thuan An,12,87,49,38,22
2022-05-03,Binh Duong,Thuan An,13,63,31,32,27
2022-05-03,Binh Duong,Thuan An,14,59,32,27,24
2022-05-03,Binh Duong,Thuan An,15,46,25,21,21
2022-05-03,Binh Duong,Thuan An,16,27,14,13,11
2022-05-03,Binh Duong,Thuan An,17,56,15,41,34
2022-05-03,Binh Duong,Thuan An,18,96,29,67,52
2022-05-03,Binh Duong,Thuan An,19,87,19,68,62
2022-05-03,Binh Duong,Thuan An,20,89,12,77,65
2022-05-03,Binh Duong,Thuan An,21,56,4,52,46
2022-05-03,Binh Duong,Thuan An,22,10,0,10,1
2022-05-03,Binh Duong,Thuan An,23,2,1,1,0
2022-05-03,Can Tho City,Binh Thuy District,6,1,1,0,0
2022-05-03,Can Tho City,Binh Thuy District,7,4,4,0,0
2022-05-03,Can Tho City,Binh Thuy District,8,3,2,1,1
2022-05-03,Can Tho City,Binh Thuy District,9,11,9,2,0
2022-05-03,Can Tho City,Binh Thuy District,10,12,7,5,0
2022-05-03,Can Tho City,Binh Thuy District,11,14,12,2,0
2022-05-03,Can Tho City,Binh Thuy District,12,9,9,0,0
2022-05-03,Can Tho City,Binh Thuy District,13,22,19,3,0
2022-05-03,Can Tho City,Binh Thuy District,14,11,8,3,1
2022-05-03,Can Tho City,Binh Thuy District,15,11,11,0,0
2022-05-03,Can Tho City,Binh Thuy District,16,17,16,1,1
2022-05-03,Can Tho City,Binh Thuy District,17,17,16,1,0
2022-05-03,Can Tho City,Binh Thuy District,18,12,11,1,0
2022-05-03,Can Tho City,Binh Thuy District,19,19,16,3,1
2022-05-03,Can Tho City,Binh Thuy District,20,10,9,1,0
2022-05-03,Can Tho City,Binh Thuy District,21,4,3,1,0
2022-05-03,Can Tho City,Cai Rang District,1,1,1,0,0
2022-05-03,Can Tho City,Cai Rang District,6,3,2,1,1
2022-05-03,Can Tho City,Cai Rang District,7,4,3,1,1
2022-05-03,Can Tho City,Cai Rang District,8,10,6,4,0
2022-05-03,Can Tho City,Cai Rang District,9,7,6,1,0
2022-05-03,Can Tho City,Cai Rang District,10,7,7,0,0
2022-05-03,Can Tho City,Cai Rang District,11,18,15,3,1
2022-05-03,Can Tho City,Cai Rang District,12,11,9,2,0
2022-05-03,Can Tho City,Cai Rang District,13,5,5,0,0
2022-05-03,Can Tho City,Cai Rang District,14,13,11,2,0
2022-05-03,Can Tho City,Cai Rang District,15,12,12,0,0
2022-05-03,Can Tho City,Cai Rang District,16,5,4,1,0
2022-05-03,Can Tho City,Cai Rang District,17,6,6,0,0
2022-05-03,Can Tho City,Cai Rang District,18,15,14,1,0
2022-05-03,Can Tho City,Cai Rang District,19,12,10,2,2
2022-05-03,Can Tho City,Cai Rang District,20,4,3,1,0
2022-05-03,Can Tho City,Cai Rang District,21,4,3,1,0
2022-05-03,Can Tho City,Ninh Kieu District,0,3,0,3,0
2022-05-03,Can Tho City,Ninh Kieu District,1,6,4,2,0
2022-05-03,Can Tho City,Ninh Kieu District,2,1,0,1,0
2022-05-03,Can Tho City,Ninh Kieu District,3,5,4,1,0
2022-05-03,Can Tho City,Ninh Kieu District,4,1,0,1,0
2022-05-03,Can Tho City,Ninh Kieu District,5,4,2,2,1
2022-05-03,Can Tho City,Ninh Kieu District,6,42,34,8,5
2022-05-03,Can Tho City,Ninh Kieu District,7,125,117,8,0
2022-05-03,Can Tho City,Ninh Kieu District,8,255,235,20,0
2022-05-03,Can Tho City,Ninh Kieu District,9,303,279,24,0
2022-05-03,Can Tho City,Ninh Kieu District,10,472,457,15,0
2022-05-03,Can Tho City,Ninh Kieu District,11,722,696,26,2
2022-05-03,Can Tho City,Ninh Kieu District,12,558,535,23,0
2022-05-03,Can Tho City,Ninh Kieu District,13,494,465,29,0
2022-05-03,Can Tho City,Ninh Kieu District,14,430,405,25,0
2022-05-03,Can Tho City,Ninh Kieu District,15,438,403,35,1
2022-05-03,Can Tho City,Ninh Kieu District,16,466,449,17,0
2022-05-03,Can Tho City,Ninh Kieu District,17,523,500,23,0
2022-05-03,Can Tho City,Ninh Kieu District,18,597,562,35,0
2022-05-03,Can Tho City,Ninh Kieu District,19,502,471,31,0
2022-05-03,Can Tho City,Ninh Kieu District,20,427,386,41,11
2022-05-03,Can Tho City,Ninh Kieu District,21,172,158,14,1
2022-05-03,Can Tho City,Ninh Kieu District,22,3,1,2,0
2022-05-03,Can Tho City,Ninh Kieu District,23,2,1,1,0
2022-05-03,Dong Nai,Bien Hoa City,1,3,3,0,0
2022-05-03,Dong Nai,Bien Hoa City,5,3,3,0,0
2022-05-03,Dong Nai,Bien Hoa City,6,29,22,7,6
2022-05-03,Dong Nai,Bien Hoa City,7,142,116,26,12
2022-05-03,Dong Nai,Bien Hoa City,8,289,263,26,7
2022-05-03,Dong Nai,Bien Hoa City,9,382,344,38,1
2022-05-03,Dong Nai,Bien Hoa City,10,699,644,55,6
2022-05-03,Dong Nai,Bien Hoa City,11,1067,986,81,14
2022-05-03,Dong Nai,Bien Hoa City,12,935,870,65,15
2022-05-03,Dong Nai,Bien Hoa City,13,818,731,87,23
2022-05-03,Dong Nai,Bien Hoa City,14,713,634,79,26
2022-05-03,Dong Nai,Bien Hoa City,15,621,542,79,20
2022-05-03,Dong Nai,Bien Hoa City,16,555,418,137,82
2022-05-03,Dong Nai,Bien Hoa City,17,845,476,369,287
2022-05-03,Dong Nai,Bien Hoa City,18,1236,495,741,625
2022-05-03,Dong Nai,Bien Hoa City,19,1328,452,876,775
2022-05-03,Dong Nai,Bien Hoa City,20,1064,280,784,689
2022-05-03,Dong Nai,Bien Hoa City,21,510,129,381,311
2022-05-03,Dong Nai,Bien Hoa City,22,8,2,6,0
2022-05-03,Dong Nai,Bien Hoa City,23,5,1,4,1
2022-05-03,Dong Nai,Long Khanh,11,1,0,1,1
2022-05-03,Dong Nai,Long Khanh,17,1,0,1,0
2022-05-03,Dong Nai,Long Thanh,12,3,0,3,2
2022-05-03,Dong Nai,Long Thanh,13,1,0,1,1
2022-05-03,Dong Nai,Long Thanh,14,1,0,1,0
2022-05-03,Dong Nai,Long Thanh,16,2,0,2,2
2022-05-03,Dong Nai,Long Thanh,17,2,0,2,2
2022-05-03,Dong Nai,Nhon trach,12,1,0,1,1
2022-05-03,Dong Nai,Nhon trach,13,1,0,1,1
2022-05-03,Dong Nai,Nhon trach,14,1,0,1,1
2022-05-03,Dong Nai,Nhon trach,20,1,0,1,0
2022-05-03,Dong Nai,Trang Bom,13,2,0,2,2
2022-05-03,Dong Nai,Trang Bom,14,2,0,2,2
2022-05-03,Dong Nai,Trang Bom,15,2,0,2,2
2022-05-03,Dong Nai,Trang Bom,17,3,0,3,3
2022-05-03,Dong Nai,Trang Bom,19,1,0,1,1
2022-05-03,Dong Nai,Trang Bom,20,1,0,1,1
2022-05-03,Dong Nai,Trang Bom,21,1,0,1,0
2022-05-03,Hai Phong City,An Duong,8,2,0,2,2
2022-05-03,Hai Phong City,An Duong,9,4,2,2,2
2022-05-03,Hai Phong City,An Duong,10,2,0,2,2
2022-05-03,Hai Phong City,An Duong,11,6,0,6,6
2022-05-03,Hai Phong City,An Duong,12,3,3,0,0
2022-05-03,Hai Phong City,An Duong,13,9,2,7,5
2022-05-03,Hai Phong City,An Duong,14,2,1,1,0
2022-05-03,Hai Phong City,An Duong,15,1,0,1,1
2022-05-03,Hai Phong City,An Duong,16,2,1,1,0
2022-05-03,Hai Phong City,An Duong,17,5,3,2,0
2022-05-03,Hai Phong City,An Duong,18,4,1,3,2
2022-05-03,Hai Phong City,An Duong,19,7,1,6,5
2022-05-03,Hai Phong City,An Duong,21,2,0,2,2
2022-05-03,Hai Phong City,Duong Kinh District,13,1,0,1,1
2022-05-03,Hai Phong City,Duong Kinh District,15,1,0,1,1
2022-05-03,Hai Phong City,Duong Kinh District,18,1,0,1,0
2022-05-03,Hai Phong City,Hai An District,1,1,0,1,0
2022-05-03,Hai Phong City,Hai An District,7,9,3,6,5
2022-05-03,Hai Phong City,Hai An District,8,12,8,4,2
2022-05-03,Hai Phong City,Hai An District,9,6,5,1,0
2022-05-03,Hai Phong City,Hai An District,10,28,25,3,1
2022-05-03,Hai Phong City,Hai An District,11,43,38,5,1
2022-05-03,Hai Phong City,Hai An District,12,33,29,4,0
2022-05-03,Hai Phong City,Hai An District,13,19,17,2,2
2022-05-03,Hai Phong City,Hai An District,14,12,8,4,2
2022-05-03,Hai Phong City,Hai An District,15,15,12,3,2
2022-05-03,Hai Phong City,Hai An District,16,16,15,1,0
2022-05-03,Hai Phong City,Hai An District,17,23,20,3,1
2022-05-03,Hai Phong City,Hai An District,18,26,20,6,3
2022-05-03,Hai Phong City,Hai An District,19,28,20,8,3
2022-05-03,Hai Phong City,Hai An District,20,12,8,4,1
2022-05-03,Hai Phong City,Hai An District,21,3,1,2,1
2022-05-03,Hai Phong City,Hong Bang District,6,1,1,0,0
2022-05-03,Hai Phong City,Hong Bang District,7,12,10,2,2
2022-05-03,Hai Phong City,Hong Bang District,8,24,19,5,1
2022-05-03,Hai Phong City,Hong Bang District,9,24,18,6,1
2022-05-03,Hai Phong City,Hong Bang District,10,69,57,12,3
2022-05-03,Hai Phong City,Hong Bang District,11,133,106,27,16
2022-05-03,Hai Phong City,Hong Bang District,12,74,66,8,3
2022-05-03,Hai Phong City,Hong Bang District,13,53,47,6,1
2022-05-03,Hai Phong City,Hong Bang District,14,31,28,3,1
2022-05-03,Hai Phong City,Hong Bang District,15,50,45,5,3
2022-05-03,Hai Phong City,Hong Bang District,16,40,36,4,2
2022-05-03,Hai Phong City,Hong Bang District,17,51,45,6,0
2022-05-03,Hai Phong City,Hong Bang District,18,60,50,10,5
2022-05-03,Hai Phong City,Hong Bang District,19,53,43,10,5
2022-05-03,Hai Phong City,Hong Bang District,20,38,31,7,0
2022-05-03,Hai Phong City,Hong Bang District,21,27,15,12,5
2022-05-03,Hai Phong City,Kien An District,7,2,0,2,2
2022-05-03,Hai Phong City,Kien An District,8,4,1,3,3
2022-05-03,Hai Phong City,Kien An District,9,7,5,2,2
2022-05-03,Hai Phong City,Kien An District,10,6,3,3,1
2022-05-03,Hai Phong City,Kien An District,11,17,10,7,6
2022-05-03,Hai Phong City,Kien An District,12,11,6,5,4
2022-05-03,Hai Phong City,Kien An District,13,9,5,4,3
2022-05-03,Hai Phong City,Kien An District,14,11,6,5,5
2022-05-03,Hai Phong City,Kien An District,15,10,4,6,6
2022-05-03,Hai Phong City,Kien An District,16,14,7,7,4
2022-05-03,Hai Phong City,Kien An District,17,6,5,1,1
2022-05-03,Hai Phong City,Kien An District,18,9,9,0,0
2022-05-03,Hai Phong City,Kien An District,19,16,9,7,5
2022-05-03,Hai Phong City,Kien An District,20,6,3,3,3
2022-05-03,Hai Phong City,Kien An District,21,5,1,4,4
2022-05-03,Hai Phong City,Le Chan District,0,2,2,0,0
2022-05-03,Hai Phong City,Le Chan District,7,51,37,14,9
2022-05-03,Hai Phong City,Le Chan District,8,69,55,14,3
2022-05-03,Hai Phong City,Le Chan District,9,112,94,18,0
2022-05-03,Hai Phong City,Le Chan District,10,204,171,33,7
2022-05-03,Hai Phong City,Le Chan District,11,357,291,66,42
2022-05-03,Hai Phong City,Le Chan District,12,223,174,49,20
2022-05-03,Hai Phong City,Le Chan District,13,125,107,18,3
2022-05-03,Hai Phong City,Le Chan District,14,150,123,27,11
2022-05-03,Hai Phong City,Le Chan District,15,158,127,31,14
2022-05-03,Hai Phong City,Le Chan District,16,150,135,15,0
2022-05-03,Hai Phong City,Le Chan District,17,159,142,17,3
2022-05-03,Hai Phong City,Le Chan District,18,248,202,46,15
2022-05-03,Hai Phong City,Le Chan District,19,210,165,45,16
2022-05-03,Hai Phong City,Le Chan District,20,133,115,18,4
2022-05-03,Hai Phong City,Le Chan District,21,90,54,36,23
2022-05-03,Hai Phong City,Le Chan District,22,2,2,0,0
2022-05-03,Hai Phong City,Ngo Quyen District,1,2,1,1,1
2022-05-03,Hai Phong City,Ngo Quyen District,2,1,0,1,1
2022-05-03,Hai Phong City,Ngo Quyen District,3,1,0,1,0
2022-05-03,Hai Phong City,Ngo Quyen District,6,1,0,1,0
2022-05-03,Hai Phong City,Ngo Quyen District,7,35,16,19,10
2022-05-03,Hai Phong City,Ngo Quyen District,8,64,54,10,3
2022-05-03,Hai Phong City,Ngo Quyen District,9,66,58,8,2
2022-05-03,Hai Phong City,Ngo Quyen District,10,140,122,18,2
2022-05-03,Hai Phong City,Ngo Quyen District,11,267,217,50,24
2022-05-03,Hai Phong City,Ngo Quyen District,12,174,152,22,7
2022-05-03,Hai Phong City,Ngo Quyen District,13,131,122,9,4
2022-05-03,Hai Phong City,Ngo Quyen District,14,105,95,10,2
2022-05-03,Hai Phong City,Ngo Quyen District,15,138,119,19,10
2022-05-03,Hai Phong City,Ngo Quyen District,16,117,107,10,1
2022-05-03,Hai Phong City,Ngo Quyen District,17,128,116,12,1
2022-05-03,Hai Phong City,Ngo Quyen District,18,193,173,20,8
2022-05-03,Hai Phong City,Ngo Quyen District,19,138,120,18,7
2022-05-03,Hai Phong City,Ngo Quyen District,20,116,99,17,5
2022-05-03,Hai Phong City,Ngo Quyen District,21,70,46,24,11
2022-05-03,Hai Phong City,Ngo Quyen District,22,1,1,0,0
2022-05-03,Hai Phong City,Thuy Nguyen,10,2,1,1,1
2022-05-03,Hai Phong City,Thuy Nguyen,14,4,0,4,3
2022-05-03,Hai Phong City,Thuy Nguyen,15,2,0,2,2
2022-05-03,Hai Phong City,Thuy Nguyen,16,3,0,3,3
2022-05-03,Hai Phong City,Thuy Nguyen,17,2,0,2,2
2022-05-03,Hai Phong City,Thuy Nguyen,18,4,0,4,4
2022-05-03,Hai Phong City,Thuy Nguyen,19,3,0,3,3
2022-05-03,Hue City,Hue City,0,2,1,1,0
2022-05-03,Hue City,Hue City,5,3,3,0,0
2022-05-03,Hue City,Hue City,6,57,45,12,1
2022-05-03,Hue City,Hue City,7,268,242,26,6
2022-05-03,Hue City,Hue City,8,396,356,40,2
2022-05-03,Hue City,Hue City,9,358,324,34,1
2022-05-03,Hue City,Hue City,10,444,412,32,0
2022-05-03,Hue City,Hue City,11,700,654,46,10
2022-05-03,Hue City,Hue City,12,548,511,37,0
2022-05-03,Hue City,Hue City,13,384,359,25,1
2022-05-03,Hue City,Hue City,14,400,362,38,2
2022-05-03,Hue City,Hue City,15,473,441,32,5
2022-05-03,Hue City,Hue City,16,464,433,31,5
2022-05-03,Hue City,Hue City,17,625,583,42,2
2022-05-03,Hue City,Hue City,18,668,618,50,3
2022-05-03,Hue City,Hue City,19,677,616,61,10
2022-05-03,Hue City,Hue City,20,514,413,101,37
2022-05-03,Hue City,Hue City,21,277,214,63,21
2022-05-03,Hue City,Hue City,22,6,3,3,1
2022-05-03,Hue City,Huong Thuy,7,1,1,0,0
2022-05-03,Hue City,Huong Thuy,8,1,1,0,0
2022-05-03,Hue City,Huong Thuy,9,1,1,0,0
2022-05-03,Hue City,Huong Thuy,12,1,1,0,0
2022-05-03,Hue City,Huong Thuy,13,3,1,2,1
2022-05-03,Hue City,Huong Thuy,15,1,1,0,0
2022-05-03,Hue City,Huong Thuy,17,1,1,0,0
2022-05-03,Hue City,Huong Thuy,18,1,0,1,0
2022-05-03,Hue City,Huong Thuy,19,2,2,0,0
2022-05-03,Hue City,Huong Thuy,21,1,0,1,0
2022-05-03,Hue City,Huong Tra,14,4,2,2,1
2022-05-03,Hue City,Huong Tra,15,1,1,0,0
2022-05-03,Hue City,Huong Tra,16,1,1,0,0
2022-05-03,Hue City,Huong Tra,18,1,1,0,0
2022-05-03,Hue City,Huong Tra,19,1,0,1,0
2022-05-03,Hue City,Phu Vang,6,1,0,1,1
2022-05-03,Hue City,Phu Vang,7,3,2,1,1
2022-05-03,Hue City,Phu Vang,8,2,2,0,0
2022-05-03,Hue City,Phu Vang,9,1,1,0,0
2022-05-03,Hue City,Phu Vang,11,3,2,1,1
2022-05-03,Hue City,Phu Vang,12,2,2,0,0
2022-05-03,Hue City,Phu Vang,13,1,1,0,0
2022-05-03,Hue City,Phu Vang,15,2,2,0,0
2022-05-03,Hue City,Phu Vang,18,6,5,1,0
2022-05-03,Hue City,Phu Vang,19,4,1,3,1
2022-05-03,Hue City,Phu Vang,20,3,2,1,0
2022-05-03,Hue City,Phu Vang,21,1,1,0,0
2022-05-03,Vung Tau,Ba Ria City,7,2,0,2,2
2022-05-03,Vung Tau,Ba Ria City,8,8,4,4,3
2022-05-03,Vung Tau,Ba Ria City,9,3,2,1,1
2022-05-03,Vung Tau,Ba Ria City,10,14,6,8,6
2022-05-03,Vung Tau,Ba Ria City,11,6,4,2,2
2022-05-03,Vung Tau,Ba Ria City,12,6,5,1,0
2022-05-03,Vung Tau,Ba Ria City,13,6,6,0,0
2022-05-03,Vung Tau,Ba Ria City,14,4,1,3,3
2022-05-03,Vung Tau,Ba Ria City,15,6,5,1,1
2022-05-03,Vung Tau,Ba Ria City,16,2,1,1,1
2022-05-03,Vung Tau,Ba Ria City,17,6,6,0,0
2022-05-03,Vung Tau,Ba Ria City,18,6,5,1,1
2022-05-03,Vung Tau,Ba Ria City,19,5,3,2,2
2022-05-03,Vung Tau,Ba Ria City,20,3,0,3,1
2022-05-03,Vung Tau,Vung Tau City,0,2,1,1,0
2022-05-03,Vung Tau,Vung Tau City,1,1,1,0,0
2022-05-03,Vung Tau,Vung Tau City,2,1,1,0,0
2022-05-03,Vung Tau,Vung Tau City,5,1,0,1,1
2022-05-03,Vung Tau,Vung Tau City,6,37,20,17,15
2022-05-03,Vung Tau,Vung Tau City,7,110,95,15,9
2022-05-03,Vung Tau,Vung Tau City,8,162,155,7,0
2022-05-03,Vung Tau,Vung Tau City,9,162,150,12,1
2022-05-03,Vung Tau,Vung Tau City,10,211,200,11,2
2022-05-03,Vung Tau,Vung Tau City,11,346,321,25,4
2022-05-03,Vung Tau,Vung Tau City,12,333,312,21,3
2022-05-03,Vung Tau,Vung Tau City,13,234,208,26,10
2022-05-03,Vung Tau,Vung Tau City,14,231,217,14,0
2022-05-03,Vung Tau,Vung Tau City,15,221,207,14,1
2022-05-03,Vung Tau,Vung Tau City,16,227,218,9,2
2022-05-03,Vung Tau,Vung Tau City,17,280,261,19,1
2022-05-03,Vung Tau,Vung Tau City,18,300,275,25,8
2022-05-03,Vung Tau,Vung Tau City,19,312,267,45,26
2022-05-03,Vung Tau,Vung Tau City,20,230,152,78,54
2022-05-03,Vung Tau,Vung Tau City,21,108,79,29,13
2022-05-03,Vung Tau,Vung Tau City,22,2,0,2,0
2022-05-04,Binh Duong,Ben Cat,9,1,0,1,1
2022-05-04,Binh Duong,Ben Cat,10,2,0,2,2
2022-05-04,Binh Duong,Ben Cat,11,1,0,1,1
2022-05-04,Binh Duong,Ben Cat,13,1,1,0,0
2022-05-04,Binh Duong,Ben Cat,15,2,0,2,2
2022-05-04,Binh Duong,Ben Cat,16,1,0,1,1
2022-05-04,Binh Duong,Ben Cat,20,1,0,1,1
2022-05-04,Binh Duong,Di An,7,5,1,4,2
2022-05-04,Binh Duong,Di An,8,10,7,3,3
2022-05-04,Binh Duong,Di An,9,14,7,7,6
2022-05-04,Binh Duong,Di An,10,23,10,13,11
2022-05-04,Binh Duong,Di An,11,59,16,43,35
2022-05-04,Binh Duong,Di An,12,36,13,23,16
2022-05-04,Binh Duong,Di An,13,30,18,12,9
2022-05-04,Binh Duong,Di An,14,27,11,16,12
2022-05-04,Binh Duong,Di An,15,17,5,12,9
2022-05-04,Binh Duong,Di An,16,18,12,6,5
2022-05-04,Binh Duong,Di An,17,19,16,3,3
2022-05-04,Binh Duong,Di An,18,17,10,7,6
2022-05-04,Binh Duong,Di An,19,21,3,18,17
2022-05-04,Binh Duong,Di An,20,32,9,23,21
2022-05-04,Binh Duong,Di An,21,20,2,18,15
2022-05-04,Binh Duong,Tan Uyen,9,2,1,1,1
2022-05-04,Binh Duong,Tan Uyen,10,1,1,0,0
2022-05-04,Binh Duong,Tan Uyen,11,2,1,1,1
2022-05-04,Binh Duong,Tan Uyen,12,3,2,1,1
2022-05-04,Binh Duong,Tan Uyen,13,1,0,1,0
2022-05-04,Binh Duong,Tan Uyen,14,1,1,0,0
2022-05-04,Binh Duong,Tan Uyen,15,2,1,1,0
2022-05-04,Binh Duong,Tan Uyen,16,2,0,2,2
2022-05-04,Binh Duong,Tan Uyen,17,11,0,11,11
2022-05-04,Binh Duong,Tan Uyen,18,10,3,7,7
2022-05-04,Binh Duong,Tan Uyen,19,2,0,2,2
2022-05-04,Binh Duong,Tan Uyen,20,4,0,4,4
2022-05-04,Binh Duong,Tan Uyen,21,1,0,1,1
2022-05-04,Binh Duong,Thu Dau Mot Town,0,2,2,0,0
2022-05-04,Binh Duong,Thu Dau Mot Town,2,1,0,1,0
2022-05-04,Binh Duong,Thu Dau Mot Town,5,4,3,1,1
2022-05-04,Binh Duong,Thu Dau Mot Town,6,34,21,13,11
2022-05-04,Binh Duong,Thu Dau Mot Town,7,113,101,12,3
2022-05-04,Binh Duong,Thu Dau Mot Town,8,208,189,19,1
2022-05-04,Binh Duong,Thu Dau Mot Town,9,244,220,24,1
2022-05-04,Binh Duong,Thu Dau Mot Town,10,323,303,20,1
2022-05-04,Binh Duong,Thu Dau Mot Town,11,652,597,55,4
2022-05-04,Binh Duong,Thu Dau Mot Town,12,415,386,29,1
2022-05-04,Binh Duong,Thu Dau Mot Town,13,412,386,26,4
2022-05-04,Binh Duong,Thu Dau Mot Town,14,313,293,20,2
2022-05-04,Binh Duong,Thu Dau Mot Town,15,241,230,11,0
2022-05-04,Binh Duong,Thu Dau Mot Town,16,282,269,13,2
2022-05-04,Binh Duong,Thu Dau Mot Town,17,379,343,36,14
2022-05-04,Binh Duong,Thu Dau Mot Town,18,469,338,131,101
2022-05-04,Binh Duong,Thu Dau Mot Town,19,411,261,150,122
2022-05-04,Binh Duong,Thu Dau Mot Town,20,531,219,312,261
2022-05-04,Binh Duong,Thu Dau Mot Town,21,236,112,124,79
2022-05-04,Binh Duong,Thu Dau Mot Town,22,3,2,1,0
2022-05-04,Binh Duong,Thuan An,6,1,1,0,0
2022-05-04,Binh Duong,Thuan An,7,8,0,8,4
2022-05-04,Binh Duong,Thuan An,8,15,10,5,3
2022-05-04,Binh Duong,Thuan An,9,18,15,3,1
2022-05-04,Binh Duong,Thuan An,10,43,33,10,7
2022-05-04,Binh Duong,Thuan An,11,83,41,42,32
2022-05-04,Binh Duong,Thuan An,12,52,39,13,5
2022-05-04,Binh Duong,Thuan An,13,57,37,20,18
2022-05-04,Binh Duong,Thuan An,14,33,23,10,6
2022-05-04,Binh Duong,Thuan An,15,40,20,20,19
2022-05-04,Binh Duong,Thuan An,16,29,20,9,8
2022-05-04,Binh Duong,Thuan An,17,33,29,4,3
2022-05-04,Binh Duong,Thuan An,18,26,14,12,8
2022-05-04,Binh Duong,Thuan An,19,84,22,62,57
2022-05-04,Binh Duong,Thuan An,20,63,15,48,45
2022-05-04,Binh Duong,Thuan An,21,35,11,24,15
2022-05-04,Can Tho City,Binh Thuy District,7,2,2,0,0
2022-05-04,Can Tho City,Binh Thuy District,8,4,4,0,0
2022-05-04,Can Tho City,Binh Thuy District,9,5,5,0,0
2022-05-04,Can Tho City,Binh Thuy District,10,7,6,1,0
2022-05-04,Can Tho City,Binh Thuy District,11,12,11,1,0
2022-05-04,Can Tho City,Binh Thuy District,12,17,14,3,0
2022-05-04,Can Tho City,Binh Thuy District,13,10,9,1,0
2022-05-04,Can Tho City,Binh Thuy District,14,8,8,0,0
2022-05-04,Can Tho City,Binh Thuy District,15,12,10,2,0
2022-05-04,Can Tho City,Binh Thuy District,16,12,11,1,0
2022-05-04,Can Tho City,Binh Thuy District,17,10,7,3,0
2022-05-04,Can Tho City,Binh Thuy District,18,14,11,3,2
2022-05-04,Can Tho City,Binh Thuy District,19,18,13,5,3
2022-05-04,Can Tho City,Binh Thuy District,20,25,17,8,5
2022-05-04,Can Tho City,Binh Thuy District,21,10,4,6,4
2022-05-04,Can Tho City,Cai Rang District,7,3,2,1,1
2022-05-04,Can Tho City,Cai Rang District,8,12,3,9,4
2022-05-04,Can Tho City,Cai Rang District,9,10,7,3,0
2022-05-04,Can Tho City,Cai Rang District,10,6,6,0,0
2022-05-04,Can Tho City,Cai Rang District,11,22,18,4,1
2022-05-04,Can Tho City,Cai Rang District,12,12,11,1,0
2022-05-04,Can Tho City,Cai Rang District,13,10,8,2,1
2022-05-04,Can Tho City,Cai Rang District,14,3,3,0,0
2022-05-04,Can Tho City,Cai Rang District,15,7,7,0,0
2022-05-04,Can Tho City,Cai Rang District,16,2,2,0,0
2022-05-04,Can Tho City,Cai Rang District,17,13,11,2,0
2022-05-04,Can Tho City,Cai Rang District,18,8,6,2,1
2022-05-04,Can Tho City,Cai Rang District,19,13,12,1,0
2022-05-04,Can Tho City,Cai Rang District,20,15,9,6,4
2022-05-04,Can Tho City,Cai Rang District,21,7,4,3,1
2022-05-04,Can Tho City,Ninh Kieu District,0,6,2,4,0
2022-05-04,Can Tho City,Ninh Kieu District,1,2,1,1,0
2022-05-04,Can Tho City,Ninh Kieu District,2,3,2,1,1
2022-05-04,Can Tho City,Ninh Kieu District,3,1,1,0,0
2022-05-04,Can Tho City,Ninh Kieu District,5,2,2,0,0
2022-05-04,Can Tho City,Ninh Kieu District,6,46,41,5,1
2022-05-04,Can Tho City,Ninh Kieu District,7,146,137,9,0
2022-05-04,Can Tho City,Ninh Kieu District,8,218,206,12,0
2022-05-04,Can Tho City,Ninh Kieu District,9,270,257,13,0
2022-05-04,Can Tho City,Ninh Kieu District,10,537,514,23,0
2022-05-04,Can Tho City,Ninh Kieu District,11,823,778,45,1
2022-05-04,Can Tho City,Ninh Kieu District,12,610,583,27,0
2022-05-04,Can Tho City,Ninh Kieu District,13,433,406,27,0
2022-05-04,Can Tho City,Ninh Kieu District,14,415,388,27,0
2022-05-04,Can Tho City,Ninh Kieu District,15,384,359,25,0
2022-05-04,Can Tho City,Ninh Kieu District,16,423,406,17,0
2022-05-04,Can Tho City,Ninh Kieu District,17,518,486,32,0
2022-05-04,Can Tho City,Ninh Kieu District,18,567,517,50,7
2022-05-04,Can Tho City,Ninh Kieu District,19,917,586,331,267
2022-05-04,Can Tho City,Ninh Kieu District,20,921,438,483,397
2022-05-04,Can Tho City,Ninh Kieu District,21,430,242,188,123
2022-05-04,Can Tho City,Ninh Kieu District,22,5,1,4,0
2022-05-04,Can Tho City,Ninh Kieu District,23,1,0,1,0
2022-05-04,Dong Nai,Bien Hoa City,1,2,0,2,0
2022-05-04,Dong Nai,Bien Hoa City,5,3,1,2,1
2022-05-04,Dong Nai,Bien Hoa City,6,42,26,16,12
2022-05-04,Dong Nai,Bien Hoa City,7,150,134,16,3
2022-05-04,Dong Nai,Bien Hoa City,8,245,217,28,8
2022-05-04,Dong Nai,Bien Hoa City,9,392,346,46,12
2022-05-04,Dong Nai,Bien Hoa City,10,691,615,76,24
2022-05-04,Dong Nai,Bien Hoa City,11,1030,936,94,29
2022-05-04,Dong Nai,Bien Hoa City,12,832,761,71,11
2022-05-04,Dong Nai,Bien Hoa City,13,771,685,86,32
2022-05-04,Dong Nai,Bien Hoa City,14,626,518,108,60
2022-05-04,Dong Nai,Bien Hoa City,15,455,415,40,7
2022-05-04,Dong Nai,Bien Hoa City,16,460,419,41,11
2022-05-04,Dong Nai,Bien Hoa City,17,616,541,75,34
2022-05-04,Dong Nai,Bien Hoa City,18,689,478,211,137
2022-05-04,Dong Nai,Bien Hoa City,19,813,352,461,366
2022-05-04,Dong Nai,Bien Hoa City,20,894,304,590,469
2022-05-04,Dong Nai,Bien Hoa City,21,386,136,250,188
2022-05-04,Dong Nai,Bien Hoa City,22,5,1,4,0
2022-05-04,Dong Nai,Bien Hoa City,23,3,2,1,0
2022-05-04,Dong Nai,Long Khanh,17,3,0,3,3
2022-05-04,Dong Nai,Long Khanh,18,3,0,3,2
2022-05-04,Dong Nai,Long Thanh,11,1,0,1,1
2022-05-04,Dong Nai,Long Thanh,14,1,0,1,1
2022-05-04,Dong Nai,Long Thanh,15,1,0,1,1
2022-05-04,Dong Nai,Nhon trach,11,2,0,2,1
2022-05-04,Dong Nai,Nhon trach,12,1,0,1,1
2022-05-04,Dong Nai,Nhon trach,19,2,0,2,2
2022-05-04,Dong Nai,Trang Bom,10,2,0,2,2
2022-05-04,Dong Nai,Trang Bom,11,1,1,0,0
2022-05-04,Dong Nai,Trang Bom,19,2,0,2,2
2022-05-04,Dong Nai,Trang Bom,20,1,0,1,1
2022-05-04,Dong Nai,Vinh Cuu,11,1,0,1,1
2022-05-04,Hai Phong City,An Duong,7,5,1,4,4
2022-05-04,Hai Phong City,An Duong,8,13,2,11,8
2022-05-04,Hai Phong City,An Duong,9,4,2,2,2
2022-05-04,Hai Phong City,An Duong,10,8,3,5,5
2022-05-04,Hai Phong City,An Duong,11,5,3,2,1
2022-05-04,Hai Phong City,An Duong,12,5,2,3,2
2022-05-04,Hai Phong City,An Duong,13,3,1,2,1
2022-05-04,Hai Phong City,An Duong,14,4,1,3,3
2022-05-04,Hai Phong City,An Duong,15,2,0,2,1
2022-05-04,Hai Phong City,An Duong,16,6,3,3,1
2022-05-04,Hai Phong City,An Duong,17,6,4,2,0
2022-05-04,Hai Phong City,An Duong,18,2,0,2,1
2022-05-04,Hai Phong City,An Duong,19,1,0,1,0
2022-05-04,Hai Phong City,An Duong,20,1,0,1,0
2022-05-04,Hai Phong City,An Duong,21,1,0,1,1
2022-05-04,Hai Phong City,Hai An District,7,3,3,0,0
2022-05-04,Hai Phong City,Hai An District,8,17,9,8,5
2022-05-04,Hai Phong City,Hai An District,9,14,7,7,3
2022-05-04,Hai Phong City,Hai An District,10,17,15,2,1
2022-05-04,Hai Phong City,Hai An District,11,56,49,7,4
2022-05-04,Hai Phong City,Hai An District,12,36,33,3,2
2022-05-04,Hai Phong City,Hai An District,13,17,14,3,0
2022-05-04,Hai Phong City,Hai An District,14,25,17,8,5
2022-05-04,Hai Phong City,Hai An District,15,18,13,5,1
2022-05-04,Hai Phong City,Hai An District,16,14,7,7,2
2022-05-04,Hai Phong City,Hai An District,17,12,9,3,2
2022-05-04,Hai Phong City,Hai An District,18,17,14,3,2
2022-05-04,Hai Phong City,Hai An District,19,17,10,7,3
2022-05-04,Hai Phong City,Hai An District,20,19,14,5,2
2022-05-04,Hai Phong City,Hai An District,21,13,9,4,1
2022-05-04,Hai Phong City,Hong Bang District,1,1,1,0,0
2022-05-04,Hai Phong City,Hong Bang District,2,1,0,1,1
2022-05-04,Hai Phong City,Hong Bang District,6,2,1,1,0
2022-05-04,Hai Phong City,Hong Bang District,7,15,12,3,0
2022-05-04,Hai Phong City,Hong Bang District,8,28,23,5,2
2022-05-04,Hai Phong City,Hong Bang District,9,30,27,3,0
2022-05-04,Hai Phong City,Hong Bang District,10,47,43,4,1
2022-05-04,Hai Phong City,Hong Bang District,11,95,85,10,2
2022-05-04,Hai Phong City,Hong Bang District,12,73,61,12,4
2022-05-04,Hai Phong City,Hong Bang District,13,45,28,17,11
2022-05-04,Hai Phong City,Hong Bang District,14,42,23,19,14
2022-05-04,Hai Phong City,Hong Bang District,15,51,44,7,3
2022-05-04,Hai Phong City,Hong Bang District,16,34,30,4,1
2022-05-04,Hai Phong City,Hong Bang District,17,44,38,6,1
2022-05-04,Hai Phong City,Hong Bang District,18,51,44,7,5
2022-05-04,Hai Phong City,Hong Bang District,19,51,46,5,2
2022-05-04,Hai Phong City,Hong Bang District,20,32,26,6,2
2022-05-04,Hai Phong City,Hong Bang District,21,19,12,7,3
2022-05-04,Hai Phong City,Hong Bang District,22,2,1,1,0
2022-05-04,Hai Phong City,Hong Bang District,23,1,0,1,0
2022-05-04,Hai Phong City,Kien An District,8,4,2,2,2
2022-05-04,Hai Phong City,Kien An District,9,4,4,0,0
2022-05-04,Hai Phong City,Kien An District,10,6,5,1,1
2022-05-04,Hai Phong City,Kien An District,11,21,13,8,4
2022-05-04,Hai Phong City,Kien An District,12,4,2,2,1
2022-05-04,Hai Phong City,Kien An District,13,8,6,2,2
2022-05-04,Hai Phong City,Kien An District,14,12,5,7,6
2022-05-04,Hai Phong City,Kien An District,15,6,3,3,2
2022-05-04,Hai Phong City,Kien An District,16,3,3,0,0
2022-05-04,Hai Phong City,Kien An District,17,3,2,1,1
2022-05-04,Hai Phong City,Kien An District,18,3,3,0,0
2022-05-04,Hai Phong City,Kien An District,19,10,7,3,0
2022-05-04,Hai Phong City,Kien An District,20,7,5,2,2
2022-05-04,Hai Phong City,Kien An District,21,7,2,5,5
2022-05-04,Hai Phong City,Kien An District,22,1,1,0,0
2022-05-04,Hai Phong City,Le Chan District,0,2,1,1,0
2022-05-04,Hai Phong City,Le Chan District,1,1,0,1,0
2022-05-04,Hai Phong City,Le Chan District,5,2,0,2,0
2022-05-04,Hai Phong City,Le Chan District,6,1,0,1,0
2022-05-04,Hai Phong City,Le Chan District,7,30,24,6,2
2022-05-04,Hai Phong City,Le Chan District,8,70,52,18,4
2022-05-04,Hai Phong City,Le Chan District,9,67,59,8,0
2022-05-04,Hai Phong City,Le Chan District,10,165,144,21,2
2022-05-04,Hai Phong City,Le Chan District,11,350,285,65,38
2022-05-04,Hai Phong City,Le Chan District,12,216,179,37,12
2022-05-04,Hai Phong City,Le Chan District,13,154,122,32,13
2022-05-04,Hai Phong City,Le Chan District,14,199,139,60,39
2022-05-04,Hai Phong City,Le Chan District,15,179,153,26,12
2022-05-04,Hai Phong City,Le Chan District,16,131,121,10,1
2022-05-04,Hai Phong City,Le Chan District,17,141,125,16,5
2022-05-04,Hai Phong City,Le Chan District,18,193,182,11,2
2022-05-04,Hai Phong City,Le Chan District,19,183,159,24,10
2022-05-04,Hai Phong City,Le Chan District,20,115,102,13,6
2022-05-04,Hai Phong City,Le Chan District,21,63,54,9,1
2022-05-04,Hai Phong City,Le Chan District,22,2,1,1,0
2022-05-04,Hai Phong City,Le Chan District,23,2,0,2,1
2022-05-04,Hai Phong City,Ngo Quyen District,0,2,2,0,0
2022-05-04,Hai Phong City,Ngo Quyen District,1,1,1,0,0
2022-05-04,Hai Phong City,Ngo Quyen District,4,2,1,1,0
2022-05-04,Hai Phong City,Ngo Quyen District,6,1,0,1,0
2022-05-04,Hai Phong City,Ngo Quyen District,7,22,18,4,3
2022-05-04,Hai Phong City,Ngo Quyen District,8,67,56,11,1
2022-05-04,Hai Phong City,Ngo Quyen District,9,81,71,10,1
2022-05-04,Hai Phong City,Ngo Quyen District,10,138,127,11,2
2022-05-04,Hai Phong City,Ngo Quyen District,11,212,184,28,13
2022-05-04,Hai Phong City,Ngo Quyen District,12,151,135,16,4
2022-05-04,Hai Phong City,Ngo Quyen District,13,119,106,13,2
2022-05-04,Hai Phong City,Ngo Quyen District,14,127,109,18,7
2022-05-04,Hai Phong City,Ngo Quyen District,15,113,103,10,1
2022-05-04,Hai Phong City,Ngo Quyen District,16,111,101,10,0
2022-05-04,Hai Phong City,Ngo Quyen District,17,128,108,20,1
2022-05-04,Hai Phong City,Ngo Quyen District,18,140,130,10,2
2022-05-04,Hai Phong City,Ngo Quyen District,19,164,142,22,3
2022-05-04,Hai Phong City,Ngo Quyen District,20,96,89,7,0
2022-05-04,Hai Phong City,Ngo Quyen District,21,49,43,6,0
2022-05-04,Hai Phong City,Thuy Nguyen,9,1,0,1,1
2022-05-04,Hai Phong City,Thuy Nguyen,10,4,0,4,4
2022-05-04,Hai Phong City,Thuy Nguyen,15,1,0,1,1
2022-05-04,Hai Phong City,Thuy Nguyen,16,1,0,1,0
2022-05-04,Hai Phong City,Thuy Nguyen,17,1,0,1,1
2022-05-04,Hai Phong City,Thuy Nguyen,19,2,0,2,1
2022-05-04,Hue City,Hue City,0,4,3,1,0
2022-05-04,Hue City,Hue City,1,4,4,0,0
2022-05-04,Hue City,Hue City,5,3,3,0,0
2022-05-04,Hue City,Hue City,6,68,58,10,3
2022-05-04,Hue City,Hue City,7,172,154,18,1
2022-05-04,Hue City,Hue City,8,269,250,19,1
2022-05-04,Hue City,Hue City,9,228,208,20,0
2022-05-04,Hue City,Hue City,10,330,304,26,0
2022-05-04,Hue City,Hue City,11,764,716,48,3
2022-05-04,Hue City,Hue City,12,487,455,32,1
2022-05-04,Hue City,Hue City,13,315,296,19,0
2022-05-04,Hue City,Hue City,14,333,306,27,3
2022-05-04,Hue City,Hue City,15,337,316,21,2
2022-05-04,Hue City,Hue City,16,335,314,21,2
2022-05-04,Hue City,Hue City,17,554,501,53,1
2022-05-04,Hue City,Hue City,18,574,525,49,1
2022-05-04,Hue City,Hue City,19,617,571,46,0
2022-05-04,Hue City,Hue City,20,504,447,57,9
2022-05-04,Hue City,Hue City,21,272,218,54,15
2022-05-04,Hue City,Hue City,22,1,1,0,0
2022-05-04,Hue City,Hue City,23,3,1,2,1
2022-05-04,Hue City,Huong Thuy,8,1,1,0,0
2022-05-04,Hue City,Huong Thuy,11,1,0,1,0
2022-05-04,Hue City,Huong Thuy,13,1,0,1,0
2022-05-04,Hue City,Huong Thuy,17,3,3,0,0
2022-05-04,Hue City,Huong Thuy,18,2,1,1,0
2022-05-04,Hue City,Huong Thuy,19,1,0,1,1
2022-05-04,Hue City,Huong Thuy,20,3,1,2,1
2022-05-04,Hue City,Huong Tra,11,1,0,1,0
2022-05-04,Hue City,Phu Vang,9,2,1,1,1
2022-05-04,Hue City,Phu Vang,10,1,0,1,1
2022-05-04,Hue City,Phu Vang,11,2,2,0,0
2022-05-04,Hue City,Phu Vang,12,2,2,0,0
2022-05-04,Hue City,Phu Vang,13,2,2,0,0
2022-05-04,Hue City,Phu Vang,15,1,1,0,0
2022-05-04,Hue City,Phu Vang,16,1,1,0,0
2022-05-04,Hue City,Phu Vang,17,1,1,0,0
2022-05-04,Hue City,Phu Vang,18,4,4,0,0
2022-05-04,Hue City,Phu Vang,20,1,1,0,0
2022-05-04,Hue City,Phu Vang,21,1,0,1,0
2022-05-04,Vung Tau,Ba Ria City,8,4,2,2,1
2022-05-04,Vung Tau,Ba Ria City,9,7,4,3,3
2022-05-04,Vung Tau,Ba Ria City,10,1,0,1,0
2022-05-04,Vung Tau,Ba Ria City,11,7,4,3,1
2022-05-04,Vung Tau,Ba Ria City,12,7,3,4,2
2022-05-04,Vung Tau,Ba Ria City,13,4,2,2,2
2022-05-04,Vung Tau,Ba Ria City,14,5,2,3,2
2022-05-04,Vung Tau,Ba Ria City,15,4,1,3,3
2022-05-04,Vung Tau,Ba Ria City,16,10,4,6,5
2022-05-04,Vung Tau,Ba Ria City,17,10,5,5,5
2022-05-04,Vung Tau,Ba Ria City,18,5,1,4,4
2022-05-04,Vung Tau,Ba Ria City,19,2,0,2,2
2022-05-04,Vung Tau,Ba Ria City,20,3,0,3,3
2022-05-04,Vung Tau,Ba Ria City,21,2,0,2,2
2022-05-04,Vung Tau,Vung Tau City,0,1,0,1,1
2022-05-04,Vung Tau,Vung Tau City,1,1,0,1,0
2022-05-04,Vung Tau,Vung Tau City,6,39,31,8,5
2022-05-04,Vung Tau,Vung Tau City,7,82,76,6,0
2022-05-04,Vung Tau,Vung Tau City,8,132,117,15,3
2022-05-04,Vung Tau,Vung Tau City,9,134,124,10,1
2022-05-04,Vung Tau,Vung Tau City,10,169,153,16,2
2022-05-04,Vung Tau,Vung Tau City,11,326,302,24,2
2022-05-04,Vung Tau,Vung Tau City,12,259,245,14,3
2022-05-04,Vung Tau,Vung Tau City,13,187,175,12,2
2022-05-04,Vung Tau,Vung Tau City,14,215,195,20,4
2022-05-04,Vung Tau,Vung Tau City,15,195,179,16,5
2022-05-04,Vung Tau,Vung Tau City,16,158,144,14,0
2022-05-04,Vung Tau,Vung Tau City,17,259,240,19,6
2022-05-04,Vung Tau,Vung Tau City,18,277,251,26,8
2022-05-04,Vung Tau,Vung Tau City,19,228,199,29,4
2022-05-04,Vung Tau,Vung Tau City,20,187,150,37,14
2022-05-04,Vung Tau,Vung Tau City,21,94,63,31,17
2022-05-04,Vung Tau,Vung Tau City,22,1,1,0,0
2022-05-05,Binh Duong,Ben Cat,8,2,0,2,1
2022-05-05,Binh Duong,Ben Cat,9,6,1,5,3
2022-05-05,Binh Duong,Ben Cat,11,3,0,3,3
2022-05-05,Binh Duong,Ben Cat,12,1,0,1,1
2022-05-05,Binh Duong,Ben Cat,13,4,0,4,3
2022-05-05,Binh Duong,Ben Cat,14,3,0,3,2
2022-05-05,Binh Duong,Ben Cat,17,1,0,1,1
2022-05-05,Binh Duong,Di An,7,11,2,9,8
2022-05-05,Binh Duong,Di An,8,16,7,9,4
2022-05-05,Binh Duong,Di An,9,18,12,6,2
2022-05-05,Binh Duong,Di An,10,28,15,13,11
2022-05-05,Binh Duong,Di An,11,55,21,34,28
2022-05-05,Binh Duong,Di An,12,50,29,21,17
2022-05-05,Binh Duong,Di An,13,55,24,31,24
2022-05-05,Binh Duong,Di An,14,33,24,9,8
2022-05-05,Binh Duong,Di An,15,31,19,12,7
2022-05-05,Binh Duong,Di An,16,31,18,13,11
2022-05-05,Binh Duong,Di An,17,36,16,20,18
2022-05-05,Binh Duong,Di An,18,45,25,20,16
2022-05-05,Binh Duong,Di An,19,20,10,10,8
2022-05-05,Binh Duong,Di An,20,22,14,8,6
2022-05-05,Binh Duong,Di An,21,9,4,5,4
2022-05-05,Binh Duong,Di An,22,3,0,3,1
2022-05-05,Binh Duong,Tan Uyen,7,1,0,1,1
2022-05-05,Binh Duong,Tan Uyen,9,1,1,0,0
2022-05-05,Binh Duong,Tan Uyen,10,7,5,2,1
2022-05-05,Binh Duong,Tan Uyen,11,5,4,1,0
2022-05-05,Binh Duong,Tan Uyen,12,4,1,3,3
2022-05-05,Binh Duong,Tan Uyen,13,8,2,6,5
2022-05-05,Binh Duong,Tan Uyen,14,2,1,1,1
2022-05-05,Binh Duong,Tan Uyen,15,7,3,4,3
2022-05-05,Binh Duong,Tan Uyen,17,4,1,3,2
2022-05-05,Binh Duong,Tan Uyen,18,9,4,5,2
2022-05-05,Binh Duong,Tan Uyen,19,2,1,1,1
2022-05-05,Binh Duong,Thu Dau Mot Town,0,1,1,0,0
2022-05-05,Binh Duong,Thu Dau Mot Town,1,3,2,1,0
2022-05-05,Binh Duong,Thu Dau Mot Town,5,1,1,0,0
2022-05-05,Binh Duong,Thu Dau Mot Town,6,36,28,8,7
2022-05-05,Binh Duong,Thu Dau Mot Town,7,121,113,8,0
2022-05-05,Binh Duong,Thu Dau Mot Town,8,199,182,17,0
2022-05-05,Binh Duong,Thu Dau Mot Town,9,274,249,25,2
2022-05-05,Binh Duong,Thu Dau Mot Town,10,374,349,25,4
2022-05-05,Binh Duong,Thu Dau Mot Town,11,646,611,35,7
2022-05-05,Binh Duong,Thu Dau Mot Town,12,513,478,35,2
2022-05-05,Binh Duong,Thu Dau Mot Town,13,476,448,28,2
2022-05-05,Binh Duong,Thu Dau Mot Town,14,382,361,21,1
2022-05-05,Binh Duong,Thu Dau Mot Town,15,315,300,15,1
2022-05-05,Binh Duong,Thu Dau Mot Town,16,368,340,28,8
2022-05-05,Binh Duong,Thu Dau Mot Town,17,433,366,67,27
2022-05-05,Binh Duong,Thu Dau Mot Town,18,566,478,88,33
2022-05-05,Binh Duong,Thu Dau Mot Town,19,414,387,27,6
2022-05-05,Binh Duong,Thu Dau Mot Town,20,310,286,24,0
2022-05-05,Binh Duong,Thu Dau Mot Town,21,135,114,21,4
2022-05-05,Binh Duong,Thu Dau Mot Town,22,1,1,0,0
2022-05-05,Binh Duong,Thu Dau Mot Town,23,1,0,1,1
2022-05-05,Binh Duong,Thuan An,0,1,0,1,1
2022-05-05,Binh Duong,Thuan An,1,1,1,0,0
2022-05-05,Binh Duong,Thuan An,6,4,0,4,3
2022-05-05,Binh Duong,Thuan An,7,10,2,8,6
2022-05-05,Binh Duong,Thuan An,8,20,13,7,2
2022-05-05,Binh Duong,Thuan An,9,33,29,4,1
2022-05-05,Binh Duong,Thuan An,10,73,53,20,13
2022-05-05,Binh Duong,Thuan An,11,76,55,21,13
2022-05-05,Binh Duong,Thuan An,12,78,57,21,11
2022-05-05,Binh Duong,Thuan An,13,55,45,10,6
2022-05-05,Binh Duong,Thuan An,14,50,38,12,6
2022-05-05,Binh Duong,Thuan An,15,48,38,10,7
2022-05-05,Binh Duong,Thuan An,16,48,28,20,16
2022-05-05,Binh Duong,Thuan An,17,44,28,16,13
2022-05-05,Binh Duong,Thuan An,18,39,23,16,15
2022-05-05,Binh Duong,Thuan An,19,48,32,16,11
2022-05-05,Binh Duong,Thuan An,20,42,27,15,11
2022-05-05,Binh Duong,Thuan An,21,18,7,11,7
2022-05-05,Binh Duong,Thuan An,22,3,1,2,0
2022-05-05,Can Tho City,Binh Thuy District,0,2,1,1,0
2022-05-05,Can Tho City,Binh Thuy District,6,1,1,0,0
2022-05-05,Can Tho City,Binh Thuy District,8,4,4,0,0
2022-05-05,Can Tho City,Binh Thuy District,9,13,13,0,0
2022-05-05,Can Tho City,Binh Thuy District,10,9,8,1,1
2022-05-05,Can Tho City,Binh Thuy District,11,11,7,4,0
2022-05-05,Can Tho City,Binh Thuy District,12,12,11,1,0
2022-05-05,Can Tho City,Binh Thuy District,13,15,11,4,0
2022-05-05,Can Tho City,Binh Thuy District,14,12,11,1,0
2022-05-05,Can Tho City,Binh Thuy District,15,15,13,2,0
2022-05-05,Can Tho City,Binh Thuy District,16,19,18,1,0
2022-05-05,Can Tho City,Binh Thuy District,17,19,19,0,0
2022-05-05,Can Tho City,Binh Thuy District,18,22,19,3,0
2022-05-05,Can Tho City,Binh Thuy District,19,20,19,1,0
2022-05-05,Can Tho City,Binh Thuy District,20,11,9,2,0
2022-05-05,Can Tho City,Binh Thuy District,21,3,1,2,0
2022-05-05,Can Tho City,Cai Rang District,0,2,1,1,1
2022-05-05,Can Tho City,Cai Rang District,6,1,0,1,1
2022-05-05,Can Tho City,Cai Rang District,7,3,1,2,0
2022-05-05,Can Tho City,Cai Rang District,8,4,4,0,0
2022-05-05,Can Tho City,Cai Rang District,9,12,11,1,0
2022-05-05,Can Tho City,Cai Rang District,10,17,13,4,0
2022-05-05,Can Tho City,Cai Rang District,11,11,9,2,1
2022-05-05,Can Tho City,Cai Rang District,12,10,10,0,0
2022-05-05,Can Tho City,Cai Rang District,13,8,6,2,0
2022-05-05,Can Tho City,Cai Rang District,14,15,13,2,1
2022-05-05,Can Tho City,Cai Rang District,15,14,12,2,1
2022-05-05,Can Tho City,Cai Rang District,16,12,11,1,1
2022-05-05,Can Tho City,Cai Rang District,17,8,8,0,0
2022-05-05,Can Tho City,Cai Rang District,18,16,13,3,1
2022-05-05,Can Tho City,Cai Rang District,19,9,8,1,0
2022-05-05,Can Tho City,Cai Rang District,20,11,10,1,0
2022-05-05,Can Tho City,Cai Rang District,21,4,3,1,1
2022-05-05,Can Tho City,Ninh Kieu District,0,14,12,2,0
2022-05-05,Can Tho City,Ninh Kieu District,1,5,2,3,0
2022-05-05,Can Tho City,Ninh Kieu District,2,1,1,0,0
2022-05-05,Can Tho City,Ninh Kieu District,3,3,2,1,0
2022-05-05,Can Tho City,Ninh Kieu District,5,8,4,4,2
2022-05-05,Can Tho City,Ninh Kieu District,6,57,46,11,3
2022-05-05,Can Tho City,Ninh Kieu District,7,171,156,15,0
2022-05-05,Can Tho City,Ninh Kieu District,8,277,257,20,0
2022-05-05,Can Tho City,Ninh Kieu District,9,364,344,20,0
2022-05-05,Can Tho City,Ninh Kieu District,10,733,695,38,0
2022-05-05,Can Tho City,Ninh Kieu District,11,1019,955,64,2
2022-05-05,Can Tho City,Ninh Kieu District,12,750,711,39,0
2022-05-05,Can Tho City,Ninh Kieu District,13,611,580,31,1
2022-05-05,Can Tho City,Ninh Kieu District,14,586,547,39,1
2022-05-05,Can Tho City,Ninh Kieu District,15,546,517,29,0
2022-05-05,Can Tho City,Ninh Kieu District,16,574,550,24,1
2022-05-05,Can Tho City,Ninh Kieu District,17,708,684,24,0
2022-05-05,Can Tho City,Ninh Kieu District,18,692,665,27,0
2022-05-05,Can Tho City,Ninh Kieu District,19,550,511,39,0
2022-05-05,Can Tho City,Ninh Kieu District,20,449,414,35,1
2022-05-05,Can Tho City,Ninh Kieu District,21,296,257,39,2
2022-05-05,Can Tho City,Ninh Kieu District,22,6,3,3,0
2022-05-05,Can Tho City,Ninh Kieu District,23,4,1,3,0
2022-05-05,Dong Nai,Bien Hoa City,0,4,2,2,2
2022-05-05,Dong Nai,Bien Hoa City,1,3,2,1,0
2022-05-05,Dong Nai,Bien Hoa City,2,3,0,3,0
2022-05-05,Dong Nai,Bien Hoa City,3,1,0,1,0
2022-05-05,Dong Nai,Bien Hoa City,4,2,1,1,0
2022-05-05,Dong Nai,Bien Hoa City,5,1,1,0,0
2022-05-05,Dong Nai,Bien Hoa City,6,45,27,18,14
2022-05-05,Dong Nai,Bien Hoa City,7,154,126,28,12
2022-05-05,Dong Nai,Bien Hoa City,8,285,254,31,11
2022-05-05,Dong Nai,Bien Hoa City,9,390,341,49,6
2022-05-05,Dong Nai,Bien Hoa City,10,821,735,86,20
2022-05-05,Dong Nai,Bien Hoa City,11,1158,1033,125,39
2022-05-05,Dong Nai,Bien Hoa City,12,911,829,82,15
2022-05-05,Dong Nai,Bien Hoa City,13,846,792,54,14
2022-05-05,Dong Nai,Bien Hoa City,14,711,640,71,13
2022-05-05,Dong Nai,Bien Hoa City,15,604,516,88,52
2022-05-05,Dong Nai,Bien Hoa City,16,647,541,106,55
2022-05-05,Dong Nai,Bien Hoa City,17,752,649,103,57
2022-05-05,Dong Nai,Bien Hoa City,18,745,671,74,18
2022-05-05,Dong Nai,Bien Hoa City,19,693,629,64,12
2022-05-05,Dong Nai,Bien Hoa City,20,505,425,80,23
2022-05-05,Dong Nai,Bien Hoa City,21,232,170,62,18
2022-05-05,Dong Nai,Bien Hoa City,22,8,2,6,2
2022-05-05,Dong Nai,Bien Hoa City,23,6,1,5,1
2022-05-05,Dong Nai,Long Khanh,7,1,0,1,1
2022-05-05,Dong Nai,Long Khanh,10,1,0,1,1
2022-05-05,Dong Nai,Long Khanh,11,2,0,2,2
2022-05-05,Dong Nai,Long Khanh,15,1,0,1,1
2022-05-05,Dong Nai,Long Thanh,9,1,0,1,1
2022-05-05,Dong Nai,Long Thanh,10,2,0,2,2
2022-05-05,Dong Nai,Long Thanh,11,1,0,1,1
2022-05-05,Dong Nai,Long Thanh,12,1,0,1,1
2022-05-05,Dong Nai,Long Thanh,13,1,0,1,1
2022-05-05,Dong Nai,Long Thanh,14,2,0,2,2
2022-05-05,Dong Nai,Long Thanh,15,1,0,1,1
2022-05-05,Dong Nai,Long Thanh,16,2,0,2,2
2022-05-05,Dong Nai,Long Thanh,19,2,0,2,2
2022-05-05,Dong Nai,Long Thanh,20,3,0,3,3
2022-05-05,Dong Nai,Nhon trach,16,1,0,1,0
2022-05-05,Dong Nai,Nhon trach,18,4,0,4,1
2022-05-05,Dong Nai,Nhon trach,19,3,0,3,3
2022-05-05,Dong Nai,Nhon trach,20,1,0,1,1
2022-05-05,Dong Nai,Trang Bom,10,1,0,1,0
2022-05-05,Dong Nai,Trang Bom,11,2,0,2,1
2022-05-05,Dong Nai,Trang Bom,12,2,0,2,2
2022-05-05,Dong Nai,Trang Bom,13,1,0,1,1
2022-05-05,Hai Phong City,An Duong,0,1,1,0,0
2022-05-05,Hai Phong City,An Duong,7,2,0,2,2
2022-05-05,Hai Phong City,An Duong,8,4,1,3,3
2022-05-05,Hai Phong City,An Duong,9,1,0,1,1
2022-05-05,Hai Phong City,An Duong,10,9,7,2,2
2022-05-05,Hai Phong City,An Duong,11,2,0,2,2
2022-05-05,Hai Phong City,An Duong,12,3,3,0,0
2022-05-05,Hai Phong City,An Duong,13,7,4,3,3
2022-05-05,Hai Phong City,An Duong,14,2,0,2,2
2022-05-05,Hai Phong City,An Duong,15,12,5,7,5
2022-05-05,Hai Phong City,An Duong,16,4,1,3,2
2022-05-05,Hai Phong City,An Duong,17,4,4,0,0
2022-05-05,Hai Phong City,An Duong,18,1,0,1,0
2022-05-05,Hai Phong City,An Duong,19,1,0,1,1
2022-05-05,Hai Phong City,An Duong,20,3,0,3,2
2022-05-05,Hai Phong City,Do Son District,14,1,0,1,1
2022-05-05,Hai Phong City,Duong Kinh District,11,1,0,1,1
2022-05-05,Hai Phong City,Duong Kinh District,17,1,0,1,1
2022-05-05,Hai Phong City,Duong Kinh District,18,1,1,0,0
2022-05-05,Hai Phong City,Hai An District,0,2,0,2,0
2022-05-05,Hai Phong City,Hai An District,1,1,1,0,0
2022-05-05,Hai Phong City,Hai An District,6,2,2,0,0
2022-05-05,Hai Phong City,Hai An District,7,7,2,5,5
2022-05-05,Hai Phong City,Hai An District,8,14,12,2,2
2022-05-05,Hai Phong City,Hai An District,9,15,12,3,1
2022-05-05,Hai Phong City,Hai An District,10,27,23,4,2
2022-05-05,Hai Phong City,Hai An District,11,59,49,10,4
2022-05-05,Hai Phong City,Hai An District,12,36,33,3,1
2022-05-05,Hai Phong City,Hai An District,13,16,13,3,1
2022-05-05,Hai Phong City,Hai An District,14,32,17,15,10
2022-05-05,Hai Phong City,Hai An District,15,28,21,7,3
2022-05-05,Hai Phong City,Hai An District,16,31,26,5,1
2022-05-05,Hai Phong City,Hai An District,17,24,23,1,0
2022-05-05,Hai Phong City,Hai An District,18,20,15,5,1
2022-05-05,Hai Phong City,Hai An District,19,13,10,3,0
2022-05-05,Hai Phong City,Hai An District,20,21,17,4,0
2022-05-05,Hai Phong City,Hai An District,21,8,6,2,2
2022-05-05,Hai Phong City,Hai An District,22,1,1,0,0
2022-05-05,Hai Phong City,Hong Bang District,2,2,0,2,0
2022-05-05,Hai Phong City,Hong Bang District,7,20,17,3,3
2022-05-05,Hai Phong City,Hong Bang District,8,44,36,8,5
2022-05-05,Hai Phong City,Hong Bang District,9,31,27,4,0
2022-05-05,Hai Phong City,Hong Bang District,10,75,61,14,4
2022-05-05,Hai Phong City,Hong Bang District,11,114,100,14,4
2022-05-05,Hai Phong City,Hong Bang District,12,70,61,9,3
2022-05-05,Hai Phong City,Hong Bang District,13,63,52,11,3
2022-05-05,Hai Phong City,Hong Bang District,14,74,65,9,7
2022-05-05,Hai Phong City,Hong Bang District,15,39,29,10,3
2022-05-05,Hai Phong City,Hong Bang District,16,49,43,6,3
2022-05-05,Hai Phong City,Hong Bang District,17,63,60,3,1
2022-05-05,Hai Phong City,Hong Bang District,18,61,55,6,1
2022-05-05,Hai Phong City,Hong Bang District,19,63,60,3,1
2022-05-05,Hai Phong City,Hong Bang District,20,48,40,8,3
2022-05-05,Hai Phong City,Hong Bang District,21,17,12,5,3
2022-05-05,Hai Phong City,Kien An District,1,1,0,1,1
2022-05-05,Hai Phong City,Kien An District,7,1,0,1,1
2022-05-05,Hai Phong City,Kien An District,8,12,8,4,1
2022-05-05,Hai Phong City,Kien An District,9,5,4,1,0
2022-05-05,Hai Phong City,Kien An District,10,16,13,3,2
2022-05-05,Hai Phong City,Kien An District,11,20,17,3,0
2022-05-05,Hai Phong City,Kien An District,12,12,7,5,2
2022-05-05,Hai Phong City,Kien An District,13,19,11,8,5
2022-05-05,Hai Phong City,Kien An District,14,12,7,5,4
2022-05-05,Hai Phong City,Kien An District,15,12,7,5,3
2022-05-05,Hai Phong City,Kien An District,16,4,3,1,0
2022-05-05,Hai Phong City,Kien An District,17,15,12,3,1
2022-05-05,Hai Phong City,Kien An District,18,18,11,7,4
2022-05-05,Hai Phong City,Kien An District,19,12,9,3,0
2022-05-05,Hai Phong City,Kien An District,20,9,5,4,2
2022-05-05,Hai Phong City,Kien An District,21,3,1,2,1
2022-05-05,Hai Phong City,Le Chan District,1,1,1,0,0
2022-05-05,Hai Phong City,Le Chan District,4,1,1,0,0
2022-05-05,Hai Phong City,Le Chan District,5,1,0,1,1
2022-05-05,Hai Phong City,Le Chan District,6,2,1,1,0
2022-05-05,Hai Phong City,Le Chan District,7,41,40,1,0
2022-05-05,Hai Phong City,Le Chan District,8,68,57,11,4
2022-05-05,Hai Phong City,Le Chan District,9,88,72,16,3
2022-05-05,Hai Phong City,Le Chan District,10,215,184,31,6
2022-05-05,Hai Phong City,Le Chan District,11,361,311,50,15
2022-05-05,Hai Phong City,Le Chan District,12,215,191,24,3
2022-05-05,Hai Phong City,Le Chan District,13,172,148,24,9
2022-05-05,Hai Phong City,Le Chan District,14,177,144,33,22
2022-05-05,Hai Phong City,Le Chan District,15,180,155,25,3
2022-05-05,Hai Phong City,Le Chan District,16,220,191,29,11
2022-05-05,Hai Phong City,Le Chan District,17,206,181,25,4
2022-05-05,Hai Phong City,Le Chan District,18,252,229,23,1
2022-05-05,Hai Phong City,Le Chan District,19,211,185,26,4
2022-05-05,Hai Phong City,Le Chan District,20,158,144,14,1
2022-05-05,Hai Phong City,Le Chan District,21,93,74,19,8
2022-05-05,Hai Phong City,Le Chan District,22,3,1,2,0
2022-05-05,Hai Phong City,Le Chan District,23,1,1,0,0
2022-05-05,Hai Phong City,Ngo Quyen District,0,2,2,0,0
2022-05-05,Hai Phong City,Ngo Quyen District,6,1,1,0,0
2022-05-05,Hai Phong City,Ngo Quyen District,7,24,17,7,5
2022-05-05,Hai Phong City,Ngo Quyen District,8,75,64,11,9
2022-05-05,Hai Phong City,Ngo Quyen District,9,82,70,12,1
2022-05-05,Hai Phong City,Ngo Quyen District,10,178,159,19,0
2022-05-05,Hai Phong City,Ngo Quyen District,11,256,214,42,9
2022-05-05,Hai Phong City,Ngo Quyen District,12,180,168,12,1
2022-05-05,Hai Phong City,Ngo Quyen District,13,151,134,17,3
2022-05-05,Hai Phong City,Ngo Quyen District,14,182,149,33,14
2022-05-05,Hai Phong City,Ngo Quyen District,15,107,97,10,5
2022-05-05,Hai Phong City,Ngo Quyen District,16,184,165,19,3
2022-05-05,Hai Phong City,Ngo Quyen District,17,131,118,13,3
2022-05-05,Hai Phong City,Ngo Quyen District,18,164,144,20,1
2022-05-05,Hai Phong City,Ngo Quyen District,19,223,199,24,4
2022-05-05,Hai Phong City,Ngo Quyen District,20,116,94,22,7
2022-05-05,Hai Phong City,Ngo Quyen District,21,62,53,9,1
2022-05-05,Hai Phong City,Ngo Quyen District,23,1,1,0,0
2022-05-05,Hai Phong City,Thuy Nguyen,11,3,0,3,2
2022-05-05,Hai Phong City,Thuy Nguyen,12,1,0,1,0
2022-05-05,Hai Phong City,Thuy Nguyen,13,1,0,1,1
2022-05-05,Hai Phong City,Thuy Nguyen,14,2,0,2,2
2022-05-05,Hai Phong City,Thuy Nguyen,15,1,0,1,1
2022-05-05,Hai Phong City,Thuy Nguyen,17,1,0,1,1
2022-05-05,Hai Phong City,Thuy Nguyen,18,1,0,1,1
2022-05-05,Hue City,Hue City,0,19,13,6,2
2022-05-05,Hue City,Hue City,1,7,4,3,1
2022-05-05,Hue City,Hue City,2,1,1,0,0
2022-05-05,Hue City,Hue City,3,1,1,0,0
2022-05-05,Hue City,Hue City,5,6,4,2,0
2022-05-05,Hue City,Hue City,6,68,53,15,4
2022-05-05,Hue City,Hue City,7,165,155,10,1
2022-05-05,Hue City,Hue City,8,271,258,13,2
2022-05-05,Hue City,Hue City,9,266,240,26,2
2022-05-05,Hue City,Hue City,10,481,446,35,0
2022-05-05,Hue City,Hue City,11,868,821,47,3
2022-05-05,Hue City,Hue City,12,572,532,40,3
2022-05-05,Hue City,Hue City,13,455,417,38,1
2022-05-05,Hue City,Hue City,14,408,362,46,1
2022-05-05,Hue City,Hue City,15,457,424,33,4
2022-05-05,Hue City,Hue City,16,503,467,36,3
2022-05-05,Hue City,Hue City,17,598,555,43,1
2022-05-05,Hue City,Hue City,18,705,658,47,1
2022-05-05,Hue City,Hue City,19,708,657,51,1
2022-05-05,Hue City,Hue City,20,506,472,34,2
2022-05-05,Hue City,Hue City,21,307,239,68,4
2022-05-05,Hue City,Hue City,22,6,1,5,0
2022-05-05,Hue City,Huong Thuy,0,3,0,3,0
2022-05-05,Hue City,Huong Thuy,6,1,1,0,0
2022-05-05,Hue City,Huong Thuy,9,1,0,1,0
2022-05-05,Hue City,Huong Thuy,12,1,1,0,0
2022-05-05,Hue City,Huong Thuy,15,1,1,0,0
2022-05-05,Hue City,Huong Thuy,17,2,2,0,0
2022-05-05,Hue City,Huong Thuy,18,1,0,1,1
2022-05-05,Hue City,Huong Tra,8,1,0,1,0
2022-05-05,Hue City,Huong Tra,11,1,1,0,0
2022-05-05,Hue City,Huong Tra,12,1,1,0,0
2022-05-05,Hue City,Phu Vang,7,1,1,0,0
2022-05-05,Hue City,Phu Vang,12,4,3,1,1
2022-05-05,Hue City,Phu Vang,13,2,1,1,1
2022-05-05,Hue City,Phu Vang,14,1,1,0,0
2022-05-05,Hue City,Phu Vang,15,2,2,0,0
2022-05-05,Hue City,Phu Vang,16,1,1,0,0
2022-05-05,Hue City,Phu Vang,17,2,2,0,0
2022-05-05,Hue City,Phu Vang,18,2,2,0,0
2022-05-05,Hue City,Phu Vang,19,1,1,0,0
2022-05-05,Hue City,Phu Vang,20,1,1,0,0
2022-05-05,Hue City,Phu Vang,21,6,3,3,0
2022-05-05,Vung Tau,Ba Ria City,7,2,0,2,2
2022-05-05,Vung Tau,Ba Ria City,8,10,3,7,7
2022-05-05,Vung Tau,Ba Ria City,9,1,1,0,0
2022-05-05,Vung Tau,Ba Ria City,10,7,7,0,0
2022-05-05,Vung Tau,Ba Ria City,11,12,9,3,2
2022-05-05,Vung Tau,Ba Ria City,12,9,6,3,2
2022-05-05,Vung Tau,Ba Ria City,13,9,6,3,1
2022-05-05,Vung Tau,Ba Ria City,14,10,6,4,3
2022-05-05,Vung Tau,Ba Ria City,15,18,6,12,10
2022-05-05,Vung Tau,Ba Ria City,16,8,6,2,2
2022-05-05,Vung Tau,Ba Ria City,17,7,6,1,0
2022-05-05,Vung Tau,Ba Ria City,18,5,3,2,2
2022-05-05,Vung Tau,Ba Ria City,19,5,1,4,4
2022-05-05,Vung Tau,Ba Ria City,20,3,0,3,3
2022-05-05,Vung Tau,Ba Ria City,21,2,0,2,2
2022-05-05,Vung Tau,Vung Tau City,0,4,1,3,1
2022-05-05,Vung Tau,Vung Tau City,1,1,1,0,0
2022-05-05,Vung Tau,Vung Tau City,4,1,1,0,0
2022-05-05,Vung Tau,Vung Tau City,5,2,1,1,1
2022-05-05,Vung Tau,Vung Tau City,6,23,19,4,3
2022-05-05,Vung Tau,Vung Tau City,7,85,84,1,0
2022-05-05,Vung Tau,Vung Tau City,8,129,109,20,10
2022-05-05,Vung Tau,Vung Tau City,9,143,132,11,1
2022-05-05,Vung Tau,Vung Tau City,10,215,201,14,0
2022-05-05,Vung Tau,Vung Tau City,11,312,293,19,2
2022-05-05,Vung Tau,Vung Tau City,12,297,277,20,2
2022-05-05,Vung Tau,Vung Tau City,13,228,211,17,3
2022-05-05,Vung Tau,Vung Tau City,14,252,229,23,2
2022-05-05,Vung Tau,Vung Tau City,15,224,211,13,0
2022-05-05,Vung Tau,Vung Tau City,16,197,171,26,5
2022-05-05,Vung Tau,Vung Tau City,17,271,254,17,4
2022-05-05,Vung Tau,Vung Tau City,18,314,284,30,3
2022-05-05,Vung Tau,Vung Tau City,19,287,262,25,9
2022-05-05,Vung Tau,Vung Tau City,20,226,170,56,31
2022-05-05,Vung Tau,Vung Tau City,21,133,73,60,42
2022-05-05,Vung Tau,Vung Tau City,22,3,1,2,0
2022-05-05,Vung Tau,Vung Tau City,23,1,1,0,0
2022-05-06,Binh Duong,Ben Cat,9,1,0,1,1
2022-05-06,Binh Duong,Ben Cat,10,3,0,3,3
2022-05-06,Binh Duong,Ben Cat,11,1,0,1,1
2022-05-06,Binh Duong,Ben Cat,14,2,0,2,2
2022-05-06,Binh Duong,Ben Cat,15,1,0,1,1
2022-05-06,Binh Duong,Ben Cat,17,1,0,1,1
2022-05-06,Binh Duong,Ben Cat,20,1,0,1,1
2022-05-06,Binh Duong,Di An,7,6,0,6,6
2022-05-06,Binh Duong,Di An,8,15,3,12,10
2022-05-06,Binh Duong,Di An,9,17,7,10,9
2022-05-06,Binh Duong,Di An,10,24,12,12,10
2022-05-06,Binh Duong,Di An,11,54,24,30,28
2022-05-06,Binh Duong,Di An,12,41,22,19,17
2022-05-06,Binh Duong,Di An,13,46,25,21,15
2022-05-06,Binh Duong,Di An,14,20,10,10,9
2022-05-06,Binh Duong,Di An,15,19,11,8,5
2022-05-06,Binh Duong,Di An,16,14,7,7,3
2022-05-06,Binh Duong,Di An,17,35,19,16,12
2022-05-06,Binh Duong,Di An,18,26,13,13,10
2022-05-06,Binh Duong,Di An,19,22,10,12,10
2022-05-06,Binh Duong,Di An,20,12,5,7,6
2022-05-06,Binh Duong,Di An,21,6,1,5,4
2022-05-06,Binh Duong,Tan Uyen,7,1,0,1,1
2022-05-06,Binh Duong,Tan Uyen,9,3,1,2,2
2022-05-06,Binh Duong,Tan Uyen,10,2,0,2,2
2022-05-06,Binh Duong,Tan Uyen,11,2,0,2,2
2022-05-06,Binh Duong,Tan Uyen,12,5,1,4,2
2022-05-06,Binh Duong,Tan Uyen,13,5,2,3,1
2022-05-06,Binh Duong,Tan Uyen,14,1,0,1,1
2022-05-06,Binh Duong,Tan Uyen,15,1,0,1,1
2022-05-06,Binh Duong,Tan Uyen,16,1,1,0,0
2022-05-06,Binh Duong,Tan Uyen,17,3,2,1,1
2022-05-06,Binh Duong,Tan Uyen,18,1,1,0,0
2022-05-06,Binh Duong,Tan Uyen,19,2,0,2,2
2022-05-06,Binh Duong,Thu Dau Mot Town,1,1,0,1,0
2022-05-06,Binh Duong,Thu Dau Mot Town,2,1,0,1,0
2022-05-06,Binh Duong,Thu Dau Mot Town,5,3,1,2,0
2022-05-06,Binh Duong,Thu Dau Mot Town,6,38,31,7,5
2022-05-06,Binh Duong,Thu Dau Mot Town,7,126,114,12,2
2022-05-06,Binh Duong,Thu Dau Mot Town,8,209,194,15,1
2022-05-06,Binh Duong,Thu Dau Mot Town,9,244,226,18,0
2022-05-06,Binh Duong,Thu Dau Mot Town,10,363,339,24,4
2022-05-06,Binh Duong,Thu Dau Mot Town,11,627,584,43,7
2022-05-06,Binh Duong,Thu Dau Mot Town,12,453,423,30,5
2022-05-06,Binh Duong,Thu Dau Mot Town,13,394,369,25,3
2022-05-06,Binh Duong,Thu Dau Mot Town,14,366,347,19,2
2022-05-06,Binh Duong,Thu Dau Mot Town,15,246,234,12,1
2022-05-06,Binh Duong,Thu Dau Mot Town,16,296,281,15,2
2022-05-06,Binh Duong,Thu Dau Mot Town,17,341,325,16,3
2022-05-06,Binh Duong,Thu Dau Mot Town,18,340,321,19,2
2022-05-06,Binh Duong,Thu Dau Mot Town,19,346,325,21,2
2022-05-06,Binh Duong,Thu Dau Mot Town,20,269,241,28,1
2022-05-06,Binh Duong,Thu Dau Mot Town,21,113,103,10,2
2022-05-06,Binh Duong,Thu Dau Mot Town,22,4,2,2,0
2022-05-06,Binh Duong,Thuan An,4,1,0,1,0
2022-05-06,Binh Duong,Thuan An,6,6,1,5,5
2022-05-06,Binh Duong,Thuan An,7,8,3,5,5
2022-05-06,Binh Duong,Thuan An,8,22,15,7,6
2022-05-06,Binh Duong,Thuan An,9,36,20,16,11
2022-05-06,Binh Duong,Thuan An,10,52,36,16,14
2022-05-06,Binh Duong,Thuan An,11,66,43,23,13
2022-05-06,Binh Duong,Thuan An,12,75,51,24,19
2022-05-06,Binh Duong,Thuan An,13,61,35,26,23
2022-05-06,Binh Duong,Thuan An,14,44,28,16,14
2022-05-06,Binh Duong,Thuan An,15,41,27,14,11
2022-05-06,Binh Duong,Thuan An,16,37,28,9,7
2022-05-06,Binh Duong,Thuan An,17,36,27,9,9
2022-05-06,Binh Duong,Thuan An,18,36,30,6,2
2022-05-06,Binh Duong,Thuan An,19,46,32,14,8
2022-05-06,Binh Duong,Thuan An,20,40,23,17,12
2022-05-06,Binh Duong,Thuan An,21,19,4,15,12
2022-05-06,Can Tho City,Binh Thuy District,5,2,1,1,1
2022-05-06,Can Tho City,Binh Thuy District,7,1,1,0,0
2022-05-06,Can Tho City,Binh Thuy District,8,2,1,1,0
2022-05-06,Can Tho City,Binh Thuy District,9,9,8,1,0
2022-05-06,Can Tho City,Binh Thuy District,10,13,11,2,0
2022-05-06,Can Tho City,Binh Thuy District,11,14,12,2,0
2022-05-06,Can Tho City,Binh Thuy District,12,12,11,1,0
2022-05-06,Can Tho City,Binh Thuy District,13,25,23,2,0
2022-05-06,Can Tho City,Binh Thuy District,14,18,17,1,0
2022-05-06,Can Tho City,Binh Thuy District,15,11,9,2,0
2022-05-06,Can Tho City,Binh Thuy District,16,16,15,1,0
2022-05-06,Can Tho City,Binh Thuy District,17,14,13,1,0
2022-05-06,Can Tho City,Binh Thuy District,18,20,15,5,0
2022-05-06,Can Tho City,Binh Thuy District,19,18,15,3,2
2022-05-06,Can Tho City,Binh Thuy District,20,7,6,1,1
2022-05-06,Can Tho City,Binh Thuy District,21,6,3,3,2
2022-05-06,Can Tho City,Cai Rang District,6,2,0,2,2
2022-05-06,Can Tho City,Cai Rang District,7,4,4,0,0
2022-05-06,Can Tho City,Cai Rang District,8,2,1,1,0
2022-05-06,Can Tho City,Cai Rang District,9,3,3,0,0
2022-05-06,Can Tho City,Cai Rang District,10,14,14,0,0
2022-05-06,Can Tho City,Cai Rang District,11,18,17,1,0
2022-05-06,Can Tho City,Cai Rang District,12,13,13,0,0
2022-05-06,Can Tho City,Cai Rang District,13,8,7,1,0
2022-05-06,Can Tho City,Cai Rang District,14,6,5,1,0
2022-05-06,Can Tho City,Cai Rang District,15,5,5,0,0
2022-05-06,Can Tho City,Cai Rang District,16,8,6,2,0
2022-05-06,Can Tho City,Cai Rang District,17,12,12,0,0
2022-05-06,Can Tho City,Cai Rang District,18,7,7,0,0
2022-05-06,Can Tho City,Cai Rang District,19,11,10,1,0
2022-05-06,Can Tho City,Cai Rang District,20,5,5,0,0
2022-05-06,Can Tho City,Cai Rang District,21,2,2,0,0
2022-05-06,Can Tho City,Ninh Kieu District,0,5,4,1,0
2022-05-06,Can Tho City,Ninh Kieu District,1,3,2,1,0
2022-05-06,Can Tho City,Ninh Kieu District,3,2,2,0,0
2022-05-06,Can Tho City,Ninh Kieu District,4,1,1,0,0
2022-05-06,Can Tho City,Ninh Kieu District,5,6,5,1,0
2022-05-06,Can Tho City,Ninh Kieu District,6,72,55,17,8
2022-05-06,Can Tho City,Ninh Kieu District,7,166,148,18,2
2022-05-06,Can Tho City,Ninh Kieu District,8,243,224,19,0
2022-05-06,Can Tho City,Ninh Kieu District,9,316,299,17,0
2022-05-06,Can Tho City,Ninh Kieu District,10,640,606,34,0
2022-05-06,Can Tho City,Ninh Kieu District,11,957,924,33,3
2022-05-06,Can Tho City,Ninh Kieu District,12,663,636,27,0
2022-05-06,Can Tho City,Ninh Kieu District,13,575,541,34,0
2022-05-06,Can Tho City,Ninh Kieu District,14,472,454,18,0
2022-05-06,Can Tho City,Ninh Kieu District,15,373,355,18,0
2022-05-06,Can Tho City,Ninh Kieu District,16,427,415,12,0
2022-05-06,Can Tho City,Ninh Kieu District,17,561,529,32,0
2022-05-06,Can Tho City,Ninh Kieu District,18,560,529,31,0
2022-05-06,Can Tho City,Ninh Kieu District,19,476,449,27,0
2022-05-06,Can Tho City,Ninh Kieu District,20,372,352,20,0
2022-05-06,Can Tho City,Ninh Kieu District,21,197,177,20,0
2022-05-06,Can Tho City,Ninh Kieu District,22,3,1,2,0
2022-05-06,Can Tho City,Ninh Kieu District,23,1,1,0,0
2022-05-06,Dong Nai,Bien Hoa City,0,3,1,2,1
2022-05-06,Dong Nai,Bien Hoa City,1,2,1,1,0
2022-05-06,Dong Nai,Bien Hoa City,3,2,2,0,0
2022-05-06,Dong Nai,Bien Hoa City,4,2,2,0,0
2022-05-06,Dong Nai,Bien Hoa City,5,2,1,1,1
2022-05-06,Dong Nai,Bien Hoa City,6,46,25,21,17
2022-05-06,Dong Nai,Bien Hoa City,7,138,123,15,5
2022-05-06,Dong Nai,Bien Hoa City,8,246,214,32,10
2022-05-06,Dong Nai,Bien Hoa City,9,387,350,37,6
2022-05-06,Dong Nai,Bien Hoa City,10,710,657,53,7
2022-05-06,Dong Nai,Bien Hoa City,11,1032,958,74,13
2022-05-06,Dong Nai,Bien Hoa City,12,838,770,68,18
2022-05-06,Dong Nai,Bien Hoa City,13,690,649,41,2
2022-05-06,Dong Nai,Bien Hoa City,14,616,556,60,10
2022-05-06,Dong Nai,Bien Hoa City,15,529,480,49,9
2022-05-06,Dong Nai,Bien Hoa City,16,477,441,36,3
2022-05-06,Dong Nai,Bien Hoa City,17,601,536,65,25
2022-05-06,Dong Nai,Bien Hoa City,18,761,689,72,20
2022-05-06,Dong Nai,Bien Hoa City,19,677,614,63,18
2022-05-06,Dong Nai,Bien Hoa City,20,486,406,80,22
2022-05-06,Dong Nai,Bien Hoa City,21,254,163,91,50
2022-05-06,Dong Nai,Bien Hoa City,22,1,0,1,0
2022-05-06,Dong Nai,Bien Hoa City,23,2,2,0,0
2022-05-06,Dong Nai,Long Khanh,10,3,0,3,1
2022-05-06,Dong Nai,Long Thanh,11,2,0,2,2
2022-05-06,Dong Nai,Long Thanh,14,3,0,3,3
2022-05-06,Dong Nai,Long Thanh,15,2,0,2,2
2022-05-06,Dong Nai,Long Thanh,16,2,0,2,2
2022-05-06,Dong Nai,Long Thanh,18,2,0,2,2
2022-05-06,Dong Nai,Long Thanh,19,1,0,1,1
2022-05-06,Dong Nai,Nhon trach,8,1,0,1,1
2022-05-06,Dong Nai,Nhon trach,9,1,0,1,1
2022-05-06,Dong Nai,Nhon trach,12,2,0,2,2
2022-05-06,Dong Nai,Nhon trach,13,3,0,3,2
2022-05-06,Dong Nai,Nhon trach,14,2,0,2,2
2022-05-06,Dong Nai,Nhon trach,15,1,0,1,1
2022-05-06,Dong Nai,Nhon trach,20,1,0,1,1
2022-05-06,Dong Nai,Trang Bom,12,1,0,1,1
2022-05-06,Dong Nai,Trang Bom,13,3,0,3,3
2022-05-06,Dong Nai,Trang Bom,14,2,0,2,2
2022-05-06,Dong Nai,Trang Bom,15,1,0,1,1
2022-05-06,Dong Nai,Trang Bom,19,1,0,1,1
2022-05-06,Dong Nai,Trang Bom,20,1,0,1,1
2022-05-06,Dong Nai,Trang Bom,21,1,0,1,1
2022-05-06,Hai Phong City,An Duong,8,3,2,1,1
2022-05-06,Hai Phong City,An Duong,9,4,3,1,1
2022-05-06,Hai Phong City,An Duong,10,4,1,3,3
2022-05-06,Hai Phong City,An Duong,11,7,3,4,4
2022-05-06,Hai Phong City,An Duong,12,4,1,3,3
2022-05-06,Hai Phong City,An Duong,13,4,1,3,2
2022-05-06,Hai Phong City,An Duong,14,4,1,3,2
2022-05-06,Hai Phong City,An Duong,15,11,2,9,7
2022-05-06,Hai Phong City,An Duong,16,2,0,2,1
2022-05-06,Hai Phong City,An Duong,17,2,0,2,0
2022-05-06,Hai Phong City,An Duong,18,3,0,3,2
2022-05-06,Hai Phong City,An Duong,19,5,0,5,4
2022-05-06,Hai Phong City,An Duong,20,2,0,2,1
2022-05-06,Hai Phong City,Hai An District,4,1,1,0,0
2022-05-06,Hai Phong City,Hai An District,7,10,5,5,5
2022-05-06,Hai Phong City,Hai An District,8,15,10,5,1
2022-05-06,Hai Phong City,Hai An District,9,17,14,3,0
2022-05-06,Hai Phong City,Hai An District,10,34,33,1,0
2022-05-06,Hai Phong City,Hai An District,11,63,51,12,4
2022-05-06,Hai Phong City,Hai An District,12,25,23,2,0
2022-05-06,Hai Phong City,Hai An District,13,16,15,1,0
2022-05-06,Hai Phong City,Hai An District,14,20,14,6,3
2022-05-06,Hai Phong City,Hai An District,15,23,18,5,2
2022-05-06,Hai Phong City,Hai An District,16,23,19,4,1
2022-05-06,Hai Phong City,Hai An District,17,20,19,1,0
2022-05-06,Hai Phong City,Hai An District,18,27,21,6,1
2022-05-06,Hai Phong City,Hai An District,19,22,18,4,0
2022-05-06,Hai Phong City,Hai An District,20,15,10,5,3
2022-05-06,Hai Phong City,Hai An District,21,10,7,3,1
2022-05-06,Hai Phong City,Hong Bang District,6,1,0,1,1
2022-05-06,Hai Phong City,Hong Bang District,7,10,9,1,1
2022-05-06,Hai Phong City,Hong Bang District,8,28,25,3,1
2022-05-06,Hai Phong City,Hong Bang District,9,39,36,3,0
2022-05-06,Hai Phong City,Hong Bang District,10,66,52,14,1
2022-05-06,Hai Phong City,Hong Bang District,11,113,106,7,3
2022-05-06,Hai Phong City,Hong Bang District,12,43,40,3,1
2022-05-06,Hai Phong City,Hong Bang District,13,35,32,3,1
2022-05-06,Hai Phong City,Hong Bang District,14,46,32,14,9
2022-05-06,Hai Phong City,Hong Bang District,15,37,32,5,4
2022-05-06,Hai Phong City,Hong Bang District,16,29,27,2,0
2022-05-06,Hai Phong City,Hong Bang District,17,49,48,1,0
2022-05-06,Hai Phong City,Hong Bang District,18,53,46,7,1
2022-05-06,Hai Phong City,Hong Bang District,19,56,44,12,7
2022-05-06,Hai Phong City,Hong Bang District,20,44,32,12,4
2022-05-06,Hai Phong City,Hong Bang District,21,17,9,8,5
2022-05-06,Hai Phong City,Hong Bang District,23,1,1,0,0
2022-05-06,Hai Phong City,Kien An District,4,1,1,0,0
2022-05-06,Hai Phong City,Kien An District,8,2,1,1,1
2022-05-06,Hai Phong City,Kien An District,9,8,7,1,0
2022-05-06,Hai Phong City,Kien An District,10,7,3,4,4
2022-05-06,Hai Phong City,Kien An District,11,14,10,4,3
2022-05-06,Hai Phong City,Kien An District,12,12,9,3,3
2022-05-06,Hai Phong City,Kien An District,13,1,1,0,0
2022-05-06,Hai Phong City,Kien An District,14,7,4,3,2
2022-05-06,Hai Phong City,Kien An District,15,7,5,2,1
2022-05-06,Hai Phong City,Kien An District,16,7,6,1,1
2022-05-06,Hai Phong City,Kien An District,17,7,6,1,0
2022-05-06,Hai Phong City,Kien An District,18,7,3,4,4
2022-05-06,Hai Phong City,Kien An District,19,8,7,1,1
2022-05-06,Hai Phong City,Kien An District,20,9,7,2,2
2022-05-06,Hai Phong City,Kien An District,21,2,1,1,0
2022-05-06,Hai Phong City,Le Chan District,1,1,1,0,0
2022-05-06,Hai Phong City,Le Chan District,2,1,1,0,0
2022-05-06,Hai Phong City,Le Chan District,6,3,1,2,1
2022-05-06,Hai Phong City,Le Chan District,7,39,29,10,6
2022-05-06,Hai Phong City,Le Chan District,8,70,59,11,4
2022-05-06,Hai Phong City,Le Chan District,9,75,64,11,1
2022-05-06,Hai Phong City,Le Chan District,10,174,154,20,3
2022-05-06,Hai Phong City,Le Chan District,11,310,281,29,8
2022-05-06,Hai Phong City,Le Chan District,12,206,185,21,3
2022-05-06,Hai Phong City,Le Chan District,13,112,102,10,2
2022-05-06,Hai Phong City,Le Chan District,14,124,110,14,5
2022-05-06,Hai Phong City,Le Chan District,15,125,110,15,5
2022-05-06,Hai Phong City,Le Chan District,16,118,109,9,2
2022-05-06,Hai Phong City,Le Chan District,17,135,123,12,2
2022-05-06,Hai Phong City,Le Chan District,18,219,188,31,14
2022-05-06,Hai Phong City,Le Chan District,19,195,166,29,7
2022-05-06,Hai Phong City,Le Chan District,20,137,118,19,2
2022-05-06,Hai Phong City,Le Chan District,21,76,49,27,12
2022-05-06,Hai Phong City,Le Chan District,22,1,1,0,0
2022-05-06,Hai Phong City,Ngo Quyen District,1,1,0,1,0
2022-05-06,Hai Phong City,Ngo Quyen District,3,1,0,1,0
2022-05-06,Hai Phong City,Ngo Quyen District,5,2,1,1,0
2022-05-06,Hai Phong City,Ngo Quyen District,6,5,2,3,2
2022-05-06,Hai Phong City,Ngo Quyen District,7,26,20,6,4
2022-05-06,Hai Phong City,Ngo Quyen District,8,63,53,10,5
2022-05-06,Hai Phong City,Ngo Quyen District,9,68,67,1,1
2022-05-06,Hai Phong City,Ngo Quyen District,10,143,123,20,2
2022-05-06,Hai Phong City,Ngo Quyen District,11,217,188,29,8
2022-05-06,Hai Phong City,Ngo Quyen District,12,133,118,15,1
2022-05-06,Hai Phong City,Ngo Quyen District,13,102,90,12,2
2022-05-06,Hai Phong City,Ngo Quyen District,14,124,106,18,9
2022-05-06,Hai Phong City,Ngo Quyen District,15,142,117,25,10
2022-05-06,Hai Phong City,Ngo Quyen District,16,105,92,13,0
2022-05-06,Hai Phong City,Ngo Quyen District,17,143,127,16,3
2022-05-06,Hai Phong City,Ngo Quyen District,18,171,147,24,5
2022-05-06,Hai Phong City,Ngo Quyen District,19,167,136,31,11
2022-05-06,Hai Phong City,Ngo Quyen District,20,111,100,11,5
2022-05-06,Hai Phong City,Ngo Quyen District,21,87,65,22,8
2022-05-06,Hai Phong City,Ngo Quyen District,23,1,1,0,0
2022-05-06,Hai Phong City,Thuy Nguyen,8,1,0,1,1
2022-05-06,Hai Phong City,Thuy Nguyen,11,1,0,1,1
2022-05-06,Hai Phong City,Thuy Nguyen,12,1,0,1,1
2022-05-06,Hai Phong City,Thuy Nguyen,13,1,0,1,1
2022-05-06,Hai Phong City,Thuy Nguyen,17,2,0,2,2
2022-05-06,Hai Phong City,Thuy Nguyen,18,3,1,2,2
2022-05-06,Hai Phong City,Thuy Nguyen,19,3,0,3,3
2022-05-06,Hai Phong City,Thuy Nguyen,20,2,0,2,2
2022-05-06,Hue City,Hue City,0,4,2,2,0
2022-05-06,Hue City,Hue City,1,1,0,1,0
2022-05-06,Hue City,Hue City,3,2,0,2,1
2022-05-06,Hue City,Hue City,4,1,0,1,0
2022-05-06,Hue City,Hue City,5,2,2,0,0
2022-05-06,Hue City,Hue City,6,67,62,5,3
2022-05-06,Hue City,Hue City,7,194,183,11,1
2022-05-06,Hue City,Hue City,8,289,263,26,2
2022-05-06,Hue City,Hue City,9,251,237,14,2
2022-05-06,Hue City,Hue City,10,382,357,25,0
2022-05-06,Hue City,Hue City,11,912,867,45,1
2022-05-06,Hue City,Hue City,12,540,510,30,0
2022-05-06,Hue City,Hue City,13,333,308,25,0
2022-05-06,Hue City,Hue City,14,361,330,31,2
2022-05-06,Hue City,Hue City,15,374,352,22,4
2022-05-06,Hue City,Hue City,16,431,391,40,7
2022-05-06,Hue City,Hue City,17,553,517,36,1
2022-05-06,Hue City,Hue City,18,633,585,48,7
2022-05-06,Hue City,Hue City,19,775,623,152,77
2022-05-06,Hue City,Hue City,20,546,442,104,37
2022-05-06,Hue City,Hue City,21,307,208,99,54
2022-05-06,Hue City,Hue City,22,3,2,1,0
2022-05-06,Hue City,Huong Thuy,8,1,1,0,0
2022-05-06,Hue City,Huong Thuy,9,3,2,1,0
2022-05-06,Hue City,Huong Thuy,11,1,1,0,0
2022-05-06,Hue City,Huong Thuy,12,2,0,2,0
2022-05-06,Hue City,Huong Thuy,13,2,1,1,0
2022-05-06,Hue City,Huong Thuy,14,3,1,2,1
2022-05-06,Hue City,Huong Thuy,15,1,1,0,0
2022-05-06,Hue City,Huong Thuy,16,2,2,0,0
2022-05-06,Hue City,Huong Thuy,17,1,1,0,0
2022-05-06,Hue City,Huong Thuy,18,2,2,0,0
2022-05-06,Hue City,Huong Thuy,19,1,1,0,0
2022-05-06,Hue City,Huong Thuy,20,2,2,0,0
2022-05-06,Hue City,Huong Thuy,21,1,1,0,0
2022-05-06,Hue City,Huong Tra,8,1,1,0,0
2022-05-06,Hue City,Huong Tra,16,1,1,0,0
2022-05-06,Hue City,Huong Tra,18,1,0,1,1
2022-05-06,Hue City,Huong Tra,19,3,1,2,1
2022-05-06,Hue City,Huong Tra,21,1,1,0,0
2022-05-06,Hue City,Phu Vang,6,1,1,0,0
2022-05-06,Hue City,Phu Vang,7,1,1,0,0
2022-05-06,Hue City,Phu Vang,9,2,2,0,0
2022-05-06,Hue City,Phu Vang,10,3,1,2,2
2022-05-06,Hue City,Phu Vang,11,2,2,0,0
2022-05-06,Hue City,Phu Vang,12,3,2,1,0
2022-05-06,Hue City,Phu Vang,13,1,1,0,0
2022-05-06,Hue City,Phu Vang,14,2,2,0,0
2022-05-06,Hue City,Phu Vang,16,1,1,0,0
2022-05-06,Hue City,Phu Vang,17,4,3,1,0
2022-05-06,Hue City,Phu Vang,18,4,3,1,0
2022-05-06,Hue City,Phu Vang,19,2,2,0,0
2022-05-06,Hue City,Phu Vang,20,1,0,1,0
2022-05-06,Hue City,Phu Vang,21,1,0,1,1
2022-05-06,Vung Tau,Ba Ria City,8,9,0,9,7
2022-05-06,Vung Tau,Ba Ria City,9,9,6,3,3
2022-05-06,Vung Tau,Ba Ria City,10,3,2,1,0
2022-05-06,Vung Tau,Ba Ria City,11,13,8,5,5
2022-05-06,Vung Tau,Ba Ria City,12,6,5,1,1
2022-05-06,Vung Tau,Ba Ria City,13,7,3,4,3
2022-05-06,Vung Tau,Ba Ria City,14,9,7,2,1
2022-05-06,Vung Tau,Ba Ria City,15,12,5,7,7
2022-05-06,Vung Tau,Ba Ria City,16,1,0,1,1
2022-05-06,Vung Tau,Ba Ria City,17,3,2,1,0
2022-05-06,Vung Tau,Ba Ria City,18,7,4,3,1
2022-05-06,Vung Tau,Ba Ria City,19,7,4,3,2
2022-05-06,Vung Tau,Ba Ria City,20,3,0,3,3
2022-05-06,Vung Tau,Ba Ria City,21,4,0,4,3
2022-05-06,Vung Tau,Vung Tau City,0,4,1,3,1
2022-05-06,Vung Tau,Vung Tau City,1,1,1,0,0
2022-05-06,Vung Tau,Vung Tau City,5,4,3,1,1
2022-05-06,Vung Tau,Vung Tau City,6,40,27,13,10
2022-05-06,Vung Tau,Vung Tau City,7,82,78,4,0
2022-05-06,Vung Tau,Vung Tau City,8,175,159,16,4
2022-05-06,Vung Tau,Vung Tau City,9,123,116,7,0
2022-05-06,Vung Tau,Vung Tau City,10,185,173,12,2
2022-05-06,Vung Tau,Vung Tau City,11,361,339,22,2
2022-05-06,Vung Tau,Vung Tau City,12,279,263,16,0
2022-05-06,Vung Tau,Vung Tau City,13,179,169,10,1
2022-05-06,Vung Tau,Vung Tau City,14,239,217,22,0
2022-05-06,Vung Tau,Vung Tau City,15,184,172,12,0
2022-05-06,Vung Tau,Vung Tau City,16,189,172,17,1
2022-05-06,Vung Tau,Vung Tau City,17,238,215,23,8
2022-05-06,Vung Tau,Vung Tau City,18,352,306,46,14
2022-05-06,Vung Tau,Vung Tau City,19,296,252,44,21
2022-05-06,Vung Tau,Vung Tau City,20,203,173,30,5
2022-05-06,Vung Tau,Vung Tau City,21,98,77,21,9
2022-05-07,Binh Duong,Ben Cat,9,2,0,2,2
2022-05-07,Binh Duong,Ben Cat,12,2,2,0,0
2022-05-07,Binh Duong,Di An,0,1,0,1,1
2022-05-07,Binh Duong,Di An,1,1,0,1,1
2022-05-07,Binh Duong,Di An,6,5,0,5,5
2022-05-07,Binh Duong,Di An,7,6,1,5,5
2022-05-07,Binh Duong,Di An,8,9,4,5,3
2022-05-07,Binh Duong,Di An,9,18,9,9,7
2022-05-07,Binh Duong,Di An,10,29,21,8,5
2022-05-07,Binh Duong,Di An,11,41,24,17,16
2022-05-07,Binh Duong,Di An,12,37,24,13,9
2022-05-07,Binh Duong,Di An,13,26,9,17,15
2022-05-07,Binh Duong,Di An,14,39,20,19,9
2022-05-07,Binh Duong,Di An,15,33,20,13,9
2022-05-07,Binh Duong,Di An,16,26,12,14,10
2022-05-07,Binh Duong,Di An,17,33,26,7,4
2022-05-07,Binh Duong,Di An,18,35,21,14,9
2022-05-07,Binh Duong,Di An,19,25,17,8,5
2022-05-07,Binh Duong,Di An,20,28,21,7,7
2022-05-07,Binh Duong,Di An,21,11,8,3,3
2022-05-07,Binh Duong,Tan Uyen,8,1,0,1,1
2022-05-07,Binh Duong,Tan Uyen,9,6,0,6,5
2022-05-07,Binh Duong,Tan Uyen,10,4,2,2,2
2022-05-07,Binh Duong,Tan Uyen,11,4,0,4,4
2022-05-07,Binh Duong,Tan Uyen,13,2,2,0,0
2022-05-07,Binh Duong,Tan Uyen,14,3,1,2,1
2022-05-07,Binh Duong,Tan Uyen,16,1,0,1,1
2022-05-07,Binh Duong,Tan Uyen,17,5,2,3,3
2022-05-07,Binh Duong,Tan Uyen,18,4,3,1,1
2022-05-07,Binh Duong,Tan Uyen,19,4,1,3,2
2022-05-07,Binh Duong,Tan Uyen,20,2,0,2,2
2022-05-07,Binh Duong,Thu Dau Mot Town,2,1,1,0,0
2022-05-07,Binh Duong,Thu Dau Mot Town,5,1,1,0,0
2022-05-07,Binh Duong,Thu Dau Mot Town,6,32,29,3,3
2022-05-07,Binh Duong,Thu Dau Mot Town,7,114,105,9,3
2022-05-07,Binh Duong,Thu Dau Mot Town,8,245,231,14,4
2022-05-07,Binh Duong,Thu Dau Mot Town,9,282,270,12,1
2022-05-07,Binh Duong,Thu Dau Mot Town,10,409,387,22,5
2022-05-07,Binh Duong,Thu Dau Mot Town,11,647,617,30,5
2022-05-07,Binh Duong,Thu Dau Mot Town,12,502,474,28,3
2022-05-07,Binh Duong,Thu Dau Mot Town,13,395,373,22,1
2022-05-07,Binh Duong,Thu Dau Mot Town,14,350,328,22,0
2022-05-07,Binh Duong,Thu Dau Mot Town,15,304,285,19,2
2022-05-07,Binh Duong,Thu Dau Mot Town,16,311,297,14,3
2022-05-07,Binh Duong,Thu Dau Mot Town,17,353,329,24,5
2022-05-07,Binh Duong,Thu Dau Mot Town,18,411,387,24,8
2022-05-07,Binh Duong,Thu Dau Mot Town,19,357,321,36,9
2022-05-07,Binh Duong,Thu Dau Mot Town,20,234,211,23,1
2022-05-07,Binh Duong,Thu Dau Mot Town,21,131,110,21,6
2022-05-07,Binh Duong,Thu Dau Mot Town,22,2,1,1,0
2022-05-07,Binh Duong,Thu Dau Mot Town,23,1,1,0,0
2022-05-07,Binh Duong,Thuan An,6,3,0,3,2
2022-05-07,Binh Duong,Thuan An,7,7,4,3,0
2022-05-07,Binh Duong,Thuan An,8,17,11,6,3
2022-05-07,Binh Duong,Thuan An,9,37,29,8,3
2022-05-07,Binh Duong,Thuan An,10,58,40,18,11
2022-05-07,Binh Duong,Thuan An,11,72,48,24,18
2022-05-07,Binh Duong,Thuan An,12,78,56,22,16
2022-05-07,Binh Duong,Thuan An,13,41,30,11,8
2022-05-07,Binh Duong,Thuan An,14,62,32,30,23
2022-05-07,Binh Duong,Thuan An,15,40,22,18,12
2022-05-07,Binh Duong,Thuan An,16,40,29,11,9
2022-05-07,Binh Duong,Thuan An,17,57,40,17,11
2022-05-07,Binh Duong,Thuan An,18,48,40,8,5
2022-05-07,Binh Duong,Thuan An,19,35,26,9,5
2022-05-07,Binh Duong,Thuan An,20,37,15,22,15
2022-05-07,Binh Duong,Thuan An,21,19,6,13,10
2022-05-07,Can Tho City,Binh Thuy District,1,1,0,1,1
2022-05-07,Can Tho City,Binh Thuy District,8,2,2,0,0
2022-05-07,Can Tho City,Binh Thuy District,9,7,6,1,0
2022-05-07,Can Tho City,Binh Thuy District,10,8,6,2,1
2022-05-07,Can Tho City,Binh Thuy District,11,16,16,0,0
2022-05-07,Can Tho City,Binh Thuy District,12,8,7,1,0
2022-05-07,Can Tho City,Binh Thuy District,13,12,10,2,0
2022-05-07,Can Tho City,Binh Thuy District,14,10,9,1,0
2022-05-07,Can Tho City,Binh Thuy District,15,13,11,2,2
2022-05-07,Can Tho City,Binh Thuy District,16,9,9,0,0
2022-05-07,Can Tho City,Binh Thuy District,17,15,14,1,0
2022-05-07,Can Tho City,Binh Thuy District,18,16,12,4,2
2022-05-07,Can Tho City,Binh Thuy District,19,12,12,0,0
2022-05-07,Can Tho City,Binh Thuy District,20,16,15,1,0
2022-05-07,Can Tho City,Binh Thuy District,21,7,7,0,0
2022-05-07,Can Tho City,Cai Rang District,7,3,3,0,0
2022-05-07,Can Tho City,Cai Rang District,8,7,5,2,0
2022-05-07,Can Tho City,Cai Rang District,9,4,4,0,0
2022-05-07,Can Tho City,Cai Rang District,10,13,13,0,0
2022-05-07,Can Tho City,Cai Rang District,11,12,9,3,1
2022-05-07,Can Tho City,Cai Rang District,12,14,12,2,0
2022-05-07,Can Tho City,Cai Rang District,13,10,9,1,0
2022-05-07,Can Tho City,Cai Rang District,14,13,12,1,0
2022-05-07,Can Tho City,Cai Rang District,15,8,6,2,1
2022-05-07,Can Tho City,Cai Rang District,16,12,11,1,0
2022-05-07,Can Tho City,Cai Rang District,17,7,7,0,0
2022-05-07,Can Tho City,Cai Rang District,18,8,7,1,0
2022-05-07,Can Tho City,Cai Rang District,19,11,10,1,0
2022-05-07,Can Tho City,Cai Rang District,20,8,8,0,0
2022-05-07,Can Tho City,Cai Rang District,21,2,1,1,1
2022-05-07,Can Tho City,Ninh Kieu District,0,1,1,0,0
2022-05-07,Can Tho City,Ninh Kieu District,1,5,5,0,0
2022-05-07,Can Tho City,Ninh Kieu District,2,2,2,0,0
2022-05-07,Can Tho City,Ninh Kieu District,3,2,2,0,0
2022-05-07,Can Tho City,Ninh Kieu District,5,2,1,1,0
2022-05-07,Can Tho City,Ninh Kieu District,6,54,50,4,1
2022-05-07,Can Tho City,Ninh Kieu District,7,139,138,1,0
2022-05-07,Can Tho City,Ninh Kieu District,8,236,227,9,0
2022-05-07,Can Tho City,Ninh Kieu District,9,311,295,16,1
2022-05-07,Can Tho City,Ninh Kieu District,10,598,568,30,0
2022-05-07,Can Tho City,Ninh Kieu District,11,807,762,45,2
2022-05-07,Can Tho City,Ninh Kieu District,12,618,590,28,0
2022-05-07,Can Tho City,Ninh Kieu District,13,474,458,16,0
2022-05-07,Can Tho City,Ninh Kieu District,14,385,373,12,0
2022-05-07,Can Tho City,Ninh Kieu District,15,400,374,26,0
2022-05-07,Can Tho City,Ninh Kieu District,16,439,415,24,0
2022-05-07,Can Tho City,Ninh Kieu District,17,511,484,27,0
2022-05-07,Can Tho City,Ninh Kieu District,18,527,502,25,0
2022-05-07,Can Tho City,Ninh Kieu District,19,508,485,23,0
2022-05-07,Can Tho City,Ninh Kieu District,20,370,343,27,1
2022-05-07,Can Tho City,Ninh Kieu District,21,216,189,27,5
2022-05-07,Can Tho City,Ninh Kieu District,22,3,3,0,0
2022-05-07,Can Tho City,Ninh Kieu District,23,4,2,2,0
2022-05-07,Dong Nai,Bien Hoa City,0,5,4,1,0
2022-05-07,Dong Nai,Bien Hoa City,1,4,2,2,0
2022-05-07,Dong Nai,Bien Hoa City,2,1,1,0,0
2022-05-07,Dong Nai,Bien Hoa City,4,2,0,2,0
2022-05-07,Dong Nai,Bien Hoa City,6,55,32,23,17
2022-05-07,Dong Nai,Bien Hoa City,7,165,139,26,13
2022-05-07,Dong Nai,Bien Hoa City,8,353,308,45,8
2022-05-07,Dong Nai,Bien Hoa City,9,474,439,35,7
2022-05-07,Dong Nai,Bien Hoa City,10,816,731,85,14
2022-05-07,Dong Nai,Bien Hoa City,11,1161,1064,97,22
2022-05-07,Dong Nai,Bien Hoa City,12,955,876,79,24
2022-05-07,Dong Nai,Bien Hoa City,13,840,755,85,19
2022-05-07,Dong Nai,Bien Hoa City,14,709,644,65,16
2022-05-07,Dong Nai,Bien Hoa City,15,615,545,70,15
2022-05-07,Dong Nai,Bien Hoa City,16,564,509,55,17
2022-05-07,Dong Nai,Bien Hoa City,17,695,613,82,41
2022-05-07,Dong Nai,Bien Hoa City,18,786,694,92,38
2022-05-07,Dong Nai,Bien Hoa City,19,812,685,127,61
2022-05-07,Dong Nai,Bien Hoa City,20,564,462,102,38
2022-05-07,Dong Nai,Bien Hoa City,21,257,185,72,40
2022-05-07,Dong Nai,Bien Hoa City,22,5,0,5,2
2022-05-07,Dong Nai,Bien Hoa City,23,5,3,2,1
2022-05-07,Dong Nai,Cam My,21,1,0,1,0
2022-05-07,Dong Nai,Long Khanh,9,2,0,2,2
2022-05-07,Dong Nai,Long Khanh,17,1,0,1,1
2022-05-07,Dong Nai,Long Thanh,8,1,0,1,1
2022-05-07,Dong Nai,Long Thanh,9,1,0,1,1
2022-05-07,Dong Nai,Long Thanh,10,1,0,1,1
2022-05-07,Dong Nai,Long Thanh,11,1,0,1,0
2022-05-07,Dong Nai,Long Thanh,12,1,0,1,1
2022-05-07,Dong Nai,Long Thanh,13,1,0,1,1
2022-05-07,Dong Nai,Long Thanh,15,1,0,1,1
2022-05-07,Dong Nai,Long Thanh,16,3,0,3,3
2022-05-07,Dong Nai,Long Thanh,17,4,0,4,4
2022-05-07,Dong Nai,Long Thanh,21,1,0,1,1
2022-05-07,Dong Nai,Nhon trach,10,1,0,1,0
2022-05-07,Dong Nai,Nhon trach,13,1,0,1,0
2022-05-07,Dong Nai,Nhon trach,14,2,0,2,1
2022-05-07,Dong Nai,Nhon trach,17,1,0,1,1
2022-05-07,Dong Nai,Nhon trach,18,1,0,1,0
2022-05-07,Dong Nai,Nhon trach,19,3,0,3,3
2022-05-07,Dong Nai,Nhon trach,20,3,0,3,2
2022-05-07,Dong Nai,Nhon trach,21,1,0,1,1
2022-05-07,Dong Nai,Trang Bom,8,1,0,1,1
2022-05-07,Dong Nai,Trang Bom,9,3,0,3,3
2022-05-07,Dong Nai,Trang Bom,10,1,0,1,1
2022-05-07,Dong Nai,Trang Bom,11,2,0,2,2
2022-05-07,Dong Nai,Trang Bom,12,3,0,3,3
2022-05-07,Dong Nai,Trang Bom,13,1,0,1,1
2022-05-07,Dong Nai,Trang Bom,14,2,0,2,2
2022-05-07,Dong Nai,Trang Bom,15,3,0,3,2
2022-05-07,Dong Nai,Trang Bom,18,2,1,1,1
2022-05-07,Dong Nai,Trang Bom,19,2,0,2,2
2022-05-07,Dong Nai,Trang Bom,20,2,1,1,1
2022-05-07,Hai Phong City,An Duong,1,1,0,1,0
2022-05-07,Hai Phong City,An Duong,7,4,2,2,1
2022-05-07,Hai Phong City,An Duong,9,6,4,2,1
2022-05-07,Hai Phong City,An Duong,10,2,1,1,1
2022-05-07,Hai Phong City,An Duong,11,7,3,4,3
2022-05-07,Hai Phong City,An Duong,12,3,1,2,0
2022-05-07,Hai Phong City,An Duong,13,3,0,3,1
2022-05-07,Hai Phong City,An Duong,14,13,5,8,6
2022-05-07,Hai Phong City,An Duong,15,7,2,5,3
2022-05-07,Hai Phong City,An Duong,16,3,3,0,0
2022-05-07,Hai Phong City,An Duong,17,3,2,1,0
2022-05-07,Hai Phong City,An Duong,18,2,1,1,0
2022-05-07,Hai Phong City,An Duong,19,2,2,0,0
2022-05-07,Hai Phong City,An Duong,21,2,1,1,0
2022-05-07,Hai Phong City,Do Son District,16,1,0,1,1
2022-05-07,Hai Phong City,Duong Kinh District,10,3,0,3,3
2022-05-07,Hai Phong City,Hai An District,0,1,1,0,0
2022-05-07,Hai Phong City,Hai An District,7,5,3,2,0
2022-05-07,Hai Phong City,Hai An District,8,13,10,3,0
2022-05-07,Hai Phong City,Hai An District,9,15,14,1,0
2022-05-07,Hai Phong City,Hai An District,10,24,18,6,5
2022-05-07,Hai Phong City,Hai An District,11,38,29,9,7
2022-05-07,Hai Phong City,Hai An District,12,33,26,7,2
2022-05-07,Hai Phong City,Hai An District,13,23,17,6,2
2022-05-07,Hai Phong City,Hai An District,14,16,15,1,1
2022-05-07,Hai Phong City,Hai An District,15,16,13,3,1
2022-05-07,Hai Phong City,Hai An District,16,17,13,4,0
2022-05-07,Hai Phong City,Hai An District,17,16,14,2,0
2022-05-07,Hai Phong City,Hai An District,18,26,20,6,1
2022-05-07,Hai Phong City,Hai An District,19,24,19,5,0
2022-05-07,Hai Phong City,Hai An District,20,20,11,9,4
2022-05-07,Hai Phong City,Hai An District,21,17,8,9,4
2022-05-07,Hai Phong City,Hong Bang District,7,11,9,2,2
2022-05-07,Hai Phong City,Hong Bang District,8,14,14,0,0
2022-05-07,Hai Phong City,Hong Bang District,9,30,26,4,1
2022-05-07,Hai Phong City,Hong Bang District,10,79,72,7,4
2022-05-07,Hai Phong City,Hong Bang District,11,102,86,16,8
2022-05-07,Hai Phong City,Hong Bang District,12,74,62,12,3
2022-05-07,Hai Phong City,Hong Bang District,13,44,37,7,5
2022-05-07,Hai Phong City,Hong Bang District,14,26,21,5,2
2022-05-07,Hai Phong City,Hong Bang District,15,36,33,3,1
2022-05-07,Hai Phong City,Hong Bang District,16,39,30,9,1
2022-05-07,Hai Phong City,Hong Bang District,17,35,29,6,0
2022-05-07,Hai Phong City,Hong Bang District,18,69,57,12,6
2022-05-07,Hai Phong City,Hong Bang District,19,60,42,18,12
2022-05-07,Hai Phong City,Hong Bang District,20,40,23,17,9
2022-05-07,Hai Phong City,Hong Bang District,21,17,9,8,8
2022-05-07,Hai Phong City,Hong Bang District,22,1,1,0,0
2022-05-07,Hai Phong City,Hong Bang District,23,1,0,1,1
2022-05-07,Hai Phong City,Kien An District,6,1,0,1,0
2022-05-07,Hai Phong City,Kien An District,7,1,0,1,1
2022-05-07,Hai Phong City,Kien An District,8,4,2,2,2
2022-05-07,Hai Phong City,Kien An District,9,4,4,0,0
2022-05-07,Hai Phong City,Kien An District,10,12,5,7,5
2022-05-07,Hai Phong City,Kien An District,11,19,9,10,8
2022-05-07,Hai Phong City,Kien An District,12,15,7,8,7
2022-05-07,Hai Phong City,Kien An District,13,8,4,4,1
2022-05-07,Hai Phong City,Kien An District,14,9,7,2,2
2022-05-07,Hai Phong City,Kien An District,15,13,10,3,3
2022-05-07,Hai Phong City,Kien An District,16,4,2,2,2
2022-05-07,Hai Phong City,Kien An District,17,4,3,1,1
2022-05-07,Hai Phong City,Kien An District,18,15,11,4,3
2022-05-07,Hai Phong City,Kien An District,19,9,5,4,3
2022-05-07,Hai Phong City,Kien An District,20,13,2,11,10
2022-05-07,Hai Phong City,Kien An District,21,6,1,5,5
2022-05-07,Hai Phong City,Le Chan District,0,1,1,0,0
2022-05-07,Hai Phong City,Le Chan District,2,1,1,0,0
2022-05-07,Hai Phong City,Le Chan District,3,1,1,0,0
2022-05-07,Hai Phong City,Le Chan District,6,2,0,2,2
2022-05-07,Hai Phong City,Le Chan District,7,43,30,13,9
2022-05-07,Hai Phong City,Le Chan District,8,80,67,13,4
2022-05-07,Hai Phong City,Le Chan District,9,83,77,6,1
2022-05-07,Hai Phong City,Le Chan District,10,190,172,18,0
2022-05-07,Hai Phong City,Le Chan District,11,331,290,41,17
2022-05-07,Hai Phong City,Le Chan District,12,210,180,30,6
2022-05-07,Hai Phong City,Le Chan District,13,127,121,6,0
2022-05-07,Hai Phong City,Le Chan District,14,119,105,14,1
2022-05-07,Hai Phong City,Le Chan District,15,141,122,19,4
2022-05-07,Hai Phong City,Le Chan District,16,163,146,17,2
2022-05-07,Hai Phong City,Le Chan District,17,161,140,21,3
2022-05-07,Hai Phong City,Le Chan District,18,211,183,28,9
2022-05-07,Hai Phong City,Le Chan District,19,222,178,44,24
2022-05-07,Hai Phong City,Le Chan District,20,171,135,36,23
2022-05-07,Hai Phong City,Le Chan District,21,109,70,39,12
2022-05-07,Hai Phong City,Le Chan District,22,1,0,1,0
2022-05-07,Hai Phong City,Le Chan District,23,2,0,2,0
2022-05-07,Hai Phong City,Ngo Quyen District,1,2,0,2,0
2022-05-07,Hai Phong City,Ngo Quyen District,7,27,19,8,3
2022-05-07,Hai Phong City,Ngo Quyen District,8,62,55,7,4
2022-05-07,Hai Phong City,Ngo Quyen District,9,90,74,16,2
2022-05-07,Hai Phong City,Ngo Quyen District,10,131,119,12,2
2022-05-07,Hai Phong City,Ngo Quyen District,11,274,243,31,18
2022-05-07,Hai Phong City,Ngo Quyen District,12,194,169,25,6
2022-05-07,Hai Phong City,Ngo Quyen District,13,99,90,9,1
2022-05-07,Hai Phong City,Ngo Quyen District,14,100,86,14,3
2022-05-07,Hai Phong City,Ngo Quyen District,15,104,98,6,1
2022-05-07,Hai Phong City,Ngo Quyen District,16,124,111,13,1
2022-05-07,Hai Phong City,Ngo Quyen District,17,137,126,11,2
2022-05-07,Hai Phong City,Ngo Quyen District,18,160,144,16,3
2022-05-07,Hai Phong City,Ngo Quyen District,19,180,154,26,11
2022-05-07,Hai Phong City,Ngo Quyen District,20,151,119,32,18
2022-05-07,Hai Phong City,Ngo Quyen District,21,75,47,28,11
2022-05-07,Hai Phong City,Thuy Nguyen,10,1,0,1,1
2022-05-07,Hai Phong City,Thuy Nguyen,11,1,1,0,0
2022-05-07,Hai Phong City,Thuy Nguyen,13,1,0,1,1
2022-05-07,Hai Phong City,Thuy Nguyen,14,1,0,1,1
2022-05-07,Hai Phong City,Thuy Nguyen,15,2,1,1,1
2022-05-07,Hai Phong City,Thuy Nguyen,16,3,0,3,3
2022-05-07,Hue City,Hue City,0,3,3,0,0
2022-05-07,Hue City,Hue City,5,5,3,2,0
2022-05-07,Hue City,Hue City,6,46,43,3,2
2022-05-07,Hue City,Hue City,7,196,187,9,2
2022-05-07,Hue City,Hue City,8,290,277,13,1
2022-05-07,Hue City,Hue City,9,308,289,19,0
2022-05-07,Hue City,Hue City,10,423,398,25,0
2022-05-07,Hue City,Hue City,11,872,822,50,3
2022-05-07,Hue City,Hue City,12,627,581,46,1
2022-05-07,Hue City,Hue City,13,332,306,26,0
2022-05-07,Hue City,Hue City,14,312,291,21,1
2022-05-07,Hue City,Hue City,15,420,394,26,5
2022-05-07,Hue City,Hue City,16,385,356,29,0
2022-05-07,Hue City,Hue City,17,552,519,33,0
2022-05-07,Hue City,Hue City,18,596,545,51,2
2022-05-07,Hue City,Hue City,19,561,505,56,3
2022-05-07,Hue City,Hue City,20,418,383,35,8
2022-05-07,Hue City,Hue City,21,243,196,47,7
2022-05-07,Hue City,Hue City,22,6,2,4,1
2022-05-07,Hue City,Hue City,23,1,1,0,0
2022-05-07,Hue City,Huong Thuy,9,1,0,1,1
2022-05-07,Hue City,Huong Thuy,10,1,1,0,0
2022-05-07,Hue City,Huong Thuy,14,1,1,0,0
2022-05-07,Hue City,Huong Thuy,17,1,1,0,0
2022-05-07,Hue City,Huong Thuy,20,1,0,1,1
2022-05-07,Hue City,Huong Tra,11,1,0,1,0
2022-05-07,Hue City,Huong Tra,12,1,1,0,0
2022-05-07,Hue City,Huong Tra,18,2,1,1,0
2022-05-07,Hue City,Phu Vang,8,1,1,0,0
2022-05-07,Hue City,Phu Vang,9,1,1,0,0
2022-05-07,Hue City,Phu Vang,10,4,4,0,0
2022-05-07,Hue City,Phu Vang,11,2,2,0,0
2022-05-07,Hue City,Phu Vang,13,6,3,3,3
2022-05-07,Hue City,Phu Vang,14,2,2,0,0
2022-05-07,Hue City,Phu Vang,15,4,2,2,0
2022-05-07,Hue City,Phu Vang,16,3,3,0,0
2022-05-07,Hue City,Phu Vang,17,5,2,3,0
2022-05-07,Hue City,Phu Vang,18,1,1,0,0
2022-05-07,Hue City,Phu Vang,19,2,1,1,1
2022-05-07,Vung Tau,Ba Ria City,7,1,0,1,0
2022-05-07,Vung Tau,Ba Ria City,8,4,1,3,2
2022-05-07,Vung Tau,Ba Ria City,9,12,7,5,5
2022-05-07,Vung Tau,Ba Ria City,10,7,5,2,2
2022-05-07,Vung Tau,Ba Ria City,11,8,7,1,1
2022-05-07,Vung Tau,Ba Ria City,12,2,1,1,0
2022-05-07,Vung Tau,Ba Ria City,13,6,6,0,0
2022-05-07,Vung Tau,Ba Ria City,14,3,2,1,1
2022-05-07,Vung Tau,Ba Ria City,15,8,5,3,3
2022-05-07,Vung Tau,Ba Ria City,16,6,3,3,3
2022-05-07,Vung Tau,Ba Ria City,17,5,1,4,4
2022-05-07,Vung Tau,Ba Ria City,18,9,3,6,5
2022-05-07,Vung Tau,Ba Ria City,19,13,0,13,13
2022-05-07,Vung Tau,Ba Ria City,20,6,0,6,5
2022-05-07,Vung Tau,Ba Ria City,21,2,0,2,2
2022-05-07,Vung Tau,Vung Tau City,0,2,2,0,0
2022-05-07,Vung Tau,Vung Tau City,1,1,1,0,0
2022-05-07,Vung Tau,Vung Tau City,2,1,1,0,0
2022-05-07,Vung Tau,Vung Tau City,5,4,4,0,0
2022-05-07,Vung Tau,Vung Tau City,6,36,28,8,6
2022-05-07,Vung Tau,Vung Tau City,7,108,93,15,6
2022-05-07,Vung Tau,Vung Tau City,8,171,163,8,2
2022-05-07,Vung Tau,Vung Tau City,9,157,145,12,1
2022-05-07,Vung Tau,Vung Tau City,10,204,196,8,0
2022-05-07,Vung Tau,Vung Tau City,11,377,352,25,3
2022-05-07,Vung Tau,Vung Tau City,12,313,300,13,0
2022-05-07,Vung Tau,Vung Tau City,13,230,211,19,3
2022-05-07,Vung Tau,Vung Tau City,14,225,205,20,3
2022-05-07,Vung Tau,Vung Tau City,15,222,203,19,6
2022-05-07,Vung Tau,Vung Tau City,16,222,202,20,2
2022-05-07,Vung Tau,Vung Tau City,17,310,281,29,2
2022-05-07,Vung Tau,Vung Tau City,18,361,320,41,23
2022-05-07,Vung Tau,Vung Tau City,19,319,271,48,20
2022-05-07,Vung Tau,Vung Tau City,20,225,195,30,5
2022-05-07,Vung Tau,Vung Tau City,21,141,82,59,30
2022-05-07,Vung Tau,Vung Tau City,22,1,1,0,0
2022-05-07,Vung Tau,Vung Tau City,23,1,0,1,0
2022-05-08,Binh Duong,Ben Cat,8,3,1,2,0
2022-05-08,Binh Duong,Ben Cat,10,1,0,1,1
2022-05-08,Binh Duong,Ben Cat,15,2,0,2,2
2022-05-08,Binh Duong,Ben Cat,20,1,0,1,1
2022-05-08,Binh Duong,Ben Cat,21,2,0,2,1
2022-05-08,Binh Duong,Di An,1,1,0,1,0
2022-05-08,Binh Duong,Di An,5,2,0,2,2
2022-05-08,Binh Duong,Di An,6,5,0,5,3
2022-05-08,Binh Duong,Di An,7,9,0,9,7
2022-05-08,Binh Duong,Di An,8,13,8,5,4
2022-05-08,Binh Duong,Di An,9,36,15,21,17
2022-05-08,Binh Duong,Di An,10,40,24,16,12
2022-05-08,Binh Duong,Di An,11,62,31,31,21
2022-05-08,Binh Duong,Di An,12,42,18,24,19
2022-05-08,Binh Duong,Di An,13,36,15,21,17
2022-05-08,Binh Duong,Di An,14,22,11,11,10
2022-05-08,Binh Duong,Di An,15,29,17,12,8
2022-05-08,Binh Duong,Di An,16,32,16,16,11
2022-05-08,Binh Duong,Di An,17,35,18,17,13
2022-05-08,Binh Duong,Di An,18,32,14,18,15
2022-05-08,Binh Duong,Di An,19,33,18,15,14
2022-05-08,Binh Duong,Di An,20,33,12,21,17
2022-05-08,Binh Duong,Di An,21,8,1,7,4
2022-05-08,Binh Duong,Tan Uyen,10,4,1,3,2
2022-05-08,Binh Duong,Tan Uyen,11,9,5,4,3
2022-05-08,Binh Duong,Tan Uyen,12,3,1,2,2
2022-05-08,Binh Duong,Tan Uyen,13,6,3,3,3
2022-05-08,Binh Duong,Tan Uyen,14,4,3,1,1
2022-05-08,Binh Duong,Tan Uyen,18,2,1,1,1
2022-05-08,Binh Duong,Tan Uyen,19,2,2,0,0
2022-05-08,Binh Duong,Thu Dau Mot Town,0,1,1,0,0
2022-05-08,Binh Duong,Thu Dau Mot Town,2,2,0,2,0
2022-05-08,Binh Duong,Thu Dau Mot Town,6,38,28,10,4
2022-05-08,Binh Duong,Thu Dau Mot Town,7,128,109,19,3
2022-05-08,Binh Duong,Thu Dau Mot Town,8,245,217,28,8
2022-05-08,Binh Duong,Thu Dau Mot Town,9,306,280,26,3
2022-05-08,Binh Duong,Thu Dau Mot Town,10,412,389,23,2
2022-05-08,Binh Duong,Thu Dau Mot Town,11,607,557,50,5
2022-05-08,Binh Duong,Thu Dau Mot Town,12,509,479,30,4
2022-05-08,Binh Duong,Thu Dau Mot Town,13,414,384,30,4
2022-05-08,Binh Duong,Thu Dau Mot Town,14,350,320,30,6
2022-05-08,Binh Duong,Thu Dau Mot Town,15,298,282,16,1
2022-05-08,Binh Duong,Thu Dau Mot Town,16,341,323,18,2
2022-05-08,Binh Duong,Thu Dau Mot Town,17,396,372,24,2
2022-05-08,Binh Duong,Thu Dau Mot Town,18,455,430,25,2
2022-05-08,Binh Duong,Thu Dau Mot Town,19,432,398,34,8
2022-05-08,Binh Duong,Thu Dau Mot Town,20,257,223,34,7
2022-05-08,Binh Duong,Thu Dau Mot Town,21,110,82,28,4
2022-05-08,Binh Duong,Thu Dau Mot Town,22,1,0,1,0
2022-05-08,Binh Duong,Thuan An,4,1,0,1,0
2022-05-08,Binh Duong,Thuan An,6,1,0,1,1
2022-05-08,Binh Duong,Thuan An,7,5,2,3,1
2022-05-08,Binh Duong,Thuan An,8,16,7,9,7
2022-05-08,Binh Duong,Thuan An,9,44,20,24,20
2022-05-08,Binh Duong,Thuan An,10,62,46,16,9
2022-05-08,Binh Duong,Thuan An,11,68,57,11,9
2022-05-08,Binh Duong,Thuan An,12,81,55,26,17
2022-05-08,Binh Duong,Thuan An,13,88,49,39,27
2022-05-08,Binh Duong,Thuan An,14,67,40,27,18
2022-05-08,Binh Duong,Thuan An,15,65,52,13,11
2022-05-08,Binh Duong,Thuan An,16,50,36,14,9
2022-05-08,Binh Duong,Thuan An,17,46,27,19,15
2022-05-08,Binh Duong,Thuan An,18,63,43,20,18
2022-05-08,Binh Duong,Thuan An,19,83,48,35,26
2022-05-08,Binh Duong,Thuan An,20,30,19,11,4
2022-05-08,Binh Duong,Thuan An,21,15,7,8,5
2022-05-08,Can Tho City,Binh Thuy District,6,1,1,0,0
2022-05-08,Can Tho City,Binh Thuy District,7,1,1,0,0
2022-05-08,Can Tho City,Binh Thuy District,8,4,3,1,0
2022-05-08,Can Tho City,Binh Thuy District,9,10,10,0,0
2022-05-08,Can Tho City,Binh Thuy District,10,8,7,1,0
2022-05-08,Can Tho City,Binh Thuy District,11,9,7,2,0
2022-05-08,Can Tho City,Binh Thuy District,12,23,20,3,0
2022-05-08,Can Tho City,Binh Thuy District,13,24,17,7,3
2022-05-08,Can Tho City,Binh Thuy District,14,10,9,1,1
2022-05-08,Can Tho City,Binh Thuy District,15,15,12,3,0
2022-05-08,Can Tho City,Binh Thuy District,16,21,19,2,1
2022-05-08,Can Tho City,Binh Thuy District,17,15,13,2,1
2022-05-08,Can Tho City,Binh Thuy District,18,21,18,3,2
2022-05-08,Can Tho City,Binh Thuy District,19,26,21,5,0
2022-05-08,Can Tho City,Binh Thuy District,20,21,17,4,2
2022-05-08,Can Tho City,Binh Thuy District,21,4,3,1,0
2022-05-08,Can Tho City,Cai Rang District,0,1,1,0,0
2022-05-08,Can Tho City,Cai Rang District,6,1,0,1,1
2022-05-08,Can Tho City,Cai Rang District,7,3,2,1,1
2022-05-08,Can Tho City,Cai Rang District,8,5,5,0,0
2022-05-08,Can Tho City,Cai Rang District,9,8,8,0,0
2022-05-08,Can Tho City,Cai Rang District,10,13,9,4,0
2022-05-08,Can Tho City,Cai Rang District,11,14,13,1,0
2022-05-08,Can Tho City,Cai Rang District,12,15,14,1,1
2022-05-08,Can Tho City,Cai Rang District,13,13,12,1,0
2022-05-08,Can Tho City,Cai Rang District,14,7,7,0,0
2022-05-08,Can Tho City,Cai Rang District,15,15,12,3,2
2022-05-08,Can Tho City,Cai Rang District,16,24,22,2,1
2022-05-08,Can Tho City,Cai Rang District,17,18,18,0,0
2022-05-08,Can Tho City,Cai Rang District,18,13,11,2,1
2022-05-08,Can Tho City,Cai Rang District,19,14,11,3,1
2022-05-08,Can Tho City,Cai Rang District,20,10,8,2,0
2022-05-08,Can Tho City,Cai Rang District,21,2,1,1,1
2022-05-08,Can Tho City,Ninh Kieu District,0,3,2,1,0
2022-05-08,Can Tho City,Ninh Kieu District,1,4,3,1,0
2022-05-08,Can Tho City,Ninh Kieu District,2,1,1,0,0
2022-05-08,Can Tho City,Ninh Kieu District,3,3,3,0,0
2022-05-08,Can Tho City,Ninh Kieu District,5,3,1,2,1
2022-05-08,Can Tho City,Ninh Kieu District,6,48,39,9,1
2022-05-08,Can Tho City,Ninh Kieu District,7,129,120,9,0
2022-05-08,Can Tho City,Ninh Kieu District,8,320,294,26,6
2022-05-08,Can Tho City,Ninh Kieu District,9,344,323,21,1
2022-05-08,Can Tho City,Ninh Kieu District,10,474,447,27,0
2022-05-08,Can Tho City,Ninh Kieu District,11,779,723,56,5
2022-05-08,Can Tho City,Ninh Kieu District,12,755,698,57,11
2022-05-08,Can Tho City,Ninh Kieu District,13,613,584,29,1
2022-05-08,Can Tho City,Ninh Kieu District,14,482,447,35,3
2022-05-08,Can Tho City,Ninh Kieu District,15,486,442,44,4
2022-05-08,Can Tho City,Ninh Kieu District,16,519,465,54,21
2022-05-08,Can Tho City,Ninh Kieu District,17,631,577,54,9
2022-05-08,Can Tho City,Ninh Kieu District,18,747,649,98,36
2022-05-08,Can Tho City,Ninh Kieu District,19,614,554,60,13
2022-05-08,Can Tho City,Ninh Kieu District,20,402,366,36,3
2022-05-08,Can Tho City,Ninh Kieu District,21,212,183,29,1
2022-05-08,Can Tho City,Ninh Kieu District,22,6,0,6,0
2022-05-08,Dong Nai,Bien Hoa City,0,5,4,1,1
2022-05-08,Dong Nai,Bien Hoa City,1,1,1,0,0
2022-05-08,Dong Nai,Bien Hoa City,2,1,1,0,0
2022-05-08,Dong Nai,Bien Hoa City,3,3,2,1,0
2022-05-08,Dong Nai,Bien Hoa City,4,1,0,1,0
2022-05-08,Dong Nai,Bien Hoa City,5,2,2,0,0
2022-05-08,Dong Nai,Bien Hoa City,6,59,38,21,16
2022-05-08,Dong Nai,Bien Hoa City,7,237,144,93,70
2022-05-08,Dong Nai,Bien Hoa City,8,423,298,125,82
2022-05-08,Dong Nai,Bien Hoa City,9,514,440,74,25
2022-05-08,Dong Nai,Bien Hoa City,10,871,748,123,47
2022-05-08,Dong Nai,Bien Hoa City,11,1260,1032,228,139
2022-05-08,Dong Nai,Bien Hoa City,12,1063,902,161,76
2022-05-08,Dong Nai,Bien Hoa City,13,821,681,140,88
2022-05-08,Dong Nai,Bien Hoa City,14,684,612,72,12
2022-05-08,Dong Nai,Bien Hoa City,15,635,542,93,34
2022-05-08,Dong Nai,Bien Hoa City,16,708,607,101,34
2022-05-08,Dong Nai,Bien Hoa City,17,705,610,95,46
2022-05-08,Dong Nai,Bien Hoa City,18,862,706,156,74
2022-05-08,Dong Nai,Bien Hoa City,19,872,650,222,148
2022-05-08,Dong Nai,Bien Hoa City,20,596,445,151,81
2022-05-08,Dong Nai,Bien Hoa City,21,259,172,87,36
2022-05-08,Dong Nai,Bien Hoa City,22,2,0,2,1
2022-05-08,Dong Nai,Bien Hoa City,23,1,0,1,0
2022-05-08,Dong Nai,Long Khanh,14,1,0,1,1
2022-05-08,Dong Nai,Long Khanh,15,1,0,1,1
2022-05-08,Dong Nai,Long Thanh,8,2,0,2,2
2022-05-08,Dong Nai,Long Thanh,9,2,0,2,2
2022-05-08,Dong Nai,Long Thanh,10,3,0,3,2
2022-05-08,Dong Nai,Long Thanh,11,2,0,2,2
2022-05-08,Dong Nai,Long Thanh,12,1,0,1,1
2022-05-08,Dong Nai,Long Thanh,13,3,0,3,3
2022-05-08,Dong Nai,Long Thanh,14,2,0,2,2
2022-05-08,Dong Nai,Long Thanh,16,1,0,1,1
2022-05-08,Dong Nai,Long Thanh,18,1,0,1,1
2022-05-08,Dong Nai,Long Thanh,19,1,0,1,1
2022-05-08,Dong Nai,Nhon trach,12,1,0,1,1
2022-05-08,Dong Nai,Nhon trach,13,1,0,1,1
2022-05-08,Dong Nai,Nhon trach,19,1,0,1,1
2022-05-08,Dong Nai,Nhon trach,20,2,0,2,2
2022-05-08,Dong Nai,Trang Bom,10,1,0,1,0
2022-05-08,Dong Nai,Trang Bom,11,3,0,3,3
2022-05-08,Dong Nai,Trang Bom,12,1,0,1,1
2022-05-08,Dong Nai,Trang Bom,13,2,1,1,1
2022-05-08,Dong Nai,Trang Bom,15,1,0,1,1
2022-05-08,Dong Nai,Trang Bom,20,1,0,1,0
2022-05-08,Dong Nai,Trang Bom,21,1,0,1,1
2022-05-08,Hai Phong City,An Duong,8,2,2,0,0
2022-05-08,Hai Phong City,An Duong,9,2,0,2,2
2022-05-08,Hai Phong City,An Duong,10,5,4,1,1
2022-05-08,Hai Phong City,An Duong,12,4,3,1,1
2022-05-08,Hai Phong City,An Duong,13,2,1,1,1
2022-05-08,Hai Phong City,An Duong,14,6,2,4,2
2022-05-08,Hai Phong City,An Duong,15,7,3,4,1
2022-05-08,Hai Phong City,An Duong,16,8,4,4,3
2022-05-08,Hai Phong City,An Duong,17,4,0,4,2
2022-05-08,Hai Phong City,An Duong,18,1,1,0,0
2022-05-08,Hai Phong City,An Duong,19,3,0,3,2
2022-05-08,Hai Phong City,An Duong,21,1,0,1,0
2022-05-08,Hai Phong City,Do Son District,10,1,0,1,1
2022-05-08,Hai Phong City,Duong Kinh District,14,1,0,1,1
2022-05-08,Hai Phong City,Hai An District,1,1,1,0,0
2022-05-08,Hai Phong City,Hai An District,7,8,3,5,4
2022-05-08,Hai Phong City,Hai An District,8,6,5,1,0
2022-05-08,Hai Phong City,Hai An District,9,12,11,1,0
2022-05-08,Hai Phong City,Hai An District,10,19,14,5,1
2022-05-08,Hai Phong City,Hai An District,11,47,36,11,7
2022-05-08,Hai Phong City,Hai An District,12,48,41,7,3
2022-05-08,Hai Phong City,Hai An District,13,17,13,4,0
2022-05-08,Hai Phong City,Hai An District,14,8,8,0,0
2022-05-08,Hai Phong City,Hai An District,15,17,8,9,2
2022-05-08,Hai Phong City,Hai An District,16,20,16,4,1
2022-05-08,Hai Phong City,Hai An District,17,21,17,4,3
2022-05-08,Hai Phong City,Hai An District,18,23,17,6,2
2022-05-08,Hai Phong City,Hai An District,19,29,19,10,2
2022-05-08,Hai Phong City,Hai An District,20,15,10,5,2
2022-05-08,Hai Phong City,Hai An District,21,3,3,0,0
2022-05-08,Hai Phong City,Hong Bang District,1,1,1,0,0
2022-05-08,Hai Phong City,Hong Bang District,7,15,4,11,10
2022-05-08,Hai Phong City,Hong Bang District,8,27,20,7,4
2022-05-08,Hai Phong City,Hong Bang District,9,35,28,7,2
2022-05-08,Hai Phong City,Hong Bang District,10,83,61,22,16
2022-05-08,Hai Phong City,Hong Bang District,11,128,88,40,28
2022-05-08,Hai Phong City,Hong Bang District,12,108,71,37,25
2022-05-08,Hai Phong City,Hong Bang District,13,36,33,3,1
2022-05-08,Hai Phong City,Hong Bang District,14,43,37,6,1
2022-05-08,Hai Phong City,Hong Bang District,15,44,38,6,5
2022-05-08,Hai Phong City,Hong Bang District,16,58,44,14,9
2022-05-08,Hai Phong City,Hong Bang District,17,72,53,19,8
2022-05-08,Hai Phong City,Hong Bang District,18,70,55,15,10
2022-05-08,Hai Phong City,Hong Bang District,19,49,34,15,13
2022-05-08,Hai Phong City,Hong Bang District,20,36,22,14,10
2022-05-08,Hai Phong City,Hong Bang District,21,21,12,9,6
2022-05-08,Hai Phong City,Hong Bang District,22,1,0,1,0
2022-05-08,Hai Phong City,Kien An District,0,1,0,1,0
2022-05-08,Hai Phong City,Kien An District,7,1,0,1,1
2022-05-08,Hai Phong City,Kien An District,8,2,1,1,1
2022-05-08,Hai Phong City,Kien An District,9,6,2,4,3
2022-05-08,Hai Phong City,Kien An District,10,24,11,13,11
2022-05-08,Hai Phong City,Kien An District,11,25,14,11,9
2022-05-08,Hai Phong City,Kien An District,12,15,7,8,5
2022-05-08,Hai Phong City,Kien An District,13,4,2,2,1
2022-05-08,Hai Phong City,Kien An District,14,8,6,2,1
2022-05-08,Hai Phong City,Kien An District,15,14,7,7,4
2022-05-08,Hai Phong City,Kien An District,16,5,2,3,2
2022-05-08,Hai Phong City,Kien An District,17,7,5,2,1
2022-05-08,Hai Phong City,Kien An District,18,8,6,2,1
2022-05-08,Hai Phong City,Kien An District,19,19,11,8,4
2022-05-08,Hai Phong City,Kien An District,20,13,4,9,9
2022-05-08,Hai Phong City,Le Chan District,1,1,0,1,1
2022-05-08,Hai Phong City,Le Chan District,2,2,0,2,0
2022-05-08,Hai Phong City,Le Chan District,5,1,0,1,1
2022-05-08,Hai Phong City,Le Chan District,6,4,3,1,1
2022-05-08,Hai Phong City,Le Chan District,7,50,24,26,18
2022-05-08,Hai Phong City,Le Chan District,8,84,69,15,5
2022-05-08,Hai Phong City,Le Chan District,9,111,91,20,4
2022-05-08,Hai Phong City,Le Chan District,10,231,199,32,9
2022-05-08,Hai Phong City,Le Chan District,11,350,261,89,59
2022-05-08,Hai Phong City,Le Chan District,12,278,223,55,32
2022-05-08,Hai Phong City,Le Chan District,13,142,116,26,4
2022-05-08,Hai Phong City,Le Chan District,14,147,130,17,2
2022-05-08,Hai Phong City,Le Chan District,15,164,138,26,6
2022-05-08,Hai Phong City,Le Chan District,16,198,168,30,14
2022-05-08,Hai Phong City,Le Chan District,17,217,168,49,20
2022-05-08,Hai Phong City,Le Chan District,18,220,186,34,21
2022-05-08,Hai Phong City,Le Chan District,19,217,148,69,38
2022-05-08,Hai Phong City,Le Chan District,20,150,115,35,16
2022-05-08,Hai Phong City,Le Chan District,21,57,34,23,14
2022-05-08,Hai Phong City,Le Chan District,22,1,0,1,0
2022-05-08,Hai Phong City,Ngo Quyen District,0,2,1,1,1
2022-05-08,Hai Phong City,Ngo Quyen District,6,1,0,1,1
2022-05-08,Hai Phong City,Ngo Quyen District,7,35,19,16,13
2022-05-08,Hai Phong City,Ngo Quyen District,8,67,54,13,6
2022-05-08,Hai Phong City,Ngo Quyen District,9,88,75,13,2
2022-05-08,Hai Phong City,Ngo Quyen District,10,182,161,21,10
2022-05-08,Hai Phong City,Ngo Quyen District,11,291,221,70,50
2022-05-08,Hai Phong City,Ngo Quyen District,12,219,174,45,27
2022-05-08,Hai Phong City,Ngo Quyen District,13,120,108,12,0
2022-05-08,Hai Phong City,Ngo Quyen District,14,91,81,10,1
2022-05-08,Hai Phong City,Ngo Quyen District,15,118,108,10,2
2022-05-08,Hai Phong City,Ngo Quyen District,16,130,110,20,6
2022-05-08,Hai Phong City,Ngo Quyen District,17,186,142,44,18
2022-05-08,Hai Phong City,Ngo Quyen District,18,236,170,66,38
2022-05-08,Hai Phong City,Ngo Quyen District,19,185,140,45,24
2022-05-08,Hai Phong City,Ngo Quyen District,20,127,95,32,17
2022-05-08,Hai Phong City,Ngo Quyen District,21,68,42,26,13
2022-05-08,Hai Phong City,Ngo Quyen District,22,1,0,1,0
2022-05-08,Hai Phong City,Thuy Nguyen,9,1,0,1,1
2022-05-08,Hai Phong City,Thuy Nguyen,11,2,0,2,2
2022-05-08,Hai Phong City,Thuy Nguyen,12,6,0,6,5
2022-05-08,Hai Phong City,Thuy Nguyen,13,6,0,6,2
2022-05-08,Hai Phong City,Thuy Nguyen,14,5,1,4,1
2022-05-08,Hai Phong City,Thuy Nguyen,15,4,1,3,3
2022-05-08,Hai Phong City,Thuy Nguyen,16,2,1,1,1
2022-05-08,Hai Phong City,Thuy Nguyen,17,2,0,2,2
2022-05-08,Hai Phong City,Thuy Nguyen,18,5,0,5,5
2022-05-08,Hue City,Hue City,0,3,3,0,0
2022-05-08,Hue City,Hue City,1,2,1,1,0
2022-05-08,Hue City,Hue City,4,1,1,0,0
2022-05-08,Hue City,Hue City,6,72,63,9,1
2022-05-08,Hue City,Hue City,7,203,190,13,3
2022-05-08,Hue City,Hue City,8,329,316,13,0
2022-05-08,Hue City,Hue City,9,306,280,26,1
2022-05-08,Hue City,Hue City,10,536,485,51,0
2022-05-08,Hue City,Hue City,11,948,863,85,6
2022-05-08,Hue City,Hue City,12,646,588,58,2
2022-05-08,Hue City,Hue City,13,368,344,24,0
2022-05-08,Hue City,Hue City,14,319,297,22,4
2022-05-08,Hue City,Hue City,15,373,335,38,4
2022-05-08,Hue City,Hue City,16,437,406,31,2
2022-05-08,Hue City,Hue City,17,599,554,45,9
2022-05-08,Hue City,Hue City,18,1019,715,304,194
2022-05-08,Hue City,Hue City,19,1002,634,368,252
2022-05-08,Hue City,Hue City,20,460,382,78,18
2022-05-08,Hue City,Hue City,21,317,218,99,42
2022-05-08,Hue City,Hue City,22,3,0,3,1
2022-05-08,Hue City,Huong Thuy,9,3,0,3,1
2022-05-08,Hue City,Huong Thuy,10,1,1,0,0
2022-05-08,Hue City,Huong Thuy,11,3,2,1,0
2022-05-08,Hue City,Huong Thuy,13,2,2,0,0
2022-05-08,Hue City,Huong Thuy,18,2,1,1,1
2022-05-08,Hue City,Huong Thuy,20,3,3,0,0
2022-05-08,Hue City,Huong Tra,7,1,1,0,0
2022-05-08,Hue City,Huong Tra,11,1,1,0,0
2022-05-08,Hue City,Huong Tra,15,1,1,0,0
2022-05-08,Hue City,Phu Vang,6,1,1,0,0
2022-05-08,Hue City,Phu Vang,7,1,0,1,1
2022-05-08,Hue City,Phu Vang,8,3,3,0,0
2022-05-08,Hue City,Phu Vang,10,7,5,2,1
2022-05-08,Hue City,Phu Vang,11,4,4,0,0
2022-05-08,Hue City,Phu Vang,12,2,2,0,0
2022-05-08,Hue City,Phu Vang,13,4,3,1,0
2022-05-08,Hue City,Phu Vang,15,2,2,0,0
2022-05-08,Hue City,Phu Vang,16,1,1,0,0
2022-05-08,Hue City,Phu Vang,17,2,2,0,0
2022-05-08,Hue City,Phu Vang,18,1,1,0,0
2022-05-08,Hue City,Phu Vang,19,4,4,0,0
2022-05-08,Hue City,Phu Vang,20,2,2,0,0
2022-05-08,Hue City,Phu Vang,21,2,1,1,0
2022-05-08,Vung Tau,Ba Ria City,7,1,0,1,0
2022-05-08,Vung Tau,Ba Ria City,8,8,0,8,8
2022-05-08,Vung Tau,Ba Ria City,9,11,3,8,5
2022-05-08,Vung Tau,Ba Ria City,10,12,3,9,7
2022-05-08,Vung Tau,Ba Ria City,11,16,11,5,3
2022-05-08,Vung Tau,Ba Ria City,12,12,6,6,6
2022-05-08,Vung Tau,Ba Ria City,13,5,2,3,3
2022-05-08,Vung Tau,Ba Ria City,14,7,4,3,3
2022-05-08,Vung Tau,Ba Ria City,15,8,3,5,5
2022-05-08,Vung Tau,Ba Ria City,16,10,1,9,9
2022-05-08,Vung Tau,Ba Ria City,17,13,1,12,10
2022-05-08,Vung Tau,Ba Ria City,18,13,2,11,10
2022-05-08,Vung Tau,Ba Ria City,19,10,0,10,10
2022-05-08,Vung Tau,Ba Ria City,20,9,0,9,6
2022-05-08,Vung Tau,Ba Ria City,21,6,0,6,2
2022-05-08,Vung Tau,Vung Tau City,2,1,1,0,0
2022-05-08,Vung Tau,Vung Tau City,5,1,0,1,0
2022-05-08,Vung Tau,Vung Tau City,6,40,35,5,2
2022-05-08,Vung Tau,Vung Tau City,7,141,116,25,10
2022-05-08,Vung Tau,Vung Tau City,8,203,184,19,5
2022-05-08,Vung Tau,Vung Tau City,9,262,235,27,7
2022-05-08,Vung Tau,Vung Tau City,10,286,263,23,3
2022-05-08,Vung Tau,Vung Tau City,11,425,379,46,12
2022-05-08,Vung Tau,Vung Tau City,12,349,325,24,2
2022-05-08,Vung Tau,Vung Tau City,13,232,215,17,2
2022-05-08,Vung Tau,Vung Tau City,14,240,223,17,4
2022-05-08,Vung Tau,Vung Tau City,15,227,211,16,5
2022-05-08,Vung Tau,Vung Tau City,16,238,219,19,2
2022-05-08,Vung Tau,Vung Tau City,17,300,271,29,8
2022-05-08,Vung Tau,Vung Tau City,18,396,284,112,69
2022-05-08,Vung Tau,Vung Tau City,19,345,293,52,11
2022-05-08,Vung Tau,Vung Tau City,20,213,181,32,13
2022-05-08,Vung Tau,Vung Tau City,21,111,74,37,22
2022-05-08,Vung Tau,Vung Tau City,22,1,0,1,0
2022-05-09,Binh Duong,Ben Cat,12,2,1,1,1
2022-05-09,Binh Duong,Ben Cat,14,4,1,3,3
2022-05-09,Binh Duong,Ben Cat,16,1,0,1,1
2022-05-09,Binh Duong,Ben Cat,19,2,1,1,1
2022-05-09,Binh Duong,Ben Cat,20,1,0,1,1
2022-05-09,Binh Duong,Di An,1,1,0,1,1
2022-05-09,Binh Duong,Di An,6,1,0,1,1
2022-05-09,Binh Duong,Di An,7,3,1,2,2
2022-05-09,Binh Duong,Di An,8,14,2,12,7
2022-05-09,Binh Duong,Di An,9,14,4,10,7
2022-05-09,Binh Duong,Di An,10,28,11,17,11
2022-05-09,Binh Duong,Di An,11,66,19,47,40
2022-05-09,Binh Duong,Di An,12,46,32,14,13
2022-05-09,Binh Duong,Di An,13,23,16,7,3
2022-05-09,Binh Duong,Di An,14,26,18,8,6
2022-05-09,Binh Duong,Di An,15,27,12,15,11
2022-05-09,Binh Duong,Di An,16,15,11,4,3
2022-05-09,Binh Duong,Di An,17,22,12,10,8
2022-05-09,Binh Duong,Di An,18,25,14,11,9
2022-05-09,Binh Duong,Di An,19,24,14,10,9
2022-05-09,Binh Duong,Di An,20,15,10,5,5
2022-05-09,Binh Duong,Di An,21,9,5,4,4
2022-05-09,Binh Duong,Tan Uyen,9,4,0,4,4
2022-05-09,Binh Duong,Tan Uyen,10,3,1,2,2
2022-05-09,Binh Duong,Tan Uyen,11,6,0,6,4
2022-05-09,Binh Duong,Tan Uyen,12,2,0,2,1
2022-05-09,Binh Duong,Tan Uyen,13,3,3,0,0
2022-05-09,Binh Duong,Tan Uyen,14,1,0,1,1
2022-05-09,Binh Duong,Tan Uyen,15,1,0,1,1
2022-05-09,Binh Duong,Tan Uyen,16,2,0,2,2
2022-05-09,Binh Duong,Tan Uyen,17,2,0,2,2
2022-05-09,Binh Duong,Tan Uyen,18,4,0,4,4
2022-05-09,Binh Duong,Tan Uyen,19,2,2,0,0
2022-05-09,Binh Duong,Tan Uyen,20,1,1,0,0
2022-05-09,Binh Duong,Tan Uyen,21,7,1,6,4
2022-05-09,Binh Duong,Thu Dau Mot Town,0,2,1,1,0
2022-05-09,Binh Duong,Thu Dau Mot Town,1,1,1,0,0
2022-05-09,Binh Duong,Thu Dau Mot Town,4,1,0,1,1
2022-05-09,Binh Duong,Thu Dau Mot Town,5,3,0,3,1
2022-05-09,Binh Duong,Thu Dau Mot Town,6,42,25,17,10
2022-05-09,Binh Duong,Thu Dau Mot Town,7,127,117,10,1
2022-05-09,Binh Duong,Thu Dau Mot Town,8,212,196,16,1
2022-05-09,Binh Duong,Thu Dau Mot Town,9,226,215,11,4
2022-05-09,Binh Duong,Thu Dau Mot Town,10,384,362,22,2
2022-05-09,Binh Duong,Thu Dau Mot Town,11,626,578,48,4
2022-05-09,Binh Duong,Thu Dau Mot Town,12,471,450,21,2
2022-05-09,Binh Duong,Thu Dau Mot Town,13,417,396,21,3
2022-05-09,Binh Duong,Thu Dau Mot Town,14,310,293,17,4
2022-05-09,Binh Duong,Thu Dau Mot Town,15,246,231,15,2
2022-05-09,Binh Duong,Thu Dau Mot Town,16,254,240,14,1
2022-05-09,Binh Duong,Thu Dau Mot Town,17,342,322,20,2
2022-05-09,Binh Duong,Thu Dau Mot Town,18,378,355,23,8
2022-05-09,Binh Duong,Thu Dau Mot Town,19,334,308,26,0
2022-05-09,Binh Duong,Thu Dau Mot Town,20,228,209,19,3
2022-05-09,Binh Duong,Thu Dau Mot Town,21,132,113,19,7
2022-05-09,Binh Duong,Thu Dau Mot Town,22,2,0,2,0
2022-05-09,Binh Duong,Thuan An,7,6,2,4,1
2022-05-09,Binh Duong,Thuan An,8,9,6,3,3
2022-05-09,Binh Duong,Thuan An,9,27,23,4,2
2022-05-09,Binh Duong,Thuan An,10,52,43,9,2
2022-05-09,Binh Duong,Thuan An,11,56,46,10,5
2022-05-09,Binh Duong,Thuan An,12,54,43,11,7
2022-05-09,Binh Duong,Thuan An,13,62,42,20,11
2022-05-09,Binh Duong,Thuan An,14,39,31,8,6
2022-05-09,Binh Duong,Thuan An,15,34,23,11,10
2022-05-09,Binh Duong,Thuan An,16,31,27,4,2
2022-05-09,Binh Duong,Thuan An,17,32,26,6,2
2022-05-09,Binh Duong,Thuan An,18,52,36,16,8
2022-05-09,Binh Duong,Thuan An,19,29,21,8,4
2022-05-09,Binh Duong,Thuan An,20,32,29,3,3
2022-05-09,Binh Duong,Thuan An,21,10,4,6,6
2022-05-09,Can Tho City,Binh Thuy District,7,4,3,1,0
2022-05-09,Can Tho City,Binh Thuy District,8,6,5,1,1
2022-05-09,Can Tho City,Binh Thuy District,9,6,5,1,0
2022-05-09,Can Tho City,Binh Thuy District,10,14,12,2,0
2022-05-09,Can Tho City,Binh Thuy District,11,18,15,3,1
2022-05-09,Can Tho City,Binh Thuy District,12,12,11,1,0
2022-05-09,Can Tho City,Binh Thuy District,13,14,12,2,0
2022-05-09,Can Tho City,Binh Thuy District,14,9,9,0,0
2022-05-09,Can Tho City,Binh Thuy District,15,13,12,1,0
2022-05-09,Can Tho City,Binh Thuy District,16,9,9,0,0
2022-05-09,Can Tho City,Binh Thuy District,17,18,17,1,0
2022-05-09,Can Tho City,Binh Thuy District,18,17,16,1,0
2022-05-09,Can Tho City,Binh Thuy District,19,21,20,1,0
2022-05-09,Can Tho City,Binh Thuy District,20,17,16,1,0
2022-05-09,Can Tho City,Binh Thuy District,21,6,4,2,0
2022-05-09,Can Tho City,Cai Rang District,7,3,2,1,0
2022-05-09,Can Tho City,Cai Rang District,8,7,6,1,0
2022-05-09,Can Tho City,Cai Rang District,9,2,1,1,1
2022-05-09,Can Tho City,Cai Rang District,10,11,10,1,0
2022-05-09,Can Tho City,Cai Rang District,11,8,8,0,0
2022-05-09,Can Tho City,Cai Rang District,12,8,7,1,0
2022-05-09,Can Tho City,Cai Rang District,13,10,8,2,0
2022-05-09,Can Tho City,Cai Rang District,14,10,8,2,1
2022-05-09,Can Tho City,Cai Rang District,15,6,5,1,0
2022-05-09,Can Tho City,Cai Rang District,16,11,7,4,0
2022-05-09,Can Tho City,Cai Rang District,17,7,7,0,0
2022-05-09,Can Tho City,Cai Rang District,18,7,7,0,0
2022-05-09,Can Tho City,Cai Rang District,19,18,16,2,2
2022-05-09,Can Tho City,Cai Rang District,20,9,6,3,0
2022-05-09,Can Tho City,Cai Rang District,21,3,1,2,0
2022-05-09,Can Tho City,Ninh Kieu District,0,3,2,1,0
2022-05-09,Can Tho City,Ninh Kieu District,1,4,2,2,0
2022-05-09,Can Tho City,Ninh Kieu District,2,1,0,1,0
2022-05-09,Can Tho City,Ninh Kieu District,3,2,2,0,0
2022-05-09,Can Tho City,Ninh Kieu District,4,3,3,0,0
2022-05-09,Can Tho City,Ninh Kieu District,5,2,0,2,1
2022-05-09,Can Tho City,Ninh Kieu District,6,51,45,6,1
2022-05-09,Can Tho City,Ninh Kieu District,7,128,123,5,0
2022-05-09,Can Tho City,Ninh Kieu District,8,234,212,22,0
2022-05-09,Can Tho City,Ninh Kieu District,9,289,277,12,0
2022-05-09,Can Tho City,Ninh Kieu District,10,534,515,19,0
2022-05-09,Can Tho City,Ninh Kieu District,11,878,796,82,21
2022-05-09,Can Tho City,Ninh Kieu District,12,677,632,45,5
2022-05-09,Can Tho City,Ninh Kieu District,13,483,463,20,0
2022-05-09,Can Tho City,Ninh Kieu District,14,389,377,12,0
2022-05-09,Can Tho City,Ninh Kieu District,15,345,325,20,0
2022-05-09,Can Tho City,Ninh Kieu District,16,438,419,19,0
2022-05-09,Can Tho City,Ninh Kieu District,17,540,510,30,0
2022-05-09,Can Tho City,Ninh Kieu District,18,560,539,21,0
2022-05-09,Can Tho City,Ninh Kieu District,19,443,421,22,0
2022-05-09,Can Tho City,Ninh Kieu District,20,372,343,29,0
2022-05-09,Can Tho City,Ninh Kieu District,21,216,199,17,0
2022-05-09,Can Tho City,Ninh Kieu District,22,2,0,2,0
2022-05-09,Can Tho City,Phong Dien,11,1,0,1,1
2022-05-09,Can Tho City,Phong Dien,12,1,0,1,1
2022-05-09,Can Tho City,Phong Dien,13,1,0,1,1
2022-05-09,Can Tho City,Phong Dien,15,1,0,1,1
2022-05-09,Dong Nai,Bien Hoa City,0,1,1,0,0
2022-05-09,Dong Nai,Bien Hoa City,4,2,1,1,1
2022-05-09,Dong Nai,Bien Hoa City,5,3,2,1,1
2022-05-09,Dong Nai,Bien Hoa City,6,50,25,25,18
2022-05-09,Dong Nai,Bien Hoa City,7,137,118,19,9
2022-05-09,Dong Nai,Bien Hoa City,8,282,250,32,14
2022-05-09,Dong Nai,Bien Hoa City,9,404,359,45,7
2022-05-09,Dong Nai,Bien Hoa City,10,744,682,62,12
2022-05-09,Dong Nai,Bien Hoa City,11,1140,1034,106,33
2022-05-09,Dong Nai,Bien Hoa City,12,877,812,65,14
2022-05-09,Dong Nai,Bien Hoa City,13,788,742,46,8
2022-05-09,Dong Nai,Bien Hoa City,14,663,611,52,13
2022-05-09,Dong Nai,Bien Hoa City,15,546,498,48,17
2022-05-09,Dong Nai,Bien Hoa City,16,484,427,57,14
2022-05-09,Dong Nai,Bien Hoa City,17,636,576,60,15
2022-05-09,Dong Nai,Bien Hoa City,18,701,642,59,9
2022-05-09,Dong Nai,Bien Hoa City,19,638,577,61,15
2022-05-09,Dong Nai,Bien Hoa City,20,473,418,55,9
2022-05-09,Dong Nai,Bien Hoa City,21,241,159,82,32
2022-05-09,Dong Nai,Cam My,13,1,0,1,1
2022-05-09,Dong Nai,Long Khanh,11,1,0,1,1
2022-05-09,Dong Nai,Long Thanh,10,4,0,4,4
2022-05-09,Dong Nai,Long Thanh,19,1,0,1,1
2022-05-09,Dong Nai,Nhon trach,11,1,0,1,1
2022-05-09,Dong Nai,Nhon trach,17,1,0,1,1
2022-05-09,Dong Nai,Nhon trach,18,1,0,1,1
2022-05-09,Dong Nai,Nhon trach,19,1,0,1,1
2022-05-09,Dong Nai,Nhon trach,20,2,0,2,1
2022-05-09,Dong Nai,Trang Bom,10,1,0,1,1
2022-05-09,Dong Nai,Trang Bom,11,1,0,1,1
2022-05-09,Dong Nai,Trang Bom,12,2,0,2,2
2022-05-09,Dong Nai,Trang Bom,13,2,0,2,2
2022-05-09,Dong Nai,Trang Bom,16,1,0,1,1
2022-05-09,Dong Nai,Trang Bom,19,3,1,2,2
2022-05-09,Dong Nai,Trang Bom,20,1,0,1,1
2022-05-09,Hai Phong City,An Duong,8,2,1,1,1
2022-05-09,Hai Phong City,An Duong,9,4,2,2,2
2022-05-09,Hai Phong City,An Duong,10,5,1,4,4
2022-05-09,Hai Phong City,An Duong,11,5,1,4,2
2022-05-09,Hai Phong City,An Duong,12,4,1,3,3
2022-05-09,Hai Phong City,An Duong,13,6,0,6,4
2022-05-09,Hai Phong City,An Duong,14,8,3,5,4
2022-05-09,Hai Phong City,An Duong,15,4,1,3,3
2022-05-09,Hai Phong City,An Duong,16,1,0,1,1
2022-05-09,Hai Phong City,An Duong,17,6,1,5,3
2022-05-09,Hai Phong City,An Duong,18,3,0,3,1
2022-05-09,Hai Phong City,An Duong,19,1,0,1,1
2022-05-09,Hai Phong City,An Duong,20,1,1,0,0
2022-05-09,Hai Phong City,Do Son District,16,1,0,1,0
2022-05-09,Hai Phong City,Do Son District,17,2,0,2,1
2022-05-09,Hai Phong City,Duong Kinh District,17,1,0,1,1
2022-05-09,Hai Phong City,Duong Kinh District,19,1,0,1,1
2022-05-09,Hai Phong City,Hai An District,7,10,6,4,4
2022-05-09,Hai Phong City,Hai An District,8,6,4,2,0
2022-05-09,Hai Phong City,Hai An District,9,10,8,2,0
2022-05-09,Hai Phong City,Hai An District,10,21,19,2,1
2022-05-09,Hai Phong City,Hai An District,11,43,34,9,5
2022-05-09,Hai Phong City,Hai An District,12,32,29,3,0
2022-05-09,Hai Phong City,Hai An District,13,14,14,0,0
2022-05-09,Hai Phong City,Hai An District,14,14,12,2,0
2022-05-09,Hai Phong City,Hai An District,15,16,16,0,0
2022-05-09,Hai Phong City,Hai An District,16,14,12,2,0
2022-05-09,Hai Phong City,Hai An District,17,24,21,3,1
2022-05-09,Hai Phong City,Hai An District,18,32,28,4,1
2022-05-09,Hai Phong City,Hai An District,19,20,17,3,0
2022-05-09,Hai Phong City,Hai An District,20,7,7,0,0
2022-05-09,Hai Phong City,Hai An District,21,11,2,9,6
2022-05-09,Hai Phong City,Hong Bang District,7,24,12,12,6
2022-05-09,Hai Phong City,Hong Bang District,8,23,16,7,4
2022-05-09,Hai Phong City,Hong Bang District,9,26,23,3,3
2022-05-09,Hai Phong City,Hong Bang District,10,58,51,7,2
2022-05-09,Hai Phong City,Hong Bang District,11,122,111,11,1
2022-05-09,Hai Phong City,Hong Bang District,12,66,59,7,3
2022-05-09,Hai Phong City,Hong Bang District,13,49,43,6,4
2022-05-09,Hai Phong City,Hong Bang District,14,41,33,8,2
2022-05-09,Hai Phong City,Hong Bang District,15,53,43,10,1
2022-05-09,Hai Phong City,Hong Bang District,16,39,36,3,0
2022-05-09,Hai Phong City,Hong Bang District,17,45,41,4,0
2022-05-09,Hai Phong City,Hong Bang District,18,57,53,4,0
2022-05-09,Hai Phong City,Hong Bang District,19,48,41,7,2
2022-05-09,Hai Phong City,Hong Bang District,20,30,23,7,2
2022-05-09,Hai Phong City,Hong Bang District,21,18,8,10,9
2022-05-09,Hai Phong City,Kien An District,0,2,1,1,0
2022-05-09,Hai Phong City,Kien An District,1,1,0,1,1
2022-05-09,Hai Phong City,Kien An District,8,5,1,4,3
2022-05-09,Hai Phong City,Kien An District,9,7,6,1,0
2022-05-09,Hai Phong City,Kien An District,10,8,5,3,3
2022-05-09,Hai Phong City,Kien An District,11,15,10,5,2
2022-05-09,Hai Phong City,Kien An District,12,10,6,4,3
2022-05-09,Hai Phong City,Kien An District,13,4,2,2,1
2022-05-09,Hai Phong City,Kien An District,14,16,7,9,7
2022-05-09,Hai Phong City,Kien An District,15,7,2,5,4
2022-05-09,Hai Phong City,Kien An District,16,4,2,2,2
2022-05-09,Hai Phong City,Kien An District,17,8,7,1,0
2022-05-09,Hai Phong City,Kien An District,18,13,11,2,0
2022-05-09,Hai Phong City,Kien An District,19,8,6,2,1
2022-05-09,Hai Phong City,Kien An District,20,15,3,12,8
2022-05-09,Hai Phong City,Kien An District,21,6,0,6,5
2022-05-09,Hai Phong City,Le Chan District,5,1,1,0,0
2022-05-09,Hai Phong City,Le Chan District,6,5,1,4,0
2022-05-09,Hai Phong City,Le Chan District,7,39,21,18,16
2022-05-09,Hai Phong City,Le Chan District,8,73,65,8,3
2022-05-09,Hai Phong City,Le Chan District,9,65,61,4,0
2022-05-09,Hai Phong City,Le Chan District,10,145,132,13,0
2022-05-09,Hai Phong City,Le Chan District,11,256,225,31,14
2022-05-09,Hai Phong City,Le Chan District,12,180,171,9,2
2022-05-09,Hai Phong City,Le Chan District,13,86,80,6,0
2022-05-09,Hai Phong City,Le Chan District,14,125,105,20,3
2022-05-09,Hai Phong City,Le Chan District,15,124,106,18,4
2022-05-09,Hai Phong City,Le Chan District,16,103,97,6,0
2022-05-09,Hai Phong City,Le Chan District,17,136,129,7,1
2022-05-09,Hai Phong City,Le Chan District,18,175,166,9,0
2022-05-09,Hai Phong City,Le Chan District,19,183,158,25,3
2022-05-09,Hai Phong City,Le Chan District,20,128,99,29,10
2022-05-09,Hai Phong City,Le Chan District,21,67,38,29,23
2022-05-09,Hai Phong City,Le Chan District,23,1,0,1,0
2022-05-09,Hai Phong City,Ngo Quyen District,0,1,0,1,1
2022-05-09,Hai Phong City,Ngo Quyen District,4,1,0,1,0
2022-05-09,Hai Phong City,Ngo Quyen District,5,1,0,1,1
2022-05-09,Hai Phong City,Ngo Quyen District,6,2,1,1,0
2022-05-09,Hai Phong City,Ngo Quyen District,7,26,16,10,7
2022-05-09,Hai Phong City,Ngo Quyen District,8,59,54,5,0
2022-05-09,Hai Phong City,Ngo Quyen District,9,58,50,8,1
2022-05-09,Hai Phong City,Ngo Quyen District,10,116,108,8,3
2022-05-09,Hai Phong City,Ngo Quyen District,11,220,192,28,15
2022-05-09,Hai Phong City,Ngo Quyen District,12,138,132,6,1
2022-05-09,Hai Phong City,Ngo Quyen District,13,80,71,9,1
2022-05-09,Hai Phong City,Ngo Quyen District,14,108,90,18,4
2022-05-09,Hai Phong City,Ngo Quyen District,15,124,108,16,4
2022-05-09,Hai Phong City,Ngo Quyen District,16,79,68,11,0
2022-05-09,Hai Phong City,Ngo Quyen District,17,102,87,15,0
2022-05-09,Hai Phong City,Ngo Quyen District,18,132,126,6,0
2022-05-09,Hai Phong City,Ngo Quyen District,19,132,117,15,1
2022-05-09,Hai Phong City,Ngo Quyen District,20,109,87,22,5
2022-05-09,Hai Phong City,Ngo Quyen District,21,71,40,31,28
2022-05-09,Hai Phong City,Thuy Nguyen,10,1,0,1,1
2022-05-09,Hai Phong City,Thuy Nguyen,11,1,0,1,1
2022-05-09,Hai Phong City,Thuy Nguyen,14,1,0,1,1
2022-05-09,Hai Phong City,Thuy Nguyen,16,1,0,1,1
2022-05-09,Hai Phong City,Thuy Nguyen,17,1,0,1,1
2022-05-09,Hai Phong City,Thuy Nguyen,20,1,1,0,0
2022-05-09,Hue City,Hue City,0,2,0,2,0
2022-05-09,Hue City,Hue City,1,1,0,1,0
2022-05-09,Hue City,Hue City,5,2,2,0,0
2022-05-09,Hue City,Hue City,6,58,48,10,2
2022-05-09,Hue City,Hue City,7,193,182,11,2
2022-05-09,Hue City,Hue City,8,264,254,10,2
2022-05-09,Hue City,Hue City,9,277,240,37,1
2022-05-09,Hue City,Hue City,10,372,349,23,0
2022-05-09,Hue City,Hue City,11,810,762,48,3
2022-05-09,Hue City,Hue City,12,510,475,35,0
2022-05-09,Hue City,Hue City,13,368,347,21,0
2022-05-09,Hue City,Hue City,14,367,343,24,3
2022-05-09,Hue City,Hue City,15,345,315,30,4
2022-05-09,Hue City,Hue City,16,311,290,21,0
2022-05-09,Hue City,Hue City,17,558,519,39,1
2022-05-09,Hue City,Hue City,18,680,619,61,4
2022-05-09,Hue City,Hue City,19,600,555,45,1
2022-05-09,Hue City,Hue City,20,440,390,50,6
2022-05-09,Hue City,Hue City,21,247,210,37,8
2022-05-09,Hue City,Hue City,22,2,0,2,0
2022-05-09,Hue City,Huong Thuy,7,1,0,1,1
2022-05-09,Hue City,Huong Thuy,9,1,0,1,1
2022-05-09,Hue City,Huong Thuy,10,2,1,1,0
2022-05-09,Hue City,Huong Thuy,17,1,1,0,0
2022-05-09,Hue City,Huong Thuy,18,2,2,0,0
2022-05-09,Hue City,Huong Thuy,19,1,1,0,0
2022-05-09,Hue City,Huong Thuy,20,5,1,4,3
2022-05-09,Hue City,Huong Thuy,21,1,0,1,0
2022-05-09,Hue City,Huong Tra,20,1,0,1,0
2022-05-09,Hue City,Phu Vang,6,1,1,0,0
2022-05-09,Hue City,Phu Vang,7,1,1,0,0
2022-05-09,Hue City,Phu Vang,8,3,3,0,0
2022-05-09,Hue City,Phu Vang,9,1,1,0,0
2022-05-09,Hue City,Phu Vang,10,1,0,1,1
2022-05-09,Hue City,Phu Vang,11,5,4,1,0
2022-05-09,Hue City,Phu Vang,12,2,2,0,0
2022-05-09,Hue City,Phu Vang,14,3,3,0,0
2022-05-09,Hue City,Phu Vang,15,4,0,4,0
2022-05-09,Hue City,Phu Vang,16,6,4,2,0
2022-05-09,Hue City,Phu Vang,17,4,4,0,0
2022-05-09,Hue City,Phu Vang,18,8,6,2,0
2022-05-09,Hue City,Phu Vang,19,2,2,0,0
2022-05-09,Hue City,Phu Vang,20,5,1,4,1
2022-05-09,Vung Tau,Ba Ria City,7,3,0,3,3
2022-05-09,Vung Tau,Ba Ria City,8,3,2,1,1
2022-05-09,Vung Tau,Ba Ria City,10,14,6,8,8
2022-05-09,Vung Tau,Ba Ria City,11,15,6,9,7
2022-05-09,Vung Tau,Ba Ria City,12,10,4,6,4
2022-05-09,Vung Tau,Ba Ria City,13,8,3,5,4
2022-05-09,Vung Tau,Ba Ria City,14,6,3,3,3
2022-05-09,Vung Tau,Ba Ria City,15,6,5,1,0
2022-05-09,Vung Tau,Ba Ria City,16,4,3,1,0
2022-05-09,Vung Tau,Ba Ria City,17,2,2,0,0
2022-05-09,Vung Tau,Ba Ria City,18,4,3,1,1
2022-05-09,Vung Tau,Ba Ria City,19,4,0,4,4
2022-05-09,Vung Tau,Ba Ria City,20,3,0,3,3
2022-05-09,Vung Tau,Vung Tau City,0,2,1,1,0
2022-05-09,Vung Tau,Vung Tau City,1,1,0,1,0
2022-05-09,Vung Tau,Vung Tau City,4,1,0,1,1
2022-05-09,Vung Tau,Vung Tau City,5,1,0,1,1
2022-05-09,Vung Tau,Vung Tau City,6,29,27,2,2
2022-05-09,Vung Tau,Vung Tau City,7,80,73,7,2
2022-05-09,Vung Tau,Vung Tau City,8,161,149,12,1
2022-05-09,Vung Tau,Vung Tau City,9,162,149,13,2
2022-05-09,Vung Tau,Vung Tau City,10,191,169,22,10
2022-05-09,Vung Tau,Vung Tau City,11,335,302,33,9
2022-05-09,Vung Tau,Vung Tau City,12,251,237,14,0
2022-05-09,Vung Tau,Vung Tau City,13,201,188,13,1
2022-05-09,Vung Tau,Vung Tau City,14,222,201,21,7
2022-05-09,Vung Tau,Vung Tau City,15,184,178,6,2
2022-05-09,Vung Tau,Vung Tau City,16,170,157,13,2
2022-05-09,Vung Tau,Vung Tau City,17,235,214,21,4
2022-05-09,Vung Tau,Vung Tau City,18,302,274,28,4
2022-05-09,Vung Tau,Vung Tau City,19,269,234,35,11
2022-05-09,Vung Tau,Vung Tau City,20,191,165,26,6
2022-05-09,Vung Tau,Vung Tau City,21,111,80,31,26
2022-05-09,Vung Tau,Vung Tau City,23,1,0,1,0
2022-05-10,Binh Duong,Ben Cat,8,1,0,1,1
2022-05-10,Binh Duong,Ben Cat,12,2,0,2,2
2022-05-10,Binh Duong,Ben Cat,13,2,0,2,1
2022-05-10,Binh Duong,Ben Cat,14,2,1,1,1
2022-05-10,Binh Duong,Ben Cat,15,1,0,1,1
2022-05-10,Binh Duong,Ben Cat,16,1,0,1,1
2022-05-10,Binh Duong,Di An,0,1,1,0,0
2022-05-10,Binh Duong,Di An,6,1,0,1,1
2022-05-10,Binh Duong,Di An,7,4,1,3,2
2022-05-10,Binh Duong,Di An,8,22,4,18,14
2022-05-10,Binh Duong,Di An,9,14,5,9,8
2022-05-10,Binh Duong,Di An,10,27,10,17,14
2022-05-10,Binh Duong,Di An,11,29,9,20,18
2022-05-10,Binh Duong,Di An,12,29,15,14,14
2022-05-10,Binh Duong,Di An,13,43,19,24,15
2022-05-10,Binh Duong,Di An,14,39,10,29,23
2022-05-10,Binh Duong,Di An,15,30,14,16,11
2022-05-10,Binh Duong,Di An,16,33,13,20,14
2022-05-10,Binh Duong,Di An,17,24,14,10,8
2022-05-10,Binh Duong,Di An,18,14,6,8,4
2022-05-10,Binh Duong,Di An,19,21,19,2,2
2022-05-10,Binh Duong,Di An,20,14,6,8,4
2022-05-10,Binh Duong,Di An,21,5,2,3,2
2022-05-10,Binh Duong,Tan Uyen,9,1,0,1,1
2022-05-10,Binh Duong,Tan Uyen,10,1,0,1,0
2022-05-10,Binh Duong,Tan Uyen,11,4,1,3,3
2022-05-10,Binh Duong,Tan Uyen,12,3,2,1,1
2022-05-10,Binh Duong,Tan Uyen,13,5,3,2,1
2022-05-10,Binh Duong,Tan Uyen,14,1,1,0,0
2022-05-10,Binh Duong,Tan Uyen,15,3,2,1,1
2022-05-10,Binh Duong,Tan Uyen,16,1,1,0,0
2022-05-10,Binh Duong,Tan Uyen,17,1,0,1,1
2022-05-10,Binh Duong,Tan Uyen,18,2,0,2,1
2022-05-10,Binh Duong,Tan Uyen,19,1,0,1,1
2022-05-10,Binh Duong,Tan Uyen,20,2,0,2,1
2022-05-10,Binh Duong,Tan Uyen,21,1,0,1,1
2022-05-10,Binh Duong,Tan Uyen,22,1,0,1,0
2022-05-10,Binh Duong,Thu Dau Mot Town,3,1,0,1,0
2022-05-10,Binh Duong,Thu Dau Mot Town,6,51,35,16,9
2022-05-10,Binh Duong,Thu Dau Mot Town,7,116,109,7,2
2022-05-10,Binh Duong,Thu Dau Mot Town,8,230,210,20,3
2022-05-10,Binh Duong,Thu Dau Mot Town,9,204,196,8,1
2022-05-10,Binh Duong,Thu Dau Mot Town,10,395,371,24,1
2022-05-10,Binh Duong,Thu Dau Mot Town,11,649,606,43,4
2022-05-10,Binh Duong,Thu Dau Mot Town,12,436,412,24,1
2022-05-10,Binh Duong,Thu Dau Mot Town,13,417,403,14,3
2022-05-10,Binh Duong,Thu Dau Mot Town,14,299,284,15,0
2022-05-10,Binh Duong,Thu Dau Mot Town,15,152,133,19,8
2022-05-10,Binh Duong,Thu Dau Mot Town,16,273,223,50,28
2022-05-10,Binh Duong,Thu Dau Mot Town,17,391,364,27,8
2022-05-10,Binh Duong,Thu Dau Mot Town,18,409,391,18,2
2022-05-10,Binh Duong,Thu Dau Mot Town,19,359,333,26,3
2022-05-10,Binh Duong,Thu Dau Mot Town,20,271,247,24,2
2022-05-10,Binh Duong,Thu Dau Mot Town,21,126,107,19,7
2022-05-10,Binh Duong,Thu Dau Mot Town,22,1,0,1,0
2022-05-10,Binh Duong,Thuan An,6,1,1,0,0
2022-05-10,Binh Duong,Thuan An,7,7,3,4,2
2022-05-10,Binh Duong,Thuan An,8,10,8,2,2
2022-05-10,Binh Duong,Thuan An,9,25,17,8,4
2022-05-10,Binh Duong,Thuan An,10,43,35,8,6
2022-05-10,Binh Duong,Thuan An,11,99,67,32,21
2022-05-10,Binh Duong,Thuan An,12,61,44,17,11
2022-05-10,Binh Duong,Thuan An,13,73,54,19,9
2022-05-10,Binh Duong,Thuan An,14,39,25,14,8
2022-05-10,Binh Duong,Thuan An,15,31,15,16,13
2022-05-10,Binh Duong,Thuan An,16,37,21,16,13
2022-05-10,Binh Duong,Thuan An,17,50,37,13,8
2022-05-10,Binh Duong,Thuan An,18,48,36,12,4
2022-05-10,Binh Duong,Thuan An,19,53,39,14,9
2022-05-10,Binh Duong,Thuan An,20,34,26,8,5
2022-05-10,Binh Duong,Thuan An,21,21,9,12,11
2022-05-10,Can Tho City,Binh Thuy District,6,2,1,1,1
2022-05-10,Can Tho City,Binh Thuy District,8,1,1,0,0
2022-05-10,Can Tho City,Binh Thuy District,9,8,6,2,0
2022-05-10,Can Tho City,Binh Thuy District,10,15,13,2,0
2022-05-10,Can Tho City,Binh Thuy District,11,3,2,1,1
2022-05-10,Can Tho City,Binh Thuy District,12,14,12,2,0
2022-05-10,Can Tho City,Binh Thuy District,13,15,15,0,0
2022-05-10,Can Tho City,Binh Thuy District,14,12,12,0,0
2022-05-10,Can Tho City,Binh Thuy District,15,8,6,2,0
2022-05-10,Can Tho City,Binh Thuy District,16,13,10,3,1
2022-05-10,Can Tho City,Binh Thuy District,17,19,18,1,0
2022-05-10,Can Tho City,Binh Thuy District,18,19,17,2,0
2022-05-10,Can Tho City,Binh Thuy District,19,17,15,2,0
2022-05-10,Can Tho City,Binh Thuy District,20,15,15,0,0
2022-05-10,Can Tho City,Binh Thuy District,21,4,3,1,1
2022-05-10,Can Tho City,Cai Rang District,6,2,1,1,0
2022-05-10,Can Tho City,Cai Rang District,7,6,4,2,1
2022-05-10,Can Tho City,Cai Rang District,8,5,4,1,0
2022-05-10,Can Tho City,Cai Rang District,9,9,8,1,1
2022-05-10,Can Tho City,Cai Rang District,10,11,10,1,0
2022-05-10,Can Tho City,Cai Rang District,11,9,9,0,0
2022-05-10,Can Tho City,Cai Rang District,12,14,12,2,0
2022-05-10,Can Tho City,Cai Rang District,13,8,8,0,0
2022-05-10,Can Tho City,Cai Rang District,14,6,5,1,1
2022-05-10,Can Tho City,Cai Rang District,15,3,3,0,0
2022-05-10,Can Tho City,Cai Rang District,16,10,10,0,0
2022-05-10,Can Tho City,Cai Rang District,17,12,9,3,1
2022-05-10,Can Tho City,Cai Rang District,18,16,12,4,0
2022-05-10,Can Tho City,Cai Rang District,19,11,10,1,1
2022-05-10,Can Tho City,Cai Rang District,20,14,9,5,1
2022-05-10,Can Tho City,Cai Rang District,21,3,2,1,0
2022-05-10,Can Tho City,Ninh Kieu District,0,3,1,2,0
2022-05-10,Can Tho City,Ninh Kieu District,1,6,2,4,0
2022-05-10,Can Tho City,Ninh Kieu District,2,4,4,0,0
2022-05-10,Can Tho City,Ninh Kieu District,3,4,3,1,0
2022-05-10,Can Tho City,Ninh Kieu District,4,1,1,0,0
2022-05-10,Can Tho City,Ninh Kieu District,5,2,2,0,0
2022-05-10,Can Tho City,Ninh Kieu District,6,38,36,2,1
2022-05-10,Can Tho City,Ninh Kieu District,7,122,108,14,0
2022-05-10,Can Tho City,Ninh Kieu District,8,268,252,16,0
2022-05-10,Can Tho City,Ninh Kieu District,9,336,317,19,1
2022-05-10,Can Tho City,Ninh Kieu District,10,622,591,31,0
2022-05-10,Can Tho City,Ninh Kieu District,11,858,794,64,3
2022-05-10,Can Tho City,Ninh Kieu District,12,614,580,34,0
2022-05-10,Can Tho City,Ninh Kieu District,13,457,437,20,0
2022-05-10,Can Tho City,Ninh Kieu District,14,397,382,15,0
2022-05-10,Can Tho City,Ninh Kieu District,15,337,317,20,0
2022-05-10,Can Tho City,Ninh Kieu District,16,534,508,26,0
2022-05-10,Can Tho City,Ninh Kieu District,17,561,536,25,0
2022-05-10,Can Tho City,Ninh Kieu District,18,594,573,21,0
2022-05-10,Can Tho City,Ninh Kieu District,19,505,471,34,0
2022-05-10,Can Tho City,Ninh Kieu District,20,390,362,28,0
2022-05-10,Can Tho City,Ninh Kieu District,21,238,208,30,7
2022-05-10,Can Tho City,Ninh Kieu District,22,1,0,1,0
2022-05-10,Dong Nai,Bien Hoa City,0,3,2,1,0
2022-05-10,Dong Nai,Bien Hoa City,1,2,2,0,0
2022-05-10,Dong Nai,Bien Hoa City,2,4,2,2,1
2022-05-10,Dong Nai,Bien Hoa City,4,1,1,0,0
2022-05-10,Dong Nai,Bien Hoa City,5,2,2,0,0
2022-05-10,Dong Nai,Bien Hoa City,6,39,29,10,7
2022-05-10,Dong Nai,Bien Hoa City,7,156,135,21,11
2022-05-10,Dong Nai,Bien Hoa City,8,269,245,24,6
2022-05-10,Dong Nai,Bien Hoa City,9,426,390,36,7
2022-05-10,Dong Nai,Bien Hoa City,10,742,666,76,19
2022-05-10,Dong Nai,Bien Hoa City,11,1083,964,119,27
2022-05-10,Dong Nai,Bien Hoa City,12,855,785,70,18
2022-05-10,Dong Nai,Bien Hoa City,13,774,721,53,15
2022-05-10,Dong Nai,Bien Hoa City,14,534,488,46,10
2022-05-10,Dong Nai,Bien Hoa City,15,472,430,42,6
2022-05-10,Dong Nai,Bien Hoa City,16,499,405,94,54
2022-05-10,Dong Nai,Bien Hoa City,17,643,463,180,129
2022-05-10,Dong Nai,Bien Hoa City,18,898,702,196,117
2022-05-10,Dong Nai,Bien Hoa City,19,788,669,119,45
2022-05-10,Dong Nai,Bien Hoa City,20,534,447,87,29
2022-05-10,Dong Nai,Bien Hoa City,21,232,152,80,39
2022-05-10,Dong Nai,Bien Hoa City,22,4,0,4,0
2022-05-10,Dong Nai,Long Khanh,12,1,0,1,1
2022-05-10,Dong Nai,Long Khanh,13,1,0,1,1
2022-05-10,Dong Nai,Long Khanh,14,1,0,1,0
2022-05-10,Dong Nai,Long Khanh,15,2,0,2,1
2022-05-10,Dong Nai,Long Khanh,16,1,0,1,1
2022-05-10,Dong Nai,Long Thanh,9,1,0,1,1
2022-05-10,Dong Nai,Long Thanh,10,2,0,2,2
2022-05-10,Dong Nai,Long Thanh,11,1,0,1,1
2022-05-10,Dong Nai,Long Thanh,12,2,0,2,2
2022-05-10,Dong Nai,Long Thanh,13,1,0,1,1
2022-05-10,Dong Nai,Long Thanh,17,1,0,1,0
2022-05-10,Dong Nai,Nhon trach,11,2,0,2,2
2022-05-10,Dong Nai,Nhon trach,12,1,0,1,1
2022-05-10,Dong Nai,Trang Bom,11,1,0,1,1
2022-05-10,Dong Nai,Trang Bom,12,1,0,1,1
2022-05-10,Dong Nai,Trang Bom,13,2,1,1,1
2022-05-10,Dong Nai,Trang Bom,19,2,0,2,2
2022-05-10,Dong Nai,Vinh Cuu,12,1,0,1,0
2022-05-10,Hai Phong City,An Duong,7,2,1,1,1
2022-05-10,Hai Phong City,An Duong,9,4,3,1,1
2022-05-10,Hai Phong City,An Duong,10,2,0,2,2
2022-05-10,Hai Phong City,An Duong,11,5,1,4,3
2022-05-10,Hai Phong City,An Duong,12,4,2,2,1
2022-05-10,Hai Phong City,An Duong,13,9,1,8,7
2022-05-10,Hai Phong City,An Duong,14,1,0,1,0
2022-05-10,Hai Phong City,An Duong,15,2,1,1,1
2022-05-10,Hai Phong City,An Duong,16,6,4,2,1
2022-05-10,Hai Phong City,An Duong,17,1,0,1,1
2022-05-10,Hai Phong City,An Duong,18,5,4,1,0
2022-05-10,Hai Phong City,An Duong,19,2,1,1,1
2022-05-10,Hai Phong City,An Duong,20,2,2,0,0
2022-05-10,Hai Phong City,Hai An District,7,9,3,6,6
2022-05-10,Hai Phong City,Hai An District,8,10,7,3,1
2022-05-10,Hai Phong City,Hai An District,9,14,10,4,0
2022-05-10,Hai Phong City,Hai An District,10,11,9,2,2
2022-05-10,Hai Phong City,Hai An District,11,42,37,5,2
2022-05-10,Hai Phong City,Hai An District,12,19,16,3,0
2022-05-10,Hai Phong City,Hai An District,13,10,8,2,1
2022-05-10,Hai Phong City,Hai An District,14,24,17,7,2
2022-05-10,Hai Phong City,Hai An District,15,13,9,4,2
2022-05-10,Hai Phong City,Hai An District,16,16,14,2,0
2022-05-10,Hai Phong City,Hai An District,17,21,15,6,0
2022-05-10,Hai Phong City,Hai An District,18,20,17,3,1
2022-05-10,Hai Phong City,Hai An District,19,23,14,9,3
2022-05-10,Hai Phong City,Hai An District,20,20,15,5,1
2022-05-10,Hai Phong City,Hai An District,21,8,4,4,2
2022-05-10,Hai Phong City,Hong Bang District,7,10,7,3,3
2022-05-10,Hai Phong City,Hong Bang District,8,32,29,3,0
2022-05-10,Hai Phong City,Hong Bang District,9,31,26,5,2
2022-05-10,Hai Phong City,Hong Bang District,10,65,55,10,6
2022-05-10,Hai Phong City,Hong Bang District,11,79,72,7,2
2022-05-10,Hai Phong City,Hong Bang District,12,63,58,5,0
2022-05-10,Hai Phong City,Hong Bang District,13,34,28,6,0
2022-05-10,Hai Phong City,Hong Bang District,14,57,45,12,7
2022-05-10,Hai Phong City,Hong Bang District,15,54,43,11,6
2022-05-10,Hai Phong City,Hong Bang District,16,40,39,1,0
2022-05-10,Hai Phong City,Hong Bang District,17,50,48,2,0
2022-05-10,Hai Phong City,Hong Bang District,18,68,56,12,5
2022-05-10,Hai Phong City,Hong Bang District,19,45,37,8,5
2022-05-10,Hai Phong City,Hong Bang District,20,37,27,10,5
2022-05-10,Hai Phong City,Hong Bang District,21,16,9,7,3
2022-05-10,Hai Phong City,Kien An District,6,4,1,3,2
2022-05-10,Hai Phong City,Kien An District,7,5,1,4,4
2022-05-10,Hai Phong City,Kien An District,8,3,1,2,0
2022-05-10,Hai Phong City,Kien An District,9,8,7,1,0
2022-05-10,Hai Phong City,Kien An District,10,10,9,1,1
2022-05-10,Hai Phong City,Kien An District,11,8,5,3,0
2022-05-10,Hai Phong City,Kien An District,12,6,5,1,0
2022-05-10,Hai Phong City,Kien An District,13,5,0,5,2
2022-05-10,Hai Phong City,Kien An District,14,9,5,4,4
2022-05-10,Hai Phong City,Kien An District,15,5,3,2,1
2022-05-10,Hai Phong City,Kien An District,16,6,4,2,1
2022-05-10,Hai Phong City,Kien An District,17,5,4,1,0
2022-05-10,Hai Phong City,Kien An District,18,12,9,3,3
2022-05-10,Hai Phong City,Kien An District,19,14,4,10,9
2022-05-10,Hai Phong City,Kien An District,20,8,6,2,0
2022-05-10,Hai Phong City,Kien An District,21,4,3,1,1
2022-05-10,Hai Phong City,Le Chan District,0,1,1,0,0
2022-05-10,Hai Phong City,Le Chan District,1,3,1,2,0
2022-05-10,Hai Phong City,Le Chan District,5,1,1,0,0
2022-05-10,Hai Phong City,Le Chan District,7,33,23,10,6
2022-05-10,Hai Phong City,Le Chan District,8,66,51,15,7
2022-05-10,Hai Phong City,Le Chan District,9,77,67,10,0
2022-05-10,Hai Phong City,Le Chan District,10,172,153,19,3
2022-05-10,Hai Phong City,Le Chan District,11,266,240,26,9
2022-05-10,Hai Phong City,Le Chan District,12,195,178,17,3
2022-05-10,Hai Phong City,Le Chan District,13,113,99,14,3
2022-05-10,Hai Phong City,Le Chan District,14,146,107,39,22
2022-05-10,Hai Phong City,Le Chan District,15,143,112,31,19
2022-05-10,Hai Phong City,Le Chan District,16,146,127,19,7
2022-05-10,Hai Phong City,Le Chan District,17,190,167,23,4
2022-05-10,Hai Phong City,Le Chan District,18,228,209,19,0
2022-05-10,Hai Phong City,Le Chan District,19,202,174,28,6
2022-05-10,Hai Phong City,Le Chan District,20,133,118,15,3
2022-05-10,Hai Phong City,Le Chan District,21,90,64,26,15
2022-05-10,Hai Phong City,Ngo Quyen District,0,4,1,3,0
2022-05-10,Hai Phong City,Ngo Quyen District,5,1,1,0,0
2022-05-10,Hai Phong City,Ngo Quyen District,6,3,0,3,1
2022-05-10,Hai Phong City,Ngo Quyen District,7,22,12,10,8
2022-05-10,Hai Phong City,Ngo Quyen District,8,87,73,14,7
2022-05-10,Hai Phong City,Ngo Quyen District,9,73,65,8,0
2022-05-10,Hai Phong City,Ngo Quyen District,10,109,100,9,0
2022-05-10,Hai Phong City,Ngo Quyen District,11,221,193,28,13
2022-05-10,Hai Phong City,Ngo Quyen District,12,138,127,11,1
2022-05-10,Hai Phong City,Ngo Quyen District,13,91,82,9,0
2022-05-10,Hai Phong City,Ngo Quyen District,14,96,82,14,5
2022-05-10,Hai Phong City,Ngo Quyen District,15,102,84,18,6
2022-05-10,Hai Phong City,Ngo Quyen District,16,100,84,16,6
2022-05-10,Hai Phong City,Ngo Quyen District,17,117,108,9,1
2022-05-10,Hai Phong City,Ngo Quyen District,18,151,131,20,4
2022-05-10,Hai Phong City,Ngo Quyen District,19,130,116,14,3
2022-05-10,Hai Phong City,Ngo Quyen District,20,122,103,19,1
2022-05-10,Hai Phong City,Ngo Quyen District,21,58,42,16,10
2022-05-10,Hai Phong City,Ngo Quyen District,23,1,0,1,0
2022-05-10,Hai Phong City,Thuy Nguyen,14,1,0,1,1
2022-05-10,Hai Phong City,Thuy Nguyen,16,1,0,1,1
2022-05-10,Hai Phong City,Thuy Nguyen,17,1,1,0,0
2022-05-10,Hai Phong City,Thuy Nguyen,18,1,0,1,1
2022-05-10,Hai Phong City,Thuy Nguyen,20,1,0,1,1
2022-05-10,Hue City,Hue City,0,4,4,0,0
2022-05-10,Hue City,Hue City,5,2,2,0,0
2022-05-10,Hue City,Hue City,6,61,57,4,1
2022-05-10,Hue City,Hue City,7,180,165,15,2
2022-05-10,Hue City,Hue City,8,279,258,21,3
2022-05-10,Hue City,Hue City,9,258,235,23,1
2022-05-10,Hue City,Hue City,10,353,334,19,0
2022-05-10,Hue City,Hue City,11,914,856,58,5
2022-05-10,Hue City,Hue City,12,581,551,30,0
2022-05-10,Hue City,Hue City,13,337,311,26,1
2022-05-10,Hue City,Hue City,14,359,331,28,5
2022-05-10,Hue City,Hue City,15,343,317,26,6
2022-05-10,Hue City,Hue City,16,376,352,24,1
2022-05-10,Hue City,Hue City,17,446,422,24,6
2022-05-10,Hue City,Hue City,18,546,510,36,4
2022-05-10,Hue City,Hue City,19,562,512,50,1
2022-05-10,Hue City,Hue City,20,385,352,33,3
2022-05-10,Hue City,Hue City,21,243,193,50,19
2022-05-10,Hue City,Hue City,22,1,0,1,0
2022-05-10,Hue City,Huong Thuy,7,1,1,0,0
2022-05-10,Hue City,Huong Thuy,10,1,1,0,0
2022-05-10,Hue City,Huong Thuy,11,3,0,3,1
2022-05-10,Hue City,Huong Thuy,12,1,1,0,0
2022-05-10,Hue City,Huong Thuy,13,1,1,0,0
2022-05-10,Hue City,Huong Thuy,14,1,1,0,0
2022-05-10,Hue City,Huong Thuy,15,1,1,0,0
2022-05-10,Hue City,Huong Thuy,17,2,2,0,0
2022-05-10,Hue City,Huong Thuy,18,2,0,2,2
2022-05-10,Hue City,Huong Tra,8,1,1,0,0
2022-05-10,Hue City,Huong Tra,11,1,0,1,1
2022-05-10,Hue City,Huong Tra,12,3,2,1,0
2022-05-10,Hue City,Huong Tra,19,1,1,0,0
2022-05-10,Hue City,Phu Vang,6,3,2,1,1
2022-05-10,Hue City,Phu Vang,7,1,1,0,0
2022-05-10,Hue City,Phu Vang,9,1,0,1,0
2022-05-10,Hue City,Phu Vang,10,3,1,2,1
2022-05-10,Hue City,Phu Vang,11,1,1,0,0
2022-05-10,Hue City,Phu Vang,12,4,3,1,0
2022-05-10,Hue City,Phu Vang,13,1,0,1,1
2022-05-10,Hue City,Phu Vang,14,2,2,0,0
2022-05-10,Hue City,Phu Vang,15,3,3,0,0
2022-05-10,Hue City,Phu Vang,17,1,1,0,0
2022-05-10,Hue City,Phu Vang,18,4,2,2,2
2022-05-10,Hue City,Phu Vang,19,3,2,1,0
2022-05-10,Hue City,Phu Vang,20,6,3,3,1
2022-05-10,Vung Tau,Ba Ria City,8,6,4,2,2
2022-05-10,Vung Tau,Ba Ria City,9,6,4,2,2
2022-05-10,Vung Tau,Ba Ria City,10,7,5,2,2
2022-05-10,Vung Tau,Ba Ria City,11,12,4,8,6
2022-05-10,Vung Tau,Ba Ria City,12,4,4,0,0
2022-05-10,Vung Tau,Ba Ria City,13,9,6,3,1
2022-05-10,Vung Tau,Ba Ria City,14,4,2,2,0
2022-05-10,Vung Tau,Ba Ria City,15,2,2,0,0
2022-05-10,Vung Tau,Ba Ria City,16,1,1,0,0
2022-05-10,Vung Tau,Ba Ria City,17,8,1,7,6
2022-05-10,Vung Tau,Ba Ria City,18,8,4,4,4
2022-05-10,Vung Tau,Ba Ria City,19,8,5,3,2
2022-05-10,Vung Tau,Ba Ria City,20,3,0,3,3
2022-05-10,Vung Tau,Ba Ria City,21,3,0,3,3
2022-05-10,Vung Tau,Vung Tau City,2,1,1,0,0
2022-05-10,Vung Tau,Vung Tau City,5,2,2,0,0
2022-05-10,Vung Tau,Vung Tau City,6,28,25,3,2
2022-05-10,Vung Tau,Vung Tau City,7,78,70,8,2
2022-05-10,Vung Tau,Vung Tau City,8,149,135,14,2
2022-05-10,Vung Tau,Vung Tau City,9,128,122,6,0
2022-05-10,Vung Tau,Vung Tau City,10,173,162,11,2
2022-05-10,Vung Tau,Vung Tau City,11,344,321,23,4
2022-05-10,Vung Tau,Vung Tau City,12,253,239,14,1
2022-05-10,Vung Tau,Vung Tau City,13,192,179,13,0
2022-05-10,Vung Tau,Vung Tau City,14,199,187,12,3
2022-05-10,Vung Tau,Vung Tau City,15,207,193,14,0
2022-05-10,Vung Tau,Vung Tau City,16,168,161,7,1
2022-05-10,Vung Tau,Vung Tau City,17,259,236,23,3
2022-05-10,Vung Tau,Vung Tau City,18,294,276,18,2
2022-05-10,Vung Tau,Vung Tau City,19,254,225,29,4
2022-05-10,Vung Tau,Vung Tau City,20,176,161,15,3
2022-05-10,Vung Tau,Vung Tau City,21,98,72,26,5
2022-05-10,Vung Tau,Vung Tau City,23,2,0,2,0
2022-05-11,Binh Duong,Ben Cat,7,1,1,0,0
2022-05-11,Binh Duong,Ben Cat,11,1,0,1,1
2022-05-11,Binh Duong,Ben Cat,15,1,0,1,1
2022-05-11,Binh Duong,Ben Cat,18,1,0,1,1
2022-05-11,Binh Duong,Ben Cat,19,1,0,1,1
2022-05-11,Binh Duong,Ben Cat,20,2,0,2,2
2022-05-11,Binh Duong,Di An,0,1,1,0,0
2022-05-11,Binh Duong,Di An,4,1,0,1,1
2022-05-11,Binh Duong,Di An,6,2,0,2,2
2022-05-11,Binh Duong,Di An,7,2,1,1,0
2022-05-11,Binh Duong,Di An,8,9,6,3,2
2022-05-11,Binh Duong,Di An,9,15,7,8,3
2022-05-11,Binh Duong,Di An,10,59,21,38,28
2022-05-11,Binh Duong,Di An,11,49,26,23,19
2022-05-11,Binh Duong,Di An,12,39,23,16,11
2022-05-11,Binh Duong,Di An,13,38,18,20,15
2022-05-11,Binh Duong,Di An,14,20,9,11,11
2022-05-11,Binh Duong,Di An,15,28,7,21,16
2022-05-11,Binh Duong,Di An,16,25,6,19,15
2022-05-11,Binh Duong,Di An,17,17,13,4,2
2022-05-11,Binh Duong,Di An,18,28,20,8,4
2022-05-11,Binh Duong,Di An,19,22,15,7,4
2022-05-11,Binh Duong,Di An,20,27,12,15,11
2022-05-11,Binh Duong,Di An,21,18,5,13,9
2022-05-11,Binh Duong,Tan Uyen,0,1,0,1,1
2022-05-11,Binh Duong,Tan Uyen,8,1,1,0,0
2022-05-11,Binh Duong,Tan Uyen,9,1,0,1,1
2022-05-11,Binh Duong,Tan Uyen,11,2,2,0,0
2022-05-11,Binh Duong,Tan Uyen,12,1,1,0,0
2022-05-11,Binh Duong,Tan Uyen,13,4,1,3,3
2022-05-11,Binh Duong,Tan Uyen,14,8,2,6,6
2022-05-11,Binh Duong,Tan Uyen,15,2,0,2,2
2022-05-11,Binh Duong,Tan Uyen,17,5,3,2,1
2022-05-11,Binh Duong,Tan Uyen,18,3,3,0,0
2022-05-11,Binh Duong,Tan Uyen,19,3,3,0,0
2022-05-11,Binh Duong,Tan Uyen,20,1,1,0,0
2022-05-11,Binh Duong,Thu Dau Mot Town,1,1,1,0,0
2022-05-11,Binh Duong,Thu Dau Mot Town,5,1,1,0,0
2022-05-11,Binh Duong,Thu Dau Mot Town,6,30,23,7,6
2022-05-11,Binh Duong,Thu Dau Mot Town,7,111,105,6,1
2022-05-11,Binh Duong,Thu Dau Mot Town,8,206,183,23,3
2022-05-11,Binh Duong,Thu Dau Mot Town,9,266,254,12,1
2022-05-11,Binh Duong,Thu Dau Mot Town,10,407,391,16,0
2022-05-11,Binh Duong,Thu Dau Mot Town,11,650,620,30,4
2022-05-11,Binh Duong,Thu Dau Mot Town,12,495,474,21,0
2022-05-11,Binh Duong,Thu Dau Mot Town,13,405,396,9,1
2022-05-11,Binh Duong,Thu Dau Mot Town,14,355,344,11,1
2022-05-11,Binh Duong,Thu Dau Mot Town,15,262,239,23,1
2022-05-11,Binh Duong,Thu Dau Mot Town,16,254,244,10,3
2022-05-11,Binh Duong,Thu Dau Mot Town,17,385,370,15,2
2022-05-11,Binh Duong,Thu Dau Mot Town,18,392,374,18,4
2022-05-11,Binh Duong,Thu Dau Mot Town,19,330,317,13,4
2022-05-11,Binh Duong,Thu Dau Mot Town,20,234,219,15,3
2022-05-11,Binh Duong,Thu Dau Mot Town,21,130,114,16,4
2022-05-11,Binh Duong,Thu Dau Mot Town,22,1,0,1,0
2022-05-11,Binh Duong,Thuan An,6,1,0,1,1
2022-05-11,Binh Duong,Thuan An,7,2,1,1,1
2022-05-11,Binh Duong,Thuan An,8,20,13,7,6
2022-05-11,Binh Duong,Thuan An,9,36,28,8,6
2022-05-11,Binh Duong,Thuan An,10,61,40,21,15
2022-05-11,Binh Duong,Thuan An,11,101,58,43,30
2022-05-11,Binh Duong,Thuan An,12,86,59,27,16
2022-05-11,Binh Duong,Thuan An,13,92,55,37,32
2022-05-11,Binh Duong,Thuan An,14,64,43,21,18
2022-05-11,Binh Duong,Thuan An,15,37,23,14,12
2022-05-11,Binh Duong,Thuan An,16,38,24,14,11
2022-05-11,Binh Duong,Thuan An,17,45,35,10,7
2022-05-11,Binh Duong,Thuan An,18,48,43,5,2
2022-05-11,Binh Duong,Thuan An,19,46,41,5,2
2022-05-11,Binh Duong,Thuan An,20,23,16,7,5
2022-05-11,Binh Duong,Thuan An,21,13,5,8,7
2022-05-11,Can Tho City,Binh Thuy District,7,2,1,1,1
2022-05-11,Can Tho City,Binh Thuy District,8,7,4,3,0
2022-05-11,Can Tho City,Binh Thuy District,9,3,3,0,0
2022-05-11,Can Tho City,Binh Thuy District,10,8,7,1,0
2022-05-11,Can Tho City,Binh Thuy District,11,10,7,3,2
2022-05-11,Can Tho City,Binh Thuy District,12,8,8,0,0
2022-05-11,Can Tho City,Binh Thuy District,13,11,8,3,0
2022-05-11,Can Tho City,Binh Thuy District,14,10,9,1,1
2022-05-11,Can Tho City,Binh Thuy District,15,13,12,1,0
2022-05-11,Can Tho City,Binh Thuy District,16,11,10,1,1
2022-05-11,Can Tho City,Binh Thuy District,17,13,12,1,0
2022-05-11,Can Tho City,Binh Thuy District,18,15,15,0,0
2022-05-11,Can Tho City,Binh Thuy District,19,15,11,4,0
2022-05-11,Can Tho City,Binh Thuy District,20,9,9,0,0
2022-05-11,Can Tho City,Binh Thuy District,21,5,3,2,1
2022-05-11,Can Tho City,Cai Rang District,6,4,2,2,1
2022-05-11,Can Tho City,Cai Rang District,7,3,3,0,0
2022-05-11,Can Tho City,Cai Rang District,8,6,5,1,0
2022-05-11,Can Tho City,Cai Rang District,9,6,4,2,1
2022-05-11,Can Tho City,Cai Rang District,10,8,8,0,0
2022-05-11,Can Tho City,Cai Rang District,11,12,11,1,0
2022-05-11,Can Tho City,Cai Rang District,12,6,4,2,0
2022-05-11,Can Tho City,Cai Rang District,13,9,9,0,0
2022-05-11,Can Tho City,Cai Rang District,14,15,14,1,1
2022-05-11,Can Tho City,Cai Rang District,15,7,7,0,0
2022-05-11,Can Tho City,Cai Rang District,16,6,6,0,0
2022-05-11,Can Tho City,Cai Rang District,17,9,8,1,0
2022-05-11,Can Tho City,Cai Rang District,18,9,8,1,0
2022-05-11,Can Tho City,Cai Rang District,19,8,7,1,0
2022-05-11,Can Tho City,Cai Rang District,20,13,10,3,1
2022-05-11,Can Tho City,Cai Rang District,21,1,1,0,0
2022-05-11,Can Tho City,Ninh Kieu District,0,3,2,1,0
2022-05-11,Can Tho City,Ninh Kieu District,2,1,1,0,0
2022-05-11,Can Tho City,Ninh Kieu District,3,1,1,0,0
2022-05-11,Can Tho City,Ninh Kieu District,4,1,1,0,0
2022-05-11,Can Tho City,Ninh Kieu District,5,1,1,0,0
2022-05-11,Can Tho City,Ninh Kieu District,6,55,48,7,0
2022-05-11,Can Tho City,Ninh Kieu District,7,130,123,7,0
2022-05-11,Can Tho City,Ninh Kieu District,8,257,242,15,0
2022-05-11,Can Tho City,Ninh Kieu District,9,318,293,25,0
2022-05-11,Can Tho City,Ninh Kieu District,10,675,653,22,0
2022-05-11,Can Tho City,Ninh Kieu District,11,952,904,48,3
2022-05-11,Can Tho City,Ninh Kieu District,12,597,569,28,0
2022-05-11,Can Tho City,Ninh Kieu District,13,516,498,18,0
2022-05-11,Can Tho City,Ninh Kieu District,14,395,379,16,1
2022-05-11,Can Tho City,Ninh Kieu District,15,408,390,18,0
2022-05-11,Can Tho City,Ninh Kieu District,16,501,462,39,0
2022-05-11,Can Tho City,Ninh Kieu District,17,591,563,28,0
2022-05-11,Can Tho City,Ninh Kieu District,18,581,558,23,0
2022-05-11,Can Tho City,Ninh Kieu District,19,473,447,26,0
2022-05-11,Can Tho City,Ninh Kieu District,20,386,367,19,0
2022-05-11,Can Tho City,Ninh Kieu District,21,208,182,26,0
2022-05-11,Can Tho City,Ninh Kieu District,22,2,0,2,0
2022-05-11,Can Tho City,O Mon District,12,1,0,1,1
2022-05-11,Dong Nai,Bien Hoa City,0,8,7,1,1
2022-05-11,Dong Nai,Bien Hoa City,2,1,0,1,0
2022-05-11,Dong Nai,Bien Hoa City,3,2,2,0,0
2022-05-11,Dong Nai,Bien Hoa City,4,1,0,1,0
2022-05-11,Dong Nai,Bien Hoa City,5,4,2,2,2
2022-05-11,Dong Nai,Bien Hoa City,6,35,26,9,6
2022-05-11,Dong Nai,Bien Hoa City,7,147,118,29,10
2022-05-11,Dong Nai,Bien Hoa City,8,341,309,32,9
2022-05-11,Dong Nai,Bien Hoa City,9,470,420,50,7
2022-05-11,Dong Nai,Bien Hoa City,10,855,766,89,19
2022-05-11,Dong Nai,Bien Hoa City,11,1145,1055,90,28
2022-05-11,Dong Nai,Bien Hoa City,12,893,809,84,16
2022-05-11,Dong Nai,Bien Hoa City,13,871,786,85,39
2022-05-11,Dong Nai,Bien Hoa City,14,738,679,59,15
2022-05-11,Dong Nai,Bien Hoa City,15,507,455,52,14
2022-05-11,Dong Nai,Bien Hoa City,16,520,471,49,11
2022-05-11,Dong Nai,Bien Hoa City,17,665,599,66,18
2022-05-11,Dong Nai,Bien Hoa City,18,693,633,60,24
2022-05-11,Dong Nai,Bien Hoa City,19,598,550,48,3
2022-05-11,Dong Nai,Bien Hoa City,20,461,403,58,13
2022-05-11,Dong Nai,Bien Hoa City,21,240,168,72,33
2022-05-11,Dong Nai,Bien Hoa City,22,1,0,1,0
2022-05-11,Dong Nai,Bien Hoa City,23,1,0,1,0
2022-05-11,Dong Nai,Long Khanh,17,1,0,1,1
2022-05-11,Dong Nai,Long Thanh,8,1,0,1,1
2022-05-11,Dong Nai,Long Thanh,11,2,0,2,1
2022-05-11,Dong Nai,Long Thanh,14,4,0,4,1
2022-05-11,Dong Nai,Long Thanh,15,4,0,4,3
2022-05-11,Dong Nai,Long Thanh,16,2,0,2,1
2022-05-11,Dong Nai,Long Thanh,18,1,0,1,1
2022-05-11,Dong Nai,Long Thanh,20,1,0,1,1
2022-05-11,Dong Nai,Nhon trach,8,1,0,1,1
2022-05-11,Dong Nai,Trang Bom,12,1,0,1,1
2022-05-11,Dong Nai,Trang Bom,14,2,0,2,0
2022-05-11,Dong Nai,Trang Bom,19,2,0,2,2
2022-05-11,Hai Phong City,An Duong,7,1,0,1,1
2022-05-11,Hai Phong City,An Duong,8,2,1,1,1
2022-05-11,Hai Phong City,An Duong,9,1,0,1,1
2022-05-11,Hai Phong City,An Duong,10,2,2,0,0
2022-05-11,Hai Phong City,An Duong,11,8,3,5,4
2022-05-11,Hai Phong City,An Duong,12,10,1,9,8
2022-05-11,Hai Phong City,An Duong,13,6,1,5,5
2022-05-11,Hai Phong City,An Duong,14,12,0,12,12
2022-05-11,Hai Phong City,An Duong,15,3,2,1,0
2022-05-11,Hai Phong City,An Duong,16,4,3,1,1
2022-05-11,Hai Phong City,An Duong,17,4,0,4,2
2022-05-11,Hai Phong City,An Duong,19,2,1,1,1
2022-05-11,Hai Phong City,An Duong,20,1,0,1,1
2022-05-11,Hai Phong City,Do Son District,10,1,0,1,1
2022-05-11,Hai Phong City,Duong Kinh District,11,1,0,1,1
2022-05-11,Hai Phong City,Duong Kinh District,20,4,1,3,3
2022-05-11,Hai Phong City,Hai An District,7,3,1,2,2
2022-05-11,Hai Phong City,Hai An District,8,15,9,6,0
2022-05-11,Hai Phong City,Hai An District,9,6,3,3,0
2022-05-11,Hai Phong City,Hai An District,10,26,24,2,0
2022-05-11,Hai Phong City,Hai An District,11,39,31,8,3
2022-05-11,Hai Phong City,Hai An District,12,18,17,1,0
2022-05-11,Hai Phong City,Hai An District,13,16,16,0,0
2022-05-11,Hai Phong City,Hai An District,14,17,14,3,2
2022-05-11,Hai Phong City,Hai An District,15,10,8,2,0
2022-05-11,Hai Phong City,Hai An District,16,15,11,4,1
2022-05-11,Hai Phong City,Hai An District,17,10,8,2,1
2022-05-11,Hai Phong City,Hai An District,18,24,20,4,2
2022-05-11,Hai Phong City,Hai An District,19,22,17,5,2
2022-05-11,Hai Phong City,Hai An District,20,19,16,3,1
2022-05-11,Hai Phong City,Hai An District,21,13,2,11,2
2022-05-11,Hai Phong City,Hong Bang District,0,2,1,1,0
2022-05-11,Hai Phong City,Hong Bang District,6,1,0,1,0
2022-05-11,Hai Phong City,Hong Bang District,7,10,9,1,1
2022-05-11,Hai Phong City,Hong Bang District,8,30,24,6,3
2022-05-11,Hai Phong City,Hong Bang District,9,29,27,2,1
2022-05-11,Hai Phong City,Hong Bang District,10,50,44,6,2
2022-05-11,Hai Phong City,Hong Bang District,11,121,97,24,10
2022-05-11,Hai Phong City,Hong Bang District,12,76,65,11,5
2022-05-11,Hai Phong City,Hong Bang District,13,50,45,5,0
2022-05-11,Hai Phong City,Hong Bang District,14,58,47,11,5
2022-05-11,Hai Phong City,Hong Bang District,15,45,42,3,2
2022-05-11,Hai Phong City,Hong Bang District,16,45,41,4,1
2022-05-11,Hai Phong City,Hong Bang District,17,40,39,1,0
2022-05-11,Hai Phong City,Hong Bang District,18,72,64,8,5
2022-05-11,Hai Phong City,Hong Bang District,19,44,27,17,13
2022-05-11,Hai Phong City,Hong Bang District,20,33,20,13,9
2022-05-11,Hai Phong City,Hong Bang District,21,15,8,7,5
2022-05-11,Hai Phong City,Kien An District,8,3,1,2,2
2022-05-11,Hai Phong City,Kien An District,9,13,4,9,7
2022-05-11,Hai Phong City,Kien An District,10,7,7,0,0
2022-05-11,Hai Phong City,Kien An District,11,16,8,8,6
2022-05-11,Hai Phong City,Kien An District,12,11,6,5,4
2022-05-11,Hai Phong City,Kien An District,13,6,4,2,0
2022-05-11,Hai Phong City,Kien An District,14,5,3,2,1
2022-05-11,Hai Phong City,Kien An District,15,3,1,2,0
2022-05-11,Hai Phong City,Kien An District,16,5,4,1,0
2022-05-11,Hai Phong City,Kien An District,17,6,3,3,2
2022-05-11,Hai Phong City,Kien An District,18,14,5,9,7
2022-05-11,Hai Phong City,Kien An District,19,6,3,3,3
2022-05-11,Hai Phong City,Kien An District,20,10,4,6,6
2022-05-11,Hai Phong City,Kien An District,21,5,0,5,5
2022-05-11,Hai Phong City,Le Chan District,6,3,1,2,1
2022-05-11,Hai Phong City,Le Chan District,7,31,27,4,3
2022-05-11,Hai Phong City,Le Chan District,8,78,68,10,4
2022-05-11,Hai Phong City,Le Chan District,9,76,68,8,0
2022-05-11,Hai Phong City,Le Chan District,10,170,150,20,2
2022-05-11,Hai Phong City,Le Chan District,11,288,253,35,10
2022-05-11,Hai Phong City,Le Chan District,12,198,178,20,2
2022-05-11,Hai Phong City,Le Chan District,13,108,99,9,1
2022-05-11,Hai Phong City,Le Chan District,14,167,130,37,25
2022-05-11,Hai Phong City,Le Chan District,15,158,134,24,2
2022-05-11,Hai Phong City,Le Chan District,16,128,123,5,0
2022-05-11,Hai Phong City,Le Chan District,17,171,153,18,1
2022-05-11,Hai Phong City,Le Chan District,18,218,198,20,3
2022-05-11,Hai Phong City,Le Chan District,19,196,166,30,7
2022-05-11,Hai Phong City,Le Chan District,20,159,110,49,27
2022-05-11,Hai Phong City,Le Chan District,21,101,56,45,28
2022-05-11,Hai Phong City,Ngo Quyen District,6,2,1,1,0
2022-05-11,Hai Phong City,Ngo Quyen District,7,20,17,3,2
2022-05-11,Hai Phong City,Ngo Quyen District,8,68,56,12,2
2022-05-11,Hai Phong City,Ngo Quyen District,9,72,68,4,1
2022-05-11,Hai Phong City,Ngo Quyen District,10,129,120,9,1
2022-05-11,Hai Phong City,Ngo Quyen District,11,223,203,20,4
2022-05-11,Hai Phong City,Ngo Quyen District,12,139,131,8,1
2022-05-11,Hai Phong City,Ngo Quyen District,13,106,94,12,0
2022-05-11,Hai Phong City,Ngo Quyen District,14,134,107,27,14
2022-05-11,Hai Phong City,Ngo Quyen District,15,117,102,15,4
2022-05-11,Hai Phong City,Ngo Quyen District,16,115,109,6,0
2022-05-11,Hai Phong City,Ngo Quyen District,17,114,106,8,1
2022-05-11,Hai Phong City,Ngo Quyen District,18,158,139,19,8
2022-05-11,Hai Phong City,Ngo Quyen District,19,149,123,26,2
2022-05-11,Hai Phong City,Ngo Quyen District,20,127,98,29,10
2022-05-11,Hai Phong City,Ngo Quyen District,21,65,44,21,13
2022-05-11,Hai Phong City,Thuy Nguyen,10,1,0,1,1
2022-05-11,Hai Phong City,Thuy Nguyen,15,2,1,1,1
2022-05-11,Hai Phong City,Thuy Nguyen,19,1,0,1,1
2022-05-11,Hai Phong City,Thuy Nguyen,20,1,1,0,0
2022-05-11,Hue City,Hue City,0,2,2,0,0
2022-05-11,Hue City,Hue City,1,2,1,1,0
2022-05-11,Hue City,Hue City,2,1,1,0,0
2022-05-11,Hue City,Hue City,3,5,4,1,0
2022-05-11,Hue City,Hue City,5,3,2,1,0
2022-05-11,Hue City,Hue City,6,58,51,7,2
2022-05-11,Hue City,Hue City,7,179,160,19,1
2022-05-11,Hue City,Hue City,8,288,267,21,1
2022-05-11,Hue City,Hue City,9,259,240,19,0
2022-05-11,Hue City,Hue City,10,412,395,17,0
2022-05-11,Hue City,Hue City,11,919,837,82,7
2022-05-11,Hue City,Hue City,12,563,533,30,0
2022-05-11,Hue City,Hue City,13,346,318,28,3
2022-05-11,Hue City,Hue City,14,399,377,22,2
2022-05-11,Hue City,Hue City,15,385,360,25,5
2022-05-11,Hue City,Hue City,16,321,300,21,2
2022-05-11,Hue City,Hue City,17,449,415,34,7
2022-05-11,Hue City,Hue City,18,606,569,37,1
2022-05-11,Hue City,Hue City,19,538,497,41,3
2022-05-11,Hue City,Hue City,20,436,391,45,2
2022-05-11,Hue City,Hue City,21,239,202,37,6
2022-05-11,Hue City,Huong Thuy,8,1,1,0,0
2022-05-11,Hue City,Huong Thuy,9,1,1,0,0
2022-05-11,Hue City,Huong Thuy,10,1,1,0,0
2022-05-11,Hue City,Huong Thuy,12,2,2,0,0
2022-05-11,Hue City,Huong Thuy,14,2,1,1,0
2022-05-11,Hue City,Huong Thuy,15,3,1,2,1
2022-05-11,Hue City,Huong Thuy,16,1,1,0,0
2022-05-11,Hue City,Huong Thuy,17,1,1,0,0
2022-05-11,Hue City,Huong Thuy,20,3,1,2,2
2022-05-11,Hue City,Huong Thuy,21,1,0,1,0
2022-05-11,Hue City,Huong Tra,10,1,1,0,0
2022-05-11,Hue City,Huong Tra,17,2,2,0,0
2022-05-11,Hue City,Huong Tra,19,1,1,0,0
2022-05-11,Hue City,Phu Vang,6,2,1,1,1
2022-05-11,Hue City,Phu Vang,7,1,0,1,1
2022-05-11,Hue City,Phu Vang,8,2,2,0,0
2022-05-11,Hue City,Phu Vang,9,1,1,0,0
2022-05-11,Hue City,Phu Vang,10,1,1,0,0
2022-05-11,Hue City,Phu Vang,11,2,2,0,0
2022-05-11,Hue City,Phu Vang,12,4,3,1,1
2022-05-11,Hue City,Phu Vang,13,3,2,1,1
2022-05-11,Hue City,Phu Vang,14,4,3,1,0
2022-05-11,Hue City,Phu Vang,15,2,2,0,0
2022-05-11,Hue City,Phu Vang,16,2,1,1,1
2022-05-11,Hue City,Phu Vang,17,1,0,1,1
2022-05-11,Hue City,Phu Vang,18,1,1,0,0
2022-05-11,Hue City,Phu Vang,19,3,3,0,0
2022-05-11,Hue City,Phu Vang,20,4,2,2,0
2022-05-11,Vung Tau,Ba Ria City,7,1,0,1,1
2022-05-11,Vung Tau,Ba Ria City,8,2,1,1,1
2022-05-11,Vung Tau,Ba Ria City,9,6,4,2,2
2022-05-11,Vung Tau,Ba Ria City,10,7,6,1,0
2022-05-11,Vung Tau,Ba Ria City,11,9,4,5,5
2022-05-11,Vung Tau,Ba Ria City,12,5,4,1,1
2022-05-11,Vung Tau,Ba Ria City,13,2,1,1,0
2022-05-11,Vung Tau,Ba Ria City,14,4,2,2,1
2022-05-11,Vung Tau,Ba Ria City,15,6,2,4,2
2022-05-11,Vung Tau,Ba Ria City,16,6,3,3,3
2022-05-11,Vung Tau,Ba Ria City,17,7,3,4,4
2022-05-11,Vung Tau,Ba Ria City,18,7,2,5,5
2022-05-11,Vung Tau,Ba Ria City,19,9,0,9,8
2022-05-11,Vung Tau,Ba Ria City,20,3,0,3,3
2022-05-11,Vung Tau,Ba Ria City,21,4,0,4,4
2022-05-11,Vung Tau,Tan Thanh,19,1,0,1,1
2022-05-11,Vung Tau,Vung Tau City,0,1,1,0,0
2022-05-11,Vung Tau,Vung Tau City,1,1,1,0,0
2022-05-11,Vung Tau,Vung Tau City,5,2,2,0,0
2022-05-11,Vung Tau,Vung Tau City,6,31,27,4,2
2022-05-11,Vung Tau,Vung Tau City,7,116,101,15,6
2022-05-11,Vung Tau,Vung Tau City,8,145,137,8,2
2022-05-11,Vung Tau,Vung Tau City,9,173,157,16,4
2022-05-11,Vung Tau,Vung Tau City,10,205,175,30,16
2022-05-11,Vung Tau,Vung Tau City,11,352,321,31,5
2022-05-11,Vung Tau,Vung Tau City,12,240,221,19,0
2022-05-11,Vung Tau,Vung Tau City,13,214,193,21,5
2022-05-11,Vung Tau,Vung Tau City,14,195,181,14,2
2022-05-11,Vung Tau,Vung Tau City,15,199,185,14,4
2022-05-11,Vung Tau,Vung Tau City,16,171,159,12,5
2022-05-11,Vung Tau,Vung Tau City,17,264,242,22,3
2022-05-11,Vung Tau,Vung Tau City,18,261,243,18,0
2022-05-11,Vung Tau,Vung Tau City,19,304,261,43,22
2022-05-11,Vung Tau,Vung Tau City,20,211,171,40,18
2022-05-11,Vung Tau,Vung Tau City,21,99,73,26,17
2022-05-12,Binh Duong,Ben Cat,8,1,0,1,1
2022-05-12,Binh Duong,Ben Cat,10,1,0,1,1
2022-05-12,Binh Duong,Ben Cat,11,1,0,1,1
2022-05-12,Binh Duong,Ben Cat,12,2,2,0,0
2022-05-12,Binh Duong,Ben Cat,13,1,0,1,1
2022-05-12,Binh Duong,Ben Cat,16,3,0,3,2
2022-05-12,Binh Duong,Ben Cat,19,2,0,2,2
2022-05-12,Binh Duong,Ben Cat,20,2,0,2,1
2022-05-12,Binh Duong,Di An,7,6,0,6,4
2022-05-12,Binh Duong,Di An,8,21,5,16,14
2022-05-12,Binh Duong,Di An,9,30,10,20,14
2022-05-12,Binh Duong,Di An,10,38,23,15,10
2022-05-12,Binh Duong,Di An,11,56,27,29,23
2022-05-12,Binh Duong,Di An,12,51,29,22,17
2022-05-12,Binh Duong,Di An,13,32,20,12,11
2022-05-12,Binh Duong,Di An,14,34,12,22,20
2022-05-12,Binh Duong,Di An,15,36,9,27,19
2022-05-12,Binh Duong,Di An,16,26,10,16,13
2022-05-12,Binh Duong,Di An,17,34,16,18,16
2022-05-12,Binh Duong,Di An,18,31,5,26,21
2022-05-12,Binh Duong,Di An,19,67,9,58,50
2022-05-12,Binh Duong,Di An,20,27,8,19,14
2022-05-12,Binh Duong,Di An,21,21,6,15,10
2022-05-12,Binh Duong,Tan Uyen,9,5,0,5,5
2022-05-12,Binh Duong,Tan Uyen,10,1,0,1,1
2022-05-12,Binh Duong,Tan Uyen,11,6,3,3,0
2022-05-12,Binh Duong,Tan Uyen,12,3,1,2,2
2022-05-12,Binh Duong,Tan Uyen,13,2,1,1,1
2022-05-12,Binh Duong,Tan Uyen,14,1,1,0,0
2022-05-12,Binh Duong,Tan Uyen,15,1,1,0,0
2022-05-12,Binh Duong,Tan Uyen,16,6,1,5,4
2022-05-12,Binh Duong,Tan Uyen,17,4,3,1,0
2022-05-12,Binh Duong,Tan Uyen,19,5,3,2,2
2022-05-12,Binh Duong,Tan Uyen,20,2,0,2,2
2022-05-12,Binh Duong,Tan Uyen,21,2,1,1,1
2022-05-12,Binh Duong,Thu Dau Mot Town,0,1,1,0,0
2022-05-12,Binh Duong,Thu Dau Mot Town,3,1,1,0,0
2022-05-12,Binh Duong,Thu Dau Mot Town,6,28,26,2,1
2022-05-12,Binh Duong,Thu Dau Mot Town,7,110,100,10,0
2022-05-12,Binh Duong,Thu Dau Mot Town,8,208,194,14,1
2022-05-12,Binh Duong,Thu Dau Mot Town,9,249,235,14,3
2022-05-12,Binh Duong,Thu Dau Mot Town,10,399,376,23,1
2022-05-12,Binh Duong,Thu Dau Mot Town,11,664,630,34,4
2022-05-12,Binh Duong,Thu Dau Mot Town,12,473,451,22,3
2022-05-12,Binh Duong,Thu Dau Mot Town,13,451,430,21,3
2022-05-12,Binh Duong,Thu Dau Mot Town,14,336,317,19,3
2022-05-12,Binh Duong,Thu Dau Mot Town,15,277,256,21,2
2022-05-12,Binh Duong,Thu Dau Mot Town,16,322,290,32,5
2022-05-12,Binh Duong,Thu Dau Mot Town,17,343,325,18,4
2022-05-12,Binh Duong,Thu Dau Mot Town,18,420,402,18,4
2022-05-12,Binh Duong,Thu Dau Mot Town,19,361,339,22,4
2022-05-12,Binh Duong,Thu Dau Mot Town,20,246,230,16,3
2022-05-12,Binh Duong,Thu Dau Mot Town,21,130,105,25,5
2022-05-12,Binh Duong,Thu Dau Mot Town,22,1,0,1,0
2022-05-12,Binh Duong,Thuan An,7,6,2,4,2
2022-05-12,Binh Duong,Thuan An,8,11,8,3,0
2022-05-12,Binh Duong,Thuan An,9,30,19,11,4
2022-05-12,Binh Duong,Thuan An,10,59,50,9,6
2022-05-12,Binh Duong,Thuan An,11,91,65,26,15
2022-05-12,Binh Duong,Thuan An,12,65,49,16,11
2022-05-12,Binh Duong,Thuan An,13,96,58,38,34
2022-05-12,Binh Duong,Thuan An,14,82,42,40,30
2022-05-12,Binh Duong,Thuan An,15,48,44,4,2
2022-05-12,Binh Duong,Thuan An,16,45,34,11,3
2022-05-12,Binh Duong,Thuan An,17,47,41,6,2
2022-05-12,Binh Duong,Thuan An,18,42,33,9,6
2022-05-12,Binh Duong,Thuan An,19,70,43,27,23
2022-05-12,Binh Duong,Thuan An,20,55,38,17,12
2022-05-12,Binh Duong,Thuan An,21,30,19,11,4
2022-05-12,Can Tho City,Binh Thuy District,8,6,3,3,2
2022-05-12,Can Tho City,Binh Thuy District,9,4,4,0,0
2022-05-12,Can Tho City,Binh Thuy District,10,10,9,1,0
2022-05-12,Can Tho City,Binh Thuy District,11,15,13,2,1
2022-05-12,Can Tho City,Binh Thuy District,12,16,16,0,0
2022-05-12,Can Tho City,Binh Thuy District,13,9,9,0,0
2022-05-12,Can Tho City,Binh Thuy District,14,16,14,2,0
2022-05-12,Can Tho City,Binh Thuy District,15,12,10,2,0
2022-05-12,Can Tho City,Binh Thuy District,16,17,17,0,0
2022-05-12,Can Tho City,Binh Thuy District,17,18,17,1,0
2022-05-12,Can Tho City,Binh Thuy District,18,10,10,0,0
2022-05-12,Can Tho City,Binh Thuy District,19,12,11,1,0
2022-05-12,Can Tho City,Binh Thuy District,20,10,7,3,0
2022-05-12,Can Tho City,Binh Thuy District,21,3,2,1,0
2022-05-12,Can Tho City,Cai Rang District,6,3,1,2,2
2022-05-12,Can Tho City,Cai Rang District,7,4,4,0,0
2022-05-12,Can Tho City,Cai Rang District,8,5,5,0,0
2022-05-12,Can Tho City,Cai Rang District,9,7,7,0,0
2022-05-12,Can Tho City,Cai Rang District,10,12,11,1,0
2022-05-12,Can Tho City,Cai Rang District,11,7,7,0,0
2022-05-12,Can Tho City,Cai Rang District,12,15,13,2,1
2022-05-12,Can Tho City,Cai Rang District,13,13,13,0,0
2022-05-12,Can Tho City,Cai Rang District,14,6,6,0,0
2022-05-12,Can Tho City,Cai Rang District,15,8,7,1,0
2022-05-12,Can Tho City,Cai Rang District,16,10,10,0,0
2022-05-12,Can Tho City,Cai Rang District,17,16,13,3,1
2022-05-12,Can Tho City,Cai Rang District,18,11,8,3,2
2022-05-12,Can Tho City,Cai Rang District,19,10,6,4,1
2022-05-12,Can Tho City,Cai Rang District,20,7,7,0,0
2022-05-12,Can Tho City,Cai Rang District,21,4,3,1,0
2022-05-12,Can Tho City,Ninh Kieu District,0,4,2,2,0
2022-05-12,Can Tho City,Ninh Kieu District,1,4,2,2,0
2022-05-12,Can Tho City,Ninh Kieu District,3,1,1,0,0
2022-05-12,Can Tho City,Ninh Kieu District,5,4,3,1,0
2022-05-12,Can Tho City,Ninh Kieu District,6,43,39,4,1
2022-05-12,Can Tho City,Ninh Kieu District,7,111,105,6,0
2022-05-12,Can Tho City,Ninh Kieu District,8,224,210,14,0
2022-05-12,Can Tho City,Ninh Kieu District,9,309,296,13,0
2022-05-12,Can Tho City,Ninh Kieu District,10,606,565,41,0
2022-05-12,Can Tho City,Ninh Kieu District,11,905,867,38,1
2022-05-12,Can Tho City,Ninh Kieu District,12,768,729,39,0
2022-05-12,Can Tho City,Ninh Kieu District,13,550,527,23,0
2022-05-12,Can Tho City,Ninh Kieu District,14,452,433,19,0
2022-05-12,Can Tho City,Ninh Kieu District,15,377,365,12,0
2022-05-12,Can Tho City,Ninh Kieu District,16,435,408,27,0
2022-05-12,Can Tho City,Ninh Kieu District,17,582,556,26,0
2022-05-12,Can Tho City,Ninh Kieu District,18,566,539,27,0
2022-05-12,Can Tho City,Ninh Kieu District,19,454,430,24,0
2022-05-12,Can Tho City,Ninh Kieu District,20,377,353,24,0
2022-05-12,Can Tho City,Ninh Kieu District,21,240,216,24,1
2022-05-12,Can Tho City,O Mon District,12,1,0,1,1
2022-05-12,Can Tho City,O Mon District,16,1,0,1,1
2022-05-12,Dong Nai,Bien Hoa City,0,1,1,0,0
2022-05-12,Dong Nai,Bien Hoa City,4,2,1,1,0
2022-05-12,Dong Nai,Bien Hoa City,5,3,0,3,3
2022-05-12,Dong Nai,Bien Hoa City,6,30,17,13,11
2022-05-12,Dong Nai,Bien Hoa City,7,150,125,25,14
2022-05-12,Dong Nai,Bien Hoa City,8,295,257,38,6
2022-05-12,Dong Nai,Bien Hoa City,9,425,391,34,9
2022-05-12,Dong Nai,Bien Hoa City,10,796,720,76,20
2022-05-12,Dong Nai,Bien Hoa City,11,1149,1046,103,24
2022-05-12,Dong Nai,Bien Hoa City,12,807,742,65,10
2022-05-12,Dong Nai,Bien Hoa City,13,753,691,62,15
2022-05-12,Dong Nai,Bien Hoa City,14,530,496,34,6
2022-05-12,Dong Nai,Bien Hoa City,15,464,434,30,4
2022-05-12,Dong Nai,Bien Hoa City,16,537,496,41,7
2022-05-12,Dong Nai,Bien Hoa City,17,613,551,62,17
2022-05-12,Dong Nai,Bien Hoa City,18,688,476,212,140
2022-05-12,Dong Nai,Bien Hoa City,19,1035,658,377,266
2022-05-12,Dong Nai,Bien Hoa City,20,700,470,230,153
2022-05-12,Dong Nai,Bien Hoa City,21,270,182,88,46
2022-05-12,Dong Nai,Long Khanh,14,2,0,2,2
2022-05-12,Dong Nai,Long Khanh,18,1,0,1,1
2022-05-12,Dong Nai,Long Thanh,9,1,0,1,1
2022-05-12,Dong Nai,Long Thanh,12,2,0,2,2
2022-05-12,Dong Nai,Long Thanh,13,4,0,4,3
2022-05-12,Dong Nai,Long Thanh,15,1,0,1,1
2022-05-12,Dong Nai,Long Thanh,18,1,0,1,0
2022-05-12,Dong Nai,Long Thanh,21,1,0,1,1
2022-05-12,Dong Nai,Nhon trach,14,1,0,1,1
2022-05-12,Dong Nai,Nhon trach,21,1,0,1,1
2022-05-12,Dong Nai,Trang Bom,13,1,0,1,0
2022-05-12,Hai Phong City,An Duong,7,1,0,1,1
2022-05-12,Hai Phong City,An Duong,8,4,3,1,1
2022-05-12,Hai Phong City,An Duong,9,2,1,1,0
2022-05-12,Hai Phong City,An Duong,10,2,0,2,1
2022-05-12,Hai Phong City,An Duong,11,4,2,2,2
2022-05-12,Hai Phong City,An Duong,12,4,0,4,3
2022-05-12,Hai Phong City,An Duong,13,2,1,1,1
2022-05-12,Hai Phong City,An Duong,14,12,5,7,6
2022-05-12,Hai Phong City,An Duong,15,4,0,4,3
2022-05-12,Hai Phong City,An Duong,16,1,0,1,1
2022-05-12,Hai Phong City,An Duong,17,5,0,5,4
2022-05-12,Hai Phong City,An Duong,18,7,1,6,3
2022-05-12,Hai Phong City,An Duong,19,3,0,3,3
2022-05-12,Hai Phong City,An Duong,20,1,1,0,0
2022-05-12,Hai Phong City,Do Son District,18,2,0,2,2
2022-05-12,Hai Phong City,Do Son District,19,1,0,1,1
2022-05-12,Hai Phong City,Do Son District,20,1,0,1,1
2022-05-12,Hai Phong City,Duong Kinh District,10,1,0,1,1
2022-05-12,Hai Phong City,Duong Kinh District,11,1,1,0,0
2022-05-12,Hai Phong City,Duong Kinh District,15,1,0,1,0
2022-05-12,Hai Phong City,Hai An District,0,1,1,0,0
2022-05-12,Hai Phong City,Hai An District,7,10,5,5,2
2022-05-12,Hai Phong City,Hai An District,8,13,10,3,3
2022-05-12,Hai Phong City,Hai An District,9,19,14,5,1
2022-05-12,Hai Phong City,Hai An District,10,37,33,4,0
2022-05-12,Hai Phong City,Hai An District,11,56,46,10,2
2022-05-12,Hai Phong City,Hai An District,12,31,27,4,2
2022-05-12,Hai Phong City,Hai An District,13,11,8,3,2
2022-05-12,Hai Phong City,Hai An District,14,25,20,5,2
2022-05-12,Hai Phong City,Hai An District,15,16,12,4,2
2022-05-12,Hai Phong City,Hai An District,16,18,11,7,5
2022-05-12,Hai Phong City,Hai An District,17,35,23,12,10
2022-05-12,Hai Phong City,Hai An District,18,30,15,15,11
2022-05-12,Hai Phong City,Hai An District,19,43,27,16,10
2022-05-12,Hai Phong City,Hai An District,20,18,10,8,5
2022-05-12,Hai Phong City,Hai An District,21,13,7,6,3
2022-05-12,Hai Phong City,Hong Bang District,0,2,2,0,0
2022-05-12,Hai Phong City,Hong Bang District,7,16,10,6,3
2022-05-12,Hai Phong City,Hong Bang District,8,31,30,1,0
2022-05-12,Hai Phong City,Hong Bang District,9,23,21,2,0
2022-05-12,Hai Phong City,Hong Bang District,10,63,56,7,4
2022-05-12,Hai Phong City,Hong Bang District,11,149,96,53,38
2022-05-12,Hai Phong City,Hong Bang District,12,65,52,13,8
2022-05-12,Hai Phong City,Hong Bang District,13,48,35,13,6
2022-05-12,Hai Phong City,Hong Bang District,14,38,28,10,9
2022-05-12,Hai Phong City,Hong Bang District,15,42,32,10,5
2022-05-12,Hai Phong City,Hong Bang District,16,45,37,8,4
2022-05-12,Hai Phong City,Hong Bang District,17,53,33,20,16
2022-05-12,Hai Phong City,Hong Bang District,18,68,39,29,24
2022-05-12,Hai Phong City,Hong Bang District,19,81,36,45,33
2022-05-12,Hai Phong City,Hong Bang District,20,48,34,14,11
2022-05-12,Hai Phong City,Hong Bang District,21,22,14,8,8
2022-05-12,Hai Phong City,Kien An District,1,2,1,1,1
2022-05-12,Hai Phong City,Kien An District,8,5,1,4,4
2022-05-12,Hai Phong City,Kien An District,9,5,2,3,3
2022-05-12,Hai Phong City,Kien An District,10,3,2,1,0
2022-05-12,Hai Phong City,Kien An District,11,15,9,6,4
2022-05-12,Hai Phong City,Kien An District,12,10,8,2,2
2022-05-12,Hai Phong City,Kien An District,13,6,2,4,2
2022-05-12,Hai Phong City,Kien An District,14,7,3,4,2
2022-05-12,Hai Phong City,Kien An District,15,9,2,7,7
2022-05-12,Hai Phong City,Kien An District,16,3,3,0,0
2022-05-12,Hai Phong City,Kien An District,17,8,8,0,0
2022-05-12,Hai Phong City,Kien An District,18,14,8,6,3
2022-05-12,Hai Phong City,Kien An District,19,14,12,2,0
2022-05-12,Hai Phong City,Kien An District,20,8,5,3,2
2022-05-12,Hai Phong City,Kien An District,21,4,2,2,2
2022-05-12,Hai Phong City,Le Chan District,3,1,1,0,0
2022-05-12,Hai Phong City,Le Chan District,4,2,1,1,0
2022-05-12,Hai Phong City,Le Chan District,5,1,0,1,1
2022-05-12,Hai Phong City,Le Chan District,6,1,1,0,0
2022-05-12,Hai Phong City,Le Chan District,7,34,27,7,3
2022-05-12,Hai Phong City,Le Chan District,8,63,60,3,1
2022-05-12,Hai Phong City,Le Chan District,9,83,68,15,1
2022-05-12,Hai Phong City,Le Chan District,10,183,164,19,4
2022-05-12,Hai Phong City,Le Chan District,11,368,285,83,50
2022-05-12,Hai Phong City,Le Chan District,12,283,241,42,25
2022-05-12,Hai Phong City,Le Chan District,13,136,121,15,5
2022-05-12,Hai Phong City,Le Chan District,14,148,117,31,19
2022-05-12,Hai Phong City,Le Chan District,15,171,131,40,19
2022-05-12,Hai Phong City,Le Chan District,16,175,117,58,38
2022-05-12,Hai Phong City,Le Chan District,17,262,158,104,80
2022-05-12,Hai Phong City,Le Chan District,18,326,187,139,109
2022-05-12,Hai Phong City,Le Chan District,19,297,157,140,105
2022-05-12,Hai Phong City,Le Chan District,20,169,111,58,40
2022-05-12,Hai Phong City,Le Chan District,21,85,47,38,11
2022-05-12,Hai Phong City,Ngo Quyen District,6,1,1,0,0
2022-05-12,Hai Phong City,Ngo Quyen District,7,25,18,7,2
2022-05-12,Hai Phong City,Ngo Quyen District,8,66,58,8,0
2022-05-12,Hai Phong City,Ngo Quyen District,9,69,61,8,0
2022-05-12,Hai Phong City,Ngo Quyen District,10,145,128,17,5
2022-05-12,Hai Phong City,Ngo Quyen District,11,278,222,56,40
2022-05-12,Hai Phong City,Ngo Quyen District,12,165,134,31,12
2022-05-12,Hai Phong City,Ngo Quyen District,13,111,92,19,2
2022-05-12,Hai Phong City,Ngo Quyen District,14,127,108,19,12
2022-05-12,Hai Phong City,Ngo Quyen District,15,137,106,31,15
2022-05-12,Hai Phong City,Ngo Quyen District,16,115,88,27,13
2022-05-12,Hai Phong City,Ngo Quyen District,17,168,99,69,52
2022-05-12,Hai Phong City,Ngo Quyen District,18,214,136,78,54
2022-05-12,Hai Phong City,Ngo Quyen District,19,232,135,97,76
2022-05-12,Hai Phong City,Ngo Quyen District,20,177,125,52,25
2022-05-12,Hai Phong City,Ngo Quyen District,21,70,47,23,9
2022-05-12,Hai Phong City,Ngo Quyen District,22,1,0,1,0
2022-05-12,Hai Phong City,Thuy Nguyen,8,1,0,1,1
2022-05-12,Hai Phong City,Thuy Nguyen,10,2,0,2,2
2022-05-12,Hai Phong City,Thuy Nguyen,11,2,0,2,2
2022-05-12,Hai Phong City,Thuy Nguyen,12,2,0,2,2
2022-05-12,Hai Phong City,Thuy Nguyen,14,1,0,1,0
2022-05-12,Hai Phong City,Thuy Nguyen,15,1,0,1,1
2022-05-12,Hai Phong City,Thuy Nguyen,17,1,0,1,1
2022-05-12,Hai Phong City,Thuy Nguyen,18,2,0,2,1
2022-05-12,Hai Phong City,Thuy Nguyen,19,1,0,1,1
2022-05-12,Hai Phong City,Thuy Nguyen,20,3,0,3,3
2022-05-12,Hue City,Hue City,0,1,1,0,0
2022-05-12,Hue City,Hue City,1,1,1,0,0
2022-05-12,Hue City,Hue City,2,1,1,0,0
2022-05-12,Hue City,Hue City,3,1,1,0,0
2022-05-12,Hue City,Hue City,5,2,2,0,0
2022-05-12,Hue City,Hue City,6,76,65,11,5
2022-05-12,Hue City,Hue City,7,209,184,25,0
2022-05-12,Hue City,Hue City,8,312,293,19,2
2022-05-12,Hue City,Hue City,9,252,236,16,0
2022-05-12,Hue City,Hue City,10,435,416,19,1
2022-05-12,Hue City,Hue City,11,1025,921,104,20
2022-05-12,Hue City,Hue City,12,571,528,43,1
2022-05-12,Hue City,Hue City,13,346,315,31,4
2022-05-12,Hue City,Hue City,14,368,336,32,3
2022-05-12,Hue City,Hue City,15,331,315,16,0
2022-05-12,Hue City,Hue City,16,323,300,23,2
2022-05-12,Hue City,Hue City,17,403,372,31,2
2022-05-12,Hue City,Hue City,18,541,509,32,1
2022-05-12,Hue City,Hue City,19,577,536,41,0
2022-05-12,Hue City,Hue City,20,431,385,46,1
2022-05-12,Hue City,Hue City,21,215,186,29,2
2022-05-12,Hue City,Hue City,22,2,0,2,0
2022-05-12,Hue City,Huong Thuy,7,2,1,1,0
2022-05-12,Hue City,Huong Thuy,8,1,1,0,0
2022-05-12,Hue City,Huong Thuy,11,2,1,1,1
2022-05-12,Hue City,Huong Thuy,14,1,1,0,0
2022-05-12,Hue City,Huong Thuy,15,1,1,0,0
2022-05-12,Hue City,Huong Thuy,17,1,1,0,0
2022-05-12,Hue City,Huong Thuy,19,3,1,2,0
2022-05-12,Hue City,Huong Thuy,20,4,2,2,0
2022-05-12,Hue City,Huong Thuy,21,1,1,0,0
2022-05-12,Hue City,Huong Tra,21,1,1,0,0
2022-05-12,Hue City,Phu Vang,6,1,0,1,0
2022-05-12,Hue City,Phu Vang,8,2,1,1,1
2022-05-12,Hue City,Phu Vang,9,1,1,0,0
2022-05-12,Hue City,Phu Vang,10,3,3,0,0
2022-05-12,Hue City,Phu Vang,11,4,3,1,0
2022-05-12,Hue City,Phu Vang,12,4,3,1,1
2022-05-12,Hue City,Phu Vang,15,3,1,2,2
2022-05-12,Hue City,Phu Vang,17,2,1,1,0
2022-05-12,Hue City,Phu Vang,18,1,1,0,0
2022-05-12,Hue City,Phu Vang,19,2,0,2,0
2022-05-12,Hue City,Phu Vang,20,2,1,1,1
2022-05-12,Vung Tau,Ba Ria City,7,1,0,1,1
2022-05-12,Vung Tau,Ba Ria City,8,2,1,1,1
2022-05-12,Vung Tau,Ba Ria City,9,6,3,3,3
2022-05-12,Vung Tau,Ba Ria City,10,7,3,4,3
2022-05-12,Vung Tau,Ba Ria City,11,7,1,6,4
2022-05-12,Vung Tau,Ba Ria City,12,12,2,10,10
2022-05-12,Vung Tau,Ba Ria City,13,11,2,9,9
2022-05-12,Vung Tau,Ba Ria City,14,5,1,4,4
2022-05-12,Vung Tau,Ba Ria City,15,6,3,3,2
2022-05-12,Vung Tau,Ba Ria City,16,4,0,4,3
2022-05-12,Vung Tau,Ba Ria City,17,14,3,11,8
2022-05-12,Vung Tau,Ba Ria City,18,6,1,5,2
2022-05-12,Vung Tau,Ba Ria City,19,5,1,4,4
2022-05-12,Vung Tau,Ba Ria City,20,1,0,1,1
2022-05-12,Vung Tau,Ba Ria City,21,1,0,1,1
2022-05-12,Vung Tau,Vung Tau City,0,2,2,0,0
2022-05-12,Vung Tau,Vung Tau City,1,1,1,0,0
2022-05-12,Vung Tau,Vung Tau City,5,1,0,1,1
2022-05-12,Vung Tau,Vung Tau City,6,41,23,18,15
2022-05-12,Vung Tau,Vung Tau City,7,114,94,20,13
2022-05-12,Vung Tau,Vung Tau City,8,178,168,10,1
2022-05-12,Vung Tau,Vung Tau City,9,139,135,4,0
2022-05-12,Vung Tau,Vung Tau City,10,201,192,9,2
2022-05-12,Vung Tau,Vung Tau City,11,420,391,29,9
2022-05-12,Vung Tau,Vung Tau City,12,271,253,18,5
2022-05-12,Vung Tau,Vung Tau City,13,210,196,14,0
2022-05-12,Vung Tau,Vung Tau City,14,245,233,12,0
2022-05-12,Vung Tau,Vung Tau City,15,187,177,10,0
2022-05-12,Vung Tau,Vung Tau City,16,197,174,23,3
2022-05-12,Vung Tau,Vung Tau City,17,224,209,15,0
2022-05-12,Vung Tau,Vung Tau City,18,295,278,17,2
2022-05-12,Vung Tau,Vung Tau City,19,271,248,23,4
2022-05-12,Vung Tau,Vung Tau City,20,175,155,20,3
2022-05-12,Vung Tau,Vung Tau City,21,85,65,20,6
2022-05-13,Binh Duong,Ben Cat,9,1,0,1,0
2022-05-13,Binh Duong,Ben Cat,10,1,0,1,1
2022-05-13,Binh Duong,Ben Cat,11,1,0,1,1
2022-05-13,Binh Duong,Di An,0,1,0,1,1
2022-05-13,Binh Duong,Di An,7,1,0,1,1
2022-05-13,Binh Duong,Di An,8,12,1,11,11
2022-05-13,Binh Duong,Di An,9,13,5,8,6
2022-05-13,Binh Duong,Di An,10,34,15,19,13
2022-05-13,Binh Duong,Di An,11,43,27,16,12
2022-05-13,Binh Duong,Di An,12,38,26,12,6
2022-05-13,Binh Duong,Di An,13,70,27,43,37
2022-05-13,Binh Duong,Di An,14,39,21,18,17
2022-05-13,Binh Duong,Di An,15,25,10,15,10
2022-05-13,Binh Duong,Di An,16,26,3,23,17
2022-05-13,Binh Duong,Di An,17,35,8,27,25
2022-05-13,Binh Duong,Di An,18,72,23,49,40
2022-05-13,Binh Duong,Di An,19,42,19,23,17
2022-05-13,Binh Duong,Di An,20,36,7,29,22
2022-05-13,Binh Duong,Di An,21,12,2,10,9
2022-05-13,Binh Duong,Tan Uyen,5,1,0,1,1
2022-05-13,Binh Duong,Tan Uyen,7,1,0,1,0
2022-05-13,Binh Duong,Tan Uyen,10,3,1,2,2
2022-05-13,Binh Duong,Tan Uyen,11,5,4,1,1
2022-05-13,Binh Duong,Tan Uyen,13,2,0,2,2
2022-05-13,Binh Duong,Tan Uyen,14,4,2,2,2
2022-05-13,Binh Duong,Tan Uyen,15,2,1,1,1
2022-05-13,Binh Duong,Tan Uyen,16,1,0,1,1
2022-05-13,Binh Duong,Tan Uyen,17,2,0,2,2
2022-05-13,Binh Duong,Tan Uyen,18,4,1,3,3
2022-05-13,Binh Duong,Tan Uyen,19,4,3,1,1
2022-05-13,Binh Duong,Tan Uyen,21,1,1,0,0
2022-05-13,Binh Duong,Thu Dau Mot Town,0,2,2,0,0
2022-05-13,Binh Duong,Thu Dau Mot Town,4,3,1,2,0
2022-05-13,Binh Duong,Thu Dau Mot Town,5,3,2,1,0
2022-05-13,Binh Duong,Thu Dau Mot Town,6,32,28,4,0
2022-05-13,Binh Duong,Thu Dau Mot Town,7,111,102,9,2
2022-05-13,Binh Duong,Thu Dau Mot Town,8,202,192,10,0
2022-05-13,Binh Duong,Thu Dau Mot Town,9,269,253,16,3
2022-05-13,Binh Duong,Thu Dau Mot Town,10,396,371,25,2
2022-05-13,Binh Duong,Thu Dau Mot Town,11,650,614,36,5
2022-05-13,Binh Duong,Thu Dau Mot Town,12,474,457,17,3
2022-05-13,Binh Duong,Thu Dau Mot Town,13,419,399,20,3
2022-05-13,Binh Duong,Thu Dau Mot Town,14,328,313,15,1
2022-05-13,Binh Duong,Thu Dau Mot Town,15,253,237,16,3
2022-05-13,Binh Duong,Thu Dau Mot Town,16,271,254,17,4
2022-05-13,Binh Duong,Thu Dau Mot Town,17,373,347,26,1
2022-05-13,Binh Duong,Thu Dau Mot Town,18,410,395,15,0
2022-05-13,Binh Duong,Thu Dau Mot Town,19,407,376,31,8
2022-05-13,Binh Duong,Thu Dau Mot Town,20,278,257,21,2
2022-05-13,Binh Duong,Thu Dau Mot Town,21,155,134,21,4
2022-05-13,Binh Duong,Thu Dau Mot Town,22,1,0,1,0
2022-05-13,Binh Duong,Thuan An,7,10,1,9,5
2022-05-13,Binh Duong,Thuan An,8,13,10,3,1
2022-05-13,Binh Duong,Thuan An,9,33,25,8,1
2022-05-13,Binh Duong,Thuan An,10,52,34,18,12
2022-05-13,Binh Duong,Thuan An,11,86,64,22,17
2022-05-13,Binh Duong,Thuan An,12,85,54,31,24
2022-05-13,Binh Duong,Thuan An,13,61,42,19,15
2022-05-13,Binh Duong,Thuan An,14,36,30,6,4
2022-05-13,Binh Duong,Thuan An,15,31,25,6,1
2022-05-13,Binh Duong,Thuan An,16,48,36,12,5
2022-05-13,Binh Duong,Thuan An,17,37,26,11,9
2022-05-13,Binh Duong,Thuan An,18,71,55,16,10
2022-05-13,Binh Duong,Thuan An,19,48,36,12,2
2022-05-13,Binh Duong,Thuan An,20,40,25,15,12
2022-05-13,Binh Duong,Thuan An,21,22,9,13,12
2022-05-13,Can Tho City,Binh Thuy District,6,3,3,0,0
2022-05-13,Can Tho City,Binh Thuy District,7,1,1,0,0
2022-05-13,Can Tho City,Binh Thuy District,8,3,3,0,0
2022-05-13,Can Tho City,Binh Thuy District,9,8,7,1,0
2022-05-13,Can Tho City,Binh Thuy District,10,13,13,0,0
2022-05-13,Can Tho City,Binh Thuy District,11,20,18,2,1
2022-05-13,Can Tho City,Binh Thuy District,12,8,6,2,0
2022-05-13,Can Tho City,Binh Thuy District,13,7,7,0,0
2022-05-13,Can Tho City,Binh Thuy District,14,9,9,0,0
2022-05-13,Can Tho City,Binh Thuy District,15,13,12,1,0
2022-05-13,Can Tho City,Binh Thuy District,16,10,9,1,0
2022-05-13,Can Tho City,Binh Thuy District,17,10,10,0,0
2022-05-13,Can Tho City,Binh Thuy District,18,18,18,0,0
2022-05-13,Can Tho City,Binh Thuy District,19,11,10,1,0
2022-05-13,Can Tho City,Binh Thuy District,20,8,6,2,0
2022-05-13,Can Tho City,Binh Thuy District,21,3,2,1,0
2022-05-13,Can Tho City,Cai Rang District,6,8,3,5,5
2022-05-13,Can Tho City,Cai Rang District,7,4,4,0,0
2022-05-13,Can Tho City,Cai Rang District,8,6,5,1,0
2022-05-13,Can Tho City,Cai Rang District,9,9,8,1,1
2022-05-13,Can Tho City,Cai Rang District,10,6,6,0,0
2022-05-13,Can Tho City,Cai Rang District,11,16,15,1,0
2022-05-13,Can Tho City,Cai Rang District,12,7,6,1,0
2022-05-13,Can Tho City,Cai Rang District,13,10,10,0,0
2022-05-13,Can Tho City,Cai Rang District,14,13,13,0,0
2022-05-13,Can Tho City,Cai Rang District,15,8,8,0,0
2022-05-13,Can Tho City,Cai Rang District,16,8,6,2,1
2022-05-13,Can Tho City,Cai Rang District,17,13,11,2,1
2022-05-13,Can Tho City,Cai Rang District,18,15,13,2,1
2022-05-13,Can Tho City,Cai Rang District,19,11,9,2,1
2022-05-13,Can Tho City,Cai Rang District,20,7,5,2,0
2022-05-13,Can Tho City,Cai Rang District,21,3,2,1,1
2022-05-13,Can Tho City,Ninh Kieu District,0,3,2,1,0
2022-05-13,Can Tho City,Ninh Kieu District,2,1,1,0,0
2022-05-13,Can Tho City,Ninh Kieu District,3,2,1,1,0
2022-05-13,Can Tho City,Ninh Kieu District,5,1,1,0,0
2022-05-13,Can Tho City,Ninh Kieu District,6,45,42,3,0
2022-05-13,Can Tho City,Ninh Kieu District,7,141,128,13,0
2022-05-13,Can Tho City,Ninh Kieu District,8,223,207,16,1
2022-05-13,Can Tho City,Ninh Kieu District,9,347,319,28,0
2022-05-13,Can Tho City,Ninh Kieu District,10,573,547,26,0
2022-05-13,Can Tho City,Ninh Kieu District,11,954,887,67,6
2022-05-13,Can Tho City,Ninh Kieu District,12,647,621,26,0
2022-05-13,Can Tho City,Ninh Kieu District,13,504,485,19,0
2022-05-13,Can Tho City,Ninh Kieu District,14,507,480,27,0
2022-05-13,Can Tho City,Ninh Kieu District,15,348,330,18,1
2022-05-13,Can Tho City,Ninh Kieu District,16,418,386,32,0
2022-05-13,Can Tho City,Ninh Kieu District,17,501,479,22,0
2022-05-13,Can Tho City,Ninh Kieu District,18,601,569,32,0
2022-05-13,Can Tho City,Ninh Kieu District,19,519,491,28,1
2022-05-13,Can Tho City,Ninh Kieu District,20,368,349,19,0
2022-05-13,Can Tho City,Ninh Kieu District,21,247,224,23,2
2022-05-13,Can Tho City,Ninh Kieu District,22,4,1,3,0
2022-05-13,Can Tho City,Ninh Kieu District,23,2,1,1,0
2022-05-13,Dong Nai,Bien Hoa City,0,3,1,2,0
2022-05-13,Dong Nai,Bien Hoa City,1,1,0,1,0
2022-05-13,Dong Nai,Bien Hoa City,2,2,1,1,0
2022-05-13,Dong Nai,Bien Hoa City,3,2,2,0,0
2022-05-13,Dong Nai,Bien Hoa City,5,1,0,1,0
2022-05-13,Dong Nai,Bien Hoa City,6,38,25,13,9
2022-05-13,Dong Nai,Bien Hoa City,7,203,154,49,33
2022-05-13,Dong Nai,Bien Hoa City,8,327,292,35,8
2022-05-13,Dong Nai,Bien Hoa City,9,420,391,29,5
2022-05-13,Dong Nai,Bien Hoa City,10,864,764,100,26
2022-05-13,Dong Nai,Bien Hoa City,11,1234,1120,114,33
2022-05-13,Dong Nai,Bien Hoa City,12,885,823,62,16
2022-05-13,Dong Nai,Bien Hoa City,13,838,768,70,21
2022-05-13,Dong Nai,Bien Hoa City,14,716,644,72,20
2022-05-13,Dong Nai,Bien Hoa City,15,583,493,90,40
2022-05-13,Dong Nai,Bien Hoa City,16,614,468,146,106
2022-05-13,Dong Nai,Bien Hoa City,17,767,455,312,252
2022-05-13,Dong Nai,Bien Hoa City,18,1093,782,311,213
2022-05-13,Dong Nai,Bien Hoa City,19,888,700,188,115
2022-05-13,Dong Nai,Bien Hoa City,20,647,439,208,136
2022-05-13,Dong Nai,Bien Hoa City,21,311,195,116,82
2022-05-13,Dong Nai,Bien Hoa City,22,3,1,2,0
2022-05-13,Dong Nai,Bien Hoa City,23,1,0,1,0
2022-05-13,Dong Nai,Long Khanh,10,1,0,1,1
2022-05-13,Dong Nai,Long Khanh,11,1,0,1,1
2022-05-13,Dong Nai,Long Thanh,9,2,0,2,1
2022-05-13,Dong Nai,Long Thanh,10,1,0,1,1
2022-05-13,Dong Nai,Long Thanh,11,3,0,3,3
2022-05-13,Dong Nai,Long Thanh,12,5,0,5,5
2022-05-13,Dong Nai,Long Thanh,13,1,0,1,1
2022-05-13,Dong Nai,Long Thanh,15,1,0,1,1
2022-05-13,Dong Nai,Long Thanh,16,6,0,6,6
2022-05-13,Dong Nai,Long Thanh,18,2,0,2,2
2022-05-13,Dong Nai,Long Thanh,19,3,0,3,3
2022-05-13,Dong Nai,Long Thanh,20,1,0,1,1
2022-05-13,Dong Nai,Nhon trach,12,2,0,2,2
2022-05-13,Dong Nai,Nhon trach,13,1,0,1,1
2022-05-13,Dong Nai,Trang Bom,12,3,0,3,3
2022-05-13,Dong Nai,Trang Bom,13,1,0,1,1
2022-05-13,Dong Nai,Trang Bom,14,5,0,5,4
2022-05-13,Dong Nai,Trang Bom,15,10,0,10,10
2022-05-13,Dong Nai,Trang Bom,16,2,0,2,2
2022-05-13,Dong Nai,Trang Bom,17,1,0,1,1
2022-05-13,Dong Nai,Trang Bom,18,5,0,5,4
2022-05-13,Dong Nai,Vinh Cuu,19,1,0,1,1
2022-05-13,Hai Phong City,An Duong,7,2,1,1,0
2022-05-13,Hai Phong City,An Duong,8,1,0,1,1
2022-05-13,Hai Phong City,An Duong,10,5,3,2,2
2022-05-13,Hai Phong City,An Duong,11,4,4,0,0
2022-05-13,Hai Phong City,An Duong,12,8,5,3,2
2022-05-13,Hai Phong City,An Duong,13,5,2,3,2
2022-05-13,Hai Phong City,An Duong,14,4,1,3,2
2022-05-13,Hai Phong City,An Duong,15,1,1,0,0
2022-05-13,Hai Phong City,An Duong,16,1,1,0,0
2022-05-13,Hai Phong City,An Duong,17,2,2,0,0
2022-05-13,Hai Phong City,An Duong,18,2,0,2,2
2022-05-13,Hai Phong City,An Duong,19,2,0,2,2
2022-05-13,Hai Phong City,An Duong,21,2,0,2,2
2022-05-13,Hai Phong City,Duong Kinh District,16,1,0,1,1
2022-05-13,Hai Phong City,Duong Kinh District,21,1,0,1,1
2022-05-13,Hai Phong City,Hai An District,7,17,7,10,6
2022-05-13,Hai Phong City,Hai An District,8,13,11,2,1
2022-05-13,Hai Phong City,Hai An District,9,21,15,6,4
2022-05-13,Hai Phong City,Hai An District,10,21,20,1,0
2022-05-13,Hai Phong City,Hai An District,11,55,47,8,4
2022-05-13,Hai Phong City,Hai An District,12,20,19,1,0
2022-05-13,Hai Phong City,Hai An District,13,16,14,2,1
2022-05-13,Hai Phong City,Hai An District,14,14,12,2,0
2022-05-13,Hai Phong City,Hai An District,15,15,10,5,2
2022-05-13,Hai Phong City,Hai An District,16,10,9,1,1
2022-05-13,Hai Phong City,Hai An District,17,23,17,6,4
2022-05-13,Hai Phong City,Hai An District,18,25,12,13,9
2022-05-13,Hai Phong City,Hai An District,19,41,10,31,26
2022-05-13,Hai Phong City,Hai An District,20,29,13,16,15
2022-05-13,Hai Phong City,Hai An District,21,13,3,10,9
2022-05-13,Hai Phong City,Hong Bang District,7,17,16,1,1
2022-05-13,Hai Phong City,Hong Bang District,8,30,25,5,2
2022-05-13,Hai Phong City,Hong Bang District,9,30,24,6,3
2022-05-13,Hai Phong City,Hong Bang District,10,46,39,7,2
2022-05-13,Hai Phong City,Hong Bang District,11,89,78,11,8
2022-05-13,Hai Phong City,Hong Bang District,12,75,68,7,5
2022-05-13,Hai Phong City,Hong Bang District,13,37,27,10,4
2022-05-13,Hai Phong City,Hong Bang District,14,34,23,11,10
2022-05-13,Hai Phong City,Hong Bang District,15,51,36,15,9
2022-05-13,Hai Phong City,Hong Bang District,16,47,38,9,7
2022-05-13,Hai Phong City,Hong Bang District,17,45,24,21,16
2022-05-13,Hai Phong City,Hong Bang District,18,73,10,63,58
2022-05-13,Hai Phong City,Hong Bang District,19,78,9,69,60
2022-05-13,Hai Phong City,Hong Bang District,20,40,5,35,31
2022-05-13,Hai Phong City,Hong Bang District,21,29,2,27,23
2022-05-13,Hai Phong City,Kien An District,7,4,2,2,1
2022-05-13,Hai Phong City,Kien An District,8,4,2,2,2
2022-05-13,Hai Phong City,Kien An District,9,4,2,2,2
2022-05-13,Hai Phong City,Kien An District,10,7,4,3,0
2022-05-13,Hai Phong City,Kien An District,11,8,7,1,1
2022-05-13,Hai Phong City,Kien An District,12,10,5,5,3
2022-05-13,Hai Phong City,Kien An District,13,11,5,6,5
2022-05-13,Hai Phong City,Kien An District,14,3,3,0,0
2022-05-13,Hai Phong City,Kien An District,15,1,0,1,1
2022-05-13,Hai Phong City,Kien An District,16,2,1,1,1
2022-05-13,Hai Phong City,Kien An District,17,7,5,2,2
2022-05-13,Hai Phong City,Kien An District,18,9,7,2,2
2022-05-13,Hai Phong City,Kien An District,19,12,6,6,4
2022-05-13,Hai Phong City,Kien An District,20,12,2,10,6
2022-05-13,Hai Phong City,Kien An District,21,7,2,5,4
2022-05-13,Hai Phong City,Le Chan District,6,4,3,1,0
2022-05-13,Hai Phong City,Le Chan District,7,30,26,4,1
2022-05-13,Hai Phong City,Le Chan District,8,86,72,14,2
2022-05-13,Hai Phong City,Le Chan District,9,76,64,12,1
2022-05-13,Hai Phong City,Le Chan District,10,175,157,18,2
2022-05-13,Hai Phong City,Le Chan District,11,311,255,56,33
2022-05-13,Hai Phong City,Le Chan District,12,226,207,19,9
2022-05-13,Hai Phong City,Le Chan District,13,142,123,19,8
2022-05-13,Hai Phong City,Le Chan District,14,155,106,49,33
2022-05-13,Hai Phong City,Le Chan District,15,180,141,39,21
2022-05-13,Hai Phong City,Le Chan District,16,149,119,30,20
2022-05-13,Hai Phong City,Le Chan District,17,216,117,99,75
2022-05-13,Hai Phong City,Le Chan District,18,297,110,187,157
2022-05-13,Hai Phong City,Le Chan District,19,347,88,259,226
2022-05-13,Hai Phong City,Le Chan District,20,208,50,158,147
2022-05-13,Hai Phong City,Le Chan District,21,102,19,83,66
2022-05-13,Hai Phong City,Ngo Quyen District,0,1,0,1,0
2022-05-13,Hai Phong City,Ngo Quyen District,6,3,2,1,0
2022-05-13,Hai Phong City,Ngo Quyen District,7,22,18,4,2
2022-05-13,Hai Phong City,Ngo Quyen District,8,69,64,5,2
2022-05-13,Hai Phong City,Ngo Quyen District,9,45,33,12,1
2022-05-13,Hai Phong City,Ngo Quyen District,10,115,101,14,7
2022-05-13,Hai Phong City,Ngo Quyen District,11,267,223,44,21
2022-05-13,Hai Phong City,Ngo Quyen District,12,155,141,14,3
2022-05-13,Hai Phong City,Ngo Quyen District,13,119,106,13,7
2022-05-13,Hai Phong City,Ngo Quyen District,14,120,96,24,9
2022-05-13,Hai Phong City,Ngo Quyen District,15,124,107,17,10
2022-05-13,Hai Phong City,Ngo Quyen District,16,101,79,22,13
2022-05-13,Hai Phong City,Ngo Quyen District,17,137,91,46,29
2022-05-13,Hai Phong City,Ngo Quyen District,18,244,91,153,133
2022-05-13,Hai Phong City,Ngo Quyen District,19,234,64,170,145
2022-05-13,Hai Phong City,Ngo Quyen District,20,179,47,132,116
2022-05-13,Hai Phong City,Ngo Quyen District,21,90,20,70,62
2022-05-13,Hai Phong City,Thuy Nguyen,9,1,0,1,1
2022-05-13,Hai Phong City,Thuy Nguyen,17,2,0,2,2
2022-05-13,Hai Phong City,Thuy Nguyen,18,2,0,2,2
2022-05-13,Hue City,Hue City,0,1,1,0,0
2022-05-13,Hue City,Hue City,1,4,4,0,0
2022-05-13,Hue City,Hue City,2,1,1,0,0
2022-05-13,Hue City,Hue City,3,1,1,0,0
2022-05-13,Hue City,Hue City,5,2,1,1,0
2022-05-13,Hue City,Hue City,6,79,70,9,7
2022-05-13,Hue City,Hue City,7,173,165,8,0
2022-05-13,Hue City,Hue City,8,294,269,25,2
2022-05-13,Hue City,Hue City,9,273,245,28,2
2022-05-13,Hue City,Hue City,10,455,425,30,4
2022-05-13,Hue City,Hue City,11,992,913,79,2
2022-05-13,Hue City,Hue City,12,613,565,48,1
2022-05-13,Hue City,Hue City,13,330,304,26,1
2022-05-13,Hue City,Hue City,14,361,338,23,1
2022-05-13,Hue City,Hue City,15,372,347,25,2
2022-05-13,Hue City,Hue City,16,382,348,34,2
2022-05-13,Hue City,Hue City,17,490,460,30,1
2022-05-13,Hue City,Hue City,18,566,524,42,2
2022-05-13,Hue City,Hue City,19,632,563,69,7
2022-05-13,Hue City,Hue City,20,443,395,48,5
2022-05-13,Hue City,Hue City,21,267,226,41,5
2022-05-13,Hue City,Hue City,22,2,2,0,0
2022-05-13,Hue City,Hue City,23,1,1,0,0
2022-05-13,Hue City,Huong Thuy,8,2,2,0,0
2022-05-13,Hue City,Huong Thuy,9,2,2,0,0
2022-05-13,Hue City,Huong Thuy,11,1,1,0,0
2022-05-13,Hue City,Huong Thuy,14,1,1,0,0
2022-05-13,Hue City,Huong Thuy,19,3,1,2,2
2022-05-13,Hue City,Huong Thuy,20,2,2,0,0
2022-05-13,Hue City,Huong Tra,8,1,1,0,0
2022-05-13,Hue City,Huong Tra,11,1,1,0,0
2022-05-13,Hue City,Huong Tra,19,1,1,0,0
2022-05-13,Hue City,Phu Vang,8,2,2,0,0
2022-05-13,Hue City,Phu Vang,10,1,1,0,0
2022-05-13,Hue City,Phu Vang,11,1,1,0,0
2022-05-13,Hue City,Phu Vang,12,3,3,0,0
2022-05-13,Hue City,Phu Vang,13,2,2,0,0
2022-05-13,Hue City,Phu Vang,14,2,1,1,0
2022-05-13,Hue City,Phu Vang,15,1,0,1,0
2022-05-13,Hue City,Phu Vang,16,1,1,0,0
2022-05-13,Hue City,Phu Vang,17,1,1,0,0
2022-05-13,Hue City,Phu Vang,18,1,1,0,0
2022-05-13,Hue City,Phu Vang,20,2,1,1,1
2022-05-13,Vung Tau,Ba Ria City,7,1,0,1,1
2022-05-13,Vung Tau,Ba Ria City,8,1,1,0,0
2022-05-13,Vung Tau,Ba Ria City,9,3,3,0,0
2022-05-13,Vung Tau,Ba Ria City,10,5,3,2,0
2022-05-13,Vung Tau,Ba Ria City,11,7,2,5,4
2022-05-13,Vung Tau,Ba Ria City,12,8,3,5,5
2022-05-13,Vung Tau,Ba Ria City,13,12,6,6,3
2022-05-13,Vung Tau,Ba Ria City,14,1,1,0,0
2022-05-13,Vung Tau,Ba Ria City,15,3,2,1,0
2022-05-13,Vung Tau,Ba Ria City,16,3,3,0,0
2022-05-13,Vung Tau,Ba Ria City,17,5,3,2,1
2022-05-13,Vung Tau,Ba Ria City,18,13,2,11,9
2022-05-13,Vung Tau,Ba Ria City,19,9,0,9,9
2022-05-13,Vung Tau,Ba Ria City,20,8,0,8,8
2022-05-13,Vung Tau,Ba Ria City,21,1,0,1,1
2022-05-13,Vung Tau,Vung Tau City,0,1,1,0,0
2022-05-13,Vung Tau,Vung Tau City,1,1,1,0,0
2022-05-13,Vung Tau,Vung Tau City,5,1,0,1,1
2022-05-13,Vung Tau,Vung Tau City,6,44,29,15,12
2022-05-13,Vung Tau,Vung Tau City,7,106,95,11,5
2022-05-13,Vung Tau,Vung Tau City,8,178,161,17,4
2022-05-13,Vung Tau,Vung Tau City,9,147,138,9,2
2022-05-13,Vung Tau,Vung Tau City,10,208,192,16,1
2022-05-13,Vung Tau,Vung Tau City,11,415,388,27,0
2022-05-13,Vung Tau,Vung Tau City,12,296,282,14,0
2022-05-13,Vung Tau,Vung Tau City,13,223,208,15,1
2022-05-13,Vung Tau,Vung Tau City,14,269,250,19,1
2022-05-13,Vung Tau,Vung Tau City,15,213,202,11,3
2022-05-13,Vung Tau,Vung Tau City,16,188,179,9,2
2022-05-13,Vung Tau,Vung Tau City,17,257,240,17,2
2022-05-13,Vung Tau,Vung Tau City,18,562,164,398,364
2022-05-13,Vung Tau,Vung Tau City,19,668,140,528,471
2022-05-13,Vung Tau,Vung Tau City,20,428,96,332,288
2022-05-13,Vung Tau,Vung Tau City,21,160,64,96,77
2022-05-13,Vung Tau,Vung Tau City,22,3,1,2,0
2022-05-13,Vung Tau,Vung Tau City,23,1,1,0,0
2022-05-14,Binh Duong,Ben Cat,9,1,0,1,1
2022-05-14,Binh Duong,Ben Cat,13,2,0,2,2
2022-05-14,Binh Duong,Ben Cat,14,1,0,1,1
2022-05-14,Binh Duong,Ben Cat,15,2,0,2,1
2022-05-14,Binh Duong,Ben Cat,16,2,0,2,2
2022-05-14,Binh Duong,Ben Cat,19,1,0,1,1
2022-05-14,Binh Duong,Di An,6,2,0,2,2
2022-05-14,Binh Duong,Di An,7,3,2,1,1
2022-05-14,Binh Duong,Di An,8,14,6,8,7
2022-05-14,Binh Duong,Di An,9,23,10,13,12
2022-05-14,Binh Duong,Di An,10,41,22,19,13
2022-05-14,Binh Duong,Di An,11,45,35,10,9
2022-05-14,Binh Duong,Di An,12,42,26,16,12
2022-05-14,Binh Duong,Di An,13,26,19,7,2
2022-05-14,Binh Duong,Di An,14,28,19,9,8
2022-05-14,Binh Duong,Di An,15,32,21,11,5
2022-05-14,Binh Duong,Di An,16,18,14,4,3
2022-05-14,Binh Duong,Di An,17,39,27,12,10
2022-05-14,Binh Duong,Di An,18,31,24,7,6
2022-05-14,Binh Duong,Di An,19,28,22,6,3
2022-05-14,Binh Duong,Di An,20,24,14,10,9
2022-05-14,Binh Duong,Di An,21,9,4,5,3
2022-05-14,Binh Duong,Di An,22,1,0,1,0
2022-05-14,Binh Duong,Phu Giao,8,1,0,1,1
2022-05-14,Binh Duong,Phu Giao,9,1,0,1,1
2022-05-14,Binh Duong,Phu Giao,10,1,0,1,1
2022-05-14,Binh Duong,Phu Giao,16,1,0,1,1
2022-05-14,Binh Duong,Tan Uyen,9,2,0,2,2
2022-05-14,Binh Duong,Tan Uyen,10,3,2,1,1
2022-05-14,Binh Duong,Tan Uyen,11,3,1,2,2
2022-05-14,Binh Duong,Tan Uyen,12,2,0,2,2
2022-05-14,Binh Duong,Tan Uyen,13,4,1,3,3
2022-05-14,Binh Duong,Tan Uyen,14,1,0,1,1
2022-05-14,Binh Duong,Tan Uyen,16,1,1,0,0
2022-05-14,Binh Duong,Tan Uyen,17,4,2,2,2
2022-05-14,Binh Duong,Tan Uyen,18,2,1,1,1
2022-05-14,Binh Duong,Tan Uyen,19,4,0,4,4
2022-05-14,Binh Duong,Tan Uyen,20,5,2,3,2
2022-05-14,Binh Duong,Thu Dau Mot Town,0,2,2,0,0
2022-05-14,Binh Duong,Thu Dau Mot Town,4,1,0,1,0
2022-05-14,Binh Duong,Thu Dau Mot Town,5,2,1,1,0
2022-05-14,Binh Duong,Thu Dau Mot Town,6,47,34,13,7
2022-05-14,Binh Duong,Thu Dau Mot Town,7,142,134,8,4
2022-05-14,Binh Duong,Thu Dau Mot Town,8,262,246,16,1
2022-05-14,Binh Duong,Thu Dau Mot Town,9,310,290,20,3
2022-05-14,Binh Duong,Thu Dau Mot Town,10,414,382,32,1
2022-05-14,Binh Duong,Thu Dau Mot Town,11,654,615,39,6
2022-05-14,Binh Duong,Thu Dau Mot Town,12,582,551,31,4
2022-05-14,Binh Duong,Thu Dau Mot Town,13,432,415,17,3
2022-05-14,Binh Duong,Thu Dau Mot Town,14,296,279,17,4
2022-05-14,Binh Duong,Thu Dau Mot Town,15,288,270,18,0
2022-05-14,Binh Duong,Thu Dau Mot Town,16,343,331,12,0
2022-05-14,Binh Duong,Thu Dau Mot Town,17,376,350,26,0
2022-05-14,Binh Duong,Thu Dau Mot Town,18,444,411,33,5
2022-05-14,Binh Duong,Thu Dau Mot Town,19,428,389,39,7
2022-05-14,Binh Duong,Thu Dau Mot Town,20,299,271,28,1
2022-05-14,Binh Duong,Thu Dau Mot Town,21,148,127,21,5
2022-05-14,Binh Duong,Thu Dau Mot Town,23,3,2,1,0
2022-05-14,Binh Duong,Thuan An,0,1,0,1,1
2022-05-14,Binh Duong,Thuan An,1,1,0,1,1
2022-05-14,Binh Duong,Thuan An,5,1,0,1,1
2022-05-14,Binh Duong,Thuan An,6,4,2,2,2
2022-05-14,Binh Duong,Thuan An,7,10,6,4,4
2022-05-14,Binh Duong,Thuan An,8,19,13,6,6
2022-05-14,Binh Duong,Thuan An,9,52,35,17,14
2022-05-14,Binh Duong,Thuan An,10,65,49,16,11
2022-05-14,Binh Duong,Thuan An,11,81,62,19,15
2022-05-14,Binh Duong,Thuan An,12,67,57,10,7
2022-05-14,Binh Duong,Thuan An,13,57,43,14,10
2022-05-14,Binh Duong,Thuan An,14,55,42,13,6
2022-05-14,Binh Duong,Thuan An,15,35,26,9,4
2022-05-14,Binh Duong,Thuan An,16,42,37,5,2
2022-05-14,Binh Duong,Thuan An,17,49,44,5,3
2022-05-14,Binh Duong,Thuan An,18,57,40,17,7
2022-05-14,Binh Duong,Thuan An,19,55,41,14,9
2022-05-14,Binh Duong,Thuan An,20,40,20,20,13
2022-05-14,Binh Duong,Thuan An,21,21,10,11,10
2022-05-14,Binh Duong,Thuan An,22,2,0,2,0
2022-05-14,Can Tho City,Binh Thuy District,6,2,2,0,0
2022-05-14,Can Tho City,Binh Thuy District,7,1,1,0,0
2022-05-14,Can Tho City,Binh Thuy District,8,6,5,1,0
2022-05-14,Can Tho City,Binh Thuy District,9,8,6,2,1
2022-05-14,Can Tho City,Binh Thuy District,10,9,9,0,0
2022-05-14,Can Tho City,Binh Thuy District,11,12,11,1,1
2022-05-14,Can Tho City,Binh Thuy District,12,14,14,0,0
2022-05-14,Can Tho City,Binh Thuy District,13,10,10,0,0
2022-05-14,Can Tho City,Binh Thuy District,14,11,11,0,0
2022-05-14,Can Tho City,Binh Thuy District,15,6,6,0,0
2022-05-14,Can Tho City,Binh Thuy District,16,17,14,3,0
2022-05-14,Can Tho City,Binh Thuy District,17,8,7,1,0
2022-05-14,Can Tho City,Binh Thuy District,18,16,16,0,0
2022-05-14,Can Tho City,Binh Thuy District,19,13,11,2,0
2022-05-14,Can Tho City,Binh Thuy District,20,11,10,1,1
2022-05-14,Can Tho City,Binh Thuy District,21,1,1,0,0
2022-05-14,Can Tho City,Cai Rang District,6,1,0,1,0
2022-05-14,Can Tho City,Cai Rang District,7,3,2,1,1
2022-05-14,Can Tho City,Cai Rang District,8,7,3,4,3
2022-05-14,Can Tho City,Cai Rang District,9,11,9,2,1
2022-05-14,Can Tho City,Cai Rang District,10,7,7,0,0
2022-05-14,Can Tho City,Cai Rang District,11,12,11,1,0
2022-05-14,Can Tho City,Cai Rang District,12,15,14,1,0
2022-05-14,Can Tho City,Cai Rang District,13,9,9,0,0
2022-05-14,Can Tho City,Cai Rang District,14,13,10,3,2
2022-05-14,Can Tho City,Cai Rang District,15,10,9,1,1
2022-05-14,Can Tho City,Cai Rang District,16,14,13,1,0
2022-05-14,Can Tho City,Cai Rang District,17,9,9,0,0
2022-05-14,Can Tho City,Cai Rang District,18,15,14,1,1
2022-05-14,Can Tho City,Cai Rang District,19,14,14,0,0
2022-05-14,Can Tho City,Cai Rang District,20,8,7,1,0
2022-05-14,Can Tho City,Cai Rang District,21,2,1,1,0
2022-05-14,Can Tho City,Ninh Kieu District,0,3,2,1,0
2022-05-14,Can Tho City,Ninh Kieu District,1,6,4,2,0
2022-05-14,Can Tho City,Ninh Kieu District,3,1,0,1,0
2022-05-14,Can Tho City,Ninh Kieu District,4,2,2,0,0
2022-05-14,Can Tho City,Ninh Kieu District,5,1,1,0,0
2022-05-14,Can Tho City,Ninh Kieu District,6,48,42,6,1
2022-05-14,Can Tho City,Ninh Kieu District,7,128,121,7,1
2022-05-14,Can Tho City,Ninh Kieu District,8,233,223,10,0
2022-05-14,Can Tho City,Ninh Kieu District,9,343,329,14,0
2022-05-14,Can Tho City,Ninh Kieu District,10,574,552,22,0
2022-05-14,Can Tho City,Ninh Kieu District,11,872,835,37,0
2022-05-14,Can Tho City,Ninh Kieu District,12,653,629,24,0
2022-05-14,Can Tho City,Ninh Kieu District,13,456,434,22,0
2022-05-14,Can Tho City,Ninh Kieu District,14,395,378,17,1
2022-05-14,Can Tho City,Ninh Kieu District,15,396,370,26,0
2022-05-14,Can Tho City,Ninh Kieu District,16,492,472,20,0
2022-05-14,Can Tho City,Ninh Kieu District,17,501,475,26,0
2022-05-14,Can Tho City,Ninh Kieu District,18,573,550,23,0
2022-05-14,Can Tho City,Ninh Kieu District,19,508,479,29,0
2022-05-14,Can Tho City,Ninh Kieu District,20,373,344,29,0
2022-05-14,Can Tho City,Ninh Kieu District,21,245,218,27,1
2022-05-14,Can Tho City,Ninh Kieu District,22,3,1,2,0
2022-05-14,Can Tho City,Ninh Kieu District,23,1,1,0,0
2022-05-14,Can Tho City,O Mon District,0,1,0,1,1
2022-05-14,Can Tho City,O Mon District,10,1,0,1,0
2022-05-14,Dong Nai,Bien Hoa City,1,1,0,1,1
2022-05-14,Dong Nai,Bien Hoa City,3,1,0,1,0
2022-05-14,Dong Nai,Bien Hoa City,5,2,0,2,1
2022-05-14,Dong Nai,Bien Hoa City,6,46,29,17,15
2022-05-14,Dong Nai,Bien Hoa City,7,189,154,35,16
2022-05-14,Dong Nai,Bien Hoa City,8,365,324,41,14
2022-05-14,Dong Nai,Bien Hoa City,9,533,467,66,10
2022-05-14,Dong Nai,Bien Hoa City,10,872,794,78,20
2022-05-14,Dong Nai,Bien Hoa City,11,1197,1085,112,22
2022-05-14,Dong Nai,Bien Hoa City,12,969,898,71,10
2022-05-14,Dong Nai,Bien Hoa City,13,871,809,62,13
2022-05-14,Dong Nai,Bien Hoa City,14,677,614,63,6
2022-05-14,Dong Nai,Bien Hoa City,15,552,510,42,5
2022-05-14,Dong Nai,Bien Hoa City,16,511,473,38,7
2022-05-14,Dong Nai,Bien Hoa City,17,713,640,73,22
2022-05-14,Dong Nai,Bien Hoa City,18,820,738,82,30
2022-05-14,Dong Nai,Bien Hoa City,19,711,619,92,27
2022-05-14,Dong Nai,Bien Hoa City,20,616,481,135,64
2022-05-14,Dong Nai,Bien Hoa City,21,268,171,97,51
2022-05-14,Dong Nai,Bien Hoa City,22,4,2,2,0
2022-05-14,Dong Nai,Bien Hoa City,23,4,0,4,1
2022-05-14,Dong Nai,Long Thanh,9,1,0,1,1
2022-05-14,Dong Nai,Long Thanh,10,2,0,2,2
2022-05-14,Dong Nai,Long Thanh,11,3,0,3,3
2022-05-14,Dong Nai,Long Thanh,12,2,0,2,2
2022-05-14,Dong Nai,Long Thanh,14,2,0,2,2
2022-05-14,Dong Nai,Long Thanh,19,1,0,1,1
2022-05-14,Dong Nai,Nhon trach,17,1,0,1,1
2022-05-14,Dong Nai,Trang Bom,11,1,0,1,1
2022-05-14,Dong Nai,Trang Bom,13,2,1,1,1
2022-05-14,Dong Nai,Trang Bom,14,1,0,1,1
2022-05-14,Dong Nai,Trang Bom,15,2,0,2,2
2022-05-14,Dong Nai,Trang Bom,16,1,0,1,1
2022-05-14,Dong Nai,Trang Bom,17,2,0,2,2
2022-05-14,Dong Nai,Trang Bom,18,2,0,2,2
2022-05-14,Dong Nai,Trang Bom,19,2,0,2,2
2022-05-14,Dong Nai,Trang Bom,20,1,0,1,1
2022-05-14,Hai Phong City,An Duong,8,2,0,2,2
2022-05-14,Hai Phong City,An Duong,9,1,0,1,1
2022-05-14,Hai Phong City,An Duong,10,1,1,0,0
2022-05-14,Hai Phong City,An Duong,11,3,3,0,0
2022-05-14,Hai Phong City,An Duong,12,2,1,1,1
2022-05-14,Hai Phong City,An Duong,13,4,1,3,2
2022-05-14,Hai Phong City,An Duong,14,9,2,7,6
2022-05-14,Hai Phong City,An Duong,15,7,4,3,2
2022-05-14,Hai Phong City,An Duong,17,6,3,3,0
2022-05-14,Hai Phong City,An Duong,18,1,1,0,0
2022-05-14,Hai Phong City,An Duong,19,3,1,2,2
2022-05-14,Hai Phong City,An Duong,20,6,1,5,4
2022-05-14,Hai Phong City,An Duong,21,2,0,2,2
2022-05-14,Hai Phong City,Do Son District,13,1,0,1,1
2022-05-14,Hai Phong City,Duong Kinh District,18,2,0,2,2
2022-05-14,Hai Phong City,Duong Kinh District,19,2,0,2,2
2022-05-14,Hai Phong City,Hai An District,0,2,1,1,0
2022-05-14,Hai Phong City,Hai An District,7,6,3,3,2
2022-05-14,Hai Phong City,Hai An District,8,20,14,6,5
2022-05-14,Hai Phong City,Hai An District,9,8,6,2,0
2022-05-14,Hai Phong City,Hai An District,10,26,24,2,1
2022-05-14,Hai Phong City,Hai An District,11,44,37,7,1
2022-05-14,Hai Phong City,Hai An District,12,14,13,1,0
2022-05-14,Hai Phong City,Hai An District,13,12,11,1,0
2022-05-14,Hai Phong City,Hai An District,14,13,10,3,0
2022-05-14,Hai Phong City,Hai An District,15,17,10,7,3
2022-05-14,Hai Phong City,Hai An District,16,19,16,3,0
2022-05-14,Hai Phong City,Hai An District,17,22,20,2,0
2022-05-14,Hai Phong City,Hai An District,18,31,23,8,3
2022-05-14,Hai Phong City,Hai An District,19,28,21,7,2
2022-05-14,Hai Phong City,Hai An District,20,15,12,3,1
2022-05-14,Hai Phong City,Hai An District,21,10,6,4,2
2022-05-14,Hai Phong City,Hai An District,22,2,1,1,0
2022-05-14,Hai Phong City,Hong Bang District,1,1,1,0,0
2022-05-14,Hai Phong City,Hong Bang District,4,1,1,0,0
2022-05-14,Hai Phong City,Hong Bang District,7,14,8,6,5
2022-05-14,Hai Phong City,Hong Bang District,8,31,24,7,4
2022-05-14,Hai Phong City,Hong Bang District,9,33,24,9,1
2022-05-14,Hai Phong City,Hong Bang District,10,60,54,6,2
2022-05-14,Hai Phong City,Hong Bang District,11,110,92,18,11
2022-05-14,Hai Phong City,Hong Bang District,12,76,65,11,2
2022-05-14,Hai Phong City,Hong Bang District,13,40,32,8,5
2022-05-14,Hai Phong City,Hong Bang District,14,36,33,3,2
2022-05-14,Hai Phong City,Hong Bang District,15,43,38,5,0
2022-05-14,Hai Phong City,Hong Bang District,16,40,37,3,2
2022-05-14,Hai Phong City,Hong Bang District,17,32,29,3,1
2022-05-14,Hai Phong City,Hong Bang District,18,73,56,17,12
2022-05-14,Hai Phong City,Hong Bang District,19,50,39,11,7
2022-05-14,Hai Phong City,Hong Bang District,20,50,37,13,7
2022-05-14,Hai Phong City,Hong Bang District,21,32,18,14,4
2022-05-14,Hai Phong City,Kien An District,7,7,2,5,4
2022-05-14,Hai Phong City,Kien An District,8,3,1,2,0
2022-05-14,Hai Phong City,Kien An District,9,3,1,2,1
2022-05-14,Hai Phong City,Kien An District,10,9,3,6,5
2022-05-14,Hai Phong City,Kien An District,11,22,18,4,2
2022-05-14,Hai Phong City,Kien An District,12,17,14,3,2
2022-05-14,Hai Phong City,Kien An District,13,7,6,1,0
2022-05-14,Hai Phong City,Kien An District,14,6,4,2,0
2022-05-14,Hai Phong City,Kien An District,15,9,7,2,1
2022-05-14,Hai Phong City,Kien An District,16,6,4,2,2
2022-05-14,Hai Phong City,Kien An District,17,12,11,1,1
2022-05-14,Hai Phong City,Kien An District,18,14,13,1,0
2022-05-14,Hai Phong City,Kien An District,19,6,4,2,1
2022-05-14,Hai Phong City,Kien An District,20,20,8,12,7
2022-05-14,Hai Phong City,Kien An District,21,2,0,2,1
2022-05-14,Hai Phong City,Le Chan District,1,1,0,1,0
2022-05-14,Hai Phong City,Le Chan District,6,2,0,2,1
2022-05-14,Hai Phong City,Le Chan District,7,50,31,19,17
2022-05-14,Hai Phong City,Le Chan District,8,91,68,23,12
2022-05-14,Hai Phong City,Le Chan District,9,97,85,12,2
2022-05-14,Hai Phong City,Le Chan District,10,170,150,20,5
2022-05-14,Hai Phong City,Le Chan District,11,332,285,47,22
2022-05-14,Hai Phong City,Le Chan District,12,222,203,19,5
2022-05-14,Hai Phong City,Le Chan District,13,144,134,10,1
2022-05-14,Hai Phong City,Le Chan District,14,131,114,17,2
2022-05-14,Hai Phong City,Le Chan District,15,138,118,20,2
2022-05-14,Hai Phong City,Le Chan District,16,179,148,31,2
2022-05-14,Hai Phong City,Le Chan District,17,201,163,38,10
2022-05-14,Hai Phong City,Le Chan District,18,227,187,40,19
2022-05-14,Hai Phong City,Le Chan District,19,194,149,45,20
2022-05-14,Hai Phong City,Le Chan District,20,155,128,27,13
2022-05-14,Hai Phong City,Le Chan District,21,118,69,49,22
2022-05-14,Hai Phong City,Le Chan District,22,4,1,3,0
2022-05-14,Hai Phong City,Le Chan District,23,2,0,2,0
2022-05-14,Hai Phong City,Ngo Quyen District,1,1,1,0,0
2022-05-14,Hai Phong City,Ngo Quyen District,4,1,0,1,1
2022-05-14,Hai Phong City,Ngo Quyen District,6,3,1,2,0
2022-05-14,Hai Phong City,Ngo Quyen District,7,30,16,14,12
2022-05-14,Hai Phong City,Ngo Quyen District,8,71,55,16,11
2022-05-14,Hai Phong City,Ngo Quyen District,9,79,69,10,4
2022-05-14,Hai Phong City,Ngo Quyen District,10,137,124,13,5
2022-05-14,Hai Phong City,Ngo Quyen District,11,218,193,25,8
2022-05-14,Hai Phong City,Ngo Quyen District,12,189,169,20,4
2022-05-14,Hai Phong City,Ngo Quyen District,13,122,105,17,1
2022-05-14,Hai Phong City,Ngo Quyen District,14,117,105,12,0
2022-05-14,Hai Phong City,Ngo Quyen District,15,116,104,12,4
2022-05-14,Hai Phong City,Ngo Quyen District,16,118,105,13,1
2022-05-14,Hai Phong City,Ngo Quyen District,17,148,131,17,3
2022-05-14,Hai Phong City,Ngo Quyen District,18,177,151,26,13
2022-05-14,Hai Phong City,Ngo Quyen District,19,162,136,26,13
2022-05-14,Hai Phong City,Ngo Quyen District,20,157,109,48,28
2022-05-14,Hai Phong City,Ngo Quyen District,21,57,38,19,12
2022-05-14,Hai Phong City,Ngo Quyen District,22,2,0,2,0
2022-05-14,Hai Phong City,Thuy Nguyen,11,1,0,1,1
2022-05-14,Hai Phong City,Thuy Nguyen,12,4,0,4,4
2022-05-14,Hai Phong City,Thuy Nguyen,13,2,0,2,2
2022-05-14,Hai Phong City,Thuy Nguyen,15,1,0,1,1
2022-05-14,Hai Phong City,Thuy Nguyen,19,1,0,1,1
2022-05-14,Hue City,Hue City,2,2,1,1,0
2022-05-14,Hue City,Hue City,3,1,0,1,0
2022-05-14,Hue City,Hue City,5,1,1,0,0
2022-05-14,Hue City,Hue City,6,64,55,9,4
2022-05-14,Hue City,Hue City,7,208,195,13,2
2022-05-14,Hue City,Hue City,8,390,350,40,1
2022-05-14,Hue City,Hue City,9,338,300,38,0
2022-05-14,Hue City,Hue City,10,613,576,37,0
2022-05-14,Hue City,Hue City,11,1050,979,71,6
2022-05-14,Hue City,Hue City,12,689,630,59,3
2022-05-14,Hue City,Hue City,13,405,364,41,4
2022-05-14,Hue City,Hue City,14,353,317,36,5
2022-05-14,Hue City,Hue City,15,506,434,72,20
2022-05-14,Hue City,Hue City,16,539,490,49,8
2022-05-14,Hue City,Hue City,17,762,646,116,30
2022-05-14,Hue City,Hue City,18,979,707,272,160
2022-05-14,Hue City,Hue City,19,726,574,152,75
2022-05-14,Hue City,Hue City,20,609,428,181,107
2022-05-14,Hue City,Hue City,21,284,210,74,28
2022-05-14,Hue City,Hue City,22,3,1,2,0
2022-05-14,Hue City,Huong Thuy,9,2,2,0,0
2022-05-14,Hue City,Huong Thuy,10,2,1,1,0
2022-05-14,Hue City,Huong Thuy,11,1,1,0,0
2022-05-14,Hue City,Huong Thuy,13,1,1,0,0
2022-05-14,Hue City,Huong Thuy,14,1,1,0,0
2022-05-14,Hue City,Huong Thuy,16,1,0,1,0
2022-05-14,Hue City,Huong Thuy,17,3,3,0,0
2022-05-14,Hue City,Huong Thuy,18,1,1,0,0
2022-05-14,Hue City,Huong Thuy,19,4,2,2,1
2022-05-14,Hue City,Huong Thuy,21,1,1,0,0
2022-05-14,Hue City,Huong Tra,10,1,1,0,0
2022-05-14,Hue City,Huong Tra,19,1,0,1,0
2022-05-14,Hue City,Phu Vang,7,1,1,0,0
2022-05-14,Hue City,Phu Vang,8,1,0,1,1
2022-05-14,Hue City,Phu Vang,9,4,2,2,2
2022-05-14,Hue City,Phu Vang,10,5,3,2,1
2022-05-14,Hue City,Phu Vang,11,5,4,1,0
2022-05-14,Hue City,Phu Vang,12,3,3,0,0
2022-05-14,Hue City,Phu Vang,14,1,0,1,0
2022-05-14,Hue City,Phu Vang,15,8,6,2,2
2022-05-14,Hue City,Phu Vang,16,2,2,0,0
2022-05-14,Hue City,Phu Vang,17,3,3,0,0
2022-05-14,Hue City,Phu Vang,18,2,1,1,0
2022-05-14,Hue City,Phu Vang,19,3,2,1,1
2022-05-14,Hue City,Phu Vang,20,4,2,2,1
2022-05-14,Hue City,Phu Vang,21,1,1,0,0
2022-05-14,Hue City,Phu Vang,22,1,0,1,1
2022-05-14,Vung Tau,Ba Ria City,6,1,0,1,1
2022-05-14,Vung Tau,Ba Ria City,7,1,0,1,1
2022-05-14,Vung Tau,Ba Ria City,8,2,0,2,1
2022-05-14,Vung Tau,Ba Ria City,9,5,0,5,3
2022-05-14,Vung Tau,Ba Ria City,10,9,3,6,4
2022-05-14,Vung Tau,Ba Ria City,11,20,3,17,15
2022-05-14,Vung Tau,Ba Ria City,12,7,3,4,3
2022-05-14,Vung Tau,Ba Ria City,13,9,1,8,6
2022-05-14,Vung Tau,Ba Ria City,14,6,0,6,5
2022-05-14,Vung Tau,Ba Ria City,15,15,0,15,10
2022-05-14,Vung Tau,Ba Ria City,16,2,0,2,1
2022-05-14,Vung Tau,Ba Ria City,17,8,0,8,5
2022-05-14,Vung Tau,Ba Ria City,18,8,0,8,8
2022-05-14,Vung Tau,Ba Ria City,19,4,0,4,3
2022-05-14,Vung Tau,Ba Ria City,20,6,0,6,6
2022-05-14,Vung Tau,Ba Ria City,21,1,0,1,1
2022-05-14,Vung Tau,Vung Tau City,0,1,1,0,0
2022-05-14,Vung Tau,Vung Tau City,1,1,1,0,0
2022-05-14,Vung Tau,Vung Tau City,6,27,24,3,0
2022-05-14,Vung Tau,Vung Tau City,7,103,94,9,2
2022-05-14,Vung Tau,Vung Tau City,8,178,166,12,2
2022-05-14,Vung Tau,Vung Tau City,9,191,177,14,2
2022-05-14,Vung Tau,Vung Tau City,10,211,196,15,0
2022-05-14,Vung Tau,Vung Tau City,11,414,385,29,3
2022-05-14,Vung Tau,Vung Tau City,12,401,375,26,6
2022-05-14,Vung Tau,Vung Tau City,13,250,232,18,2
2022-05-14,Vung Tau,Vung Tau City,14,232,209,23,2
2022-05-14,Vung Tau,Vung Tau City,15,239,222,17,4
2022-05-14,Vung Tau,Vung Tau City,16,242,224,18,5
2022-05-14,Vung Tau,Vung Tau City,17,282,264,18,1
2022-05-14,Vung Tau,Vung Tau City,18,407,332,75,36
2022-05-14,Vung Tau,Vung Tau City,19,371,245,126,86
2022-05-14,Vung Tau,Vung Tau City,20,263,171,92,63
2022-05-14,Vung Tau,Vung Tau City,21,142,92,50,38
2022-05-14,Vung Tau,Vung Tau City,22,1,0,1,0
2022-05-14,Vung Tau,Vung Tau City,23,3,2,1,0
2022-05-15,Binh Duong,Ben Cat,8,1,0,1,1
2022-05-15,Binh Duong,Ben Cat,9,1,0,1,1
2022-05-15,Binh Duong,Ben Cat,11,2,0,2,2
2022-05-15,Binh Duong,Ben Cat,14,3,0,3,3
2022-05-15,Binh Duong,Ben Cat,19,2,0,2,2
2022-05-15,Binh Duong,Di An,0,2,0,2,2
2022-05-15,Binh Duong,Di An,6,1,0,1,0
2022-05-15,Binh Duong,Di An,7,6,0,6,6
2022-05-15,Binh Duong,Di An,8,14,3,11,5
2022-05-15,Binh Duong,Di An,9,36,15,21,20
2022-05-15,Binh Duong,Di An,10,36,22,14,12
2022-05-15,Binh Duong,Di An,11,51,32,19,17
2022-05-15,Binh Duong,Di An,12,48,29,19,15
2022-05-15,Binh Duong,Di An,13,47,32,15,12
2022-05-15,Binh Duong,Di An,14,29,16,13,10
2022-05-15,Binh Duong,Di An,15,28,20,8,6
2022-05-15,Binh Duong,Di An,16,35,25,10,7
2022-05-15,Binh Duong,Di An,17,32,17,15,12
2022-05-15,Binh Duong,Di An,18,47,26,21,16
2022-05-15,Binh Duong,Di An,19,36,8,28,22
2022-05-15,Binh Duong,Di An,20,42,10,32,26
2022-05-15,Binh Duong,Di An,21,11,1,10,9
2022-05-15,Binh Duong,Tan Uyen,7,4,0,4,3
2022-05-15,Binh Duong,Tan Uyen,8,1,0,1,1
2022-05-15,Binh Duong,Tan Uyen,9,3,1,2,1
2022-05-15,Binh Duong,Tan Uyen,10,3,2,1,1
2022-05-15,Binh Duong,Tan Uyen,11,9,4,5,4
2022-05-15,Binh Duong,Tan Uyen,12,1,0,1,1
2022-05-15,Binh Duong,Tan Uyen,13,2,2,0,0
2022-05-15,Binh Duong,Tan Uyen,14,3,1,2,2
2022-05-15,Binh Duong,Tan Uyen,16,4,2,2,2
2022-05-15,Binh Duong,Tan Uyen,17,2,0,2,2
2022-05-15,Binh Duong,Tan Uyen,18,4,2,2,0
2022-05-15,Binh Duong,Tan Uyen,19,2,1,1,1
2022-05-15,Binh Duong,Tan Uyen,20,4,1,3,3
2022-05-15,Binh Duong,Tan Uyen,21,2,1,1,1
2022-05-15,Binh Duong,Thu Dau Mot Town,0,1,1,0,0
2022-05-15,Binh Duong,Thu Dau Mot Town,1,2,1,1,0
2022-05-15,Binh Duong,Thu Dau Mot Town,6,49,40,9,2
2022-05-15,Binh Duong,Thu Dau Mot Town,7,151,143,8,2
2022-05-15,Binh Duong,Thu Dau Mot Town,8,267,250,17,2
2022-05-15,Binh Duong,Thu Dau Mot Town,9,318,290,28,0
2022-05-15,Binh Duong,Thu Dau Mot Town,10,435,414,21,2
2022-05-15,Binh Duong,Thu Dau Mot Town,11,685,652,33,5
2022-05-15,Binh Duong,Thu Dau Mot Town,12,685,641,44,6
2022-05-15,Binh Duong,Thu Dau Mot Town,13,499,473,26,1
2022-05-15,Binh Duong,Thu Dau Mot Town,14,459,436,23,4
2022-05-15,Binh Duong,Thu Dau Mot Town,15,425,398,27,3
2022-05-15,Binh Duong,Thu Dau Mot Town,16,383,364,19,1
2022-05-15,Binh Duong,Thu Dau Mot Town,17,415,389,26,3
2022-05-15,Binh Duong,Thu Dau Mot Town,18,485,439,46,5
2022-05-15,Binh Duong,Thu Dau Mot Town,19,435,390,45,13
2022-05-15,Binh Duong,Thu Dau Mot Town,20,280,250,30,1
2022-05-15,Binh Duong,Thu Dau Mot Town,21,150,132,18,5
2022-05-15,Binh Duong,Thu Dau Mot Town,22,4,0,4,0
2022-05-15,Binh Duong,Thuan An,6,1,0,1,1
2022-05-15,Binh Duong,Thuan An,7,13,3,10,4
2022-05-15,Binh Duong,Thuan An,8,24,12,12,5
2022-05-15,Binh Duong,Thuan An,9,40,23,17,12
2022-05-15,Binh Duong,Thuan An,10,70,44,26,13
2022-05-15,Binh Duong,Thuan An,11,103,85,18,7
2022-05-15,Binh Duong,Thuan An,12,85,70,15,11
2022-05-15,Binh Duong,Thuan An,13,77,61,16,12
2022-05-15,Binh Duong,Thuan An,14,70,52,18,11
2022-05-15,Binh Duong,Thuan An,15,74,58,16,10
2022-05-15,Binh Duong,Thuan An,16,45,39,6,5
2022-05-15,Binh Duong,Thuan An,17,47,39,8,6
2022-05-15,Binh Duong,Thuan An,18,69,50,19,15
2022-05-15,Binh Duong,Thuan An,19,57,37,20,14
2022-05-15,Binh Duong,Thuan An,20,41,26,15,11
2022-05-15,Binh Duong,Thuan An,21,15,6,9,7
2022-05-15,Can Tho City,Binh Thuy District,8,5,5,0,0
2022-05-15,Can Tho City,Binh Thuy District,9,12,12,0,0
2022-05-15,Can Tho City,Binh Thuy District,10,17,14,3,0
2022-05-15,Can Tho City,Binh Thuy District,11,20,20,0,0
2022-05-15,Can Tho City,Binh Thuy District,12,23,22,1,0
2022-05-15,Can Tho City,Binh Thuy District,13,18,18,0,0
2022-05-15,Can Tho City,Binh Thuy District,14,13,12,1,1
2022-05-15,Can Tho City,Binh Thuy District,15,19,18,1,0
2022-05-15,Can Tho City,Binh Thuy District,16,16,15,1,0
2022-05-15,Can Tho City,Binh Thuy District,17,14,14,0,0
2022-05-15,Can Tho City,Binh Thuy District,18,18,16,2,0
2022-05-15,Can Tho City,Binh Thuy District,19,13,12,1,0
2022-05-15,Can Tho City,Binh Thuy District,20,10,10,0,0
2022-05-15,Can Tho City,Binh Thuy District,21,3,2,1,0
2022-05-15,Can Tho City,Cai Rang District,6,3,0,3,2
2022-05-15,Can Tho City,Cai Rang District,7,2,2,0,0
2022-05-15,Can Tho City,Cai Rang District,8,9,9,0,0
2022-05-15,Can Tho City,Cai Rang District,9,10,10,0,0
2022-05-15,Can Tho City,Cai Rang District,10,12,12,0,0
2022-05-15,Can Tho City,Cai Rang District,11,17,12,5,1
2022-05-15,Can Tho City,Cai Rang District,12,21,17,4,2
2022-05-15,Can Tho City,Cai Rang District,13,9,8,1,0
2022-05-15,Can Tho City,Cai Rang District,14,8,5,3,1
2022-05-15,Can Tho City,Cai Rang District,15,12,8,4,1
2022-05-15,Can Tho City,Cai Rang District,16,20,18,2,1
2022-05-15,Can Tho City,Cai Rang District,17,22,18,4,0
2022-05-15,Can Tho City,Cai Rang District,18,8,8,0,0
2022-05-15,Can Tho City,Cai Rang District,19,12,12,0,0
2022-05-15,Can Tho City,Cai Rang District,20,8,6,2,0
2022-05-15,Can Tho City,Cai Rang District,21,4,2,2,0
2022-05-15,Can Tho City,Ninh Kieu District,0,10,8,2,0
2022-05-15,Can Tho City,Ninh Kieu District,1,8,5,3,0
2022-05-15,Can Tho City,Ninh Kieu District,2,1,0,1,0
2022-05-15,Can Tho City,Ninh Kieu District,3,1,0,1,0
2022-05-15,Can Tho City,Ninh Kieu District,4,1,0,1,0
2022-05-15,Can Tho City,Ninh Kieu District,5,3,3,0,0
2022-05-15,Can Tho City,Ninh Kieu District,6,45,39,6,1
2022-05-15,Can Tho City,Ninh Kieu District,7,142,132,10,0
2022-05-15,Can Tho City,Ninh Kieu District,8,256,227,29,1
2022-05-15,Can Tho City,Ninh Kieu District,9,427,405,22,0
2022-05-15,Can Tho City,Ninh Kieu District,10,607,574,33,0
2022-05-15,Can Tho City,Ninh Kieu District,11,815,773,42,1
2022-05-15,Can Tho City,Ninh Kieu District,12,709,673,36,0
2022-05-15,Can Tho City,Ninh Kieu District,13,587,552,35,0
2022-05-15,Can Tho City,Ninh Kieu District,14,461,436,25,0
2022-05-15,Can Tho City,Ninh Kieu District,15,455,419,36,0
2022-05-15,Can Tho City,Ninh Kieu District,16,539,505,34,0
2022-05-15,Can Tho City,Ninh Kieu District,17,561,543,18,0
2022-05-15,Can Tho City,Ninh Kieu District,18,626,585,41,1
2022-05-15,Can Tho City,Ninh Kieu District,19,572,536,36,2
2022-05-15,Can Tho City,Ninh Kieu District,20,410,383,27,0
2022-05-15,Can Tho City,Ninh Kieu District,21,201,184,17,0
2022-05-15,Can Tho City,Ninh Kieu District,22,1,0,1,0
2022-05-15,Dong Nai,Bien Hoa City,0,1,1,0,0
2022-05-15,Dong Nai,Bien Hoa City,1,2,1,1,0
2022-05-15,Dong Nai,Bien Hoa City,3,1,1,0,0
2022-05-15,Dong Nai,Bien Hoa City,4,1,1,0,0
2022-05-15,Dong Nai,Bien Hoa City,5,2,1,1,0
2022-05-15,Dong Nai,Bien Hoa City,6,64,40,24,17
2022-05-15,Dong Nai,Bien Hoa City,7,207,167,40,17
2022-05-15,Dong Nai,Bien Hoa City,8,337,283,54,20
2022-05-15,Dong Nai,Bien Hoa City,9,528,461,67,12
2022-05-15,Dong Nai,Bien Hoa City,10,878,774,104,41
2022-05-15,Dong Nai,Bien Hoa City,11,1222,1095,127,45
2022-05-15,Dong Nai,Bien Hoa City,12,1190,1044,146,42
2022-05-15,Dong Nai,Bien Hoa City,13,967,873,94,29
2022-05-15,Dong Nai,Bien Hoa City,14,829,700,129,61
2022-05-15,Dong Nai,Bien Hoa City,15,647,557,90,36
2022-05-15,Dong Nai,Bien Hoa City,16,643,549,94,37
2022-05-15,Dong Nai,Bien Hoa City,17,757,640,117,49
2022-05-15,Dong Nai,Bien Hoa City,18,900,718,182,100
2022-05-15,Dong Nai,Bien Hoa City,19,917,618,299,195
2022-05-15,Dong Nai,Bien Hoa City,20,692,423,269,165
2022-05-15,Dong Nai,Bien Hoa City,21,240,171,69,30
2022-05-15,Dong Nai,Bien Hoa City,22,2,0,2,0
2022-05-15,Dong Nai,Long Khanh,12,2,0,2,2
2022-05-15,Dong Nai,Long Khanh,19,1,0,1,0
2022-05-15,Dong Nai,Long Thanh,8,1,0,1,1
2022-05-15,Dong Nai,Long Thanh,11,3,0,3,3
2022-05-15,Dong Nai,Long Thanh,13,1,0,1,1
2022-05-15,Dong Nai,Long Thanh,16,1,0,1,0
2022-05-15,Dong Nai,Long Thanh,17,4,0,4,2
2022-05-15,Dong Nai,Nhon trach,17,1,0,1,1
2022-05-15,Dong Nai,Nhon trach,18,3,0,3,3
2022-05-15,Dong Nai,Trang Bom,8,1,0,1,1
2022-05-15,Dong Nai,Trang Bom,10,1,0,1,1
2022-05-15,Dong Nai,Trang Bom,12,2,0,2,1
2022-05-15,Dong Nai,Trang Bom,13,1,0,1,1
2022-05-15,Dong Nai,Trang Bom,17,2,1,1,1
2022-05-15,Dong Nai,Vinh Cuu,15,1,0,1,1
2022-05-15,Dong Nai,Vinh Cuu,16,1,0,1,1
2022-05-15,Dong Nai,Vinh Cuu,17,1,0,1,1
2022-05-15,Hai Phong City,An Duong,8,4,3,1,1
2022-05-15,Hai Phong City,An Duong,9,1,0,1,0
2022-05-15,Hai Phong City,An Duong,10,3,1,2,2
2022-05-15,Hai Phong City,An Duong,11,3,1,2,1
2022-05-15,Hai Phong City,An Duong,12,2,0,2,1
2022-05-15,Hai Phong City,An Duong,13,7,2,5,3
2022-05-15,Hai Phong City,An Duong,14,5,0,5,4
2022-05-15,Hai Phong City,An Duong,15,1,0,1,1
2022-05-15,Hai Phong City,An Duong,16,4,4,0,0
2022-05-15,Hai Phong City,An Duong,18,4,2,2,1
2022-05-15,Hai Phong City,An Duong,19,3,1,2,1
2022-05-15,Hai Phong City,An Duong,21,1,1,0,0
2022-05-15,Hai Phong City,Do Son District,11,3,0,3,3
2022-05-15,Hai Phong City,Duong Kinh District,10,1,0,1,1
2022-05-15,Hai Phong City,Duong Kinh District,15,2,0,2,2
2022-05-15,Hai Phong City,Hai An District,6,1,1,0,0
2022-05-15,Hai Phong City,Hai An District,7,8,4,4,0
2022-05-15,Hai Phong City,Hai An District,8,9,6,3,0
2022-05-15,Hai Phong City,Hai An District,9,18,12,6,1
2022-05-15,Hai Phong City,Hai An District,10,19,16,3,0
2022-05-15,Hai Phong City,Hai An District,11,50,36,14,8
2022-05-15,Hai Phong City,Hai An District,12,29,21,8,3
2022-05-15,Hai Phong City,Hai An District,13,24,21,3,1
2022-05-15,Hai Phong City,Hai An District,14,6,5,1,0
2022-05-15,Hai Phong City,Hai An District,15,21,17,4,0
2022-05-15,Hai Phong City,Hai An District,16,21,13,8,3
2022-05-15,Hai Phong City,Hai An District,17,21,14,7,4
2022-05-15,Hai Phong City,Hai An District,18,26,20,6,2
2022-05-15,Hai Phong City,Hai An District,19,21,17,4,2
2022-05-15,Hai Phong City,Hai An District,20,9,7,2,2
2022-05-15,Hai Phong City,Hai An District,21,8,8,0,0
2022-05-15,Hai Phong City,Hong Bang District,0,1,1,0,0
2022-05-15,Hai Phong City,Hong Bang District,1,1,1,0,0
2022-05-15,Hai Phong City,Hong Bang District,6,2,0,2,1
2022-05-15,Hai Phong City,Hong Bang District,7,12,7,5,4
2022-05-15,Hai Phong City,Hong Bang District,8,31,23,8,5
2022-05-15,Hai Phong City,Hong Bang District,9,29,27,2,1
2022-05-15,Hai Phong City,Hong Bang District,10,66,50,16,3
2022-05-15,Hai Phong City,Hong Bang District,11,116,81,35,28
2022-05-15,Hai Phong City,Hong Bang District,12,96,71,25,19
2022-05-15,Hai Phong City,Hong Bang District,13,49,39,10,3
2022-05-15,Hai Phong City,Hong Bang District,14,38,35,3,1
2022-05-15,Hai Phong City,Hong Bang District,15,34,27,7,1
2022-05-15,Hai Phong City,Hong Bang District,16,53,40,13,3
2022-05-15,Hai Phong City,Hong Bang District,17,61,46,15,6
2022-05-15,Hai Phong City,Hong Bang District,18,73,54,19,10
2022-05-15,Hai Phong City,Hong Bang District,19,62,39,23,10
2022-05-15,Hai Phong City,Hong Bang District,20,44,32,12,4
2022-05-15,Hai Phong City,Hong Bang District,21,16,13,3,1
2022-05-15,Hai Phong City,Kien An District,7,8,0,8,7
2022-05-15,Hai Phong City,Kien An District,8,15,6,9,6
2022-05-15,Hai Phong City,Kien An District,9,8,5,3,1
2022-05-15,Hai Phong City,Kien An District,10,18,11,7,5
2022-05-15,Hai Phong City,Kien An District,11,25,7,18,16
2022-05-15,Hai Phong City,Kien An District,12,22,12,10,8
2022-05-15,Hai Phong City,Kien An District,13,6,5,1,1
2022-05-15,Hai Phong City,Kien An District,14,6,4,2,1
2022-05-15,Hai Phong City,Kien An District,15,7,5,2,2
2022-05-15,Hai Phong City,Kien An District,16,12,9,3,1
2022-05-15,Hai Phong City,Kien An District,17,12,9,3,2
2022-05-15,Hai Phong City,Kien An District,18,15,11,4,2
2022-05-15,Hai Phong City,Kien An District,19,20,8,12,8
2022-05-15,Hai Phong City,Kien An District,20,9,3,6,3
2022-05-15,Hai Phong City,Kien An District,21,1,1,0,0
2022-05-15,Hai Phong City,Le Chan District,0,2,0,2,0
2022-05-15,Hai Phong City,Le Chan District,1,1,0,1,0
2022-05-15,Hai Phong City,Le Chan District,5,1,0,1,0
2022-05-15,Hai Phong City,Le Chan District,6,4,2,2,0
2022-05-15,Hai Phong City,Le Chan District,7,40,29,11,7
2022-05-15,Hai Phong City,Le Chan District,8,77,58,19,6
2022-05-15,Hai Phong City,Le Chan District,9,102,90,12,3
2022-05-15,Hai Phong City,Le Chan District,10,209,172,37,12
2022-05-15,Hai Phong City,Le Chan District,11,351,273,78,46
2022-05-15,Hai Phong City,Le Chan District,12,266,197,69,42
2022-05-15,Hai Phong City,Le Chan District,13,149,127,22,0
2022-05-15,Hai Phong City,Le Chan District,14,120,108,12,3
2022-05-15,Hai Phong City,Le Chan District,15,152,133,19,3
2022-05-15,Hai Phong City,Le Chan District,16,170,139,31,9
2022-05-15,Hai Phong City,Le Chan District,17,188,159,29,11
2022-05-15,Hai Phong City,Le Chan District,18,247,183,64,45
2022-05-15,Hai Phong City,Le Chan District,19,248,181,67,32
2022-05-15,Hai Phong City,Le Chan District,20,113,94,19,3
2022-05-15,Hai Phong City,Le Chan District,21,62,50,12,1
2022-05-15,Hai Phong City,Ngo Quyen District,0,3,0,3,0
2022-05-15,Hai Phong City,Ngo Quyen District,7,24,16,8,4
2022-05-15,Hai Phong City,Ngo Quyen District,8,65,52,13,7
2022-05-15,Hai Phong City,Ngo Quyen District,9,82,68,14,5
2022-05-15,Hai Phong City,Ngo Quyen District,10,158,120,38,13
2022-05-15,Hai Phong City,Ngo Quyen District,11,266,203,63,40
2022-05-15,Hai Phong City,Ngo Quyen District,12,179,135,44,22
2022-05-15,Hai Phong City,Ngo Quyen District,13,102,87,15,1
2022-05-15,Hai Phong City,Ngo Quyen District,14,101,93,8,0
2022-05-15,Hai Phong City,Ngo Quyen District,15,146,133,13,1
2022-05-15,Hai Phong City,Ngo Quyen District,16,138,117,21,2
2022-05-15,Hai Phong City,Ngo Quyen District,17,178,145,33,13
2022-05-15,Hai Phong City,Ngo Quyen District,18,217,174,43,19
2022-05-15,Hai Phong City,Ngo Quyen District,19,167,124,43,21
2022-05-15,Hai Phong City,Ngo Quyen District,20,122,99,23,3
2022-05-15,Hai Phong City,Ngo Quyen District,21,57,43,14,2
2022-05-15,Hai Phong City,Thuy Nguyen,9,1,0,1,1
2022-05-15,Hai Phong City,Thuy Nguyen,10,4,0,4,4
2022-05-15,Hai Phong City,Thuy Nguyen,11,8,2,6,6
2022-05-15,Hai Phong City,Thuy Nguyen,12,2,0,2,2
2022-05-15,Hai Phong City,Thuy Nguyen,13,1,0,1,1
2022-05-15,Hai Phong City,Thuy Nguyen,14,1,0,1,1
2022-05-15,Hai Phong City,Thuy Nguyen,16,1,0,1,1
2022-05-15,Hai Phong City,Thuy Nguyen,17,1,0,1,1
2022-05-15,Hai Phong City,Thuy Nguyen,18,3,0,3,3
2022-05-15,Hai Phong City,Thuy Nguyen,20,1,0,1,1
2022-05-15,Hue City,Hue City,0,2,1,1,0
2022-05-15,Hue City,Hue City,1,5,3,2,0
2022-05-15,Hue City,Hue City,3,1,0,1,0
2022-05-15,Hue City,Hue City,5,4,4,0,0
2022-05-15,Hue City,Hue City,6,68,54,14,3
2022-05-15,Hue City,Hue City,7,207,175,32,3
2022-05-15,Hue City,Hue City,8,345,306,39,1
2022-05-15,Hue City,Hue City,9,368,315,53,1
2022-05-15,Hue City,Hue City,10,654,557,97,12
2022-05-15,Hue City,Hue City,11,1011,844,167,52
2022-05-15,Hue City,Hue City,12,798,687,111,14
2022-05-15,Hue City,Hue City,13,485,432,53,3
2022-05-15,Hue City,Hue City,14,391,327,64,15
2022-05-15,Hue City,Hue City,15,564,421,143,67
2022-05-15,Hue City,Hue City,16,574,472,102,28
2022-05-15,Hue City,Hue City,17,736,582,154,63
2022-05-15,Hue City,Hue City,18,917,615,302,169
2022-05-15,Hue City,Hue City,19,789,521,268,122
2022-05-15,Hue City,Hue City,20,609,420,189,95
2022-05-15,Hue City,Hue City,21,321,223,98,38
2022-05-15,Hue City,Hue City,22,2,0,2,1
2022-05-15,Hue City,Huong Thuy,7,1,1,0,0
2022-05-15,Hue City,Huong Thuy,9,2,2,0,0
2022-05-15,Hue City,Huong Thuy,10,1,1,0,0
2022-05-15,Hue City,Huong Thuy,11,6,2,4,1
2022-05-15,Hue City,Huong Thuy,12,2,1,1,0
2022-05-15,Hue City,Huong Thuy,15,1,1,0,0
2022-05-15,Hue City,Huong Thuy,16,1,1,0,0
2022-05-15,Hue City,Huong Thuy,17,1,1,0,0
2022-05-15,Hue City,Huong Thuy,19,4,1,3,2
2022-05-15,Hue City,Huong Thuy,21,2,1,1,1
2022-05-15,Hue City,Huong Tra,12,2,0,2,1
2022-05-15,Hue City,Huong Tra,15,1,0,1,0
2022-05-15,Hue City,Huong Tra,21,2,0,2,1
2022-05-15,Hue City,Phu Vang,6,1,1,0,0
2022-05-15,Hue City,Phu Vang,8,2,1,1,0
2022-05-15,Hue City,Phu Vang,11,1,1,0,0
2022-05-15,Hue City,Phu Vang,12,5,2,3,0
2022-05-15,Hue City,Phu Vang,13,2,2,0,0
2022-05-15,Hue City,Phu Vang,14,3,1,2,2
2022-05-15,Hue City,Phu Vang,15,8,4,4,0
2022-05-15,Hue City,Phu Vang,16,2,2,0,0
2022-05-15,Hue City,Phu Vang,17,2,2,0,0
2022-05-15,Hue City,Phu Vang,18,4,2,2,0
2022-05-15,Hue City,Phu Vang,19,2,2,0,0
2022-05-15,Hue City,Phu Vang,20,4,0,4,2
2022-05-15,Vung Tau,Ba Ria City,7,1,0,1,1
2022-05-15,Vung Tau,Ba Ria City,8,3,2,1,1
2022-05-15,Vung Tau,Ba Ria City,9,7,3,4,3
2022-05-15,Vung Tau,Ba Ria City,10,9,3,6,5
2022-05-15,Vung Tau,Ba Ria City,11,8,3,5,5
2022-05-15,Vung Tau,Ba Ria City,12,19,1,18,18
2022-05-15,Vung Tau,Ba Ria City,13,8,2,6,6
2022-05-15,Vung Tau,Ba Ria City,14,7,2,5,4
2022-05-15,Vung Tau,Ba Ria City,15,8,4,4,4
2022-05-15,Vung Tau,Ba Ria City,16,11,3,8,7
2022-05-15,Vung Tau,Ba Ria City,17,10,0,10,9
2022-05-15,Vung Tau,Ba Ria City,18,9,0,9,8
2022-05-15,Vung Tau,Ba Ria City,19,6,0,6,6
2022-05-15,Vung Tau,Ba Ria City,20,3,0,3,3
2022-05-15,Vung Tau,Tan Thanh,15,1,0,1,1
2022-05-15,Vung Tau,Vung Tau City,2,1,0,1,0
2022-05-15,Vung Tau,Vung Tau City,5,3,2,1,0
2022-05-15,Vung Tau,Vung Tau City,6,38,32,6,3
2022-05-15,Vung Tau,Vung Tau City,7,133,106,27,15
2022-05-15,Vung Tau,Vung Tau City,8,250,207,43,21
2022-05-15,Vung Tau,Vung Tau City,9,261,227,34,14
2022-05-15,Vung Tau,Vung Tau City,10,330,301,29,10
2022-05-15,Vung Tau,Vung Tau City,11,501,428,73,30
2022-05-15,Vung Tau,Vung Tau City,12,450,356,94,54
2022-05-15,Vung Tau,Vung Tau City,13,292,269,23,9
2022-05-15,Vung Tau,Vung Tau City,14,251,221,30,1
2022-05-15,Vung Tau,Vung Tau City,15,219,210,9,2
2022-05-15,Vung Tau,Vung Tau City,16,241,213,28,3
2022-05-15,Vung Tau,Vung Tau City,17,293,253,40,11
2022-05-15,Vung Tau,Vung Tau City,18,359,286,73,41
2022-05-15,Vung Tau,Vung Tau City,19,390,301,89,62
2022-05-15,Vung Tau,Vung Tau City,20,218,168,50,26
2022-05-15,Vung Tau,Vung Tau City,21,110,84,26,14
2022-05-15,Vung Tau,Vung Tau City,22,1,0,1,0
2022-05-16,Binh Duong,Ben Cat,11,1,0,1,1
2022-05-16,Binh Duong,Ben Cat,12,1,0,1,1
2022-05-16,Binh Duong,Ben Cat,19,1,1,0,0
2022-05-16,Binh Duong,Ben Cat,20,1,0,1,0
2022-05-16,Binh Duong,Ben Cat,21,1,0,1,1
2022-05-16,Binh Duong,Di An,0,1,0,1,1
2022-05-16,Binh Duong,Di An,7,3,1,2,2
2022-05-16,Binh Duong,Di An,8,8,4,4,4
2022-05-16,Binh Duong,Di An,9,13,4,9,9
2022-05-16,Binh Duong,Di An,10,32,6,26,23
2022-05-16,Binh Duong,Di An,11,48,19,29,25
2022-05-16,Binh Duong,Di An,12,47,9,38,31
2022-05-16,Binh Duong,Di An,13,22,11,11,8
2022-05-16,Binh Duong,Di An,14,32,22,10,7
2022-05-16,Binh Duong,Di An,15,18,9,9,8
2022-05-16,Binh Duong,Di An,16,33,18,15,15
2022-05-16,Binh Duong,Di An,17,29,10,19,17
2022-05-16,Binh Duong,Di An,18,28,16,12,8
2022-05-16,Binh Duong,Di An,19,30,21,9,5
2022-05-16,Binh Duong,Di An,20,19,9,10,3
2022-05-16,Binh Duong,Di An,21,6,1,5,4
2022-05-16,Binh Duong,Tan Uyen,7,1,0,1,1
2022-05-16,Binh Duong,Tan Uyen,8,1,0,1,1
2022-05-16,Binh Duong,Tan Uyen,9,2,1,1,0
2022-05-16,Binh Duong,Tan Uyen,10,6,3,3,3
2022-05-16,Binh Duong,Tan Uyen,11,8,1,7,4
2022-05-16,Binh Duong,Tan Uyen,12,2,1,1,1
2022-05-16,Binh Duong,Tan Uyen,13,5,3,2,2
2022-05-16,Binh Duong,Tan Uyen,14,3,2,1,1
2022-05-16,Binh Duong,Tan Uyen,15,2,1,1,0
2022-05-16,Binh Duong,Tan Uyen,17,2,1,1,0
2022-05-16,Binh Duong,Tan Uyen,18,5,2,3,3
2022-05-16,Binh Duong,Tan Uyen,19,2,1,1,1
2022-05-16,Binh Duong,Tan Uyen,20,4,1,3,3
2022-05-16,Binh Duong,Thu Dau Mot Town,1,1,0,1,1
2022-05-16,Binh Duong,Thu Dau Mot Town,2,1,0,1,0
2022-05-16,Binh Duong,Thu Dau Mot Town,6,52,33,19,14
2022-05-16,Binh Duong,Thu Dau Mot Town,7,146,114,32,18
2022-05-16,Binh Duong,Thu Dau Mot Town,8,235,219,16,4
2022-05-16,Binh Duong,Thu Dau Mot Town,9,236,220,16,2
2022-05-16,Binh Duong,Thu Dau Mot Town,10,401,375,26,3
2022-05-16,Binh Duong,Thu Dau Mot Town,11,647,603,44,5
2022-05-16,Binh Duong,Thu Dau Mot Town,12,501,473,28,1
2022-05-16,Binh Duong,Thu Dau Mot Town,13,363,334,29,9
2022-05-16,Binh Duong,Thu Dau Mot Town,14,320,290,30,8
2022-05-16,Binh Duong,Thu Dau Mot Town,15,253,243,10,3
2022-05-16,Binh Duong,Thu Dau Mot Town,16,289,269,20,2
2022-05-16,Binh Duong,Thu Dau Mot Town,17,365,342,23,2
2022-05-16,Binh Duong,Thu Dau Mot Town,18,430,398,32,4
2022-05-16,Binh Duong,Thu Dau Mot Town,19,340,318,22,2
2022-05-16,Binh Duong,Thu Dau Mot Town,20,245,220,25,2
2022-05-16,Binh Duong,Thu Dau Mot Town,21,128,100,28,4
2022-05-16,Binh Duong,Thu Dau Mot Town,22,3,0,3,0
2022-05-16,Binh Duong,Thuan An,6,4,1,3,3
2022-05-16,Binh Duong,Thuan An,7,9,6,3,3
2022-05-16,Binh Duong,Thuan An,8,18,7,11,8
2022-05-16,Binh Duong,Thuan An,9,45,30,15,12
2022-05-16,Binh Duong,Thuan An,10,43,37,6,5
2022-05-16,Binh Duong,Thuan An,11,92,65,27,20
2022-05-16,Binh Duong,Thuan An,12,84,56,28,18
2022-05-16,Binh Duong,Thuan An,13,59,40,19,10
2022-05-16,Binh Duong,Thuan An,14,47,35,12,8
2022-05-16,Binh Duong,Thuan An,15,43,33,10,8
2022-05-16,Binh Duong,Thuan An,16,44,35,9,7
2022-05-16,Binh Duong,Thuan An,17,32,27,5,3
2022-05-16,Binh Duong,Thuan An,18,49,35,14,13
2022-05-16,Binh Duong,Thuan An,19,42,29,13,8
2022-05-16,Binh Duong,Thuan An,20,39,24,15,9
2022-05-16,Binh Duong,Thuan An,21,21,5,16,13
2022-05-16,Can Tho City,Binh Thuy District,7,2,1,1,0
2022-05-16,Can Tho City,Binh Thuy District,8,4,3,1,1
2022-05-16,Can Tho City,Binh Thuy District,9,2,2,0,0
2022-05-16,Can Tho City,Binh Thuy District,10,11,11,0,0
2022-05-16,Can Tho City,Binh Thuy District,11,10,9,1,0
2022-05-16,Can Tho City,Binh Thuy District,12,11,10,1,0
2022-05-16,Can Tho City,Binh Thuy District,13,13,12,1,0
2022-05-16,Can Tho City,Binh Thuy District,14,14,12,2,0
2022-05-16,Can Tho City,Binh Thuy District,15,5,5,0,0
2022-05-16,Can Tho City,Binh Thuy District,16,6,6,0,0
2022-05-16,Can Tho City,Binh Thuy District,17,8,8,0,0
2022-05-16,Can Tho City,Binh Thuy District,18,11,10,1,0
2022-05-16,Can Tho City,Binh Thuy District,19,9,9,0,0
2022-05-16,Can Tho City,Binh Thuy District,20,5,5,0,0
2022-05-16,Can Tho City,Binh Thuy District,21,4,1,3,1
2022-05-16,Can Tho City,Cai Rang District,6,2,1,1,1
2022-05-16,Can Tho City,Cai Rang District,7,1,1,0,0
2022-05-16,Can Tho City,Cai Rang District,8,5,5,0,0
2022-05-16,Can Tho City,Cai Rang District,9,8,3,5,4
2022-05-16,Can Tho City,Cai Rang District,10,5,4,1,0
2022-05-16,Can Tho City,Cai Rang District,11,16,15,1,0
2022-05-16,Can Tho City,Cai Rang District,12,11,11,0,0
2022-05-16,Can Tho City,Cai Rang District,13,7,4,3,1
2022-05-16,Can Tho City,Cai Rang District,14,14,13,1,1
2022-05-16,Can Tho City,Cai Rang District,15,6,6,0,0
2022-05-16,Can Tho City,Cai Rang District,16,6,6,0,0
2022-05-16,Can Tho City,Cai Rang District,17,6,5,1,0
2022-05-16,Can Tho City,Cai Rang District,18,10,10,0,0
2022-05-16,Can Tho City,Cai Rang District,19,12,10,2,1
2022-05-16,Can Tho City,Cai Rang District,20,11,10,1,0
2022-05-16,Can Tho City,Cai Rang District,21,3,3,0,0
2022-05-16,Can Tho City,Ninh Kieu District,1,2,2,0,0
2022-05-16,Can Tho City,Ninh Kieu District,2,4,4,0,0
2022-05-16,Can Tho City,Ninh Kieu District,5,4,2,2,0
2022-05-16,Can Tho City,Ninh Kieu District,6,45,40,5,0
2022-05-16,Can Tho City,Ninh Kieu District,7,162,148,14,1
2022-05-16,Can Tho City,Ninh Kieu District,8,276,260,16,0
2022-05-16,Can Tho City,Ninh Kieu District,9,326,303,23,0
2022-05-16,Can Tho City,Ninh Kieu District,10,570,538,32,0
2022-05-16,Can Tho City,Ninh Kieu District,11,857,822,35,1
2022-05-16,Can Tho City,Ninh Kieu District,12,608,581,27,0
2022-05-16,Can Tho City,Ninh Kieu District,13,521,499,22,0
2022-05-16,Can Tho City,Ninh Kieu District,14,469,446,23,0
2022-05-16,Can Tho City,Ninh Kieu District,15,340,323,17,0
2022-05-16,Can Tho City,Ninh Kieu District,16,467,442,25,0
2022-05-16,Can Tho City,Ninh Kieu District,17,529,515,14,0
2022-05-16,Can Tho City,Ninh Kieu District,18,576,545,31,0
2022-05-16,Can Tho City,Ninh Kieu District,19,441,419,22,0
2022-05-16,Can Tho City,Ninh Kieu District,20,421,384,37,0
2022-05-16,Can Tho City,Ninh Kieu District,21,241,214,27,1
2022-05-16,Can Tho City,Ninh Kieu District,22,3,0,3,0
2022-05-16,Dong Nai,Bien Hoa City,0,2,1,1,0
2022-05-16,Dong Nai,Bien Hoa City,1,1,0,1,1
2022-05-16,Dong Nai,Bien Hoa City,5,1,0,1,1
2022-05-16,Dong Nai,Bien Hoa City,6,40,23,17,15
2022-05-16,Dong Nai,Bien Hoa City,7,156,126,30,18
2022-05-16,Dong Nai,Bien Hoa City,8,270,236,34,9
2022-05-16,Dong Nai,Bien Hoa City,9,354,314,40,6
2022-05-16,Dong Nai,Bien Hoa City,10,740,660,80,23
2022-05-16,Dong Nai,Bien Hoa City,11,1100,977,123,27
2022-05-16,Dong Nai,Bien Hoa City,12,929,842,87,12
2022-05-16,Dong Nai,Bien Hoa City,13,853,766,87,32
2022-05-16,Dong Nai,Bien Hoa City,14,713,637,76,22
2022-05-16,Dong Nai,Bien Hoa City,15,473,436,37,15
2022-05-16,Dong Nai,Bien Hoa City,16,478,419,59,23
2022-05-16,Dong Nai,Bien Hoa City,17,593,549,44,11
2022-05-16,Dong Nai,Bien Hoa City,18,682,626,56,10
2022-05-16,Dong Nai,Bien Hoa City,19,618,582,36,7
2022-05-16,Dong Nai,Bien Hoa City,20,432,377,55,14
2022-05-16,Dong Nai,Bien Hoa City,21,206,142,64,27
2022-05-16,Dong Nai,Bien Hoa City,22,2,0,2,0
2022-05-16,Dong Nai,Long Thanh,12,1,0,1,1
2022-05-16,Dong Nai,Long Thanh,14,1,0,1,1
2022-05-16,Dong Nai,Long Thanh,18,1,0,1,1
2022-05-16,Dong Nai,Long Thanh,19,3,0,3,2
2022-05-16,Dong Nai,Long Thanh,20,1,0,1,1
2022-05-16,Dong Nai,Long Thanh,21,2,0,2,2
2022-05-16,Dong Nai,Trang Bom,10,1,0,1,1
2022-05-16,Dong Nai,Trang Bom,12,2,0,2,2
2022-05-16,Dong Nai,Trang Bom,13,1,0,1,1
2022-05-16,Dong Nai,Trang Bom,14,2,0,2,2
2022-05-16,Dong Nai,Trang Bom,21,1,0,1,1
2022-05-16,Hai Phong City,An Duong,2,1,1,0,0
2022-05-16,Hai Phong City,An Duong,8,3,1,2,0
2022-05-16,Hai Phong City,An Duong,9,1,0,1,1
2022-05-16,Hai Phong City,An Duong,10,2,0,2,0
2022-05-16,Hai Phong City,An Duong,11,1,1,0,0
2022-05-16,Hai Phong City,An Duong,12,7,5,2,1
2022-05-16,Hai Phong City,An Duong,13,1,0,1,0
2022-05-16,Hai Phong City,An Duong,14,6,2,4,4
2022-05-16,Hai Phong City,An Duong,15,1,0,1,1
2022-05-16,Hai Phong City,An Duong,16,1,0,1,1
2022-05-16,Hai Phong City,An Duong,17,3,1,2,0
2022-05-16,Hai Phong City,An Duong,19,1,1,0,0
2022-05-16,Hai Phong City,An Duong,20,3,2,1,0
2022-05-16,Hai Phong City,Hai An District,7,4,0,4,2
2022-05-16,Hai Phong City,Hai An District,8,12,10,2,2
2022-05-16,Hai Phong City,Hai An District,9,14,11,3,1
2022-05-16,Hai Phong City,Hai An District,10,17,15,2,1
2022-05-16,Hai Phong City,Hai An District,11,34,26,8,4
2022-05-16,Hai Phong City,Hai An District,12,29,27,2,0
2022-05-16,Hai Phong City,Hai An District,13,19,13,6,3
2022-05-16,Hai Phong City,Hai An District,14,13,9,4,1
2022-05-16,Hai Phong City,Hai An District,15,15,13,2,1
2022-05-16,Hai Phong City,Hai An District,16,14,12,2,1
2022-05-16,Hai Phong City,Hai An District,17,14,11,3,0
2022-05-16,Hai Phong City,Hai An District,18,28,20,8,0
2022-05-16,Hai Phong City,Hai An District,19,23,18,5,4
2022-05-16,Hai Phong City,Hai An District,20,12,9,3,0
2022-05-16,Hai Phong City,Hai An District,21,13,8,5,3
2022-05-16,Hai Phong City,Hong Bang District,6,1,1,0,0
2022-05-16,Hai Phong City,Hong Bang District,7,13,6,7,4
2022-05-16,Hai Phong City,Hong Bang District,8,21,18,3,2
2022-05-16,Hai Phong City,Hong Bang District,9,28,22,6,2
2022-05-16,Hai Phong City,Hong Bang District,10,49,44,5,3
2022-05-16,Hai Phong City,Hong Bang District,11,83,72,11,3
2022-05-16,Hai Phong City,Hong Bang District,12,64,60,4,2
2022-05-16,Hai Phong City,Hong Bang District,13,43,40,3,0
2022-05-16,Hai Phong City,Hong Bang District,14,49,40,9,7
2022-05-16,Hai Phong City,Hong Bang District,15,42,33,9,6
2022-05-16,Hai Phong City,Hong Bang District,16,38,33,5,2
2022-05-16,Hai Phong City,Hong Bang District,17,29,28,1,1
2022-05-16,Hai Phong City,Hong Bang District,18,42,35,7,0
2022-05-16,Hai Phong City,Hong Bang District,19,56,43,13,5
2022-05-16,Hai Phong City,Hong Bang District,20,42,34,8,3
2022-05-16,Hai Phong City,Hong Bang District,21,18,13,5,2
2022-05-16,Hai Phong City,Kien An District,7,1,0,1,1
2022-05-16,Hai Phong City,Kien An District,8,6,1,5,2
2022-05-16,Hai Phong City,Kien An District,9,4,3,1,1
2022-05-16,Hai Phong City,Kien An District,10,7,2,5,4
2022-05-16,Hai Phong City,Kien An District,11,20,10,10,10
2022-05-16,Hai Phong City,Kien An District,12,12,9,3,2
2022-05-16,Hai Phong City,Kien An District,13,2,2,0,0
2022-05-16,Hai Phong City,Kien An District,14,3,2,1,1
2022-05-16,Hai Phong City,Kien An District,15,8,3,5,3
2022-05-16,Hai Phong City,Kien An District,16,6,3,3,3
2022-05-16,Hai Phong City,Kien An District,17,7,5,2,2
2022-05-16,Hai Phong City,Kien An District,18,14,12,2,1
2022-05-16,Hai Phong City,Kien An District,19,18,15,3,1
2022-05-16,Hai Phong City,Kien An District,20,5,3,2,1
2022-05-16,Hai Phong City,Kien An District,21,3,0,3,3
2022-05-16,Hai Phong City,Le Chan District,0,1,1,0,0
2022-05-16,Hai Phong City,Le Chan District,1,2,1,1,0
2022-05-16,Hai Phong City,Le Chan District,6,1,1,0,0
2022-05-16,Hai Phong City,Le Chan District,7,32,22,10,8
2022-05-16,Hai Phong City,Le Chan District,8,60,50,10,3
2022-05-16,Hai Phong City,Le Chan District,9,61,55,6,0
2022-05-16,Hai Phong City,Le Chan District,10,131,117,14,1
2022-05-16,Hai Phong City,Le Chan District,11,271,249,22,4
2022-05-16,Hai Phong City,Le Chan District,12,188,177,11,0
2022-05-16,Hai Phong City,Le Chan District,13,114,102,12,3
2022-05-16,Hai Phong City,Le Chan District,14,123,109,14,3
2022-05-16,Hai Phong City,Le Chan District,15,157,136,21,5
2022-05-16,Hai Phong City,Le Chan District,16,129,109,20,3
2022-05-16,Hai Phong City,Le Chan District,17,170,157,13,1
2022-05-16,Hai Phong City,Le Chan District,18,224,199,25,1
2022-05-16,Hai Phong City,Le Chan District,19,193,173,20,3
2022-05-16,Hai Phong City,Le Chan District,20,112,96,16,6
2022-05-16,Hai Phong City,Le Chan District,21,76,52,24,4
2022-05-16,Hai Phong City,Ngo Quyen District,0,1,0,1,0
2022-05-16,Hai Phong City,Ngo Quyen District,6,1,1,0,0
2022-05-16,Hai Phong City,Ngo Quyen District,7,25,17,8,3
2022-05-16,Hai Phong City,Ngo Quyen District,8,60,51,9,2
2022-05-16,Hai Phong City,Ngo Quyen District,9,78,64,14,1
2022-05-16,Hai Phong City,Ngo Quyen District,10,136,116,20,1
2022-05-16,Hai Phong City,Ngo Quyen District,11,215,190,25,3
2022-05-16,Hai Phong City,Ngo Quyen District,12,128,119,9,2
2022-05-16,Hai Phong City,Ngo Quyen District,13,72,61,11,2
2022-05-16,Hai Phong City,Ngo Quyen District,14,104,93,11,4
2022-05-16,Hai Phong City,Ngo Quyen District,15,138,125,13,3
2022-05-16,Hai Phong City,Ngo Quyen District,16,94,86,8,0
2022-05-16,Hai Phong City,Ngo Quyen District,17,108,99,9,2
2022-05-16,Hai Phong City,Ngo Quyen District,18,140,131,9,1
2022-05-16,Hai Phong City,Ngo Quyen District,19,137,125,12,2
2022-05-16,Hai Phong City,Ngo Quyen District,20,111,95,16,5
2022-05-16,Hai Phong City,Ngo Quyen District,21,62,47,15,6
2022-05-16,Hai Phong City,Thuy Nguyen,11,2,0,2,2
2022-05-16,Hai Phong City,Thuy Nguyen,14,2,0,2,2
2022-05-16,Hue City,Hue City,0,5,5,0,0
2022-05-16,Hue City,Hue City,2,2,1,1,0
2022-05-16,Hue City,Hue City,5,3,2,1,0
2022-05-16,Hue City,Hue City,6,60,55,5,1
2022-05-16,Hue City,Hue City,7,176,160,16,3
2022-05-16,Hue City,Hue City,8,368,338,30,1
2022-05-16,Hue City,Hue City,9,337,306,31,2
2022-05-16,Hue City,Hue City,10,430,393,37,1
2022-05-16,Hue City,Hue City,11,895,798,97,13
2022-05-16,Hue City,Hue City,12,549,506,43,4
2022-05-16,Hue City,Hue City,13,349,318,31,0
2022-05-16,Hue City,Hue City,14,397,363,34,5
2022-05-16,Hue City,Hue City,15,424,382,42,7
2022-05-16,Hue City,Hue City,16,423,390,33,2
2022-05-16,Hue City,Hue City,17,594,536,58,3
2022-05-16,Hue City,Hue City,18,766,661,105,24
2022-05-16,Hue City,Hue City,19,711,602,109,30
2022-05-16,Hue City,Hue City,20,513,402,111,40
2022-05-16,Hue City,Hue City,21,300,206,94,41
2022-05-16,Hue City,Hue City,22,1,0,1,0
2022-05-16,Hue City,Huong Thuy,7,1,1,0,0
2022-05-16,Hue City,Huong Thuy,10,3,2,1,0
2022-05-16,Hue City,Huong Thuy,12,1,1,0,0
2022-05-16,Hue City,Huong Thuy,13,2,2,0,0
2022-05-16,Hue City,Huong Thuy,18,1,1,0,0
2022-05-16,Hue City,Huong Thuy,19,2,1,1,0
2022-05-16,Hue City,Huong Tra,14,1,0,1,1
2022-05-16,Hue City,Huong Tra,15,2,1,1,1
2022-05-16,Hue City,Phu Vang,6,1,0,1,1
2022-05-16,Hue City,Phu Vang,7,1,1,0,0
2022-05-16,Hue City,Phu Vang,9,1,1,0,0
2022-05-16,Hue City,Phu Vang,11,2,2,0,0
2022-05-16,Hue City,Phu Vang,13,3,2,1,0
2022-05-16,Hue City,Phu Vang,14,3,2,1,0
2022-05-16,Hue City,Phu Vang,15,2,2,0,0
2022-05-16,Hue City,Phu Vang,17,1,1,0,0
2022-05-16,Hue City,Phu Vang,18,4,3,1,0
2022-05-16,Hue City,Phu Vang,19,2,2,0,0
2022-05-16,Hue City,Phu Vang,20,1,1,0,0
2022-05-16,Hue City,Phu Vang,21,2,2,0,0
2022-05-16,Vung Tau,Ba Ria City,8,2,2,0,0
2022-05-16,Vung Tau,Ba Ria City,9,8,3,5,4
2022-05-16,Vung Tau,Ba Ria City,10,9,4,5,4
2022-05-16,Vung Tau,Ba Ria City,11,7,2,5,4
2022-05-16,Vung Tau,Ba Ria City,12,4,0,4,4
2022-05-16,Vung Tau,Ba Ria City,13,2,0,2,2
2022-05-16,Vung Tau,Ba Ria City,14,5,0,5,4
2022-05-16,Vung Tau,Ba Ria City,15,4,2,2,2
2022-05-16,Vung Tau,Ba Ria City,16,3,1,2,2
2022-05-16,Vung Tau,Ba Ria City,17,12,0,12,10
2022-05-16,Vung Tau,Ba Ria City,18,4,1,3,3
2022-05-16,Vung Tau,Ba Ria City,19,13,0,13,13
2022-05-16,Vung Tau,Ba Ria City,21,2,0,2,1
2022-05-16,Vung Tau,Vung Tau City,0,1,0,1,1
2022-05-16,Vung Tau,Vung Tau City,3,1,1,0,0
2022-05-16,Vung Tau,Vung Tau City,5,1,1,0,0
2022-05-16,Vung Tau,Vung Tau City,6,35,29,6,3
2022-05-16,Vung Tau,Vung Tau City,7,81,75,6,1
2022-05-16,Vung Tau,Vung Tau City,8,159,142,17,3
2022-05-16,Vung Tau,Vung Tau City,9,191,182,9,0
2022-05-16,Vung Tau,Vung Tau City,10,180,165,15,2
2022-05-16,Vung Tau,Vung Tau City,11,342,325,17,1
2022-05-16,Vung Tau,Vung Tau City,12,286,270,16,1
2022-05-16,Vung Tau,Vung Tau City,13,201,190,11,5
2022-05-16,Vung Tau,Vung Tau City,14,208,186,22,7
2022-05-16,Vung Tau,Vung Tau City,15,201,185,16,6
2022-05-16,Vung Tau,Vung Tau City,16,200,184,16,1
2022-05-16,Vung Tau,Vung Tau City,17,274,253,21,2
2022-05-16,Vung Tau,Vung Tau City,18,279,264,15,0
2022-05-16,Vung Tau,Vung Tau City,19,231,214,17,1
2022-05-16,Vung Tau,Vung Tau City,20,184,150,34,9
2022-05-16,Vung Tau,Vung Tau City,21,111,66,45,26
2022-05-16,Vung Tau,Vung Tau City,22,1,0,1,0
2022-05-17,Binh Duong,Ben Cat,8,1,1,0,0
2022-05-17,Binh Duong,Ben Cat,9,2,0,2,2
2022-05-17,Binh Duong,Ben Cat,20,1,0,1,1
2022-05-17,Binh Duong,Di An,6,2,0,2,2
2022-05-17,Binh Duong,Di An,7,15,3,12,11
2022-05-17,Binh Duong,Di An,8,6,4,2,1
2022-05-17,Binh Duong,Di An,9,17,7,10,10
2022-05-17,Binh Duong,Di An,10,26,11,15,14
2022-05-17,Binh Duong,Di An,11,37,16,21,18
2022-05-17,Binh Duong,Di An,12,43,20,23,21
2022-05-17,Binh Duong,Di An,13,48,19,29,20
2022-05-17,Binh Duong,Di An,14,33,18,15,12
2022-05-17,Binh Duong,Di An,15,19,15,4,3
2022-05-17,Binh Duong,Di An,16,23,13,10,7
2022-05-17,Binh Duong,Di An,17,38,9,29,24
2022-05-17,Binh Duong,Di An,18,34,13,21,17
2022-05-17,Binh Duong,Di An,19,41,18,23,14
2022-05-17,Binh Duong,Di An,20,24,17,7,3
2022-05-17,Binh Duong,Di An,21,9,2,7,5
2022-05-17,Binh Duong,Tan Uyen,10,2,1,1,1
2022-05-17,Binh Duong,Tan Uyen,11,1,1,0,0
2022-05-17,Binh Duong,Tan Uyen,12,3,2,1,0
2022-05-17,Binh Duong,Tan Uyen,13,7,4,3,3
2022-05-17,Binh Duong,Tan Uyen,14,3,2,1,1
2022-05-17,Binh Duong,Tan Uyen,15,2,0,2,2
2022-05-17,Binh Duong,Tan Uyen,16,1,0,1,1
2022-05-17,Binh Duong,Tan Uyen,17,2,2,0,0
2022-05-17,Binh Duong,Tan Uyen,18,4,2,2,2
2022-05-17,Binh Duong,Tan Uyen,21,1,0,1,1
2022-05-17,Binh Duong,Thu Dau Mot Town,5,1,1,0,0
2022-05-17,Binh Duong,Thu Dau Mot Town,6,48,42,6,4
2022-05-17,Binh Duong,Thu Dau Mot Town,7,114,101,13,4
2022-05-17,Binh Duong,Thu Dau Mot Town,8,215,202,13,2
2022-05-17,Binh Duong,Thu Dau Mot Town,9,234,214,20,0
2022-05-17,Binh Duong,Thu Dau Mot Town,10,398,376,22,1
2022-05-17,Binh Duong,Thu Dau Mot Town,11,668,619,49,5
2022-05-17,Binh Duong,Thu Dau Mot Town,12,449,430,19,1
2022-05-17,Binh Duong,Thu Dau Mot Town,13,444,411,33,1
2022-05-17,Binh Duong,Thu Dau Mot Town,14,315,296,19,0
2022-05-17,Binh Duong,Thu Dau Mot Town,15,249,237,12,3
2022-05-17,Binh Duong,Thu Dau Mot Town,16,311,287,24,3
2022-05-17,Binh Duong,Thu Dau Mot Town,17,378,358,20,5
2022-05-17,Binh Duong,Thu Dau Mot Town,18,376,360,16,0
2022-05-17,Binh Duong,Thu Dau Mot Town,19,329,307,22,0
2022-05-17,Binh Duong,Thu Dau Mot Town,20,260,240,20,4
2022-05-17,Binh Duong,Thu Dau Mot Town,21,114,92,22,4
2022-05-17,Binh Duong,Thu Dau Mot Town,22,2,0,2,0
2022-05-17,Binh Duong,Thuan An,5,1,1,0,0
2022-05-17,Binh Duong,Thuan An,6,3,0,3,1
2022-05-17,Binh Duong,Thuan An,7,7,3,4,4
2022-05-17,Binh Duong,Thuan An,8,9,7,2,2
2022-05-17,Binh Duong,Thuan An,9,35,25,10,8
2022-05-17,Binh Duong,Thuan An,10,57,35,22,15
2022-05-17,Binh Duong,Thuan An,11,87,62,25,21
2022-05-17,Binh Duong,Thuan An,12,48,33,15,9
2022-05-17,Binh Duong,Thuan An,13,38,36,2,2
2022-05-17,Binh Duong,Thuan An,14,46,38,8,4
2022-05-17,Binh Duong,Thuan An,15,37,30,7,2
2022-05-17,Binh Duong,Thuan An,16,39,33,6,4
2022-05-17,Binh Duong,Thuan An,17,48,32,16,10
2022-05-17,Binh Duong,Thuan An,18,44,37,7,2
2022-05-17,Binh Duong,Thuan An,19,54,33,21,11
2022-05-17,Binh Duong,Thuan An,20,35,20,15,11
2022-05-17,Binh Duong,Thuan An,21,21,8,13,8
2022-05-17,Can Tho City,Binh Thuy District,6,1,1,0,0
2022-05-17,Can Tho City,Binh Thuy District,7,2,2,0,0
2022-05-17,Can Tho City,Binh Thuy District,8,4,3,1,0
2022-05-17,Can Tho City,Binh Thuy District,9,6,6,0,0
2022-05-17,Can Tho City,Binh Thuy District,10,5,5,0,0
2022-05-17,Can Tho City,Binh Thuy District,11,12,12,0,0
2022-05-17,Can Tho City,Binh Thuy District,12,11,11,0,0
2022-05-17,Can Tho City,Binh Thuy District,13,12,12,0,0
2022-05-17,Can Tho City,Binh Thuy District,14,11,11,0,0
2022-05-17,Can Tho City,Binh Thuy District,15,7,6,1,0
2022-05-17,Can Tho City,Binh Thuy District,16,12,11,1,0
2022-05-17,Can Tho City,Binh Thuy District,17,11,9,2,0
2022-05-17,Can Tho City,Binh Thuy District,18,12,12,0,0
2022-05-17,Can Tho City,Binh Thuy District,19,9,8,1,0
2022-05-17,Can Tho City,Binh Thuy District,20,6,6,0,0
2022-05-17,Can Tho City,Binh Thuy District,21,3,2,1,0
2022-05-17,Can Tho City,Cai Rang District,1,1,0,1,0
2022-05-17,Can Tho City,Cai Rang District,6,2,1,1,1
2022-05-17,Can Tho City,Cai Rang District,7,4,3,1,1
2022-05-17,Can Tho City,Cai Rang District,8,12,7,5,3
2022-05-17,Can Tho City,Cai Rang District,9,6,6,0,0
2022-05-17,Can Tho City,Cai Rang District,10,9,6,3,0
2022-05-17,Can Tho City,Cai Rang District,11,14,14,0,0
2022-05-17,Can Tho City,Cai Rang District,12,6,6,0,0
2022-05-17,Can Tho City,Cai Rang District,13,12,11,1,0
2022-05-17,Can Tho City,Cai Rang District,14,11,8,3,1
2022-05-17,Can Tho City,Cai Rang District,15,11,9,2,0
2022-05-17,Can Tho City,Cai Rang District,16,12,8,4,2
2022-05-17,Can Tho City,Cai Rang District,17,13,11,2,0
2022-05-17,Can Tho City,Cai Rang District,18,12,8,4,1
2022-05-17,Can Tho City,Cai Rang District,19,7,7,0,0
2022-05-17,Can Tho City,Cai Rang District,20,4,3,1,0
2022-05-17,Can Tho City,Cai Rang District,21,2,1,1,0
2022-05-17,Can Tho City,Ninh Kieu District,0,1,1,0,0
2022-05-17,Can Tho City,Ninh Kieu District,1,2,2,0,0
2022-05-17,Can Tho City,Ninh Kieu District,2,1,0,1,0
2022-05-17,Can Tho City,Ninh Kieu District,5,1,1,0,0
2022-05-17,Can Tho City,Ninh Kieu District,6,46,37,9,8
2022-05-17,Can Tho City,Ninh Kieu District,7,121,110,11,0
2022-05-17,Can Tho City,Ninh Kieu District,8,256,240,16,1
2022-05-17,Can Tho City,Ninh Kieu District,9,315,303,12,0
2022-05-17,Can Tho City,Ninh Kieu District,10,602,566,36,0
2022-05-17,Can Tho City,Ninh Kieu District,11,859,822,37,1
2022-05-17,Can Tho City,Ninh Kieu District,12,667,636,31,0
2022-05-17,Can Tho City,Ninh Kieu District,13,500,484,16,0
2022-05-17,Can Tho City,Ninh Kieu District,14,423,406,17,0
2022-05-17,Can Tho City,Ninh Kieu District,15,371,353,18,0
2022-05-17,Can Tho City,Ninh Kieu District,16,446,422,24,0
2022-05-17,Can Tho City,Ninh Kieu District,17,644,614,30,0
2022-05-17,Can Tho City,Ninh Kieu District,18,574,536,38,0
2022-05-17,Can Tho City,Ninh Kieu District,19,538,516,22,1
2022-05-17,Can Tho City,Ninh Kieu District,20,417,389,28,0
2022-05-17,Can Tho City,Ninh Kieu District,21,212,189,23,0
2022-05-17,Can Tho City,Ninh Kieu District,22,3,1,2,0
2022-05-17,Can Tho City,Ninh Kieu District,23,3,0,3,0
2022-05-17,Can Tho City,Thoi Lai,10,1,0,1,1
2022-05-17,Dong Nai,Bien Hoa City,0,2,0,2,2
2022-05-17,Dong Nai,Bien Hoa City,2,3,2,1,1
2022-05-17,Dong Nai,Bien Hoa City,3,1,0,1,0
2022-05-17,Dong Nai,Bien Hoa City,6,47,24,23,19
2022-05-17,Dong Nai,Bien Hoa City,7,153,125,28,14
2022-05-17,Dong Nai,Bien Hoa City,8,319,282,37,8
2022-05-17,Dong Nai,Bien Hoa City,9,411,374,37,4
2022-05-17,Dong Nai,Bien Hoa City,10,714,647,67,18
2022-05-17,Dong Nai,Bien Hoa City,11,984,844,140,73
2022-05-17,Dong Nai,Bien Hoa City,12,841,756,85,34
2022-05-17,Dong Nai,Bien Hoa City,13,831,760,71,21
2022-05-17,Dong Nai,Bien Hoa City,14,641,595,46,7
2022-05-17,Dong Nai,Bien Hoa City,15,471,428,43,5
2022-05-17,Dong Nai,Bien Hoa City,16,536,459,77,27
2022-05-17,Dong Nai,Bien Hoa City,17,632,543,89,39
2022-05-17,Dong Nai,Bien Hoa City,18,763,660,103,33
2022-05-17,Dong Nai,Bien Hoa City,19,631,578,53,9
2022-05-17,Dong Nai,Bien Hoa City,20,514,436,78,10
2022-05-17,Dong Nai,Bien Hoa City,21,191,156,35,13
2022-05-17,Dong Nai,Long Khanh,11,3,0,3,3
2022-05-17,Dong Nai,Long Thanh,9,1,0,1,1
2022-05-17,Dong Nai,Long Thanh,10,1,0,1,1
2022-05-17,Dong Nai,Long Thanh,12,2,0,2,2
2022-05-17,Dong Nai,Long Thanh,19,1,0,1,1
2022-05-17,Dong Nai,Long Thanh,20,1,0,1,1
2022-05-17,Dong Nai,Nhon trach,18,1,0,1,1
2022-05-17,Dong Nai,Nhon trach,19,1,0,1,1
2022-05-17,Dong Nai,Trang Bom,9,2,0,2,2
2022-05-17,Dong Nai,Trang Bom,18,3,1,2,2
2022-05-17,Dong Nai,Trang Bom,19,1,0,1,1
2022-05-17,Dong Nai,Trang Bom,20,1,0,1,1
2022-05-17,Dong Nai,Trang Bom,21,2,0,2,2
2022-05-17,Hai Phong City,An Duong,7,2,1,1,1
2022-05-17,Hai Phong City,An Duong,8,5,0,5,2
2022-05-17,Hai Phong City,An Duong,9,6,0,6,5
2022-05-17,Hai Phong City,An Duong,10,4,2,2,1
2022-05-17,Hai Phong City,An Duong,11,1,1,0,0
2022-05-17,Hai Phong City,An Duong,12,1,0,1,1
2022-05-17,Hai Phong City,An Duong,13,3,1,2,2
2022-05-17,Hai Phong City,An Duong,14,8,0,8,7
2022-05-17,Hai Phong City,An Duong,15,3,2,1,1
2022-05-17,Hai Phong City,An Duong,16,3,2,1,0
2022-05-17,Hai Phong City,An Duong,17,4,3,1,0
2022-05-17,Hai Phong City,An Duong,18,2,2,0,0
2022-05-17,Hai Phong City,An Duong,19,6,1,5,2
2022-05-17,Hai Phong City,An Duong,20,1,0,1,1
2022-05-17,Hai Phong City,An Duong,21,2,2,0,0
2022-05-17,Hai Phong City,Duong Kinh District,10,1,0,1,0
2022-05-17,Hai Phong City,Hai An District,7,10,3,7,6
2022-05-17,Hai Phong City,Hai An District,8,11,7,4,2
2022-05-17,Hai Phong City,Hai An District,9,12,11,1,0
2022-05-17,Hai Phong City,Hai An District,10,12,11,1,0
2022-05-17,Hai Phong City,Hai An District,11,47,41,6,2
2022-05-17,Hai Phong City,Hai An District,12,24,21,3,2
2022-05-17,Hai Phong City,Hai An District,13,13,12,1,0
2022-05-17,Hai Phong City,Hai An District,14,20,12,8,3
2022-05-17,Hai Phong City,Hai An District,15,13,9,4,2
2022-05-17,Hai Phong City,Hai An District,16,15,13,2,1
2022-05-17,Hai Phong City,Hai An District,17,14,14,0,0
2022-05-17,Hai Phong City,Hai An District,18,18,15,3,1
2022-05-17,Hai Phong City,Hai An District,19,20,17,3,1
2022-05-17,Hai Phong City,Hai An District,20,14,8,6,2
2022-05-17,Hai Phong City,Hai An District,21,17,9,8,4
2022-05-17,Hai Phong City,Hong Bang District,6,1,0,1,1
2022-05-17,Hai Phong City,Hong Bang District,7,14,11,3,2
2022-05-17,Hai Phong City,Hong Bang District,8,41,36,5,2
2022-05-17,Hai Phong City,Hong Bang District,9,19,18,1,0
2022-05-17,Hai Phong City,Hong Bang District,10,47,41,6,0
2022-05-17,Hai Phong City,Hong Bang District,11,97,90,7,4
2022-05-17,Hai Phong City,Hong Bang District,12,57,49,8,0
2022-05-17,Hai Phong City,Hong Bang District,13,38,34,4,2
2022-05-17,Hai Phong City,Hong Bang District,14,41,37,4,2
2022-05-17,Hai Phong City,Hong Bang District,15,43,39,4,1
2022-05-17,Hai Phong City,Hong Bang District,16,25,22,3,0
2022-05-17,Hai Phong City,Hong Bang District,17,42,39,3,0
2022-05-17,Hai Phong City,Hong Bang District,18,55,52,3,1
2022-05-17,Hai Phong City,Hong Bang District,19,43,36,7,2
2022-05-17,Hai Phong City,Hong Bang District,20,32,29,3,1
2022-05-17,Hai Phong City,Hong Bang District,21,15,11,4,2
2022-05-17,Hai Phong City,Kien An District,7,5,1,4,4
2022-05-17,Hai Phong City,Kien An District,8,4,2,2,1
2022-05-17,Hai Phong City,Kien An District,9,5,3,2,1
2022-05-17,Hai Phong City,Kien An District,10,11,6,5,2
2022-05-17,Hai Phong City,Kien An District,11,16,7,9,6
2022-05-17,Hai Phong City,Kien An District,12,13,9,4,1
2022-05-17,Hai Phong City,Kien An District,13,5,2,3,2
2022-05-17,Hai Phong City,Kien An District,14,3,0,3,2
2022-05-17,Hai Phong City,Kien An District,15,8,0,8,8
2022-05-17,Hai Phong City,Kien An District,16,7,3,4,3
2022-05-17,Hai Phong City,Kien An District,17,8,5,3,3
2022-05-17,Hai Phong City,Kien An District,18,13,10,3,2
2022-05-17,Hai Phong City,Kien An District,19,16,11,5,5
2022-05-17,Hai Phong City,Kien An District,20,8,6,2,0
2022-05-17,Hai Phong City,Kien An District,21,7,1,6,3
2022-05-17,Hai Phong City,Le Chan District,7,32,28,4,2
2022-05-17,Hai Phong City,Le Chan District,8,79,65,14,6
2022-05-17,Hai Phong City,Le Chan District,9,90,75,15,1
2022-05-17,Hai Phong City,Le Chan District,10,153,136,17,2
2022-05-17,Hai Phong City,Le Chan District,11,316,299,17,3
2022-05-17,Hai Phong City,Le Chan District,12,162,151,11,0
2022-05-17,Hai Phong City,Le Chan District,13,113,98,15,2
2022-05-17,Hai Phong City,Le Chan District,14,127,117,10,2
2022-05-17,Hai Phong City,Le Chan District,15,137,114,23,9
2022-05-17,Hai Phong City,Le Chan District,16,113,109,4,0
2022-05-17,Hai Phong City,Le Chan District,17,152,145,7,1
2022-05-17,Hai Phong City,Le Chan District,18,162,154,8,0
2022-05-17,Hai Phong City,Le Chan District,19,208,189,19,7
2022-05-17,Hai Phong City,Le Chan District,20,143,121,22,1
2022-05-17,Hai Phong City,Le Chan District,21,58,39,19,6
2022-05-17,Hai Phong City,Ngo Quyen District,0,2,2,0,0
2022-05-17,Hai Phong City,Ngo Quyen District,2,1,1,0,0
2022-05-17,Hai Phong City,Ngo Quyen District,5,2,1,1,0
2022-05-17,Hai Phong City,Ngo Quyen District,6,2,0,2,0
2022-05-17,Hai Phong City,Ngo Quyen District,7,28,22,6,4
2022-05-17,Hai Phong City,Ngo Quyen District,8,59,46,13,4
2022-05-17,Hai Phong City,Ngo Quyen District,9,71,57,14,0
2022-05-17,Hai Phong City,Ngo Quyen District,10,102,93,9,0
2022-05-17,Hai Phong City,Ngo Quyen District,11,223,198,25,5
2022-05-17,Hai Phong City,Ngo Quyen District,12,129,119,10,3
2022-05-17,Hai Phong City,Ngo Quyen District,13,105,96,9,5
2022-05-17,Hai Phong City,Ngo Quyen District,14,147,134,13,2
2022-05-17,Hai Phong City,Ngo Quyen District,15,138,122,16,5
2022-05-17,Hai Phong City,Ngo Quyen District,16,100,89,11,0
2022-05-17,Hai Phong City,Ngo Quyen District,17,109,99,10,1
2022-05-17,Hai Phong City,Ngo Quyen District,18,158,149,9,0
2022-05-17,Hai Phong City,Ngo Quyen District,19,138,122,16,4
2022-05-17,Hai Phong City,Ngo Quyen District,20,111,104,7,4
2022-05-17,Hai Phong City,Ngo Quyen District,21,50,42,8,4
2022-05-17,Hai Phong City,Ngo Quyen District,23,1,0,1,0
2022-05-17,Hai Phong City,Thuy Nguyen,11,1,0,1,1
2022-05-17,Hai Phong City,Thuy Nguyen,12,1,1,0,0
2022-05-17,Hai Phong City,Thuy Nguyen,15,1,1,0,0
2022-05-17,Hai Phong City,Thuy Nguyen,16,1,0,1,1
2022-05-17,Hai Phong City,Thuy Nguyen,17,1,0,1,0
2022-05-17,Hai Phong City,Thuy Nguyen,18,2,0,2,2
2022-05-17,Hue City,Hue City,0,4,4,0,0
2022-05-17,Hue City,Hue City,4,1,0,1,1
2022-05-17,Hue City,Hue City,5,4,1,3,1
2022-05-17,Hue City,Hue City,6,71,60,11,5
2022-05-17,Hue City,Hue City,7,211,182,29,8
2022-05-17,Hue City,Hue City,8,365,343,22,0
2022-05-17,Hue City,Hue City,9,270,240,30,0
2022-05-17,Hue City,Hue City,10,403,378,25,0
2022-05-17,Hue City,Hue City,11,788,729,59,4
2022-05-17,Hue City,Hue City,12,481,450,31,0
2022-05-17,Hue City,Hue City,13,301,272,29,1
2022-05-17,Hue City,Hue City,14,372,337,35,3
2022-05-17,Hue City,Hue City,15,450,412,38,7
2022-05-17,Hue City,Hue City,16,434,415,19,0
2022-05-17,Hue City,Hue City,17,616,565,51,6
2022-05-17,Hue City,Hue City,18,747,683,64,4
2022-05-17,Hue City,Hue City,19,667,605,62,6
2022-05-17,Hue City,Hue City,20,480,422,58,19
2022-05-17,Hue City,Hue City,21,244,207,37,8
2022-05-17,Hue City,Hue City,22,3,1,2,0
2022-05-17,Hue City,Huong Thuy,8,3,2,1,0
2022-05-17,Hue City,Huong Thuy,10,3,3,0,0
2022-05-17,Hue City,Huong Thuy,11,1,1,0,0
2022-05-17,Hue City,Huong Thuy,12,1,0,1,1
2022-05-17,Hue City,Huong Thuy,14,2,0,2,1
2022-05-17,Hue City,Huong Thuy,15,2,1,1,0
2022-05-17,Hue City,Huong Thuy,18,1,0,1,1
2022-05-17,Hue City,Huong Thuy,19,1,1,0,0
2022-05-17,Hue City,Huong Tra,9,1,0,1,0
2022-05-17,Hue City,Huong Tra,17,1,1,0,0
2022-05-17,Hue City,Phu Vang,8,3,2,1,0
2022-05-17,Hue City,Phu Vang,9,1,1,0,0
2022-05-17,Hue City,Phu Vang,11,4,2,2,0
2022-05-17,Hue City,Phu Vang,12,4,4,0,0
2022-05-17,Hue City,Phu Vang,14,4,3,1,1
2022-05-17,Hue City,Phu Vang,15,4,1,3,3
2022-05-17,Hue City,Phu Vang,17,2,2,0,0
2022-05-17,Hue City,Phu Vang,18,1,0,1,1
2022-05-17,Hue City,Phu Vang,19,1,1,0,0
2022-05-17,Hue City,Phu Vang,20,4,4,0,0
2022-05-17,Hue City,Phu Vang,21,2,0,2,0
2022-05-17,Vung Tau,Ba Ria City,7,2,0,2,2
2022-05-17,Vung Tau,Ba Ria City,8,3,0,3,3
2022-05-17,Vung Tau,Ba Ria City,9,7,0,7,4
2022-05-17,Vung Tau,Ba Ria City,10,4,3,1,1
2022-05-17,Vung Tau,Ba Ria City,11,12,6,6,4
2022-05-17,Vung Tau,Ba Ria City,12,6,4,2,1
2022-05-17,Vung Tau,Ba Ria City,13,7,4,3,3
2022-05-17,Vung Tau,Ba Ria City,14,6,4,2,1
2022-05-17,Vung Tau,Ba Ria City,15,3,0,3,2
2022-05-17,Vung Tau,Ba Ria City,16,6,4,2,2
2022-05-17,Vung Tau,Ba Ria City,17,5,0,5,4
2022-05-17,Vung Tau,Ba Ria City,18,9,5,4,3
2022-05-17,Vung Tau,Ba Ria City,19,5,0,5,5
2022-05-17,Vung Tau,Ba Ria City,20,4,0,4,4
2022-05-17,Vung Tau,Ba Ria City,21,1,0,1,1
2022-05-17,Vung Tau,Vung Tau City,0,1,1,0,0
2022-05-17,Vung Tau,Vung Tau City,1,1,1,0,0
2022-05-17,Vung Tau,Vung Tau City,6,28,23,5,0
2022-05-17,Vung Tau,Vung Tau City,7,90,88,2,0
2022-05-17,Vung Tau,Vung Tau City,8,166,150,16,4
2022-05-17,Vung Tau,Vung Tau City,9,154,144,10,6
2022-05-17,Vung Tau,Vung Tau City,10,177,166,11,0
2022-05-17,Vung Tau,Vung Tau City,11,344,318,26,7
2022-05-17,Vung Tau,Vung Tau City,12,244,237,7,0
2022-05-17,Vung Tau,Vung Tau City,13,204,193,11,0
2022-05-17,Vung Tau,Vung Tau City,14,203,181,22,3
2022-05-17,Vung Tau,Vung Tau City,15,177,161,16,2
2022-05-17,Vung Tau,Vung Tau City,16,233,216,17,4
2022-05-17,Vung Tau,Vung Tau City,17,326,288,38,16
2022-05-17,Vung Tau,Vung Tau City,18,352,306,46,20
2022-05-17,Vung Tau,Vung Tau City,19,325,272,53,25
2022-05-17,Vung Tau,Vung Tau City,20,203,156,47,27
2022-05-17,Vung Tau,Vung Tau City,21,91,65,26,11
2022-05-18,Binh Duong,Ben Cat,9,1,0,1,1
2022-05-18,Binh Duong,Ben Cat,11,1,0,1,1
2022-05-18,Binh Duong,Ben Cat,12,1,1,0,0
2022-05-18,Binh Duong,Ben Cat,14,1,0,1,1
2022-05-18,Binh Duong,Ben Cat,17,1,0,1,1
2022-05-18,Binh Duong,Ben Cat,20,1,0,1,1
2022-05-18,Binh Duong,Di An,6,2,0,2,2
2022-05-18,Binh Duong,Di An,7,2,1,1,1
2022-05-18,Binh Duong,Di An,8,11,4,7,6
2022-05-18,Binh Duong,Di An,9,19,11,8,5
2022-05-18,Binh Duong,Di An,10,29,13,16,16
2022-05-18,Binh Duong,Di An,11,59,6,53,40
2022-05-18,Binh Duong,Di An,12,52,10,42,37
2022-05-18,Binh Duong,Di An,13,53,19,34,29
2022-05-18,Binh Duong,Di An,14,48,21,27,25
2022-05-18,Binh Duong,Di An,15,27,10,17,17
2022-05-18,Binh Duong,Di An,16,31,18,13,11
2022-05-18,Binh Duong,Di An,17,39,19,20,14
2022-05-18,Binh Duong,Di An,18,38,21,17,14
2022-05-18,Binh Duong,Di An,19,28,15,13,8
2022-05-18,Binh Duong,Di An,20,17,11,6,2
2022-05-18,Binh Duong,Di An,21,8,4,4,3
2022-05-18,Binh Duong,Tan Uyen,8,2,0,2,2
2022-05-18,Binh Duong,Tan Uyen,9,1,0,1,1
2022-05-18,Binh Duong,Tan Uyen,10,3,1,2,2
2022-05-18,Binh Duong,Tan Uyen,11,7,0,7,5
2022-05-18,Binh Duong,Tan Uyen,12,3,1,2,1
2022-05-18,Binh Duong,Tan Uyen,13,5,3,2,2
2022-05-18,Binh Duong,Tan Uyen,14,2,2,0,0
2022-05-18,Binh Duong,Tan Uyen,15,4,3,1,1
2022-05-18,Binh Duong,Tan Uyen,16,4,1,3,3
2022-05-18,Binh Duong,Tan Uyen,17,6,4,2,2
2022-05-18,Binh Duong,Tan Uyen,18,2,0,2,1
2022-05-18,Binh Duong,Tan Uyen,19,3,1,2,2
2022-05-18,Binh Duong,Tan Uyen,20,2,1,1,1
2022-05-18,Binh Duong,Tan Uyen,21,1,0,1,1
2022-05-18,Binh Duong,Thu Dau Mot Town,0,1,1,0,0
2022-05-18,Binh Duong,Thu Dau Mot Town,2,1,1,0,0
2022-05-18,Binh Duong,Thu Dau Mot Town,5,1,0,1,1
2022-05-18,Binh Duong,Thu Dau Mot Town,6,28,22,6,5
2022-05-18,Binh Duong,Thu Dau Mot Town,7,119,111,8,1
2022-05-18,Binh Duong,Thu Dau Mot Town,8,221,200,21,1
2022-05-18,Binh Duong,Thu Dau Mot Town,9,229,210,19,1
2022-05-18,Binh Duong,Thu Dau Mot Town,10,404,380,24,2
2022-05-18,Binh Duong,Thu Dau Mot Town,11,605,539,66,25
2022-05-18,Binh Duong,Thu Dau Mot Town,12,420,402,18,7
2022-05-18,Binh Duong,Thu Dau Mot Town,13,404,381,23,3
2022-05-18,Binh Duong,Thu Dau Mot Town,14,309,295,14,3
2022-05-18,Binh Duong,Thu Dau Mot Town,15,285,267,18,1
2022-05-18,Binh Duong,Thu Dau Mot Town,16,306,289,17,1
2022-05-18,Binh Duong,Thu Dau Mot Town,17,423,399,24,5
2022-05-18,Binh Duong,Thu Dau Mot Town,18,375,355,20,1
2022-05-18,Binh Duong,Thu Dau Mot Town,19,357,339,18,3
2022-05-18,Binh Duong,Thu Dau Mot Town,20,240,224,16,1
2022-05-18,Binh Duong,Thu Dau Mot Town,21,107,87,20,2
2022-05-18,Binh Duong,Thuan An,7,8,5,3,3
2022-05-18,Binh Duong,Thuan An,8,24,15,9,6
2022-05-18,Binh Duong,Thuan An,9,35,26,9,4
2022-05-18,Binh Duong,Thuan An,10,57,28,29,25
2022-05-18,Binh Duong,Thuan An,11,79,45,34,27
2022-05-18,Binh Duong,Thuan An,12,66,44,22,18
2022-05-18,Binh Duong,Thuan An,13,71,38,33,27
2022-05-18,Binh Duong,Thuan An,14,61,35,26,17
2022-05-18,Binh Duong,Thuan An,15,45,31,14,14
2022-05-18,Binh Duong,Thuan An,16,39,30,9,6
2022-05-18,Binh Duong,Thuan An,17,51,38,13,5
2022-05-18,Binh Duong,Thuan An,18,56,40,16,9
2022-05-18,Binh Duong,Thuan An,19,43,35,8,4
2022-05-18,Binh Duong,Thuan An,20,37,28,9,5
2022-05-18,Binh Duong,Thuan An,21,23,7,16,11
2022-05-18,Binh Duong,Thuan An,22,1,0,1,0
2022-05-18,Can Tho City,Binh Thuy District,7,3,2,1,1
2022-05-18,Can Tho City,Binh Thuy District,8,1,0,1,0
2022-05-18,Can Tho City,Binh Thuy District,9,7,7,0,0
2022-05-18,Can Tho City,Binh Thuy District,10,7,7,0,0
2022-05-18,Can Tho City,Binh Thuy District,11,9,7,2,0
2022-05-18,Can Tho City,Binh Thuy District,12,12,11,1,0
2022-05-18,Can Tho City,Binh Thuy District,13,9,6,3,1
2022-05-18,Can Tho City,Binh Thuy District,14,15,12,3,0
2022-05-18,Can Tho City,Binh Thuy District,15,5,4,1,1
2022-05-18,Can Tho City,Binh Thuy District,16,12,9,3,1
2022-05-18,Can Tho City,Binh Thuy District,17,9,6,3,1
2022-05-18,Can Tho City,Binh Thuy District,18,11,10,1,0
2022-05-18,Can Tho City,Binh Thuy District,19,17,17,0,0
2022-05-18,Can Tho City,Binh Thuy District,20,5,5,0,0
2022-05-18,Can Tho City,Binh Thuy District,21,1,1,0,0
2022-05-18,Can Tho City,Cai Rang District,6,4,1,3,2
2022-05-18,Can Tho City,Cai Rang District,7,3,2,1,0
2022-05-18,Can Tho City,Cai Rang District,8,8,5,3,1
2022-05-18,Can Tho City,Cai Rang District,9,7,6,1,0
2022-05-18,Can Tho City,Cai Rang District,10,9,9,0,0
2022-05-18,Can Tho City,Cai Rang District,11,13,10,3,0
2022-05-18,Can Tho City,Cai Rang District,12,5,3,2,0
2022-05-18,Can Tho City,Cai Rang District,13,13,11,2,0
2022-05-18,Can Tho City,Cai Rang District,14,9,8,1,0
2022-05-18,Can Tho City,Cai Rang District,15,9,9,0,0
2022-05-18,Can Tho City,Cai Rang District,16,8,8,0,0
2022-05-18,Can Tho City,Cai Rang District,17,7,7,0,0
2022-05-18,Can Tho City,Cai Rang District,18,9,8,1,0
2022-05-18,Can Tho City,Cai Rang District,19,14,14,0,0
2022-05-18,Can Tho City,Cai Rang District,20,8,7,1,0
2022-05-18,Can Tho City,Cai Rang District,21,5,2,3,0
2022-05-18,Can Tho City,Ninh Kieu District,0,5,3,2,0
2022-05-18,Can Tho City,Ninh Kieu District,1,5,2,3,1
2022-05-18,Can Tho City,Ninh Kieu District,2,1,1,0,0
2022-05-18,Can Tho City,Ninh Kieu District,4,1,1,0,0
2022-05-18,Can Tho City,Ninh Kieu District,5,6,4,2,0
2022-05-18,Can Tho City,Ninh Kieu District,6,55,51,4,0
2022-05-18,Can Tho City,Ninh Kieu District,7,129,126,3,0
2022-05-18,Can Tho City,Ninh Kieu District,8,238,225,13,0
2022-05-18,Can Tho City,Ninh Kieu District,9,306,285,21,0
2022-05-18,Can Tho City,Ninh Kieu District,10,582,560,22,0
2022-05-18,Can Tho City,Ninh Kieu District,11,829,792,37,4
2022-05-18,Can Tho City,Ninh Kieu District,12,581,551,30,2
2022-05-18,Can Tho City,Ninh Kieu District,13,541,520,21,0
2022-05-18,Can Tho City,Ninh Kieu District,14,445,427,18,0
2022-05-18,Can Tho City,Ninh Kieu District,15,377,358,19,0
2022-05-18,Can Tho City,Ninh Kieu District,16,460,445,15,0
2022-05-18,Can Tho City,Ninh Kieu District,17,570,546,24,0
2022-05-18,Can Tho City,Ninh Kieu District,18,583,557,26,0
2022-05-18,Can Tho City,Ninh Kieu District,19,501,474,27,0
2022-05-18,Can Tho City,Ninh Kieu District,20,380,363,17,0
2022-05-18,Can Tho City,Ninh Kieu District,21,181,165,16,0
2022-05-18,Can Tho City,O Mon District,17,1,0,1,1
2022-05-18,Dong Nai,Bien Hoa City,0,2,2,0,0
2022-05-18,Dong Nai,Bien Hoa City,2,3,2,1,0
2022-05-18,Dong Nai,Bien Hoa City,4,1,1,0,0
2022-05-18,Dong Nai,Bien Hoa City,5,4,1,3,3
2022-05-18,Dong Nai,Bien Hoa City,6,41,23,18,17
2022-05-18,Dong Nai,Bien Hoa City,7,152,133,19,8
2022-05-18,Dong Nai,Bien Hoa City,8,276,244,32,6
2022-05-18,Dong Nai,Bien Hoa City,9,365,330,35,13
2022-05-18,Dong Nai,Bien Hoa City,10,694,642,52,8
2022-05-18,Dong Nai,Bien Hoa City,11,1025,893,132,48
2022-05-18,Dong Nai,Bien Hoa City,12,767,702,65,21
2022-05-18,Dong Nai,Bien Hoa City,13,738,678,60,16
2022-05-18,Dong Nai,Bien Hoa City,14,630,554,76,21
2022-05-18,Dong Nai,Bien Hoa City,15,498,446,52,17
2022-05-18,Dong Nai,Bien Hoa City,16,526,452,74,24
2022-05-18,Dong Nai,Bien Hoa City,17,649,574,75,30
2022-05-18,Dong Nai,Bien Hoa City,18,615,559,56,15
2022-05-18,Dong Nai,Bien Hoa City,19,587,533,54,12
2022-05-18,Dong Nai,Bien Hoa City,20,450,395,55,7
2022-05-18,Dong Nai,Bien Hoa City,21,185,133,52,19
2022-05-18,Dong Nai,Bien Hoa City,22,1,0,1,0
2022-05-18,Dong Nai,Bien Hoa City,23,1,0,1,0
2022-05-18,Dong Nai,Cam My,14,1,0,1,1
2022-05-18,Dong Nai,Cam My,17,1,0,1,1
2022-05-18,Dong Nai,Long Khanh,14,1,0,1,1
2022-05-18,Dong Nai,Long Thanh,12,1,0,1,1
2022-05-18,Dong Nai,Long Thanh,13,3,0,3,2
2022-05-18,Dong Nai,Long Thanh,18,2,0,2,2
2022-05-18,Dong Nai,Nhon trach,17,2,0,2,2
2022-05-18,Dong Nai,Trang Bom,13,2,0,2,2
2022-05-18,Dong Nai,Trang Bom,14,1,0,1,1
2022-05-18,Dong Nai,Trang Bom,19,2,0,2,2
2022-05-18,Hai Phong City,An Duong,7,3,1,2,2
2022-05-18,Hai Phong City,An Duong,8,4,1,3,2
2022-05-18,Hai Phong City,An Duong,9,5,3,2,1
2022-05-18,Hai Phong City,An Duong,10,5,0,5,5
2022-05-18,Hai Phong City,An Duong,11,1,1,0,0
2022-05-18,Hai Phong City,An Duong,12,5,1,4,2
2022-05-18,Hai Phong City,An Duong,13,6,0,6,3
2022-05-18,Hai Phong City,An Duong,14,3,0,3,1
2022-05-18,Hai Phong City,An Duong,15,9,3,6,4
2022-05-18,Hai Phong City,An Duong,16,3,0,3,3
2022-05-18,Hai Phong City,An Duong,17,3,2,1,0
2022-05-18,Hai Phong City,An Duong,18,1,1,0,0
2022-05-18,Hai Phong City,Do Son District,16,1,0,1,1
2022-05-18,Hai Phong City,Do Son District,17,3,0,3,3
2022-05-18,Hai Phong City,Hai An District,7,5,3,2,2
2022-05-18,Hai Phong City,Hai An District,8,9,7,2,1
2022-05-18,Hai Phong City,Hai An District,9,15,9,6,4
2022-05-18,Hai Phong City,Hai An District,10,26,19,7,1
2022-05-18,Hai Phong City,Hai An District,11,38,31,7,2
2022-05-18,Hai Phong City,Hai An District,12,19,16,3,0
2022-05-18,Hai Phong City,Hai An District,13,15,13,2,1
2022-05-18,Hai Phong City,Hai An District,14,8,7,1,1
2022-05-18,Hai Phong City,Hai An District,15,17,16,1,0
2022-05-18,Hai Phong City,Hai An District,16,17,12,5,2
2022-05-18,Hai Phong City,Hai An District,17,12,10,2,0
2022-05-18,Hai Phong City,Hai An District,18,21,16,5,1
2022-05-18,Hai Phong City,Hai An District,19,30,24,6,4
2022-05-18,Hai Phong City,Hai An District,20,10,7,3,0
2022-05-18,Hai Phong City,Hai An District,21,13,9,4,1
2022-05-18,Hai Phong City,Hong Bang District,7,7,7,0,0
2022-05-18,Hai Phong City,Hong Bang District,8,40,32,8,5
2022-05-18,Hai Phong City,Hong Bang District,9,41,35,6,2
2022-05-18,Hai Phong City,Hong Bang District,10,61,55,6,1
2022-05-18,Hai Phong City,Hong Bang District,11,76,70,6,1
2022-05-18,Hai Phong City,Hong Bang District,12,56,49,7,2
2022-05-18,Hai Phong City,Hong Bang District,13,32,28,4,2
2022-05-18,Hai Phong City,Hong Bang District,14,42,36,6,4
2022-05-18,Hai Phong City,Hong Bang District,15,40,29,11,3
2022-05-18,Hai Phong City,Hong Bang District,16,39,38,1,0
2022-05-18,Hai Phong City,Hong Bang District,17,38,36,2,0
2022-05-18,Hai Phong City,Hong Bang District,18,44,39,5,0
2022-05-18,Hai Phong City,Hong Bang District,19,34,32,2,0
2022-05-18,Hai Phong City,Hong Bang District,20,26,23,3,0
2022-05-18,Hai Phong City,Hong Bang District,21,3,2,1,0
2022-05-18,Hai Phong City,Kien An District,7,2,1,1,1
2022-05-18,Hai Phong City,Kien An District,8,7,5,2,1
2022-05-18,Hai Phong City,Kien An District,9,3,2,1,1
2022-05-18,Hai Phong City,Kien An District,10,6,4,2,2
2022-05-18,Hai Phong City,Kien An District,11,18,7,11,10
2022-05-18,Hai Phong City,Kien An District,12,6,6,0,0
2022-05-18,Hai Phong City,Kien An District,13,3,3,0,0
2022-05-18,Hai Phong City,Kien An District,14,8,3,5,3
2022-05-18,Hai Phong City,Kien An District,15,7,4,3,1
2022-05-18,Hai Phong City,Kien An District,16,4,3,1,1
2022-05-18,Hai Phong City,Kien An District,17,7,4,3,2
2022-05-18,Hai Phong City,Kien An District,18,10,6,4,3
2022-05-18,Hai Phong City,Kien An District,19,8,4,4,3
2022-05-18,Hai Phong City,Kien An District,20,7,7,0,0
2022-05-18,Hai Phong City,Le Chan District,0,2,2,0,0
2022-05-18,Hai Phong City,Le Chan District,2,1,1,0,0
2022-05-18,Hai Phong City,Le Chan District,7,35,31,4,0
2022-05-18,Hai Phong City,Le Chan District,8,64,56,8,3
2022-05-18,Hai Phong City,Le Chan District,9,77,72,5,0
2022-05-18,Hai Phong City,Le Chan District,10,176,157,19,3
2022-05-18,Hai Phong City,Le Chan District,11,327,293,34,8
2022-05-18,Hai Phong City,Le Chan District,12,195,183,12,1
2022-05-18,Hai Phong City,Le Chan District,13,109,102,7,1
2022-05-18,Hai Phong City,Le Chan District,14,128,111,17,4
2022-05-18,Hai Phong City,Le Chan District,15,163,146,17,5
2022-05-18,Hai Phong City,Le Chan District,16,136,121,15,2
2022-05-18,Hai Phong City,Le Chan District,17,157,137,20,2
2022-05-18,Hai Phong City,Le Chan District,18,195,174,21,4
2022-05-18,Hai Phong City,Le Chan District,19,216,196,20,3
2022-05-18,Hai Phong City,Le Chan District,20,129,108,21,1
2022-05-18,Hai Phong City,Le Chan District,21,63,53,10,2
2022-05-18,Hai Phong City,Ngo Quyen District,0,1,1,0,0
2022-05-18,Hai Phong City,Ngo Quyen District,7,25,20,5,3
2022-05-18,Hai Phong City,Ngo Quyen District,8,63,54,9,2
2022-05-18,Hai Phong City,Ngo Quyen District,9,62,57,5,0
2022-05-18,Hai Phong City,Ngo Quyen District,10,116,99,17,1
2022-05-18,Hai Phong City,Ngo Quyen District,11,242,217,25,4
2022-05-18,Hai Phong City,Ngo Quyen District,12,143,131,12,1
2022-05-18,Hai Phong City,Ngo Quyen District,13,87,79,8,1
2022-05-18,Hai Phong City,Ngo Quyen District,14,125,112,13,6
2022-05-18,Hai Phong City,Ngo Quyen District,15,129,104,25,5
2022-05-18,Hai Phong City,Ngo Quyen District,16,79,74,5,1
2022-05-18,Hai Phong City,Ngo Quyen District,17,108,100,8,0
2022-05-18,Hai Phong City,Ngo Quyen District,18,141,125,16,1
2022-05-18,Hai Phong City,Ngo Quyen District,19,125,116,9,1
2022-05-18,Hai Phong City,Ngo Quyen District,20,123,108,15,2
2022-05-18,Hai Phong City,Ngo Quyen District,21,40,37,3,1
2022-05-18,Hai Phong City,Thuy Nguyen,10,1,0,1,1
2022-05-18,Hai Phong City,Thuy Nguyen,11,1,0,1,1
2022-05-18,Hai Phong City,Thuy Nguyen,13,2,0,2,2
2022-05-18,Hai Phong City,Thuy Nguyen,18,1,0,1,1
2022-05-18,Hai Phong City,Thuy Nguyen,20,4,0,4,4
2022-05-18,Hue City,Hue City,0,5,4,1,0
2022-05-18,Hue City,Hue City,2,1,1,0,0
2022-05-18,Hue City,Hue City,3,1,1,0,0
2022-05-18,Hue City,Hue City,5,2,1,1,0
2022-05-18,Hue City,Hue City,6,68,57,11,0
2022-05-18,Hue City,Hue City,7,208,190,18,4
2022-05-18,Hue City,Hue City,8,321,296,25,2
2022-05-18,Hue City,Hue City,9,245,219,26,2
2022-05-18,Hue City,Hue City,10,396,368,28,1
2022-05-18,Hue City,Hue City,11,820,772,48,6
2022-05-18,Hue City,Hue City,12,473,445,28,0
2022-05-18,Hue City,Hue City,13,309,283,26,0
2022-05-18,Hue City,Hue City,14,296,263,33,0
2022-05-18,Hue City,Hue City,15,335,317,18,2
2022-05-18,Hue City,Hue City,16,332,309,23,0
2022-05-18,Hue City,Hue City,17,460,437,23,0
2022-05-18,Hue City,Hue City,18,562,513,49,0
2022-05-18,Hue City,Hue City,19,539,501,38,0
2022-05-18,Hue City,Hue City,20,415,360,55,3
2022-05-18,Hue City,Hue City,21,231,193,38,8
2022-05-18,Hue City,Hue City,22,1,0,1,1
2022-05-18,Hue City,Huong Thuy,7,1,1,0,0
2022-05-18,Hue City,Huong Thuy,8,1,0,1,0
2022-05-18,Hue City,Huong Thuy,10,1,1,0,0
2022-05-18,Hue City,Huong Thuy,12,1,1,0,0
2022-05-18,Hue City,Huong Thuy,13,1,0,1,1
2022-05-18,Hue City,Huong Thuy,14,3,0,3,0
2022-05-18,Hue City,Huong Thuy,15,2,1,1,0
2022-05-18,Hue City,Huong Thuy,16,2,1,1,0
2022-05-18,Hue City,Huong Thuy,18,2,1,1,0
2022-05-18,Hue City,Huong Thuy,21,2,0,2,2
2022-05-18,Hue City,Huong Tra,16,1,1,0,0
2022-05-18,Hue City,Huong Tra,20,1,1,0,0
2022-05-18,Hue City,Phu Vang,8,2,2,0,0
2022-05-18,Hue City,Phu Vang,9,1,1,0,0
2022-05-18,Hue City,Phu Vang,11,6,4,2,1
2022-05-18,Hue City,Phu Vang,12,2,2,0,0
2022-05-18,Hue City,Phu Vang,13,3,0,3,2
2022-05-18,Hue City,Phu Vang,14,4,2,2,1
2022-05-18,Hue City,Phu Vang,15,2,2,0,0
2022-05-18,Hue City,Phu Vang,16,2,1,1,1
2022-05-18,Hue City,Phu Vang,18,3,3,0,0
2022-05-18,Hue City,Phu Vang,20,2,2,0,0
2022-05-18,Vung Tau,Ba Ria City,7,2,0,2,2
2022-05-18,Vung Tau,Ba Ria City,8,5,2,3,3
2022-05-18,Vung Tau,Ba Ria City,9,3,2,1,1
2022-05-18,Vung Tau,Ba Ria City,10,4,3,1,1
2022-05-18,Vung Tau,Ba Ria City,11,8,1,7,4
2022-05-18,Vung Tau,Ba Ria City,12,11,3,8,6
2022-05-18,Vung Tau,Ba Ria City,13,3,2,1,1
2022-05-18,Vung Tau,Ba Ria City,14,2,2,0,0
2022-05-18,Vung Tau,Ba Ria City,15,3,1,2,2
2022-05-18,Vung Tau,Ba Ria City,16,8,4,4,3
2022-05-18,Vung Tau,Ba Ria City,17,6,3,3,3
2022-05-18,Vung Tau,Ba Ria City,18,9,2,7,7
2022-05-18,Vung Tau,Ba Ria City,19,8,2,6,6
2022-05-18,Vung Tau,Ba Ria City,20,2,0,2,2
2022-05-18,Vung Tau,Ba Ria City,21,2,0,2,2
2022-05-18,Vung Tau,Vung Tau City,2,1,1,0,0
2022-05-18,Vung Tau,Vung Tau City,5,1,1,0,0
2022-05-18,Vung Tau,Vung Tau City,6,27,21,6,3
2022-05-18,Vung Tau,Vung Tau City,7,127,116,11,4
2022-05-18,Vung Tau,Vung Tau City,8,190,167,23,7
2022-05-18,Vung Tau,Vung Tau City,9,173,155,18,3
2022-05-18,Vung Tau,Vung Tau City,10,185,174,11,0
2022-05-18,Vung Tau,Vung Tau City,11,348,333,15,1
2022-05-18,Vung Tau,Vung Tau City,12,224,212,12,2
2022-05-18,Vung Tau,Vung Tau City,13,195,180,15,5
2022-05-18,Vung Tau,Vung Tau City,14,197,183,14,2
2022-05-18,Vung Tau,Vung Tau City,15,207,187,20,6
2022-05-18,Vung Tau,Vung Tau City,16,187,168,19,3
2022-05-18,Vung Tau,Vung Tau City,17,265,245,20,0
2022-05-18,Vung Tau,Vung Tau City,18,302,289,13,2
2022-05-18,Vung Tau,Vung Tau City,19,253,229,24,7
2022-05-18,Vung Tau,Vung Tau City,20,156,141,15,3
2022-05-18,Vung Tau,Vung Tau City,21,95,78,17,9
2022-05-18,Vung Tau,Vung Tau City,22,1,0,1,0
2022-05-19,Binh Duong,Ben Cat,9,2,0,2,2
2022-05-19,Binh Duong,Ben Cat,10,1,1,0,0
2022-05-19,Binh Duong,Ben Cat,11,2,0,2,2
2022-05-19,Binh Duong,Ben Cat,12,2,0,2,2
2022-05-19,Binh Duong,Ben Cat,13,2,0,2,2
2022-05-19,Binh Duong,Ben Cat,14,2,0,2,2
2022-05-19,Binh Duong,Ben Cat,19,1,0,1,1
2022-05-19,Binh Duong,Ben Cat,20,1,0,1,1
2022-05-19,Binh Duong,Di An,0,1,0,1,1
2022-05-19,Binh Duong,Di An,7,7,0,7,7
2022-05-19,Binh Duong,Di An,8,20,6,14,11
2022-05-19,Binh Duong,Di An,9,36,14,22,18
2022-05-19,Binh Duong,Di An,10,45,26,19,17
2022-05-19,Binh Duong,Di An,11,55,27,28,18
2022-05-19,Binh Duong,Di An,12,39,17,22,19
2022-05-19,Binh Duong,Di An,13,49,20,29,24
2022-05-19,Binh Duong,Di An,14,30,22,8,6
2022-05-19,Binh Duong,Di An,15,24,18,6,6
2022-05-19,Binh Duong,Di An,16,14,5,9,6
2022-05-19,Binh Duong,Di An,17,18,12,6,5
2022-05-19,Binh Duong,Di An,18,30,15,15,15
2022-05-19,Binh Duong,Di An,19,30,16,14,13
2022-05-19,Binh Duong,Di An,20,25,10,15,11
2022-05-19,Binh Duong,Di An,21,9,4,5,4
2022-05-19,Binh Duong,Tan Uyen,7,2,1,1,1
2022-05-19,Binh Duong,Tan Uyen,8,1,1,0,0
2022-05-19,Binh Duong,Tan Uyen,9,3,0,3,2
2022-05-19,Binh Duong,Tan Uyen,10,4,0,4,2
2022-05-19,Binh Duong,Tan Uyen,11,2,1,1,1
2022-05-19,Binh Duong,Tan Uyen,12,4,2,2,0
2022-05-19,Binh Duong,Tan Uyen,13,7,3,4,4
2022-05-19,Binh Duong,Tan Uyen,14,1,1,0,0
2022-05-19,Binh Duong,Tan Uyen,16,1,1,0,0
2022-05-19,Binh Duong,Tan Uyen,17,1,1,0,0
2022-05-19,Binh Duong,Tan Uyen,18,5,4,1,1
2022-05-19,Binh Duong,Tan Uyen,19,2,2,0,0
2022-05-19,Binh Duong,Tan Uyen,20,1,0,1,1
2022-05-19,Binh Duong,Tan Uyen,21,2,2,0,0
2022-05-19,Binh Duong,Thu Dau Mot Town,5,1,1,0,0
2022-05-19,Binh Duong,Thu Dau Mot Town,6,42,34,8,3
2022-05-19,Binh Duong,Thu Dau Mot Town,7,139,129,10,0
2022-05-19,Binh Duong,Thu Dau Mot Town,8,231,215,16,0
2022-05-19,Binh Duong,Thu Dau Mot Town,9,256,234,22,4
2022-05-19,Binh Duong,Thu Dau Mot Town,10,394,369,25,3
2022-05-19,Binh Duong,Thu Dau Mot Town,11,565,525,40,5
2022-05-19,Binh Duong,Thu Dau Mot Town,12,386,369,17,2
2022-05-19,Binh Duong,Thu Dau Mot Town,13,407,387,20,2
2022-05-19,Binh Duong,Thu Dau Mot Town,14,315,305,10,2
2022-05-19,Binh Duong,Thu Dau Mot Town,15,258,240,18,0
2022-05-19,Binh Duong,Thu Dau Mot Town,16,319,298,21,2
2022-05-19,Binh Duong,Thu Dau Mot Town,17,403,377,26,3
2022-05-19,Binh Duong,Thu Dau Mot Town,18,409,392,17,3
2022-05-19,Binh Duong,Thu Dau Mot Town,19,374,346,28,4
2022-05-19,Binh Duong,Thu Dau Mot Town,20,249,225,24,3
2022-05-19,Binh Duong,Thu Dau Mot Town,21,104,92,12,4
2022-05-19,Binh Duong,Thu Dau Mot Town,22,1,0,1,0
2022-05-19,Binh Duong,Thuan An,2,1,0,1,1
2022-05-19,Binh Duong,Thuan An,5,1,0,1,1
2022-05-19,Binh Duong,Thuan An,6,1,0,1,1
2022-05-19,Binh Duong,Thuan An,7,10,5,5,5
2022-05-19,Binh Duong,Thuan An,8,25,15,10,6
2022-05-19,Binh Duong,Thuan An,9,36,24,12,5
2022-05-19,Binh Duong,Thuan An,10,71,54,17,6
2022-05-19,Binh Duong,Thuan An,11,80,59,21,12
2022-05-19,Binh Duong,Thuan An,12,74,48,26,13
2022-05-19,Binh Duong,Thuan An,13,80,59,21,13
2022-05-19,Binh Duong,Thuan An,14,28,28,0,0
2022-05-19,Binh Duong,Thuan An,15,25,22,3,1
2022-05-19,Binh Duong,Thuan An,16,35,31,4,0
2022-05-19,Binh Duong,Thuan An,17,43,41,2,1
2022-05-19,Binh Duong,Thuan An,18,32,27,5,3
2022-05-19,Binh Duong,Thuan An,19,33,20,13,9
2022-05-19,Binh Duong,Thuan An,20,38,20,18,13
2022-05-19,Binh Duong,Thuan An,21,21,12,9,6
2022-05-19,Can Tho City,Binh Thuy District,6,2,1,1,0
2022-05-19,Can Tho City,Binh Thuy District,7,2,2,0,0
2022-05-19,Can Tho City,Binh Thuy District,9,9,9,0,0
2022-05-19,Can Tho City,Binh Thuy District,10,6,4,2,0
2022-05-19,Can Tho City,Binh Thuy District,11,9,9,0,0
2022-05-19,Can Tho City,Binh Thuy District,12,7,7,0,0
2022-05-19,Can Tho City,Binh Thuy District,13,12,10,2,0
2022-05-19,Can Tho City,Binh Thuy District,14,10,10,0,0
2022-05-19,Can Tho City,Binh Thuy District,15,11,11,0,0
2022-05-19,Can Tho City,Binh Thuy District,16,8,8,0,0
2022-05-19,Can Tho City,Binh Thuy District,17,12,11,1,0
2022-05-19,Can Tho City,Binh Thuy District,18,21,21,0,0
2022-05-19,Can Tho City,Binh Thuy District,19,21,18,3,0
2022-05-19,Can Tho City,Binh Thuy District,20,10,9,1,0
2022-05-19,Can Tho City,Binh Thuy District,21,2,1,1,0
2022-05-19,Can Tho City,Cai Rang District,7,3,3,0,0
2022-05-19,Can Tho City,Cai Rang District,8,6,6,0,0
2022-05-19,Can Tho City,Cai Rang District,9,7,6,1,0
2022-05-19,Can Tho City,Cai Rang District,10,13,10,3,3
2022-05-19,Can Tho City,Cai Rang District,11,10,10,0,0
2022-05-19,Can Tho City,Cai Rang District,12,9,6,3,0
2022-05-19,Can Tho City,Cai Rang District,13,10,8,2,1
2022-05-19,Can Tho City,Cai Rang District,14,7,7,0,0
2022-05-19,Can Tho City,Cai Rang District,15,8,8,0,0
2022-05-19,Can Tho City,Cai Rang District,16,8,8,0,0
2022-05-19,Can Tho City,Cai Rang District,17,11,11,0,0
2022-05-19,Can Tho City,Cai Rang District,18,11,11,0,0
2022-05-19,Can Tho City,Cai Rang District,19,19,17,2,0
2022-05-19,Can Tho City,Cai Rang District,20,13,12,1,0
2022-05-19,Can Tho City,Cai Rang District,21,2,1,1,1
2022-05-19,Can Tho City,Ninh Kieu District,0,1,1,0,0
2022-05-19,Can Tho City,Ninh Kieu District,2,1,1,0,0
2022-05-19,Can Tho City,Ninh Kieu District,3,1,1,0,0
2022-05-19,Can Tho City,Ninh Kieu District,4,1,1,0,0
2022-05-19,Can Tho City,Ninh Kieu District,5,4,2,2,0
2022-05-19,Can Tho City,Ninh Kieu District,6,68,58,10,1
2022-05-19,Can Tho City,Ninh Kieu District,7,156,151,5,0
2022-05-19,Can Tho City,Ninh Kieu District,8,239,220,19,0
2022-05-19,Can Tho City,Ninh Kieu District,9,320,300,20,0
2022-05-19,Can Tho City,Ninh Kieu District,10,587,565,22,0
2022-05-19,Can Tho City,Ninh Kieu District,11,812,758,54,8
2022-05-19,Can Tho City,Ninh Kieu District,12,558,536,22,0
2022-05-19,Can Tho City,Ninh Kieu District,13,525,513,12,0
2022-05-19,Can Tho City,Ninh Kieu District,14,454,437,17,0
2022-05-19,Can Tho City,Ninh Kieu District,15,382,361,21,0
2022-05-19,Can Tho City,Ninh Kieu District,16,439,418,21,0
2022-05-19,Can Tho City,Ninh Kieu District,17,567,545,22,0
2022-05-19,Can Tho City,Ninh Kieu District,18,613,574,39,0
2022-05-19,Can Tho City,Ninh Kieu District,19,560,531,29,1
2022-05-19,Can Tho City,Ninh Kieu District,20,386,349,37,0
2022-05-19,Can Tho City,Ninh Kieu District,21,188,176,12,0
2022-05-19,Can Tho City,Ninh Kieu District,22,1,0,1,0
2022-05-19,Can Tho City,O Mon District,18,1,0,1,1
2022-05-19,Dong Nai,Bien Hoa City,0,3,2,1,0
2022-05-19,Dong Nai,Bien Hoa City,1,2,1,1,0
2022-05-19,Dong Nai,Bien Hoa City,4,2,2,0,0
2022-05-19,Dong Nai,Bien Hoa City,5,1,1,0,0
2022-05-19,Dong Nai,Bien Hoa City,6,65,33,32,22
2022-05-19,Dong Nai,Bien Hoa City,7,146,124,22,12
2022-05-19,Dong Nai,Bien Hoa City,8,325,285,40,9
2022-05-19,Dong Nai,Bien Hoa City,9,417,373,44,5
2022-05-19,Dong Nai,Bien Hoa City,10,766,702,64,9
2022-05-19,Dong Nai,Bien Hoa City,11,1093,990,103,14
2022-05-19,Dong Nai,Bien Hoa City,12,781,738,43,8
2022-05-19,Dong Nai,Bien Hoa City,13,672,632,40,5
2022-05-19,Dong Nai,Bien Hoa City,14,560,516,44,5
2022-05-19,Dong Nai,Bien Hoa City,15,503,469,34,5
2022-05-19,Dong Nai,Bien Hoa City,16,500,460,40,8
2022-05-19,Dong Nai,Bien Hoa City,17,674,599,75,21
2022-05-19,Dong Nai,Bien Hoa City,18,764,692,72,9
2022-05-19,Dong Nai,Bien Hoa City,19,667,590,77,23
2022-05-19,Dong Nai,Bien Hoa City,20,469,405,64,20
2022-05-19,Dong Nai,Bien Hoa City,21,233,162,71,20
2022-05-19,Dong Nai,Bien Hoa City,22,4,0,4,0
2022-05-19,Dong Nai,Long Khanh,10,1,0,1,1
2022-05-19,Dong Nai,Long Khanh,11,1,0,1,1
2022-05-19,Dong Nai,Long Khanh,12,1,0,1,1
2022-05-19,Dong Nai,Long Thanh,10,1,0,1,1
2022-05-19,Dong Nai,Long Thanh,11,1,0,1,1
2022-05-19,Dong Nai,Long Thanh,13,1,0,1,1
2022-05-19,Dong Nai,Long Thanh,14,2,0,2,2
2022-05-19,Dong Nai,Long Thanh,15,3,0,3,3
2022-05-19,Dong Nai,Long Thanh,16,1,0,1,1
2022-05-19,Dong Nai,Long Thanh,17,1,0,1,1
2022-05-19,Dong Nai,Long Thanh,18,1,0,1,1
2022-05-19,Dong Nai,Long Thanh,19,3,0,3,3
2022-05-19,Dong Nai,Long Thanh,20,1,0,1,0
2022-05-19,Dong Nai,Nhon trach,15,1,0,1,1
2022-05-19,Dong Nai,Nhon trach,16,1,0,1,1
2022-05-19,Dong Nai,Nhon trach,20,1,0,1,1
2022-05-19,Dong Nai,Trang Bom,11,1,0,1,1
2022-05-19,Dong Nai,Trang Bom,13,2,0,2,2
2022-05-19,Dong Nai,Trang Bom,18,1,0,1,0
2022-05-19,Dong Nai,Trang Bom,19,3,0,3,2
2022-05-19,Dong Nai,Trang Bom,20,1,0,1,1
2022-05-19,Hai Phong City,An Duong,8,3,1,2,1
2022-05-19,Hai Phong City,An Duong,9,6,1,5,5
2022-05-19,Hai Phong City,An Duong,10,3,2,1,1
2022-05-19,Hai Phong City,An Duong,11,9,0,9,8
2022-05-19,Hai Phong City,An Duong,12,5,0,5,5
2022-05-19,Hai Phong City,An Duong,13,7,3,4,4
2022-05-19,Hai Phong City,An Duong,14,5,1,4,3
2022-05-19,Hai Phong City,An Duong,15,2,2,0,0
2022-05-19,Hai Phong City,An Duong,16,5,1,4,4
2022-05-19,Hai Phong City,An Duong,17,4,1,3,3
2022-05-19,Hai Phong City,An Duong,18,5,0,5,5
2022-05-19,Hai Phong City,An Duong,19,6,2,4,3
2022-05-19,Hai Phong City,An Duong,20,1,0,1,0
2022-05-19,Hai Phong City,An Duong,21,1,1,0,0
2022-05-19,Hai Phong City,Hai An District,7,5,4,1,1
2022-05-19,Hai Phong City,Hai An District,8,17,13,4,1
2022-05-19,Hai Phong City,Hai An District,9,11,8,3,0
2022-05-19,Hai Phong City,Hai An District,10,20,17,3,1
2022-05-19,Hai Phong City,Hai An District,11,36,24,12,5
2022-05-19,Hai Phong City,Hai An District,12,22,18,4,0
2022-05-19,Hai Phong City,Hai An District,13,6,5,1,0
2022-05-19,Hai Phong City,Hai An District,14,17,16,1,0
2022-05-19,Hai Phong City,Hai An District,15,24,19,5,1
2022-05-19,Hai Phong City,Hai An District,16,20,17,3,2
2022-05-19,Hai Phong City,Hai An District,17,14,13,1,1
2022-05-19,Hai Phong City,Hai An District,18,27,21,6,2
2022-05-19,Hai Phong City,Hai An District,19,16,12,4,2
2022-05-19,Hai Phong City,Hai An District,20,13,13,0,0
2022-05-19,Hai Phong City,Hai An District,21,14,6,8,3
2022-05-19,Hai Phong City,Hong Bang District,3,2,1,1,0
2022-05-19,Hai Phong City,Hong Bang District,7,14,9,5,4
2022-05-19,Hai Phong City,Hong Bang District,8,35,29,6,6
2022-05-19,Hai Phong City,Hong Bang District,9,35,29,6,0
2022-05-19,Hai Phong City,Hong Bang District,10,57,47,10,3
2022-05-19,Hai Phong City,Hong Bang District,11,88,80,8,1
2022-05-19,Hai Phong City,Hong Bang District,12,45,40,5,1
2022-05-19,Hai Phong City,Hong Bang District,13,37,30,7,0
2022-05-19,Hai Phong City,Hong Bang District,14,35,31,4,1
2022-05-19,Hai Phong City,Hong Bang District,15,33,32,1,0
2022-05-19,Hai Phong City,Hong Bang District,16,32,28,4,0
2022-05-19,Hai Phong City,Hong Bang District,17,29,23,6,1
2022-05-19,Hai Phong City,Hong Bang District,18,52,47,5,1
2022-05-19,Hai Phong City,Hong Bang District,19,71,54,17,13
2022-05-19,Hai Phong City,Hong Bang District,20,38,32,6,1
2022-05-19,Hai Phong City,Hong Bang District,21,10,6,4,2
2022-05-19,Hai Phong City,Kien An District,7,1,0,1,1
2022-05-19,Hai Phong City,Kien An District,8,1,1,0,0
2022-05-19,Hai Phong City,Kien An District,9,4,3,1,1
2022-05-19,Hai Phong City,Kien An District,10,9,5,4,1
2022-05-19,Hai Phong City,Kien An District,11,13,12,1,1
2022-05-19,Hai Phong City,Kien An District,12,4,4,0,0
2022-05-19,Hai Phong City,Kien An District,13,8,4,4,3
2022-05-19,Hai Phong City,Kien An District,14,7,4,3,1
2022-05-19,Hai Phong City,Kien An District,15,6,5,1,1
2022-05-19,Hai Phong City,Kien An District,16,6,5,1,1
2022-05-19,Hai Phong City,Kien An District,17,8,7,1,1
2022-05-19,Hai Phong City,Kien An District,18,9,9,0,0
2022-05-19,Hai Phong City,Kien An District,19,11,7,4,3
2022-05-19,Hai Phong City,Kien An District,20,6,6,0,0
2022-05-19,Hai Phong City,Le Chan District,6,1,0,1,1
2022-05-19,Hai Phong City,Le Chan District,7,37,32,5,2
2022-05-19,Hai Phong City,Le Chan District,8,70,63,7,3
2022-05-19,Hai Phong City,Le Chan District,9,64,58,6,0
2022-05-19,Hai Phong City,Le Chan District,10,205,165,40,10
2022-05-19,Hai Phong City,Le Chan District,11,316,287,29,7
2022-05-19,Hai Phong City,Le Chan District,12,208,183,25,3
2022-05-19,Hai Phong City,Le Chan District,13,122,108,14,0
2022-05-19,Hai Phong City,Le Chan District,14,132,118,14,2
2022-05-19,Hai Phong City,Le Chan District,15,153,131,22,0
2022-05-19,Hai Phong City,Le Chan District,16,127,114,13,1
2022-05-19,Hai Phong City,Le Chan District,17,171,152,19,2
2022-05-19,Hai Phong City,Le Chan District,18,212,193,19,5
2022-05-19,Hai Phong City,Le Chan District,19,195,147,48,21
2022-05-19,Hai Phong City,Le Chan District,20,138,117,21,5
2022-05-19,Hai Phong City,Le Chan District,21,79,62,17,4
2022-05-19,Hai Phong City,Ngo Quyen District,1,1,0,1,0
2022-05-19,Hai Phong City,Ngo Quyen District,3,1,0,1,0
2022-05-19,Hai Phong City,Ngo Quyen District,7,27,25,2,0
2022-05-19,Hai Phong City,Ngo Quyen District,8,85,74,11,0
2022-05-19,Hai Phong City,Ngo Quyen District,9,78,71,7,0
2022-05-19,Hai Phong City,Ngo Quyen District,10,124,112,12,3
2022-05-19,Hai Phong City,Ngo Quyen District,11,220,199,21,2
2022-05-19,Hai Phong City,Ngo Quyen District,12,142,128,14,1
2022-05-19,Hai Phong City,Ngo Quyen District,13,94,88,6,0
2022-05-19,Hai Phong City,Ngo Quyen District,14,121,105,16,4
2022-05-19,Hai Phong City,Ngo Quyen District,15,119,112,7,0
2022-05-19,Hai Phong City,Ngo Quyen District,16,121,116,5,2
2022-05-19,Hai Phong City,Ngo Quyen District,17,125,116,9,3
2022-05-19,Hai Phong City,Ngo Quyen District,18,151,134,17,5
2022-05-19,Hai Phong City,Ngo Quyen District,19,157,126,31,6
2022-05-19,Hai Phong City,Ngo Quyen District,20,120,106,14,2
2022-05-19,Hai Phong City,Ngo Quyen District,21,53,40,13,3
2022-05-19,Hai Phong City,Thuy Nguyen,9,1,0,1,1
2022-05-19,Hai Phong City,Thuy Nguyen,10,2,0,2,2
2022-05-19,Hai Phong City,Thuy Nguyen,12,2,0,2,2
2022-05-19,Hai Phong City,Thuy Nguyen,13,1,0,1,1
2022-05-19,Hai Phong City,Thuy Nguyen,20,1,0,1,1
2022-05-19,Hue City,Hue City,3,1,1,0,0
2022-05-19,Hue City,Hue City,4,2,1,1,0
2022-05-19,Hue City,Hue City,5,3,0,3,0
2022-05-19,Hue City,Hue City,6,65,50,15,0
2022-05-19,Hue City,Hue City,7,184,173,11,1
2022-05-19,Hue City,Hue City,8,291,275,16,0
2022-05-19,Hue City,Hue City,9,272,243,29,1
2022-05-19,Hue City,Hue City,10,365,337,28,0
2022-05-19,Hue City,Hue City,11,805,749,56,4
2022-05-19,Hue City,Hue City,12,460,427,33,1
2022-05-19,Hue City,Hue City,13,293,271,22,0
2022-05-19,Hue City,Hue City,14,304,291,13,2
2022-05-19,Hue City,Hue City,15,360,338,22,2
2022-05-19,Hue City,Hue City,16,297,282,15,2
2022-05-19,Hue City,Hue City,17,421,380,41,0
2022-05-19,Hue City,Hue City,18,583,541,42,4
2022-05-19,Hue City,Hue City,19,658,585,73,22
2022-05-19,Hue City,Hue City,20,408,352,56,7
2022-05-19,Hue City,Hue City,21,232,185,47,12
2022-05-19,Hue City,Hue City,22,1,0,1,0
2022-05-19,Hue City,Huong Thuy,7,2,1,1,0
2022-05-19,Hue City,Huong Thuy,10,1,0,1,1
2022-05-19,Hue City,Huong Thuy,14,1,1,0,0
2022-05-19,Hue City,Huong Thuy,18,1,1,0,0
2022-05-19,Hue City,Huong Thuy,20,1,1,0,0
2022-05-19,Hue City,Huong Thuy,21,1,0,1,1
2022-05-19,Hue City,Huong Tra,13,1,1,0,0
2022-05-19,Hue City,Phu Vang,7,1,1,0,0
2022-05-19,Hue City,Phu Vang,8,2,2,0,0
2022-05-19,Hue City,Phu Vang,11,3,3,0,0
2022-05-19,Hue City,Phu Vang,13,2,2,0,0
2022-05-19,Hue City,Phu Vang,14,1,1,0,0
2022-05-19,Hue City,Phu Vang,15,2,2,0,0
2022-05-19,Hue City,Phu Vang,16,3,1,2,2
2022-05-19,Hue City,Phu Vang,20,4,3,1,1
2022-05-19,Vung Tau,Ba Ria City,7,2,0,2,2
2022-05-19,Vung Tau,Ba Ria City,8,3,0,3,3
2022-05-19,Vung Tau,Ba Ria City,9,8,1,7,4
2022-05-19,Vung Tau,Ba Ria City,10,9,6,3,2
2022-05-19,Vung Tau,Ba Ria City,11,9,3,6,6
2022-05-19,Vung Tau,Ba Ria City,12,5,3,2,2
2022-05-19,Vung Tau,Ba Ria City,13,7,4,3,3
2022-05-19,Vung Tau,Ba Ria City,14,7,4,3,3
2022-05-19,Vung Tau,Ba Ria City,15,5,1,4,4
2022-05-19,Vung Tau,Ba Ria City,16,10,6,4,3
2022-05-19,Vung Tau,Ba Ria City,17,9,3,6,6
2022-05-19,Vung Tau,Ba Ria City,18,5,1,4,3
2022-05-19,Vung Tau,Ba Ria City,19,3,0,3,3
2022-05-19,Vung Tau,Ba Ria City,20,2,0,2,2
2022-05-19,Vung Tau,Ba Ria City,21,1,0,1,1
2022-05-19,Vung Tau,Vung Tau City,4,1,0,1,0
2022-05-19,Vung Tau,Vung Tau City,5,1,1,0,0
2022-05-19,Vung Tau,Vung Tau City,6,26,19,7,1
2022-05-19,Vung Tau,Vung Tau City,7,97,93,4,1
2022-05-19,Vung Tau,Vung Tau City,8,169,155,14,6
2022-05-19,Vung Tau,Vung Tau City,9,142,136,6,0
2022-05-19,Vung Tau,Vung Tau City,10,185,168,17,5
2022-05-19,Vung Tau,Vung Tau City,11,325,306,19,3
2022-05-19,Vung Tau,Vung Tau City,12,262,241,21,3
2022-05-19,Vung Tau,Vung Tau City,13,217,204,13,0
2022-05-19,Vung Tau,Vung Tau City,14,232,211,21,2
2022-05-19,Vung Tau,Vung Tau City,15,214,196,18,2
2022-05-19,Vung Tau,Vung Tau City,16,166,161,5,0
2022-05-19,Vung Tau,Vung Tau City,17,253,233,20,5
2022-05-19,Vung Tau,Vung Tau City,18,291,241,50,17
2022-05-19,Vung Tau,Vung Tau City,19,288,225,63,36
2022-05-19,Vung Tau,Vung Tau City,20,175,143,32,11
2022-05-19,Vung Tau,Vung Tau City,21,95,58,37,25
2022-05-19,Vung Tau,Vung Tau City,22,1,0,1,0
2022-05-20,Binh Duong,Ben Cat,8,1,0,1,1
2022-05-20,Binh Duong,Ben Cat,9,1,0,1,1
2022-05-20,Binh Duong,Ben Cat,10,1,0,1,1
2022-05-20,Binh Duong,Ben Cat,11,1,0,1,1
2022-05-20,Binh Duong,Ben Cat,12,1,0,1,1
2022-05-20,Binh Duong,Ben Cat,17,1,1,0,0
2022-05-20,Binh Duong,Ben Cat,21,1,0,1,0
2022-05-20,Binh Duong,Di An,6,3,0,3,3
2022-05-20,Binh Duong,Di An,7,8,1,7,6
2022-05-20,Binh Duong,Di An,8,15,3,12,9
2022-05-20,Binh Duong,Di An,9,24,9,15,11
2022-05-20,Binh Duong,Di An,10,35,20,15,12
2022-05-20,Binh Duong,Di An,11,44,25,19,15
2022-05-20,Binh Duong,Di An,12,38,20,18,10
2022-05-20,Binh Duong,Di An,13,40,21,19,14
2022-05-20,Binh Duong,Di An,14,30,19,11,7
2022-05-20,Binh Duong,Di An,15,22,12,10,8
2022-05-20,Binh Duong,Di An,16,23,12,11,9
2022-05-20,Binh Duong,Di An,17,22,14,8,7
2022-05-20,Binh Duong,Di An,18,15,12,3,2
2022-05-20,Binh Duong,Di An,19,19,10,9,6
2022-05-20,Binh Duong,Di An,20,18,7,11,9
2022-05-20,Binh Duong,Di An,21,9,3,6,4
2022-05-20,Binh Duong,Tan Uyen,9,1,0,1,1
2022-05-20,Binh Duong,Tan Uyen,10,2,0,2,2
2022-05-20,Binh Duong,Tan Uyen,12,3,3,0,0
2022-05-20,Binh Duong,Tan Uyen,13,1,1,0,0
2022-05-20,Binh Duong,Tan Uyen,14,2,2,0,0
2022-05-20,Binh Duong,Tan Uyen,15,2,1,1,1
2022-05-20,Binh Duong,Tan Uyen,16,2,0,2,2
2022-05-20,Binh Duong,Tan Uyen,17,2,1,1,0
2022-05-20,Binh Duong,Tan Uyen,18,3,2,1,1
2022-05-20,Binh Duong,Tan Uyen,19,1,0,1,1
2022-05-20,Binh Duong,Tan Uyen,20,3,1,2,2
2022-05-20,Binh Duong,Tan Uyen,21,2,1,1,1
2022-05-20,Binh Duong,Thu Dau Mot Town,0,1,0,1,0
2022-05-20,Binh Duong,Thu Dau Mot Town,1,1,0,1,1
2022-05-20,Binh Duong,Thu Dau Mot Town,6,38,32,6,1
2022-05-20,Binh Duong,Thu Dau Mot Town,7,124,114,10,1
2022-05-20,Binh Duong,Thu Dau Mot Town,8,210,201,9,1
2022-05-20,Binh Duong,Thu Dau Mot Town,9,251,237,14,0
2022-05-20,Binh Duong,Thu Dau Mot Town,10,392,362,30,5
2022-05-20,Binh Duong,Thu Dau Mot Town,11,617,584,33,4
2022-05-20,Binh Duong,Thu Dau Mot Town,12,421,403,18,1
2022-05-20,Binh Duong,Thu Dau Mot Town,13,386,365,21,2
2022-05-20,Binh Duong,Thu Dau Mot Town,14,385,378,7,1
2022-05-20,Binh Duong,Thu Dau Mot Town,15,271,252,19,1
2022-05-20,Binh Duong,Thu Dau Mot Town,16,292,279,13,2
2022-05-20,Binh Duong,Thu Dau Mot Town,17,376,349,27,11
2022-05-20,Binh Duong,Thu Dau Mot Town,18,375,357,18,2
2022-05-20,Binh Duong,Thu Dau Mot Town,19,314,296,18,4
2022-05-20,Binh Duong,Thu Dau Mot Town,20,294,264,30,2
2022-05-20,Binh Duong,Thu Dau Mot Town,21,133,118,15,6
2022-05-20,Binh Duong,Thu Dau Mot Town,22,4,0,4,0
2022-05-20,Binh Duong,Thu Dau Mot Town,23,3,1,2,2
2022-05-20,Binh Duong,Thuan An,6,1,0,1,1
2022-05-20,Binh Duong,Thuan An,7,9,5,4,3
2022-05-20,Binh Duong,Thuan An,8,12,9,3,2
2022-05-20,Binh Duong,Thuan An,9,39,29,10,8
2022-05-20,Binh Duong,Thuan An,10,50,36,14,10
2022-05-20,Binh Duong,Thuan An,11,71,56,15,8
2022-05-20,Binh Duong,Thuan An,12,72,50,22,15
2022-05-20,Binh Duong,Thuan An,13,80,51,29,17
2022-05-20,Binh Duong,Thuan An,14,51,27,24,16
2022-05-20,Binh Duong,Thuan An,15,40,31,9,6
2022-05-20,Binh Duong,Thuan An,16,45,32,13,6
2022-05-20,Binh Duong,Thuan An,17,31,27,4,4
2022-05-20,Binh Duong,Thuan An,18,45,33,12,6
2022-05-20,Binh Duong,Thuan An,19,42,38,4,2
2022-05-20,Binh Duong,Thuan An,20,44,31,13,7
2022-05-20,Binh Duong,Thuan An,21,12,6,6,2
2022-05-20,Binh Duong,Thuan An,23,1,0,1,1
2022-05-20,Can Tho City,Binh Thuy District,7,4,3,1,0
2022-05-20,Can Tho City,Binh Thuy District,8,1,0,1,0
2022-05-20,Can Tho City,Binh Thuy District,9,7,6,1,0
2022-05-20,Can Tho City,Binh Thuy District,10,15,13,2,0
2022-05-20,Can Tho City,Binh Thuy District,11,12,10,2,1
2022-05-20,Can Tho City,Binh Thuy District,12,13,10,3,0
2022-05-20,Can Tho City,Binh Thuy District,13,12,12,0,0
2022-05-20,Can Tho City,Binh Thuy District,14,11,10,1,0
2022-05-20,Can Tho City,Binh Thuy District,15,15,12,3,0
2022-05-20,Can Tho City,Binh Thuy District,16,9,9,0,0
2022-05-20,Can Tho City,Binh Thuy District,17,9,9,0,0
2022-05-20,Can Tho City,Binh Thuy District,18,12,9,3,0
2022-05-20,Can Tho City,Binh Thuy District,19,6,6,0,0
2022-05-20,Can Tho City,Binh Thuy District,20,9,9,0,0
2022-05-20,Can Tho City,Binh Thuy District,21,8,3,5,3
2022-05-20,Can Tho City,Cai Rang District,7,7,6,1,1
2022-05-20,Can Tho City,Cai Rang District,8,10,9,1,0
2022-05-20,Can Tho City,Cai Rang District,9,9,6,3,0
2022-05-20,Can Tho City,Cai Rang District,10,11,11,0,0
2022-05-20,Can Tho City,Cai Rang District,11,12,10,2,1
2022-05-20,Can Tho City,Cai Rang District,12,9,8,1,1
2022-05-20,Can Tho City,Cai Rang District,13,6,6,0,0
2022-05-20,Can Tho City,Cai Rang District,14,12,11,1,1
2022-05-20,Can Tho City,Cai Rang District,15,12,11,1,0
2022-05-20,Can Tho City,Cai Rang District,16,7,6,1,1
2022-05-20,Can Tho City,Cai Rang District,17,18,18,0,0
2022-05-20,Can Tho City,Cai Rang District,18,8,8,0,0
2022-05-20,Can Tho City,Cai Rang District,19,13,12,1,0
2022-05-20,Can Tho City,Cai Rang District,20,19,12,7,2
2022-05-20,Can Tho City,Cai Rang District,21,2,2,0,0
2022-05-20,Can Tho City,Ninh Kieu District,0,3,1,2,1
2022-05-20,Can Tho City,Ninh Kieu District,1,3,3,0,0
2022-05-20,Can Tho City,Ninh Kieu District,2,1,1,0,0
2022-05-20,Can Tho City,Ninh Kieu District,3,2,2,0,0
2022-05-20,Can Tho City,Ninh Kieu District,5,4,3,1,1
2022-05-20,Can Tho City,Ninh Kieu District,6,40,31,9,6
2022-05-20,Can Tho City,Ninh Kieu District,7,148,137,11,0
2022-05-20,Can Tho City,Ninh Kieu District,8,235,228,7,0
2022-05-20,Can Tho City,Ninh Kieu District,9,336,319,17,0
2022-05-20,Can Tho City,Ninh Kieu District,10,614,585,29,0
2022-05-20,Can Tho City,Ninh Kieu District,11,904,870,34,2
2022-05-20,Can Tho City,Ninh Kieu District,12,633,600,33,0
2022-05-20,Can Tho City,Ninh Kieu District,13,552,527,25,0
2022-05-20,Can Tho City,Ninh Kieu District,14,483,454,29,0
2022-05-20,Can Tho City,Ninh Kieu District,15,393,368,25,0
2022-05-20,Can Tho City,Ninh Kieu District,16,420,403,17,0
2022-05-20,Can Tho City,Ninh Kieu District,17,515,492,23,0
2022-05-20,Can Tho City,Ninh Kieu District,18,509,479,30,0
2022-05-20,Can Tho City,Ninh Kieu District,19,512,487,25,0
2022-05-20,Can Tho City,Ninh Kieu District,20,354,332,22,0
2022-05-20,Can Tho City,Ninh Kieu District,21,196,177,19,0
2022-05-20,Can Tho City,Ninh Kieu District,22,4,1,3,0
2022-05-20,Can Tho City,Ninh Kieu District,23,2,1,1,0
2022-05-20,Can Tho City,Thoi Lai,15,1,0,1,1
2022-05-20,Dong Nai,Bien Hoa City,1,1,0,1,0
2022-05-20,Dong Nai,Bien Hoa City,2,2,0,2,0
2022-05-20,Dong Nai,Bien Hoa City,4,2,2,0,0
2022-05-20,Dong Nai,Bien Hoa City,5,2,0,2,1
2022-05-20,Dong Nai,Bien Hoa City,6,48,31,17,14
2022-05-20,Dong Nai,Bien Hoa City,7,164,141,23,8
2022-05-20,Dong Nai,Bien Hoa City,8,318,288,30,2
2022-05-20,Dong Nai,Bien Hoa City,9,433,388,45,7
2022-05-20,Dong Nai,Bien Hoa City,10,759,681,78,11
2022-05-20,Dong Nai,Bien Hoa City,11,1138,1044,94,23
2022-05-20,Dong Nai,Bien Hoa City,12,886,821,65,9
2022-05-20,Dong Nai,Bien Hoa City,13,827,765,62,6
2022-05-20,Dong Nai,Bien Hoa City,14,679,631,48,20
2022-05-20,Dong Nai,Bien Hoa City,15,525,481,44,11
2022-05-20,Dong Nai,Bien Hoa City,16,495,459,36,4
2022-05-20,Dong Nai,Bien Hoa City,17,607,563,44,8
2022-05-20,Dong Nai,Bien Hoa City,18,668,624,44,14
2022-05-20,Dong Nai,Bien Hoa City,19,615,570,45,2
2022-05-20,Dong Nai,Bien Hoa City,20,474,407,67,15
2022-05-20,Dong Nai,Bien Hoa City,21,213,153,60,25
2022-05-20,Dong Nai,Bien Hoa City,22,1,0,1,0
2022-05-20,Dong Nai,Bien Hoa City,23,2,0,2,0
2022-05-20,Dong Nai,Long Khanh,15,1,0,1,1
2022-05-20,Dong Nai,Long Khanh,16,1,0,1,1
2022-05-20,Dong Nai,Long Thanh,9,1,0,1,0
2022-05-20,Dong Nai,Long Thanh,12,3,0,3,3
2022-05-20,Dong Nai,Long Thanh,13,1,0,1,1
2022-05-20,Dong Nai,Long Thanh,15,2,0,2,1
2022-05-20,Dong Nai,Long Thanh,18,1,0,1,1
2022-05-20,Dong Nai,Long Thanh,19,4,0,4,3
2022-05-20,Dong Nai,Nhon trach,7,1,0,1,1
2022-05-20,Dong Nai,Nhon trach,17,2,0,2,2
2022-05-20,Dong Nai,Trang Bom,12,2,0,2,2
2022-05-20,Dong Nai,Trang Bom,20,3,0,3,0
2022-05-20,Dong Nai,Trang Bom,21,1,0,1,0
2022-05-20,Dong Nai,Vinh Cuu,11,1,0,1,1
2022-05-20,Hai Phong City,An Duong,1,1,0,1,1
2022-05-20,Hai Phong City,An Duong,7,2,0,2,2
2022-05-20,Hai Phong City,An Duong,8,3,1,2,2
2022-05-20,Hai Phong City,An Duong,9,1,0,1,1
2022-05-20,Hai Phong City,An Duong,10,5,4,1,0
2022-05-20,Hai Phong City,An Duong,11,2,1,1,1
2022-05-20,Hai Phong City,An Duong,12,2,1,1,1
2022-05-20,Hai Phong City,An Duong,13,1,1,0,0
2022-05-20,Hai Phong City,An Duong,14,5,1,4,1
2022-05-20,Hai Phong City,An Duong,16,1,0,1,1
2022-05-20,Hai Phong City,An Duong,17,4,1,3,0
2022-05-20,Hai Phong City,An Duong,18,3,1,2,1
2022-05-20,Hai Phong City,An Duong,20,1,1,0,0
2022-05-20,Hai Phong City,An Duong,21,2,1,1,1
2022-05-20,Hai Phong City,Hai An District,0,1,0,1,1
2022-05-20,Hai Phong City,Hai An District,6,1,1,0,0
2022-05-20,Hai Phong City,Hai An District,7,7,6,1,1
2022-05-20,Hai Phong City,Hai An District,8,14,9,5,4
2022-05-20,Hai Phong City,Hai An District,9,17,9,8,1
2022-05-20,Hai Phong City,Hai An District,10,25,22,3,2
2022-05-20,Hai Phong City,Hai An District,11,52,42,10,1
2022-05-20,Hai Phong City,Hai An District,12,26,21,5,1
2022-05-20,Hai Phong City,Hai An District,13,19,16,3,2
2022-05-20,Hai Phong City,Hai An District,14,19,18,1,1
2022-05-20,Hai Phong City,Hai An District,15,15,13,2,2
2022-05-20,Hai Phong City,Hai An District,16,12,12,0,0
2022-05-20,Hai Phong City,Hai An District,17,14,12,2,0
2022-05-20,Hai Phong City,Hai An District,18,27,20,7,0
2022-05-20,Hai Phong City,Hai An District,19,26,22,4,1
2022-05-20,Hai Phong City,Hai An District,20,17,15,2,0
2022-05-20,Hai Phong City,Hai An District,21,12,11,1,0
2022-05-20,Hai Phong City,Hong Bang District,3,1,1,0,0
2022-05-20,Hai Phong City,Hong Bang District,7,18,16,2,1
2022-05-20,Hai Phong City,Hong Bang District,8,34,29,5,4
2022-05-20,Hai Phong City,Hong Bang District,9,33,27,6,1
2022-05-20,Hai Phong City,Hong Bang District,10,47,44,3,1
2022-05-20,Hai Phong City,Hong Bang District,11,89,76,13,7
2022-05-20,Hai Phong City,Hong Bang District,12,66,52,14,6
2022-05-20,Hai Phong City,Hong Bang District,13,51,43,8,3
2022-05-20,Hai Phong City,Hong Bang District,14,34,28,6,5
2022-05-20,Hai Phong City,Hong Bang District,15,29,27,2,0
2022-05-20,Hai Phong City,Hong Bang District,16,36,32,4,0
2022-05-20,Hai Phong City,Hong Bang District,17,37,31,6,0
2022-05-20,Hai Phong City,Hong Bang District,18,44,40,4,1
2022-05-20,Hai Phong City,Hong Bang District,19,41,30,11,10
2022-05-20,Hai Phong City,Hong Bang District,20,31,23,8,2
2022-05-20,Hai Phong City,Hong Bang District,21,24,13,11,3
2022-05-20,Hai Phong City,Kien An District,1,1,0,1,0
2022-05-20,Hai Phong City,Kien An District,6,1,0,1,1
2022-05-20,Hai Phong City,Kien An District,7,1,1,0,0
2022-05-20,Hai Phong City,Kien An District,8,5,2,3,1
2022-05-20,Hai Phong City,Kien An District,9,3,2,1,1
2022-05-20,Hai Phong City,Kien An District,10,6,6,0,0
2022-05-20,Hai Phong City,Kien An District,11,12,10,2,1
2022-05-20,Hai Phong City,Kien An District,12,6,4,2,0
2022-05-20,Hai Phong City,Kien An District,13,10,7,3,3
2022-05-20,Hai Phong City,Kien An District,14,6,6,0,0
2022-05-20,Hai Phong City,Kien An District,15,6,5,1,0
2022-05-20,Hai Phong City,Kien An District,16,5,4,1,0
2022-05-20,Hai Phong City,Kien An District,17,4,4,0,0
2022-05-20,Hai Phong City,Kien An District,18,11,8,3,1
2022-05-20,Hai Phong City,Kien An District,19,11,5,6,5
2022-05-20,Hai Phong City,Kien An District,20,17,5,12,9
2022-05-20,Hai Phong City,Kien An District,21,4,2,2,1
2022-05-20,Hai Phong City,Le Chan District,5,1,0,1,0
2022-05-20,Hai Phong City,Le Chan District,6,1,1,0,0
2022-05-20,Hai Phong City,Le Chan District,7,38,28,10,6
2022-05-20,Hai Phong City,Le Chan District,8,81,67,14,7
2022-05-20,Hai Phong City,Le Chan District,9,74,63,11,2
2022-05-20,Hai Phong City,Le Chan District,10,162,147,15,2
2022-05-20,Hai Phong City,Le Chan District,11,320,279,41,19
2022-05-20,Hai Phong City,Le Chan District,12,178,166,12,3
2022-05-20,Hai Phong City,Le Chan District,13,118,105,13,0
2022-05-20,Hai Phong City,Le Chan District,14,136,109,27,8
2022-05-20,Hai Phong City,Le Chan District,15,117,108,9,1
2022-05-20,Hai Phong City,Le Chan District,16,107,95,12,0
2022-05-20,Hai Phong City,Le Chan District,17,172,155,17,4
2022-05-20,Hai Phong City,Le Chan District,18,199,167,32,12
2022-05-20,Hai Phong City,Le Chan District,19,198,162,36,19
2022-05-20,Hai Phong City,Le Chan District,20,134,114,20,6
2022-05-20,Hai Phong City,Le Chan District,21,66,57,9,1
2022-05-20,Hai Phong City,Le Chan District,23,1,1,0,0
2022-05-20,Hai Phong City,Ngo Quyen District,1,1,1,0,0
2022-05-20,Hai Phong City,Ngo Quyen District,3,1,1,0,0
2022-05-20,Hai Phong City,Ngo Quyen District,6,1,0,1,1
2022-05-20,Hai Phong City,Ngo Quyen District,7,18,14,4,3
2022-05-20,Hai Phong City,Ngo Quyen District,8,72,63,9,3
2022-05-20,Hai Phong City,Ngo Quyen District,9,64,58,6,1
2022-05-20,Hai Phong City,Ngo Quyen District,10,117,109,8,0
2022-05-20,Hai Phong City,Ngo Quyen District,11,231,216,15,3
2022-05-20,Hai Phong City,Ngo Quyen District,12,140,130,10,1
2022-05-20,Hai Phong City,Ngo Quyen District,13,104,93,11,2
2022-05-20,Hai Phong City,Ngo Quyen District,14,118,104,14,1
2022-05-20,Hai Phong City,Ngo Quyen District,15,115,104,11,0
2022-05-20,Hai Phong City,Ngo Quyen District,16,102,93,9,1
2022-05-20,Hai Phong City,Ngo Quyen District,17,128,109,19,2
2022-05-20,Hai Phong City,Ngo Quyen District,18,158,132,26,6
2022-05-20,Hai Phong City,Ngo Quyen District,19,140,117,23,10
2022-05-20,Hai Phong City,Ngo Quyen District,20,104,91,13,3
2022-05-20,Hai Phong City,Ngo Quyen District,21,57,39,18,8
2022-05-20,Hai Phong City,Ngo Quyen District,22,2,1,1,0
2022-05-20,Hai Phong City,Thuy Nguyen,11,1,0,1,1
2022-05-20,Hai Phong City,Thuy Nguyen,20,1,0,1,0
2022-05-20,Hue City,Hue City,1,2,2,0,0
2022-05-20,Hue City,Hue City,3,1,1,0,0
2022-05-20,Hue City,Hue City,4,1,1,0,0
2022-05-20,Hue City,Hue City,5,3,2,1,0
2022-05-20,Hue City,Hue City,6,66,56,10,8
2022-05-20,Hue City,Hue City,7,205,190,15,0
2022-05-20,Hue City,Hue City,8,319,291,28,2
2022-05-20,Hue City,Hue City,9,229,207,22,0
2022-05-20,Hue City,Hue City,10,405,379,26,1
2022-05-20,Hue City,Hue City,11,908,840,68,2
2022-05-20,Hue City,Hue City,12,539,505,34,0
2022-05-20,Hue City,Hue City,13,315,289,26,1
2022-05-20,Hue City,Hue City,14,351,324,27,1
2022-05-20,Hue City,Hue City,15,314,295,19,1
2022-05-20,Hue City,Hue City,16,332,306,26,1
2022-05-20,Hue City,Hue City,17,409,387,22,0
2022-05-20,Hue City,Hue City,18,532,493,39,1
2022-05-20,Hue City,Hue City,19,522,481,41,10
2022-05-20,Hue City,Hue City,20,355,322,33,8
2022-05-20,Hue City,Hue City,21,261,217,44,6
2022-05-20,Hue City,Hue City,22,6,4,2,1
2022-05-20,Hue City,Huong Thuy,10,1,0,1,1
2022-05-20,Hue City,Huong Thuy,11,1,1,0,0
2022-05-20,Hue City,Huong Thuy,13,1,1,0,0
2022-05-20,Hue City,Huong Tra,9,1,1,0,0
2022-05-20,Hue City,Huong Tra,11,1,1,0,0
2022-05-20,Hue City,Huong Tra,12,1,1,0,0
2022-05-20,Hue City,Huong Tra,13,1,1,0,0
2022-05-20,Hue City,Huong Tra,19,1,0,1,0
2022-05-20,Hue City,Phu Vang,8,3,3,0,0
2022-05-20,Hue City,Phu Vang,11,3,3,0,0
2022-05-20,Hue City,Phu Vang,12,1,0,1,1
2022-05-20,Hue City,Phu Vang,13,2,2,0,0
2022-05-20,Hue City,Phu Vang,14,4,3,1,0
2022-05-20,Hue City,Phu Vang,15,1,1,0,0
2022-05-20,Hue City,Phu Vang,16,3,3,0,0
2022-05-20,Hue City,Phu Vang,18,3,2,1,0
2022-05-20,Hue City,Phu Vang,19,3,3,0,0
2022-05-20,Hue City,Phu Vang,20,3,2,1,0
2022-05-20,Vung Tau,Ba Ria City,7,1,0,1,0
2022-05-20,Vung Tau,Ba Ria City,8,1,0,1,1
2022-05-20,Vung Tau,Ba Ria City,9,6,3,3,2
2022-05-20,Vung Tau,Ba Ria City,10,9,6,3,2
2022-05-20,Vung Tau,Ba Ria City,11,10,1,9,9
2022-05-20,Vung Tau,Ba Ria City,12,3,3,0,0
2022-05-20,Vung Tau,Ba Ria City,13,10,4,6,4
2022-05-20,Vung Tau,Ba Ria City,14,6,2,4,4
2022-05-20,Vung Tau,Ba Ria City,15,5,2,3,3
2022-05-20,Vung Tau,Ba Ria City,16,4,2,2,2
2022-05-20,Vung Tau,Ba Ria City,17,1,0,1,1
2022-05-20,Vung Tau,Ba Ria City,18,7,4,3,2
2022-05-20,Vung Tau,Ba Ria City,19,5,1,4,3
2022-05-20,Vung Tau,Ba Ria City,20,1,0,1,1
2022-05-20,Vung Tau,Ba Ria City,21,1,0,1,1
2022-05-20,Vung Tau,Vung Tau City,0,1,1,0,0
2022-05-20,Vung Tau,Vung Tau City,1,2,1,1,1
2022-05-20,Vung Tau,Vung Tau City,2,1,1,0,0
2022-05-20,Vung Tau,Vung Tau City,5,2,0,2,2
2022-05-20,Vung Tau,Vung Tau City,6,25,24,1,0
2022-05-20,Vung Tau,Vung Tau City,7,83,79,4,2
2022-05-20,Vung Tau,Vung Tau City,8,179,163,16,3
2022-05-20,Vung Tau,Vung Tau City,9,168,152,16,3
2022-05-20,Vung Tau,Vung Tau City,10,179,165,14,3
2022-05-20,Vung Tau,Vung Tau City,11,344,327,17,3
2022-05-20,Vung Tau,Vung Tau City,12,283,270,13,1
2022-05-20,Vung Tau,Vung Tau City,13,203,194,9,0
2022-05-20,Vung Tau,Vung Tau City,14,262,242,20,5
2022-05-20,Vung Tau,Vung Tau City,15,208,196,12,3
2022-05-20,Vung Tau,Vung Tau City,16,182,166,16,6
2022-05-20,Vung Tau,Vung Tau City,17,296,253,43,25
2022-05-20,Vung Tau,Vung Tau City,18,365,272,93,70
2022-05-20,Vung Tau,Vung Tau City,19,301,222,79,56
2022-05-20,Vung Tau,Vung Tau City,20,228,138,90,70
2022-05-20,Vung Tau,Vung Tau City,21,190,46,144,126
2022-05-20,Vung Tau,Vung Tau City,22,1,0,1,0
2022-05-20,Vung Tau,Vung Tau City,23,1,1,0,0
2022-05-21,Binh Duong,Ben Cat,10,1,0,1,1
2022-05-21,Binh Duong,Ben Cat,11,1,1,0,0
2022-05-21,Binh Duong,Ben Cat,12,3,0,3,1
2022-05-21,Binh Duong,Ben Cat,13,1,0,1,1
2022-05-21,Binh Duong,Ben Cat,14,1,0,1,0
2022-05-21,Binh Duong,Ben Cat,18,3,0,3,2
2022-05-21,Binh Duong,Ben Cat,19,1,0,1,1
2022-05-21,Binh Duong,Ben Cat,21,1,0,1,1
2022-05-21,Binh Duong,Di An,6,1,0,1,1
2022-05-21,Binh Duong,Di An,7,4,0,4,3
2022-05-21,Binh Duong,Di An,8,10,7,3,3
2022-05-21,Binh Duong,Di An,9,17,10,7,4
2022-05-21,Binh Duong,Di An,10,48,26,22,19
2022-05-21,Binh Duong,Di An,11,60,27,33,27
2022-05-21,Binh Duong,Di An,12,42,28,14,13
2022-05-21,Binh Duong,Di An,13,41,21,20,12
2022-05-21,Binh Duong,Di An,14,35,11,24,20
2022-05-21,Binh Duong,Di An,15,26,14,12,10
2022-05-21,Binh Duong,Di An,16,31,13,18,14
2022-05-21,Binh Duong,Di An,17,52,22,30,25
2022-05-21,Binh Duong,Di An,18,43,21,22,17
2022-05-21,Binh Duong,Di An,19,39,12,27,25
2022-05-21,Binh Duong,Di An,20,40,17,23,16
2022-05-21,Binh Duong,Di An,21,16,8,8,7
2022-05-21,Binh Duong,Tan Uyen,8,2,1,1,1
2022-05-21,Binh Duong,Tan Uyen,9,1,0,1,1
2022-05-21,Binh Duong,Tan Uyen,10,2,0,2,2
2022-05-21,Binh Duong,Tan Uyen,11,1,1,0,0
2022-05-21,Binh Duong,Tan Uyen,12,2,1,1,0
2022-05-21,Binh Duong,Tan Uyen,13,2,0,2,2
2022-05-21,Binh Duong,Tan Uyen,14,1,1,0,0
2022-05-21,Binh Duong,Tan Uyen,15,2,1,1,1
2022-05-21,Binh Duong,Tan Uyen,16,2,0,2,1
2022-05-21,Binh Duong,Tan Uyen,17,3,2,1,1
2022-05-21,Binh Duong,Tan Uyen,18,1,1,0,0
2022-05-21,Binh Duong,Tan Uyen,19,2,1,1,1
2022-05-21,Binh Duong,Tan Uyen,20,1,0,1,1
2022-05-21,Binh Duong,Thu Dau Mot Town,3,2,0,2,0
2022-05-21,Binh Duong,Thu Dau Mot Town,5,1,1,0,0
2022-05-21,Binh Duong,Thu Dau Mot Town,6,44,34,10,9
2022-05-21,Binh Duong,Thu Dau Mot Town,7,142,133,9,2
2022-05-21,Binh Duong,Thu Dau Mot Town,8,191,174,17,1
2022-05-21,Binh Duong,Thu Dau Mot Town,9,318,301,17,3
2022-05-21,Binh Duong,Thu Dau Mot Town,10,438,413,25,2
2022-05-21,Binh Duong,Thu Dau Mot Town,11,642,609,33,1
2022-05-21,Binh Duong,Thu Dau Mot Town,12,544,521,23,4
2022-05-21,Binh Duong,Thu Dau Mot Town,13,388,376,12,0
2022-05-21,Binh Duong,Thu Dau Mot Town,14,323,304,19,3
2022-05-21,Binh Duong,Thu Dau Mot Town,15,315,298,17,3
2022-05-21,Binh Duong,Thu Dau Mot Town,16,277,266,11,0
2022-05-21,Binh Duong,Thu Dau Mot Town,17,349,320,29,3
2022-05-21,Binh Duong,Thu Dau Mot Town,18,409,382,27,2
2022-05-21,Binh Duong,Thu Dau Mot Town,19,365,344,21,1
2022-05-21,Binh Duong,Thu Dau Mot Town,20,306,269,37,4
2022-05-21,Binh Duong,Thu Dau Mot Town,21,124,106,18,6
2022-05-21,Binh Duong,Thu Dau Mot Town,22,2,1,1,0
2022-05-21,Binh Duong,Thu Dau Mot Town,23,1,0,1,0
2022-05-21,Binh Duong,Thuan An,1,1,1,0,0
2022-05-21,Binh Duong,Thuan An,6,6,1,5,4
2022-05-21,Binh Duong,Thuan An,7,4,4,0,0
2022-05-21,Binh Duong,Thuan An,8,25,14,11,8
2022-05-21,Binh Duong,Thuan An,9,34,25,9,6
2022-05-21,Binh Duong,Thuan An,10,60,47,13,7
2022-05-21,Binh Duong,Thuan An,11,95,62,33,25
2022-05-21,Binh Duong,Thuan An,12,80,57,23,13
2022-05-21,Binh Duong,Thuan An,13,63,40,23,16
2022-05-21,Binh Duong,Thuan An,14,43,19,24,19
2022-05-21,Binh Duong,Thuan An,15,32,21,11,8
2022-05-21,Binh Duong,Thuan An,16,36,26,10,7
2022-05-21,Binh Duong,Thuan An,17,54,45,9,4
2022-05-21,Binh Duong,Thuan An,18,53,46,7,4
2022-05-21,Binh Duong,Thuan An,19,46,38,8,6
2022-05-21,Binh Duong,Thuan An,20,52,28,24,21
2022-05-21,Binh Duong,Thuan An,21,21,4,17,12
2022-05-21,Can Tho City,Binh Thuy District,7,4,3,1,1
2022-05-21,Can Tho City,Binh Thuy District,8,4,3,1,0
2022-05-21,Can Tho City,Binh Thuy District,9,8,5,3,0
2022-05-21,Can Tho City,Binh Thuy District,10,13,11,2,0
2022-05-21,Can Tho City,Binh Thuy District,11,9,7,2,0
2022-05-21,Can Tho City,Binh Thuy District,12,9,9,0,0
2022-05-21,Can Tho City,Binh Thuy District,13,13,12,1,0
2022-05-21,Can Tho City,Binh Thuy District,14,13,12,1,0
2022-05-21,Can Tho City,Binh Thuy District,15,15,15,0,0
2022-05-21,Can Tho City,Binh Thuy District,16,11,9,2,0
2022-05-21,Can Tho City,Binh Thuy District,17,16,14,2,1
2022-05-21,Can Tho City,Binh Thuy District,18,18,17,1,0
2022-05-21,Can Tho City,Binh Thuy District,19,13,9,4,0
2022-05-21,Can Tho City,Binh Thuy District,20,12,9,3,2
2022-05-21,Can Tho City,Binh Thuy District,21,5,1,4,1
2022-05-21,Can Tho City,Cai Rang District,6,3,2,1,1
2022-05-21,Can Tho City,Cai Rang District,7,2,1,1,0
2022-05-21,Can Tho City,Cai Rang District,8,8,7,1,1
2022-05-21,Can Tho City,Cai Rang District,9,4,4,0,0
2022-05-21,Can Tho City,Cai Rang District,10,9,7,2,0
2022-05-21,Can Tho City,Cai Rang District,11,7,7,0,0
2022-05-21,Can Tho City,Cai Rang District,12,9,8,1,0
2022-05-21,Can Tho City,Cai Rang District,13,10,9,1,0
2022-05-21,Can Tho City,Cai Rang District,14,7,7,0,0
2022-05-21,Can Tho City,Cai Rang District,15,11,10,1,0
2022-05-21,Can Tho City,Cai Rang District,16,12,12,0,0
2022-05-21,Can Tho City,Cai Rang District,17,15,14,1,0
2022-05-21,Can Tho City,Cai Rang District,18,14,13,1,0
2022-05-21,Can Tho City,Cai Rang District,19,8,8,0,0
2022-05-21,Can Tho City,Cai Rang District,20,18,15,3,0
2022-05-21,Can Tho City,Cai Rang District,21,3,3,0,0
2022-05-21,Can Tho City,Ninh Kieu District,0,2,1,1,0
2022-05-21,Can Tho City,Ninh Kieu District,1,3,3,0,0
2022-05-21,Can Tho City,Ninh Kieu District,2,2,2,0,0
2022-05-21,Can Tho City,Ninh Kieu District,3,1,0,1,0
2022-05-21,Can Tho City,Ninh Kieu District,4,4,2,2,0
2022-05-21,Can Tho City,Ninh Kieu District,5,3,1,2,1
2022-05-21,Can Tho City,Ninh Kieu District,6,51,41,10,5
2022-05-21,Can Tho City,Ninh Kieu District,7,165,153,12,0
2022-05-21,Can Tho City,Ninh Kieu District,8,233,219,14,0
2022-05-21,Can Tho City,Ninh Kieu District,9,318,294,24,0
2022-05-21,Can Tho City,Ninh Kieu District,10,561,537,24,0
2022-05-21,Can Tho City,Ninh Kieu District,11,741,704,37,2
2022-05-21,Can Tho City,Ninh Kieu District,12,620,596,24,0
2022-05-21,Can Tho City,Ninh Kieu District,13,480,458,22,0
2022-05-21,Can Tho City,Ninh Kieu District,14,380,365,15,0
2022-05-21,Can Tho City,Ninh Kieu District,15,350,325,25,0
2022-05-21,Can Tho City,Ninh Kieu District,16,456,428,28,0
2022-05-21,Can Tho City,Ninh Kieu District,17,549,529,20,1
2022-05-21,Can Tho City,Ninh Kieu District,18,527,499,28,0
2022-05-21,Can Tho City,Ninh Kieu District,19,481,442,39,1
2022-05-21,Can Tho City,Ninh Kieu District,20,405,345,60,18
2022-05-21,Can Tho City,Ninh Kieu District,21,267,234,33,12
2022-05-21,Can Tho City,Ninh Kieu District,22,7,1,6,0
2022-05-21,Can Tho City,Ninh Kieu District,23,2,2,0,0
2022-05-21,Can Tho City,O Mon District,8,1,0,1,1
2022-05-21,Can Tho City,O Mon District,9,1,0,1,1
2022-05-21,Dong Nai,Bien Hoa City,0,3,1,2,1
2022-05-21,Dong Nai,Bien Hoa City,2,2,2,0,0
2022-05-21,Dong Nai,Bien Hoa City,3,1,1,0,0
2022-05-21,Dong Nai,Bien Hoa City,4,1,1,0,0
2022-05-21,Dong Nai,Bien Hoa City,6,64,39,25,23
2022-05-21,Dong Nai,Bien Hoa City,7,196,161,35,18
2022-05-21,Dong Nai,Bien Hoa City,8,351,318,33,7
2022-05-21,Dong Nai,Bien Hoa City,9,446,406,40,6
2022-05-21,Dong Nai,Bien Hoa City,10,816,766,50,5
2022-05-21,Dong Nai,Bien Hoa City,11,1156,1061,95,18
2022-05-21,Dong Nai,Bien Hoa City,12,971,898,73,15
2022-05-21,Dong Nai,Bien Hoa City,13,755,706,49,7
2022-05-21,Dong Nai,Bien Hoa City,14,502,423,79,43
2022-05-21,Dong Nai,Bien Hoa City,15,558,448,110,57
2022-05-21,Dong Nai,Bien Hoa City,16,718,569,149,90
2022-05-21,Dong Nai,Bien Hoa City,17,895,734,161,93
2022-05-21,Dong Nai,Bien Hoa City,18,926,759,167,105
2022-05-21,Dong Nai,Bien Hoa City,19,820,662,158,80
2022-05-21,Dong Nai,Bien Hoa City,20,596,492,104,42
2022-05-21,Dong Nai,Bien Hoa City,21,255,186,69,33
2022-05-21,Dong Nai,Bien Hoa City,22,2,0,2,0
2022-05-21,Dong Nai,Bien Hoa City,23,3,2,1,0
2022-05-21,Dong Nai,Long Khanh,15,2,0,2,1
2022-05-21,Dong Nai,Long Thanh,11,7,0,7,7
2022-05-21,Dong Nai,Long Thanh,12,2,0,2,2
2022-05-21,Dong Nai,Long Thanh,13,2,0,2,2
2022-05-21,Dong Nai,Long Thanh,14,3,0,3,3
2022-05-21,Dong Nai,Long Thanh,16,1,0,1,1
2022-05-21,Dong Nai,Long Thanh,19,2,0,2,2
2022-05-21,Dong Nai,Nhon trach,8,1,0,1,1
2022-05-21,Dong Nai,Nhon trach,11,3,0,3,3
2022-05-21,Dong Nai,Nhon trach,17,1,0,1,1
2022-05-21,Dong Nai,Nhon trach,18,1,0,1,1
2022-05-21,Dong Nai,Nhon trach,20,1,0,1,1
2022-05-21,Dong Nai,Trang Bom,10,2,0,2,1
2022-05-21,Dong Nai,Trang Bom,17,1,0,1,0
2022-05-21,Hai Phong City,An Duong,8,2,1,1,1
2022-05-21,Hai Phong City,An Duong,9,1,0,1,1
2022-05-21,Hai Phong City,An Duong,10,2,0,2,2
2022-05-21,Hai Phong City,An Duong,11,1,0,1,1
2022-05-21,Hai Phong City,An Duong,12,1,1,0,0
2022-05-21,Hai Phong City,An Duong,13,3,2,1,0
2022-05-21,Hai Phong City,An Duong,14,5,1,4,3
2022-05-21,Hai Phong City,An Duong,15,1,0,1,0
2022-05-21,Hai Phong City,An Duong,16,3,1,2,1
2022-05-21,Hai Phong City,An Duong,17,2,0,2,0
2022-05-21,Hai Phong City,An Duong,18,3,2,1,1
2022-05-21,Hai Phong City,An Duong,19,3,1,2,2
2022-05-21,Hai Phong City,An Duong,20,2,0,2,1
2022-05-21,Hai Phong City,An Duong,21,5,0,5,4
2022-05-21,Hai Phong City,An Duong,23,1,0,1,0
2022-05-21,Hai Phong City,Do Son District,11,1,0,1,1
2022-05-21,Hai Phong City,Do Son District,16,1,0,1,1
2022-05-21,Hai Phong City,Hai An District,6,1,0,1,0
2022-05-21,Hai Phong City,Hai An District,7,6,5,1,1
2022-05-21,Hai Phong City,Hai An District,8,17,10,7,3
2022-05-21,Hai Phong City,Hai An District,9,14,10,4,0
2022-05-21,Hai Phong City,Hai An District,10,31,22,9,3
2022-05-21,Hai Phong City,Hai An District,11,36,31,5,3
2022-05-21,Hai Phong City,Hai An District,12,23,17,6,3
2022-05-21,Hai Phong City,Hai An District,13,11,10,1,0
2022-05-21,Hai Phong City,Hai An District,14,14,7,7,1
2022-05-21,Hai Phong City,Hai An District,15,18,16,2,0
2022-05-21,Hai Phong City,Hai An District,16,21,18,3,1
2022-05-21,Hai Phong City,Hai An District,17,27,26,1,0
2022-05-21,Hai Phong City,Hai An District,18,27,18,9,3
2022-05-21,Hai Phong City,Hai An District,19,16,12,4,2
2022-05-21,Hai Phong City,Hai An District,20,18,14,4,0
2022-05-21,Hai Phong City,Hai An District,21,15,12,3,1
2022-05-21,Hai Phong City,Hong Bang District,6,1,1,0,0
2022-05-21,Hai Phong City,Hong Bang District,7,12,10,2,0
2022-05-21,Hai Phong City,Hong Bang District,8,28,26,2,0
2022-05-21,Hai Phong City,Hong Bang District,9,24,21,3,0
2022-05-21,Hai Phong City,Hong Bang District,10,73,62,11,3
2022-05-21,Hai Phong City,Hong Bang District,11,104,88,16,1
2022-05-21,Hai Phong City,Hong Bang District,12,83,69,14,7
2022-05-21,Hai Phong City,Hong Bang District,13,48,45,3,0
2022-05-21,Hai Phong City,Hong Bang District,14,41,32,9,4
2022-05-21,Hai Phong City,Hong Bang District,15,27,25,2,0
2022-05-21,Hai Phong City,Hong Bang District,16,45,40,5,1
2022-05-21,Hai Phong City,Hong Bang District,17,73,61,12,2
2022-05-21,Hai Phong City,Hong Bang District,18,63,51,12,3
2022-05-21,Hai Phong City,Hong Bang District,19,44,38,6,2
2022-05-21,Hai Phong City,Hong Bang District,20,42,34,8,4
2022-05-21,Hai Phong City,Hong Bang District,21,24,12,12,6
2022-05-21,Hai Phong City,Hong Bang District,22,1,1,0,0
2022-05-21,Hai Phong City,Kien An District,8,9,3,6,4
2022-05-21,Hai Phong City,Kien An District,9,8,6,2,2
2022-05-21,Hai Phong City,Kien An District,10,17,5,12,9
2022-05-21,Hai Phong City,Kien An District,11,10,8,2,2
2022-05-21,Hai Phong City,Kien An District,12,8,7,1,1
2022-05-21,Hai Phong City,Kien An District,13,6,4,2,2
2022-05-21,Hai Phong City,Kien An District,14,6,3,3,3
2022-05-21,Hai Phong City,Kien An District,15,5,4,1,0
2022-05-21,Hai Phong City,Kien An District,16,6,6,0,0
2022-05-21,Hai Phong City,Kien An District,17,7,7,0,0
2022-05-21,Hai Phong City,Kien An District,18,12,8,4,3
2022-05-21,Hai Phong City,Kien An District,19,7,2,5,4
2022-05-21,Hai Phong City,Kien An District,20,11,5,6,5
2022-05-21,Hai Phong City,Kien An District,21,2,1,1,1
2022-05-21,Hai Phong City,Le Chan District,0,1,1,0,0
2022-05-21,Hai Phong City,Le Chan District,1,1,0,1,0
2022-05-21,Hai Phong City,Le Chan District,6,3,2,1,0
2022-05-21,Hai Phong City,Le Chan District,7,35,25,10,7
2022-05-21,Hai Phong City,Le Chan District,8,74,67,7,1
2022-05-21,Hai Phong City,Le Chan District,9,93,80,13,3
2022-05-21,Hai Phong City,Le Chan District,10,166,152,14,1
2022-05-21,Hai Phong City,Le Chan District,11,321,298,23,5
2022-05-21,Hai Phong City,Le Chan District,12,217,191,26,8
2022-05-21,Hai Phong City,Le Chan District,13,122,106,16,1
2022-05-21,Hai Phong City,Le Chan District,14,139,125,14,5
2022-05-21,Hai Phong City,Le Chan District,15,155,138,17,2
2022-05-21,Hai Phong City,Le Chan District,16,157,139,18,1
2022-05-21,Hai Phong City,Le Chan District,17,176,156,20,5
2022-05-21,Hai Phong City,Le Chan District,18,230,205,25,13
2022-05-21,Hai Phong City,Le Chan District,19,192,164,28,11
2022-05-21,Hai Phong City,Le Chan District,20,141,126,15,3
2022-05-21,Hai Phong City,Le Chan District,21,87,64,23,7
2022-05-21,Hai Phong City,Le Chan District,22,1,1,0,0
2022-05-21,Hai Phong City,Le Chan District,23,2,1,1,0
2022-05-21,Hai Phong City,Ngo Quyen District,6,1,0,1,1
2022-05-21,Hai Phong City,Ngo Quyen District,7,17,12,5,3
2022-05-21,Hai Phong City,Ngo Quyen District,8,58,55,3,0
2022-05-21,Hai Phong City,Ngo Quyen District,9,85,73,12,3
2022-05-21,Hai Phong City,Ngo Quyen District,10,120,107,13,0
2022-05-21,Hai Phong City,Ngo Quyen District,11,194,182,12,3
2022-05-21,Hai Phong City,Ngo Quyen District,12,154,138,16,2
2022-05-21,Hai Phong City,Ngo Quyen District,13,93,84,9,1
2022-05-21,Hai Phong City,Ngo Quyen District,14,98,84,14,2
2022-05-21,Hai Phong City,Ngo Quyen District,15,85,77,8,0
2022-05-21,Hai Phong City,Ngo Quyen District,16,94,91,3,0
2022-05-21,Hai Phong City,Ngo Quyen District,17,108,93,15,5
2022-05-21,Hai Phong City,Ngo Quyen District,18,177,149,28,13
2022-05-21,Hai Phong City,Ngo Quyen District,19,136,114,22,4
2022-05-21,Hai Phong City,Ngo Quyen District,20,127,106,21,4
2022-05-21,Hai Phong City,Ngo Quyen District,21,58,37,21,10
2022-05-21,Hai Phong City,Ngo Quyen District,22,3,1,2,2
2022-05-21,Hai Phong City,Ngo Quyen District,23,1,0,1,0
2022-05-21,Hai Phong City,Thuy Nguyen,10,3,0,3,2
2022-05-21,Hai Phong City,Thuy Nguyen,11,2,0,2,2
2022-05-21,Hai Phong City,Thuy Nguyen,12,2,1,1,0
2022-05-21,Hai Phong City,Thuy Nguyen,14,1,0,1,1
2022-05-21,Hai Phong City,Thuy Nguyen,17,1,0,1,1
2022-05-21,Hai Phong City,Thuy Nguyen,19,2,0,2,2
2022-05-21,Hai Phong City,Thuy Nguyen,20,2,0,2,2
2022-05-21,Hai Phong City,Thuy Nguyen,21,1,0,1,0
2022-05-21,Hue City,Hue City,0,2,1,1,0
2022-05-21,Hue City,Hue City,5,1,1,0,0
2022-05-21,Hue City,Hue City,6,75,66,9,4
2022-05-21,Hue City,Hue City,7,185,168,17,0
2022-05-21,Hue City,Hue City,8,339,312,27,1
2022-05-21,Hue City,Hue City,9,271,255,16,0
2022-05-21,Hue City,Hue City,10,396,378,18,0
2022-05-21,Hue City,Hue City,11,689,647,42,0
2022-05-21,Hue City,Hue City,12,558,529,29,0
2022-05-21,Hue City,Hue City,13,325,297,28,0
2022-05-21,Hue City,Hue City,14,362,335,27,1
2022-05-21,Hue City,Hue City,15,362,334,28,1
2022-05-21,Hue City,Hue City,16,362,338,24,1
2022-05-21,Hue City,Hue City,17,436,413,23,3
2022-05-21,Hue City,Hue City,18,550,502,48,7
2022-05-21,Hue City,Hue City,19,529,471,58,3
2022-05-21,Hue City,Hue City,20,387,357,30,0
2022-05-21,Hue City,Hue City,21,232,162,70,39
2022-05-21,Hue City,Hue City,22,6,4,2,0
2022-05-21,Hue City,Huong Thuy,10,1,1,0,0
2022-05-21,Hue City,Huong Thuy,17,2,1,1,0
2022-05-21,Hue City,Huong Thuy,19,4,0,4,3
2022-05-21,Hue City,Huong Thuy,20,1,1,0,0
2022-05-21,Hue City,Huong Thuy,21,3,0,3,0
2022-05-21,Hue City,Huong Tra,16,1,0,1,1
2022-05-21,Hue City,Huong Tra,17,1,1,0,0
2022-05-21,Hue City,Huong Tra,18,2,2,0,0
2022-05-21,Hue City,Phu Vang,10,3,3,0,0
2022-05-21,Hue City,Phu Vang,11,4,3,1,0
2022-05-21,Hue City,Phu Vang,12,2,1,1,1
2022-05-21,Hue City,Phu Vang,13,1,1,0,0
2022-05-21,Hue City,Phu Vang,14,2,2,0,0
2022-05-21,Hue City,Phu Vang,15,1,1,0,0
2022-05-21,Hue City,Phu Vang,16,2,1,1,1
2022-05-21,Hue City,Phu Vang,17,1,0,1,0
2022-05-21,Hue City,Phu Vang,18,1,1,0,0
2022-05-21,Hue City,Phu Vang,20,1,1,0,0
2022-05-21,Hue City,Phu Vang,21,2,0,2,2
2022-05-21,Vung Tau,Ba Ria City,8,3,0,3,3
2022-05-21,Vung Tau,Ba Ria City,9,2,0,2,2
2022-05-21,Vung Tau,Ba Ria City,10,11,6,5,3
2022-05-21,Vung Tau,Ba Ria City,11,16,6,10,7
2022-05-21,Vung Tau,Ba Ria City,12,12,4,8,7
2022-05-21,Vung Tau,Ba Ria City,13,6,3,3,3
2022-05-21,Vung Tau,Ba Ria City,14,6,2,4,2
2022-05-21,Vung Tau,Ba Ria City,15,4,1,3,3
2022-05-21,Vung Tau,Ba Ria City,16,9,5,4,3
2022-05-21,Vung Tau,Ba Ria City,17,12,2,10,8
2022-05-21,Vung Tau,Ba Ria City,18,8,4,4,1
2022-05-21,Vung Tau,Ba Ria City,19,4,0,4,4
2022-05-21,Vung Tau,Ba Ria City,20,2,0,2,2
2022-05-21,Vung Tau,Ba Ria City,21,4,0,4,4
2022-05-21,Vung Tau,Vung Tau City,0,2,1,1,0
2022-05-21,Vung Tau,Vung Tau City,1,1,0,1,0
2022-05-21,Vung Tau,Vung Tau City,4,1,1,0,0
2022-05-21,Vung Tau,Vung Tau City,6,40,35,5,1
2022-05-21,Vung Tau,Vung Tau City,7,125,110,15,3
2022-05-21,Vung Tau,Vung Tau City,8,204,187,17,6
2022-05-21,Vung Tau,Vung Tau City,9,203,181,22,3
2022-05-21,Vung Tau,Vung Tau City,10,232,214,18,2
2022-05-21,Vung Tau,Vung Tau City,11,405,382,23,3
2022-05-21,Vung Tau,Vung Tau City,12,365,315,50,29
2022-05-21,Vung Tau,Vung Tau City,13,214,197,17,6
2022-05-21,Vung Tau,Vung Tau City,14,266,246,20,4
2022-05-21,Vung Tau,Vung Tau City,15,225,205,20,1
2022-05-21,Vung Tau,Vung Tau City,16,257,230,27,5
2022-05-21,Vung Tau,Vung Tau City,17,398,332,66,26
2022-05-21,Vung Tau,Vung Tau City,18,465,340,125,93
2022-05-21,Vung Tau,Vung Tau City,19,311,272,39,14
2022-05-21,Vung Tau,Vung Tau City,20,275,217,58,28
2022-05-21,Vung Tau,Vung Tau City,21,142,92,50,31
2022-05-21,Vung Tau,Vung Tau City,22,4,0,4,0
2022-05-22,Binh Duong,Ben Cat,11,3,0,3,3
2022-05-22,Binh Duong,Ben Cat,12,1,1,0,0
2022-05-22,Binh Duong,Ben Cat,13,2,1,1,0
2022-05-22,Binh Duong,Ben Cat,15,1,0,1,1
2022-05-22,Binh Duong,Ben Cat,16,1,0,1,1
2022-05-22,Binh Duong,Ben Cat,17,1,0,1,1
2022-05-22,Binh Duong,Di An,2,2,0,2,0
2022-05-22,Binh Duong,Di An,6,1,0,1,1
2022-05-22,Binh Duong,Di An,7,10,1,9,6
2022-05-22,Binh Duong,Di An,8,17,4,13,8
2022-05-22,Binh Duong,Di An,9,17,11,6,2
2022-05-22,Binh Duong,Di An,10,32,21,11,8
2022-05-22,Binh Duong,Di An,11,44,22,22,13
2022-05-22,Binh Duong,Di An,12,59,35,24,10
2022-05-22,Binh Duong,Di An,13,29,11,18,12
2022-05-22,Binh Duong,Di An,14,28,14,14,8
2022-05-22,Binh Duong,Di An,15,29,18,11,6
2022-05-22,Binh Duong,Di An,16,37,22,15,11
2022-05-22,Binh Duong,Di An,17,29,17,12,10
2022-05-22,Binh Duong,Di An,18,43,8,35,32
2022-05-22,Binh Duong,Di An,19,55,8,47,39
2022-05-22,Binh Duong,Di An,20,31,5,26,21
2022-05-22,Binh Duong,Di An,21,13,2,11,7
2022-05-22,Binh Duong,Tan Uyen,7,1,1,0,0
2022-05-22,Binh Duong,Tan Uyen,8,2,1,1,0
2022-05-22,Binh Duong,Tan Uyen,9,1,0,1,0
2022-05-22,Binh Duong,Tan Uyen,11,3,2,1,1
2022-05-22,Binh Duong,Tan Uyen,12,2,1,1,1
2022-05-22,Binh Duong,Tan Uyen,14,2,1,1,1
2022-05-22,Binh Duong,Tan Uyen,15,2,1,1,1
2022-05-22,Binh Duong,Tan Uyen,16,3,0,3,1
2022-05-22,Binh Duong,Tan Uyen,19,2,1,1,1
2022-05-22,Binh Duong,Tan Uyen,21,1,1,0,0
2022-05-22,Binh Duong,Thu Dau Mot Town,1,1,1,0,0
2022-05-22,Binh Duong,Thu Dau Mot Town,3,2,1,1,0
2022-05-22,Binh Duong,Thu Dau Mot Town,4,1,0,1,0
2022-05-22,Binh Duong,Thu Dau Mot Town,6,44,37,7,3
2022-05-22,Binh Duong,Thu Dau Mot Town,7,123,112,11,4
2022-05-22,Binh Duong,Thu Dau Mot Town,8,238,220,18,1
2022-05-22,Binh Duong,Thu Dau Mot Town,9,270,252,18,2
2022-05-22,Binh Duong,Thu Dau Mot Town,10,392,375,17,0
2022-05-22,Binh Duong,Thu Dau Mot Town,11,624,585,39,4
2022-05-22,Binh Duong,Thu Dau Mot Town,12,535,505,30,1
2022-05-22,Binh Duong,Thu Dau Mot Town,13,386,371,15,3
2022-05-22,Binh Duong,Thu Dau Mot Town,14,376,344,32,3
2022-05-22,Binh Duong,Thu Dau Mot Town,15,326,303,23,2
2022-05-22,Binh Duong,Thu Dau Mot Town,16,387,354,33,2
2022-05-22,Binh Duong,Thu Dau Mot Town,17,362,328,34,9
2022-05-22,Binh Duong,Thu Dau Mot Town,18,443,341,102,69
2022-05-22,Binh Duong,Thu Dau Mot Town,19,542,372,170,107
2022-05-22,Binh Duong,Thu Dau Mot Town,20,273,222,51,21
2022-05-22,Binh Duong,Thu Dau Mot Town,21,90,71,19,7
2022-05-22,Binh Duong,Thu Dau Mot Town,22,2,0,2,0
2022-05-22,Binh Duong,Thuan An,1,1,1,0,0
2022-05-22,Binh Duong,Thuan An,6,2,2,0,0
2022-05-22,Binh Duong,Thuan An,7,3,2,1,0
2022-05-22,Binh Duong,Thuan An,8,17,12,5,1
2022-05-22,Binh Duong,Thuan An,9,42,30,12,6
2022-05-22,Binh Duong,Thuan An,10,69,59,10,4
2022-05-22,Binh Duong,Thuan An,11,87,66,21,8
2022-05-22,Binh Duong,Thuan An,12,68,57,11,3
2022-05-22,Binh Duong,Thuan An,13,62,51,11,8
2022-05-22,Binh Duong,Thuan An,14,53,43,10,3
2022-05-22,Binh Duong,Thuan An,15,49,35,14,6
2022-05-22,Binh Duong,Thuan An,16,54,33,21,16
2022-05-22,Binh Duong,Thuan An,17,84,42,42,24
2022-05-22,Binh Duong,Thuan An,18,85,41,44,32
2022-05-22,Binh Duong,Thuan An,19,71,30,41,31
2022-05-22,Binh Duong,Thuan An,20,64,22,42,34
2022-05-22,Binh Duong,Thuan An,21,18,4,14,12
2022-05-22,Can Tho City,Binh Thuy District,0,1,1,0,0
2022-05-22,Can Tho City,Binh Thuy District,6,1,0,1,1
2022-05-22,Can Tho City,Binh Thuy District,7,5,2,3,0
2022-05-22,Can Tho City,Binh Thuy District,8,7,5,2,1
2022-05-22,Can Tho City,Binh Thuy District,9,12,10,2,0
2022-05-22,Can Tho City,Binh Thuy District,10,10,10,0,0
2022-05-22,Can Tho City,Binh Thuy District,11,8,7,1,1
2022-05-22,Can Tho City,Binh Thuy District,12,16,14,2,1
2022-05-22,Can Tho City,Binh Thuy District,13,11,9,2,0
2022-05-22,Can Tho City,Binh Thuy District,14,14,10,4,0
2022-05-22,Can Tho City,Binh Thuy District,15,9,9,0,0
2022-05-22,Can Tho City,Binh Thuy District,16,12,10,2,0
2022-05-22,Can Tho City,Binh Thuy District,17,21,19,2,0
2022-05-22,Can Tho City,Binh Thuy District,18,24,20,4,2
2022-05-22,Can Tho City,Binh Thuy District,19,15,11,4,3
2022-05-22,Can Tho City,Binh Thuy District,20,16,9,7,6
2022-05-22,Can Tho City,Binh Thuy District,21,8,2,6,5
2022-05-22,Can Tho City,Cai Rang District,6,2,0,2,2
2022-05-22,Can Tho City,Cai Rang District,7,6,5,1,1
2022-05-22,Can Tho City,Cai Rang District,8,3,2,1,1
2022-05-22,Can Tho City,Cai Rang District,9,6,6,0,0
2022-05-22,Can Tho City,Cai Rang District,10,12,11,1,0
2022-05-22,Can Tho City,Cai Rang District,11,13,11,2,1
2022-05-22,Can Tho City,Cai Rang District,12,7,6,1,0
2022-05-22,Can Tho City,Cai Rang District,13,7,6,1,1
2022-05-22,Can Tho City,Cai Rang District,14,11,11,0,0
2022-05-22,Can Tho City,Cai Rang District,15,17,13,4,3
2022-05-22,Can Tho City,Cai Rang District,16,15,14,1,1
2022-05-22,Can Tho City,Cai Rang District,17,14,12,2,0
2022-05-22,Can Tho City,Cai Rang District,18,11,9,2,1
2022-05-22,Can Tho City,Cai Rang District,19,20,8,12,10
2022-05-22,Can Tho City,Cai Rang District,20,18,8,10,5
2022-05-22,Can Tho City,Cai Rang District,21,10,2,8,8
2022-05-22,Can Tho City,Ninh Kieu District,0,4,1,3,0
2022-05-22,Can Tho City,Ninh Kieu District,1,2,2,0,0
2022-05-22,Can Tho City,Ninh Kieu District,3,3,3,0,0
2022-05-22,Can Tho City,Ninh Kieu District,5,3,3,0,0
2022-05-22,Can Tho City,Ninh Kieu District,6,53,37,16,13
2022-05-22,Can Tho City,Ninh Kieu District,7,157,120,37,24
2022-05-22,Can Tho City,Ninh Kieu District,8,272,255,17,0
2022-05-22,Can Tho City,Ninh Kieu District,9,364,333,31,0
2022-05-22,Can Tho City,Ninh Kieu District,10,565,537,28,0
2022-05-22,Can Tho City,Ninh Kieu District,11,763,704,59,10
2022-05-22,Can Tho City,Ninh Kieu District,12,523,502,21,0
2022-05-22,Can Tho City,Ninh Kieu District,13,492,477,15,0
2022-05-22,Can Tho City,Ninh Kieu District,14,469,443,26,0
2022-05-22,Can Tho City,Ninh Kieu District,15,419,397,22,0
2022-05-22,Can Tho City,Ninh Kieu District,16,542,503,39,5
2022-05-22,Can Tho City,Ninh Kieu District,17,674,605,69,23
2022-05-22,Can Tho City,Ninh Kieu District,18,686,582,104,51
2022-05-22,Can Tho City,Ninh Kieu District,19,632,393,239,189
2022-05-22,Can Tho City,Ninh Kieu District,20,758,327,431,363
2022-05-22,Can Tho City,Ninh Kieu District,21,538,200,338,278
2022-05-22,Can Tho City,Ninh Kieu District,22,5,0,5,0
2022-05-22,Can Tho City,O Mon District,8,1,0,1,1
2022-05-22,Can Tho City,Thoi Lai,14,1,0,1,1
2022-05-22,Dong Nai,Bien Hoa City,0,2,2,0,0
2022-05-22,Dong Nai,Bien Hoa City,1,4,3,1,0
2022-05-22,Dong Nai,Bien Hoa City,3,1,1,0,0
2022-05-22,Dong Nai,Bien Hoa City,6,50,34,16,11
2022-05-22,Dong Nai,Bien Hoa City,7,175,143,32,14
2022-05-22,Dong Nai,Bien Hoa City,8,320,276,44,15
2022-05-22,Dong Nai,Bien Hoa City,9,568,487,81,10
2022-05-22,Dong Nai,Bien Hoa City,10,816,741,75,9
2022-05-22,Dong Nai,Bien Hoa City,11,1219,1079,140,44
2022-05-22,Dong Nai,Bien Hoa City,12,1121,1029,92,19
2022-05-22,Dong Nai,Bien Hoa City,13,852,780,72,11
2022-05-22,Dong Nai,Bien Hoa City,14,608,545,63,17
2022-05-22,Dong Nai,Bien Hoa City,15,552,492,60,19
2022-05-22,Dong Nai,Bien Hoa City,16,630,551,79,28
2022-05-22,Dong Nai,Bien Hoa City,17,859,626,233,155
2022-05-22,Dong Nai,Bien Hoa City,18,1146,624,522,410
2022-05-22,Dong Nai,Bien Hoa City,19,1376,592,784,639
2022-05-22,Dong Nai,Bien Hoa City,20,624,348,276,198
2022-05-22,Dong Nai,Bien Hoa City,21,201,87,114,59
2022-05-22,Dong Nai,Bien Hoa City,22,2,0,2,0
2022-05-22,Dong Nai,Bien Hoa City,23,1,0,1,0
2022-05-22,Dong Nai,Long Khanh,7,1,0,1,1
2022-05-22,Dong Nai,Long Khanh,8,1,0,1,1
2022-05-22,Dong Nai,Long Thanh,6,1,0,1,1
2022-05-22,Dong Nai,Long Thanh,9,2,0,2,2
2022-05-22,Dong Nai,Long Thanh,10,2,0,2,2
2022-05-22,Dong Nai,Long Thanh,13,1,0,1,0
2022-05-22,Dong Nai,Long Thanh,16,2,0,2,1
2022-05-22,Dong Nai,Long Thanh,17,5,0,5,4
2022-05-22,Dong Nai,Long Thanh,18,2,0,2,2
2022-05-22,Dong Nai,Long Thanh,19,3,0,3,2
2022-05-22,Dong Nai,Long Thanh,20,1,0,1,1
2022-05-22,Dong Nai,Long Thanh,21,1,0,1,1
2022-05-22,Dong Nai,Nhon trach,10,2,0,2,2
2022-05-22,Dong Nai,Nhon trach,11,1,0,1,1
2022-05-22,Dong Nai,Nhon trach,12,1,0,1,1
2022-05-22,Dong Nai,Nhon trach,18,1,0,1,1
2022-05-22,Dong Nai,Nhon trach,19,1,0,1,1
2022-05-22,Dong Nai,Trang Bom,9,2,0,2,2
2022-05-22,Dong Nai,Trang Bom,11,1,1,0,0
2022-05-22,Dong Nai,Trang Bom,13,1,0,1,1
2022-05-22,Dong Nai,Trang Bom,14,1,1,0,0
2022-05-22,Dong Nai,Trang Bom,15,2,0,2,1
2022-05-22,Dong Nai,Trang Bom,19,2,0,2,2
2022-05-22,Hai Phong City,An Duong,8,1,0,1,1
2022-05-22,Hai Phong City,An Duong,10,4,1,3,2
2022-05-22,Hai Phong City,An Duong,11,5,1,4,4
2022-05-22,Hai Phong City,An Duong,12,7,4,3,2
2022-05-22,Hai Phong City,An Duong,13,1,1,0,0
2022-05-22,Hai Phong City,An Duong,14,1,1,0,0
2022-05-22,Hai Phong City,An Duong,15,2,2,0,0
2022-05-22,Hai Phong City,An Duong,16,4,2,2,0
2022-05-22,Hai Phong City,An Duong,17,1,0,1,1
2022-05-22,Hai Phong City,An Duong,19,2,0,2,2
2022-05-22,Hai Phong City,An Duong,20,3,1,2,0
2022-05-22,Hai Phong City,An Duong,21,1,0,1,1
2022-05-22,Hai Phong City,Do Son District,12,1,0,1,1
2022-05-22,Hai Phong City,Do Son District,19,1,0,1,1
2022-05-22,Hai Phong City,Do Son District,20,1,0,1,1
2022-05-22,Hai Phong City,Duong Kinh District,13,2,1,1,1
2022-05-22,Hai Phong City,Hai An District,7,3,1,2,2
2022-05-22,Hai Phong City,Hai An District,8,15,13,2,0
2022-05-22,Hai Phong City,Hai An District,9,15,12,3,1
2022-05-22,Hai Phong City,Hai An District,10,28,23,5,1
2022-05-22,Hai Phong City,Hai An District,11,43,29,14,9
2022-05-22,Hai Phong City,Hai An District,12,19,18,1,0
2022-05-22,Hai Phong City,Hai An District,13,15,13,2,0
2022-05-22,Hai Phong City,Hai An District,14,14,11,3,0
2022-05-22,Hai Phong City,Hai An District,15,10,8,2,2
2022-05-22,Hai Phong City,Hai An District,16,24,17,7,2
2022-05-22,Hai Phong City,Hai An District,17,17,15,2,0
2022-05-22,Hai Phong City,Hai An District,18,27,13,14,5
2022-05-22,Hai Phong City,Hai An District,19,27,10,17,5
2022-05-22,Hai Phong City,Hai An District,20,22,6,16,11
2022-05-22,Hai Phong City,Hai An District,21,11,6,5,3
2022-05-22,Hai Phong City,Hong Bang District,1,1,0,1,1
2022-05-22,Hai Phong City,Hong Bang District,2,1,0,1,0
2022-05-22,Hai Phong City,Hong Bang District,6,1,1,0,0
2022-05-22,Hai Phong City,Hong Bang District,7,9,5,4,2
2022-05-22,Hai Phong City,Hong Bang District,8,46,30,16,10
2022-05-22,Hai Phong City,Hong Bang District,9,41,32,9,5
2022-05-22,Hai Phong City,Hong Bang District,10,105,59,46,29
2022-05-22,Hai Phong City,Hong Bang District,11,145,85,60,39
2022-05-22,Hai Phong City,Hong Bang District,12,68,50,18,13
2022-05-22,Hai Phong City,Hong Bang District,13,29,28,1,0
2022-05-22,Hai Phong City,Hong Bang District,14,46,46,0,0
2022-05-22,Hai Phong City,Hong Bang District,15,53,43,10,4
2022-05-22,Hai Phong City,Hong Bang District,16,42,36,6,2
2022-05-22,Hai Phong City,Hong Bang District,17,46,31,15,9
2022-05-22,Hai Phong City,Hong Bang District,18,75,39,36,24
2022-05-22,Hai Phong City,Hong Bang District,19,67,28,39,28
2022-05-22,Hai Phong City,Hong Bang District,20,46,25,21,14
2022-05-22,Hai Phong City,Hong Bang District,21,8,4,4,3
2022-05-22,Hai Phong City,Kien An District,7,5,1,4,2
2022-05-22,Hai Phong City,Kien An District,8,16,1,15,9
2022-05-22,Hai Phong City,Kien An District,9,16,8,8,5
2022-05-22,Hai Phong City,Kien An District,10,12,8,4,2
2022-05-22,Hai Phong City,Kien An District,11,15,13,2,1
2022-05-22,Hai Phong City,Kien An District,12,4,3,1,1
2022-05-22,Hai Phong City,Kien An District,13,11,5,6,3
2022-05-22,Hai Phong City,Kien An District,14,6,5,1,1
2022-05-22,Hai Phong City,Kien An District,15,9,6,3,1
2022-05-22,Hai Phong City,Kien An District,16,8,5,3,1
2022-05-22,Hai Phong City,Kien An District,17,6,6,0,0
2022-05-22,Hai Phong City,Kien An District,18,11,9,2,2
2022-05-22,Hai Phong City,Kien An District,19,11,5,6,4
2022-05-22,Hai Phong City,Kien An District,20,7,1,6,3
2022-05-22,Hai Phong City,Kien An District,21,3,3,0,0
2022-05-22,Hai Phong City,Le Chan District,0,1,0,1,0
2022-05-22,Hai Phong City,Le Chan District,1,2,0,2,0
2022-05-22,Hai Phong City,Le Chan District,6,4,3,1,0
2022-05-22,Hai Phong City,Le Chan District,7,41,30,11,6
2022-05-22,Hai Phong City,Le Chan District,8,112,72,40,33
2022-05-22,Hai Phong City,Le Chan District,9,167,119,48,30
2022-05-22,Hai Phong City,Le Chan District,10,260,175,85,50
2022-05-22,Hai Phong City,Le Chan District,11,410,267,143,113
2022-05-22,Hai Phong City,Le Chan District,12,261,199,62,31
2022-05-22,Hai Phong City,Le Chan District,13,127,114,13,0
2022-05-22,Hai Phong City,Le Chan District,14,123,108,15,1
2022-05-22,Hai Phong City,Le Chan District,15,210,165,45,15
2022-05-22,Hai Phong City,Le Chan District,16,178,138,40,16
2022-05-22,Hai Phong City,Le Chan District,17,201,161,40,23
2022-05-22,Hai Phong City,Le Chan District,18,266,143,123,86
2022-05-22,Hai Phong City,Le Chan District,19,279,135,144,116
2022-05-22,Hai Phong City,Le Chan District,20,169,98,71,49
2022-05-22,Hai Phong City,Le Chan District,21,52,31,21,11
2022-05-22,Hai Phong City,Le Chan District,22,1,0,1,0
2022-05-22,Hai Phong City,Ngo Quyen District,0,2,2,0,0
2022-05-22,Hai Phong City,Ngo Quyen District,6,1,0,1,0
2022-05-22,Hai Phong City,Ngo Quyen District,7,27,23,4,3
2022-05-22,Hai Phong City,Ngo Quyen District,8,71,46,25,19
2022-05-22,Hai Phong City,Ngo Quyen District,9,124,95,29,13
2022-05-22,Hai Phong City,Ngo Quyen District,10,209,161,48,28
2022-05-22,Hai Phong City,Ngo Quyen District,11,284,195,89,65
2022-05-22,Hai Phong City,Ngo Quyen District,12,174,141,33,16
2022-05-22,Hai Phong City,Ngo Quyen District,13,102,92,10,1
2022-05-22,Hai Phong City,Ngo Quyen District,14,112,96,16,3
2022-05-22,Hai Phong City,Ngo Quyen District,15,157,123,34,17
2022-05-22,Hai Phong City,Ngo Quyen District,16,153,120,33,10
2022-05-22,Hai Phong City,Ngo Quyen District,17,149,126,23,10
2022-05-22,Hai Phong City,Ngo Quyen District,18,212,123,89,59
2022-05-22,Hai Phong City,Ngo Quyen District,19,256,134,122,92
2022-05-22,Hai Phong City,Ngo Quyen District,20,113,68,45,19
2022-05-22,Hai Phong City,Ngo Quyen District,21,39,26,13,6
2022-05-22,Hai Phong City,Thuy Nguyen,10,1,0,1,1
2022-05-22,Hai Phong City,Thuy Nguyen,11,3,0,3,3
2022-05-22,Hai Phong City,Thuy Nguyen,12,5,0,5,4
2022-05-22,Hai Phong City,Thuy Nguyen,14,2,0,2,1
2022-05-22,Hai Phong City,Thuy Nguyen,15,4,0,4,4
2022-05-22,Hai Phong City,Thuy Nguyen,16,1,0,1,1
2022-05-22,Hai Phong City,Thuy Nguyen,19,2,0,2,2
2022-05-22,Hai Phong City,Thuy Nguyen,20,1,0,1,1
2022-05-22,Hue City,Hue City,0,1,0,1,0
2022-05-22,Hue City,Hue City,1,1,0,1,0
2022-05-22,Hue City,Hue City,4,3,3,0,0
2022-05-22,Hue City,Hue City,5,3,3,0,0
2022-05-22,Hue City,Hue City,6,63,52,11,4
2022-05-22,Hue City,Hue City,7,216,194,22,1
2022-05-22,Hue City,Hue City,8,317,292,25,1
2022-05-22,Hue City,Hue City,9,280,265,15,0
2022-05-22,Hue City,Hue City,10,446,411,35,1
2022-05-22,Hue City,Hue City,11,686,636,50,0
2022-05-22,Hue City,Hue City,12,579,534,45,0
2022-05-22,Hue City,Hue City,13,313,291,22,0
2022-05-22,Hue City,Hue City,14,311,283,28,2
2022-05-22,Hue City,Hue City,15,347,328,19,4
2022-05-22,Hue City,Hue City,16,519,447,72,26
2022-05-22,Hue City,Hue City,17,536,484,52,11
2022-05-22,Hue City,Hue City,18,788,542,246,162
2022-05-22,Hue City,Hue City,19,1007,471,536,426
2022-05-22,Hue City,Hue City,20,604,296,308,237
2022-05-22,Hue City,Hue City,21,276,111,165,123
2022-05-22,Hue City,Huong Thuy,6,1,0,1,0
2022-05-22,Hue City,Huong Thuy,11,2,1,1,0
2022-05-22,Hue City,Huong Thuy,12,1,0,1,1
2022-05-22,Hue City,Huong Thuy,13,2,1,1,1
2022-05-22,Hue City,Huong Thuy,14,1,0,1,1
2022-05-22,Hue City,Huong Thuy,15,1,1,0,0
2022-05-22,Hue City,Huong Thuy,17,1,1,0,0
2022-05-22,Hue City,Huong Thuy,18,1,0,1,1
2022-05-22,Hue City,Huong Thuy,19,1,1,0,0
2022-05-22,Hue City,Huong Thuy,20,2,1,1,1
2022-05-22,Hue City,Huong Thuy,21,1,0,1,0
2022-05-22,Hue City,Huong Tra,8,1,1,0,0
2022-05-22,Hue City,Huong Tra,9,1,1,0,0
2022-05-22,Hue City,Huong Tra,10,1,1,0,0
2022-05-22,Hue City,Huong Tra,12,5,0,5,0
2022-05-22,Hue City,Huong Tra,13,1,1,0,0
2022-05-22,Hue City,Huong Tra,20,1,0,1,1
2022-05-22,Hue City,Phu Vang,7,1,1,0,0
2022-05-22,Hue City,Phu Vang,8,3,2,1,1
2022-05-22,Hue City,Phu Vang,9,2,0,2,1
2022-05-22,Hue City,Phu Vang,10,1,1,0,0
2022-05-22,Hue City,Phu Vang,11,1,1,0,0
2022-05-22,Hue City,Phu Vang,12,2,2,0,0
2022-05-22,Hue City,Phu Vang,13,2,2,0,0
2022-05-22,Hue City,Phu Vang,14,1,1,0,0
2022-05-22,Hue City,Phu Vang,15,2,1,1,0
2022-05-22,Hue City,Phu Vang,16,1,1,0,0
2022-05-22,Hue City,Phu Vang,17,2,2,0,0
2022-05-22,Hue City,Phu Vang,18,2,1,1,1
2022-05-22,Hue City,Phu Vang,19,3,0,3,3
2022-05-22,Vung Tau,Ba Ria City,6,1,0,1,1
2022-05-22,Vung Tau,Ba Ria City,7,3,0,3,3
2022-05-22,Vung Tau,Ba Ria City,8,4,0,4,3
2022-05-22,Vung Tau,Ba Ria City,9,10,0,10,6
2022-05-22,Vung Tau,Ba Ria City,10,6,2,4,3
2022-05-22,Vung Tau,Ba Ria City,11,11,5,6,4
2022-05-22,Vung Tau,Ba Ria City,12,2,2,0,0
2022-05-22,Vung Tau,Ba Ria City,13,9,3,6,5
2022-05-22,Vung Tau,Ba Ria City,14,7,3,4,4
2022-05-22,Vung Tau,Ba Ria City,15,10,5,5,5
2022-05-22,Vung Tau,Ba Ria City,16,12,1,11,11
2022-05-22,Vung Tau,Ba Ria City,17,11,4,7,7
2022-05-22,Vung Tau,Ba Ria City,18,16,2,14,14
2022-05-22,Vung Tau,Ba Ria City,19,13,3,10,8
2022-05-22,Vung Tau,Long Dien,16,1,0,1,0
2022-05-22,Vung Tau,Tan Thanh,17,1,0,1,1
2022-05-22,Vung Tau,Vung Tau City,2,4,0,4,0
2022-05-22,Vung Tau,Vung Tau City,5,2,0,2,2
2022-05-22,Vung Tau,Vung Tau City,6,49,36,13,5
2022-05-22,Vung Tau,Vung Tau City,7,125,106,19,5
2022-05-22,Vung Tau,Vung Tau City,8,231,175,56,33
2022-05-22,Vung Tau,Vung Tau City,9,266,232,34,17
2022-05-22,Vung Tau,Vung Tau City,10,301,279,22,4
2022-05-22,Vung Tau,Vung Tau City,11,446,388,58,23
2022-05-22,Vung Tau,Vung Tau City,12,367,338,29,5
2022-05-22,Vung Tau,Vung Tau City,13,264,248,16,5
2022-05-22,Vung Tau,Vung Tau City,14,189,136,53,28
2022-05-22,Vung Tau,Vung Tau City,15,325,255,70,47
2022-05-22,Vung Tau,Vung Tau City,16,335,224,111,79
2022-05-22,Vung Tau,Vung Tau City,17,580,244,336,282
2022-05-22,Vung Tau,Vung Tau City,18,617,214,403,358
2022-05-22,Vung Tau,Vung Tau City,19,550,147,403,353
2022-05-22,Vung Tau,Vung Tau City,20,286,113,173,142
2022-05-22,Vung Tau,Vung Tau City,21,114,52,62,41
2022-05-23,Binh Duong,Ben Cat,10,1,0,1,0
2022-05-23,Binh Duong,Ben Cat,13,1,1,0,0
2022-05-23,Binh Duong,Ben Cat,15,1,0,1,1
2022-05-23,Binh Duong,Ben Cat,18,2,0,2,1
2022-05-23,Binh Duong,Ben Cat,19,1,0,1,1
2022-05-23,Binh Duong,Di An,0,1,0,1,1
2022-05-23,Binh Duong,Di An,4,1,0,1,1
2022-05-23,Binh Duong,Di An,6,1,0,1,0
2022-05-23,Binh Duong,Di An,7,4,0,4,2
2022-05-23,Binh Duong,Di An,8,6,0,6,6
2022-05-23,Binh Duong,Di An,9,20,7,13,11
2022-05-23,Binh Duong,Di An,10,40,15,25,21
2022-05-23,Binh Duong,Di An,11,34,16,18,15
2022-05-23,Binh Duong,Di An,12,27,20,7,5
2022-05-23,Binh Duong,Di An,13,30,14,16,14
2022-05-23,Binh Duong,Di An,14,37,11,26,24
2022-05-23,Binh Duong,Di An,15,22,9,13,11
2022-05-23,Binh Duong,Di An,16,27,14,13,10
2022-05-23,Binh Duong,Di An,17,28,16,12,9
2022-05-23,Binh Duong,Di An,18,28,18,10,8
2022-05-23,Binh Duong,Di An,19,23,18,5,4
2022-05-23,Binh Duong,Di An,20,16,9,7,2
2022-05-23,Binh Duong,Di An,21,6,4,2,1
2022-05-23,Binh Duong,Tan Uyen,7,1,0,1,1
2022-05-23,Binh Duong,Tan Uyen,8,2,1,1,1
2022-05-23,Binh Duong,Tan Uyen,10,1,0,1,0
2022-05-23,Binh Duong,Tan Uyen,11,3,2,1,1
2022-05-23,Binh Duong,Tan Uyen,16,1,1,0,0
2022-05-23,Binh Duong,Tan Uyen,18,3,1,2,1
2022-05-23,Binh Duong,Thu Dau Mot Town,1,1,1,0,0
2022-05-23,Binh Duong,Thu Dau Mot Town,4,1,1,0,0
2022-05-23,Binh Duong,Thu Dau Mot Town,5,1,0,1,1
2022-05-23,Binh Duong,Thu Dau Mot Town,6,20,16,4,3
2022-05-23,Binh Duong,Thu Dau Mot Town,7,125,121,4,1
2022-05-23,Binh Duong,Thu Dau Mot Town,8,187,176,11,3
2022-05-23,Binh Duong,Thu Dau Mot Town,9,191,177,14,3
2022-05-23,Binh Duong,Thu Dau Mot Town,10,337,310,27,5
2022-05-23,Binh Duong,Thu Dau Mot Town,11,590,560,30,6
2022-05-23,Binh Duong,Thu Dau Mot Town,12,444,425,19,0
2022-05-23,Binh Duong,Thu Dau Mot Town,13,409,395,14,2
2022-05-23,Binh Duong,Thu Dau Mot Town,14,273,259,14,1
2022-05-23,Binh Duong,Thu Dau Mot Town,15,255,236,19,3
2022-05-23,Binh Duong,Thu Dau Mot Town,16,250,227,23,5
2022-05-23,Binh Duong,Thu Dau Mot Town,17,357,328,29,3
2022-05-23,Binh Duong,Thu Dau Mot Town,18,369,347,22,5
2022-05-23,Binh Duong,Thu Dau Mot Town,19,303,276,27,1
2022-05-23,Binh Duong,Thu Dau Mot Town,20,263,241,22,6
2022-05-23,Binh Duong,Thu Dau Mot Town,21,107,98,9,4
2022-05-23,Binh Duong,Thu Dau Mot Town,22,1,0,1,0
2022-05-23,Binh Duong,Thuan An,1,1,1,0,0
2022-05-23,Binh Duong,Thuan An,6,9,2,7,7
2022-05-23,Binh Duong,Thuan An,7,6,4,2,2
2022-05-23,Binh Duong,Thuan An,8,15,12,3,2
2022-05-23,Binh Duong,Thuan An,9,29,21,8,5
2022-05-23,Binh Duong,Thuan An,10,50,42,8,4
2022-05-23,Binh Duong,Thuan An,11,61,47,14,7
2022-05-23,Binh Duong,Thuan An,12,66,48,18,8
2022-05-23,Binh Duong,Thuan An,13,73,51,22,17
2022-05-23,Binh Duong,Thuan An,14,52,35,17,12
2022-05-23,Binh Duong,Thuan An,15,31,26,5,3
2022-05-23,Binh Duong,Thuan An,16,27,23,4,2
2022-05-23,Binh Duong,Thuan An,17,36,34,2,2
2022-05-23,Binh Duong,Thuan An,18,37,30,7,2
2022-05-23,Binh Duong,Thuan An,19,34,28,6,3
2022-05-23,Binh Duong,Thuan An,20,36,21,15,12
2022-05-23,Binh Duong,Thuan An,21,29,3,26,20
2022-05-23,Can Tho City,Binh Thuy District,6,1,0,1,1
2022-05-23,Can Tho City,Binh Thuy District,7,3,2,1,1
2022-05-23,Can Tho City,Binh Thuy District,8,5,5,0,0
2022-05-23,Can Tho City,Binh Thuy District,9,7,6,1,0
2022-05-23,Can Tho City,Binh Thuy District,10,5,4,1,0
2022-05-23,Can Tho City,Binh Thuy District,11,15,15,0,0
2022-05-23,Can Tho City,Binh Thuy District,12,11,10,1,0
2022-05-23,Can Tho City,Binh Thuy District,13,9,8,1,1
2022-05-23,Can Tho City,Binh Thuy District,14,8,8,0,0
2022-05-23,Can Tho City,Binh Thuy District,15,8,7,1,1
2022-05-23,Can Tho City,Binh Thuy District,16,8,8,0,0
2022-05-23,Can Tho City,Binh Thuy District,17,11,11,0,0
2022-05-23,Can Tho City,Binh Thuy District,18,7,6,1,0
2022-05-23,Can Tho City,Binh Thuy District,19,17,17,0,0
2022-05-23,Can Tho City,Binh Thuy District,20,7,7,0,0
2022-05-23,Can Tho City,Binh Thuy District,21,3,1,2,0
2022-05-23,Can Tho City,Cai Rang District,6,1,1,0,0
2022-05-23,Can Tho City,Cai Rang District,7,8,4,4,3
2022-05-23,Can Tho City,Cai Rang District,8,12,6,6,5
2022-05-23,Can Tho City,Cai Rang District,9,5,5,0,0
2022-05-23,Can Tho City,Cai Rang District,10,16,13,3,2
2022-05-23,Can Tho City,Cai Rang District,11,13,12,1,0
2022-05-23,Can Tho City,Cai Rang District,12,8,6,2,0
2022-05-23,Can Tho City,Cai Rang District,13,7,7,0,0
2022-05-23,Can Tho City,Cai Rang District,14,9,8,1,0
2022-05-23,Can Tho City,Cai Rang District,15,8,5,3,0
2022-05-23,Can Tho City,Cai Rang District,16,14,12,2,1
2022-05-23,Can Tho City,Cai Rang District,17,11,9,2,2
2022-05-23,Can Tho City,Cai Rang District,18,8,7,1,0
2022-05-23,Can Tho City,Cai Rang District,19,12,9,3,0
2022-05-23,Can Tho City,Cai Rang District,20,10,9,1,1
2022-05-23,Can Tho City,Cai Rang District,21,5,4,1,0
2022-05-23,Can Tho City,Ninh Kieu District,0,1,0,1,0
2022-05-23,Can Tho City,Ninh Kieu District,1,1,0,1,0
2022-05-23,Can Tho City,Ninh Kieu District,4,1,1,0,0
2022-05-23,Can Tho City,Ninh Kieu District,5,5,1,4,2
2022-05-23,Can Tho City,Ninh Kieu District,6,56,45,11,5
2022-05-23,Can Tho City,Ninh Kieu District,7,121,111,10,0
2022-05-23,Can Tho City,Ninh Kieu District,8,245,227,18,0
2022-05-23,Can Tho City,Ninh Kieu District,9,291,269,22,1
2022-05-23,Can Tho City,Ninh Kieu District,10,470,444,26,0
2022-05-23,Can Tho City,Ninh Kieu District,11,782,741,41,7
2022-05-23,Can Tho City,Ninh Kieu District,12,576,553,23,0
2022-05-23,Can Tho City,Ninh Kieu District,13,447,424,23,0
2022-05-23,Can Tho City,Ninh Kieu District,14,410,391,19,0
2022-05-23,Can Tho City,Ninh Kieu District,15,355,331,24,0
2022-05-23,Can Tho City,Ninh Kieu District,16,498,465,33,0
2022-05-23,Can Tho City,Ninh Kieu District,17,519,494,25,0
2022-05-23,Can Tho City,Ninh Kieu District,18,580,557,23,0
2022-05-23,Can Tho City,Ninh Kieu District,19,471,447,24,0
2022-05-23,Can Tho City,Ninh Kieu District,20,395,377,18,0
2022-05-23,Can Tho City,Ninh Kieu District,21,226,204,22,3
2022-05-23,Can Tho City,Ninh Kieu District,22,2,1,1,0
2022-05-23,Can Tho City,Ninh Kieu District,23,2,0,2,0
2022-05-23,Can Tho City,O Mon District,12,2,0,2,1
2022-05-23,Dong Nai,Bien Hoa City,1,1,0,1,0
2022-05-23,Dong Nai,Bien Hoa City,2,1,0,1,0
2022-05-23,Dong Nai,Bien Hoa City,3,1,1,0,0
2022-05-23,Dong Nai,Bien Hoa City,5,2,2,0,0
2022-05-23,Dong Nai,Bien Hoa City,6,29,19,10,7
2022-05-23,Dong Nai,Bien Hoa City,7,149,111,38,28
2022-05-23,Dong Nai,Bien Hoa City,8,314,268,46,13
2022-05-23,Dong Nai,Bien Hoa City,9,369,331,38,9
2022-05-23,Dong Nai,Bien Hoa City,10,723,631,92,24
2022-05-23,Dong Nai,Bien Hoa City,11,1075,968,107,42
2022-05-23,Dong Nai,Bien Hoa City,12,872,809,63,17
2022-05-23,Dong Nai,Bien Hoa City,13,774,724,50,12
2022-05-23,Dong Nai,Bien Hoa City,14,633,565,68,19
2022-05-23,Dong Nai,Bien Hoa City,15,443,406,37,6
2022-05-23,Dong Nai,Bien Hoa City,16,499,457,42,4
2022-05-23,Dong Nai,Bien Hoa City,17,565,515,50,7
2022-05-23,Dong Nai,Bien Hoa City,18,653,605,48,8
2022-05-23,Dong Nai,Bien Hoa City,19,650,590,60,14
2022-05-23,Dong Nai,Bien Hoa City,20,475,399,76,31
2022-05-23,Dong Nai,Bien Hoa City,21,212,153,59,22
2022-05-23,Dong Nai,Bien Hoa City,22,3,0,3,0
2022-05-23,Dong Nai,Long Khanh,11,1,0,1,1
2022-05-23,Dong Nai,Long Khanh,15,1,0,1,1
2022-05-23,Dong Nai,Long Khanh,17,1,0,1,1
2022-05-23,Dong Nai,Long Thanh,9,3,0,3,2
2022-05-23,Dong Nai,Long Thanh,10,4,0,4,3
2022-05-23,Dong Nai,Long Thanh,13,3,0,3,2
2022-05-23,Dong Nai,Long Thanh,14,1,0,1,1
2022-05-23,Dong Nai,Long Thanh,16,2,0,2,2
2022-05-23,Dong Nai,Long Thanh,17,1,0,1,1
2022-05-23,Dong Nai,Long Thanh,19,1,0,1,1
2022-05-23,Dong Nai,Nhon trach,13,1,0,1,1
2022-05-23,Dong Nai,Nhon trach,19,5,0,5,4
2022-05-23,Dong Nai,Nhon trach,20,2,0,2,2
2022-05-23,Dong Nai,Trang Bom,9,1,0,1,1
2022-05-23,Dong Nai,Trang Bom,10,1,0,1,1
2022-05-23,Dong Nai,Trang Bom,12,2,1,1,1
2022-05-23,Dong Nai,Trang Bom,14,1,0,1,1
2022-05-23,Hai Phong City,An Duong,7,2,0,2,1
2022-05-23,Hai Phong City,An Duong,8,3,0,3,3
2022-05-23,Hai Phong City,An Duong,9,3,1,2,2
2022-05-23,Hai Phong City,An Duong,10,1,0,1,0
2022-05-23,Hai Phong City,An Duong,11,4,3,1,1
2022-05-23,Hai Phong City,An Duong,12,10,4,6,5
2022-05-23,Hai Phong City,An Duong,13,5,2,3,2
2022-05-23,Hai Phong City,An Duong,14,5,1,4,3
2022-05-23,Hai Phong City,An Duong,15,3,2,1,1
2022-05-23,Hai Phong City,An Duong,17,3,2,1,1
2022-05-23,Hai Phong City,An Duong,18,1,1,0,0
2022-05-23,Hai Phong City,An Duong,19,1,0,1,0
2022-05-23,Hai Phong City,An Duong,20,3,0,3,2
2022-05-23,Hai Phong City,An Duong,21,4,0,4,2
2022-05-23,Hai Phong City,An Duong,22,1,0,1,0
2022-05-23,Hai Phong City,Do Son District,9,1,0,1,1
2022-05-23,Hai Phong City,Do Son District,14,1,0,1,1
2022-05-23,Hai Phong City,Duong Kinh District,13,2,0,2,2
2022-05-23,Hai Phong City,Duong Kinh District,20,1,0,1,1
2022-05-23,Hai Phong City,Hai An District,6,1,0,1,0
2022-05-23,Hai Phong City,Hai An District,7,6,2,4,2
2022-05-23,Hai Phong City,Hai An District,8,14,7,7,4
2022-05-23,Hai Phong City,Hai An District,9,16,15,1,0
2022-05-23,Hai Phong City,Hai An District,10,17,15,2,0
2022-05-23,Hai Phong City,Hai An District,11,55,42,13,9
2022-05-23,Hai Phong City,Hai An District,12,24,20,4,1
2022-05-23,Hai Phong City,Hai An District,13,21,17,4,1
2022-05-23,Hai Phong City,Hai An District,14,18,15,3,1
2022-05-23,Hai Phong City,Hai An District,15,17,16,1,0
2022-05-23,Hai Phong City,Hai An District,16,14,14,0,0
2022-05-23,Hai Phong City,Hai An District,17,12,11,1,1
2022-05-23,Hai Phong City,Hai An District,18,20,15,5,0
2022-05-23,Hai Phong City,Hai An District,19,28,17,11,7
2022-05-23,Hai Phong City,Hai An District,20,13,11,2,0
2022-05-23,Hai Phong City,Hai An District,21,9,6,3,2
2022-05-23,Hai Phong City,Hong Bang District,3,1,0,1,0
2022-05-23,Hai Phong City,Hong Bang District,7,8,4,4,3
2022-05-23,Hai Phong City,Hong Bang District,8,30,22,8,7
2022-05-23,Hai Phong City,Hong Bang District,9,18,14,4,1
2022-05-23,Hai Phong City,Hong Bang District,10,49,40,9,1
2022-05-23,Hai Phong City,Hong Bang District,11,91,83,8,2
2022-05-23,Hai Phong City,Hong Bang District,12,51,41,10,3
2022-05-23,Hai Phong City,Hong Bang District,13,32,23,9,8
2022-05-23,Hai Phong City,Hong Bang District,14,45,33,12,8
2022-05-23,Hai Phong City,Hong Bang District,15,42,34,8,7
2022-05-23,Hai Phong City,Hong Bang District,16,40,37,3,1
2022-05-23,Hai Phong City,Hong Bang District,17,24,20,4,0
2022-05-23,Hai Phong City,Hong Bang District,18,54,46,8,2
2022-05-23,Hai Phong City,Hong Bang District,19,49,43,6,2
2022-05-23,Hai Phong City,Hong Bang District,20,34,21,13,4
2022-05-23,Hai Phong City,Hong Bang District,21,18,12,6,2
2022-05-23,Hai Phong City,Kien An District,8,6,1,5,4
2022-05-23,Hai Phong City,Kien An District,9,7,5,2,2
2022-05-23,Hai Phong City,Kien An District,10,6,4,2,0
2022-05-23,Hai Phong City,Kien An District,11,5,2,3,0
2022-05-23,Hai Phong City,Kien An District,12,8,8,0,0
2022-05-23,Hai Phong City,Kien An District,13,6,2,4,4
2022-05-23,Hai Phong City,Kien An District,14,10,6,4,3
2022-05-23,Hai Phong City,Kien An District,15,6,2,4,4
2022-05-23,Hai Phong City,Kien An District,16,3,3,0,0
2022-05-23,Hai Phong City,Kien An District,17,13,5,8,5
2022-05-23,Hai Phong City,Kien An District,18,3,2,1,1
2022-05-23,Hai Phong City,Kien An District,19,7,6,1,1
2022-05-23,Hai Phong City,Kien An District,20,11,5,6,4
2022-05-23,Hai Phong City,Kien An District,21,6,0,6,4
2022-05-23,Hai Phong City,Le Chan District,0,1,1,0,0
2022-05-23,Hai Phong City,Le Chan District,1,1,0,1,1
2022-05-23,Hai Phong City,Le Chan District,2,2,2,0,0
2022-05-23,Hai Phong City,Le Chan District,6,1,1,0,0
2022-05-23,Hai Phong City,Le Chan District,7,32,15,17,13
2022-05-23,Hai Phong City,Le Chan District,8,80,57,23,15
2022-05-23,Hai Phong City,Le Chan District,9,65,57,8,1
2022-05-23,Hai Phong City,Le Chan District,10,152,128,24,0
2022-05-23,Hai Phong City,Le Chan District,11,248,228,20,6
2022-05-23,Hai Phong City,Le Chan District,12,185,168,17,1
2022-05-23,Hai Phong City,Le Chan District,13,123,111,12,5
2022-05-23,Hai Phong City,Le Chan District,14,146,129,17,7
2022-05-23,Hai Phong City,Le Chan District,15,179,146,33,14
2022-05-23,Hai Phong City,Le Chan District,16,147,136,11,0
2022-05-23,Hai Phong City,Le Chan District,17,141,128,13,2
2022-05-23,Hai Phong City,Le Chan District,18,192,172,20,2
2022-05-23,Hai Phong City,Le Chan District,19,161,139,22,5
2022-05-23,Hai Phong City,Le Chan District,20,118,101,17,4
2022-05-23,Hai Phong City,Le Chan District,21,63,53,10,5
2022-05-23,Hai Phong City,Ngo Quyen District,4,1,1,0,0
2022-05-23,Hai Phong City,Ngo Quyen District,7,31,19,12,10
2022-05-23,Hai Phong City,Ngo Quyen District,8,72,54,18,8
2022-05-23,Hai Phong City,Ngo Quyen District,9,71,64,7,0
2022-05-23,Hai Phong City,Ngo Quyen District,10,107,97,10,1
2022-05-23,Hai Phong City,Ngo Quyen District,11,207,177,30,11
2022-05-23,Hai Phong City,Ngo Quyen District,12,131,117,14,0
2022-05-23,Hai Phong City,Ngo Quyen District,13,96,78,18,7
2022-05-23,Hai Phong City,Ngo Quyen District,14,130,109,21,10
2022-05-23,Hai Phong City,Ngo Quyen District,15,121,106,15,2
2022-05-23,Hai Phong City,Ngo Quyen District,16,80,72,8,2
2022-05-23,Hai Phong City,Ngo Quyen District,17,99,86,13,1
2022-05-23,Hai Phong City,Ngo Quyen District,18,134,122,12,4
2022-05-23,Hai Phong City,Ngo Quyen District,19,112,103,9,2
2022-05-23,Hai Phong City,Ngo Quyen District,20,108,94,14,1
2022-05-23,Hai Phong City,Ngo Quyen District,21,46,33,13,3
2022-05-23,Hai Phong City,Thuy Nguyen,10,1,0,1,1
2022-05-23,Hai Phong City,Thuy Nguyen,11,1,0,1,1
2022-05-23,Hai Phong City,Thuy Nguyen,12,2,0,2,2
2022-05-23,Hai Phong City,Thuy Nguyen,13,1,0,1,1
2022-05-23,Hai Phong City,Thuy Nguyen,16,2,0,2,1
2022-05-23,Hai Phong City,Thuy Nguyen,18,1,0,1,1
2022-05-23,Hai Phong City,Thuy Nguyen,20,1,0,1,1
2022-05-23,Hue City,Hue City,0,4,1,3,0
2022-05-23,Hue City,Hue City,1,2,1,1,0
2022-05-23,Hue City,Hue City,3,1,1,0,0
2022-05-23,Hue City,Hue City,5,3,3,0,0
2022-05-23,Hue City,Hue City,6,62,51,11,6
2022-05-23,Hue City,Hue City,7,200,180,20,3
2022-05-23,Hue City,Hue City,8,269,248,21,0
2022-05-23,Hue City,Hue City,9,280,257,23,0
2022-05-23,Hue City,Hue City,10,406,373,33,1
2022-05-23,Hue City,Hue City,11,812,750,62,14
2022-05-23,Hue City,Hue City,12,524,487,37,3
2022-05-23,Hue City,Hue City,13,304,277,27,0
2022-05-23,Hue City,Hue City,14,345,313,32,4
2022-05-23,Hue City,Hue City,15,373,355,18,0
2022-05-23,Hue City,Hue City,16,283,262,21,1
2022-05-23,Hue City,Hue City,17,378,358,20,2
2022-05-23,Hue City,Hue City,18,513,478,35,2
2022-05-23,Hue City,Hue City,19,487,458,29,0
2022-05-23,Hue City,Hue City,20,374,329,45,2
2022-05-23,Hue City,Hue City,21,216,192,24,3
2022-05-23,Hue City,Hue City,22,1,0,1,0
2022-05-23,Hue City,Hue City,23,2,0,2,0
2022-05-23,Hue City,Huong Thuy,11,1,1,0,0
2022-05-23,Hue City,Huong Thuy,15,1,1,0,0
2022-05-23,Hue City,Huong Thuy,17,1,1,0,0
2022-05-23,Hue City,Huong Thuy,20,1,1,0,0
2022-05-23,Hue City,Huong Thuy,21,1,1,0,0
2022-05-23,Hue City,Huong Tra,15,1,1,0,0
2022-05-23,Hue City,Huong Tra,17,1,0,1,0
2022-05-23,Hue City,Huong Tra,18,1,1,0,0
2022-05-23,Hue City,Huong Tra,21,1,1,0,0
2022-05-23,Hue City,Phu Vang,6,1,0,1,1
2022-05-23,Hue City,Phu Vang,8,3,3,0,0
2022-05-23,Hue City,Phu Vang,11,1,1,0,0
2022-05-23,Hue City,Phu Vang,12,2,2,0,0
2022-05-23,Hue City,Phu Vang,16,1,1,0,0
2022-05-23,Hue City,Phu Vang,18,4,2,2,1
2022-05-23,Hue City,Phu Vang,19,2,2,0,0
2022-05-23,Hue City,Phu Vang,20,1,0,1,0
2022-05-23,Hue City,Phu Vang,21,2,1,1,0
2022-05-23,Vung Tau,Ba Ria City,8,2,0,2,2
2022-05-23,Vung Tau,Ba Ria City,9,7,2,5,4
2022-05-23,Vung Tau,Ba Ria City,10,4,1,3,1
2022-05-23,Vung Tau,Ba Ria City,11,10,5,5,5
2022-05-23,Vung Tau,Ba Ria City,12,7,1,6,6
2022-05-23,Vung Tau,Ba Ria City,13,5,2,3,3
2022-05-23,Vung Tau,Ba Ria City,14,8,3,5,5
2022-05-23,Vung Tau,Ba Ria City,15,4,1,3,3
2022-05-23,Vung Tau,Ba Ria City,16,3,0,3,3
2022-05-23,Vung Tau,Ba Ria City,17,4,0,4,4
2022-05-23,Vung Tau,Ba Ria City,18,11,0,11,10
2022-05-23,Vung Tau,Ba Ria City,19,8,0,8,8
2022-05-23,Vung Tau,Ba Ria City,20,4,0,4,4
2022-05-23,Vung Tau,Vung Tau City,1,4,2,2,0
2022-05-23,Vung Tau,Vung Tau City,5,6,4,2,2
2022-05-23,Vung Tau,Vung Tau City,6,38,27,11,7
2022-05-23,Vung Tau,Vung Tau City,7,125,110,15,10
2022-05-23,Vung Tau,Vung Tau City,8,140,123,17,9
2022-05-23,Vung Tau,Vung Tau City,9,114,108,6,1
2022-05-23,Vung Tau,Vung Tau City,10,190,175,15,2
2022-05-23,Vung Tau,Vung Tau City,11,359,328,31,6
2022-05-23,Vung Tau,Vung Tau City,12,293,273,20,1
2022-05-23,Vung Tau,Vung Tau City,13,197,188,9,0
2022-05-23,Vung Tau,Vung Tau City,14,214,203,11,4
2022-05-23,Vung Tau,Vung Tau City,15,189,173,16,7
2022-05-23,Vung Tau,Vung Tau City,16,179,167,12,0
2022-05-23,Vung Tau,Vung Tau City,17,226,207,19,5
2022-05-23,Vung Tau,Vung Tau City,18,230,209,21,6
2022-05-23,Vung Tau,Vung Tau City,19,247,227,20,2
2022-05-23,Vung Tau,Vung Tau City,20,200,173,27,9
2022-05-23,Vung Tau,Vung Tau City,21,102,80,22,12
2022-05-23,Vung Tau,Vung Tau City,23,1,0,1,1
2022-05-24,Binh Duong,Ben Cat,13,1,0,1,1
2022-05-24,Binh Duong,Ben Cat,14,1,0,1,1
2022-05-24,Binh Duong,Ben Cat,15,1,0,1,1
2022-05-24,Binh Duong,Ben Cat,19,1,0,1,1
2022-05-24,Binh Duong,Di An,7,5,0,5,5
2022-05-24,Binh Duong,Di An,8,16,5,11,10
2022-05-24,Binh Duong,Di An,9,13,9,4,4
2022-05-24,Binh Duong,Di An,10,18,14,4,2
2022-05-24,Binh Duong,Di An,11,36,18,18,13
2022-05-24,Binh Duong,Di An,12,32,23,9,6
2022-05-24,Binh Duong,Di An,13,30,20,10,7
2022-05-24,Binh Duong,Di An,14,24,18,6,5
2022-05-24,Binh Duong,Di An,15,38,15,23,19
2022-05-24,Binh Duong,Di An,16,31,21,10,4
2022-05-24,Binh Duong,Di An,17,25,14,11,7
2022-05-24,Binh Duong,Di An,18,22,15,7,5
2022-05-24,Binh Duong,Di An,19,22,12,10,6
2022-05-24,Binh Duong,Di An,20,5,2,3,2
2022-05-24,Binh Duong,Di An,21,5,2,3,2
2022-05-24,Binh Duong,Phu Giao,13,1,0,1,0
2022-05-24,Binh Duong,Tan Uyen,9,1,0,1,1
2022-05-24,Binh Duong,Tan Uyen,11,3,3,0,0
2022-05-24,Binh Duong,Tan Uyen,12,1,0,1,0
2022-05-24,Binh Duong,Tan Uyen,13,1,0,1,1
2022-05-24,Binh Duong,Tan Uyen,16,2,1,1,1
2022-05-24,Binh Duong,Tan Uyen,17,1,0,1,1
2022-05-24,Binh Duong,Tan Uyen,18,1,1,0,0
2022-05-24,Binh Duong,Thu Dau Mot Town,2,2,2,0,0
2022-05-24,Binh Duong,Thu Dau Mot Town,5,1,1,0,0
2022-05-24,Binh Duong,Thu Dau Mot Town,6,35,31,4,2
2022-05-24,Binh Duong,Thu Dau Mot Town,7,125,114,11,3
2022-05-24,Binh Duong,Thu Dau Mot Town,8,204,191,13,3
2022-05-24,Binh Duong,Thu Dau Mot Town,9,251,232,19,3
2022-05-24,Binh Duong,Thu Dau Mot Town,10,365,341,24,0
2022-05-24,Binh Duong,Thu Dau Mot Town,11,623,589,34,7
2022-05-24,Binh Duong,Thu Dau Mot Town,12,410,386,24,3
2022-05-24,Binh Duong,Thu Dau Mot Town,13,426,396,30,1
2022-05-24,Binh Duong,Thu Dau Mot Town,14,323,310,13,3
2022-05-24,Binh Duong,Thu Dau Mot Town,15,313,284,29,3
2022-05-24,Binh Duong,Thu Dau Mot Town,16,266,257,9,2
2022-05-24,Binh Duong,Thu Dau Mot Town,17,328,316,12,0
2022-05-24,Binh Duong,Thu Dau Mot Town,18,386,372,14,1
2022-05-24,Binh Duong,Thu Dau Mot Town,19,334,315,19,0
2022-05-24,Binh Duong,Thu Dau Mot Town,20,262,247,15,2
2022-05-24,Binh Duong,Thu Dau Mot Town,21,108,97,11,1
2022-05-24,Binh Duong,Thu Dau Mot Town,22,1,0,1,0
2022-05-24,Binh Duong,Thuan An,6,3,1,2,2
2022-05-24,Binh Duong,Thuan An,7,6,2,4,4
2022-05-24,Binh Duong,Thuan An,8,13,7,6,5
2022-05-24,Binh Duong,Thuan An,9,35,29,6,5
2022-05-24,Binh Duong,Thuan An,10,64,49,15,10
2022-05-24,Binh Duong,Thuan An,11,71,58,13,8
2022-05-24,Binh Duong,Thuan An,12,64,58,6,5
2022-05-24,Binh Duong,Thuan An,13,61,44,17,14
2022-05-24,Binh Duong,Thuan An,14,51,38,13,12
2022-05-24,Binh Duong,Thuan An,15,36,32,4,2
2022-05-24,Binh Duong,Thuan An,16,30,25,5,2
2022-05-24,Binh Duong,Thuan An,17,44,36,8,4
2022-05-24,Binh Duong,Thuan An,18,46,39,7,4
2022-05-24,Binh Duong,Thuan An,19,44,34,10,4
2022-05-24,Binh Duong,Thuan An,20,34,24,10,5
2022-05-24,Binh Duong,Thuan An,21,15,8,7,5
2022-05-24,Can Tho City,Binh Thuy District,6,2,2,0,0
2022-05-24,Can Tho City,Binh Thuy District,8,2,1,1,0
2022-05-24,Can Tho City,Binh Thuy District,9,5,5,0,0
2022-05-24,Can Tho City,Binh Thuy District,10,3,3,0,0
2022-05-24,Can Tho City,Binh Thuy District,11,12,11,1,0
2022-05-24,Can Tho City,Binh Thuy District,12,8,7,1,0
2022-05-24,Can Tho City,Binh Thuy District,13,16,13,3,0
2022-05-24,Can Tho City,Binh Thuy District,14,14,14,0,0
2022-05-24,Can Tho City,Binh Thuy District,15,15,12,3,2
2022-05-24,Can Tho City,Binh Thuy District,16,6,5,1,0
2022-05-24,Can Tho City,Binh Thuy District,17,12,10,2,0
2022-05-24,Can Tho City,Binh Thuy District,18,13,12,1,0
2022-05-24,Can Tho City,Binh Thuy District,19,18,16,2,0
2022-05-24,Can Tho City,Binh Thuy District,20,9,9,0,0
2022-05-24,Can Tho City,Binh Thuy District,21,5,3,2,2
2022-05-24,Can Tho City,Cai Rang District,6,3,2,1,1
2022-05-24,Can Tho City,Cai Rang District,7,3,3,0,0
2022-05-24,Can Tho City,Cai Rang District,8,11,8,3,3
2022-05-24,Can Tho City,Cai Rang District,9,16,13,3,2
2022-05-24,Can Tho City,Cai Rang District,10,10,9,1,0
2022-05-24,Can Tho City,Cai Rang District,11,3,3,0,0
2022-05-24,Can Tho City,Cai Rang District,12,16,13,3,2
2022-05-24,Can Tho City,Cai Rang District,13,8,8,0,0
2022-05-24,Can Tho City,Cai Rang District,14,11,10,1,0
2022-05-24,Can Tho City,Cai Rang District,15,12,11,1,1
2022-05-24,Can Tho City,Cai Rang District,16,11,8,3,1
2022-05-24,Can Tho City,Cai Rang District,17,16,14,2,0
2022-05-24,Can Tho City,Cai Rang District,18,8,8,0,0
2022-05-24,Can Tho City,Cai Rang District,19,7,7,0,0
2022-05-24,Can Tho City,Cai Rang District,20,6,6,0,0
2022-05-24,Can Tho City,Cai Rang District,21,1,1,0,0
2022-05-24,Can Tho City,Ninh Kieu District,0,2,0,2,0
2022-05-24,Can Tho City,Ninh Kieu District,1,2,1,1,0
2022-05-24,Can Tho City,Ninh Kieu District,2,2,2,0,0
2022-05-24,Can Tho City,Ninh Kieu District,4,1,1,0,0
2022-05-24,Can Tho City,Ninh Kieu District,5,2,2,0,0
2022-05-24,Can Tho City,Ninh Kieu District,6,53,46,7,1
2022-05-24,Can Tho City,Ninh Kieu District,7,134,128,6,0
2022-05-24,Can Tho City,Ninh Kieu District,8,208,195,13,0
2022-05-24,Can Tho City,Ninh Kieu District,9,292,274,18,0
2022-05-24,Can Tho City,Ninh Kieu District,10,523,497,26,0
2022-05-24,Can Tho City,Ninh Kieu District,11,832,788,44,5
2022-05-24,Can Tho City,Ninh Kieu District,12,614,587,27,0
2022-05-24,Can Tho City,Ninh Kieu District,13,495,464,31,0
2022-05-24,Can Tho City,Ninh Kieu District,14,407,391,16,0
2022-05-24,Can Tho City,Ninh Kieu District,15,362,335,27,1
2022-05-24,Can Tho City,Ninh Kieu District,16,432,416,16,0
2022-05-24,Can Tho City,Ninh Kieu District,17,490,477,13,0
2022-05-24,Can Tho City,Ninh Kieu District,18,539,511,28,0
2022-05-24,Can Tho City,Ninh Kieu District,19,468,446,22,0
2022-05-24,Can Tho City,Ninh Kieu District,20,401,382,19,0
2022-05-24,Can Tho City,Ninh Kieu District,21,196,176,20,0
2022-05-24,Can Tho City,Ninh Kieu District,22,1,1,0,0
2022-05-24,Can Tho City,O Mon District,18,1,0,1,1
2022-05-24,Can Tho City,Thoi Lai,12,1,0,1,1
2022-05-24,Dong Nai,Bien Hoa City,0,1,1,0,0
2022-05-24,Dong Nai,Bien Hoa City,1,1,1,0,0
2022-05-24,Dong Nai,Bien Hoa City,4,1,1,0,0
2022-05-24,Dong Nai,Bien Hoa City,5,3,2,1,0
2022-05-24,Dong Nai,Bien Hoa City,6,36,23,13,10
2022-05-24,Dong Nai,Bien Hoa City,7,145,120,25,5
2022-05-24,Dong Nai,Bien Hoa City,8,304,269,35,6
2022-05-24,Dong Nai,Bien Hoa City,9,447,404,43,4
2022-05-24,Dong Nai,Bien Hoa City,10,704,652,52,11
2022-05-24,Dong Nai,Bien Hoa City,11,1139,1046,93,17
2022-05-24,Dong Nai,Bien Hoa City,12,847,785,62,6
2022-05-24,Dong Nai,Bien Hoa City,13,819,764,55,11
2022-05-24,Dong Nai,Bien Hoa City,14,667,602,65,12
2022-05-24,Dong Nai,Bien Hoa City,15,520,475,45,9
2022-05-24,Dong Nai,Bien Hoa City,16,498,461,37,7
2022-05-24,Dong Nai,Bien Hoa City,17,569,527,42,8
2022-05-24,Dong Nai,Bien Hoa City,18,632,590,42,8
2022-05-24,Dong Nai,Bien Hoa City,19,680,632,48,10
2022-05-24,Dong Nai,Bien Hoa City,20,474,411,63,14
2022-05-24,Dong Nai,Bien Hoa City,21,232,172,60,22
2022-05-24,Dong Nai,Bien Hoa City,22,2,0,2,0
2022-05-24,Dong Nai,Long Khanh,14,1,0,1,1
2022-05-24,Dong Nai,Long Thanh,11,4,0,4,4
2022-05-24,Dong Nai,Long Thanh,13,1,0,1,1
2022-05-24,Dong Nai,Long Thanh,14,1,0,1,1
2022-05-24,Dong Nai,Long Thanh,16,2,0,2,2
2022-05-24,Dong Nai,Long Thanh,19,2,0,2,2
2022-05-24,Dong Nai,Long Thanh,20,3,0,3,2
2022-05-24,Dong Nai,Nhon trach,16,1,0,1,1
2022-05-24,Dong Nai,Nhon trach,17,1,0,1,1
2022-05-24,Dong Nai,Trang Bom,10,1,0,1,1
2022-05-24,Dong Nai,Trang Bom,14,1,0,1,1
2022-05-24,Dong Nai,Trang Bom,19,1,0,1,1
2022-05-24,Dong Nai,Trang Bom,21,2,0,2,1
2022-05-24,Hai Phong City,An Duong,1,1,0,1,1
2022-05-24,Hai Phong City,An Duong,7,1,1,0,0
2022-05-24,Hai Phong City,An Duong,8,3,1,2,2
2022-05-24,Hai Phong City,An Duong,9,4,0,4,2
2022-05-24,Hai Phong City,An Duong,10,3,2,1,0
2022-05-24,Hai Phong City,An Duong,11,4,1,3,3
2022-05-24,Hai Phong City,An Duong,12,1,1,0,0
2022-05-24,Hai Phong City,An Duong,13,2,0,2,1
2022-05-24,Hai Phong City,An Duong,14,4,1,3,2
2022-05-24,Hai Phong City,An Duong,15,1,0,1,1
2022-05-24,Hai Phong City,An Duong,16,1,1,0,0
2022-05-24,Hai Phong City,An Duong,17,1,1,0,0
2022-05-24,Hai Phong City,An Duong,18,1,1,0,0
2022-05-24,Hai Phong City,An Duong,19,1,0,1,1
2022-05-24,Hai Phong City,An Duong,20,2,0,2,2
2022-05-24,Hai Phong City,An Duong,21,2,1,1,1
2022-05-24,Hai Phong City,Do Son District,21,1,0,1,1
2022-05-24,Hai Phong City,Hai An District,7,4,4,0,0
2022-05-24,Hai Phong City,Hai An District,8,13,9,4,2
2022-05-24,Hai Phong City,Hai An District,9,13,13,0,0
2022-05-24,Hai Phong City,Hai An District,10,28,24,4,1
2022-05-24,Hai Phong City,Hai An District,11,40,36,4,3
2022-05-24,Hai Phong City,Hai An District,12,24,22,2,0
2022-05-24,Hai Phong City,Hai An District,13,22,16,6,1
2022-05-24,Hai Phong City,Hai An District,14,12,9,3,0
2022-05-24,Hai Phong City,Hai An District,15,12,12,0,0
2022-05-24,Hai Phong City,Hai An District,16,19,17,2,2
2022-05-24,Hai Phong City,Hai An District,17,14,11,3,1
2022-05-24,Hai Phong City,Hai An District,18,25,23,2,1
2022-05-24,Hai Phong City,Hai An District,19,21,16,5,5
2022-05-24,Hai Phong City,Hai An District,20,26,13,13,8
2022-05-24,Hai Phong City,Hai An District,21,5,4,1,0
2022-05-24,Hai Phong City,Hai An District,22,1,0,1,0
2022-05-24,Hai Phong City,Hong Bang District,7,21,13,8,7
2022-05-24,Hai Phong City,Hong Bang District,8,38,32,6,3
2022-05-24,Hai Phong City,Hong Bang District,9,26,22,4,1
2022-05-24,Hai Phong City,Hong Bang District,10,58,53,5,0
2022-05-24,Hai Phong City,Hong Bang District,11,97,90,7,1
2022-05-24,Hai Phong City,Hong Bang District,12,39,37,2,1
2022-05-24,Hai Phong City,Hong Bang District,13,30,26,4,2
2022-05-24,Hai Phong City,Hong Bang District,14,44,24,20,15
2022-05-24,Hai Phong City,Hong Bang District,15,45,36,9,6
2022-05-24,Hai Phong City,Hong Bang District,16,42,36,6,1
2022-05-24,Hai Phong City,Hong Bang District,17,46,38,8,1
2022-05-24,Hai Phong City,Hong Bang District,18,64,45,19,9
2022-05-24,Hai Phong City,Hong Bang District,19,68,37,31,20
2022-05-24,Hai Phong City,Hong Bang District,20,65,25,40,26
2022-05-24,Hai Phong City,Hong Bang District,21,15,11,4,1
2022-05-24,Hai Phong City,Kien An District,6,1,0,1,0
2022-05-24,Hai Phong City,Kien An District,8,6,1,5,5
2022-05-24,Hai Phong City,Kien An District,9,15,6,9,8
2022-05-24,Hai Phong City,Kien An District,10,12,5,7,6
2022-05-24,Hai Phong City,Kien An District,11,5,3,2,1
2022-05-24,Hai Phong City,Kien An District,12,9,6,3,2
2022-05-24,Hai Phong City,Kien An District,13,7,2,5,1
2022-05-24,Hai Phong City,Kien An District,14,7,1,6,6
2022-05-24,Hai Phong City,Kien An District,15,6,2,4,3
2022-05-24,Hai Phong City,Kien An District,16,6,1,5,4
2022-05-24,Hai Phong City,Kien An District,17,13,1,12,11
2022-05-24,Hai Phong City,Kien An District,18,23,3,20,14
2022-05-24,Hai Phong City,Kien An District,19,18,6,12,12
2022-05-24,Hai Phong City,Kien An District,20,15,3,12,10
2022-05-24,Hai Phong City,Kien An District,21,5,0,5,4
2022-05-24,Hai Phong City,Le Chan District,6,3,0,3,2
2022-05-24,Hai Phong City,Le Chan District,7,39,23,16,7
2022-05-24,Hai Phong City,Le Chan District,8,67,51,16,10
2022-05-24,Hai Phong City,Le Chan District,9,81,70,11,1
2022-05-24,Hai Phong City,Le Chan District,10,155,129,26,2
2022-05-24,Hai Phong City,Le Chan District,11,265,234,31,5
2022-05-24,Hai Phong City,Le Chan District,12,183,171,12,1
2022-05-24,Hai Phong City,Le Chan District,13,140,121,19,9
2022-05-24,Hai Phong City,Le Chan District,14,150,108,42,26
2022-05-24,Hai Phong City,Le Chan District,15,169,135,34,12
2022-05-24,Hai Phong City,Le Chan District,16,142,130,12,3
2022-05-24,Hai Phong City,Le Chan District,17,164,142,22,2
2022-05-24,Hai Phong City,Le Chan District,18,237,188,49,22
2022-05-24,Hai Phong City,Le Chan District,19,256,182,74,42
2022-05-24,Hai Phong City,Le Chan District,20,212,118,94,79
2022-05-24,Hai Phong City,Le Chan District,21,94,62,32,16
2022-05-24,Hai Phong City,Le Chan District,22,1,0,1,0
2022-05-24,Hai Phong City,Ngo Quyen District,1,1,1,0,0
2022-05-24,Hai Phong City,Ngo Quyen District,4,1,1,0,0
2022-05-24,Hai Phong City,Ngo Quyen District,6,2,0,2,1
2022-05-24,Hai Phong City,Ngo Quyen District,7,29,17,12,8
2022-05-24,Hai Phong City,Ngo Quyen District,8,77,57,20,9
2022-05-24,Hai Phong City,Ngo Quyen District,9,57,52,5,0
2022-05-24,Hai Phong City,Ngo Quyen District,10,115,103,12,0
2022-05-24,Hai Phong City,Ngo Quyen District,11,182,157,25,7
2022-05-24,Hai Phong City,Ngo Quyen District,12,110,98,12,3
2022-05-24,Hai Phong City,Ngo Quyen District,13,92,83,9,3
2022-05-24,Hai Phong City,Ngo Quyen District,14,129,102,27,14
2022-05-24,Hai Phong City,Ngo Quyen District,15,106,98,8,5
2022-05-24,Hai Phong City,Ngo Quyen District,16,110,101,9,2
2022-05-24,Hai Phong City,Ngo Quyen District,17,132,119,13,4
2022-05-24,Hai Phong City,Ngo Quyen District,18,154,131,23,13
2022-05-24,Hai Phong City,Ngo Quyen District,19,149,115,34,23
2022-05-24,Hai Phong City,Ngo Quyen District,20,170,91,79,64
2022-05-24,Hai Phong City,Ngo Quyen District,21,81,61,20,10
2022-05-24,Hai Phong City,Thuy Nguyen,12,1,0,1,1
2022-05-24,Hai Phong City,Thuy Nguyen,16,2,1,1,1
2022-05-24,Hai Phong City,Thuy Nguyen,18,2,0,2,2
2022-05-24,Hai Phong City,Thuy Nguyen,19,2,0,2,2
2022-05-24,Hai Phong City,Thuy Nguyen,20,1,0,1,1
2022-05-24,Hue City,Hue City,0,5,3,2,0
2022-05-24,Hue City,Hue City,1,1,1,0,0
2022-05-24,Hue City,Hue City,3,1,1,0,0
2022-05-24,Hue City,Hue City,5,2,1,1,0
2022-05-24,Hue City,Hue City,6,64,61,3,1
2022-05-24,Hue City,Hue City,7,199,185,14,2
2022-05-24,Hue City,Hue City,8,285,268,17,0
2022-05-24,Hue City,Hue City,9,274,254,20,4
2022-05-24,Hue City,Hue City,10,396,362,34,0
2022-05-24,Hue City,Hue City,11,706,669,37,2
2022-05-24,Hue City,Hue City,12,478,439,39,1
2022-05-24,Hue City,Hue City,13,318,293,25,1
2022-05-24,Hue City,Hue City,14,299,276,23,7
2022-05-24,Hue City,Hue City,15,336,318,18,0
2022-05-24,Hue City,Hue City,16,317,290,27,5
2022-05-24,Hue City,Hue City,17,424,401,23,0
2022-05-24,Hue City,Hue City,18,503,471,32,1
2022-05-24,Hue City,Hue City,19,553,501,52,1
2022-05-24,Hue City,Hue City,20,413,369,44,1
2022-05-24,Hue City,Hue City,21,247,207,40,2
2022-05-24,Hue City,Hue City,22,2,0,2,0
2022-05-24,Hue City,Huong Thuy,8,1,1,0,0
2022-05-24,Hue City,Huong Thuy,9,1,1,0,0
2022-05-24,Hue City,Huong Thuy,16,1,0,1,1
2022-05-24,Hue City,Huong Thuy,19,1,0,1,0
2022-05-24,Hue City,Huong Tra,10,1,1,0,0
2022-05-24,Hue City,Huong Tra,21,1,1,0,0
2022-05-24,Hue City,Phu Vang,8,2,2,0,0
2022-05-24,Hue City,Phu Vang,9,2,2,0,0
2022-05-24,Hue City,Phu Vang,10,1,1,0,0
2022-05-24,Hue City,Phu Vang,11,2,2,0,0
2022-05-24,Hue City,Phu Vang,12,3,2,1,1
2022-05-24,Hue City,Phu Vang,13,4,2,2,0
2022-05-24,Hue City,Phu Vang,14,4,2,2,2
2022-05-24,Hue City,Phu Vang,15,2,1,1,1
2022-05-24,Hue City,Phu Vang,16,2,2,0,0
2022-05-24,Hue City,Phu Vang,17,2,2,0,0
2022-05-24,Hue City,Phu Vang,19,2,1,1,1
2022-05-24,Hue City,Phu Vang,20,2,2,0,0
2022-05-24,Hue City,Phu Vang,21,1,1,0,0
2022-05-24,Vung Tau,Ba Ria City,7,4,0,4,4
2022-05-24,Vung Tau,Ba Ria City,8,9,0,9,8
2022-05-24,Vung Tau,Ba Ria City,9,11,1,10,8
2022-05-24,Vung Tau,Ba Ria City,10,7,1,6,5
2022-05-24,Vung Tau,Ba Ria City,11,7,6,1,1
2022-05-24,Vung Tau,Ba Ria City,12,6,4,2,1
2022-05-24,Vung Tau,Ba Ria City,13,5,3,2,2
2022-05-24,Vung Tau,Ba Ria City,14,2,2,0,0
2022-05-24,Vung Tau,Ba Ria City,15,2,2,0,0
2022-05-24,Vung Tau,Ba Ria City,16,6,2,4,4
2022-05-24,Vung Tau,Ba Ria City,17,7,1,6,6
2022-05-24,Vung Tau,Ba Ria City,18,4,1,3,3
2022-05-24,Vung Tau,Ba Ria City,19,10,2,8,7
2022-05-24,Vung Tau,Ba Ria City,20,1,0,1,1
2022-05-24,Vung Tau,Ba Ria City,21,1,0,1,1
2022-05-24,Vung Tau,Vung Tau City,1,2,2,0,0
2022-05-24,Vung Tau,Vung Tau City,3,1,1,0,0
2022-05-24,Vung Tau,Vung Tau City,5,3,3,0,0
2022-05-24,Vung Tau,Vung Tau City,6,23,22,1,0
2022-05-24,Vung Tau,Vung Tau City,7,102,93,9,2
2022-05-24,Vung Tau,Vung Tau City,8,141,128,13,3
2022-05-24,Vung Tau,Vung Tau City,9,181,161,20,9
2022-05-24,Vung Tau,Vung Tau City,10,172,157,15,5
2022-05-24,Vung Tau,Vung Tau City,11,361,330,31,4
2022-05-24,Vung Tau,Vung Tau City,12,242,225,17,6
2022-05-24,Vung Tau,Vung Tau City,13,198,184,14,1
2022-05-24,Vung Tau,Vung Tau City,14,199,180,19,3
2022-05-24,Vung Tau,Vung Tau City,15,190,172,18,2
2022-05-24,Vung Tau,Vung Tau City,16,173,158,15,1
2022-05-24,Vung Tau,Vung Tau City,17,230,218,12,0
2022-05-24,Vung Tau,Vung Tau City,18,292,262,30,2
2022-05-24,Vung Tau,Vung Tau City,19,249,218,31,6
2022-05-24,Vung Tau,Vung Tau City,20,172,145,27,6
2022-05-24,Vung Tau,Vung Tau City,21,96,68,28,21
2022-05-24,Vung Tau,Vung Tau City,22,1,0,1,0
2022-05-25,Binh Duong,Ben Cat,10,2,0,2,2
2022-05-25,Binh Duong,Ben Cat,13,2,1,1,1
2022-05-25,Binh Duong,Ben Cat,17,2,1,1,0
2022-05-25,Binh Duong,Ben Cat,18,3,0,3,3
2022-05-25,Binh Duong,Ben Cat,19,1,0,1,0
2022-05-25,Binh Duong,Ben Cat,20,1,0,1,1
2022-05-25,Binh Duong,Di An,7,13,6,7,5
2022-05-25,Binh Duong,Di An,8,15,9,6,2
2022-05-25,Binh Duong,Di An,9,18,11,7,4
2022-05-25,Binh Duong,Di An,10,34,17,17,13
2022-05-25,Binh Duong,Di An,11,44,16,28,23
2022-05-25,Binh Duong,Di An,12,48,21,27,24
2022-05-25,Binh Duong,Di An,13,48,28,20,16
2022-05-25,Binh Duong,Di An,14,33,26,7,7
2022-05-25,Binh Duong,Di An,15,20,16,4,4
2022-05-25,Binh Duong,Di An,16,24,15,9,7
2022-05-25,Binh Duong,Di An,17,31,15,16,14
2022-05-25,Binh Duong,Di An,18,30,17,13,11
2022-05-25,Binh Duong,Di An,19,33,19,14,12
2022-05-25,Binh Duong,Di An,20,25,11,14,10
2022-05-25,Binh Duong,Di An,21,8,4,4,2
2022-05-25,Binh Duong,Tan Uyen,8,1,1,0,0
2022-05-25,Binh Duong,Tan Uyen,9,4,2,2,1
2022-05-25,Binh Duong,Tan Uyen,10,3,0,3,3
2022-05-25,Binh Duong,Tan Uyen,11,2,0,2,2
2022-05-25,Binh Duong,Tan Uyen,12,2,0,2,2
2022-05-25,Binh Duong,Tan Uyen,13,2,0,2,2
2022-05-25,Binh Duong,Tan Uyen,14,6,4,2,0
2022-05-25,Binh Duong,Tan Uyen,15,1,0,1,0
2022-05-25,Binh Duong,Tan Uyen,16,1,1,0,0
2022-05-25,Binh Duong,Tan Uyen,17,1,1,0,0
2022-05-25,Binh Duong,Tan Uyen,21,1,0,1,1
2022-05-25,Binh Duong,Thu Dau Mot Town,2,1,1,0,0
2022-05-25,Binh Duong,Thu Dau Mot Town,6,31,26,5,3
2022-05-25,Binh Duong,Thu Dau Mot Town,7,106,96,10,1
2022-05-25,Binh Duong,Thu Dau Mot Town,8,194,181,13,1
2022-05-25,Binh Duong,Thu Dau Mot Town,9,246,230,16,3
2022-05-25,Binh Duong,Thu Dau Mot Town,10,369,349,20,5
2022-05-25,Binh Duong,Thu Dau Mot Town,11,598,478,120,63
2022-05-25,Binh Duong,Thu Dau Mot Town,12,538,364,174,138
2022-05-25,Binh Duong,Thu Dau Mot Town,13,459,445,14,2
2022-05-25,Binh Duong,Thu Dau Mot Town,14,340,321,19,1
2022-05-25,Binh Duong,Thu Dau Mot Town,15,285,259,26,2
2022-05-25,Binh Duong,Thu Dau Mot Town,16,271,264,7,0
2022-05-25,Binh Duong,Thu Dau Mot Town,17,342,321,21,3
2022-05-25,Binh Duong,Thu Dau Mot Town,18,376,355,21,4
2022-05-25,Binh Duong,Thu Dau Mot Town,19,336,316,20,2
2022-05-25,Binh Duong,Thu Dau Mot Town,20,281,254,27,2
2022-05-25,Binh Duong,Thu Dau Mot Town,21,140,113,27,7
2022-05-25,Binh Duong,Thu Dau Mot Town,22,4,0,4,3
2022-05-25,Binh Duong,Thuan An,4,1,0,1,0
2022-05-25,Binh Duong,Thuan An,6,2,1,1,1
2022-05-25,Binh Duong,Thuan An,7,6,4,2,2
2022-05-25,Binh Duong,Thuan An,8,24,14,10,6
2022-05-25,Binh Duong,Thuan An,9,35,27,8,3
2022-05-25,Binh Duong,Thuan An,10,67,53,14,10
2022-05-25,Binh Duong,Thuan An,11,74,39,35,32
2022-05-25,Binh Duong,Thuan An,12,88,38,50,39
2022-05-25,Binh Duong,Thuan An,13,60,39,21,19
2022-05-25,Binh Duong,Thuan An,14,47,38,9,4
2022-05-25,Binh Duong,Thuan An,15,50,38,12,6
2022-05-25,Binh Duong,Thuan An,16,37,32,5,2
2022-05-25,Binh Duong,Thuan An,17,49,45,4,3
2022-05-25,Binh Duong,Thuan An,18,55,41,14,9
2022-05-25,Binh Duong,Thuan An,19,43,35,8,7
2022-05-25,Binh Duong,Thuan An,20,24,10,14,9
2022-05-25,Binh Duong,Thuan An,21,19,10,9,6
2022-05-25,Can Tho City,Binh Thuy District,7,3,1,2,0
2022-05-25,Can Tho City,Binh Thuy District,8,2,2,0,0
2022-05-25,Can Tho City,Binh Thuy District,9,5,4,1,0
2022-05-25,Can Tho City,Binh Thuy District,10,5,5,0,0
2022-05-25,Can Tho City,Binh Thuy District,11,5,4,1,1
2022-05-25,Can Tho City,Binh Thuy District,12,10,8,2,1
2022-05-25,Can Tho City,Binh Thuy District,13,14,13,1,1
2022-05-25,Can Tho City,Binh Thuy District,14,10,10,0,0
2022-05-25,Can Tho City,Binh Thuy District,15,10,10,0,0
2022-05-25,Can Tho City,Binh Thuy District,16,16,12,4,0
2022-05-25,Can Tho City,Binh Thuy District,17,11,11,0,0
2022-05-25,Can Tho City,Binh Thuy District,18,11,8,3,0
2022-05-25,Can Tho City,Binh Thuy District,19,7,5,2,0
2022-05-25,Can Tho City,Binh Thuy District,20,9,8,1,0
2022-05-25,Can Tho City,Binh Thuy District,21,5,4,1,1
2022-05-25,Can Tho City,Cai Rang District,6,2,0,2,2
2022-05-25,Can Tho City,Cai Rang District,7,5,4,1,0
2022-05-25,Can Tho City,Cai Rang District,8,6,4,2,0
2022-05-25,Can Tho City,Cai Rang District,9,4,3,1,0
2022-05-25,Can Tho City,Cai Rang District,10,10,7,3,0
2022-05-25,Can Tho City,Cai Rang District,11,12,9,3,2
2022-05-25,Can Tho City,Cai Rang District,12,10,6,4,3
2022-05-25,Can Tho City,Cai Rang District,13,10,9,1,0
2022-05-25,Can Tho City,Cai Rang District,14,7,7,0,0
2022-05-25,Can Tho City,Cai Rang District,15,7,7,0,0
2022-05-25,Can Tho City,Cai Rang District,16,19,18,1,1
2022-05-25,Can Tho City,Cai Rang District,17,11,10,1,0
2022-05-25,Can Tho City,Cai Rang District,18,9,8,1,0
2022-05-25,Can Tho City,Cai Rang District,19,9,8,1,0
2022-05-25,Can Tho City,Cai Rang District,20,8,7,1,0
2022-05-25,Can Tho City,Cai Rang District,21,4,0,4,2
2022-05-25,Can Tho City,Ninh Kieu District,0,13,12,1,0
2022-05-25,Can Tho City,Ninh Kieu District,1,5,4,1,0
2022-05-25,Can Tho City,Ninh Kieu District,2,2,1,1,0
2022-05-25,Can Tho City,Ninh Kieu District,3,3,3,0,0
2022-05-25,Can Tho City,Ninh Kieu District,4,3,3,0,0
2022-05-25,Can Tho City,Ninh Kieu District,5,8,4,4,2
2022-05-25,Can Tho City,Ninh Kieu District,6,53,43,10,5
2022-05-25,Can Tho City,Ninh Kieu District,7,146,141,5,0
2022-05-25,Can Tho City,Ninh Kieu District,8,218,208,10,0
2022-05-25,Can Tho City,Ninh Kieu District,9,317,298,19,0
2022-05-25,Can Tho City,Ninh Kieu District,10,583,563,20,1
2022-05-25,Can Tho City,Ninh Kieu District,11,742,624,118,62
2022-05-25,Can Tho City,Ninh Kieu District,12,845,517,328,273
2022-05-25,Can Tho City,Ninh Kieu District,13,506,487,19,0
2022-05-25,Can Tho City,Ninh Kieu District,14,408,395,13,0
2022-05-25,Can Tho City,Ninh Kieu District,15,361,343,18,0
2022-05-25,Can Tho City,Ninh Kieu District,16,416,385,31,0
2022-05-25,Can Tho City,Ninh Kieu District,17,485,460,25,0
2022-05-25,Can Tho City,Ninh Kieu District,18,540,519,21,0
2022-05-25,Can Tho City,Ninh Kieu District,19,492,471,21,0
2022-05-25,Can Tho City,Ninh Kieu District,20,371,347,24,0
2022-05-25,Can Tho City,Ninh Kieu District,21,201,185,16,1
2022-05-25,Can Tho City,Ninh Kieu District,22,3,0,3,0
2022-05-25,Dong Nai,Bien Hoa City,0,6,4,2,0
2022-05-25,Dong Nai,Bien Hoa City,1,3,0,3,3
2022-05-25,Dong Nai,Bien Hoa City,2,1,0,1,1
2022-05-25,Dong Nai,Bien Hoa City,3,1,1,0,0
2022-05-25,Dong Nai,Bien Hoa City,5,4,2,2,1
2022-05-25,Dong Nai,Bien Hoa City,6,43,28,15,6
2022-05-25,Dong Nai,Bien Hoa City,7,165,134,31,12
2022-05-25,Dong Nai,Bien Hoa City,8,333,289,44,10
2022-05-25,Dong Nai,Bien Hoa City,9,437,394,43,8
2022-05-25,Dong Nai,Bien Hoa City,10,778,706,72,18
2022-05-25,Dong Nai,Bien Hoa City,11,1074,731,343,236
2022-05-25,Dong Nai,Bien Hoa City,12,1240,691,549,459
2022-05-25,Dong Nai,Bien Hoa City,13,916,800,116,59
2022-05-25,Dong Nai,Bien Hoa City,14,725,642,83,30
2022-05-25,Dong Nai,Bien Hoa City,15,533,504,29,16
2022-05-25,Dong Nai,Bien Hoa City,16,484,437,47,12
2022-05-25,Dong Nai,Bien Hoa City,17,629,580,49,7
2022-05-25,Dong Nai,Bien Hoa City,18,633,595,38,1
2022-05-25,Dong Nai,Bien Hoa City,19,654,595,59,14
2022-05-25,Dong Nai,Bien Hoa City,20,459,394,65,17
2022-05-25,Dong Nai,Bien Hoa City,21,184,132,52,21
2022-05-25,Dong Nai,Bien Hoa City,22,1,0,1,0
2022-05-25,Dong Nai,Cam My,12,2,0,2,1
2022-05-25,Dong Nai,Long Thanh,10,4,0,4,4
2022-05-25,Dong Nai,Long Thanh,11,2,0,2,2
2022-05-25,Dong Nai,Long Thanh,12,2,0,2,2
2022-05-25,Dong Nai,Long Thanh,17,1,0,1,1
2022-05-25,Dong Nai,Long Thanh,18,1,0,1,1
2022-05-25,Dong Nai,Trang Bom,11,1,0,1,1
2022-05-25,Hai Phong City,An Duong,7,3,2,1,1
2022-05-25,Hai Phong City,An Duong,9,2,2,0,0
2022-05-25,Hai Phong City,An Duong,10,4,2,2,1
2022-05-25,Hai Phong City,An Duong,11,3,1,2,1
2022-05-25,Hai Phong City,An Duong,13,5,1,4,3
2022-05-25,Hai Phong City,An Duong,14,1,0,1,1
2022-05-25,Hai Phong City,An Duong,15,4,1,3,3
2022-05-25,Hai Phong City,An Duong,16,1,1,0,0
2022-05-25,Hai Phong City,An Duong,17,3,2,1,0
2022-05-25,Hai Phong City,An Duong,18,1,0,1,0
2022-05-25,Hai Phong City,An Duong,19,1,1,0,0
2022-05-25,Hai Phong City,An Duong,21,1,0,1,1
2022-05-25,Hai Phong City,Do Son District,16,1,0,1,1
2022-05-25,Hai Phong City,Do Son District,19,2,0,2,1
2022-05-25,Hai Phong City,Do Son District,20,1,0,1,1
2022-05-25,Hai Phong City,Hai An District,7,11,8,3,2
2022-05-25,Hai Phong City,Hai An District,8,4,4,0,0
2022-05-25,Hai Phong City,Hai An District,9,16,9,7,6
2022-05-25,Hai Phong City,Hai An District,10,23,20,3,1
2022-05-25,Hai Phong City,Hai An District,11,40,22,18,11
2022-05-25,Hai Phong City,Hai An District,12,29,10,19,15
2022-05-25,Hai Phong City,Hai An District,13,20,13,7,3
2022-05-25,Hai Phong City,Hai An District,14,13,11,2,1
2022-05-25,Hai Phong City,Hai An District,15,22,16,6,1
2022-05-25,Hai Phong City,Hai An District,16,21,17,4,0
2022-05-25,Hai Phong City,Hai An District,17,16,14,2,0
2022-05-25,Hai Phong City,Hai An District,18,19,15,4,1
2022-05-25,Hai Phong City,Hai An District,19,17,15,2,0
2022-05-25,Hai Phong City,Hai An District,20,16,16,0,0
2022-05-25,Hai Phong City,Hai An District,21,15,11,4,2
2022-05-25,Hai Phong City,Hong Bang District,0,1,1,0,0
2022-05-25,Hai Phong City,Hong Bang District,7,20,18,2,0
2022-05-25,Hai Phong City,Hong Bang District,8,32,25,7,2
2022-05-25,Hai Phong City,Hong Bang District,9,26,26,0,0
2022-05-25,Hai Phong City,Hong Bang District,10,52,45,7,5
2022-05-25,Hai Phong City,Hong Bang District,11,110,61,49,36
2022-05-25,Hai Phong City,Hong Bang District,12,70,32,38,30
2022-05-25,Hai Phong City,Hong Bang District,13,40,33,7,4
2022-05-25,Hai Phong City,Hong Bang District,14,41,34,7,7
2022-05-25,Hai Phong City,Hong Bang District,15,44,36,8,3
2022-05-25,Hai Phong City,Hong Bang District,16,42,39,3,0
2022-05-25,Hai Phong City,Hong Bang District,17,37,36,1,1
2022-05-25,Hai Phong City,Hong Bang District,18,64,54,10,4
2022-05-25,Hai Phong City,Hong Bang District,19,58,50,8,0
2022-05-25,Hai Phong City,Hong Bang District,20,28,22,6,1
2022-05-25,Hai Phong City,Hong Bang District,21,19,11,8,4
2022-05-25,Hai Phong City,Hong Bang District,22,1,1,0,0
2022-05-25,Hai Phong City,Kien An District,7,4,0,4,3
2022-05-25,Hai Phong City,Kien An District,8,1,0,1,1
2022-05-25,Hai Phong City,Kien An District,9,3,0,3,2
2022-05-25,Hai Phong City,Kien An District,10,9,6,3,3
2022-05-25,Hai Phong City,Kien An District,11,16,9,7,7
2022-05-25,Hai Phong City,Kien An District,12,17,8,9,7
2022-05-25,Hai Phong City,Kien An District,13,6,5,1,1
2022-05-25,Hai Phong City,Kien An District,14,7,3,4,3
2022-05-25,Hai Phong City,Kien An District,15,8,3,5,4
2022-05-25,Hai Phong City,Kien An District,16,7,2,5,3
2022-05-25,Hai Phong City,Kien An District,17,9,6,3,2
2022-05-25,Hai Phong City,Kien An District,18,10,8,2,0
2022-05-25,Hai Phong City,Kien An District,19,11,8,3,1
2022-05-25,Hai Phong City,Kien An District,20,19,1,18,15
2022-05-25,Hai Phong City,Kien An District,21,4,0,4,3
2022-05-25,Hai Phong City,Le Chan District,0,2,2,0,0
2022-05-25,Hai Phong City,Le Chan District,6,2,2,0,0
2022-05-25,Hai Phong City,Le Chan District,7,40,27,13,6
2022-05-25,Hai Phong City,Le Chan District,8,61,52,9,3
2022-05-25,Hai Phong City,Le Chan District,9,66,55,11,0
2022-05-25,Hai Phong City,Le Chan District,10,151,132,19,3
2022-05-25,Hai Phong City,Le Chan District,11,261,166,95,65
2022-05-25,Hai Phong City,Le Chan District,12,244,114,130,101
2022-05-25,Hai Phong City,Le Chan District,13,145,111,34,14
2022-05-25,Hai Phong City,Le Chan District,14,141,124,17,7
2022-05-25,Hai Phong City,Le Chan District,15,173,148,25,10
2022-05-25,Hai Phong City,Le Chan District,16,143,133,10,1
2022-05-25,Hai Phong City,Le Chan District,17,162,144,18,1
2022-05-25,Hai Phong City,Le Chan District,18,179,152,27,3
2022-05-25,Hai Phong City,Le Chan District,19,205,180,25,5
2022-05-25,Hai Phong City,Le Chan District,20,148,134,14,4
2022-05-25,Hai Phong City,Le Chan District,21,74,59,15,5
2022-05-25,Hai Phong City,Le Chan District,22,1,0,1,0
2022-05-25,Hai Phong City,Ngo Quyen District,6,3,2,1,0
2022-05-25,Hai Phong City,Ngo Quyen District,7,32,25,7,4
2022-05-25,Hai Phong City,Ngo Quyen District,8,76,68,8,3
2022-05-25,Hai Phong City,Ngo Quyen District,9,73,63,10,1
2022-05-25,Hai Phong City,Ngo Quyen District,10,123,109,14,2
2022-05-25,Hai Phong City,Ngo Quyen District,11,208,135,73,54
2022-05-25,Hai Phong City,Ngo Quyen District,12,189,100,89,69
2022-05-25,Hai Phong City,Ngo Quyen District,13,112,88,24,14
2022-05-25,Hai Phong City,Ngo Quyen District,14,110,101,9,2
2022-05-25,Hai Phong City,Ngo Quyen District,15,145,133,12,1
2022-05-25,Hai Phong City,Ngo Quyen District,16,137,123,14,1
2022-05-25,Hai Phong City,Ngo Quyen District,17,110,94,16,1
2022-05-25,Hai Phong City,Ngo Quyen District,18,165,145,20,4
2022-05-25,Hai Phong City,Ngo Quyen District,19,142,125,17,6
2022-05-25,Hai Phong City,Ngo Quyen District,20,96,87,9,3
2022-05-25,Hai Phong City,Ngo Quyen District,21,64,44,20,6
2022-05-25,Hai Phong City,Ngo Quyen District,22,1,0,1,0
2022-05-25,Hai Phong City,Thuy Nguyen,8,2,0,2,1
2022-05-25,Hai Phong City,Thuy Nguyen,10,3,1,2,2
2022-05-25,Hai Phong City,Thuy Nguyen,13,2,0,2,0
2022-05-25,Hai Phong City,Thuy Nguyen,16,4,0,4,2
2022-05-25,Hai Phong City,Thuy Nguyen,17,1,0,1,1
2022-05-25,Hai Phong City,Thuy Nguyen,18,1,0,1,1
2022-05-25,Hue City,Hue City,0,8,7,1,0
2022-05-25,Hue City,Hue City,2,2,1,1,1
2022-05-25,Hue City,Hue City,3,1,1,0,0
2022-05-25,Hue City,Hue City,4,1,1,0,0
2022-05-25,Hue City,Hue City,5,1,1,0,0
2022-05-25,Hue City,Hue City,6,74,65,9,3
2022-05-25,Hue City,Hue City,7,200,183,17,1
2022-05-25,Hue City,Hue City,8,329,305,24,0
2022-05-25,Hue City,Hue City,9,243,221,22,0
2022-05-25,Hue City,Hue City,10,369,346,23,0
2022-05-25,Hue City,Hue City,11,791,600,191,110
2022-05-25,Hue City,Hue City,12,644,339,305,250
2022-05-25,Hue City,Hue City,13,304,282,22,2
2022-05-25,Hue City,Hue City,14,370,347,23,0
2022-05-25,Hue City,Hue City,15,402,368,34,4
2022-05-25,Hue City,Hue City,16,353,325,28,2
2022-05-25,Hue City,Hue City,17,383,366,17,0
2022-05-25,Hue City,Hue City,18,498,472,26,2
2022-05-25,Hue City,Hue City,19,534,493,41,0
2022-05-25,Hue City,Hue City,20,401,362,39,2
2022-05-25,Hue City,Hue City,21,234,192,42,7
2022-05-25,Hue City,Hue City,23,1,0,1,0
2022-05-25,Hue City,Huong Thuy,8,1,1,0,0
2022-05-25,Hue City,Huong Thuy,10,2,1,1,0
2022-05-25,Hue City,Huong Thuy,11,1,0,1,0
2022-05-25,Hue City,Huong Thuy,12,2,0,2,2
2022-05-25,Hue City,Huong Thuy,14,1,0,1,0
2022-05-25,Hue City,Huong Thuy,15,2,1,1,0
2022-05-25,Hue City,Huong Thuy,17,4,1,3,2
2022-05-25,Hue City,Huong Thuy,21,1,0,1,1
2022-05-25,Hue City,Huong Tra,12,1,0,1,1
2022-05-25,Hue City,Huong Tra,16,1,0,1,1
2022-05-25,Hue City,Huong Tra,19,1,1,0,0
2022-05-25,Hue City,Phu Vang,8,2,1,1,1
2022-05-25,Hue City,Phu Vang,9,1,1,0,0
2022-05-25,Hue City,Phu Vang,10,4,3,1,0
2022-05-25,Hue City,Phu Vang,11,4,1,3,2
2022-05-25,Hue City,Phu Vang,12,2,0,2,2
2022-05-25,Hue City,Phu Vang,14,5,5,0,0
2022-05-25,Hue City,Phu Vang,15,3,1,2,0
2022-05-25,Hue City,Phu Vang,16,2,1,1,1
2022-05-25,Hue City,Phu Vang,17,3,2,1,1
2022-05-25,Hue City,Phu Vang,18,1,1,0,0
2022-05-25,Hue City,Phu Vang,19,4,2,2,1
2022-05-25,Hue City,Phu Vang,20,1,1,0,0
2022-05-25,Hue City,Phu Vang,21,1,1,0,0
2022-05-25,Vung Tau,Ba Ria City,8,4,2,2,0
2022-05-25,Vung Tau,Ba Ria City,9,6,2,4,3
2022-05-25,Vung Tau,Ba Ria City,10,14,7,7,5
2022-05-25,Vung Tau,Ba Ria City,11,4,2,2,1
2022-05-25,Vung Tau,Ba Ria City,12,6,2,4,3
2022-05-25,Vung Tau,Ba Ria City,13,7,5,2,1
2022-05-25,Vung Tau,Ba Ria City,14,5,4,1,0
2022-05-25,Vung Tau,Ba Ria City,15,5,3,2,2
2022-05-25,Vung Tau,Ba Ria City,16,6,3,3,2
2022-05-25,Vung Tau,Ba Ria City,17,8,4,4,3
2022-05-25,Vung Tau,Ba Ria City,18,6,5,1,1
2022-05-25,Vung Tau,Tan Thanh,21,1,0,1,1
2022-05-25,Vung Tau,Vung Tau City,0,2,0,2,2
2022-05-25,Vung Tau,Vung Tau City,1,3,2,1,0
2022-05-25,Vung Tau,Vung Tau City,4,1,1,0,0
2022-05-25,Vung Tau,Vung Tau City,5,4,1,3,2
2022-05-25,Vung Tau,Vung Tau City,6,37,29,8,6
2022-05-25,Vung Tau,Vung Tau City,7,99,89,10,2
2022-05-25,Vung Tau,Vung Tau City,8,176,165,11,2
2022-05-25,Vung Tau,Vung Tau City,9,138,129,9,3
2022-05-25,Vung Tau,Vung Tau City,10,160,141,19,1
2022-05-25,Vung Tau,Vung Tau City,11,308,251,57,28
2022-05-25,Vung Tau,Vung Tau City,12,340,214,126,95
2022-05-25,Vung Tau,Vung Tau City,13,226,202,24,5
2022-05-25,Vung Tau,Vung Tau City,14,233,216,17,5
2022-05-25,Vung Tau,Vung Tau City,15,223,211,12,2
2022-05-25,Vung Tau,Vung Tau City,16,195,172,23,5
2022-05-25,Vung Tau,Vung Tau City,17,236,223,13,2
2022-05-25,Vung Tau,Vung Tau City,18,252,238,14,1
2022-05-25,Vung Tau,Vung Tau City,19,209,191,18,1
2022-05-25,Vung Tau,Vung Tau City,20,173,155,18,4
2022-05-25,Vung Tau,Vung Tau City,21,91,73,18,6
2022-05-25,Vung Tau,Vung Tau City,22,1,0,1,0
2022-05-26,Binh Duong,Ben Cat,11,2,0,2,2
2022-05-26,Binh Duong,Ben Cat,13,1,0,1,1
2022-05-26,Binh Duong,Ben Cat,14,5,0,5,4
2022-05-26,Binh Duong,Ben Cat,16,2,0,2,2
2022-05-26,Binh Duong,Ben Cat,18,1,0,1,1
2022-05-26,Binh Duong,Ben Cat,19,1,1,0,0
2022-05-26,Binh Duong,Ben Cat,20,1,0,1,1
2022-05-26,Binh Duong,Di An,6,3,0,3,3
2022-05-26,Binh Duong,Di An,7,13,1,12,10
2022-05-26,Binh Duong,Di An,8,13,8,5,5
2022-05-26,Binh Duong,Di An,9,18,7,11,9
2022-05-26,Binh Duong,Di An,10,39,19,20,16
2022-05-26,Binh Duong,Di An,11,36,18,18,15
2022-05-26,Binh Duong,Di An,12,44,22,22,15
2022-05-26,Binh Duong,Di An,13,36,18,18,10
2022-05-26,Binh Duong,Di An,14,22,16,6,3
2022-05-26,Binh Duong,Di An,15,32,17,15,10
2022-05-26,Binh Duong,Di An,16,24,12,12,10
2022-05-26,Binh Duong,Di An,17,31,24,7,5
2022-05-26,Binh Duong,Di An,18,31,27,4,2
2022-05-26,Binh Duong,Di An,19,40,30,10,3
2022-05-26,Binh Duong,Di An,20,15,5,10,8
2022-05-26,Binh Duong,Di An,21,13,2,11,5
2022-05-26,Binh Duong,Tan Uyen,10,3,1,2,2
2022-05-26,Binh Duong,Tan Uyen,11,2,1,1,1
2022-05-26,Binh Duong,Tan Uyen,12,3,2,1,1
2022-05-26,Binh Duong,Tan Uyen,13,1,1,0,0
2022-05-26,Binh Duong,Tan Uyen,14,3,2,1,1
2022-05-26,Binh Duong,Tan Uyen,15,4,1,3,1
2022-05-26,Binh Duong,Tan Uyen,17,1,1,0,0
2022-05-26,Binh Duong,Tan Uyen,18,1,1,0,0
2022-05-26,Binh Duong,Tan Uyen,19,5,0,5,5
2022-05-26,Binh Duong,Tan Uyen,20,5,1,4,3
2022-05-26,Binh Duong,Tan Uyen,21,1,0,1,1
2022-05-26,Binh Duong,Thu Dau Mot Town,0,1,1,0,0
2022-05-26,Binh Duong,Thu Dau Mot Town,1,1,1,0,0
2022-05-26,Binh Duong,Thu Dau Mot Town,5,1,1,0,0
2022-05-26,Binh Duong,Thu Dau Mot Town,6,31,24,7,3
2022-05-26,Binh Duong,Thu Dau Mot Town,7,105,97,8,1
2022-05-26,Binh Duong,Thu Dau Mot Town,8,228,207,21,3
2022-05-26,Binh Duong,Thu Dau Mot Town,9,241,224,17,1
2022-05-26,Binh Duong,Thu Dau Mot Town,10,351,325,26,6
2022-05-26,Binh Duong,Thu Dau Mot Town,11,613,572,41,3
2022-05-26,Binh Duong,Thu Dau Mot Town,12,499,469,30,1
2022-05-26,Binh Duong,Thu Dau Mot Town,13,415,399,16,3
2022-05-26,Binh Duong,Thu Dau Mot Town,14,378,356,22,3
2022-05-26,Binh Duong,Thu Dau Mot Town,15,257,244,13,0
2022-05-26,Binh Duong,Thu Dau Mot Town,16,299,274,25,3
2022-05-26,Binh Duong,Thu Dau Mot Town,17,352,332,20,0
2022-05-26,Binh Duong,Thu Dau Mot Town,18,355,341,14,3
2022-05-26,Binh Duong,Thu Dau Mot Town,19,338,307,31,8
2022-05-26,Binh Duong,Thu Dau Mot Town,20,306,259,47,23
2022-05-26,Binh Duong,Thu Dau Mot Town,21,202,86,116,75
2022-05-26,Binh Duong,Thu Dau Mot Town,22,1,0,1,0
2022-05-26,Binh Duong,Thuan An,1,1,0,1,0
2022-05-26,Binh Duong,Thuan An,2,1,0,1,1
2022-05-26,Binh Duong,Thuan An,5,1,0,1,1
2022-05-26,Binh Duong,Thuan An,6,5,2,3,3
2022-05-26,Binh Duong,Thuan An,7,14,6,8,7
2022-05-26,Binh Duong,Thuan An,8,22,17,5,2
2022-05-26,Binh Duong,Thuan An,9,28,21,7,4
2022-05-26,Binh Duong,Thuan An,10,57,45,12,8
2022-05-26,Binh Duong,Thuan An,11,81,63,18,10
2022-05-26,Binh Duong,Thuan An,12,65,59,6,5
2022-05-26,Binh Duong,Thuan An,13,68,61,7,6
2022-05-26,Binh Duong,Thuan An,14,64,50,14,9
2022-05-26,Binh Duong,Thuan An,15,55,46,9,3
2022-05-26,Binh Duong,Thuan An,16,47,34,13,7
2022-05-26,Binh Duong,Thuan An,17,37,31,6,4
2022-05-26,Binh Duong,Thuan An,18,46,39,7,4
2022-05-26,Binh Duong,Thuan An,19,54,46,8,4
2022-05-26,Binh Duong,Thuan An,20,35,15,20,13
2022-05-26,Binh Duong,Thuan An,21,35,2,33,30
2022-05-26,Binh Duong,Thuan An,22,1,0,1,0
2022-05-26,Can Tho City,Binh Thuy District,6,1,1,0,0
2022-05-26,Can Tho City,Binh Thuy District,7,1,1,0,0
2022-05-26,Can Tho City,Binh Thuy District,8,5,3,2,0
2022-05-26,Can Tho City,Binh Thuy District,9,5,5,0,0
2022-05-26,Can Tho City,Binh Thuy District,10,9,8,1,1
2022-05-26,Can Tho City,Binh Thuy District,11,11,11,0,0
2022-05-26,Can Tho City,Binh Thuy District,12,8,6,2,0
2022-05-26,Can Tho City,Binh Thuy District,13,15,13,2,1
2022-05-26,Can Tho City,Binh Thuy District,14,7,7,0,0
2022-05-26,Can Tho City,Binh Thuy District,15,16,15,1,0
2022-05-26,Can Tho City,Binh Thuy District,16,11,8,3,0
2022-05-26,Can Tho City,Binh Thuy District,17,15,15,0,0
2022-05-26,Can Tho City,Binh Thuy District,18,15,14,1,0
2022-05-26,Can Tho City,Binh Thuy District,19,11,9,2,0
2022-05-26,Can Tho City,Binh Thuy District,20,10,9,1,0
2022-05-26,Can Tho City,Binh Thuy District,21,3,3,0,0
2022-05-26,Can Tho City,Cai Rang District,2,2,1,1,0
2022-05-26,Can Tho City,Cai Rang District,6,1,0,1,1
2022-05-26,Can Tho City,Cai Rang District,7,4,4,0,0
2022-05-26,Can Tho City,Cai Rang District,8,7,6,1,0
2022-05-26,Can Tho City,Cai Rang District,9,9,6,3,0
2022-05-26,Can Tho City,Cai Rang District,10,14,13,1,0
2022-05-26,Can Tho City,Cai Rang District,11,20,18,2,0
2022-05-26,Can Tho City,Cai Rang District,12,6,6,0,0
2022-05-26,Can Tho City,Cai Rang District,13,7,7,0,0
2022-05-26,Can Tho City,Cai Rang District,14,10,10,0,0
2022-05-26,Can Tho City,Cai Rang District,15,16,16,0,0
2022-05-26,Can Tho City,Cai Rang District,16,7,5,2,0
2022-05-26,Can Tho City,Cai Rang District,17,14,14,0,0
2022-05-26,Can Tho City,Cai Rang District,18,8,7,1,0
2022-05-26,Can Tho City,Cai Rang District,19,16,14,2,1
2022-05-26,Can Tho City,Cai Rang District,20,16,10,6,3
2022-05-26,Can Tho City,Cai Rang District,21,2,1,1,0
2022-05-26,Can Tho City,Ninh Kieu District,0,10,8,2,0
2022-05-26,Can Tho City,Ninh Kieu District,1,4,4,0,0
2022-05-26,Can Tho City,Ninh Kieu District,2,1,1,0,0
2022-05-26,Can Tho City,Ninh Kieu District,5,6,5,1,0
2022-05-26,Can Tho City,Ninh Kieu District,6,51,46,5,3
2022-05-26,Can Tho City,Ninh Kieu District,7,127,113,14,0
2022-05-26,Can Tho City,Ninh Kieu District,8,240,226,14,0
2022-05-26,Can Tho City,Ninh Kieu District,9,281,271,10,0
2022-05-26,Can Tho City,Ninh Kieu District,10,549,523,26,0
2022-05-26,Can Tho City,Ninh Kieu District,11,893,849,44,5
2022-05-26,Can Tho City,Ninh Kieu District,12,619,586,33,0
2022-05-26,Can Tho City,Ninh Kieu District,13,466,451,15,0
2022-05-26,Can Tho City,Ninh Kieu District,14,451,421,30,0
2022-05-26,Can Tho City,Ninh Kieu District,15,349,328,21,0
2022-05-26,Can Tho City,Ninh Kieu District,16,412,396,16,0
2022-05-26,Can Tho City,Ninh Kieu District,17,571,546,25,0
2022-05-26,Can Tho City,Ninh Kieu District,18,529,511,18,0
2022-05-26,Can Tho City,Ninh Kieu District,19,484,456,28,0
2022-05-26,Can Tho City,Ninh Kieu District,20,330,311,19,0
2022-05-26,Can Tho City,Ninh Kieu District,21,188,158,30,1
2022-05-26,Can Tho City,Ninh Kieu District,22,1,0,1,0
2022-05-26,Dong Nai,Bien Hoa City,0,4,1,3,0
2022-05-26,Dong Nai,Bien Hoa City,1,3,3,0,0
2022-05-26,Dong Nai,Bien Hoa City,5,3,2,1,0
2022-05-26,Dong Nai,Bien Hoa City,6,67,33,34,31
2022-05-26,Dong Nai,Bien Hoa City,7,168,146,22,11
2022-05-26,Dong Nai,Bien Hoa City,8,284,248,36,10
2022-05-26,Dong Nai,Bien Hoa City,9,422,377,45,7
2022-05-26,Dong Nai,Bien Hoa City,10,784,695,89,24
2022-05-26,Dong Nai,Bien Hoa City,11,1073,963,110,29
2022-05-26,Dong Nai,Bien Hoa City,12,870,800,70,23
2022-05-26,Dong Nai,Bien Hoa City,13,873,812,61,16
2022-05-26,Dong Nai,Bien Hoa City,14,707,639,68,22
2022-05-26,Dong Nai,Bien Hoa City,15,520,484,36,6
2022-05-26,Dong Nai,Bien Hoa City,16,478,439,39,16
2022-05-26,Dong Nai,Bien Hoa City,17,569,521,48,9
2022-05-26,Dong Nai,Bien Hoa City,18,682,628,54,6
2022-05-26,Dong Nai,Bien Hoa City,19,600,539,61,7
2022-05-26,Dong Nai,Bien Hoa City,20,471,407,64,13
2022-05-26,Dong Nai,Bien Hoa City,21,268,118,150,94
2022-05-26,Dong Nai,Bien Hoa City,23,1,0,1,0
2022-05-26,Dong Nai,Long Khanh,11,1,0,1,1
2022-05-26,Dong Nai,Long Thanh,8,4,0,4,4
2022-05-26,Dong Nai,Long Thanh,11,1,0,1,1
2022-05-26,Dong Nai,Long Thanh,12,2,0,2,2
2022-05-26,Dong Nai,Long Thanh,13,2,0,2,2
2022-05-26,Dong Nai,Long Thanh,16,1,0,1,1
2022-05-26,Dong Nai,Nhon trach,13,1,0,1,1
2022-05-26,Dong Nai,Nhon trach,15,1,0,1,1
2022-05-26,Dong Nai,Nhon trach,18,1,0,1,1
2022-05-26,Dong Nai,Trang Bom,11,2,0,2,2
2022-05-26,Dong Nai,Trang Bom,12,1,0,1,1
2022-05-26,Dong Nai,Trang Bom,13,1,1,0,0
2022-05-26,Dong Nai,Trang Bom,14,1,0,1,1
2022-05-26,Dong Nai,Trang Bom,15,1,0,1,1
2022-05-26,Dong Nai,Trang Bom,16,1,0,1,1
2022-05-26,Dong Nai,Trang Bom,17,3,0,3,3
2022-05-26,Hai Phong City,An Duong,7,1,1,0,0
2022-05-26,Hai Phong City,An Duong,8,4,0,4,2
2022-05-26,Hai Phong City,An Duong,9,1,0,1,0
2022-05-26,Hai Phong City,An Duong,10,6,4,2,2
2022-05-26,Hai Phong City,An Duong,11,2,2,0,0
2022-05-26,Hai Phong City,An Duong,12,2,1,1,0
2022-05-26,Hai Phong City,An Duong,13,1,1,0,0
2022-05-26,Hai Phong City,An Duong,14,5,2,3,3
2022-05-26,Hai Phong City,An Duong,15,2,0,2,2
2022-05-26,Hai Phong City,An Duong,16,8,5,3,2
2022-05-26,Hai Phong City,An Duong,17,3,1,2,2
2022-05-26,Hai Phong City,An Duong,19,4,2,2,2
2022-05-26,Hai Phong City,An Duong,20,2,0,2,2
2022-05-26,Hai Phong City,An Duong,21,2,1,1,0
2022-05-26,Hai Phong City,Do Son District,11,1,0,1,1
2022-05-26,Hai Phong City,Do Son District,16,1,0,1,1
2022-05-26,Hai Phong City,Duong Kinh District,10,1,0,1,1
2022-05-26,Hai Phong City,Duong Kinh District,14,1,0,1,1
2022-05-26,Hai Phong City,Duong Kinh District,17,1,0,1,1
2022-05-26,Hai Phong City,Hai An District,7,8,7,1,1
2022-05-26,Hai Phong City,Hai An District,8,8,6,2,0
2022-05-26,Hai Phong City,Hai An District,9,14,11,3,0
2022-05-26,Hai Phong City,Hai An District,10,33,27,6,3
2022-05-26,Hai Phong City,Hai An District,11,35,31,4,1
2022-05-26,Hai Phong City,Hai An District,12,21,19,2,0
2022-05-26,Hai Phong City,Hai An District,13,22,19,3,0
2022-05-26,Hai Phong City,Hai An District,14,18,13,5,2
2022-05-26,Hai Phong City,Hai An District,15,17,17,0,0
2022-05-26,Hai Phong City,Hai An District,16,15,13,2,0
2022-05-26,Hai Phong City,Hai An District,17,18,12,6,1
2022-05-26,Hai Phong City,Hai An District,18,20,17,3,0
2022-05-26,Hai Phong City,Hai An District,19,17,11,6,2
2022-05-26,Hai Phong City,Hai An District,20,12,8,4,1
2022-05-26,Hai Phong City,Hai An District,21,12,7,5,2
2022-05-26,Hai Phong City,Hai An District,23,1,0,1,0
2022-05-26,Hai Phong City,Hong Bang District,7,14,11,3,1
2022-05-26,Hai Phong City,Hong Bang District,8,30,27,3,1
2022-05-26,Hai Phong City,Hong Bang District,9,29,23,6,1
2022-05-26,Hai Phong City,Hong Bang District,10,44,39,5,1
2022-05-26,Hai Phong City,Hong Bang District,11,107,98,9,2
2022-05-26,Hai Phong City,Hong Bang District,12,59,50,9,1
2022-05-26,Hai Phong City,Hong Bang District,13,42,41,1,1
2022-05-26,Hai Phong City,Hong Bang District,14,43,38,5,1
2022-05-26,Hai Phong City,Hong Bang District,15,41,40,1,1
2022-05-26,Hai Phong City,Hong Bang District,16,34,32,2,0
2022-05-26,Hai Phong City,Hong Bang District,17,32,31,1,0
2022-05-26,Hai Phong City,Hong Bang District,18,57,46,11,8
2022-05-26,Hai Phong City,Hong Bang District,19,49,42,7,4
2022-05-26,Hai Phong City,Hong Bang District,20,25,20,5,0
2022-05-26,Hai Phong City,Hong Bang District,21,13,7,6,3
2022-05-26,Hai Phong City,Hong Bang District,22,1,0,1,0
2022-05-26,Hai Phong City,Kien An District,7,4,1,3,1
2022-05-26,Hai Phong City,Kien An District,8,2,0,2,2
2022-05-26,Hai Phong City,Kien An District,9,3,1,2,2
2022-05-26,Hai Phong City,Kien An District,10,12,4,8,3
2022-05-26,Hai Phong City,Kien An District,11,13,9,4,2
2022-05-26,Hai Phong City,Kien An District,12,11,6,5,5
2022-05-26,Hai Phong City,Kien An District,13,3,1,2,1
2022-05-26,Hai Phong City,Kien An District,14,13,4,9,9
2022-05-26,Hai Phong City,Kien An District,15,13,4,9,5
2022-05-26,Hai Phong City,Kien An District,16,10,7,3,3
2022-05-26,Hai Phong City,Kien An District,17,6,4,2,0
2022-05-26,Hai Phong City,Kien An District,18,4,4,0,0
2022-05-26,Hai Phong City,Kien An District,19,10,7,3,3
2022-05-26,Hai Phong City,Kien An District,20,7,3,4,4
2022-05-26,Hai Phong City,Kien An District,21,6,2,4,3
2022-05-26,Hai Phong City,Le Chan District,0,1,0,1,1
2022-05-26,Hai Phong City,Le Chan District,5,1,1,0,0
2022-05-26,Hai Phong City,Le Chan District,7,32,28,4,0
2022-05-26,Hai Phong City,Le Chan District,8,69,63,6,0
2022-05-26,Hai Phong City,Le Chan District,9,96,88,8,1
2022-05-26,Hai Phong City,Le Chan District,10,166,156,10,1
2022-05-26,Hai Phong City,Le Chan District,11,303,264,39,15
2022-05-26,Hai Phong City,Le Chan District,12,204,184,20,4
2022-05-26,Hai Phong City,Le Chan District,13,120,105,15,4
2022-05-26,Hai Phong City,Le Chan District,14,153,139,14,8
2022-05-26,Hai Phong City,Le Chan District,15,171,148,23,8
2022-05-26,Hai Phong City,Le Chan District,16,141,124,17,4
2022-05-26,Hai Phong City,Le Chan District,17,154,139,15,3
2022-05-26,Hai Phong City,Le Chan District,18,199,175,24,7
2022-05-26,Hai Phong City,Le Chan District,19,200,166,34,16
2022-05-26,Hai Phong City,Le Chan District,20,110,94,16,5
2022-05-26,Hai Phong City,Le Chan District,21,74,55,19,4
2022-05-26,Hai Phong City,Ngo Quyen District,1,2,1,1,0
2022-05-26,Hai Phong City,Ngo Quyen District,3,1,0,1,0
2022-05-26,Hai Phong City,Ngo Quyen District,5,1,0,1,0
2022-05-26,Hai Phong City,Ngo Quyen District,6,1,0,1,0
2022-05-26,Hai Phong City,Ngo Quyen District,7,26,17,9,2
2022-05-26,Hai Phong City,Ngo Quyen District,8,66,58,8,3
2022-05-26,Hai Phong City,Ngo Quyen District,9,68,63,5,0
2022-05-26,Hai Phong City,Ngo Quyen District,10,124,113,11,1
2022-05-26,Hai Phong City,Ngo Quyen District,11,238,207,31,11
2022-05-26,Hai Phong City,Ngo Quyen District,12,140,131,9,2
2022-05-26,Hai Phong City,Ngo Quyen District,13,98,85,13,2
2022-05-26,Hai Phong City,Ngo Quyen District,14,121,99,22,12
2022-05-26,Hai Phong City,Ngo Quyen District,15,124,105,19,8
2022-05-26,Hai Phong City,Ngo Quyen District,16,120,101,19,3
2022-05-26,Hai Phong City,Ngo Quyen District,17,107,95,12,4
2022-05-26,Hai Phong City,Ngo Quyen District,18,150,129,21,8
2022-05-26,Hai Phong City,Ngo Quyen District,19,179,142,37,15
2022-05-26,Hai Phong City,Ngo Quyen District,20,100,85,15,5
2022-05-26,Hai Phong City,Ngo Quyen District,21,54,35,19,14
2022-05-26,Hai Phong City,Thuy Nguyen,11,3,0,3,3
2022-05-26,Hai Phong City,Thuy Nguyen,12,1,0,1,1
2022-05-26,Hai Phong City,Thuy Nguyen,13,1,0,1,1
2022-05-26,Hai Phong City,Thuy Nguyen,14,6,0,6,6
2022-05-26,Hai Phong City,Thuy Nguyen,15,2,0,2,2
2022-05-26,Hai Phong City,Thuy Nguyen,17,1,0,1,1
2022-05-26,Hai Phong City,Thuy Nguyen,18,1,0,1,1
2022-05-26,Hue City,Hue City,0,1,1,0,0
2022-05-26,Hue City,Hue City,1,1,1,0,0
2022-05-26,Hue City,Hue City,5,7,3,4,1
2022-05-26,Hue City,Hue City,6,62,51,11,3
2022-05-26,Hue City,Hue City,7,191,178,13,0
2022-05-26,Hue City,Hue City,8,317,289,28,1
2022-05-26,Hue City,Hue City,9,267,244,23,0
2022-05-26,Hue City,Hue City,10,392,370,22,0
2022-05-26,Hue City,Hue City,11,848,771,77,9
2022-05-26,Hue City,Hue City,12,475,449,26,2
2022-05-26,Hue City,Hue City,13,335,303,32,1
2022-05-26,Hue City,Hue City,14,335,308,27,3
2022-05-26,Hue City,Hue City,15,393,361,32,4
2022-05-26,Hue City,Hue City,16,383,360,23,1
2022-05-26,Hue City,Hue City,17,541,490,51,4
2022-05-26,Hue City,Hue City,18,685,632,53,0
2022-05-26,Hue City,Hue City,19,587,536,51,2
2022-05-26,Hue City,Hue City,20,471,419,52,4
2022-05-26,Hue City,Hue City,21,285,194,91,23
2022-05-26,Hue City,Hue City,22,5,0,5,0
2022-05-26,Hue City,Hue City,23,1,0,1,0
2022-05-26,Hue City,Huong Thuy,7,1,0,1,1
2022-05-26,Hue City,Huong Thuy,9,2,1,1,1
2022-05-26,Hue City,Huong Thuy,13,1,0,1,1
2022-05-26,Hue City,Huong Thuy,17,1,1,0,0
2022-05-26,Hue City,Huong Thuy,18,3,0,3,3
2022-05-26,Hue City,Huong Thuy,19,3,2,1,1
2022-05-26,Hue City,Huong Tra,19,1,1,0,0
2022-05-26,Hue City,Phu Vang,6,1,0,1,0
2022-05-26,Hue City,Phu Vang,8,2,1,1,1
2022-05-26,Hue City,Phu Vang,9,3,2,1,0
2022-05-26,Hue City,Phu Vang,10,1,1,0,0
2022-05-26,Hue City,Phu Vang,11,1,0,1,0
2022-05-26,Hue City,Phu Vang,12,3,1,2,2
2022-05-26,Hue City,Phu Vang,13,2,0,2,2
2022-05-26,Hue City,Phu Vang,14,6,4,2,2
2022-05-26,Hue City,Phu Vang,15,2,2,0,0
2022-05-26,Hue City,Phu Vang,17,3,2,1,1
2022-05-26,Hue City,Phu Vang,18,2,2,0,0
2022-05-26,Hue City,Phu Vang,19,2,1,1,0
2022-05-26,Hue City,Phu Vang,20,1,1,0,0
2022-05-26,Vung Tau,Ba Ria City,7,5,0,5,5
2022-05-26,Vung Tau,Ba Ria City,8,3,1,2,1
2022-05-26,Vung Tau,Ba Ria City,9,4,3,1,1
2022-05-26,Vung Tau,Ba Ria City,10,4,4,0,0
2022-05-26,Vung Tau,Ba Ria City,11,6,5,1,0
2022-05-26,Vung Tau,Ba Ria City,12,5,4,1,0
2022-05-26,Vung Tau,Ba Ria City,13,3,3,0,0
2022-05-26,Vung Tau,Ba Ria City,14,4,2,2,1
2022-05-26,Vung Tau,Ba Ria City,15,1,1,0,0
2022-05-26,Vung Tau,Ba Ria City,16,2,1,1,1
2022-05-26,Vung Tau,Ba Ria City,17,3,2,1,0
2022-05-26,Vung Tau,Ba Ria City,18,4,4,0,0
2022-05-26,Vung Tau,Ba Ria City,19,2,0,2,2
2022-05-26,Vung Tau,Ba Ria City,20,2,0,2,2
2022-05-26,Vung Tau,Ba Ria City,21,3,0,3,2
2022-05-26,Vung Tau,Vung Tau City,1,2,1,1,0
2022-05-26,Vung Tau,Vung Tau City,5,5,1,4,1
2022-05-26,Vung Tau,Vung Tau City,6,32,24,8,6
2022-05-26,Vung Tau,Vung Tau City,7,93,86,7,2
2022-05-26,Vung Tau,Vung Tau City,8,143,135,8,1
2022-05-26,Vung Tau,Vung Tau City,9,157,150,7,1
2022-05-26,Vung Tau,Vung Tau City,10,185,171,14,1
2022-05-26,Vung Tau,Vung Tau City,11,354,326,28,3
2022-05-26,Vung Tau,Vung Tau City,12,272,260,12,2
2022-05-26,Vung Tau,Vung Tau City,13,187,175,12,2
2022-05-26,Vung Tau,Vung Tau City,14,251,238,13,5
2022-05-26,Vung Tau,Vung Tau City,15,213,200,13,1
2022-05-26,Vung Tau,Vung Tau City,16,188,172,16,3
2022-05-26,Vung Tau,Vung Tau City,17,267,250,17,1
2022-05-26,Vung Tau,Vung Tau City,18,266,247,19,4
2022-05-26,Vung Tau,Vung Tau City,19,235,208,27,3
2022-05-26,Vung Tau,Vung Tau City,20,200,138,62,38
2022-05-26,Vung Tau,Vung Tau City,21,156,26,130,104
2022-05-26,Vung Tau,Vung Tau City,22,5,0,5,0
2022-05-27,Binh Duong,Ben Cat,10,2,0,2,2
2022-05-27,Binh Duong,Ben Cat,12,2,0,2,1
2022-05-27,Binh Duong,Ben Cat,13,4,0,4,2
2022-05-27,Binh Duong,Ben Cat,14,4,0,4,2
2022-05-27,Binh Duong,Ben Cat,16,2,0,2,1
2022-05-27,Binh Duong,Ben Cat,18,1,0,1,1
2022-05-27,Binh Duong,Ben Cat,19,1,1,0,0
2022-05-27,Binh Duong,Ben Cat,21,2,0,2,2
2022-05-27,Binh Duong,Di An,0,1,0,1,0
2022-05-27,Binh Duong,Di An,7,2,1,1,1
2022-05-27,Binh Duong,Di An,8,10,6,4,4
2022-05-27,Binh Duong,Di An,9,14,7,7,2
2022-05-27,Binh Duong,Di An,10,24,17,7,7
2022-05-27,Binh Duong,Di An,11,49,34,15,9
2022-05-27,Binh Duong,Di An,12,44,29,15,13
2022-05-27,Binh Duong,Di An,13,30,18,12,10
2022-05-27,Binh Duong,Di An,14,24,13,11,8
2022-05-27,Binh Duong,Di An,15,17,11,6,2
2022-05-27,Binh Duong,Di An,16,32,17,15,10
2022-05-27,Binh Duong,Di An,17,22,8,14,7
2022-05-27,Binh Duong,Di An,18,43,11,32,28
2022-05-27,Binh Duong,Di An,19,41,8,33,29
2022-05-27,Binh Duong,Di An,20,40,13,27,24
2022-05-27,Binh Duong,Di An,21,24,7,17,13
2022-05-27,Binh Duong,Tan Uyen,8,3,2,1,1
2022-05-27,Binh Duong,Tan Uyen,9,1,0,1,1
2022-05-27,Binh Duong,Tan Uyen,11,6,2,4,3
2022-05-27,Binh Duong,Tan Uyen,12,3,2,1,1
2022-05-27,Binh Duong,Tan Uyen,14,1,1,0,0
2022-05-27,Binh Duong,Tan Uyen,15,5,3,2,1
2022-05-27,Binh Duong,Tan Uyen,16,5,1,4,3
2022-05-27,Binh Duong,Tan Uyen,18,1,0,1,1
2022-05-27,Binh Duong,Tan Uyen,19,2,0,2,2
2022-05-27,Binh Duong,Tan Uyen,20,6,0,6,6
2022-05-27,Binh Duong,Tan Uyen,21,3,0,3,3
2022-05-27,Binh Duong,Thu Dau Mot Town,2,1,1,0,0
2022-05-27,Binh Duong,Thu Dau Mot Town,4,2,1,1,0
2022-05-27,Binh Duong,Thu Dau Mot Town,6,28,22,6,4
2022-05-27,Binh Duong,Thu Dau Mot Town,7,118,103,15,1
2022-05-27,Binh Duong,Thu Dau Mot Town,8,185,173,12,0
2022-05-27,Binh Duong,Thu Dau Mot Town,9,259,238,21,4
2022-05-27,Binh Duong,Thu Dau Mot Town,10,411,388,23,3
2022-05-27,Binh Duong,Thu Dau Mot Town,11,683,651,32,5
2022-05-27,Binh Duong,Thu Dau Mot Town,12,486,449,37,4
2022-05-27,Binh Duong,Thu Dau Mot Town,13,459,445,14,1
2022-05-27,Binh Duong,Thu Dau Mot Town,14,346,328,18,2
2022-05-27,Binh Duong,Thu Dau Mot Town,15,271,255,16,2
2022-05-27,Binh Duong,Thu Dau Mot Town,16,306,283,23,6
2022-05-27,Binh Duong,Thu Dau Mot Town,17,444,351,93,60
2022-05-27,Binh Duong,Thu Dau Mot Town,18,527,325,202,153
2022-05-27,Binh Duong,Thu Dau Mot Town,19,644,326,318,261
2022-05-27,Binh Duong,Thu Dau Mot Town,20,557,239,318,237
2022-05-27,Binh Duong,Thu Dau Mot Town,21,299,132,167,118
2022-05-27,Binh Duong,Thu Dau Mot Town,22,1,0,1,0
2022-05-27,Binh Duong,Thu Dau Mot Town,23,3,0,3,0
2022-05-27,Binh Duong,Thuan An,7,12,4,8,6
2022-05-27,Binh Duong,Thuan An,8,17,8,9,7
2022-05-27,Binh Duong,Thuan An,9,30,23,7,4
2022-05-27,Binh Duong,Thuan An,10,91,45,46,32
2022-05-27,Binh Duong,Thuan An,11,113,70,43,30
2022-05-27,Binh Duong,Thuan An,12,79,63,16,9
2022-05-27,Binh Duong,Thuan An,13,69,49,20,15
2022-05-27,Binh Duong,Thuan An,14,59,48,11,8
2022-05-27,Binh Duong,Thuan An,15,36,29,7,4
2022-05-27,Binh Duong,Thuan An,16,36,30,6,3
2022-05-27,Binh Duong,Thuan An,17,45,19,26,19
2022-05-27,Binh Duong,Thuan An,18,66,21,45,37
2022-05-27,Binh Duong,Thuan An,19,79,12,67,58
2022-05-27,Binh Duong,Thuan An,20,77,19,58,48
2022-05-27,Binh Duong,Thuan An,21,45,13,32,22
2022-05-27,Can Tho City,Binh Thuy District,5,1,1,0,0
2022-05-27,Can Tho City,Binh Thuy District,7,1,1,0,0
2022-05-27,Can Tho City,Binh Thuy District,8,7,4,3,1
2022-05-27,Can Tho City,Binh Thuy District,9,6,6,0,0
2022-05-27,Can Tho City,Binh Thuy District,10,7,7,0,0
2022-05-27,Can Tho City,Binh Thuy District,11,10,9,1,0
2022-05-27,Can Tho City,Binh Thuy District,12,9,8,1,1
2022-05-27,Can Tho City,Binh Thuy District,13,12,9,3,1
2022-05-27,Can Tho City,Binh Thuy District,14,12,11,1,0
2022-05-27,Can Tho City,Binh Thuy District,15,11,10,1,1
2022-05-27,Can Tho City,Binh Thuy District,16,10,10,0,0
2022-05-27,Can Tho City,Binh Thuy District,17,7,7,0,0
2022-05-27,Can Tho City,Binh Thuy District,18,22,20,2,0
2022-05-27,Can Tho City,Binh Thuy District,19,14,13,1,1
2022-05-27,Can Tho City,Binh Thuy District,20,11,9,2,1
2022-05-27,Can Tho City,Binh Thuy District,21,2,0,2,1
2022-05-27,Can Tho City,Cai Rang District,6,2,2,0,0
2022-05-27,Can Tho City,Cai Rang District,7,9,7,2,1
2022-05-27,Can Tho City,Cai Rang District,8,9,8,1,0
2022-05-27,Can Tho City,Cai Rang District,9,9,7,2,1
2022-05-27,Can Tho City,Cai Rang District,10,9,8,1,1
2022-05-27,Can Tho City,Cai Rang District,11,17,16,1,0
2022-05-27,Can Tho City,Cai Rang District,12,10,10,0,0
2022-05-27,Can Tho City,Cai Rang District,13,10,10,0,0
2022-05-27,Can Tho City,Cai Rang District,14,13,8,5,0
2022-05-27,Can Tho City,Cai Rang District,15,8,7,1,0
2022-05-27,Can Tho City,Cai Rang District,16,8,8,0,0
2022-05-27,Can Tho City,Cai Rang District,17,8,7,1,0
2022-05-27,Can Tho City,Cai Rang District,18,12,11,1,0
2022-05-27,Can Tho City,Cai Rang District,19,20,18,2,0
2022-05-27,Can Tho City,Cai Rang District,20,11,9,2,0
2022-05-27,Can Tho City,Ninh Kieu District,0,2,2,0,0
2022-05-27,Can Tho City,Ninh Kieu District,1,1,0,1,0
2022-05-27,Can Tho City,Ninh Kieu District,2,2,2,0,0
2022-05-27,Can Tho City,Ninh Kieu District,3,2,2,0,0
2022-05-27,Can Tho City,Ninh Kieu District,4,1,1,0,0
2022-05-27,Can Tho City,Ninh Kieu District,5,2,1,1,0
2022-05-27,Can Tho City,Ninh Kieu District,6,41,37,4,2
2022-05-27,Can Tho City,Ninh Kieu District,7,112,105,7,0
2022-05-27,Can Tho City,Ninh Kieu District,8,197,186,11,1
2022-05-27,Can Tho City,Ninh Kieu District,9,284,269,15,0
2022-05-27,Can Tho City,Ninh Kieu District,10,513,493,20,0
2022-05-27,Can Tho City,Ninh Kieu District,11,777,741,36,4
2022-05-27,Can Tho City,Ninh Kieu District,12,572,538,34,0
2022-05-27,Can Tho City,Ninh Kieu District,13,499,483,16,0
2022-05-27,Can Tho City,Ninh Kieu District,14,431,410,21,0
2022-05-27,Can Tho City,Ninh Kieu District,15,407,384,23,0
2022-05-27,Can Tho City,Ninh Kieu District,16,446,430,16,0
2022-05-27,Can Tho City,Ninh Kieu District,17,508,485,23,0
2022-05-27,Can Tho City,Ninh Kieu District,18,607,566,41,1
2022-05-27,Can Tho City,Ninh Kieu District,19,519,505,14,1
2022-05-27,Can Tho City,Ninh Kieu District,20,440,420,20,0
2022-05-27,Can Tho City,Ninh Kieu District,21,194,174,20,1
2022-05-27,Can Tho City,Ninh Kieu District,22,2,1,1,0
2022-05-27,Can Tho City,Ninh Kieu District,23,1,1,0,0
2022-05-27,Dong Nai,Bien Hoa City,0,2,2,0,0
2022-05-27,Dong Nai,Bien Hoa City,1,2,2,0,0
2022-05-27,Dong Nai,Bien Hoa City,2,1,1,0,0
2022-05-27,Dong Nai,Bien Hoa City,3,1,1,0,0
2022-05-27,Dong Nai,Bien Hoa City,4,1,0,1,0
2022-05-27,Dong Nai,Bien Hoa City,6,48,24,24,21
2022-05-27,Dong Nai,Bien Hoa City,7,165,142,23,19
2022-05-27,Dong Nai,Bien Hoa City,8,292,243,49,15
2022-05-27,Dong Nai,Bien Hoa City,9,399,355,44,13
2022-05-27,Dong Nai,Bien Hoa City,10,674,616,58,11
2022-05-27,Dong Nai,Bien Hoa City,11,1134,1028,106,40
2022-05-27,Dong Nai,Bien Hoa City,12,922,862,60,14
2022-05-27,Dong Nai,Bien Hoa City,13,803,743,60,16
2022-05-27,Dong Nai,Bien Hoa City,14,646,605,41,10
2022-05-27,Dong Nai,Bien Hoa City,15,548,490,58,17
2022-05-27,Dong Nai,Bien Hoa City,16,600,453,147,96
2022-05-27,Dong Nai,Bien Hoa City,17,690,425,265,197
2022-05-27,Dong Nai,Bien Hoa City,18,931,479,452,378
2022-05-27,Dong Nai,Bien Hoa City,19,1210,427,783,649
2022-05-27,Dong Nai,Bien Hoa City,20,1121,368,753,626
2022-05-27,Dong Nai,Bien Hoa City,21,395,156,239,162
2022-05-27,Dong Nai,Bien Hoa City,22,9,3,6,0
2022-05-27,Dong Nai,Bien Hoa City,23,1,1,0,0
2022-05-27,Dong Nai,Long Khanh,12,1,0,1,1
2022-05-27,Dong Nai,Long Khanh,14,1,0,1,1
2022-05-27,Dong Nai,Long Thanh,9,1,0,1,1
2022-05-27,Dong Nai,Long Thanh,11,3,0,3,3
2022-05-27,Dong Nai,Long Thanh,15,2,0,2,2
2022-05-27,Dong Nai,Long Thanh,16,1,0,1,1
2022-05-27,Dong Nai,Long Thanh,17,1,0,1,1
2022-05-27,Dong Nai,Long Thanh,19,2,0,2,1
2022-05-27,Dong Nai,Long Thanh,21,1,0,1,1
2022-05-27,Dong Nai,Nhon trach,10,1,0,1,0
2022-05-27,Dong Nai,Nhon trach,11,2,0,2,1
2022-05-27,Dong Nai,Nhon trach,18,1,0,1,1
2022-05-27,Dong Nai,Nhon trach,21,1,0,1,1
2022-05-27,Dong Nai,Trang Bom,12,1,0,1,1
2022-05-27,Dong Nai,Trang Bom,13,3,0,3,3
2022-05-27,Dong Nai,Trang Bom,14,1,0,1,1
2022-05-27,Dong Nai,Trang Bom,15,1,0,1,1
2022-05-27,Dong Nai,Trang Bom,19,2,0,2,2
2022-05-27,Dong Nai,Trang Bom,20,1,0,1,1
2022-05-27,Dong Nai,Trang Bom,21,2,0,2,2
2022-05-27,Hai Phong City,An Duong,6,1,1,0,0
2022-05-27,Hai Phong City,An Duong,7,1,1,0,0
2022-05-27,Hai Phong City,An Duong,8,1,0,1,0
2022-05-27,Hai Phong City,An Duong,10,6,3,3,2
2022-05-27,Hai Phong City,An Duong,11,5,3,2,2
2022-05-27,Hai Phong City,An Duong,12,4,3,1,1
2022-05-27,Hai Phong City,An Duong,13,1,0,1,0
2022-05-27,Hai Phong City,An Duong,14,4,0,4,3
2022-05-27,Hai Phong City,An Duong,15,4,2,2,1
2022-05-27,Hai Phong City,An Duong,16,2,1,1,1
2022-05-27,Hai Phong City,An Duong,18,2,0,2,2
2022-05-27,Hai Phong City,An Duong,19,2,2,0,0
2022-05-27,Hai Phong City,An Duong,21,1,0,1,1
2022-05-27,Hai Phong City,Hai An District,7,3,3,0,0
2022-05-27,Hai Phong City,Hai An District,8,16,13,3,1
2022-05-27,Hai Phong City,Hai An District,9,16,10,6,0
2022-05-27,Hai Phong City,Hai An District,10,29,23,6,5
2022-05-27,Hai Phong City,Hai An District,11,50,40,10,3
2022-05-27,Hai Phong City,Hai An District,12,28,23,5,1
2022-05-27,Hai Phong City,Hai An District,13,14,12,2,0
2022-05-27,Hai Phong City,Hai An District,14,28,15,13,8
2022-05-27,Hai Phong City,Hai An District,15,22,17,5,2
2022-05-27,Hai Phong City,Hai An District,16,23,19,4,2
2022-05-27,Hai Phong City,Hai An District,17,18,15,3,0
2022-05-27,Hai Phong City,Hai An District,18,18,17,1,0
2022-05-27,Hai Phong City,Hai An District,19,18,15,3,1
2022-05-27,Hai Phong City,Hai An District,20,24,16,8,4
2022-05-27,Hai Phong City,Hai An District,21,9,8,1,0
2022-05-27,Hai Phong City,Hong Bang District,7,14,12,2,1
2022-05-27,Hai Phong City,Hong Bang District,8,30,20,10,2
2022-05-27,Hai Phong City,Hong Bang District,9,36,29,7,1
2022-05-27,Hai Phong City,Hong Bang District,10,51,45,6,4
2022-05-27,Hai Phong City,Hong Bang District,11,115,89,26,18
2022-05-27,Hai Phong City,Hong Bang District,12,61,47,14,4
2022-05-27,Hai Phong City,Hong Bang District,13,43,36,7,4
2022-05-27,Hai Phong City,Hong Bang District,14,42,29,13,6
2022-05-27,Hai Phong City,Hong Bang District,15,54,38,16,10
2022-05-27,Hai Phong City,Hong Bang District,16,34,25,9,4
2022-05-27,Hai Phong City,Hong Bang District,17,51,42,9,6
2022-05-27,Hai Phong City,Hong Bang District,18,43,40,3,0
2022-05-27,Hai Phong City,Hong Bang District,19,53,42,11,7
2022-05-27,Hai Phong City,Hong Bang District,20,39,28,11,6
2022-05-27,Hai Phong City,Hong Bang District,21,14,9,5,3
2022-05-27,Hai Phong City,Kien An District,7,1,1,0,0
2022-05-27,Hai Phong City,Kien An District,8,2,0,2,2
2022-05-27,Hai Phong City,Kien An District,9,8,5,3,1
2022-05-27,Hai Phong City,Kien An District,10,6,5,1,1
2022-05-27,Hai Phong City,Kien An District,11,15,7,8,7
2022-05-27,Hai Phong City,Kien An District,12,8,4,4,2
2022-05-27,Hai Phong City,Kien An District,13,8,2,6,6
2022-05-27,Hai Phong City,Kien An District,14,19,4,15,10
2022-05-27,Hai Phong City,Kien An District,15,14,10,4,3
2022-05-27,Hai Phong City,Kien An District,16,4,4,0,0
2022-05-27,Hai Phong City,Kien An District,17,2,1,1,1
2022-05-27,Hai Phong City,Kien An District,18,14,6,8,6
2022-05-27,Hai Phong City,Kien An District,19,18,9,9,9
2022-05-27,Hai Phong City,Kien An District,20,16,6,10,7
2022-05-27,Hai Phong City,Kien An District,21,5,0,5,3
2022-05-27,Hai Phong City,Le Chan District,1,1,1,0,0
2022-05-27,Hai Phong City,Le Chan District,3,1,0,1,0
2022-05-27,Hai Phong City,Le Chan District,4,1,0,1,0
2022-05-27,Hai Phong City,Le Chan District,6,3,3,0,0
2022-05-27,Hai Phong City,Le Chan District,7,28,24,4,2
2022-05-27,Hai Phong City,Le Chan District,8,76,68,8,0
2022-05-27,Hai Phong City,Le Chan District,9,88,73,15,1
2022-05-27,Hai Phong City,Le Chan District,10,166,149,17,5
2022-05-27,Hai Phong City,Le Chan District,11,327,286,41,20
2022-05-27,Hai Phong City,Le Chan District,12,223,197,26,7
2022-05-27,Hai Phong City,Le Chan District,13,132,115,17,5
2022-05-27,Hai Phong City,Le Chan District,14,116,102,14,3
2022-05-27,Hai Phong City,Le Chan District,15,165,140,25,11
2022-05-27,Hai Phong City,Le Chan District,16,148,125,23,9
2022-05-27,Hai Phong City,Le Chan District,17,131,118,13,9
2022-05-27,Hai Phong City,Le Chan District,18,228,197,31,10
2022-05-27,Hai Phong City,Le Chan District,19,210,184,26,11
2022-05-27,Hai Phong City,Le Chan District,20,175,132,43,21
2022-05-27,Hai Phong City,Le Chan District,21,84,63,21,11
2022-05-27,Hai Phong City,Ngo Quyen District,0,1,1,0,0
2022-05-27,Hai Phong City,Ngo Quyen District,1,1,0,1,0
2022-05-27,Hai Phong City,Ngo Quyen District,2,1,0,1,0
2022-05-27,Hai Phong City,Ngo Quyen District,6,2,1,1,0
2022-05-27,Hai Phong City,Ngo Quyen District,7,20,15,5,1
2022-05-27,Hai Phong City,Ngo Quyen District,8,68,62,6,0
2022-05-27,Hai Phong City,Ngo Quyen District,9,65,59,6,0
2022-05-27,Hai Phong City,Ngo Quyen District,10,147,134,13,3
2022-05-27,Hai Phong City,Ngo Quyen District,11,243,200,43,18
2022-05-27,Hai Phong City,Ngo Quyen District,12,159,138,21,4
2022-05-27,Hai Phong City,Ngo Quyen District,13,125,110,15,8
2022-05-27,Hai Phong City,Ngo Quyen District,14,116,102,14,6
2022-05-27,Hai Phong City,Ngo Quyen District,15,119,106,13,3
2022-05-27,Hai Phong City,Ngo Quyen District,16,121,107,14,4
2022-05-27,Hai Phong City,Ngo Quyen District,17,113,104,9,2
2022-05-27,Hai Phong City,Ngo Quyen District,18,149,135,14,3
2022-05-27,Hai Phong City,Ngo Quyen District,19,133,108,25,9
2022-05-27,Hai Phong City,Ngo Quyen District,20,129,100,29,16
2022-05-27,Hai Phong City,Ngo Quyen District,21,58,38,20,15
2022-05-27,Hai Phong City,Ngo Quyen District,22,3,1,2,1
2022-05-27,Hai Phong City,Thuy Nguyen,7,1,0,1,1
2022-05-27,Hai Phong City,Thuy Nguyen,8,1,0,1,0
2022-05-27,Hai Phong City,Thuy Nguyen,11,3,2,1,1
2022-05-27,Hai Phong City,Thuy Nguyen,12,1,0,1,1
2022-05-27,Hai Phong City,Thuy Nguyen,13,3,0,3,2
2022-05-27,Hai Phong City,Thuy Nguyen,18,1,0,1,1
2022-05-27,Hue City,Hue City,0,2,2,0,0
2022-05-27,Hue City,Hue City,2,1,1,0,0
2022-05-27,Hue City,Hue City,3,2,1,1,0
2022-05-27,Hue City,Hue City,5,3,3,0,0
2022-05-27,Hue City,Hue City,6,58,51,7,1
2022-05-27,Hue City,Hue City,7,218,196,22,4
2022-05-27,Hue City,Hue City,8,340,313,27,1
2022-05-27,Hue City,Hue City,9,278,255,23,0
2022-05-27,Hue City,Hue City,10,459,415,44,1
2022-05-27,Hue City,Hue City,11,949,879,70,9
2022-05-27,Hue City,Hue City,12,605,561,44,0
2022-05-27,Hue City,Hue City,13,307,284,23,0
2022-05-27,Hue City,Hue City,14,348,314,34,6
2022-05-27,Hue City,Hue City,15,434,387,47,8
2022-05-27,Hue City,Hue City,16,442,405,37,4
2022-05-27,Hue City,Hue City,17,625,575,50,2
2022-05-27,Hue City,Hue City,18,635,587,48,2
2022-05-27,Hue City,Hue City,19,638,576,62,7
2022-05-27,Hue City,Hue City,20,456,411,45,2
2022-05-27,Hue City,Hue City,21,303,234,69,5
2022-05-27,Hue City,Hue City,23,4,3,1,0
2022-05-27,Hue City,Huong Thuy,7,3,2,1,1
2022-05-27,Hue City,Huong Thuy,8,1,1,0,0
2022-05-27,Hue City,Huong Thuy,11,2,2,0,0
2022-05-27,Hue City,Huong Thuy,16,1,1,0,0
2022-05-27,Hue City,Huong Thuy,17,2,2,0,0
2022-05-27,Hue City,Huong Thuy,18,2,1,1,1
2022-05-27,Hue City,Huong Thuy,19,1,1,0,0
2022-05-27,Hue City,Huong Thuy,20,1,0,1,1
2022-05-27,Hue City,Huong Tra,6,1,1,0,0
2022-05-27,Hue City,Phu Vang,7,1,1,0,0
2022-05-27,Hue City,Phu Vang,8,1,1,0,0
2022-05-27,Hue City,Phu Vang,9,3,3,0,0
2022-05-27,Hue City,Phu Vang,11,5,1,4,2
2022-05-27,Hue City,Phu Vang,13,2,1,1,0
2022-05-27,Hue City,Phu Vang,14,6,2,4,2
2022-05-27,Hue City,Phu Vang,15,2,0,2,2
2022-05-27,Hue City,Phu Vang,16,5,4,1,1
2022-05-27,Hue City,Phu Vang,17,4,1,3,3
2022-05-27,Hue City,Phu Vang,18,4,3,1,0
2022-05-27,Hue City,Phu Vang,19,5,5,0,0
2022-05-27,Hue City,Phu Vang,20,5,3,2,1
2022-05-27,Vung Tau,Ba Ria City,7,3,0,3,3
2022-05-27,Vung Tau,Ba Ria City,8,2,0,2,2
2022-05-27,Vung Tau,Ba Ria City,9,10,3,7,6
2022-05-27,Vung Tau,Ba Ria City,10,7,0,7,6
2022-05-27,Vung Tau,Ba Ria City,11,17,6,11,10
2022-05-27,Vung Tau,Ba Ria City,12,8,3,5,2
2022-05-27,Vung Tau,Ba Ria City,13,6,3,3,3
2022-05-27,Vung Tau,Ba Ria City,14,2,0,2,2
2022-05-27,Vung Tau,Ba Ria City,15,19,3,16,13
2022-05-27,Vung Tau,Ba Ria City,16,11,2,9,8
2022-05-27,Vung Tau,Ba Ria City,17,19,2,17,13
2022-05-27,Vung Tau,Ba Ria City,18,21,0,21,18
2022-05-27,Vung Tau,Ba Ria City,19,13,0,13,13
2022-05-27,Vung Tau,Ba Ria City,20,10,0,10,9
2022-05-27,Vung Tau,Ba Ria City,21,5,0,5,5
2022-05-27,Vung Tau,Vung Tau City,0,1,1,0,0
2022-05-27,Vung Tau,Vung Tau City,1,2,1,1,0
2022-05-27,Vung Tau,Vung Tau City,2,1,1,0,0
2022-05-27,Vung Tau,Vung Tau City,5,2,1,1,0
2022-05-27,Vung Tau,Vung Tau City,6,25,21,4,2
2022-05-27,Vung Tau,Vung Tau City,7,89,78,11,2
2022-05-27,Vung Tau,Vung Tau City,8,176,158,18,0
2022-05-27,Vung Tau,Vung Tau City,9,169,162,7,4
2022-05-27,Vung Tau,Vung Tau City,10,201,186,15,3
2022-05-27,Vung Tau,Vung Tau City,11,351,325,26,6
2022-05-27,Vung Tau,Vung Tau City,12,264,250,14,1
2022-05-27,Vung Tau,Vung Tau City,13,188,168,20,2
2022-05-27,Vung Tau,Vung Tau City,14,208,193,15,2
2022-05-27,Vung Tau,Vung Tau City,15,229,200,29,6
2022-05-27,Vung Tau,Vung Tau City,16,253,218,35,10
2022-05-27,Vung Tau,Vung Tau City,17,428,347,81,48
2022-05-27,Vung Tau,Vung Tau City,18,451,298,153,122
2022-05-27,Vung Tau,Vung Tau City,19,461,192,269,231
2022-05-27,Vung Tau,Vung Tau City,20,529,109,420,354
2022-05-27,Vung Tau,Vung Tau City,21,277,59,218,180
2022-05-27,Vung Tau,Vung Tau City,22,5,2,3,0
2022-05-27,Vung Tau,Vung Tau City,23,3,2,1,1
2022-05-28,Binh Duong,Ben Cat,1,1,0,1,1
2022-05-28,Binh Duong,Ben Cat,10,2,0,2,2
2022-05-28,Binh Duong,Ben Cat,12,1,0,1,1
2022-05-28,Binh Duong,Ben Cat,13,2,0,2,2
2022-05-28,Binh Duong,Ben Cat,17,2,2,0,0
2022-05-28,Binh Duong,Ben Cat,18,1,1,0,0
2022-05-28,Binh Duong,Ben Cat,20,1,0,1,1
2022-05-28,Binh Duong,Di An,6,1,0,1,0
2022-05-28,Binh Duong,Di An,7,5,1,4,3
2022-05-28,Binh Duong,Di An,8,19,6,13,11
2022-05-28,Binh Duong,Di An,9,39,10,29,23
2022-05-28,Binh Duong,Di An,10,34,16,18,14
2022-05-28,Binh Duong,Di An,11,50,24,26,20
2022-05-28,Binh Duong,Di An,12,38,28,10,8
2022-05-28,Binh Duong,Di An,13,37,23,14,12
2022-05-28,Binh Duong,Di An,14,29,24,5,2
2022-05-28,Binh Duong,Di An,15,17,8,9,7
2022-05-28,Binh Duong,Di An,16,20,11,9,8
2022-05-28,Binh Duong,Di An,17,50,21,29,28
2022-05-28,Binh Duong,Di An,18,63,23,40,32
2022-05-28,Binh Duong,Di An,19,52,20,32,24
2022-05-28,Binh Duong,Di An,20,37,11,26,19
2022-05-28,Binh Duong,Di An,21,24,7,17,13
2022-05-28,Binh Duong,Di An,23,1,1,0,0
2022-05-28,Binh Duong,Tan Uyen,8,1,1,0,0
2022-05-28,Binh Duong,Tan Uyen,10,6,2,4,2
2022-05-28,Binh Duong,Tan Uyen,11,5,3,2,1
2022-05-28,Binh Duong,Tan Uyen,12,1,1,0,0
2022-05-28,Binh Duong,Tan Uyen,13,2,0,2,2
2022-05-28,Binh Duong,Tan Uyen,14,4,2,2,2
2022-05-28,Binh Duong,Tan Uyen,15,1,0,1,1
2022-05-28,Binh Duong,Tan Uyen,16,1,1,0,0
2022-05-28,Binh Duong,Tan Uyen,17,2,0,2,2
2022-05-28,Binh Duong,Tan Uyen,18,2,0,2,1
2022-05-28,Binh Duong,Tan Uyen,19,2,0,2,1
2022-05-28,Binh Duong,Tan Uyen,20,3,3,0,0
2022-05-28,Binh Duong,Tan Uyen,21,1,0,1,1
2022-05-28,Binh Duong,Thu Dau Mot Town,1,3,1,2,1
2022-05-28,Binh Duong,Thu Dau Mot Town,5,1,0,1,0
2022-05-28,Binh Duong,Thu Dau Mot Town,6,42,31,11,10
2022-05-28,Binh Duong,Thu Dau Mot Town,7,132,127,5,1
2022-05-28,Binh Duong,Thu Dau Mot Town,8,225,208,17,7
2022-05-28,Binh Duong,Thu Dau Mot Town,9,253,233,20,1
2022-05-28,Binh Duong,Thu Dau Mot Town,10,466,438,28,3
2022-05-28,Binh Duong,Thu Dau Mot Town,11,650,599,51,9
2022-05-28,Binh Duong,Thu Dau Mot Town,12,485,467,18,2
2022-05-28,Binh Duong,Thu Dau Mot Town,13,460,440,20,3
2022-05-28,Binh Duong,Thu Dau Mot Town,14,348,330,18,2
2022-05-28,Binh Duong,Thu Dau Mot Town,15,256,225,31,12
2022-05-28,Binh Duong,Thu Dau Mot Town,16,394,279,115,87
2022-05-28,Binh Duong,Thu Dau Mot Town,17,613,406,207,163
2022-05-28,Binh Duong,Thu Dau Mot Town,18,555,474,81,48
2022-05-28,Binh Duong,Thu Dau Mot Town,19,479,430,49,12
2022-05-28,Binh Duong,Thu Dau Mot Town,20,315,276,39,17
2022-05-28,Binh Duong,Thu Dau Mot Town,21,141,127,14,7
2022-05-28,Binh Duong,Thu Dau Mot Town,22,2,0,2,0
2022-05-28,Binh Duong,Thuan An,6,3,0,3,3
2022-05-28,Binh Duong,Thuan An,7,9,4,5,3
2022-05-28,Binh Duong,Thuan An,8,16,11,5,4
2022-05-28,Binh Duong,Thuan An,9,40,28,12,8
2022-05-28,Binh Duong,Thuan An,10,64,42,22,16
2022-05-28,Binh Duong,Thuan An,11,73,60,13,5
2022-05-28,Binh Duong,Thuan An,12,55,47,8,5
2022-05-28,Binh Duong,Thuan An,13,78,54,24,17
2022-05-28,Binh Duong,Thuan An,14,56,46,10,5
2022-05-28,Binh Duong,Thuan An,15,35,21,14,9
2022-05-28,Binh Duong,Thuan An,16,67,23,44,34
2022-05-28,Binh Duong,Thuan An,17,62,36,26,20
2022-05-28,Binh Duong,Thuan An,18,72,50,22,18
2022-05-28,Binh Duong,Thuan An,19,88,50,38,27
2022-05-28,Binh Duong,Thuan An,20,57,25,32,22
2022-05-28,Binh Duong,Thuan An,21,34,7,27,24
2022-05-28,Binh Duong,Thuan An,22,1,0,1,0
2022-05-28,Can Tho City,Binh Thuy District,4,1,1,0,0
2022-05-28,Can Tho City,Binh Thuy District,7,2,2,0,0
2022-05-28,Can Tho City,Binh Thuy District,8,2,2,0,0
2022-05-28,Can Tho City,Binh Thuy District,9,6,6,0,0
2022-05-28,Can Tho City,Binh Thuy District,10,4,4,0,0
2022-05-28,Can Tho City,Binh Thuy District,11,14,11,3,0
2022-05-28,Can Tho City,Binh Thuy District,12,13,13,0,0
2022-05-28,Can Tho City,Binh Thuy District,13,9,8,1,0
2022-05-28,Can Tho City,Binh Thuy District,14,7,7,0,0
2022-05-28,Can Tho City,Binh Thuy District,15,10,9,1,0
2022-05-28,Can Tho City,Binh Thuy District,16,9,9,0,0
2022-05-28,Can Tho City,Binh Thuy District,17,14,13,1,0
2022-05-28,Can Tho City,Binh Thuy District,18,21,21,0,0
2022-05-28,Can Tho City,Binh Thuy District,19,16,16,0,0
2022-05-28,Can Tho City,Binh Thuy District,20,16,13,3,0
2022-05-28,Can Tho City,Binh Thuy District,21,2,1,1,0
2022-05-28,Can Tho City,Cai Rang District,6,5,1,4,3
2022-05-28,Can Tho City,Cai Rang District,7,7,2,5,4
2022-05-28,Can Tho City,Cai Rang District,8,5,4,1,0
2022-05-28,Can Tho City,Cai Rang District,9,15,12,3,0
2022-05-28,Can Tho City,Cai Rang District,10,15,15,0,0
2022-05-28,Can Tho City,Cai Rang District,11,12,9,3,1
2022-05-28,Can Tho City,Cai Rang District,12,18,14,4,1
2022-05-28,Can Tho City,Cai Rang District,13,6,6,0,0
2022-05-28,Can Tho City,Cai Rang District,14,7,7,0,0
2022-05-28,Can Tho City,Cai Rang District,15,11,10,1,0
2022-05-28,Can Tho City,Cai Rang District,16,15,15,0,0
2022-05-28,Can Tho City,Cai Rang District,17,19,18,1,0
2022-05-28,Can Tho City,Cai Rang District,18,15,15,0,0
2022-05-28,Can Tho City,Cai Rang District,19,14,14,0,0
2022-05-28,Can Tho City,Cai Rang District,20,19,16,3,0
2022-05-28,Can Tho City,Cai Rang District,21,4,2,2,1
2022-05-28,Can Tho City,Ninh Kieu District,0,3,3,0,0
2022-05-28,Can Tho City,Ninh Kieu District,2,2,2,0,0
2022-05-28,Can Tho City,Ninh Kieu District,3,1,0,1,0
2022-05-28,Can Tho City,Ninh Kieu District,4,2,1,1,1
2022-05-28,Can Tho City,Ninh Kieu District,5,3,2,1,0
2022-05-28,Can Tho City,Ninh Kieu District,6,62,51,11,6
2022-05-28,Can Tho City,Ninh Kieu District,7,165,127,38,19
2022-05-28,Can Tho City,Ninh Kieu District,8,235,217,18,3
2022-05-28,Can Tho City,Ninh Kieu District,9,288,276,12,1
2022-05-28,Can Tho City,Ninh Kieu District,10,475,458,17,0
2022-05-28,Can Tho City,Ninh Kieu District,11,764,734,30,0
2022-05-28,Can Tho City,Ninh Kieu District,12,580,556,24,0
2022-05-28,Can Tho City,Ninh Kieu District,13,410,391,19,0
2022-05-28,Can Tho City,Ninh Kieu District,14,373,349,24,0
2022-05-28,Can Tho City,Ninh Kieu District,15,360,341,19,0
2022-05-28,Can Tho City,Ninh Kieu District,16,434,412,22,0
2022-05-28,Can Tho City,Ninh Kieu District,17,535,512,23,0
2022-05-28,Can Tho City,Ninh Kieu District,18,551,531,20,0
2022-05-28,Can Tho City,Ninh Kieu District,19,523,494,29,1
2022-05-28,Can Tho City,Ninh Kieu District,20,381,349,32,2
2022-05-28,Can Tho City,Ninh Kieu District,21,266,228,38,6
2022-05-28,Can Tho City,Ninh Kieu District,22,2,0,2,0
2022-05-28,Can Tho City,O Mon District,7,2,1,1,1
2022-05-28,Dong Nai,Bien Hoa City,0,2,1,1,1
2022-05-28,Dong Nai,Bien Hoa City,1,1,0,1,0
2022-05-28,Dong Nai,Bien Hoa City,4,1,1,0,0
2022-05-28,Dong Nai,Bien Hoa City,5,1,0,1,1
2022-05-28,Dong Nai,Bien Hoa City,6,55,30,25,19
2022-05-28,Dong Nai,Bien Hoa City,7,176,136,40,22
2022-05-28,Dong Nai,Bien Hoa City,8,337,292,45,18
2022-05-28,Dong Nai,Bien Hoa City,9,447,408,39,7
2022-05-28,Dong Nai,Bien Hoa City,10,726,674,52,10
2022-05-28,Dong Nai,Bien Hoa City,11,1115,999,116,33
2022-05-28,Dong Nai,Bien Hoa City,12,1020,943,77,19
2022-05-28,Dong Nai,Bien Hoa City,13,733,680,53,9
2022-05-28,Dong Nai,Bien Hoa City,14,633,586,47,8
2022-05-28,Dong Nai,Bien Hoa City,15,581,468,113,72
2022-05-28,Dong Nai,Bien Hoa City,16,698,476,222,149
2022-05-28,Dong Nai,Bien Hoa City,17,1007,738,269,176
2022-05-28,Dong Nai,Bien Hoa City,18,932,752,180,106
2022-05-28,Dong Nai,Bien Hoa City,19,936,734,202,113
2022-05-28,Dong Nai,Bien Hoa City,20,649,457,192,106
2022-05-28,Dong Nai,Bien Hoa City,21,348,189,159,98
2022-05-28,Dong Nai,Bien Hoa City,22,8,2,6,0
2022-05-28,Dong Nai,Bien Hoa City,23,1,1,0,0
2022-05-28,Dong Nai,Cam My,19,1,0,1,1
2022-05-28,Dong Nai,Long Khanh,14,1,0,1,1
2022-05-28,Dong Nai,Long Khanh,19,1,0,1,1
2022-05-28,Dong Nai,Long Thanh,14,2,0,2,2
2022-05-28,Dong Nai,Long Thanh,16,3,0,3,3
2022-05-28,Dong Nai,Long Thanh,17,1,0,1,1
2022-05-28,Dong Nai,Long Thanh,19,2,0,2,2
2022-05-28,Dong Nai,Long Thanh,21,1,0,1,1
2022-05-28,Dong Nai,Nhon trach,15,1,0,1,1
2022-05-28,Dong Nai,Nhon trach,16,1,0,1,0
2022-05-28,Dong Nai,Nhon trach,19,2,0,2,2
2022-05-28,Dong Nai,Trang Bom,11,3,0,3,3
2022-05-28,Dong Nai,Trang Bom,12,2,0,2,2
2022-05-28,Dong Nai,Trang Bom,13,1,1,0,0
2022-05-28,Dong Nai,Trang Bom,21,1,0,1,1
2022-05-28,Hai Phong City,An Duong,7,2,1,1,1
2022-05-28,Hai Phong City,An Duong,9,1,1,0,0
2022-05-28,Hai Phong City,An Duong,10,2,2,0,0
2022-05-28,Hai Phong City,An Duong,11,3,2,1,1
2022-05-28,Hai Phong City,An Duong,12,1,1,0,0
2022-05-28,Hai Phong City,An Duong,13,1,1,0,0
2022-05-28,Hai Phong City,An Duong,14,5,2,3,2
2022-05-28,Hai Phong City,An Duong,15,2,2,0,0
2022-05-28,Hai Phong City,An Duong,16,2,1,1,1
2022-05-28,Hai Phong City,An Duong,17,3,1,2,1
2022-05-28,Hai Phong City,An Duong,18,3,1,2,2
2022-05-28,Hai Phong City,An Duong,20,3,0,3,2
2022-05-28,Hai Phong City,An Duong,21,1,0,1,0
2022-05-28,Hai Phong City,Do Son District,19,1,0,1,1
2022-05-28,Hai Phong City,Duong Kinh District,20,1,0,1,1
2022-05-28,Hai Phong City,Hai An District,1,1,1,0,0
2022-05-28,Hai Phong City,Hai An District,7,3,2,1,0
2022-05-28,Hai Phong City,Hai An District,8,13,10,3,2
2022-05-28,Hai Phong City,Hai An District,9,17,13,4,1
2022-05-28,Hai Phong City,Hai An District,10,19,16,3,0
2022-05-28,Hai Phong City,Hai An District,11,44,35,9,2
2022-05-28,Hai Phong City,Hai An District,12,29,25,4,2
2022-05-28,Hai Phong City,Hai An District,13,29,21,8,3
2022-05-28,Hai Phong City,Hai An District,14,19,13,6,2
2022-05-28,Hai Phong City,Hai An District,15,21,14,7,5
2022-05-28,Hai Phong City,Hai An District,16,22,18,4,1
2022-05-28,Hai Phong City,Hai An District,17,23,23,0,0
2022-05-28,Hai Phong City,Hai An District,18,27,22,5,5
2022-05-28,Hai Phong City,Hai An District,19,32,23,9,5
2022-05-28,Hai Phong City,Hai An District,20,23,14,9,1
2022-05-28,Hai Phong City,Hai An District,21,13,8,5,1
2022-05-28,Hai Phong City,Hong Bang District,7,13,8,5,3
2022-05-28,Hai Phong City,Hong Bang District,8,42,26,16,11
2022-05-28,Hai Phong City,Hong Bang District,9,42,34,8,1
2022-05-28,Hai Phong City,Hong Bang District,10,58,50,8,2
2022-05-28,Hai Phong City,Hong Bang District,11,116,96,20,13
2022-05-28,Hai Phong City,Hong Bang District,12,64,53,11,6
2022-05-28,Hai Phong City,Hong Bang District,13,43,36,7,5
2022-05-28,Hai Phong City,Hong Bang District,14,31,24,7,4
2022-05-28,Hai Phong City,Hong Bang District,15,47,34,13,6
2022-05-28,Hai Phong City,Hong Bang District,16,35,31,4,2
2022-05-28,Hai Phong City,Hong Bang District,17,57,48,9,3
2022-05-28,Hai Phong City,Hong Bang District,18,78,57,21,9
2022-05-28,Hai Phong City,Hong Bang District,19,60,38,22,15
2022-05-28,Hai Phong City,Hong Bang District,20,42,27,15,5
2022-05-28,Hai Phong City,Hong Bang District,21,35,18,17,11
2022-05-28,Hai Phong City,Hong Bang District,23,1,0,1,0
2022-05-28,Hai Phong City,Kien An District,7,3,1,2,1
2022-05-28,Hai Phong City,Kien An District,8,7,1,6,5
2022-05-28,Hai Phong City,Kien An District,9,10,6,4,4
2022-05-28,Hai Phong City,Kien An District,10,18,12,6,6
2022-05-28,Hai Phong City,Kien An District,11,10,8,2,1
2022-05-28,Hai Phong City,Kien An District,12,12,7,5,4
2022-05-28,Hai Phong City,Kien An District,13,6,3,3,3
2022-05-28,Hai Phong City,Kien An District,14,3,2,1,1
2022-05-28,Hai Phong City,Kien An District,15,13,10,3,1
2022-05-28,Hai Phong City,Kien An District,16,8,3,5,4
2022-05-28,Hai Phong City,Kien An District,17,6,5,1,0
2022-05-28,Hai Phong City,Kien An District,18,16,10,6,4
2022-05-28,Hai Phong City,Kien An District,19,12,7,5,1
2022-05-28,Hai Phong City,Kien An District,20,17,6,11,9
2022-05-28,Hai Phong City,Kien An District,21,2,1,1,1
2022-05-28,Hai Phong City,Le Chan District,2,1,1,0,0
2022-05-28,Hai Phong City,Le Chan District,5,2,2,0,0
2022-05-28,Hai Phong City,Le Chan District,6,3,2,1,0
2022-05-28,Hai Phong City,Le Chan District,7,44,28,16,12
2022-05-28,Hai Phong City,Le Chan District,8,79,69,10,4
2022-05-28,Hai Phong City,Le Chan District,9,94,77,17,4
2022-05-28,Hai Phong City,Le Chan District,10,175,156,19,6
2022-05-28,Hai Phong City,Le Chan District,11,338,286,52,20
2022-05-28,Hai Phong City,Le Chan District,12,253,222,31,11
2022-05-28,Hai Phong City,Le Chan District,13,143,126,17,2
2022-05-28,Hai Phong City,Le Chan District,14,154,134,20,5
2022-05-28,Hai Phong City,Le Chan District,15,153,131,22,9
2022-05-28,Hai Phong City,Le Chan District,16,154,133,21,7
2022-05-28,Hai Phong City,Le Chan District,17,172,156,16,2
2022-05-28,Hai Phong City,Le Chan District,18,249,205,44,16
2022-05-28,Hai Phong City,Le Chan District,19,242,181,61,28
2022-05-28,Hai Phong City,Le Chan District,20,183,130,53,37
2022-05-28,Hai Phong City,Le Chan District,21,97,63,34,15
2022-05-28,Hai Phong City,Le Chan District,23,2,0,2,0
2022-05-28,Hai Phong City,Ngo Quyen District,1,1,1,0,0
2022-05-28,Hai Phong City,Ngo Quyen District,2,2,1,1,1
2022-05-28,Hai Phong City,Ngo Quyen District,6,2,2,0,0
2022-05-28,Hai Phong City,Ngo Quyen District,7,24,18,6,4
2022-05-28,Hai Phong City,Ngo Quyen District,8,80,67,13,10
2022-05-28,Hai Phong City,Ngo Quyen District,9,88,79,9,1
2022-05-28,Hai Phong City,Ngo Quyen District,10,143,126,17,4
2022-05-28,Hai Phong City,Ngo Quyen District,11,248,217,31,13
2022-05-28,Hai Phong City,Ngo Quyen District,12,171,156,15,0
2022-05-28,Hai Phong City,Ngo Quyen District,13,114,106,8,2
2022-05-28,Hai Phong City,Ngo Quyen District,14,106,87,19,6
2022-05-28,Hai Phong City,Ngo Quyen District,15,121,107,14,8
2022-05-28,Hai Phong City,Ngo Quyen District,16,109,97,12,2
2022-05-28,Hai Phong City,Ngo Quyen District,17,125,107,18,6
2022-05-28,Hai Phong City,Ngo Quyen District,18,147,128,19,5
2022-05-28,Hai Phong City,Ngo Quyen District,19,164,127,37,19
2022-05-28,Hai Phong City,Ngo Quyen District,20,127,101,26,15
2022-05-28,Hai Phong City,Ngo Quyen District,21,79,60,19,4
2022-05-28,Hai Phong City,Ngo Quyen District,22,1,0,1,0
2022-05-28,Hai Phong City,Thuy Nguyen,11,4,0,4,4
2022-05-28,Hai Phong City,Thuy Nguyen,12,1,0,1,1
2022-05-28,Hai Phong City,Thuy Nguyen,13,1,0,1,1
2022-05-28,Hai Phong City,Thuy Nguyen,14,1,0,1,1
2022-05-28,Hai Phong City,Thuy Nguyen,15,1,0,1,1
2022-05-28,Hai Phong City,Thuy Nguyen,18,1,0,1,1
2022-05-28,Hai Phong City,Thuy Nguyen,19,2,0,2,2
2022-05-28,Hai Phong City,Thuy Nguyen,20,2,0,2,2
2022-05-28,Hue City,Hue City,0,1,1,0,0
2022-05-28,Hue City,Hue City,1,2,1,1,0
2022-05-28,Hue City,Hue City,5,4,4,0,0
2022-05-28,Hue City,Hue City,6,70,65,5,0
2022-05-28,Hue City,Hue City,7,189,179,10,0
2022-05-28,Hue City,Hue City,8,333,303,30,2
2022-05-28,Hue City,Hue City,9,298,274,24,1
2022-05-28,Hue City,Hue City,10,427,398,29,0
2022-05-28,Hue City,Hue City,11,763,714,49,4
2022-05-28,Hue City,Hue City,12,600,563,37,0
2022-05-28,Hue City,Hue City,13,297,275,22,0
2022-05-28,Hue City,Hue City,14,305,275,30,1
2022-05-28,Hue City,Hue City,15,366,339,27,4
2022-05-28,Hue City,Hue City,16,354,327,27,3
2022-05-28,Hue City,Hue City,17,396,374,22,1
2022-05-28,Hue City,Hue City,18,509,461,48,6
2022-05-28,Hue City,Hue City,19,493,445,48,6
2022-05-28,Hue City,Hue City,20,368,331,37,1
2022-05-28,Hue City,Hue City,21,314,228,86,37
2022-05-28,Hue City,Hue City,22,5,2,3,0
2022-05-28,Hue City,Hue City,23,4,3,1,0
2022-05-28,Hue City,Huong Thuy,11,1,0,1,0
2022-05-28,Hue City,Huong Thuy,17,1,1,0,0
2022-05-28,Hue City,Huong Thuy,18,1,1,0,0
2022-05-28,Hue City,Huong Thuy,19,2,1,1,0
2022-05-28,Hue City,Huong Thuy,21,2,1,1,1
2022-05-28,Hue City,Huong Tra,11,1,1,0,0
2022-05-28,Hue City,Huong Tra,18,1,0,1,0
2022-05-28,Hue City,Huong Tra,20,1,1,0,0
2022-05-28,Hue City,Phu Vang,7,2,1,1,1
2022-05-28,Hue City,Phu Vang,8,1,1,0,0
2022-05-28,Hue City,Phu Vang,9,2,2,0,0
2022-05-28,Hue City,Phu Vang,10,3,3,0,0
2022-05-28,Hue City,Phu Vang,11,4,3,1,0
2022-05-28,Hue City,Phu Vang,13,1,0,1,0
2022-05-28,Hue City,Phu Vang,14,1,0,1,1
2022-05-28,Hue City,Phu Vang,15,5,2,3,2
2022-05-28,Hue City,Phu Vang,16,5,1,4,1
2022-05-28,Hue City,Phu Vang,17,1,1,0,0
2022-05-28,Hue City,Phu Vang,18,2,2,0,0
2022-05-28,Hue City,Phu Vang,19,2,2,0,0
2022-05-28,Hue City,Phu Vang,20,2,0,2,0
2022-05-28,Hue City,Phu Vang,21,2,1,1,1
2022-05-28,Vung Tau,Ba Ria City,7,2,0,2,2
2022-05-28,Vung Tau,Ba Ria City,8,3,1,2,1
2022-05-28,Vung Tau,Ba Ria City,9,4,2,2,2
2022-05-28,Vung Tau,Ba Ria City,10,15,7,8,7
2022-05-28,Vung Tau,Ba Ria City,11,3,1,2,2
2022-05-28,Vung Tau,Ba Ria City,12,10,7,3,2
2022-05-28,Vung Tau,Ba Ria City,13,6,3,3,2
2022-05-28,Vung Tau,Ba Ria City,14,11,4,7,3
2022-05-28,Vung Tau,Ba Ria City,15,9,2,7,6
2022-05-28,Vung Tau,Ba Ria City,16,15,6,9,8
2022-05-28,Vung Tau,Ba Ria City,17,8,4,4,3
2022-05-28,Vung Tau,Ba Ria City,18,4,1,3,2
2022-05-28,Vung Tau,Ba Ria City,19,12,4,8,5
2022-05-28,Vung Tau,Ba Ria City,20,7,0,7,6
2022-05-28,Vung Tau,Ba Ria City,21,3,0,3,2
2022-05-28,Vung Tau,Vung Tau City,2,1,1,0,0
2022-05-28,Vung Tau,Vung Tau City,5,1,1,0,0
2022-05-28,Vung Tau,Vung Tau City,6,41,24,17,13
2022-05-28,Vung Tau,Vung Tau City,7,102,84,18,6
2022-05-28,Vung Tau,Vung Tau City,8,184,169,15,3
2022-05-28,Vung Tau,Vung Tau City,9,181,159,22,4
2022-05-28,Vung Tau,Vung Tau City,10,295,266,29,3
2022-05-28,Vung Tau,Vung Tau City,11,359,336,23,2
2022-05-28,Vung Tau,Vung Tau City,12,351,331,20,2
2022-05-28,Vung Tau,Vung Tau City,13,228,214,14,0
2022-05-28,Vung Tau,Vung Tau City,14,234,217,17,1
2022-05-28,Vung Tau,Vung Tau City,15,210,196,14,2
2022-05-28,Vung Tau,Vung Tau City,16,231,203,28,6
2022-05-28,Vung Tau,Vung Tau City,17,361,278,83,57
2022-05-28,Vung Tau,Vung Tau City,18,535,345,190,144
2022-05-28,Vung Tau,Vung Tau City,19,475,268,207,166
2022-05-28,Vung Tau,Vung Tau City,20,381,148,233,185
2022-05-28,Vung Tau,Vung Tau City,21,266,85,181,149
2022-05-28,Vung Tau,Vung Tau City,22,3,2,1,0
2022-05-28,Vung Tau,Vung Tau City,23,1,0,1,1
2022-05-29,Binh Duong,Ben Cat,10,2,0,2,1
2022-05-29,Binh Duong,Ben Cat,11,2,0,2,1
2022-05-29,Binh Duong,Ben Cat,12,3,2,1,1
2022-05-29,Binh Duong,Ben Cat,14,7,0,7,4
2022-05-29,Binh Duong,Ben Cat,15,5,1,4,3
2022-05-29,Binh Duong,Ben Cat,17,1,0,1,1
2022-05-29,Binh Duong,Ben Cat,18,2,0,2,1
2022-05-29,Binh Duong,Ben Cat,19,3,0,3,3
2022-05-29,Binh Duong,Ben Cat,20,1,1,0,0
2022-05-29,Binh Duong,Ben Cat,21,1,0,1,0
2022-05-29,Binh Duong,Di An,3,1,0,1,1
2022-05-29,Binh Duong,Di An,6,1,0,1,1
2022-05-29,Binh Duong,Di An,7,6,3,3,3
2022-05-29,Binh Duong,Di An,8,12,4,8,7
2022-05-29,Binh Duong,Di An,9,24,11,13,10
2022-05-29,Binh Duong,Di An,10,29,21,8,6
2022-05-29,Binh Duong,Di An,11,45,21,24,17
2022-05-29,Binh Duong,Di An,12,66,32,34,30
2022-05-29,Binh Duong,Di An,13,41,21,20,15
2022-05-29,Binh Duong,Di An,14,30,12,18,16
2022-05-29,Binh Duong,Di An,15,33,13,20,18
2022-05-29,Binh Duong,Di An,16,36,13,23,22
2022-05-29,Binh Duong,Di An,17,39,11,28,22
2022-05-29,Binh Duong,Di An,18,48,30,18,12
2022-05-29,Binh Duong,Di An,19,36,17,19,15
2022-05-29,Binh Duong,Di An,20,45,16,29,23
2022-05-29,Binh Duong,Di An,21,22,8,14,13
2022-05-29,Binh Duong,Tan Uyen,8,1,0,1,1
2022-05-29,Binh Duong,Tan Uyen,10,7,2,5,4
2022-05-29,Binh Duong,Tan Uyen,11,1,0,1,1
2022-05-29,Binh Duong,Tan Uyen,12,2,2,0,0
2022-05-29,Binh Duong,Tan Uyen,13,1,1,0,0
2022-05-29,Binh Duong,Tan Uyen,14,1,0,1,1
2022-05-29,Binh Duong,Tan Uyen,15,2,2,0,0
2022-05-29,Binh Duong,Tan Uyen,17,3,0,3,3
2022-05-29,Binh Duong,Tan Uyen,18,4,0,4,4
2022-05-29,Binh Duong,Tan Uyen,20,2,0,2,2
2022-05-29,Binh Duong,Thu Dau Mot Town,3,1,0,1,0
2022-05-29,Binh Duong,Thu Dau Mot Town,5,1,0,1,1
2022-05-29,Binh Duong,Thu Dau Mot Town,6,36,30,6,5
2022-05-29,Binh Duong,Thu Dau Mot Town,7,117,104,13,5
2022-05-29,Binh Duong,Thu Dau Mot Town,8,251,236,15,4
2022-05-29,Binh Duong,Thu Dau Mot Town,9,294,277,17,1
2022-05-29,Binh Duong,Thu Dau Mot Town,10,412,398,14,3
2022-05-29,Binh Duong,Thu Dau Mot Town,11,591,536,55,19
2022-05-29,Binh Duong,Thu Dau Mot Town,12,544,508,36,8
2022-05-29,Binh Duong,Thu Dau Mot Town,13,386,362,24,8
2022-05-29,Binh Duong,Thu Dau Mot Town,14,335,305,30,9
2022-05-29,Binh Duong,Thu Dau Mot Town,15,317,300,17,4
2022-05-29,Binh Duong,Thu Dau Mot Town,16,396,350,46,20
2022-05-29,Binh Duong,Thu Dau Mot Town,17,433,386,47,13
2022-05-29,Binh Duong,Thu Dau Mot Town,18,463,419,44,17
2022-05-29,Binh Duong,Thu Dau Mot Town,19,383,344,39,12
2022-05-29,Binh Duong,Thu Dau Mot Town,20,316,274,42,8
2022-05-29,Binh Duong,Thu Dau Mot Town,21,116,97,19,9
2022-05-29,Binh Duong,Thu Dau Mot Town,22,1,0,1,0
2022-05-29,Binh Duong,Thuan An,6,3,0,3,2
2022-05-29,Binh Duong,Thuan An,7,8,1,7,6
2022-05-29,Binh Duong,Thuan An,8,22,6,16,13
2022-05-29,Binh Duong,Thuan An,9,39,19,20,17
2022-05-29,Binh Duong,Thuan An,10,66,42,24,18
2022-05-29,Binh Duong,Thuan An,11,89,59,30,23
2022-05-29,Binh Duong,Thuan An,12,67,40,27,22
2022-05-29,Binh Duong,Thuan An,13,68,36,32,27
2022-05-29,Binh Duong,Thuan An,14,69,44,25,18
2022-05-29,Binh Duong,Thuan An,15,56,43,13,4
2022-05-29,Binh Duong,Thuan An,16,57,42,15,13
2022-05-29,Binh Duong,Thuan An,17,54,35,19,9
2022-05-29,Binh Duong,Thuan An,18,71,42,29,17
2022-05-29,Binh Duong,Thuan An,19,66,42,24,17
2022-05-29,Binh Duong,Thuan An,20,54,20,34,29
2022-05-29,Binh Duong,Thuan An,21,27,10,17,15
2022-05-29,Can Tho City,Binh Thuy District,6,1,1,0,0
2022-05-29,Can Tho City,Binh Thuy District,7,2,1,1,0
2022-05-29,Can Tho City,Binh Thuy District,8,9,7,2,1
2022-05-29,Can Tho City,Binh Thuy District,9,6,5,1,0
2022-05-29,Can Tho City,Binh Thuy District,10,10,8,2,1
2022-05-29,Can Tho City,Binh Thuy District,11,20,18,2,1
2022-05-29,Can Tho City,Binh Thuy District,12,17,16,1,0
2022-05-29,Can Tho City,Binh Thuy District,13,9,7,2,0
2022-05-29,Can Tho City,Binh Thuy District,14,7,7,0,0
2022-05-29,Can Tho City,Binh Thuy District,15,12,11,1,0
2022-05-29,Can Tho City,Binh Thuy District,16,8,8,0,0
2022-05-29,Can Tho City,Binh Thuy District,17,12,11,1,0
2022-05-29,Can Tho City,Binh Thuy District,18,10,9,1,0
2022-05-29,Can Tho City,Binh Thuy District,19,18,16,2,0
2022-05-29,Can Tho City,Binh Thuy District,20,11,10,1,0
2022-05-29,Can Tho City,Cai Rang District,5,1,0,1,1
2022-05-29,Can Tho City,Cai Rang District,6,6,2,4,4
2022-05-29,Can Tho City,Cai Rang District,7,4,3,1,0
2022-05-29,Can Tho City,Cai Rang District,8,9,7,2,1
2022-05-29,Can Tho City,Cai Rang District,9,18,13,5,3
2022-05-29,Can Tho City,Cai Rang District,10,14,11,3,0
2022-05-29,Can Tho City,Cai Rang District,11,15,15,0,0
2022-05-29,Can Tho City,Cai Rang District,12,13,11,2,0
2022-05-29,Can Tho City,Cai Rang District,13,9,7,2,1
2022-05-29,Can Tho City,Cai Rang District,14,9,8,1,1
2022-05-29,Can Tho City,Cai Rang District,15,4,4,0,0
2022-05-29,Can Tho City,Cai Rang District,16,8,8,0,0
2022-05-29,Can Tho City,Cai Rang District,17,17,14,3,0
2022-05-29,Can Tho City,Cai Rang District,18,21,17,4,1
2022-05-29,Can Tho City,Cai Rang District,19,10,8,2,0
2022-05-29,Can Tho City,Cai Rang District,20,12,10,2,1
2022-05-29,Can Tho City,Cai Rang District,21,4,2,2,2
2022-05-29,Can Tho City,Ninh Kieu District,0,3,2,1,0
2022-05-29,Can Tho City,Ninh Kieu District,3,1,1,0,0
2022-05-29,Can Tho City,Ninh Kieu District,4,1,1,0,0
2022-05-29,Can Tho City,Ninh Kieu District,5,2,2,0,0
2022-05-29,Can Tho City,Ninh Kieu District,6,49,45,4,0
2022-05-29,Can Tho City,Ninh Kieu District,7,122,108,14,2
2022-05-29,Can Tho City,Ninh Kieu District,8,226,203,23,0
2022-05-29,Can Tho City,Ninh Kieu District,9,301,287,14,0
2022-05-29,Can Tho City,Ninh Kieu District,10,533,501,32,3
2022-05-29,Can Tho City,Ninh Kieu District,11,633,585,48,5
2022-05-29,Can Tho City,Ninh Kieu District,12,554,530,24,0
2022-05-29,Can Tho City,Ninh Kieu District,13,413,385,28,0
2022-05-29,Can Tho City,Ninh Kieu District,14,355,339,16,0
2022-05-29,Can Tho City,Ninh Kieu District,15,354,328,26,0
2022-05-29,Can Tho City,Ninh Kieu District,16,362,346,16,0
2022-05-29,Can Tho City,Ninh Kieu District,17,512,498,14,0
2022-05-29,Can Tho City,Ninh Kieu District,18,560,536,24,0
2022-05-29,Can Tho City,Ninh Kieu District,19,520,485,35,0
2022-05-29,Can Tho City,Ninh Kieu District,20,383,360,23,0
2022-05-29,Can Tho City,Ninh Kieu District,21,201,179,22,1
2022-05-29,Can Tho City,O Mon District,11,1,0,1,1
2022-05-29,Can Tho City,Thoi Lai,12,1,0,1,1
2022-05-29,Can Tho City,Thoi Lai,13,1,0,1,1
2022-05-29,Dong Nai,Bien Hoa City,0,1,1,0,0
2022-05-29,Dong Nai,Bien Hoa City,1,1,0,1,1
2022-05-29,Dong Nai,Bien Hoa City,2,1,1,0,0
2022-05-29,Dong Nai,Bien Hoa City,5,1,1,0,0
2022-05-29,Dong Nai,Bien Hoa City,6,54,34,20,12
2022-05-29,Dong Nai,Bien Hoa City,7,170,141,29,16
2022-05-29,Dong Nai,Bien Hoa City,8,360,306,54,23
2022-05-29,Dong Nai,Bien Hoa City,9,477,417,60,17
2022-05-29,Dong Nai,Bien Hoa City,10,801,701,100,44
2022-05-29,Dong Nai,Bien Hoa City,11,1205,975,230,137
2022-05-29,Dong Nai,Bien Hoa City,12,973,760,213,141
2022-05-29,Dong Nai,Bien Hoa City,13,725,639,86,31
2022-05-29,Dong Nai,Bien Hoa City,14,585,521,64,8
2022-05-29,Dong Nai,Bien Hoa City,15,643,561,82,31
2022-05-29,Dong Nai,Bien Hoa City,16,681,543,138,77
2022-05-29,Dong Nai,Bien Hoa City,17,759,651,108,49
2022-05-29,Dong Nai,Bien Hoa City,18,800,689,111,44
2022-05-29,Dong Nai,Bien Hoa City,19,806,649,157,92
2022-05-29,Dong Nai,Bien Hoa City,20,573,390,183,84
2022-05-29,Dong Nai,Bien Hoa City,21,258,134,124,73
2022-05-29,Dong Nai,Bien Hoa City,22,3,0,3,1
2022-05-29,Dong Nai,Long Khanh,16,1,0,1,1
2022-05-29,Dong Nai,Long Khanh,17,2,0,2,2
2022-05-29,Dong Nai,Long Khanh,19,1,0,1,1
2022-05-29,Dong Nai,Long Thanh,8,2,0,2,1
2022-05-29,Dong Nai,Long Thanh,10,1,0,1,0
2022-05-29,Dong Nai,Long Thanh,11,2,0,2,2
2022-05-29,Dong Nai,Long Thanh,12,1,0,1,1
2022-05-29,Dong Nai,Long Thanh,13,2,0,2,0
2022-05-29,Dong Nai,Long Thanh,14,2,0,2,2
2022-05-29,Dong Nai,Long Thanh,16,4,0,4,3
2022-05-29,Dong Nai,Nhon trach,10,1,0,1,1
2022-05-29,Dong Nai,Nhon trach,16,1,0,1,0
2022-05-29,Dong Nai,Trang Bom,10,4,0,4,3
2022-05-29,Dong Nai,Trang Bom,11,2,0,2,2
2022-05-29,Dong Nai,Trang Bom,14,1,0,1,1
2022-05-29,Dong Nai,Trang Bom,19,1,0,1,1
2022-05-29,Hai Phong City,An Duong,7,1,0,1,0
2022-05-29,Hai Phong City,An Duong,8,4,2,2,2
2022-05-29,Hai Phong City,An Duong,9,2,1,1,1
2022-05-29,Hai Phong City,An Duong,10,2,1,1,1
2022-05-29,Hai Phong City,An Duong,11,3,1,2,1
2022-05-29,Hai Phong City,An Duong,12,1,1,0,0
2022-05-29,Hai Phong City,An Duong,13,2,1,1,1
2022-05-29,Hai Phong City,An Duong,14,5,3,2,2
2022-05-29,Hai Phong City,An Duong,15,5,1,4,4
2022-05-29,Hai Phong City,An Duong,16,2,1,1,0
2022-05-29,Hai Phong City,An Duong,18,3,1,2,1
2022-05-29,Hai Phong City,An Duong,19,6,0,6,6
2022-05-29,Hai Phong City,An Duong,20,1,0,1,1
2022-05-29,Hai Phong City,An Duong,21,3,1,2,2
2022-05-29,Hai Phong City,Duong Kinh District,12,1,0,1,1
2022-05-29,Hai Phong City,Hai An District,7,8,5,3,3
2022-05-29,Hai Phong City,Hai An District,8,10,8,2,0
2022-05-29,Hai Phong City,Hai An District,9,13,8,5,1
2022-05-29,Hai Phong City,Hai An District,10,25,21,4,2
2022-05-29,Hai Phong City,Hai An District,11,58,46,12,5
2022-05-29,Hai Phong City,Hai An District,12,35,26,9,4
2022-05-29,Hai Phong City,Hai An District,13,29,17,12,7
2022-05-29,Hai Phong City,Hai An District,14,25,17,8,5
2022-05-29,Hai Phong City,Hai An District,15,20,12,8,6
2022-05-29,Hai Phong City,Hai An District,16,23,15,8,4
2022-05-29,Hai Phong City,Hai An District,17,28,21,7,5
2022-05-29,Hai Phong City,Hai An District,18,23,20,3,2
2022-05-29,Hai Phong City,Hai An District,19,26,19,7,5
2022-05-29,Hai Phong City,Hai An District,20,20,17,3,1
2022-05-29,Hai Phong City,Hai An District,21,15,9,6,3
2022-05-29,Hai Phong City,Hong Bang District,7,14,9,5,3
2022-05-29,Hai Phong City,Hong Bang District,8,26,21,5,3
2022-05-29,Hai Phong City,Hong Bang District,9,34,24,10,7
2022-05-29,Hai Phong City,Hong Bang District,10,92,60,32,16
2022-05-29,Hai Phong City,Hong Bang District,11,171,83,88,68
2022-05-29,Hai Phong City,Hong Bang District,12,140,79,61,50
2022-05-29,Hai Phong City,Hong Bang District,13,69,45,24,20
2022-05-29,Hai Phong City,Hong Bang District,14,45,27,18,11
2022-05-29,Hai Phong City,Hong Bang District,15,53,28,25,22
2022-05-29,Hai Phong City,Hong Bang District,16,39,28,11,9
2022-05-29,Hai Phong City,Hong Bang District,17,51,31,20,17
2022-05-29,Hai Phong City,Hong Bang District,18,67,41,26,17
2022-05-29,Hai Phong City,Hong Bang District,19,78,37,41,31
2022-05-29,Hai Phong City,Hong Bang District,20,53,33,20,12
2022-05-29,Hai Phong City,Hong Bang District,21,20,13,7,5
2022-05-29,Hai Phong City,Kien An District,5,2,0,2,1
2022-05-29,Hai Phong City,Kien An District,6,2,0,2,1
2022-05-29,Hai Phong City,Kien An District,7,3,0,3,2
2022-05-29,Hai Phong City,Kien An District,8,12,1,11,8
2022-05-29,Hai Phong City,Kien An District,9,7,3,4,2
2022-05-29,Hai Phong City,Kien An District,10,16,6,10,10
2022-05-29,Hai Phong City,Kien An District,11,18,9,9,9
2022-05-29,Hai Phong City,Kien An District,12,13,2,11,9
2022-05-29,Hai Phong City,Kien An District,13,13,3,10,9
2022-05-29,Hai Phong City,Kien An District,14,20,6,14,14
2022-05-29,Hai Phong City,Kien An District,15,17,5,12,9
2022-05-29,Hai Phong City,Kien An District,16,4,2,2,1
2022-05-29,Hai Phong City,Kien An District,17,3,1,2,2
2022-05-29,Hai Phong City,Kien An District,18,15,12,3,1
2022-05-29,Hai Phong City,Kien An District,19,14,8,6,6
2022-05-29,Hai Phong City,Kien An District,20,7,5,2,1
2022-05-29,Hai Phong City,Kien An District,21,3,2,1,1
2022-05-29,Hai Phong City,Kien An District,22,1,0,1,0
2022-05-29,Hai Phong City,Le Chan District,2,1,1,0,0
2022-05-29,Hai Phong City,Le Chan District,4,1,0,1,0
2022-05-29,Hai Phong City,Le Chan District,6,3,1,2,1
2022-05-29,Hai Phong City,Le Chan District,7,57,35,22,12
2022-05-29,Hai Phong City,Le Chan District,8,75,59,16,6
2022-05-29,Hai Phong City,Le Chan District,9,101,85,16,6
2022-05-29,Hai Phong City,Le Chan District,10,207,164,43,17
2022-05-29,Hai Phong City,Le Chan District,11,446,259,187,155
2022-05-29,Hai Phong City,Le Chan District,12,324,191,133,112
2022-05-29,Hai Phong City,Le Chan District,13,179,121,58,39
2022-05-29,Hai Phong City,Le Chan District,14,191,111,80,47
2022-05-29,Hai Phong City,Le Chan District,15,218,141,77,50
2022-05-29,Hai Phong City,Le Chan District,16,202,136,66,46
2022-05-29,Hai Phong City,Le Chan District,17,224,162,62,45
2022-05-29,Hai Phong City,Le Chan District,18,246,162,84,54
2022-05-29,Hai Phong City,Le Chan District,19,250,158,92,69
2022-05-29,Hai Phong City,Le Chan District,20,156,100,56,41
2022-05-29,Hai Phong City,Le Chan District,21,95,59,36,18
2022-05-29,Hai Phong City,Ngo Quyen District,0,1,0,1,1
2022-05-29,Hai Phong City,Ngo Quyen District,6,5,1,4,2
2022-05-29,Hai Phong City,Ngo Quyen District,7,30,19,11,11
2022-05-29,Hai Phong City,Ngo Quyen District,8,65,51,14,4
2022-05-29,Hai Phong City,Ngo Quyen District,9,82,79,3,3
2022-05-29,Hai Phong City,Ngo Quyen District,10,192,150,42,23
2022-05-29,Hai Phong City,Ngo Quyen District,11,318,203,115,85
2022-05-29,Hai Phong City,Ngo Quyen District,12,266,177,89,66
2022-05-29,Hai Phong City,Ngo Quyen District,13,153,108,45,27
2022-05-29,Hai Phong City,Ngo Quyen District,14,139,88,51,32
2022-05-29,Hai Phong City,Ngo Quyen District,15,149,88,61,42
2022-05-29,Hai Phong City,Ngo Quyen District,16,164,116,48,32
2022-05-29,Hai Phong City,Ngo Quyen District,17,160,110,50,34
2022-05-29,Hai Phong City,Ngo Quyen District,18,200,129,71,47
2022-05-29,Hai Phong City,Ngo Quyen District,19,202,141,61,35
2022-05-29,Hai Phong City,Ngo Quyen District,20,116,82,34,20
2022-05-29,Hai Phong City,Ngo Quyen District,21,64,43,21,10
2022-05-29,Hai Phong City,Thuy Nguyen,9,2,0,2,1
2022-05-29,Hai Phong City,Thuy Nguyen,10,1,0,1,1
2022-05-29,Hai Phong City,Thuy Nguyen,11,1,0,1,1
2022-05-29,Hai Phong City,Thuy Nguyen,12,2,0,2,2
2022-05-29,Hai Phong City,Thuy Nguyen,13,3,0,3,2
2022-05-29,Hai Phong City,Thuy Nguyen,14,1,0,1,1
2022-05-29,Hai Phong City,Thuy Nguyen,15,1,0,1,1
2022-05-29,Hai Phong City,Thuy Nguyen,16,1,0,1,1
2022-05-29,Hai Phong City,Thuy Nguyen,17,1,0,1,1
2022-05-29,Hai Phong City,Thuy Nguyen,21,2,0,2,2
2022-05-29,Hue City,Hue City,0,3,3,0,0
2022-05-29,Hue City,Hue City,1,2,1,1,0
2022-05-29,Hue City,Hue City,3,2,0,2,0
2022-05-29,Hue City,Hue City,5,1,0,1,0
2022-05-29,Hue City,Hue City,6,52,42,10,4
2022-05-29,Hue City,Hue City,7,196,179,17,3
2022-05-29,Hue City,Hue City,8,311,284,27,1
2022-05-29,Hue City,Hue City,9,298,280,18,0
2022-05-29,Hue City,Hue City,10,486,453,33,0
2022-05-29,Hue City,Hue City,11,789,727,62,3
2022-05-29,Hue City,Hue City,12,528,492,36,0
2022-05-29,Hue City,Hue City,13,321,289,32,0
2022-05-29,Hue City,Hue City,14,320,291,29,3
2022-05-29,Hue City,Hue City,15,374,343,31,6
2022-05-29,Hue City,Hue City,16,379,350,29,5
2022-05-29,Hue City,Hue City,17,416,388,28,2
2022-05-29,Hue City,Hue City,18,565,521,44,3
2022-05-29,Hue City,Hue City,19,568,502,66,5
2022-05-29,Hue City,Hue City,20,475,386,89,30
2022-05-29,Hue City,Hue City,21,268,200,68,19
2022-05-29,Hue City,Hue City,22,2,0,2,1
2022-05-29,Hue City,Hue City,23,3,0,3,0
2022-05-29,Hue City,Huong Thuy,7,1,1,0,0
2022-05-29,Hue City,Huong Thuy,9,2,1,1,0
2022-05-29,Hue City,Huong Thuy,10,3,1,2,2
2022-05-29,Hue City,Huong Thuy,11,1,1,0,0
2022-05-29,Hue City,Huong Thuy,12,2,1,1,1
2022-05-29,Hue City,Huong Thuy,16,1,1,0,0
2022-05-29,Hue City,Huong Thuy,17,1,1,0,0
2022-05-29,Hue City,Huong Thuy,18,1,1,0,0
2022-05-29,Hue City,Huong Thuy,20,1,1,0,0
2022-05-29,Hue City,Huong Thuy,21,1,0,1,0
2022-05-29,Hue City,Huong Tra,8,1,1,0,0
2022-05-29,Hue City,Huong Tra,9,1,1,0,0
2022-05-29,Hue City,Huong Tra,12,1,0,1,0
2022-05-29,Hue City,Phu Vang,7,1,0,1,0
2022-05-29,Hue City,Phu Vang,8,2,2,0,0
2022-05-29,Hue City,Phu Vang,9,2,1,1,1
2022-05-29,Hue City,Phu Vang,10,1,1,0,0
2022-05-29,Hue City,Phu Vang,11,3,2,1,0
2022-05-29,Hue City,Phu Vang,12,2,2,0,0
2022-05-29,Hue City,Phu Vang,13,3,1,2,2
2022-05-29,Hue City,Phu Vang,16,4,4,0,0
2022-05-29,Hue City,Phu Vang,17,2,2,0,0
2022-05-29,Hue City,Phu Vang,18,4,1,3,0
2022-05-29,Hue City,Phu Vang,19,1,1,0,0
2022-05-29,Hue City,Phu Vang,20,3,1,2,2
2022-05-29,Vung Tau,Ba Ria City,6,1,0,1,1
2022-05-29,Vung Tau,Ba Ria City,7,1,0,1,1
2022-05-29,Vung Tau,Ba Ria City,8,3,1,2,2
2022-05-29,Vung Tau,Ba Ria City,9,2,2,0,0
2022-05-29,Vung Tau,Ba Ria City,10,14,6,8,7
2022-05-29,Vung Tau,Ba Ria City,11,10,6,4,2
2022-05-29,Vung Tau,Ba Ria City,12,11,5,6,5
2022-05-29,Vung Tau,Ba Ria City,13,15,1,14,14
2022-05-29,Vung Tau,Ba Ria City,14,7,0,7,7
2022-05-29,Vung Tau,Ba Ria City,15,8,3,5,4
2022-05-29,Vung Tau,Ba Ria City,16,11,4,7,7
2022-05-29,Vung Tau,Ba Ria City,17,5,4,1,1
2022-05-29,Vung Tau,Ba Ria City,18,8,2,6,5
2022-05-29,Vung Tau,Ba Ria City,19,4,3,1,1
2022-05-29,Vung Tau,Ba Ria City,20,4,0,4,3
2022-05-29,Vung Tau,Vung Tau City,1,2,2,0,0
2022-05-29,Vung Tau,Vung Tau City,3,1,1,0,0
2022-05-29,Vung Tau,Vung Tau City,5,1,1,0,0
2022-05-29,Vung Tau,Vung Tau City,6,42,33,9,5
2022-05-29,Vung Tau,Vung Tau City,7,112,92,20,10
2022-05-29,Vung Tau,Vung Tau City,8,199,183,16,5
2022-05-29,Vung Tau,Vung Tau City,9,223,212,11,0
2022-05-29,Vung Tau,Vung Tau City,10,300,279,21,1
2022-05-29,Vung Tau,Vung Tau City,11,400,371,29,7
2022-05-29,Vung Tau,Vung Tau City,12,372,324,48,2
2022-05-29,Vung Tau,Vung Tau City,13,250,228,22,1
2022-05-29,Vung Tau,Vung Tau City,14,225,219,6,1
2022-05-29,Vung Tau,Vung Tau City,15,250,228,22,2
2022-05-29,Vung Tau,Vung Tau City,16,251,234,17,1
2022-05-29,Vung Tau,Vung Tau City,17,294,269,25,1
2022-05-29,Vung Tau,Vung Tau City,18,354,311,43,20
2022-05-29,Vung Tau,Vung Tau City,19,317,249,68,38
2022-05-29,Vung Tau,Vung Tau City,20,196,146,50,25
2022-05-29,Vung Tau,Vung Tau City,21,112,75,37,28
2022-05-30,Binh Duong,Ben Cat,13,2,0,2,2
2022-05-30,Binh Duong,Di An,6,1,0,1,1
2022-05-30,Binh Duong,Di An,7,7,3,4,2
2022-05-30,Binh Duong,Di An,8,12,5,7,5
2022-05-30,Binh Duong,Di An,9,17,9,8,6
2022-05-30,Binh Duong,Di An,10,35,20,15,13
2022-05-30,Binh Duong,Di An,11,62,23,39,32
2022-05-30,Binh Duong,Di An,12,51,24,27,23
2022-05-30,Binh Duong,Di An,13,33,19,14,10
2022-05-30,Binh Duong,Di An,14,33,14,19,15
2022-05-30,Binh Duong,Di An,15,26,20,6,4
2022-05-30,Binh Duong,Di An,16,13,9,4,0
2022-05-30,Binh Duong,Di An,17,31,18,13,7
2022-05-30,Binh Duong,Di An,18,23,20,3,3
2022-05-30,Binh Duong,Di An,19,31,22,9,5
2022-05-30,Binh Duong,Di An,20,28,13,15,9
2022-05-30,Binh Duong,Di An,21,10,3,7,5
2022-05-30,Binh Duong,Di An,22,1,0,1,0
2022-05-30,Binh Duong,Phu Giao,13,1,0,1,0
2022-05-30,Binh Duong,Tan Uyen,7,1,0,1,1
2022-05-30,Binh Duong,Tan Uyen,9,1,1,0,0
2022-05-30,Binh Duong,Tan Uyen,11,3,2,1,1
2022-05-30,Binh Duong,Tan Uyen,12,4,3,1,1
2022-05-30,Binh Duong,Tan Uyen,14,3,0,3,3
2022-05-30,Binh Duong,Tan Uyen,15,2,2,0,0
2022-05-30,Binh Duong,Tan Uyen,16,2,1,1,1
2022-05-30,Binh Duong,Tan Uyen,17,3,0,3,3
2022-05-30,Binh Duong,Tan Uyen,18,1,1,0,0
2022-05-30,Binh Duong,Tan Uyen,19,3,1,2,2
2022-05-30,Binh Duong,Tan Uyen,20,1,0,1,0
2022-05-30,Binh Duong,Tan Uyen,21,3,0,3,3
2022-05-30,Binh Duong,Thu Dau Mot Town,0,2,1,1,0
2022-05-30,Binh Duong,Thu Dau Mot Town,6,33,27,6,2
2022-05-30,Binh Duong,Thu Dau Mot Town,7,134,124,10,1
2022-05-30,Binh Duong,Thu Dau Mot Town,8,225,212,13,1
2022-05-30,Binh Duong,Thu Dau Mot Town,9,239,222,17,3
2022-05-30,Binh Duong,Thu Dau Mot Town,10,415,390,25,6
2022-05-30,Binh Duong,Thu Dau Mot Town,11,583,557,26,5
2022-05-30,Binh Duong,Thu Dau Mot Town,12,463,435,28,4
2022-05-30,Binh Duong,Thu Dau Mot Town,13,437,413,24,4
2022-05-30,Binh Duong,Thu Dau Mot Town,14,314,295,19,3
2022-05-30,Binh Duong,Thu Dau Mot Town,15,251,240,11,2
2022-05-30,Binh Duong,Thu Dau Mot Town,16,253,237,16,2
2022-05-30,Binh Duong,Thu Dau Mot Town,17,317,307,10,1
2022-05-30,Binh Duong,Thu Dau Mot Town,18,354,327,27,1
2022-05-30,Binh Duong,Thu Dau Mot Town,19,338,305,33,5
2022-05-30,Binh Duong,Thu Dau Mot Town,20,293,273,20,2
2022-05-30,Binh Duong,Thu Dau Mot Town,21,119,96,23,4
2022-05-30,Binh Duong,Thu Dau Mot Town,22,1,0,1,0
2022-05-30,Binh Duong,Thuan An,6,5,1,4,4
2022-05-30,Binh Duong,Thuan An,7,8,3,5,4
2022-05-30,Binh Duong,Thuan An,8,19,6,13,11
2022-05-30,Binh Duong,Thuan An,9,26,20,6,1
2022-05-30,Binh Duong,Thuan An,10,65,52,13,8
2022-05-30,Binh Duong,Thuan An,11,93,62,31,22
2022-05-30,Binh Duong,Thuan An,12,79,47,32,23
2022-05-30,Binh Duong,Thuan An,13,59,40,19,18
2022-05-30,Binh Duong,Thuan An,14,48,22,26,22
2022-05-30,Binh Duong,Thuan An,15,62,46,16,10
2022-05-30,Binh Duong,Thuan An,16,48,35,13,9
2022-05-30,Binh Duong,Thuan An,17,43,31,12,8
2022-05-30,Binh Duong,Thuan An,18,44,38,6,3
2022-05-30,Binh Duong,Thuan An,19,46,35,11,9
2022-05-30,Binh Duong,Thuan An,20,48,23,25,16
2022-05-30,Binh Duong,Thuan An,21,18,8,10,9
2022-05-30,Can Tho City,Binh Thuy District,5,1,1,0,0
2022-05-30,Can Tho City,Binh Thuy District,7,3,0,3,0
2022-05-30,Can Tho City,Binh Thuy District,8,4,4,0,0
2022-05-30,Can Tho City,Binh Thuy District,9,6,6,0,0
2022-05-30,Can Tho City,Binh Thuy District,10,6,5,1,1
2022-05-30,Can Tho City,Binh Thuy District,11,26,23,3,1
2022-05-30,Can Tho City,Binh Thuy District,12,11,10,1,0
2022-05-30,Can Tho City,Binh Thuy District,13,10,10,0,0
2022-05-30,Can Tho City,Binh Thuy District,14,8,7,1,1
2022-05-30,Can Tho City,Binh Thuy District,15,8,7,1,1
2022-05-30,Can Tho City,Binh Thuy District,16,12,12,0,0
2022-05-30,Can Tho City,Binh Thuy District,17,20,20,0,0
2022-05-30,Can Tho City,Binh Thuy District,18,23,22,1,0
2022-05-30,Can Tho City,Binh Thuy District,19,16,15,1,1
2022-05-30,Can Tho City,Binh Thuy District,20,17,15,2,1
2022-05-30,Can Tho City,Binh Thuy District,21,4,3,1,0
2022-05-30,Can Tho City,Cai Rang District,3,1,1,0,0
2022-05-30,Can Tho City,Cai Rang District,6,8,3,5,4
2022-05-30,Can Tho City,Cai Rang District,7,5,2,3,1
2022-05-30,Can Tho City,Cai Rang District,8,8,5,3,1
2022-05-30,Can Tho City,Cai Rang District,9,15,14,1,1
2022-05-30,Can Tho City,Cai Rang District,10,3,3,0,0
2022-05-30,Can Tho City,Cai Rang District,11,10,10,0,0
2022-05-30,Can Tho City,Cai Rang District,12,15,14,1,0
2022-05-30,Can Tho City,Cai Rang District,13,9,9,0,0
2022-05-30,Can Tho City,Cai Rang District,14,12,11,1,0
2022-05-30,Can Tho City,Cai Rang District,15,12,10,2,0
2022-05-30,Can Tho City,Cai Rang District,16,12,11,1,0
2022-05-30,Can Tho City,Cai Rang District,17,12,11,1,0
2022-05-30,Can Tho City,Cai Rang District,18,11,11,0,0
2022-05-30,Can Tho City,Cai Rang District,19,28,23,5,0
2022-05-30,Can Tho City,Cai Rang District,20,6,4,2,1
2022-05-30,Can Tho City,Cai Rang District,21,5,3,2,1
2022-05-30,Can Tho City,Ninh Kieu District,0,2,1,1,1
2022-05-30,Can Tho City,Ninh Kieu District,2,1,1,0,0
2022-05-30,Can Tho City,Ninh Kieu District,4,1,1,0,0
2022-05-30,Can Tho City,Ninh Kieu District,5,3,2,1,1
2022-05-30,Can Tho City,Ninh Kieu District,6,55,49,6,1
2022-05-30,Can Tho City,Ninh Kieu District,7,98,95,3,0
2022-05-30,Can Tho City,Ninh Kieu District,8,217,200,17,0
2022-05-30,Can Tho City,Ninh Kieu District,9,256,245,11,0
2022-05-30,Can Tho City,Ninh Kieu District,10,453,422,31,1
2022-05-30,Can Tho City,Ninh Kieu District,11,784,740,44,6
2022-05-30,Can Tho City,Ninh Kieu District,12,541,514,27,0
2022-05-30,Can Tho City,Ninh Kieu District,13,419,394,25,0
2022-05-30,Can Tho City,Ninh Kieu District,14,352,333,19,0
2022-05-30,Can Tho City,Ninh Kieu District,15,335,315,20,0
2022-05-30,Can Tho City,Ninh Kieu District,16,473,451,22,2
2022-05-30,Can Tho City,Ninh Kieu District,17,690,653,37,12
2022-05-30,Can Tho City,Ninh Kieu District,18,737,689,48,12
2022-05-30,Can Tho City,Ninh Kieu District,19,659,600,59,11
2022-05-30,Can Tho City,Ninh Kieu District,20,404,379,25,3
2022-05-30,Can Tho City,Ninh Kieu District,21,217,187,30,3
2022-05-30,Can Tho City,Ninh Kieu District,22,2,0,2,0
2022-05-30,Dong Nai,Bien Hoa City,0,4,0,4,0
2022-05-30,Dong Nai,Bien Hoa City,1,1,1,0,0
2022-05-30,Dong Nai,Bien Hoa City,2,3,3,0,0
2022-05-30,Dong Nai,Bien Hoa City,5,7,3,4,0
2022-05-30,Dong Nai,Bien Hoa City,6,38,18,20,17
2022-05-30,Dong Nai,Bien Hoa City,7,179,151,28,12
2022-05-30,Dong Nai,Bien Hoa City,8,306,271,35,13
2022-05-30,Dong Nai,Bien Hoa City,9,403,362,41,7
2022-05-30,Dong Nai,Bien Hoa City,10,793,713,80,18
2022-05-30,Dong Nai,Bien Hoa City,11,1173,1041,132,44
2022-05-30,Dong Nai,Bien Hoa City,12,950,861,89,33
2022-05-30,Dong Nai,Bien Hoa City,13,820,754,66,15
2022-05-30,Dong Nai,Bien Hoa City,14,638,592,46,3
2022-05-30,Dong Nai,Bien Hoa City,15,482,437,45,6
2022-05-30,Dong Nai,Bien Hoa City,16,481,426,55,8
2022-05-30,Dong Nai,Bien Hoa City,17,586,534,52,11
2022-05-30,Dong Nai,Bien Hoa City,18,653,604,49,8
2022-05-30,Dong Nai,Bien Hoa City,19,655,595,60,9
2022-05-30,Dong Nai,Bien Hoa City,20,449,385,64,25
2022-05-30,Dong Nai,Bien Hoa City,21,244,152,92,35
2022-05-30,Dong Nai,Bien Hoa City,22,1,0,1,0
2022-05-30,Dong Nai,Long Khanh,8,1,0,1,1
2022-05-30,Dong Nai,Long Khanh,19,1,0,1,1
2022-05-30,Dong Nai,Long Thanh,10,1,0,1,1
2022-05-30,Dong Nai,Long Thanh,11,1,0,1,1
2022-05-30,Dong Nai,Long Thanh,12,1,0,1,1
2022-05-30,Dong Nai,Long Thanh,13,1,0,1,1
2022-05-30,Dong Nai,Long Thanh,15,2,0,2,2
2022-05-30,Dong Nai,Long Thanh,17,1,0,1,1
2022-05-30,Dong Nai,Long Thanh,19,1,0,1,1
2022-05-30,Dong Nai,Nhon trach,11,1,0,1,0
2022-05-30,Dong Nai,Nhon trach,15,2,0,2,2
2022-05-30,Dong Nai,Nhon trach,20,1,0,1,1
2022-05-30,Dong Nai,Trang Bom,11,1,0,1,1
2022-05-30,Dong Nai,Trang Bom,12,4,0,4,4
2022-05-30,Dong Nai,Trang Bom,15,1,0,1,1
2022-05-30,Dong Nai,Trang Bom,17,1,0,1,1
2022-05-30,Dong Nai,Trang Bom,19,1,0,1,1
2022-05-30,Dong Nai,Trang Bom,21,1,0,1,1
2022-05-30,Hai Phong City,An Duong,9,1,0,1,1
2022-05-30,Hai Phong City,An Duong,10,1,0,1,1
2022-05-30,Hai Phong City,An Duong,11,4,3,1,1
2022-05-30,Hai Phong City,An Duong,12,6,3,3,3
2022-05-30,Hai Phong City,An Duong,13,3,1,2,2
2022-05-30,Hai Phong City,An Duong,14,1,0,1,1
2022-05-30,Hai Phong City,An Duong,15,5,2,3,3
2022-05-30,Hai Phong City,An Duong,16,6,2,4,2
2022-05-30,Hai Phong City,An Duong,17,2,1,1,1
2022-05-30,Hai Phong City,An Duong,18,1,0,1,0
2022-05-30,Hai Phong City,An Duong,19,4,1,3,1
2022-05-30,Hai Phong City,An Duong,20,3,1,2,1
2022-05-30,Hai Phong City,An Duong,21,1,1,0,0
2022-05-30,Hai Phong City,Duong Kinh District,16,1,0,1,0
2022-05-30,Hai Phong City,Hai An District,7,4,3,1,1
2022-05-30,Hai Phong City,Hai An District,8,15,10,5,2
2022-05-30,Hai Phong City,Hai An District,9,15,13,2,1
2022-05-30,Hai Phong City,Hai An District,10,19,14,5,1
2022-05-30,Hai Phong City,Hai An District,11,47,33,14,12
2022-05-30,Hai Phong City,Hai An District,12,41,30,11,8
2022-05-30,Hai Phong City,Hai An District,13,19,16,3,0
2022-05-30,Hai Phong City,Hai An District,14,22,13,9,5
2022-05-30,Hai Phong City,Hai An District,15,13,9,4,4
2022-05-30,Hai Phong City,Hai An District,16,19,11,8,3
2022-05-30,Hai Phong City,Hai An District,17,22,17,5,0
2022-05-30,Hai Phong City,Hai An District,18,22,15,7,2
2022-05-30,Hai Phong City,Hai An District,19,23,19,4,2
2022-05-30,Hai Phong City,Hai An District,20,17,12,5,0
2022-05-30,Hai Phong City,Hai An District,21,16,7,9,5
2022-05-30,Hai Phong City,Hong Bang District,1,1,1,0,0
2022-05-30,Hai Phong City,Hong Bang District,7,12,9,3,3
2022-05-30,Hai Phong City,Hong Bang District,8,28,21,7,3
2022-05-30,Hai Phong City,Hong Bang District,9,36,29,7,3
2022-05-30,Hai Phong City,Hong Bang District,10,67,55,12,6
2022-05-30,Hai Phong City,Hong Bang District,11,112,82,30,24
2022-05-30,Hai Phong City,Hong Bang District,12,52,44,8,5
2022-05-30,Hai Phong City,Hong Bang District,13,43,32,11,7
2022-05-30,Hai Phong City,Hong Bang District,14,49,34,15,10
2022-05-30,Hai Phong City,Hong Bang District,15,35,26,9,5
2022-05-30,Hai Phong City,Hong Bang District,16,36,30,6,3
2022-05-30,Hai Phong City,Hong Bang District,17,54,48,6,2
2022-05-30,Hai Phong City,Hong Bang District,18,67,49,18,13
2022-05-30,Hai Phong City,Hong Bang District,19,55,46,9,2
2022-05-30,Hai Phong City,Hong Bang District,20,20,17,3,2
2022-05-30,Hai Phong City,Hong Bang District,21,15,9,6,4
2022-05-30,Hai Phong City,Kien An District,7,1,1,0,0
2022-05-30,Hai Phong City,Kien An District,8,4,1,3,3
2022-05-30,Hai Phong City,Kien An District,9,11,5,6,5
2022-05-30,Hai Phong City,Kien An District,10,21,11,10,4
2022-05-30,Hai Phong City,Kien An District,11,18,15,3,2
2022-05-30,Hai Phong City,Kien An District,12,16,13,3,0
2022-05-30,Hai Phong City,Kien An District,13,4,2,2,2
2022-05-30,Hai Phong City,Kien An District,14,12,4,8,5
2022-05-30,Hai Phong City,Kien An District,15,9,7,2,1
2022-05-30,Hai Phong City,Kien An District,16,5,4,1,0
2022-05-30,Hai Phong City,Kien An District,17,3,2,1,1
2022-05-30,Hai Phong City,Kien An District,18,11,9,2,0
2022-05-30,Hai Phong City,Kien An District,19,12,11,1,0
2022-05-30,Hai Phong City,Kien An District,20,13,7,6,4
2022-05-30,Hai Phong City,Kien An District,21,5,1,4,2
2022-05-30,Hai Phong City,Le Chan District,6,4,2,2,2
2022-05-30,Hai Phong City,Le Chan District,7,29,17,12,12
2022-05-30,Hai Phong City,Le Chan District,8,80,53,27,16
2022-05-30,Hai Phong City,Le Chan District,9,84,71,13,4
2022-05-30,Hai Phong City,Le Chan District,10,163,131,32,6
2022-05-30,Hai Phong City,Le Chan District,11,325,246,79,39
2022-05-30,Hai Phong City,Le Chan District,12,195,165,30,18
2022-05-30,Hai Phong City,Le Chan District,13,105,91,14,4
2022-05-30,Hai Phong City,Le Chan District,14,124,89,35,18
2022-05-30,Hai Phong City,Le Chan District,15,157,131,26,16
2022-05-30,Hai Phong City,Le Chan District,16,134,117,17,3
2022-05-30,Hai Phong City,Le Chan District,17,150,129,21,10
2022-05-30,Hai Phong City,Le Chan District,18,203,176,27,13
2022-05-30,Hai Phong City,Le Chan District,19,168,137,31,12
2022-05-30,Hai Phong City,Le Chan District,20,127,104,23,8
2022-05-30,Hai Phong City,Le Chan District,21,66,39,27,17
2022-05-30,Hai Phong City,Ngo Quyen District,1,1,0,1,0
2022-05-30,Hai Phong City,Ngo Quyen District,6,1,0,1,1
2022-05-30,Hai Phong City,Ngo Quyen District,7,28,15,13,9
2022-05-30,Hai Phong City,Ngo Quyen District,8,58,41,17,10
2022-05-30,Hai Phong City,Ngo Quyen District,9,82,71,11,2
2022-05-30,Hai Phong City,Ngo Quyen District,10,123,105,18,6
2022-05-30,Hai Phong City,Ngo Quyen District,11,267,203,64,31
2022-05-30,Hai Phong City,Ngo Quyen District,12,188,151,37,17
2022-05-30,Hai Phong City,Ngo Quyen District,13,116,102,14,5
2022-05-30,Hai Phong City,Ngo Quyen District,14,139,108,31,18
2022-05-30,Hai Phong City,Ngo Quyen District,15,120,103,17,12
2022-05-30,Hai Phong City,Ngo Quyen District,16,96,84,12,1
2022-05-30,Hai Phong City,Ngo Quyen District,17,122,102,20,4
2022-05-30,Hai Phong City,Ngo Quyen District,18,137,116,21,5
2022-05-30,Hai Phong City,Ngo Quyen District,19,141,124,17,6
2022-05-30,Hai Phong City,Ngo Quyen District,20,85,73,12,0
2022-05-30,Hai Phong City,Ngo Quyen District,21,62,41,21,11
2022-05-30,Hai Phong City,Ngo Quyen District,22,1,0,1,0
2022-05-30,Hai Phong City,Thuy Nguyen,7,1,0,1,1
2022-05-30,Hai Phong City,Thuy Nguyen,11,2,2,0,0
2022-05-30,Hai Phong City,Thuy Nguyen,12,1,0,1,0
2022-05-30,Hai Phong City,Thuy Nguyen,13,3,0,3,2
2022-05-30,Hai Phong City,Thuy Nguyen,19,1,0,1,0
2022-05-30,Hue City,Hue City,0,4,3,1,0
2022-05-30,Hue City,Hue City,1,1,1,0,0
2022-05-30,Hue City,Hue City,2,1,1,0,0
2022-05-30,Hue City,Hue City,5,7,3,4,0
2022-05-30,Hue City,Hue City,6,65,54,11,1
2022-05-30,Hue City,Hue City,7,215,193,22,0
2022-05-30,Hue City,Hue City,8,303,282,21,0
2022-05-30,Hue City,Hue City,9,298,281,17,0
2022-05-30,Hue City,Hue City,10,455,412,43,5
2022-05-30,Hue City,Hue City,11,938,852,86,9
2022-05-30,Hue City,Hue City,12,501,476,25,0
2022-05-30,Hue City,Hue City,13,293,274,19,1
2022-05-30,Hue City,Hue City,14,335,290,45,4
2022-05-30,Hue City,Hue City,15,327,313,14,0
2022-05-30,Hue City,Hue City,16,352,321,31,6
2022-05-30,Hue City,Hue City,17,495,461,34,3
2022-05-30,Hue City,Hue City,18,542,499,43,1
2022-05-30,Hue City,Hue City,19,560,516,44,2
2022-05-30,Hue City,Hue City,20,423,379,44,3
2022-05-30,Hue City,Hue City,21,257,209,48,9
2022-05-30,Hue City,Hue City,22,3,0,3,0
2022-05-30,Hue City,Huong Thuy,9,1,0,1,0
2022-05-30,Hue City,Huong Thuy,10,1,0,1,1
2022-05-30,Hue City,Huong Thuy,15,2,1,1,1
2022-05-30,Hue City,Huong Thuy,17,1,1,0,0
2022-05-30,Hue City,Huong Thuy,19,1,1,0,0
2022-05-30,Hue City,Huong Thuy,21,3,0,3,1
2022-05-30,Hue City,Huong Tra,17,1,1,0,0
2022-05-30,Hue City,Huong Tra,21,1,0,1,1
2022-05-30,Hue City,Phu Vang,8,3,2,1,0
2022-05-30,Hue City,Phu Vang,9,1,0,1,1
2022-05-30,Hue City,Phu Vang,10,3,2,1,1
2022-05-30,Hue City,Phu Vang,11,3,3,0,0
2022-05-30,Hue City,Phu Vang,12,4,3,1,0
2022-05-30,Hue City,Phu Vang,13,1,1,0,0
2022-05-30,Hue City,Phu Vang,14,1,1,0,0
2022-05-30,Hue City,Phu Vang,15,1,1,0,0
2022-05-30,Hue City,Phu Vang,16,1,1,0,0
2022-05-30,Hue City,Phu Vang,17,1,1,0,0
2022-05-30,Hue City,Phu Vang,18,2,2,0,0
2022-05-30,Hue City,Phu Vang,19,2,0,2,2
2022-05-30,Hue City,Phu Vang,20,1,0,1,1
2022-05-30,Vung Tau,Ba Ria City,8,5,4,1,1
2022-05-30,Vung Tau,Ba Ria City,9,5,5,0,0
2022-05-30,Vung Tau,Ba Ria City,10,3,3,0,0
2022-05-30,Vung Tau,Ba Ria City,11,11,5,6,4
2022-05-30,Vung Tau,Ba Ria City,12,7,4,3,1
2022-05-30,Vung Tau,Ba Ria City,13,8,5,3,3
2022-05-30,Vung Tau,Ba Ria City,14,10,3,7,5
2022-05-30,Vung Tau,Ba Ria City,15,6,5,1,0
2022-05-30,Vung Tau,Ba Ria City,16,11,6,5,3
2022-05-30,Vung Tau,Ba Ria City,17,3,3,0,0
2022-05-30,Vung Tau,Ba Ria City,18,5,4,1,1
2022-05-30,Vung Tau,Ba Ria City,19,2,2,0,0
2022-05-30,Vung Tau,Ba Ria City,20,2,0,2,0
2022-05-30,Vung Tau,Vung Tau City,0,4,1,3,0
2022-05-30,Vung Tau,Vung Tau City,4,1,1,0,0
2022-05-30,Vung Tau,Vung Tau City,5,1,1,0,0
2022-05-30,Vung Tau,Vung Tau City,6,34,28,6,1
2022-05-30,Vung Tau,Vung Tau City,7,99,87,12,4
2022-05-30,Vung Tau,Vung Tau City,8,151,139,12,2
2022-05-30,Vung Tau,Vung Tau City,9,147,134,13,1
2022-05-30,Vung Tau,Vung Tau City,10,197,172,25,2
2022-05-30,Vung Tau,Vung Tau City,11,334,316,18,3
2022-05-30,Vung Tau,Vung Tau City,12,282,266,16,2
2022-05-30,Vung Tau,Vung Tau City,13,200,182,18,10
2022-05-30,Vung Tau,Vung Tau City,14,238,220,18,2
2022-05-30,Vung Tau,Vung Tau City,15,195,183,12,2
2022-05-30,Vung Tau,Vung Tau City,16,175,158,17,2
2022-05-30,Vung Tau,Vung Tau City,17,279,259,20,2
2022-05-30,Vung Tau,Vung Tau City,18,273,237,36,13
2022-05-30,Vung Tau,Vung Tau City,19,244,211,33,3
2022-05-30,Vung Tau,Vung Tau City,20,198,157,41,23
2022-05-30,Vung Tau,Vung Tau City,21,131,78,53,36
2022-05-30,Vung Tau,Vung Tau City,22,2,0,2,0
2022-05-31,Binh Duong,Ben Cat,11,2,1,1,1
2022-05-31,Binh Duong,Ben Cat,12,2,0,2,1
2022-05-31,Binh Duong,Ben Cat,13,3,1,2,1
2022-05-31,Binh Duong,Ben Cat,14,2,0,2,2
2022-05-31,Binh Duong,Ben Cat,15,3,0,3,3
2022-05-31,Binh Duong,Ben Cat,16,3,0,3,3
2022-05-31,Binh Duong,Ben Cat,18,1,1,0,0
2022-05-31,Binh Duong,Ben Cat,19,1,0,1,1
2022-05-31,Binh Duong,Di An,6,3,1,2,1
2022-05-31,Binh Duong,Di An,7,8,2,6,6
2022-05-31,Binh Duong,Di An,8,7,7,0,0
2022-05-31,Binh Duong,Di An,9,15,11,4,4
2022-05-31,Binh Duong,Di An,10,28,17,11,7
2022-05-31,Binh Duong,Di An,11,38,22,16,12
2022-05-31,Binh Duong,Di An,12,41,28,13,10
2022-05-31,Binh Duong,Di An,13,37,19,18,17
2022-05-31,Binh Duong,Di An,14,26,15,11,3
2022-05-31,Binh Duong,Di An,15,24,18,6,6
2022-05-31,Binh Duong,Di An,16,20,10,10,6
2022-05-31,Binh Duong,Di An,17,19,13,6,3
2022-05-31,Binh Duong,Di An,18,33,15,18,13
2022-05-31,Binh Duong,Di An,19,36,16,20,15
2022-05-31,Binh Duong,Di An,20,25,11,14,7
2022-05-31,Binh Duong,Di An,21,8,3,5,4
2022-05-31,Binh Duong,Di An,22,1,0,1,0
2022-05-31,Binh Duong,Tan Uyen,9,2,0,2,1
2022-05-31,Binh Duong,Tan Uyen,10,1,0,1,1
2022-05-31,Binh Duong,Tan Uyen,11,3,2,1,1
2022-05-31,Binh Duong,Tan Uyen,12,2,1,1,1
2022-05-31,Binh Duong,Tan Uyen,14,5,1,4,4
2022-05-31,Binh Duong,Tan Uyen,15,1,0,1,0
2022-05-31,Binh Duong,Tan Uyen,16,2,1,1,1
2022-05-31,Binh Duong,Tan Uyen,17,3,2,1,0
2022-05-31,Binh Duong,Tan Uyen,18,2,1,1,0
2022-05-31,Binh Duong,Tan Uyen,19,2,1,1,1
2022-05-31,Binh Duong,Tan Uyen,20,2,1,1,1
2022-05-31,Binh Duong,Thu Dau Mot Town,1,1,0,1,0
2022-05-31,Binh Duong,Thu Dau Mot Town,4,2,0,2,0
2022-05-31,Binh Duong,Thu Dau Mot Town,5,2,1,1,1
2022-05-31,Binh Duong,Thu Dau Mot Town,6,49,39,10,8
2022-05-31,Binh Duong,Thu Dau Mot Town,7,106,91,15,5
2022-05-31,Binh Duong,Thu Dau Mot Town,8,199,182,17,1
2022-05-31,Binh Duong,Thu Dau Mot Town,9,242,223,19,2
2022-05-31,Binh Duong,Thu Dau Mot Town,10,412,388,24,5
2022-05-31,Binh Duong,Thu Dau Mot Town,11,684,648,36,4
2022-05-31,Binh Duong,Thu Dau Mot Town,12,448,421,27,4
2022-05-31,Binh Duong,Thu Dau Mot Town,13,504,474,30,7
2022-05-31,Binh Duong,Thu Dau Mot Town,14,419,382,37,6
2022-05-31,Binh Duong,Thu Dau Mot Town,15,310,287,23,5
2022-05-31,Binh Duong,Thu Dau Mot Town,16,257,245,12,2
2022-05-31,Binh Duong,Thu Dau Mot Town,17,345,329,16,2
2022-05-31,Binh Duong,Thu Dau Mot Town,18,391,372,19,4
2022-05-31,Binh Duong,Thu Dau Mot Town,19,416,354,62,27
2022-05-31,Binh Duong,Thu Dau Mot Town,20,325,274,51,28
2022-05-31,Binh Duong,Thu Dau Mot Town,21,130,112,18,5
2022-05-31,Binh Duong,Thu Dau Mot Town,22,6,1,5,2
2022-05-31,Binh Duong,Thuan An,6,4,1,3,3
2022-05-31,Binh Duong,Thuan An,7,6,4,2,2
2022-05-31,Binh Duong,Thuan An,8,9,8,1,1
2022-05-31,Binh Duong,Thuan An,9,34,27,7,5
2022-05-31,Binh Duong,Thuan An,10,68,51,17,10
2022-05-31,Binh Duong,Thuan An,11,78,62,16,11
2022-05-31,Binh Duong,Thuan An,12,62,47,15,11
2022-05-31,Binh Duong,Thuan An,13,65,53,12,6
2022-05-31,Binh Duong,Thuan An,14,88,58,30,23
2022-05-31,Binh Duong,Thuan An,15,48,33,15,11
2022-05-31,Binh Duong,Thuan An,16,35,30,5,3
2022-05-31,Binh Duong,Thuan An,17,41,29,12,7
2022-05-31,Binh Duong,Thuan An,18,38,18,20,15
2022-05-31,Binh Duong,Thuan An,19,58,14,44,36
2022-05-31,Binh Duong,Thuan An,20,81,31,50,36
2022-05-31,Binh Duong,Thuan An,21,33,12,21,18
2022-05-31,Binh Duong,Thuan An,22,1,0,1,0
2022-05-31,Can Tho City,Binh Thuy District,7,1,1,0,0
2022-05-31,Can Tho City,Binh Thuy District,8,3,3,0,0
2022-05-31,Can Tho City,Binh Thuy District,9,6,6,0,0
2022-05-31,Can Tho City,Binh Thuy District,10,18,17,1,0
2022-05-31,Can Tho City,Binh Thuy District,11,14,14,0,0
2022-05-31,Can Tho City,Binh Thuy District,12,7,7,0,0
2022-05-31,Can Tho City,Binh Thuy District,13,10,9,1,0
2022-05-31,Can Tho City,Binh Thuy District,14,15,15,0,0
2022-05-31,Can Tho City,Binh Thuy District,15,10,7,3,0
2022-05-31,Can Tho City,Binh Thuy District,16,7,7,0,0
2022-05-31,Can Tho City,Binh Thuy District,17,7,7,0,0
2022-05-31,Can Tho City,Binh Thuy District,18,12,11,1,1
2022-05-31,Can Tho City,Binh Thuy District,19,10,9,1,0
2022-05-31,Can Tho City,Binh Thuy District,20,7,6,1,0
2022-05-31,Can Tho City,Binh Thuy District,21,4,2,2,0
2022-05-31,Can Tho City,Cai Rang District,6,2,2,0,0
2022-05-31,Can Tho City,Cai Rang District,7,8,6,2,2
2022-05-31,Can Tho City,Cai Rang District,8,9,8,1,0
2022-05-31,Can Tho City,Cai Rang District,9,5,4,1,1
2022-05-31,Can Tho City,Cai Rang District,10,12,11,1,0
2022-05-31,Can Tho City,Cai Rang District,11,6,6,0,0
2022-05-31,Can Tho City,Cai Rang District,12,12,11,1,0
2022-05-31,Can Tho City,Cai Rang District,13,17,11,6,2
2022-05-31,Can Tho City,Cai Rang District,14,7,5,2,2
2022-05-31,Can Tho City,Cai Rang District,15,4,4,0,0
2022-05-31,Can Tho City,Cai Rang District,16,12,10,2,0
2022-05-31,Can Tho City,Cai Rang District,17,10,6,4,1
2022-05-31,Can Tho City,Cai Rang District,18,25,22,3,1
2022-05-31,Can Tho City,Cai Rang District,19,9,9,0,0
2022-05-31,Can Tho City,Cai Rang District,20,9,8,1,1
2022-05-31,Can Tho City,Cai Rang District,21,7,4,3,1
2022-05-31,Can Tho City,Ninh Kieu District,0,1,1,0,0
2022-05-31,Can Tho City,Ninh Kieu District,5,2,2,0,0
2022-05-31,Can Tho City,Ninh Kieu District,6,39,34,5,1
2022-05-31,Can Tho City,Ninh Kieu District,7,141,131,10,0
2022-05-31,Can Tho City,Ninh Kieu District,8,216,204,12,0
2022-05-31,Can Tho City,Ninh Kieu District,9,286,266,20,0
2022-05-31,Can Tho City,Ninh Kieu District,10,543,520,23,0
2022-05-31,Can Tho City,Ninh Kieu District,11,775,733,42,1
2022-05-31,Can Tho City,Ninh Kieu District,12,630,601,29,0
2022-05-31,Can Tho City,Ninh Kieu District,13,498,480,18,0
2022-05-31,Can Tho City,Ninh Kieu District,14,403,389,14,0
2022-05-31,Can Tho City,Ninh Kieu District,15,350,333,17,0
2022-05-31,Can Tho City,Ninh Kieu District,16,436,414,22,0
2022-05-31,Can Tho City,Ninh Kieu District,17,539,525,14,0
2022-05-31,Can Tho City,Ninh Kieu District,18,540,508,32,0
2022-05-31,Can Tho City,Ninh Kieu District,19,474,447,27,0
2022-05-31,Can Tho City,Ninh Kieu District,20,339,319,20,0
2022-05-31,Can Tho City,Ninh Kieu District,21,197,173,24,1
2022-05-31,Can Tho City,Ninh Kieu District,22,1,0,1,0
2022-05-31,Can Tho City,O Mon District,10,1,0,1,1
2022-05-31,Can Tho City,O Mon District,13,1,0,1,1
2022-05-31,Can Tho City,O Mon District,14,2,0,2,2
2022-05-31,Dong Nai,Bien Hoa City,0,2,0,2,0
2022-05-31,Dong Nai,Bien Hoa City,1,1,0,1,0
2022-05-31,Dong Nai,Bien Hoa City,2,3,1,2,0
2022-05-31,Dong Nai,Bien Hoa City,5,3,2,1,1
2022-05-31,Dong Nai,Bien Hoa City,6,49,30,19,14
2022-05-31,Dong Nai,Bien Hoa City,7,142,121,21,7
2022-05-31,Dong Nai,Bien Hoa City,8,322,283,39,8
2022-05-31,Dong Nai,Bien Hoa City,9,431,376,55,8
2022-05-31,Dong Nai,Bien Hoa City,10,792,718,74,20
2022-05-31,Dong Nai,Bien Hoa City,11,1180,1041,139,33
2022-05-31,Dong Nai,Bien Hoa City,12,892,818,74,14
2022-05-31,Dong Nai,Bien Hoa City,13,868,782,86,24
2022-05-31,Dong Nai,Bien Hoa City,14,756,692,64,24
2022-05-31,Dong Nai,Bien Hoa City,15,558,503,55,13
2022-05-31,Dong Nai,Bien Hoa City,16,509,459,50,9
2022-05-31,Dong Nai,Bien Hoa City,17,632,571,61,12
2022-05-31,Dong Nai,Bien Hoa City,18,684,626,58,13
2022-05-31,Dong Nai,Bien Hoa City,19,693,623,70,16
2022-05-31,Dong Nai,Bien Hoa City,20,504,428,76,18
2022-05-31,Dong Nai,Bien Hoa City,21,215,168,47,15
2022-05-31,Dong Nai,Bien Hoa City,22,1,0,1,0
2022-05-31,Dong Nai,Cam My,11,1,0,1,0
2022-05-31,Dong Nai,Long Khanh,9,1,0,1,1
2022-05-31,Dong Nai,Long Khanh,10,2,0,2,2
2022-05-31,Dong Nai,Long Thanh,11,2,0,2,2
2022-05-31,Dong Nai,Long Thanh,12,1,0,1,1
2022-05-31,Dong Nai,Long Thanh,13,1,0,1,1
2022-05-31,Dong Nai,Long Thanh,14,6,0,6,6
2022-05-31,Dong Nai,Nhon trach,13,1,0,1,1
2022-05-31,Dong Nai,Nhon trach,18,1,0,1,1
2022-05-31,Dong Nai,Trang Bom,9,3,0,3,2
2022-05-31,Dong Nai,Trang Bom,10,2,0,2,2
2022-05-31,Dong Nai,Trang Bom,11,1,0,1,1
2022-05-31,Dong Nai,Trang Bom,12,1,1,0,0
2022-05-31,Dong Nai,Trang Bom,14,1,0,1,1
2022-05-31,Dong Nai,Trang Bom,19,1,0,1,1
2022-05-31,Dong Nai,Trang Bom,20,2,0,2,2
2022-05-31,Dong Nai,Vinh Cuu,18,1,0,1,1
2022-05-31,Hai Phong City,An Duong,11,3,1,2,2
2022-05-31,Hai Phong City,An Duong,12,1,1,0,0
2022-05-31,Hai Phong City,An Duong,14,7,2,5,3
2022-05-31,Hai Phong City,An Duong,16,2,1,1,0
2022-05-31,Hai Phong City,An Duong,17,2,1,1,1
2022-05-31,Hai Phong City,An Duong,18,4,1,3,3
2022-05-31,Hai Phong City,An Duong,19,2,0,2,1
2022-05-31,Hai Phong City,An Duong,20,1,0,1,1
2022-05-31,Hai Phong City,An Duong,21,2,0,2,2
2022-05-31,Hai Phong City,Duong Kinh District,13,2,0,2,1
2022-05-31,Hai Phong City,Hai An District,7,8,1,7,7
2022-05-31,Hai Phong City,Hai An District,8,9,2,7,7
2022-05-31,Hai Phong City,Hai An District,9,16,13,3,2
2022-05-31,Hai Phong City,Hai An District,10,27,20,7,3
2022-05-31,Hai Phong City,Hai An District,11,42,35,7,2
2022-05-31,Hai Phong City,Hai An District,12,38,32,6,0
2022-05-31,Hai Phong City,Hai An District,13,19,11,8,4
2022-05-31,Hai Phong City,Hai An District,14,18,14,4,1
2022-05-31,Hai Phong City,Hai An District,15,15,13,2,1
2022-05-31,Hai Phong City,Hai An District,16,15,14,1,0
2022-05-31,Hai Phong City,Hai An District,17,24,19,5,0
2022-05-31,Hai Phong City,Hai An District,18,29,25,4,1
2022-05-31,Hai Phong City,Hai An District,19,20,18,2,0
2022-05-31,Hai Phong City,Hai An District,20,18,14,4,1
2022-05-31,Hai Phong City,Hai An District,21,10,7,3,2
2022-05-31,Hai Phong City,Hai An District,23,1,0,1,0
2022-05-31,Hai Phong City,Hong Bang District,6,1,0,1,1
2022-05-31,Hai Phong City,Hong Bang District,7,14,7,7,7
2022-05-31,Hai Phong City,Hong Bang District,8,33,23,10,8
2022-05-31,Hai Phong City,Hong Bang District,9,26,19,7,0
2022-05-31,Hai Phong City,Hong Bang District,10,41,36,5,1
2022-05-31,Hai Phong City,Hong Bang District,11,104,86,18,7
2022-05-31,Hai Phong City,Hong Bang District,12,56,46,10,2
2022-05-31,Hai Phong City,Hong Bang District,13,51,41,10,5
2022-05-31,Hai Phong City,Hong Bang District,14,43,35,8,7
2022-05-31,Hai Phong City,Hong Bang District,15,56,43,13,6
2022-05-31,Hai Phong City,Hong Bang District,16,40,30,10,5
2022-05-31,Hai Phong City,Hong Bang District,17,53,50,3,0
2022-05-31,Hai Phong City,Hong Bang District,18,50,45,5,3
2022-05-31,Hai Phong City,Hong Bang District,19,51,43,8,3
2022-05-31,Hai Phong City,Hong Bang District,20,33,26,7,3
2022-05-31,Hai Phong City,Hong Bang District,21,11,8,3,1
2022-05-31,Hai Phong City,Kien An District,7,2,0,2,2
2022-05-31,Hai Phong City,Kien An District,8,5,1,4,3
2022-05-31,Hai Phong City,Kien An District,9,11,9,2,0
2022-05-31,Hai Phong City,Kien An District,10,5,3,2,1
2022-05-31,Hai Phong City,Kien An District,11,11,9,2,2
2022-05-31,Hai Phong City,Kien An District,12,5,4,1,1
2022-05-31,Hai Phong City,Kien An District,13,4,2,2,2
2022-05-31,Hai Phong City,Kien An District,14,17,10,7,4
2022-05-31,Hai Phong City,Kien An District,15,17,10,7,4
2022-05-31,Hai Phong City,Kien An District,16,12,6,6,5
2022-05-31,Hai Phong City,Kien An District,17,14,10,4,2
2022-05-31,Hai Phong City,Kien An District,18,13,11,2,0
2022-05-31,Hai Phong City,Kien An District,19,12,10,2,1
2022-05-31,Hai Phong City,Kien An District,20,8,5,3,2
2022-05-31,Hai Phong City,Kien An District,21,6,3,3,3
2022-05-31,Hai Phong City,Le Chan District,3,2,1,1,0
2022-05-31,Hai Phong City,Le Chan District,6,1,1,0,0
2022-05-31,Hai Phong City,Le Chan District,7,30,14,16,10
2022-05-31,Hai Phong City,Le Chan District,8,83,61,22,15
2022-05-31,Hai Phong City,Le Chan District,9,70,58,12,1
2022-05-31,Hai Phong City,Le Chan District,10,156,128,28,3
2022-05-31,Hai Phong City,Le Chan District,11,292,225,67,26
2022-05-31,Hai Phong City,Le Chan District,12,181,163,18,4
2022-05-31,Hai Phong City,Le Chan District,13,135,113,22,9
2022-05-31,Hai Phong City,Le Chan District,14,168,135,33,11
2022-05-31,Hai Phong City,Le Chan District,15,155,136,19,5
2022-05-31,Hai Phong City,Le Chan District,16,154,133,21,7
2022-05-31,Hai Phong City,Le Chan District,17,187,158,29,8
2022-05-31,Hai Phong City,Le Chan District,18,188,167,21,6
2022-05-31,Hai Phong City,Le Chan District,19,198,175,23,3
2022-05-31,Hai Phong City,Le Chan District,20,151,118,33,14
2022-05-31,Hai Phong City,Le Chan District,21,90,60,30,15
2022-05-31,Hai Phong City,Ngo Quyen District,1,1,1,0,0
2022-05-31,Hai Phong City,Ngo Quyen District,7,29,10,19,13
2022-05-31,Hai Phong City,Ngo Quyen District,8,62,45,17,12
2022-05-31,Hai Phong City,Ngo Quyen District,9,63,56,7,2
2022-05-31,Hai Phong City,Ngo Quyen District,10,110,97,13,0
2022-05-31,Hai Phong City,Ngo Quyen District,11,259,203,56,29
2022-05-31,Hai Phong City,Ngo Quyen District,12,145,127,18,4
2022-05-31,Hai Phong City,Ngo Quyen District,13,104,85,19,8
2022-05-31,Hai Phong City,Ngo Quyen District,14,133,106,27,10
2022-05-31,Hai Phong City,Ngo Quyen District,15,128,107,21,5
2022-05-31,Hai Phong City,Ngo Quyen District,16,115,102,13,3
2022-05-31,Hai Phong City,Ngo Quyen District,17,116,104,12,2
2022-05-31,Hai Phong City,Ngo Quyen District,18,153,132,21,7
2022-05-31,Hai Phong City,Ngo Quyen District,19,135,115,20,4
2022-05-31,Hai Phong City,Ngo Quyen District,20,126,107,19,5
2022-05-31,Hai Phong City,Ngo Quyen District,21,73,59,14,5
2022-05-31,Hai Phong City,Ngo Quyen District,22,1,0,1,0
2022-05-31,Hai Phong City,Thuy Nguyen,10,3,0,3,3
2022-05-31,Hai Phong City,Thuy Nguyen,12,1,0,1,1
2022-05-31,Hai Phong City,Thuy Nguyen,14,1,1,0,0
2022-05-31,Hai Phong City,Thuy Nguyen,15,1,0,1,1
2022-05-31,Hai Phong City,Thuy Nguyen,16,4,0,4,3
2022-05-31,Hai Phong City,Thuy Nguyen,19,2,0,2,2
2022-05-31,Hai Phong City,Thuy Nguyen,20,2,0,2,2
2022-05-31,Hue City,Hue City,1,1,1,0,0
2022-05-31,Hue City,Hue City,4,3,2,1,0
2022-05-31,Hue City,Hue City,5,2,1,1,0
2022-05-31,Hue City,Hue City,6,74,63,11,4
2022-05-31,Hue City,Hue City,7,181,167,14,0
2022-05-31,Hue City,Hue City,8,308,278,30,1
2022-05-31,Hue City,Hue City,9,283,250,33,3
2022-05-31,Hue City,Hue City,10,417,387,30,1
2022-05-31,Hue City,Hue City,11,869,803,66,7
2022-05-31,Hue City,Hue City,12,567,522,45,0
2022-05-31,Hue City,Hue City,13,343,315,28,1
2022-05-31,Hue City,Hue City,14,381,343,38,0
2022-05-31,Hue City,Hue City,15,424,381,43,5
2022-05-31,Hue City,Hue City,16,428,390,38,5
2022-05-31,Hue City,Hue City,17,448,425,23,0
2022-05-31,Hue City,Hue City,18,572,528,44,0
2022-05-31,Hue City,Hue City,19,526,486,40,0
2022-05-31,Hue City,Hue City,20,460,420,40,1
2022-05-31,Hue City,Hue City,21,271,227,44,8
2022-05-31,Hue City,Hue City,22,3,0,3,0
2022-05-31,Hue City,Huong Thuy,7,1,1,0,0
2022-05-31,Hue City,Huong Thuy,9,1,0,1,0
2022-05-31,Hue City,Huong Thuy,11,1,0,1,0
2022-05-31,Hue City,Huong Thuy,14,1,0,1,0
2022-05-31,Hue City,Huong Thuy,17,2,1,1,1
2022-05-31,Hue City,Huong Thuy,19,1,0,1,0
2022-05-31,Hue City,Huong Thuy,21,1,1,0,0
2022-05-31,Hue City,Phu Vang,0,1,0,1,0
2022-05-31,Hue City,Phu Vang,6,1,0,1,0
2022-05-31,Hue City,Phu Vang,8,4,2,2,0
2022-05-31,Hue City,Phu Vang,9,2,2,0,0
2022-05-31,Hue City,Phu Vang,10,1,1,0,0
2022-05-31,Hue City,Phu Vang,11,3,2,1,1
2022-05-31,Hue City,Phu Vang,12,3,2,1,1
2022-05-31,Hue City,Phu Vang,13,2,1,1,0
2022-05-31,Hue City,Phu Vang,14,1,1,0,0
2022-05-31,Hue City,Phu Vang,16,2,1,1,1
2022-05-31,Hue City,Phu Vang,17,3,1,2,1
2022-05-31,Hue City,Phu Vang,18,2,2,0,0
2022-05-31,Hue City,Phu Vang,20,3,3,0,0
2022-05-31,Vung Tau,Ba Ria City,6,1,0,1,1
2022-05-31,Vung Tau,Ba Ria City,7,2,0,2,2
2022-05-31,Vung Tau,Ba Ria City,8,3,0,3,3
2022-05-31,Vung Tau,Ba Ria City,9,4,3,1,0
2022-05-31,Vung Tau,Ba Ria City,10,6,6,0,0
2022-05-31,Vung Tau,Ba Ria City,11,6,5,1,0
2022-05-31,Vung Tau,Ba Ria City,12,17,7,10,4
2022-05-31,Vung Tau,Ba Ria City,13,11,6,5,4
2022-05-31,Vung Tau,Ba Ria City,14,4,1,3,1
2022-05-31,Vung Tau,Ba Ria City,15,3,3,0,0
2022-05-31,Vung Tau,Ba Ria City,16,4,3,1,1
2022-05-31,Vung Tau,Ba Ria City,17,6,5,1,0
2022-05-31,Vung Tau,Ba Ria City,18,7,1,6,6
2022-05-31,Vung Tau,Ba Ria City,19,9,0,9,9
2022-05-31,Vung Tau,Ba Ria City,20,3,0,3,3
2022-05-31,Vung Tau,Vung Tau City,0,2,1,1,0
2022-05-31,Vung Tau,Vung Tau City,2,1,0,1,0
2022-05-31,Vung Tau,Vung Tau City,5,1,1,0,0
2022-05-31,Vung Tau,Vung Tau City,6,42,36,6,3
2022-05-31,Vung Tau,Vung Tau City,7,106,91,15,4
2022-05-31,Vung Tau,Vung Tau City,8,169,157,12,2
2022-05-31,Vung Tau,Vung Tau City,9,196,182,14,1
2022-05-31,Vung Tau,Vung Tau City,10,223,197,26,11
2022-05-31,Vung Tau,Vung Tau City,11,379,352,27,3
2022-05-31,Vung Tau,Vung Tau City,12,262,241,21,6
2022-05-31,Vung Tau,Vung Tau City,13,195,180,15,3
2022-05-31,Vung Tau,Vung Tau City,14,241,212,29,5
2022-05-31,Vung Tau,Vung Tau City,15,224,206,18,4
2022-05-31,Vung Tau,Vung Tau City,16,215,192,23,6
2022-05-31,Vung Tau,Vung Tau City,17,244,222,22,1
2022-05-31,Vung Tau,Vung Tau City,18,292,264,28,4
2022-05-31,Vung Tau,Vung Tau City,19,283,257,26,8
2022-05-31,Vung Tau,Vung Tau City,20,209,179,30,15
2022-05-31,Vung Tau,Vung Tau City,21,95,63,32,10
2022-05-31,Vung Tau,Vung Tau City,22,2,1,1,0
2022-06-01,Binh Duong,Ben Cat,11,1,0,1,1
2022-06-01,Binh Duong,Ben Cat,13,2,0,2,2
2022-06-01,Binh Duong,Ben Cat,20,2,0,2,2
2022-06-01,Binh Duong,Di An,0,1,0,1,0
2022-06-01,Binh Duong,Di An,7,4,0,4,4
2022-06-01,Binh Duong,Di An,8,13,7,6,2
2022-06-01,Binh Duong,Di An,9,25,18,7,5
2022-06-01,Binh Duong,Di An,10,43,23,20,16
2022-06-01,Binh Duong,Di An,11,41,25,16,15
2022-06-01,Binh Duong,Di An,12,51,32,19,12
2022-06-01,Binh Duong,Di An,13,41,29,12,9
2022-06-01,Binh Duong,Di An,14,46,22,24,15
2022-06-01,Binh Duong,Di An,15,34,15,19,11
2022-06-01,Binh Duong,Di An,16,29,17,12,8
2022-06-01,Binh Duong,Di An,17,29,23,6,4
2022-06-01,Binh Duong,Di An,18,27,14,13,10
2022-06-01,Binh Duong,Di An,19,47,20,27,21
2022-06-01,Binh Duong,Di An,20,27,9,18,16
2022-06-01,Binh Duong,Di An,21,7,3,4,3
2022-06-01,Binh Duong,Tan Uyen,7,1,0,1,1
2022-06-01,Binh Duong,Tan Uyen,8,1,0,1,1
2022-06-01,Binh Duong,Tan Uyen,9,2,0,2,1
2022-06-01,Binh Duong,Tan Uyen,10,7,4,3,3
2022-06-01,Binh Duong,Tan Uyen,11,1,1,0,0
2022-06-01,Binh Duong,Tan Uyen,12,2,2,0,0
2022-06-01,Binh Duong,Tan Uyen,15,2,2,0,0
2022-06-01,Binh Duong,Tan Uyen,16,1,1,0,0
2022-06-01,Binh Duong,Tan Uyen,17,1,1,0,0
2022-06-01,Binh Duong,Tan Uyen,18,2,1,1,1
2022-06-01,Binh Duong,Tan Uyen,19,1,0,1,1
2022-06-01,Binh Duong,Thu Dau Mot Town,0,1,1,0,0
2022-06-01,Binh Duong,Thu Dau Mot Town,2,1,1,0,0
2022-06-01,Binh Duong,Thu Dau Mot Town,6,29,21,8,5
2022-06-01,Binh Duong,Thu Dau Mot Town,7,123,108,15,4
2022-06-01,Binh Duong,Thu Dau Mot Town,8,202,192,10,0
2022-06-01,Binh Duong,Thu Dau Mot Town,9,232,218,14,2
2022-06-01,Binh Duong,Thu Dau Mot Town,10,383,357,26,2
2022-06-01,Binh Duong,Thu Dau Mot Town,11,645,607,38,5
2022-06-01,Binh Duong,Thu Dau Mot Town,12,471,448,23,1
2022-06-01,Binh Duong,Thu Dau Mot Town,13,451,417,34,3
2022-06-01,Binh Duong,Thu Dau Mot Town,14,376,357,19,1
2022-06-01,Binh Duong,Thu Dau Mot Town,15,318,295,23,5
2022-06-01,Binh Duong,Thu Dau Mot Town,16,320,302,18,3
2022-06-01,Binh Duong,Thu Dau Mot Town,17,355,327,28,3
2022-06-01,Binh Duong,Thu Dau Mot Town,18,383,360,23,5
2022-06-01,Binh Duong,Thu Dau Mot Town,19,360,336,24,9
2022-06-01,Binh Duong,Thu Dau Mot Town,20,255,225,30,7
2022-06-01,Binh Duong,Thu Dau Mot Town,21,124,100,24,5
2022-06-01,Binh Duong,Thuan An,0,1,0,1,0
2022-06-01,Binh Duong,Thuan An,1,1,1,0,0
2022-06-01,Binh Duong,Thuan An,5,1,1,0,0
2022-06-01,Binh Duong,Thuan An,6,4,1,3,3
2022-06-01,Binh Duong,Thuan An,7,7,5,2,2
2022-06-01,Binh Duong,Thuan An,8,15,11,4,2
2022-06-01,Binh Duong,Thuan An,9,31,22,9,8
2022-06-01,Binh Duong,Thuan An,10,57,30,27,18
2022-06-01,Binh Duong,Thuan An,11,103,53,50,42
2022-06-01,Binh Duong,Thuan An,12,79,49,30,22
2022-06-01,Binh Duong,Thuan An,13,61,41,20,16
2022-06-01,Binh Duong,Thuan An,14,81,51,30,21
2022-06-01,Binh Duong,Thuan An,15,47,38,9,5
2022-06-01,Binh Duong,Thuan An,16,34,28,6,0
2022-06-01,Binh Duong,Thuan An,17,34,31,3,2
2022-06-01,Binh Duong,Thuan An,18,48,38,10,4
2022-06-01,Binh Duong,Thuan An,19,44,33,11,6
2022-06-01,Binh Duong,Thuan An,20,33,15,18,14
2022-06-01,Binh Duong,Thuan An,21,13,4,9,4
2022-06-01,Binh Duong,Thuan An,22,1,0,1,0
2022-06-01,Can Tho City,Binh Thuy District,7,2,2,0,0
2022-06-01,Can Tho City,Binh Thuy District,8,2,1,1,0
2022-06-01,Can Tho City,Binh Thuy District,9,7,7,0,0
2022-06-01,Can Tho City,Binh Thuy District,10,10,10,0,0
2022-06-01,Can Tho City,Binh Thuy District,11,10,9,1,0
2022-06-01,Can Tho City,Binh Thuy District,12,10,7,3,1
2022-06-01,Can Tho City,Binh Thuy District,13,12,11,1,0
2022-06-01,Can Tho City,Binh Thuy District,14,9,9,0,0
2022-06-01,Can Tho City,Binh Thuy District,15,12,11,1,0
2022-06-01,Can Tho City,Binh Thuy District,16,10,10,0,0
2022-06-01,Can Tho City,Binh Thuy District,17,12,10,2,0
2022-06-01,Can Tho City,Binh Thuy District,18,18,16,2,0
2022-06-01,Can Tho City,Binh Thuy District,19,16,15,1,0
2022-06-01,Can Tho City,Binh Thuy District,20,8,6,2,0
2022-06-01,Can Tho City,Binh Thuy District,21,5,2,3,0
2022-06-01,Can Tho City,Cai Rang District,6,1,1,0,0
2022-06-01,Can Tho City,Cai Rang District,7,6,5,1,1
2022-06-01,Can Tho City,Cai Rang District,8,6,5,1,0
2022-06-01,Can Tho City,Cai Rang District,9,8,8,0,0
2022-06-01,Can Tho City,Cai Rang District,10,9,6,3,1
2022-06-01,Can Tho City,Cai Rang District,11,10,9,1,0
2022-06-01,Can Tho City,Cai Rang District,12,15,14,1,0
2022-06-01,Can Tho City,Cai Rang District,13,12,11,1,0
2022-06-01,Can Tho City,Cai Rang District,14,12,12,0,0
2022-06-01,Can Tho City,Cai Rang District,15,7,7,0,0
2022-06-01,Can Tho City,Cai Rang District,16,17,13,4,0
2022-06-01,Can Tho City,Cai Rang District,17,9,7,2,0
2022-06-01,Can Tho City,Cai Rang District,18,13,9,4,1
2022-06-01,Can Tho City,Cai Rang District,19,10,8,2,0
2022-06-01,Can Tho City,Cai Rang District,20,12,10,2,1
2022-06-01,Can Tho City,Cai Rang District,21,1,1,0,0
2022-06-01,Can Tho City,Ninh Kieu District,0,1,1,0,0
2022-06-01,Can Tho City,Ninh Kieu District,1,1,0,1,0
2022-06-01,Can Tho City,Ninh Kieu District,2,1,0,1,0
2022-06-01,Can Tho City,Ninh Kieu District,3,2,1,1,0
2022-06-01,Can Tho City,Ninh Kieu District,4,1,0,1,0
2022-06-01,Can Tho City,Ninh Kieu District,5,2,1,1,0
2022-06-01,Can Tho City,Ninh Kieu District,6,48,46,2,0
2022-06-01,Can Tho City,Ninh Kieu District,7,128,117,11,0
2022-06-01,Can Tho City,Ninh Kieu District,8,238,217,21,0
2022-06-01,Can Tho City,Ninh Kieu District,9,309,289,20,0
2022-06-01,Can Tho City,Ninh Kieu District,10,623,588,35,0
2022-06-01,Can Tho City,Ninh Kieu District,11,913,864,49,0
2022-06-01,Can Tho City,Ninh Kieu District,12,654,633,21,1
2022-06-01,Can Tho City,Ninh Kieu District,13,532,505,27,0
2022-06-01,Can Tho City,Ninh Kieu District,14,388,374,14,0
2022-06-01,Can Tho City,Ninh Kieu District,15,373,359,14,0
2022-06-01,Can Tho City,Ninh Kieu District,16,464,435,29,0
2022-06-01,Can Tho City,Ninh Kieu District,17,458,434,24,0
2022-06-01,Can Tho City,Ninh Kieu District,18,530,503,27,0
2022-06-01,Can Tho City,Ninh Kieu District,19,442,424,18,1
2022-06-01,Can Tho City,Ninh Kieu District,20,326,308,18,0
2022-06-01,Can Tho City,Ninh Kieu District,21,198,175,23,0
2022-06-01,Can Tho City,Ninh Kieu District,22,1,1,0,0
2022-06-01,Can Tho City,Ninh Kieu District,23,1,0,1,0
2022-06-01,Can Tho City,O Mon District,13,1,0,1,1
2022-06-01,Can Tho City,Thoi Lai,12,2,0,2,2
2022-06-01,Can Tho City,Thoi Lai,13,2,0,2,2
2022-06-01,Dong Nai,Bien Hoa City,0,1,1,0,0
2022-06-01,Dong Nai,Bien Hoa City,1,2,1,1,0
2022-06-01,Dong Nai,Bien Hoa City,4,2,2,0,0
2022-06-01,Dong Nai,Bien Hoa City,5,4,1,3,3
2022-06-01,Dong Nai,Bien Hoa City,6,48,30,18,13
2022-06-01,Dong Nai,Bien Hoa City,7,148,123,25,12
2022-06-01,Dong Nai,Bien Hoa City,8,287,251,36,7
2022-06-01,Dong Nai,Bien Hoa City,9,461,420,41,3
2022-06-01,Dong Nai,Bien Hoa City,10,845,733,112,25
2022-06-01,Dong Nai,Bien Hoa City,11,1187,1074,113,29
2022-06-01,Dong Nai,Bien Hoa City,12,994,907,87,18
2022-06-01,Dong Nai,Bien Hoa City,13,887,807,80,27
2022-06-01,Dong Nai,Bien Hoa City,14,775,679,96,42
2022-06-01,Dong Nai,Bien Hoa City,15,628,569,59,24
2022-06-01,Dong Nai,Bien Hoa City,16,569,510,59,19
2022-06-01,Dong Nai,Bien Hoa City,17,655,571,84,33
2022-06-01,Dong Nai,Bien Hoa City,18,699,609,90,16
2022-06-01,Dong Nai,Bien Hoa City,19,728,601,127,42
2022-06-01,Dong Nai,Bien Hoa City,20,558,433,125,53
2022-06-01,Dong Nai,Bien Hoa City,21,211,146,65,18
2022-06-01,Dong Nai,Bien Hoa City,22,1,0,1,0
2022-06-01,Dong Nai,Cam My,12,1,0,1,1
2022-06-01,Dong Nai,Long Thanh,9,2,0,2,2
2022-06-01,Dong Nai,Long Thanh,10,1,0,1,1
2022-06-01,Dong Nai,Long Thanh,11,2,0,2,2
2022-06-01,Dong Nai,Long Thanh,12,8,0,8,8
2022-06-01,Dong Nai,Long Thanh,14,2,0,2,1
2022-06-01,Dong Nai,Long Thanh,18,1,0,1,1
2022-06-01,Dong Nai,Long Thanh,19,1,0,1,0
2022-06-01,Dong Nai,Long Thanh,20,3,0,3,3
2022-06-01,Dong Nai,Nhon trach,17,1,0,1,1
2022-06-01,Dong Nai,Nhon trach,18,2,0,2,1
2022-06-01,Dong Nai,Trang Bom,10,3,0,3,2
2022-06-01,Dong Nai,Trang Bom,12,1,0,1,1
2022-06-01,Hai Phong City,An Duong,8,2,1,1,1
2022-06-01,Hai Phong City,An Duong,9,4,2,2,2
2022-06-01,Hai Phong City,An Duong,10,1,1,0,0
2022-06-01,Hai Phong City,An Duong,11,2,1,1,1
2022-06-01,Hai Phong City,An Duong,12,2,1,1,1
2022-06-01,Hai Phong City,An Duong,13,1,0,1,1
2022-06-01,Hai Phong City,An Duong,14,6,1,5,4
2022-06-01,Hai Phong City,An Duong,15,7,5,2,2
2022-06-01,Hai Phong City,An Duong,16,1,1,0,0
2022-06-01,Hai Phong City,An Duong,17,5,0,5,3
2022-06-01,Hai Phong City,An Duong,19,2,0,2,2
2022-06-01,Hai Phong City,An Duong,20,3,0,3,3
2022-06-01,Hai Phong City,An Duong,21,6,0,6,6
2022-06-01,Hai Phong City,Hai An District,6,1,1,0,0
2022-06-01,Hai Phong City,Hai An District,7,7,3,4,3
2022-06-01,Hai Phong City,Hai An District,8,20,12,8,5
2022-06-01,Hai Phong City,Hai An District,9,25,20,5,2
2022-06-01,Hai Phong City,Hai An District,10,39,30,9,4
2022-06-01,Hai Phong City,Hai An District,11,60,51,9,4
2022-06-01,Hai Phong City,Hai An District,12,42,34,8,2
2022-06-01,Hai Phong City,Hai An District,13,19,15,4,2
2022-06-01,Hai Phong City,Hai An District,14,17,15,2,0
2022-06-01,Hai Phong City,Hai An District,15,22,14,8,4
2022-06-01,Hai Phong City,Hai An District,16,16,11,5,1
2022-06-01,Hai Phong City,Hai An District,17,23,21,2,0
2022-06-01,Hai Phong City,Hai An District,18,26,24,2,1
2022-06-01,Hai Phong City,Hai An District,19,19,12,7,4
2022-06-01,Hai Phong City,Hai An District,20,17,13,4,3
2022-06-01,Hai Phong City,Hai An District,21,13,8,5,3
2022-06-01,Hai Phong City,Hong Bang District,0,1,1,0,0
2022-06-01,Hai Phong City,Hong Bang District,7,22,11,11,6
2022-06-01,Hai Phong City,Hong Bang District,8,37,33,4,1
2022-06-01,Hai Phong City,Hong Bang District,9,43,33,10,4
2022-06-01,Hai Phong City,Hong Bang District,10,64,53,11,5
2022-06-01,Hai Phong City,Hong Bang District,11,129,92,37,22
2022-06-01,Hai Phong City,Hong Bang District,12,55,46,9,6
2022-06-01,Hai Phong City,Hong Bang District,13,48,41,7,2
2022-06-01,Hai Phong City,Hong Bang District,14,55,42,13,10
2022-06-01,Hai Phong City,Hong Bang District,15,39,33,6,4
2022-06-01,Hai Phong City,Hong Bang District,16,43,35,8,2
2022-06-01,Hai Phong City,Hong Bang District,17,52,32,20,12
2022-06-01,Hai Phong City,Hong Bang District,18,60,39,21,12
2022-06-01,Hai Phong City,Hong Bang District,19,66,36,30,25
2022-06-01,Hai Phong City,Hong Bang District,20,45,21,24,13
2022-06-01,Hai Phong City,Hong Bang District,21,19,12,7,4
2022-06-01,Hai Phong City,Kien An District,7,3,0,3,0
2022-06-01,Hai Phong City,Kien An District,8,3,0,3,3
2022-06-01,Hai Phong City,Kien An District,9,7,4,3,1
2022-06-01,Hai Phong City,Kien An District,10,11,5,6,5
2022-06-01,Hai Phong City,Kien An District,11,21,17,4,4
2022-06-01,Hai Phong City,Kien An District,12,7,4,3,1
2022-06-01,Hai Phong City,Kien An District,13,4,4,0,0
2022-06-01,Hai Phong City,Kien An District,14,17,7,10,5
2022-06-01,Hai Phong City,Kien An District,15,13,8,5,1
2022-06-01,Hai Phong City,Kien An District,16,11,9,2,1
2022-06-01,Hai Phong City,Kien An District,17,13,9,4,1
2022-06-01,Hai Phong City,Kien An District,18,7,3,4,1
2022-06-01,Hai Phong City,Kien An District,19,18,11,7,3
2022-06-01,Hai Phong City,Kien An District,20,11,3,8,6
2022-06-01,Hai Phong City,Kien An District,21,13,3,10,10
2022-06-01,Hai Phong City,Le Chan District,2,1,1,0,0
2022-06-01,Hai Phong City,Le Chan District,6,2,2,0,0
2022-06-01,Hai Phong City,Le Chan District,7,36,30,6,2
2022-06-01,Hai Phong City,Le Chan District,8,67,57,10,3
2022-06-01,Hai Phong City,Le Chan District,9,96,83,13,2
2022-06-01,Hai Phong City,Le Chan District,10,223,182,41,9
2022-06-01,Hai Phong City,Le Chan District,11,356,298,58,36
2022-06-01,Hai Phong City,Le Chan District,12,274,246,28,6
2022-06-01,Hai Phong City,Le Chan District,13,174,148,26,6
2022-06-01,Hai Phong City,Le Chan District,14,171,136,35,23
2022-06-01,Hai Phong City,Le Chan District,15,196,163,33,10
2022-06-01,Hai Phong City,Le Chan District,16,134,114,20,7
2022-06-01,Hai Phong City,Le Chan District,17,187,140,47,16
2022-06-01,Hai Phong City,Le Chan District,18,252,178,74,41
2022-06-01,Hai Phong City,Le Chan District,19,235,173,62,35
2022-06-01,Hai Phong City,Le Chan District,20,155,102,53,35
2022-06-01,Hai Phong City,Le Chan District,21,77,46,31,22
2022-06-01,Hai Phong City,Ngo Quyen District,1,1,1,0,0
2022-06-01,Hai Phong City,Ngo Quyen District,2,1,0,1,0
2022-06-01,Hai Phong City,Ngo Quyen District,6,3,1,2,2
2022-06-01,Hai Phong City,Ngo Quyen District,7,24,15,9,6
2022-06-01,Hai Phong City,Ngo Quyen District,8,80,62,18,7
2022-06-01,Hai Phong City,Ngo Quyen District,9,82,75,7,3
2022-06-01,Hai Phong City,Ngo Quyen District,10,132,110,22,4
2022-06-01,Hai Phong City,Ngo Quyen District,11,262,217,45,26
2022-06-01,Hai Phong City,Ngo Quyen District,12,179,147,32,9
2022-06-01,Hai Phong City,Ngo Quyen District,13,142,124,18,3
2022-06-01,Hai Phong City,Ngo Quyen District,14,164,128,36,18
2022-06-01,Hai Phong City,Ngo Quyen District,15,128,112,16,3
2022-06-01,Hai Phong City,Ngo Quyen District,16,141,120,21,9
2022-06-01,Hai Phong City,Ngo Quyen District,17,161,130,31,18
2022-06-01,Hai Phong City,Ngo Quyen District,18,182,131,51,21
2022-06-01,Hai Phong City,Ngo Quyen District,19,185,137,48,21
2022-06-01,Hai Phong City,Ngo Quyen District,20,140,90,50,31
2022-06-01,Hai Phong City,Ngo Quyen District,21,68,38,30,12
2022-06-01,Hai Phong City,Ngo Quyen District,22,2,0,2,0
2022-06-01,Hai Phong City,Thuy Nguyen,10,1,0,1,1
2022-06-01,Hai Phong City,Thuy Nguyen,11,3,0,3,3
2022-06-01,Hai Phong City,Thuy Nguyen,12,3,0,3,3
2022-06-01,Hai Phong City,Thuy Nguyen,13,1,0,1,1
2022-06-01,Hai Phong City,Thuy Nguyen,16,1,0,1,1
2022-06-01,Hai Phong City,Thuy Nguyen,17,3,0,3,3
2022-06-01,Hai Phong City,Thuy Nguyen,18,3,0,3,3
2022-06-01,Hai Phong City,Thuy Nguyen,20,1,0,1,1
2022-06-01,Hue City,Hue City,0,2,2,0,0
2022-06-01,Hue City,Hue City,1,1,0,1,0
2022-06-01,Hue City,Hue City,2,1,1,0,0
2022-06-01,Hue City,Hue City,3,1,1,0,0
2022-06-01,Hue City,Hue City,4,1,1,0,0
2022-06-01,Hue City,Hue City,5,3,1,2,2
2022-06-01,Hue City,Hue City,6,74,67,7,2
2022-06-01,Hue City,Hue City,7,197,187,10,4
2022-06-01,Hue City,Hue City,8,314,297,17,0
2022-06-01,Hue City,Hue City,9,280,253,27,0
2022-06-01,Hue City,Hue City,10,467,430,37,1
2022-06-01,Hue City,Hue City,11,966,893,73,4
2022-06-01,Hue City,Hue City,12,633,591,42,0
2022-06-01,Hue City,Hue City,13,385,358,27,0
2022-06-01,Hue City,Hue City,14,368,348,20,0
2022-06-01,Hue City,Hue City,15,409,381,28,6
2022-06-01,Hue City,Hue City,16,400,362,38,3
2022-06-01,Hue City,Hue City,17,468,430,38,0
2022-06-01,Hue City,Hue City,18,550,482,68,1
2022-06-01,Hue City,Hue City,19,631,523,108,17
2022-06-01,Hue City,Hue City,20,500,366,134,69
2022-06-01,Hue City,Hue City,21,257,200,57,16
2022-06-01,Hue City,Hue City,22,1,0,1,0
2022-06-01,Hue City,Huong Thuy,8,2,1,1,0
2022-06-01,Hue City,Huong Thuy,9,3,1,2,1
2022-06-01,Hue City,Huong Thuy,11,1,0,1,0
2022-06-01,Hue City,Huong Thuy,14,1,1,0,0
2022-06-01,Hue City,Huong Thuy,15,4,0,4,3
2022-06-01,Hue City,Huong Thuy,16,7,3,4,1
2022-06-01,Hue City,Huong Thuy,17,1,1,0,0
2022-06-01,Hue City,Huong Thuy,18,4,3,1,0
2022-06-01,Hue City,Huong Thuy,19,2,1,1,0
2022-06-01,Hue City,Huong Thuy,20,2,1,1,1
2022-06-01,Hue City,Huong Thuy,21,2,1,1,1
2022-06-01,Hue City,Huong Tra,18,1,1,0,0
2022-06-01,Hue City,Phu Vang,8,3,3,0,0
2022-06-01,Hue City,Phu Vang,9,1,1,0,0
2022-06-01,Hue City,Phu Vang,10,1,0,1,1
2022-06-01,Hue City,Phu Vang,11,4,4,0,0
2022-06-01,Hue City,Phu Vang,12,2,2,0,0
2022-06-01,Hue City,Phu Vang,13,5,4,1,0
2022-06-01,Hue City,Phu Vang,14,1,0,1,0
2022-06-01,Hue City,Phu Vang,15,3,2,1,1
2022-06-01,Hue City,Phu Vang,17,2,1,1,1
2022-06-01,Hue City,Phu Vang,18,2,1,1,1
2022-06-01,Hue City,Phu Vang,19,4,2,2,1
2022-06-01,Hue City,Phu Vang,20,2,2,0,0
2022-06-01,Vung Tau,Ba Ria City,7,1,0,1,1
2022-06-01,Vung Tau,Ba Ria City,8,1,0,1,1
2022-06-01,Vung Tau,Ba Ria City,9,6,1,5,3
2022-06-01,Vung Tau,Ba Ria City,10,13,0,13,13
2022-06-01,Vung Tau,Ba Ria City,11,14,0,14,12
2022-06-01,Vung Tau,Ba Ria City,12,6,0,6,5
2022-06-01,Vung Tau,Ba Ria City,13,9,0,9,9
2022-06-01,Vung Tau,Ba Ria City,14,10,2,8,6
2022-06-01,Vung Tau,Ba Ria City,15,9,4,5,5
2022-06-01,Vung Tau,Ba Ria City,16,6,3,3,3
2022-06-01,Vung Tau,Ba Ria City,17,7,3,4,3
2022-06-01,Vung Tau,Ba Ria City,18,11,2,9,8
2022-06-01,Vung Tau,Ba Ria City,19,12,0,12,11
2022-06-01,Vung Tau,Ba Ria City,20,3,0,3,3
2022-06-01,Vung Tau,Tan Thanh,18,1,0,1,1
2022-06-01,Vung Tau,Vung Tau City,0,1,0,1,0
2022-06-01,Vung Tau,Vung Tau City,1,2,1,1,0
2022-06-01,Vung Tau,Vung Tau City,3,1,0,1,0
2022-06-01,Vung Tau,Vung Tau City,5,2,2,0,0
2022-06-01,Vung Tau,Vung Tau City,6,33,25,8,6
2022-06-01,Vung Tau,Vung Tau City,7,105,98,7,3
2022-06-01,Vung Tau,Vung Tau City,8,176,161,15,5
2022-06-01,Vung Tau,Vung Tau City,9,179,169,10,1
2022-06-01,Vung Tau,Vung Tau City,10,208,185,23,6
2022-06-01,Vung Tau,Vung Tau City,11,380,358,22,4
2022-06-01,Vung Tau,Vung Tau City,12,289,269,20,1
2022-06-01,Vung Tau,Vung Tau City,13,240,221,19,2
2022-06-01,Vung Tau,Vung Tau City,14,233,221,12,1
2022-06-01,Vung Tau,Vung Tau City,15,248,225,23,8
2022-06-01,Vung Tau,Vung Tau City,16,226,206,20,4
2022-06-01,Vung Tau,Vung Tau City,17,260,234,26,6
2022-06-01,Vung Tau,Vung Tau City,18,302,258,44,6
2022-06-01,Vung Tau,Vung Tau City,19,267,227,40,10
2022-06-01,Vung Tau,Vung Tau City,20,212,179,33,15
2022-06-01,Vung Tau,Vung Tau City,21,95,73,22,8
2022-06-02,Binh Duong,Ben Cat,9,1,0,1,1
2022-06-02,Binh Duong,Ben Cat,11,1,0,1,1
2022-06-02,Binh Duong,Ben Cat,12,5,0,5,5
2022-06-02,Binh Duong,Ben Cat,14,4,0,4,3
2022-06-02,Binh Duong,Ben Cat,15,1,0,1,1
2022-06-02,Binh Duong,Ben Cat,16,3,0,3,3
2022-06-02,Binh Duong,Ben Cat,18,1,0,1,1
2022-06-02,Binh Duong,Di An,7,9,3,6,4
2022-06-02,Binh Duong,Di An,8,10,7,3,2
2022-06-02,Binh Duong,Di An,9,18,14,4,3
2022-06-02,Binh Duong,Di An,10,39,28,11,8
2022-06-02,Binh Duong,Di An,11,30,24,6,2
2022-06-02,Binh Duong,Di An,12,33,14,19,16
2022-06-02,Binh Duong,Di An,13,35,21,14,13
2022-06-02,Binh Duong,Di An,14,29,17,12,11
2022-06-02,Binh Duong,Di An,15,24,16,8,7
2022-06-02,Binh Duong,Di An,16,24,9,15,12
2022-06-02,Binh Duong,Di An,17,38,12,26,18
2022-06-02,Binh Duong,Di An,18,80,10,70,63
2022-06-02,Binh Duong,Di An,19,81,9,72,63
2022-06-02,Binh Duong,Di An,20,60,8,52,45
2022-06-02,Binh Duong,Di An,21,24,5,19,16
2022-06-02,Binh Duong,Tan Uyen,8,1,1,0,0
2022-06-02,Binh Duong,Tan Uyen,9,2,1,1,1
2022-06-02,Binh Duong,Tan Uyen,11,3,1,2,1
2022-06-02,Binh Duong,Tan Uyen,12,1,1,0,0
2022-06-02,Binh Duong,Tan Uyen,13,2,2,0,0
2022-06-02,Binh Duong,Tan Uyen,14,5,2,3,2
2022-06-02,Binh Duong,Tan Uyen,15,1,0,1,0
2022-06-02,Binh Duong,Tan Uyen,16,1,0,1,1
2022-06-02,Binh Duong,Tan Uyen,17,4,2,2,2
2022-06-02,Binh Duong,Tan Uyen,18,1,0,1,1
2022-06-02,Binh Duong,Tan Uyen,19,2,0,2,2
2022-06-02,Binh Duong,Tan Uyen,20,8,1,7,4
2022-06-02,Binh Duong,Thu Dau Mot Town,0,1,0,1,1
2022-06-02,Binh Duong,Thu Dau Mot Town,5,1,0,1,1
2022-06-02,Binh Duong,Thu Dau Mot Town,6,28,27,1,1
2022-06-02,Binh Duong,Thu Dau Mot Town,7,115,102,13,2
2022-06-02,Binh Duong,Thu Dau Mot Town,8,223,212,11,0
2022-06-02,Binh Duong,Thu Dau Mot Town,9,263,246,17,0
2022-06-02,Binh Duong,Thu Dau Mot Town,10,406,388,18,1
2022-06-02,Binh Duong,Thu Dau Mot Town,11,608,530,78,51
2022-06-02,Binh Duong,Thu Dau Mot Town,12,483,423,60,20
2022-06-02,Binh Duong,Thu Dau Mot Town,13,409,389,20,2
2022-06-02,Binh Duong,Thu Dau Mot Town,14,339,325,14,1
2022-06-02,Binh Duong,Thu Dau Mot Town,15,307,285,22,8
2022-06-02,Binh Duong,Thu Dau Mot Town,16,315,253,62,24
2022-06-02,Binh Duong,Thu Dau Mot Town,17,552,358,194,145
2022-06-02,Binh Duong,Thu Dau Mot Town,18,669,368,301,246
2022-06-02,Binh Duong,Thu Dau Mot Town,19,629,369,260,208
2022-06-02,Binh Duong,Thu Dau Mot Town,20,468,249,219,160
2022-06-02,Binh Duong,Thu Dau Mot Town,21,263,115,148,106
2022-06-02,Binh Duong,Thu Dau Mot Town,22,3,1,2,2
2022-06-02,Binh Duong,Thu Dau Mot Town,23,1,0,1,0
2022-06-02,Binh Duong,Thuan An,5,1,0,1,1
2022-06-02,Binh Duong,Thuan An,6,4,1,3,1
2022-06-02,Binh Duong,Thuan An,7,8,3,5,5
2022-06-02,Binh Duong,Thuan An,8,18,9,9,4
2022-06-02,Binh Duong,Thuan An,9,38,31,7,3
2022-06-02,Binh Duong,Thuan An,10,66,46,20,13
2022-06-02,Binh Duong,Thuan An,11,71,47,24,20
2022-06-02,Binh Duong,Thuan An,12,66,43,23,12
2022-06-02,Binh Duong,Thuan An,13,83,45,38,27
2022-06-02,Binh Duong,Thuan An,14,68,46,22,12
2022-06-02,Binh Duong,Thuan An,15,39,29,10,2
2022-06-02,Binh Duong,Thuan An,16,30,17,13,10
2022-06-02,Binh Duong,Thuan An,17,42,29,13,11
2022-06-02,Binh Duong,Thuan An,18,90,41,49,40
2022-06-02,Binh Duong,Thuan An,19,104,27,77,73
2022-06-02,Binh Duong,Thuan An,20,76,22,54,47
2022-06-02,Binh Duong,Thuan An,21,39,11,28,22
2022-06-02,Binh Duong,Thuan An,22,1,0,1,0
2022-06-02,Can Tho City,Binh Thuy District,7,1,1,0,0
2022-06-02,Can Tho City,Binh Thuy District,8,1,1,0,0
2022-06-02,Can Tho City,Binh Thuy District,9,4,4,0,0
2022-06-02,Can Tho City,Binh Thuy District,10,5,5,0,0
2022-06-02,Can Tho City,Binh Thuy District,11,16,14,2,0
2022-06-02,Can Tho City,Binh Thuy District,12,13,13,0,0
2022-06-02,Can Tho City,Binh Thuy District,13,14,13,1,0
2022-06-02,Can Tho City,Binh Thuy District,14,12,12,0,0
2022-06-02,Can Tho City,Binh Thuy District,15,9,9,0,0
2022-06-02,Can Tho City,Binh Thuy District,16,15,14,1,0
2022-06-02,Can Tho City,Binh Thuy District,17,8,8,0,0
2022-06-02,Can Tho City,Binh Thuy District,18,12,12,0,0
2022-06-02,Can Tho City,Binh Thuy District,19,15,13,2,0
2022-06-02,Can Tho City,Binh Thuy District,20,10,9,1,0
2022-06-02,Can Tho City,Binh Thuy District,21,7,2,5,0
2022-06-02,Can Tho City,Cai Rang District,6,1,1,0,0
2022-06-02,Can Tho City,Cai Rang District,7,6,2,4,3
2022-06-02,Can Tho City,Cai Rang District,8,10,7,3,3
2022-06-02,Can Tho City,Cai Rang District,9,13,10,3,3
2022-06-02,Can Tho City,Cai Rang District,10,15,14,1,0
2022-06-02,Can Tho City,Cai Rang District,11,13,12,1,0
2022-06-02,Can Tho City,Cai Rang District,12,17,15,2,0
2022-06-02,Can Tho City,Cai Rang District,13,9,8,1,0
2022-06-02,Can Tho City,Cai Rang District,14,9,9,0,0
2022-06-02,Can Tho City,Cai Rang District,15,3,3,0,0
2022-06-02,Can Tho City,Cai Rang District,16,6,5,1,0
2022-06-02,Can Tho City,Cai Rang District,17,15,14,1,0
2022-06-02,Can Tho City,Cai Rang District,18,13,11,2,0
2022-06-02,Can Tho City,Cai Rang District,19,15,15,0,0
2022-06-02,Can Tho City,Cai Rang District,20,15,12,3,1
2022-06-02,Can Tho City,Cai Rang District,21,3,2,1,0
2022-06-02,Can Tho City,Ninh Kieu District,0,3,2,1,0
2022-06-02,Can Tho City,Ninh Kieu District,1,1,0,1,0
2022-06-02,Can Tho City,Ninh Kieu District,4,2,1,1,0
2022-06-02,Can Tho City,Ninh Kieu District,5,1,1,0,0
2022-06-02,Can Tho City,Ninh Kieu District,6,54,45,9,4
2022-06-02,Can Tho City,Ninh Kieu District,7,139,124,15,0
2022-06-02,Can Tho City,Ninh Kieu District,8,243,229,14,0
2022-06-02,Can Tho City,Ninh Kieu District,9,292,275,17,0
2022-06-02,Can Tho City,Ninh Kieu District,10,542,523,19,0
2022-06-02,Can Tho City,Ninh Kieu District,11,862,824,38,0
2022-06-02,Can Tho City,Ninh Kieu District,12,657,626,31,1
2022-06-02,Can Tho City,Ninh Kieu District,13,530,512,18,0
2022-06-02,Can Tho City,Ninh Kieu District,14,428,405,23,0
2022-06-02,Can Tho City,Ninh Kieu District,15,358,340,18,0
2022-06-02,Can Tho City,Ninh Kieu District,16,485,460,25,0
2022-06-02,Can Tho City,Ninh Kieu District,17,605,580,25,0
2022-06-02,Can Tho City,Ninh Kieu District,18,582,555,27,0
2022-06-02,Can Tho City,Ninh Kieu District,19,479,453,26,0
2022-06-02,Can Tho City,Ninh Kieu District,20,360,339,21,0
2022-06-02,Can Tho City,Ninh Kieu District,21,217,198,19,0
2022-06-02,Can Tho City,Ninh Kieu District,22,1,0,1,0
2022-06-02,Can Tho City,Ninh Kieu District,23,1,0,1,0
2022-06-02,Dong Nai,Bien Hoa City,0,1,0,1,0
2022-06-02,Dong Nai,Bien Hoa City,1,3,0,3,0
2022-06-02,Dong Nai,Bien Hoa City,2,2,2,0,0
2022-06-02,Dong Nai,Bien Hoa City,3,1,0,1,0
2022-06-02,Dong Nai,Bien Hoa City,6,39,21,18,14
2022-06-02,Dong Nai,Bien Hoa City,7,170,144,26,9
2022-06-02,Dong Nai,Bien Hoa City,8,337,286,51,30
2022-06-02,Dong Nai,Bien Hoa City,9,405,337,68,29
2022-06-02,Dong Nai,Bien Hoa City,10,764,660,104,37
2022-06-02,Dong Nai,Bien Hoa City,11,1101,971,130,44
2022-06-02,Dong Nai,Bien Hoa City,12,666,538,128,49
2022-06-02,Dong Nai,Bien Hoa City,13,702,601,101,45
2022-06-02,Dong Nai,Bien Hoa City,14,659,558,101,44
2022-06-02,Dong Nai,Bien Hoa City,15,629,518,111,61
2022-06-02,Dong Nai,Bien Hoa City,16,549,359,190,136
2022-06-02,Dong Nai,Bien Hoa City,17,940,457,483,382
2022-06-02,Dong Nai,Bien Hoa City,18,1313,601,712,588
2022-06-02,Dong Nai,Bien Hoa City,19,1363,573,790,628
2022-06-02,Dong Nai,Bien Hoa City,20,999,417,582,448
2022-06-02,Dong Nai,Bien Hoa City,21,365,182,183,106
2022-06-02,Dong Nai,Bien Hoa City,22,6,0,6,0
2022-06-02,Dong Nai,Bien Hoa City,23,4,0,4,0
2022-06-02,Dong Nai,Long Khanh,8,1,0,1,1
2022-06-02,Dong Nai,Long Khanh,9,1,0,1,1
2022-06-02,Dong Nai,Long Khanh,11,1,0,1,1
2022-06-02,Dong Nai,Long Thanh,9,1,0,1,1
2022-06-02,Dong Nai,Long Thanh,10,4,1,3,3
2022-06-02,Dong Nai,Long Thanh,11,2,0,2,1
2022-06-02,Dong Nai,Long Thanh,12,1,1,0,0
2022-06-02,Dong Nai,Long Thanh,13,4,3,1,1
2022-06-02,Dong Nai,Long Thanh,14,3,0,3,2
2022-06-02,Dong Nai,Long Thanh,15,2,0,2,2
2022-06-02,Dong Nai,Long Thanh,16,1,0,1,1
2022-06-02,Dong Nai,Long Thanh,20,1,0,1,1
2022-06-02,Dong Nai,Nhon trach,10,2,0,2,1
2022-06-02,Dong Nai,Nhon trach,11,1,0,1,1
2022-06-02,Dong Nai,Nhon trach,19,1,0,1,0
2022-06-02,Dong Nai,Trang Bom,9,2,0,2,2
2022-06-02,Dong Nai,Trang Bom,11,2,0,2,2
2022-06-02,Dong Nai,Trang Bom,13,1,0,1,1
2022-06-02,Dong Nai,Trang Bom,14,2,1,1,1
2022-06-02,Dong Nai,Trang Bom,19,1,0,1,1
2022-06-02,Dong Nai,Trang Bom,21,2,0,2,2
2022-06-02,Hai Phong City,An Duong,8,3,2,1,1
2022-06-02,Hai Phong City,An Duong,10,3,0,3,2
2022-06-02,Hai Phong City,An Duong,11,2,1,1,1
2022-06-02,Hai Phong City,An Duong,12,2,1,1,1
2022-06-02,Hai Phong City,An Duong,13,3,1,2,2
2022-06-02,Hai Phong City,An Duong,14,4,1,3,2
2022-06-02,Hai Phong City,An Duong,16,1,1,0,0
2022-06-02,Hai Phong City,An Duong,17,1,1,0,0
2022-06-02,Hai Phong City,An Duong,18,7,2,5,3
2022-06-02,Hai Phong City,An Duong,19,7,2,5,3
2022-06-02,Hai Phong City,An Duong,20,1,0,1,0
2022-06-02,Hai Phong City,An Duong,21,1,0,1,1
2022-06-02,Hai Phong City,Do Son District,12,1,0,1,1
2022-06-02,Hai Phong City,Duong Kinh District,13,2,0,2,2
2022-06-02,Hai Phong City,Duong Kinh District,16,1,0,1,0
2022-06-02,Hai Phong City,Hai An District,7,7,5,2,2
2022-06-02,Hai Phong City,Hai An District,8,10,10,0,0
2022-06-02,Hai Phong City,Hai An District,9,10,8,2,0
2022-06-02,Hai Phong City,Hai An District,10,36,31,5,4
2022-06-02,Hai Phong City,Hai An District,11,64,46,18,10
2022-06-02,Hai Phong City,Hai An District,12,36,32,4,2
2022-06-02,Hai Phong City,Hai An District,13,15,13,2,0
2022-06-02,Hai Phong City,Hai An District,14,24,16,8,5
2022-06-02,Hai Phong City,Hai An District,15,30,17,13,6
2022-06-02,Hai Phong City,Hai An District,16,27,25,2,0
2022-06-02,Hai Phong City,Hai An District,17,22,20,2,1
2022-06-02,Hai Phong City,Hai An District,18,25,22,3,2
2022-06-02,Hai Phong City,Hai An District,19,26,21,5,1
2022-06-02,Hai Phong City,Hai An District,20,10,9,1,1
2022-06-02,Hai Phong City,Hai An District,21,15,10,5,5
2022-06-02,Hai Phong City,Hong Bang District,7,19,14,5,3
2022-06-02,Hai Phong City,Hong Bang District,8,36,26,10,1
2022-06-02,Hai Phong City,Hong Bang District,9,43,36,7,1
2022-06-02,Hai Phong City,Hong Bang District,10,48,42,6,1
2022-06-02,Hai Phong City,Hong Bang District,11,113,89,24,20
2022-06-02,Hai Phong City,Hong Bang District,12,60,52,8,3
2022-06-02,Hai Phong City,Hong Bang District,13,50,36,14,10
2022-06-02,Hai Phong City,Hong Bang District,14,47,32,15,12
2022-06-02,Hai Phong City,Hong Bang District,15,47,37,10,5
2022-06-02,Hai Phong City,Hong Bang District,16,25,20,5,1
2022-06-02,Hai Phong City,Hong Bang District,17,47,40,7,1
2022-06-02,Hai Phong City,Hong Bang District,18,48,32,16,8
2022-06-02,Hai Phong City,Hong Bang District,19,50,37,13,8
2022-06-02,Hai Phong City,Hong Bang District,20,31,26,5,3
2022-06-02,Hai Phong City,Hong Bang District,21,24,17,7,4
2022-06-02,Hai Phong City,Kien An District,8,6,0,6,3
2022-06-02,Hai Phong City,Kien An District,9,8,3,5,2
2022-06-02,Hai Phong City,Kien An District,10,22,7,15,10
2022-06-02,Hai Phong City,Kien An District,11,19,5,14,11
2022-06-02,Hai Phong City,Kien An District,12,15,11,4,4
2022-06-02,Hai Phong City,Kien An District,13,5,4,1,1
2022-06-02,Hai Phong City,Kien An District,14,17,4,13,11
2022-06-02,Hai Phong City,Kien An District,15,15,7,8,8
2022-06-02,Hai Phong City,Kien An District,16,19,5,14,11
2022-06-02,Hai Phong City,Kien An District,17,12,10,2,2
2022-06-02,Hai Phong City,Kien An District,18,12,12,0,0
2022-06-02,Hai Phong City,Kien An District,19,13,11,2,1
2022-06-02,Hai Phong City,Kien An District,20,9,7,2,0
2022-06-02,Hai Phong City,Kien An District,21,2,1,1,0
2022-06-02,Hai Phong City,Le Chan District,0,1,0,1,0
2022-06-02,Hai Phong City,Le Chan District,1,1,0,1,1
2022-06-02,Hai Phong City,Le Chan District,2,2,0,2,1
2022-06-02,Hai Phong City,Le Chan District,6,2,1,1,0
2022-06-02,Hai Phong City,Le Chan District,7,37,31,6,6
2022-06-02,Hai Phong City,Le Chan District,8,83,73,10,0
2022-06-02,Hai Phong City,Le Chan District,9,90,82,8,0
2022-06-02,Hai Phong City,Le Chan District,10,173,156,17,6
2022-06-02,Hai Phong City,Le Chan District,11,380,311,69,42
2022-06-02,Hai Phong City,Le Chan District,12,247,212,35,15
2022-06-02,Hai Phong City,Le Chan District,13,147,126,21,7
2022-06-02,Hai Phong City,Le Chan District,14,148,117,31,20
2022-06-02,Hai Phong City,Le Chan District,15,185,150,35,17
2022-06-02,Hai Phong City,Le Chan District,16,136,121,15,1
2022-06-02,Hai Phong City,Le Chan District,17,153,129,24,7
2022-06-02,Hai Phong City,Le Chan District,18,217,193,24,9
2022-06-02,Hai Phong City,Le Chan District,19,215,180,35,19
2022-06-02,Hai Phong City,Le Chan District,20,138,106,32,17
2022-06-02,Hai Phong City,Le Chan District,21,81,53,28,18
2022-06-02,Hai Phong City,Le Chan District,23,1,0,1,0
2022-06-02,Hai Phong City,Ngo Quyen District,4,1,0,1,0
2022-06-02,Hai Phong City,Ngo Quyen District,6,1,1,0,0
2022-06-02,Hai Phong City,Ngo Quyen District,7,26,14,12,6
2022-06-02,Hai Phong City,Ngo Quyen District,8,72,60,12,3
2022-06-02,Hai Phong City,Ngo Quyen District,9,78,69,9,2
2022-06-02,Hai Phong City,Ngo Quyen District,10,123,109,14,1
2022-06-02,Hai Phong City,Ngo Quyen District,11,261,211,50,31
2022-06-02,Hai Phong City,Ngo Quyen District,12,183,147,36,18
2022-06-02,Hai Phong City,Ngo Quyen District,13,136,116,20,6
2022-06-02,Hai Phong City,Ngo Quyen District,14,138,119,19,10
2022-06-02,Hai Phong City,Ngo Quyen District,15,152,127,25,6
2022-06-02,Hai Phong City,Ngo Quyen District,16,109,97,12,2
2022-06-02,Hai Phong City,Ngo Quyen District,17,129,113,16,3
2022-06-02,Hai Phong City,Ngo Quyen District,18,168,147,21,10
2022-06-02,Hai Phong City,Ngo Quyen District,19,138,112,26,10
2022-06-02,Hai Phong City,Ngo Quyen District,20,128,110,18,8
2022-06-02,Hai Phong City,Ngo Quyen District,21,75,52,23,13
2022-06-02,Hai Phong City,Ngo Quyen District,23,1,0,1,0
2022-06-02,Hai Phong City,Thuy Nguyen,10,1,1,0,0
2022-06-02,Hai Phong City,Thuy Nguyen,11,2,0,2,2
2022-06-02,Hai Phong City,Thuy Nguyen,12,3,0,3,3
2022-06-02,Hai Phong City,Thuy Nguyen,13,1,0,1,1
2022-06-02,Hai Phong City,Thuy Nguyen,14,5,0,5,5
2022-06-02,Hai Phong City,Thuy Nguyen,15,1,0,1,1
2022-06-02,Hai Phong City,Thuy Nguyen,16,2,0,2,2
2022-06-02,Hai Phong City,Thuy Nguyen,17,1,0,1,1
2022-06-02,Hai Phong City,Thuy Nguyen,18,5,0,5,2
2022-06-02,Hai Phong City,Thuy Nguyen,19,5,0,5,5
2022-06-02,Hai Phong City,Thuy Nguyen,20,2,0,2,2
2022-06-02,Hue City,Hue City,0,3,2,1,1
2022-06-02,Hue City,Hue City,5,1,1,0,0
2022-06-02,Hue City,Hue City,6,94,78,16,4
2022-06-02,Hue City,Hue City,7,245,228,17,0
2022-06-02,Hue City,Hue City,8,325,295,30,2
2022-06-02,Hue City,Hue City,9,300,275,25,0
2022-06-02,Hue City,Hue City,10,445,409,36,2
2022-06-02,Hue City,Hue City,11,877,811,66,3
2022-06-02,Hue City,Hue City,12,573,528,45,1
2022-06-02,Hue City,Hue City,13,410,375,35,2
2022-06-02,Hue City,Hue City,14,393,350,43,3
2022-06-02,Hue City,Hue City,15,465,429,36,5
2022-06-02,Hue City,Hue City,16,420,384,36,4
2022-06-02,Hue City,Hue City,17,481,447,34,0
2022-06-02,Hue City,Hue City,18,600,558,42,1
2022-06-02,Hue City,Hue City,19,561,517,44,3
2022-06-02,Hue City,Hue City,20,400,353,47,2
2022-06-02,Hue City,Hue City,21,294,224,70,22
2022-06-02,Hue City,Hue City,22,1,0,1,0
2022-06-02,Hue City,Huong Thuy,6,1,1,0,0
2022-06-02,Hue City,Huong Thuy,7,1,0,1,0
2022-06-02,Hue City,Huong Thuy,8,1,1,0,0
2022-06-02,Hue City,Huong Thuy,9,1,1,0,0
2022-06-02,Hue City,Huong Thuy,10,2,1,1,0
2022-06-02,Hue City,Huong Thuy,12,2,0,2,1
2022-06-02,Hue City,Huong Thuy,14,1,0,1,1
2022-06-02,Hue City,Huong Thuy,16,1,1,0,0
2022-06-02,Hue City,Huong Thuy,17,2,2,0,0
2022-06-02,Hue City,Huong Thuy,18,3,1,2,1
2022-06-02,Hue City,Huong Thuy,20,1,1,0,0
2022-06-02,Hue City,Huong Tra,9,2,1,1,0
2022-06-02,Hue City,Huong Tra,11,1,0,1,1
2022-06-02,Hue City,Huong Tra,15,1,1,0,0
2022-06-02,Hue City,Huong Tra,20,1,0,1,1
2022-06-02,Hue City,Huong Tra,21,1,0,1,1
2022-06-02,Hue City,Phu Vang,7,1,1,0,0
2022-06-02,Hue City,Phu Vang,8,2,1,1,0
2022-06-02,Hue City,Phu Vang,9,4,1,3,2
2022-06-02,Hue City,Phu Vang,10,1,1,0,0
2022-06-02,Hue City,Phu Vang,11,3,3,0,0
2022-06-02,Hue City,Phu Vang,12,3,3,0,0
2022-06-02,Hue City,Phu Vang,13,3,2,1,0
2022-06-02,Hue City,Phu Vang,15,2,2,0,0
2022-06-02,Hue City,Phu Vang,17,2,2,0,0
2022-06-02,Hue City,Phu Vang,18,1,1,0,0
2022-06-02,Hue City,Phu Vang,19,2,2,0,0
2022-06-02,Hue City,Phu Vang,20,1,1,0,0
2022-06-02,Hue City,Phu Vang,21,1,0,1,1
2022-06-02,Vung Tau,Ba Ria City,7,3,0,3,2
2022-06-02,Vung Tau,Ba Ria City,8,6,2,4,3
2022-06-02,Vung Tau,Ba Ria City,9,6,4,2,2
2022-06-02,Vung Tau,Ba Ria City,10,5,2,3,2
2022-06-02,Vung Tau,Ba Ria City,11,11,4,7,7
2022-06-02,Vung Tau,Ba Ria City,12,3,0,3,2
2022-06-02,Vung Tau,Ba Ria City,13,1,0,1,1
2022-06-02,Vung Tau,Ba Ria City,14,16,1,15,12
2022-06-02,Vung Tau,Ba Ria City,15,14,0,14,14
2022-06-02,Vung Tau,Ba Ria City,16,13,0,13,13
2022-06-02,Vung Tau,Ba Ria City,17,9,0,9,7
2022-06-02,Vung Tau,Ba Ria City,18,5,0,5,5
2022-06-02,Vung Tau,Ba Ria City,19,9,0,9,9
2022-06-02,Vung Tau,Ba Ria City,20,2,0,2,2
2022-06-02,Vung Tau,Ba Ria City,21,3,0,3,2
2022-06-02,Vung Tau,Tan Thanh,10,1,0,1,0
2022-06-02,Vung Tau,Tan Thanh,11,1,0,1,1
2022-06-02,Vung Tau,Tan Thanh,16,1,0,1,1
2022-06-02,Vung Tau,Tan Thanh,18,1,0,1,1
2022-06-02,Vung Tau,Vung Tau City,1,1,0,1,0
2022-06-02,Vung Tau,Vung Tau City,3,1,0,1,0
2022-06-02,Vung Tau,Vung Tau City,5,3,3,0,0
2022-06-02,Vung Tau,Vung Tau City,6,40,33,7,5
2022-06-02,Vung Tau,Vung Tau City,7,96,87,9,1
2022-06-02,Vung Tau,Vung Tau City,8,186,171,15,2
2022-06-02,Vung Tau,Vung Tau City,9,170,156,14,1
2022-06-02,Vung Tau,Vung Tau City,10,173,157,16,4
2022-06-02,Vung Tau,Vung Tau City,11,329,307,22,6
2022-06-02,Vung Tau,Vung Tau City,12,284,258,26,5
2022-06-02,Vung Tau,Vung Tau City,13,209,197,12,4
2022-06-02,Vung Tau,Vung Tau City,14,245,221,24,5
2022-06-02,Vung Tau,Vung Tau City,15,217,202,15,1
2022-06-02,Vung Tau,Vung Tau City,16,202,189,13,1
2022-06-02,Vung Tau,Vung Tau City,17,249,231,18,6
2022-06-02,Vung Tau,Vung Tau City,18,389,237,152,116
2022-06-02,Vung Tau,Vung Tau City,19,508,217,291,243
2022-06-02,Vung Tau,Vung Tau City,20,368,133,235,200
2022-06-02,Vung Tau,Vung Tau City,21,145,56,89,70
2022-06-02,Vung Tau,Vung Tau City,22,1,0,1,0
2022-06-02,Vung Tau,Vung Tau City,23,1,0,1,0
2022-06-03,Binh Duong,Ben Cat,12,2,0,2,1
2022-06-03,Binh Duong,Ben Cat,14,2,0,2,1
2022-06-03,Binh Duong,Ben Cat,16,1,0,1,1
2022-06-03,Binh Duong,Ben Cat,19,3,1,2,0
2022-06-03,Binh Duong,Ben Cat,20,1,0,1,1
2022-06-03,Binh Duong,Ben Cat,21,1,0,1,1
2022-06-03,Binh Duong,Di An,6,2,0,2,2
2022-06-03,Binh Duong,Di An,7,4,1,3,2
2022-06-03,Binh Duong,Di An,8,25,3,22,20
2022-06-03,Binh Duong,Di An,9,28,11,17,14
2022-06-03,Binh Duong,Di An,10,39,12,27,22
2022-06-03,Binh Duong,Di An,11,41,27,14,11
2022-06-03,Binh Duong,Di An,12,42,24,18,12
2022-06-03,Binh Duong,Di An,13,35,17,18,17
2022-06-03,Binh Duong,Di An,14,30,10,20,13
2022-06-03,Binh Duong,Di An,15,34,18,16,15
2022-06-03,Binh Duong,Di An,16,43,27,16,6
2022-06-03,Binh Duong,Di An,17,51,35,16,14
2022-06-03,Binh Duong,Di An,18,36,18,18,16
2022-06-03,Binh Duong,Di An,19,47,29,18,15
2022-06-03,Binh Duong,Di An,20,28,12,16,11
2022-06-03,Binh Duong,Di An,21,19,6,13,11
2022-06-03,Binh Duong,Di An,22,1,0,1,0
2022-06-03,Binh Duong,Tan Uyen,7,2,0,2,2
2022-06-03,Binh Duong,Tan Uyen,8,2,1,1,0
2022-06-03,Binh Duong,Tan Uyen,10,1,1,0,0
2022-06-03,Binh Duong,Tan Uyen,11,4,2,2,2
2022-06-03,Binh Duong,Tan Uyen,12,7,4,3,1
2022-06-03,Binh Duong,Tan Uyen,14,6,4,2,2
2022-06-03,Binh Duong,Tan Uyen,18,1,1,0,0
2022-06-03,Binh Duong,Tan Uyen,19,1,1,0,0
2022-06-03,Binh Duong,Tan Uyen,21,3,1,2,1
2022-06-03,Binh Duong,Thu Dau Mot Town,0,1,0,1,0
2022-06-03,Binh Duong,Thu Dau Mot Town,1,2,0,2,1
2022-06-03,Binh Duong,Thu Dau Mot Town,5,3,0,3,1
2022-06-03,Binh Duong,Thu Dau Mot Town,6,45,26,19,11
2022-06-03,Binh Duong,Thu Dau Mot Town,7,131,116,15,3
2022-06-03,Binh Duong,Thu Dau Mot Town,8,206,177,29,5
2022-06-03,Binh Duong,Thu Dau Mot Town,9,308,279,29,1
2022-06-03,Binh Duong,Thu Dau Mot Town,10,405,380,25,3
2022-06-03,Binh Duong,Thu Dau Mot Town,11,625,582,43,4
2022-06-03,Binh Duong,Thu Dau Mot Town,12,448,423,25,4
2022-06-03,Binh Duong,Thu Dau Mot Town,13,521,475,46,14
2022-06-03,Binh Duong,Thu Dau Mot Town,14,342,318,24,7
2022-06-03,Binh Duong,Thu Dau Mot Town,15,279,263,16,1
2022-06-03,Binh Duong,Thu Dau Mot Town,16,288,269,19,3
2022-06-03,Binh Duong,Thu Dau Mot Town,17,355,334,21,2
2022-06-03,Binh Duong,Thu Dau Mot Town,18,381,362,19,1
2022-06-03,Binh Duong,Thu Dau Mot Town,19,363,333,30,3
2022-06-03,Binh Duong,Thu Dau Mot Town,20,250,226,24,2
2022-06-03,Binh Duong,Thu Dau Mot Town,21,115,96,19,5
2022-06-03,Binh Duong,Thu Dau Mot Town,22,3,1,2,0
2022-06-03,Binh Duong,Thu Dau Mot Town,23,1,1,0,0
2022-06-03,Binh Duong,Thuan An,6,2,1,1,1
2022-06-03,Binh Duong,Thuan An,7,7,2,5,4
2022-06-03,Binh Duong,Thuan An,8,26,12,14,11
2022-06-03,Binh Duong,Thuan An,9,49,22,27,21
2022-06-03,Binh Duong,Thuan An,10,57,35,22,17
2022-06-03,Binh Duong,Thuan An,11,102,66,36,23
2022-06-03,Binh Duong,Thuan An,12,70,45,25,18
2022-06-03,Binh Duong,Thuan An,13,81,58,23,19
2022-06-03,Binh Duong,Thuan An,14,54,20,34,29
2022-06-03,Binh Duong,Thuan An,15,51,31,20,18
2022-06-03,Binh Duong,Thuan An,16,28,25,3,3
2022-06-03,Binh Duong,Thuan An,17,41,35,6,4
2022-06-03,Binh Duong,Thuan An,18,58,39,19,12
2022-06-03,Binh Duong,Thuan An,19,60,36,24,14
2022-06-03,Binh Duong,Thuan An,20,38,28,10,10
2022-06-03,Binh Duong,Thuan An,21,24,8,16,8
2022-06-03,Can Tho City,Binh Thuy District,7,2,2,0,0
2022-06-03,Can Tho City,Binh Thuy District,8,9,6,3,2
2022-06-03,Can Tho City,Binh Thuy District,9,14,11,3,1
2022-06-03,Can Tho City,Binh Thuy District,10,11,10,1,1
2022-06-03,Can Tho City,Binh Thuy District,11,14,11,3,1
2022-06-03,Can Tho City,Binh Thuy District,12,8,7,1,0
2022-06-03,Can Tho City,Binh Thuy District,13,16,15,1,0
2022-06-03,Can Tho City,Binh Thuy District,14,11,10,1,0
2022-06-03,Can Tho City,Binh Thuy District,15,5,5,0,0
2022-06-03,Can Tho City,Binh Thuy District,16,3,3,0,0
2022-06-03,Can Tho City,Binh Thuy District,17,12,12,0,0
2022-06-03,Can Tho City,Binh Thuy District,18,15,14,1,0
2022-06-03,Can Tho City,Binh Thuy District,19,25,23,2,0
2022-06-03,Can Tho City,Binh Thuy District,20,14,12,2,2
2022-06-03,Can Tho City,Binh Thuy District,21,6,2,4,0
2022-06-03,Can Tho City,Cai Rang District,6,4,2,2,1
2022-06-03,Can Tho City,Cai Rang District,7,5,3,2,1
2022-06-03,Can Tho City,Cai Rang District,8,8,8,0,0
2022-06-03,Can Tho City,Cai Rang District,9,6,4,2,0
2022-06-03,Can Tho City,Cai Rang District,10,13,12,1,0
2022-06-03,Can Tho City,Cai Rang District,11,19,18,1,0
2022-06-03,Can Tho City,Cai Rang District,12,9,9,0,0
2022-06-03,Can Tho City,Cai Rang District,13,11,11,0,0
2022-06-03,Can Tho City,Cai Rang District,14,7,7,0,0
2022-06-03,Can Tho City,Cai Rang District,15,7,7,0,0
2022-06-03,Can Tho City,Cai Rang District,16,11,9,2,1
2022-06-03,Can Tho City,Cai Rang District,17,12,11,1,0
2022-06-03,Can Tho City,Cai Rang District,18,7,4,3,1
2022-06-03,Can Tho City,Cai Rang District,19,18,12,6,0
2022-06-03,Can Tho City,Cai Rang District,20,12,10,2,0
2022-06-03,Can Tho City,Cai Rang District,21,3,3,0,0
2022-06-03,Can Tho City,Ninh Kieu District,0,5,2,3,0
2022-06-03,Can Tho City,Ninh Kieu District,1,1,0,1,0
2022-06-03,Can Tho City,Ninh Kieu District,2,1,0,1,0
2022-06-03,Can Tho City,Ninh Kieu District,3,1,1,0,0
2022-06-03,Can Tho City,Ninh Kieu District,4,1,0,1,0
2022-06-03,Can Tho City,Ninh Kieu District,5,2,2,0,0
2022-06-03,Can Tho City,Ninh Kieu District,6,49,47,2,0
2022-06-03,Can Tho City,Ninh Kieu District,7,146,132,14,0
2022-06-03,Can Tho City,Ninh Kieu District,8,228,207,21,0
2022-06-03,Can Tho City,Ninh Kieu District,9,337,314,23,0
2022-06-03,Can Tho City,Ninh Kieu District,10,557,521,36,0
2022-06-03,Can Tho City,Ninh Kieu District,11,868,814,54,4
2022-06-03,Can Tho City,Ninh Kieu District,12,552,516,36,0
2022-06-03,Can Tho City,Ninh Kieu District,13,450,419,31,0
2022-06-03,Can Tho City,Ninh Kieu District,14,420,402,18,0
2022-06-03,Can Tho City,Ninh Kieu District,15,357,333,24,0
2022-06-03,Can Tho City,Ninh Kieu District,16,399,380,19,0
2022-06-03,Can Tho City,Ninh Kieu District,17,563,527,36,0
2022-06-03,Can Tho City,Ninh Kieu District,18,597,552,45,0
2022-06-03,Can Tho City,Ninh Kieu District,19,557,522,35,0
2022-06-03,Can Tho City,Ninh Kieu District,20,360,332,28,0
2022-06-03,Can Tho City,Ninh Kieu District,21,209,183,26,2
2022-06-03,Can Tho City,Ninh Kieu District,22,1,0,1,0
2022-06-03,Can Tho City,Ninh Kieu District,23,6,3,3,0
2022-06-03,Can Tho City,O Mon District,11,1,0,1,1
2022-06-03,Can Tho City,O Mon District,13,1,0,1,1
2022-06-03,Can Tho City,O Mon District,15,2,0,2,2
2022-06-03,Can Tho City,O Mon District,16,1,0,1,1
2022-06-03,Can Tho City,Thoi Lai,13,2,0,2,1
2022-06-03,Dong Nai,Bien Hoa City,0,2,0,2,1
2022-06-03,Dong Nai,Bien Hoa City,1,2,1,1,0
2022-06-03,Dong Nai,Bien Hoa City,3,3,1,2,0
2022-06-03,Dong Nai,Bien Hoa City,6,34,20,14,13
2022-06-03,Dong Nai,Bien Hoa City,7,173,137,36,23
2022-06-03,Dong Nai,Bien Hoa City,8,332,287,45,9
2022-06-03,Dong Nai,Bien Hoa City,9,481,430,51,7
2022-06-03,Dong Nai,Bien Hoa City,10,804,716,88,23
2022-06-03,Dong Nai,Bien Hoa City,11,1171,1045,126,38
2022-06-03,Dong Nai,Bien Hoa City,12,988,889,99,30
2022-06-03,Dong Nai,Bien Hoa City,13,900,813,87,24
2022-06-03,Dong Nai,Bien Hoa City,14,592,507,85,29
2022-06-03,Dong Nai,Bien Hoa City,15,531,471,60,15
2022-06-03,Dong Nai,Bien Hoa City,16,559,485,74,32
2022-06-03,Dong Nai,Bien Hoa City,17,660,584,76,25
2022-06-03,Dong Nai,Bien Hoa City,18,841,732,109,41
2022-06-03,Dong Nai,Bien Hoa City,19,746,654,92,30
2022-06-03,Dong Nai,Bien Hoa City,20,525,431,94,28
2022-06-03,Dong Nai,Bien Hoa City,21,219,154,65,18
2022-06-03,Dong Nai,Bien Hoa City,22,3,1,2,1
2022-06-03,Dong Nai,Bien Hoa City,23,2,1,1,0
2022-06-03,Dong Nai,Long Khanh,9,1,0,1,0
2022-06-03,Dong Nai,Long Khanh,20,2,0,2,1
2022-06-03,Dong Nai,Long Thanh,8,1,0,1,0
2022-06-03,Dong Nai,Long Thanh,13,2,0,2,2
2022-06-03,Dong Nai,Long Thanh,14,2,0,2,2
2022-06-03,Dong Nai,Long Thanh,15,3,0,3,3
2022-06-03,Dong Nai,Long Thanh,17,2,0,2,2
2022-06-03,Dong Nai,Long Thanh,18,3,0,3,3
2022-06-03,Dong Nai,Long Thanh,19,2,0,2,1
2022-06-03,Dong Nai,Nhon trach,9,1,0,1,1
2022-06-03,Dong Nai,Nhon trach,10,2,0,2,1
2022-06-03,Dong Nai,Nhon trach,12,1,0,1,1
2022-06-03,Dong Nai,Nhon trach,13,1,0,1,1
2022-06-03,Dong Nai,Nhon trach,14,1,0,1,1
2022-06-03,Dong Nai,Nhon trach,16,1,0,1,1
2022-06-03,Dong Nai,Nhon trach,17,1,0,1,1
2022-06-03,Dong Nai,Trang Bom,9,3,1,2,2
2022-06-03,Dong Nai,Trang Bom,10,2,1,1,1
2022-06-03,Dong Nai,Trang Bom,11,1,1,0,0
2022-06-03,Dong Nai,Trang Bom,13,4,1,3,3
2022-06-03,Dong Nai,Trang Bom,15,2,0,2,1
2022-06-03,Hai Phong City,An Duong,9,4,1,3,2
2022-06-03,Hai Phong City,An Duong,10,5,4,1,0
2022-06-03,Hai Phong City,An Duong,11,4,1,3,3
2022-06-03,Hai Phong City,An Duong,12,6,4,2,2
2022-06-03,Hai Phong City,An Duong,13,3,3,0,0
2022-06-03,Hai Phong City,An Duong,14,5,1,4,1
2022-06-03,Hai Phong City,An Duong,15,8,4,4,3
2022-06-03,Hai Phong City,An Duong,16,2,2,0,0
2022-06-03,Hai Phong City,An Duong,17,3,2,1,1
2022-06-03,Hai Phong City,An Duong,18,2,2,0,0
2022-06-03,Hai Phong City,An Duong,19,1,0,1,1
2022-06-03,Hai Phong City,An Duong,20,3,2,1,1
2022-06-03,Hai Phong City,An Duong,21,1,0,1,1
2022-06-03,Hai Phong City,Hai An District,6,1,0,1,0
2022-06-03,Hai Phong City,Hai An District,7,9,3,6,5
2022-06-03,Hai Phong City,Hai An District,8,11,10,1,1
2022-06-03,Hai Phong City,Hai An District,9,10,9,1,0
2022-06-03,Hai Phong City,Hai An District,10,45,33,12,7
2022-06-03,Hai Phong City,Hai An District,11,43,36,7,4
2022-06-03,Hai Phong City,Hai An District,12,32,26,6,3
2022-06-03,Hai Phong City,Hai An District,13,32,21,11,5
2022-06-03,Hai Phong City,Hai An District,14,15,10,5,2
2022-06-03,Hai Phong City,Hai An District,15,21,14,7,3
2022-06-03,Hai Phong City,Hai An District,16,29,23,6,3
2022-06-03,Hai Phong City,Hai An District,17,15,11,4,0
2022-06-03,Hai Phong City,Hai An District,18,22,18,4,2
2022-06-03,Hai Phong City,Hai An District,19,26,23,3,0
2022-06-03,Hai Phong City,Hai An District,20,15,13,2,1
2022-06-03,Hai Phong City,Hai An District,21,14,9,5,4
2022-06-03,Hai Phong City,Hai An District,22,1,0,1,0
2022-06-03,Hai Phong City,Hong Bang District,0,1,1,0,0
2022-06-03,Hai Phong City,Hong Bang District,5,1,1,0,0
2022-06-03,Hai Phong City,Hong Bang District,7,15,12,3,1
2022-06-03,Hai Phong City,Hong Bang District,8,33,27,6,0
2022-06-03,Hai Phong City,Hong Bang District,9,33,30,3,2
2022-06-03,Hai Phong City,Hong Bang District,10,61,50,11,5
2022-06-03,Hai Phong City,Hong Bang District,11,107,76,31,16
2022-06-03,Hai Phong City,Hong Bang District,12,70,56,14,9
2022-06-03,Hai Phong City,Hong Bang District,13,58,45,13,8
2022-06-03,Hai Phong City,Hong Bang District,14,39,28,11,9
2022-06-03,Hai Phong City,Hong Bang District,15,49,35,14,9
2022-06-03,Hai Phong City,Hong Bang District,16,37,32,5,2
2022-06-03,Hai Phong City,Hong Bang District,17,52,43,9,5
2022-06-03,Hai Phong City,Hong Bang District,18,58,48,10,0
2022-06-03,Hai Phong City,Hong Bang District,19,53,37,16,8
2022-06-03,Hai Phong City,Hong Bang District,20,37,27,10,5
2022-06-03,Hai Phong City,Hong Bang District,21,24,14,10,5
2022-06-03,Hai Phong City,Kien An District,8,2,2,0,0
2022-06-03,Hai Phong City,Kien An District,9,6,2,4,1
2022-06-03,Hai Phong City,Kien An District,10,13,8,5,2
2022-06-03,Hai Phong City,Kien An District,11,18,12,6,1
2022-06-03,Hai Phong City,Kien An District,12,10,9,1,0
2022-06-03,Hai Phong City,Kien An District,13,8,4,4,2
2022-06-03,Hai Phong City,Kien An District,14,12,7,5,2
2022-06-03,Hai Phong City,Kien An District,15,23,12,11,7
2022-06-03,Hai Phong City,Kien An District,16,10,6,4,3
2022-06-03,Hai Phong City,Kien An District,17,11,10,1,1
2022-06-03,Hai Phong City,Kien An District,18,9,6,3,1
2022-06-03,Hai Phong City,Kien An District,19,21,13,8,5
2022-06-03,Hai Phong City,Kien An District,20,4,2,2,1
2022-06-03,Hai Phong City,Kien An District,21,3,1,2,2
2022-06-03,Hai Phong City,Le Chan District,2,1,0,1,0
2022-06-03,Hai Phong City,Le Chan District,3,1,1,0,0
2022-06-03,Hai Phong City,Le Chan District,6,1,0,1,0
2022-06-03,Hai Phong City,Le Chan District,7,38,24,14,9
2022-06-03,Hai Phong City,Le Chan District,8,85,68,17,3
2022-06-03,Hai Phong City,Le Chan District,9,72,66,6,1
2022-06-03,Hai Phong City,Le Chan District,10,167,148,19,3
2022-06-03,Hai Phong City,Le Chan District,11,384,305,79,42
2022-06-03,Hai Phong City,Le Chan District,12,246,194,52,25
2022-06-03,Hai Phong City,Le Chan District,13,153,129,24,9
2022-06-03,Hai Phong City,Le Chan District,14,182,126,56,39
2022-06-03,Hai Phong City,Le Chan District,15,198,148,50,26
2022-06-03,Hai Phong City,Le Chan District,16,187,155,32,15
2022-06-03,Hai Phong City,Le Chan District,17,148,126,22,6
2022-06-03,Hai Phong City,Le Chan District,18,220,184,36,5
2022-06-03,Hai Phong City,Le Chan District,19,209,170,39,12
2022-06-03,Hai Phong City,Le Chan District,20,151,118,33,14
2022-06-03,Hai Phong City,Le Chan District,21,94,74,20,9
2022-06-03,Hai Phong City,Le Chan District,22,2,0,2,0
2022-06-03,Hai Phong City,Ngo Quyen District,0,1,0,1,0
2022-06-03,Hai Phong City,Ngo Quyen District,1,1,0,1,1
2022-06-03,Hai Phong City,Ngo Quyen District,4,1,0,1,0
2022-06-03,Hai Phong City,Ngo Quyen District,6,3,0,3,2
2022-06-03,Hai Phong City,Ngo Quyen District,7,35,14,21,16
2022-06-03,Hai Phong City,Ngo Quyen District,8,75,69,6,2
2022-06-03,Hai Phong City,Ngo Quyen District,9,82,71,11,0
2022-06-03,Hai Phong City,Ngo Quyen District,10,140,115,25,8
2022-06-03,Hai Phong City,Ngo Quyen District,11,280,220,60,31
2022-06-03,Hai Phong City,Ngo Quyen District,12,202,155,47,22
2022-06-03,Hai Phong City,Ngo Quyen District,13,123,109,14,5
2022-06-03,Hai Phong City,Ngo Quyen District,14,193,135,58,28
2022-06-03,Hai Phong City,Ngo Quyen District,15,158,121,37,19
2022-06-03,Hai Phong City,Ngo Quyen District,16,121,102,19,10
2022-06-03,Hai Phong City,Ngo Quyen District,17,145,125,20,6
2022-06-03,Hai Phong City,Ngo Quyen District,18,166,136,30,14
2022-06-03,Hai Phong City,Ngo Quyen District,19,185,159,26,6
2022-06-03,Hai Phong City,Ngo Quyen District,20,136,120,16,5
2022-06-03,Hai Phong City,Ngo Quyen District,21,75,59,16,7
2022-06-03,Hai Phong City,Ngo Quyen District,22,3,1,2,1
2022-06-03,Hai Phong City,Thuy Nguyen,9,1,0,1,1
2022-06-03,Hai Phong City,Thuy Nguyen,10,2,0,2,2
2022-06-03,Hai Phong City,Thuy Nguyen,11,1,0,1,1
2022-06-03,Hai Phong City,Thuy Nguyen,14,2,1,1,1
2022-06-03,Hai Phong City,Thuy Nguyen,15,1,0,1,1
2022-06-03,Hai Phong City,Thuy Nguyen,16,1,0,1,1
2022-06-03,Hai Phong City,Thuy Nguyen,19,1,0,1,1
2022-06-03,Hai Phong City,Thuy Nguyen,20,2,0,2,1
2022-06-03,Hue City,Hue City,0,2,2,0,0
2022-06-03,Hue City,Hue City,1,2,2,0,0
2022-06-03,Hue City,Hue City,4,1,1,0,0
2022-06-03,Hue City,Hue City,5,1,0,1,0
2022-06-03,Hue City,Hue City,6,88,65,23,6
2022-06-03,Hue City,Hue City,7,204,189,15,1
2022-06-03,Hue City,Hue City,8,319,291,28,0
2022-06-03,Hue City,Hue City,9,350,308,42,0
2022-06-03,Hue City,Hue City,10,445,377,68,5
2022-06-03,Hue City,Hue City,11,892,736,156,32
2022-06-03,Hue City,Hue City,12,603,513,90,9
2022-06-03,Hue City,Hue City,13,378,335,43,1
2022-06-03,Hue City,Hue City,14,404,354,50,9
2022-06-03,Hue City,Hue City,15,412,335,77,12
2022-06-03,Hue City,Hue City,16,410,354,56,4
2022-06-03,Hue City,Hue City,17,499,430,69,3
2022-06-03,Hue City,Hue City,18,579,474,105,14
2022-06-03,Hue City,Hue City,19,745,507,238,131
2022-06-03,Hue City,Hue City,20,512,362,150,59
2022-06-03,Hue City,Hue City,21,297,205,92,35
2022-06-03,Hue City,Hue City,22,3,0,3,0
2022-06-03,Hue City,Hue City,23,2,2,0,0
2022-06-03,Hue City,Huong Thuy,7,1,0,1,0
2022-06-03,Hue City,Huong Thuy,10,3,0,3,2
2022-06-03,Hue City,Huong Thuy,11,4,3,1,1
2022-06-03,Hue City,Huong Thuy,12,6,1,5,3
2022-06-03,Hue City,Huong Thuy,14,1,1,0,0
2022-06-03,Hue City,Huong Thuy,15,1,1,0,0
2022-06-03,Hue City,Huong Thuy,16,1,0,1,0
2022-06-03,Hue City,Huong Thuy,17,2,2,0,0
2022-06-03,Hue City,Huong Thuy,18,2,0,2,0
2022-06-03,Hue City,Huong Thuy,19,2,0,2,1
2022-06-03,Hue City,Huong Thuy,21,1,1,0,0
2022-06-03,Hue City,Huong Tra,18,1,1,0,0
2022-06-03,Hue City,Huong Tra,20,1,0,1,1
2022-06-03,Hue City,Phu Vang,6,2,1,1,1
2022-06-03,Hue City,Phu Vang,7,2,0,2,1
2022-06-03,Hue City,Phu Vang,8,1,1,0,0
2022-06-03,Hue City,Phu Vang,9,2,2,0,0
2022-06-03,Hue City,Phu Vang,10,1,0,1,0
2022-06-03,Hue City,Phu Vang,11,3,2,1,1
2022-06-03,Hue City,Phu Vang,12,3,3,0,0
2022-06-03,Hue City,Phu Vang,16,1,1,0,0
2022-06-03,Hue City,Phu Vang,17,1,0,1,0
2022-06-03,Hue City,Phu Vang,18,3,1,2,1
2022-06-03,Hue City,Phu Vang,19,4,2,2,0
2022-06-03,Hue City,Phu Vang,20,1,1,0,0
2022-06-03,Hue City,Phu Vang,21,5,2,3,2
2022-06-03,Vung Tau,Ba Ria City,7,1,0,1,1
2022-06-03,Vung Tau,Ba Ria City,8,2,0,2,1
2022-06-03,Vung Tau,Ba Ria City,9,3,3,0,0
2022-06-03,Vung Tau,Ba Ria City,10,11,4,7,6
2022-06-03,Vung Tau,Ba Ria City,11,12,4,8,7
2022-06-03,Vung Tau,Ba Ria City,12,19,0,19,17
2022-06-03,Vung Tau,Ba Ria City,13,9,0,9,8
2022-06-03,Vung Tau,Ba Ria City,14,8,0,8,8
2022-06-03,Vung Tau,Ba Ria City,15,6,0,6,6
2022-06-03,Vung Tau,Ba Ria City,16,5,0,5,5
2022-06-03,Vung Tau,Ba Ria City,17,10,0,10,10
2022-06-03,Vung Tau,Ba Ria City,18,13,0,13,12
2022-06-03,Vung Tau,Ba Ria City,19,5,0,5,5
2022-06-03,Vung Tau,Ba Ria City,20,2,0,2,2
2022-06-03,Vung Tau,Ba Ria City,21,1,0,1,1
2022-06-03,Vung Tau,Vung Tau City,0,2,1,1,0
2022-06-03,Vung Tau,Vung Tau City,1,1,1,0,0
2022-06-03,Vung Tau,Vung Tau City,2,2,1,1,0
2022-06-03,Vung Tau,Vung Tau City,5,7,3,4,1
2022-06-03,Vung Tau,Vung Tau City,6,36,27,9,4
2022-06-03,Vung Tau,Vung Tau City,7,103,91,12,8
2022-06-03,Vung Tau,Vung Tau City,8,187,171,16,0
2022-06-03,Vung Tau,Vung Tau City,9,182,158,24,3
2022-06-03,Vung Tau,Vung Tau City,10,210,193,17,2
2022-06-03,Vung Tau,Vung Tau City,11,388,355,33,3
2022-06-03,Vung Tau,Vung Tau City,12,292,277,15,1
2022-06-03,Vung Tau,Vung Tau City,13,211,199,12,0
2022-06-03,Vung Tau,Vung Tau City,14,240,222,18,5
2022-06-03,Vung Tau,Vung Tau City,15,172,150,22,11
2022-06-03,Vung Tau,Vung Tau City,16,215,195,20,2
2022-06-03,Vung Tau,Vung Tau City,17,279,252,27,5
2022-06-03,Vung Tau,Vung Tau City,18,315,287,28,5
2022-06-03,Vung Tau,Vung Tau City,19,262,233,29,8
2022-06-03,Vung Tau,Vung Tau City,20,198,154,44,18
2022-06-03,Vung Tau,Vung Tau City,21,127,73,54,35
2022-06-04,Binh Duong,Ben Cat,11,1,0,1,1
2022-06-04,Binh Duong,Ben Cat,12,1,0,1,1
2022-06-04,Binh Duong,Ben Cat,13,2,0,2,2
2022-06-04,Binh Duong,Ben Cat,14,3,0,3,0
2022-06-04,Binh Duong,Ben Cat,17,1,0,1,1
2022-06-04,Binh Duong,Ben Cat,19,1,0,1,1
2022-06-04,Binh Duong,Ben Cat,20,1,0,1,1
2022-06-04,Binh Duong,Di An,6,1,0,1,1
2022-06-04,Binh Duong,Di An,7,5,2,3,2
2022-06-04,Binh Duong,Di An,8,16,11,5,4
2022-06-04,Binh Duong,Di An,9,32,19,13,10
2022-06-04,Binh Duong,Di An,10,41,26,15,10
2022-06-04,Binh Duong,Di An,11,48,31,17,12
2022-06-04,Binh Duong,Di An,12,29,21,8,4
2022-06-04,Binh Duong,Di An,13,33,27,6,4
2022-06-04,Binh Duong,Di An,14,33,21,12,8
2022-06-04,Binh Duong,Di An,15,35,14,21,18
2022-06-04,Binh Duong,Di An,16,31,18,13,11
2022-06-04,Binh Duong,Di An,17,28,22,6,5
2022-06-04,Binh Duong,Di An,18,52,22,30,22
2022-06-04,Binh Duong,Di An,19,69,24,45,36
2022-06-04,Binh Duong,Di An,20,35,16,19,15
2022-06-04,Binh Duong,Di An,21,19,10,9,5
2022-06-04,Binh Duong,Tan Uyen,7,1,0,1,1
2022-06-04,Binh Duong,Tan Uyen,9,1,1,0,0
2022-06-04,Binh Duong,Tan Uyen,10,4,1,3,3
2022-06-04,Binh Duong,Tan Uyen,11,7,3,4,2
2022-06-04,Binh Duong,Tan Uyen,12,5,1,4,0
2022-06-04,Binh Duong,Tan Uyen,13,4,2,2,1
2022-06-04,Binh Duong,Tan Uyen,14,1,0,1,1
2022-06-04,Binh Duong,Tan Uyen,15,3,2,1,1
2022-06-04,Binh Duong,Tan Uyen,16,3,0,3,0
2022-06-04,Binh Duong,Tan Uyen,17,2,1,1,0
2022-06-04,Binh Duong,Tan Uyen,19,3,2,1,1
2022-06-04,Binh Duong,Tan Uyen,20,1,0,1,1
2022-06-04,Binh Duong,Tan Uyen,21,2,0,2,1
2022-06-04,Binh Duong,Thu Dau Mot Town,5,2,1,1,0
2022-06-04,Binh Duong,Thu Dau Mot Town,6,43,34,9,3
2022-06-04,Binh Duong,Thu Dau Mot Town,7,140,126,14,3
2022-06-04,Binh Duong,Thu Dau Mot Town,8,247,228,19,1
2022-06-04,Binh Duong,Thu Dau Mot Town,9,289,268,21,0
2022-06-04,Binh Duong,Thu Dau Mot Town,10,414,390,24,3
2022-06-04,Binh Duong,Thu Dau Mot Town,11,659,618,41,8
2022-06-04,Binh Duong,Thu Dau Mot Town,12,505,472,33,5
2022-06-04,Binh Duong,Thu Dau Mot Town,13,450,436,14,3
2022-06-04,Binh Duong,Thu Dau Mot Town,14,390,371,19,0
2022-06-04,Binh Duong,Thu Dau Mot Town,15,304,282,22,1
2022-06-04,Binh Duong,Thu Dau Mot Town,16,313,298,15,0
2022-06-04,Binh Duong,Thu Dau Mot Town,17,380,365,15,1
2022-06-04,Binh Duong,Thu Dau Mot Town,18,416,384,32,5
2022-06-04,Binh Duong,Thu Dau Mot Town,19,414,363,51,20
2022-06-04,Binh Duong,Thu Dau Mot Town,20,321,270,51,17
2022-06-04,Binh Duong,Thu Dau Mot Town,21,134,116,18,6
2022-06-04,Binh Duong,Thu Dau Mot Town,23,1,1,0,0
2022-06-04,Binh Duong,Thuan An,0,1,0,1,0
2022-06-04,Binh Duong,Thuan An,6,1,1,0,0
2022-06-04,Binh Duong,Thuan An,7,11,6,5,4
2022-06-04,Binh Duong,Thuan An,8,18,14,4,1
2022-06-04,Binh Duong,Thuan An,9,45,37,8,3
2022-06-04,Binh Duong,Thuan An,10,74,59,15,4
2022-06-04,Binh Duong,Thuan An,11,100,70,30,21
2022-06-04,Binh Duong,Thuan An,12,87,69,18,8
2022-06-04,Binh Duong,Thuan An,13,82,61,21,14
2022-06-04,Binh Duong,Thuan An,14,55,46,9,5
2022-06-04,Binh Duong,Thuan An,15,33,32,1,0
2022-06-04,Binh Duong,Thuan An,16,39,31,8,2
2022-06-04,Binh Duong,Thuan An,17,50,46,4,1
2022-06-04,Binh Duong,Thuan An,18,69,48,21,15
2022-06-04,Binh Duong,Thuan An,19,66,37,29,17
2022-06-04,Binh Duong,Thuan An,20,38,27,11,7
2022-06-04,Binh Duong,Thuan An,21,24,14,10,4
2022-06-04,Binh Duong,Thuan An,23,1,1,0,0
2022-06-04,Can Tho City,Binh Thuy District,7,1,1,0,0
2022-06-04,Can Tho City,Binh Thuy District,8,4,4,0,0
2022-06-04,Can Tho City,Binh Thuy District,9,3,3,0,0
2022-06-04,Can Tho City,Binh Thuy District,10,6,5,1,0
2022-06-04,Can Tho City,Binh Thuy District,11,15,12,3,1
2022-06-04,Can Tho City,Binh Thuy District,12,5,5,0,0
2022-06-04,Can Tho City,Binh Thuy District,13,13,10,3,1
2022-06-04,Can Tho City,Binh Thuy District,14,14,13,1,0
2022-06-04,Can Tho City,Binh Thuy District,15,12,10,2,0
2022-06-04,Can Tho City,Binh Thuy District,16,7,6,1,0
2022-06-04,Can Tho City,Binh Thuy District,17,15,13,2,0
2022-06-04,Can Tho City,Binh Thuy District,18,16,16,0,0
2022-06-04,Can Tho City,Binh Thuy District,19,15,14,1,1
2022-06-04,Can Tho City,Binh Thuy District,20,11,11,0,0
2022-06-04,Can Tho City,Binh Thuy District,21,2,2,0,0
2022-06-04,Can Tho City,Cai Rang District,6,2,1,1,1
2022-06-04,Can Tho City,Cai Rang District,8,9,9,0,0
2022-06-04,Can Tho City,Cai Rang District,9,4,4,0,0
2022-06-04,Can Tho City,Cai Rang District,10,10,10,0,0
2022-06-04,Can Tho City,Cai Rang District,11,17,17,0,0
2022-06-04,Can Tho City,Cai Rang District,12,11,10,1,0
2022-06-04,Can Tho City,Cai Rang District,13,10,9,1,1
2022-06-04,Can Tho City,Cai Rang District,14,9,7,2,0
2022-06-04,Can Tho City,Cai Rang District,15,12,6,6,5
2022-06-04,Can Tho City,Cai Rang District,16,19,17,2,0
2022-06-04,Can Tho City,Cai Rang District,17,5,5,0,0
2022-06-04,Can Tho City,Cai Rang District,18,17,14,3,0
2022-06-04,Can Tho City,Cai Rang District,19,16,15,1,0
2022-06-04,Can Tho City,Cai Rang District,20,8,7,1,0
2022-06-04,Can Tho City,Cai Rang District,21,3,3,0,0
2022-06-04,Can Tho City,Ninh Kieu District,0,1,1,0,0
2022-06-04,Can Tho City,Ninh Kieu District,1,5,4,1,0
2022-06-04,Can Tho City,Ninh Kieu District,3,1,0,1,0
2022-06-04,Can Tho City,Ninh Kieu District,4,1,1,0,0
2022-06-04,Can Tho City,Ninh Kieu District,5,1,1,0,0
2022-06-04,Can Tho City,Ninh Kieu District,6,53,50,3,0
2022-06-04,Can Tho City,Ninh Kieu District,7,143,137,6,0
2022-06-04,Can Tho City,Ninh Kieu District,8,260,247,13,0
2022-06-04,Can Tho City,Ninh Kieu District,9,280,254,26,0
2022-06-04,Can Tho City,Ninh Kieu District,10,534,505,29,1
2022-06-04,Can Tho City,Ninh Kieu District,11,740,705,35,1
2022-06-04,Can Tho City,Ninh Kieu District,12,536,505,31,1
2022-06-04,Can Tho City,Ninh Kieu District,13,573,532,41,0
2022-06-04,Can Tho City,Ninh Kieu District,14,464,429,35,0
2022-06-04,Can Tho City,Ninh Kieu District,15,366,339,27,1
2022-06-04,Can Tho City,Ninh Kieu District,16,479,445,34,0
2022-06-04,Can Tho City,Ninh Kieu District,17,534,509,25,1
2022-06-04,Can Tho City,Ninh Kieu District,18,534,510,24,1
2022-06-04,Can Tho City,Ninh Kieu District,19,478,456,22,0
2022-06-04,Can Tho City,Ninh Kieu District,20,348,324,24,0
2022-06-04,Can Tho City,Ninh Kieu District,21,183,172,11,1
2022-06-04,Can Tho City,Ninh Kieu District,22,1,1,0,0
2022-06-04,Dong Nai,Bien Hoa City,0,1,0,1,0
2022-06-04,Dong Nai,Bien Hoa City,1,1,1,0,0
2022-06-04,Dong Nai,Bien Hoa City,3,6,3,3,0
2022-06-04,Dong Nai,Bien Hoa City,6,62,27,35,27
2022-06-04,Dong Nai,Bien Hoa City,7,177,133,44,31
2022-06-04,Dong Nai,Bien Hoa City,8,307,270,37,12
2022-06-04,Dong Nai,Bien Hoa City,9,462,417,45,2
2022-06-04,Dong Nai,Bien Hoa City,10,759,681,78,10
2022-06-04,Dong Nai,Bien Hoa City,11,1096,1016,80,28
2022-06-04,Dong Nai,Bien Hoa City,12,965,894,71,12
2022-06-04,Dong Nai,Bien Hoa City,13,746,693,53,9
2022-06-04,Dong Nai,Bien Hoa City,14,631,582,49,8
2022-06-04,Dong Nai,Bien Hoa City,15,637,552,85,44
2022-06-04,Dong Nai,Bien Hoa City,16,551,484,67,21
2022-06-04,Dong Nai,Bien Hoa City,17,669,603,66,19
2022-06-04,Dong Nai,Bien Hoa City,18,843,717,126,49
2022-06-04,Dong Nai,Bien Hoa City,19,972,682,290,195
2022-06-04,Dong Nai,Bien Hoa City,20,675,452,223,133
2022-06-04,Dong Nai,Bien Hoa City,21,283,160,123,58
2022-06-04,Dong Nai,Bien Hoa City,22,3,0,3,0
2022-06-04,Dong Nai,Bien Hoa City,23,4,2,2,0
2022-06-04,Dong Nai,Cam My,12,1,0,1,1
2022-06-04,Dong Nai,Long Khanh,10,1,0,1,1
2022-06-04,Dong Nai,Long Khanh,11,1,0,1,1
2022-06-04,Dong Nai,Long Thanh,10,1,0,1,1
2022-06-04,Dong Nai,Long Thanh,11,2,0,2,2
2022-06-04,Dong Nai,Long Thanh,12,3,0,3,3
2022-06-04,Dong Nai,Long Thanh,16,1,0,1,1
2022-06-04,Dong Nai,Nhon trach,10,2,0,2,2
2022-06-04,Dong Nai,Nhon trach,11,2,0,2,2
2022-06-04,Dong Nai,Nhon trach,12,1,0,1,1
2022-06-04,Dong Nai,Nhon trach,14,1,0,1,1
2022-06-04,Dong Nai,Trang Bom,9,1,0,1,1
2022-06-04,Dong Nai,Trang Bom,10,3,0,3,3
2022-06-04,Dong Nai,Trang Bom,11,1,0,1,1
2022-06-04,Dong Nai,Trang Bom,12,1,0,1,1
2022-06-04,Dong Nai,Trang Bom,13,1,1,0,0
2022-06-04,Dong Nai,Trang Bom,15,1,0,1,1
2022-06-04,Dong Nai,Trang Bom,16,2,0,2,1
2022-06-04,Dong Nai,Trang Bom,17,1,1,0,0
2022-06-04,Dong Nai,Trang Bom,19,3,0,3,3
2022-06-04,Dong Nai,Trang Bom,21,1,0,1,0
2022-06-04,Dong Nai,Vinh Cuu,9,1,0,1,0
2022-06-04,Hai Phong City,An Duong,8,2,1,1,0
2022-06-04,Hai Phong City,An Duong,9,3,2,1,1
2022-06-04,Hai Phong City,An Duong,10,5,4,1,1
2022-06-04,Hai Phong City,An Duong,11,2,0,2,1
2022-06-04,Hai Phong City,An Duong,12,6,4,2,1
2022-06-04,Hai Phong City,An Duong,13,6,2,4,2
2022-06-04,Hai Phong City,An Duong,14,3,2,1,1
2022-06-04,Hai Phong City,An Duong,15,4,3,1,1
2022-06-04,Hai Phong City,An Duong,17,3,2,1,1
2022-06-04,Hai Phong City,An Duong,18,1,0,1,0
2022-06-04,Hai Phong City,An Duong,20,2,1,1,1
2022-06-04,Hai Phong City,An Duong,21,1,1,0,0
2022-06-04,Hai Phong City,Do Son District,15,2,0,2,2
2022-06-04,Hai Phong City,Duong Kinh District,12,1,0,1,1
2022-06-04,Hai Phong City,Duong Kinh District,13,1,0,1,1
2022-06-04,Hai Phong City,Duong Kinh District,17,1,0,1,1
2022-06-04,Hai Phong City,Hai An District,7,7,6,1,0
2022-06-04,Hai Phong City,Hai An District,8,16,14,2,0
2022-06-04,Hai Phong City,Hai An District,9,32,24,8,2
2022-06-04,Hai Phong City,Hai An District,10,26,23,3,0
2022-06-04,Hai Phong City,Hai An District,11,56,47,9,4
2022-06-04,Hai Phong City,Hai An District,12,41,33,8,6
2022-06-04,Hai Phong City,Hai An District,13,32,25,7,1
2022-06-04,Hai Phong City,Hai An District,14,17,11,6,4
2022-06-04,Hai Phong City,Hai An District,15,31,21,10,6
2022-06-04,Hai Phong City,Hai An District,16,27,25,2,1
2022-06-04,Hai Phong City,Hai An District,17,15,13,2,2
2022-06-04,Hai Phong City,Hai An District,18,29,20,9,1
2022-06-04,Hai Phong City,Hai An District,19,34,26,8,3
2022-06-04,Hai Phong City,Hai An District,20,29,22,7,3
2022-06-04,Hai Phong City,Hai An District,21,10,8,2,1
2022-06-04,Hai Phong City,Hong Bang District,1,1,1,0,0
2022-06-04,Hai Phong City,Hong Bang District,7,12,10,2,2
2022-06-04,Hai Phong City,Hong Bang District,8,30,25,5,1
2022-06-04,Hai Phong City,Hong Bang District,9,39,32,7,2
2022-06-04,Hai Phong City,Hong Bang District,10,72,53,19,4
2022-06-04,Hai Phong City,Hong Bang District,11,129,100,29,21
2022-06-04,Hai Phong City,Hong Bang District,12,96,74,22,14
2022-06-04,Hai Phong City,Hong Bang District,13,57,41,16,9
2022-06-04,Hai Phong City,Hong Bang District,14,55,43,12,5
2022-06-04,Hai Phong City,Hong Bang District,15,47,34,13,11
2022-06-04,Hai Phong City,Hong Bang District,16,47,37,10,5
2022-06-04,Hai Phong City,Hong Bang District,17,46,41,5,2
2022-06-04,Hai Phong City,Hong Bang District,18,65,55,10,3
2022-06-04,Hai Phong City,Hong Bang District,19,53,41,12,4
2022-06-04,Hai Phong City,Hong Bang District,20,50,31,19,11
2022-06-04,Hai Phong City,Hong Bang District,21,24,14,10,4
2022-06-04,Hai Phong City,Hong Bang District,22,1,0,1,0
2022-06-04,Hai Phong City,Kien An District,8,2,0,2,1
2022-06-04,Hai Phong City,Kien An District,9,5,5,0,0
2022-06-04,Hai Phong City,Kien An District,10,10,10,0,0
2022-06-04,Hai Phong City,Kien An District,11,19,14,5,2
2022-06-04,Hai Phong City,Kien An District,12,20,9,11,5
2022-06-04,Hai Phong City,Kien An District,13,8,5,3,1
2022-06-04,Hai Phong City,Kien An District,14,10,7,3,1
2022-06-04,Hai Phong City,Kien An District,15,14,13,1,0
2022-06-04,Hai Phong City,Kien An District,16,12,8,4,2
2022-06-04,Hai Phong City,Kien An District,17,11,10,1,1
2022-06-04,Hai Phong City,Kien An District,18,9,9,0,0
2022-06-04,Hai Phong City,Kien An District,19,26,17,9,2
2022-06-04,Hai Phong City,Kien An District,20,12,8,4,0
2022-06-04,Hai Phong City,Kien An District,21,8,3,5,0
2022-06-04,Hai Phong City,Le Chan District,0,2,2,0,0
2022-06-04,Hai Phong City,Le Chan District,1,1,1,0,0
2022-06-04,Hai Phong City,Le Chan District,3,1,1,0,0
2022-06-04,Hai Phong City,Le Chan District,6,2,0,2,2
2022-06-04,Hai Phong City,Le Chan District,7,31,27,4,2
2022-06-04,Hai Phong City,Le Chan District,8,92,80,12,0
2022-06-04,Hai Phong City,Le Chan District,9,107,98,9,0
2022-06-04,Hai Phong City,Le Chan District,10,217,189,28,3
2022-06-04,Hai Phong City,Le Chan District,11,385,317,68,36
2022-06-04,Hai Phong City,Le Chan District,12,324,265,59,25
2022-06-04,Hai Phong City,Le Chan District,13,156,138,18,6
2022-06-04,Hai Phong City,Le Chan District,14,155,127,28,13
2022-06-04,Hai Phong City,Le Chan District,15,191,141,50,30
2022-06-04,Hai Phong City,Le Chan District,16,176,148,28,11
2022-06-04,Hai Phong City,Le Chan District,17,185,164,21,7
2022-06-04,Hai Phong City,Le Chan District,18,226,194,32,6
2022-06-04,Hai Phong City,Le Chan District,19,201,161,40,18
2022-06-04,Hai Phong City,Le Chan District,20,155,114,41,14
2022-06-04,Hai Phong City,Le Chan District,21,96,66,30,10
2022-06-04,Hai Phong City,Le Chan District,22,3,0,3,0
2022-06-04,Hai Phong City,Ngo Quyen District,0,1,1,0,0
2022-06-04,Hai Phong City,Ngo Quyen District,1,3,1,2,0
2022-06-04,Hai Phong City,Ngo Quyen District,7,31,23,8,1
2022-06-04,Hai Phong City,Ngo Quyen District,8,93,77,16,0
2022-06-04,Hai Phong City,Ngo Quyen District,9,76,67,9,1
2022-06-04,Hai Phong City,Ngo Quyen District,10,158,140,18,3
2022-06-04,Hai Phong City,Ngo Quyen District,11,265,225,40,30
2022-06-04,Hai Phong City,Ngo Quyen District,12,194,171,23,3
2022-06-04,Hai Phong City,Ngo Quyen District,13,139,118,21,6
2022-06-04,Hai Phong City,Ngo Quyen District,14,145,123,22,10
2022-06-04,Hai Phong City,Ngo Quyen District,15,148,119,29,15
2022-06-04,Hai Phong City,Ngo Quyen District,16,146,115,31,14
2022-06-04,Hai Phong City,Ngo Quyen District,17,159,131,28,14
2022-06-04,Hai Phong City,Ngo Quyen District,18,165,137,28,13
2022-06-04,Hai Phong City,Ngo Quyen District,19,198,164,34,15
2022-06-04,Hai Phong City,Ngo Quyen District,20,151,120,31,14
2022-06-04,Hai Phong City,Ngo Quyen District,21,68,51,17,6
2022-06-04,Hai Phong City,Ngo Quyen District,23,2,1,1,0
2022-06-04,Hai Phong City,Thuy Nguyen,10,3,0,3,2
2022-06-04,Hai Phong City,Thuy Nguyen,11,3,0,3,3
2022-06-04,Hai Phong City,Thuy Nguyen,15,3,0,3,2
2022-06-04,Hai Phong City,Thuy Nguyen,16,1,0,1,0
2022-06-04,Hai Phong City,Thuy Nguyen,17,1,0,1,1
2022-06-04,Hai Phong City,Thuy Nguyen,18,1,0,1,1
2022-06-04,Hai Phong City,Thuy Nguyen,19,2,0,2,2
2022-06-04,Hai Phong City,Thuy Nguyen,20,1,0,1,1
2022-06-04,Hai Phong City,Thuy Nguyen,21,2,0,2,1
2022-06-04,Hue City,Hue City,0,4,2,2,0
2022-06-04,Hue City,Hue City,1,2,2,0,0
2022-06-04,Hue City,Hue City,2,1,1,0,0
2022-06-04,Hue City,Hue City,5,2,2,0,0
2022-06-04,Hue City,Hue City,6,73,58,15,3
2022-06-04,Hue City,Hue City,7,224,208,16,2
2022-06-04,Hue City,Hue City,8,373,347,26,2
2022-06-04,Hue City,Hue City,9,298,270,28,0
2022-06-04,Hue City,Hue City,10,460,419,41,0
2022-06-04,Hue City,Hue City,11,859,795,64,5
2022-06-04,Hue City,Hue City,12,583,548,35,1
2022-06-04,Hue City,Hue City,13,453,411,42,2
2022-06-04,Hue City,Hue City,14,409,379,30,3
2022-06-04,Hue City,Hue City,15,431,395,36,2
2022-06-04,Hue City,Hue City,16,431,397,34,4
2022-06-04,Hue City,Hue City,17,479,432,47,5
2022-06-04,Hue City,Hue City,18,562,503,59,5
2022-06-04,Hue City,Hue City,19,690,616,74,4
2022-06-04,Hue City,Hue City,20,519,433,86,25
2022-06-04,Hue City,Hue City,21,261,210,51,8
2022-06-04,Hue City,Hue City,22,3,2,1,0
2022-06-04,Hue City,Hue City,23,1,1,0,0
2022-06-04,Hue City,Huong Thuy,8,1,1,0,0
2022-06-04,Hue City,Huong Thuy,9,1,0,1,1
2022-06-04,Hue City,Huong Thuy,10,4,2,2,0
2022-06-04,Hue City,Huong Thuy,11,2,0,2,1
2022-06-04,Hue City,Huong Thuy,12,6,3,3,1
2022-06-04,Hue City,Huong Thuy,14,1,0,1,1
2022-06-04,Hue City,Huong Thuy,17,1,1,0,0
2022-06-04,Hue City,Huong Thuy,19,2,0,2,0
2022-06-04,Hue City,Huong Thuy,20,2,1,1,0
2022-06-04,Hue City,Huong Tra,12,1,0,1,0
2022-06-04,Hue City,Huong Tra,16,1,0,1,0
2022-06-04,Hue City,Huong Tra,21,1,1,0,0
2022-06-04,Hue City,Phu Vang,7,3,2,1,1
2022-06-04,Hue City,Phu Vang,8,2,0,2,0
2022-06-04,Hue City,Phu Vang,9,2,1,1,0
2022-06-04,Hue City,Phu Vang,10,2,1,1,0
2022-06-04,Hue City,Phu Vang,11,1,1,0,0
2022-06-04,Hue City,Phu Vang,12,1,1,0,0
2022-06-04,Hue City,Phu Vang,13,1,0,1,0
2022-06-04,Hue City,Phu Vang,14,5,3,2,2
2022-06-04,Hue City,Phu Vang,15,1,1,0,0
2022-06-04,Hue City,Phu Vang,16,2,0,2,1
2022-06-04,Hue City,Phu Vang,17,5,2,3,3
2022-06-04,Hue City,Phu Vang,20,1,1,0,0
2022-06-04,Vung Tau,Ba Ria City,8,1,1,0,0
2022-06-04,Vung Tau,Ba Ria City,9,2,2,0,0
2022-06-04,Vung Tau,Ba Ria City,10,3,3,0,0
2022-06-04,Vung Tau,Ba Ria City,11,8,5,3,1
2022-06-04,Vung Tau,Ba Ria City,12,3,3,0,0
2022-06-04,Vung Tau,Ba Ria City,13,10,5,5,4
2022-06-04,Vung Tau,Ba Ria City,14,13,3,10,9
2022-06-04,Vung Tau,Ba Ria City,15,6,6,0,0
2022-06-04,Vung Tau,Ba Ria City,16,2,0,2,1
2022-06-04,Vung Tau,Ba Ria City,17,11,0,11,9
2022-06-04,Vung Tau,Ba Ria City,18,23,0,23,21
2022-06-04,Vung Tau,Ba Ria City,19,13,0,13,11
2022-06-04,Vung Tau,Ba Ria City,20,5,0,5,5
2022-06-04,Vung Tau,Ba Ria City,21,2,0,2,1
2022-06-04,Vung Tau,Vung Tau City,0,1,1,0,0
2022-06-04,Vung Tau,Vung Tau City,1,1,1,0,0
2022-06-04,Vung Tau,Vung Tau City,5,1,1,0,0
2022-06-04,Vung Tau,Vung Tau City,6,36,30,6,3
2022-06-04,Vung Tau,Vung Tau City,7,107,97,10,1
2022-06-04,Vung Tau,Vung Tau City,8,188,162,26,11
2022-06-04,Vung Tau,Vung Tau City,9,200,183,17,3
2022-06-04,Vung Tau,Vung Tau City,10,248,228,20,2
2022-06-04,Vung Tau,Vung Tau City,11,397,366,31,5
2022-06-04,Vung Tau,Vung Tau City,12,365,331,34,2
2022-06-04,Vung Tau,Vung Tau City,13,272,260,12,1
2022-06-04,Vung Tau,Vung Tau City,14,267,247,20,5
2022-06-04,Vung Tau,Vung Tau City,15,252,226,26,11
2022-06-04,Vung Tau,Vung Tau City,16,272,242,30,8
2022-06-04,Vung Tau,Vung Tau City,17,301,265,36,6
2022-06-04,Vung Tau,Vung Tau City,18,309,276,33,11
2022-06-04,Vung Tau,Vung Tau City,19,259,226,33,15
2022-06-04,Vung Tau,Vung Tau City,20,230,185,45,16
2022-06-04,Vung Tau,Vung Tau City,21,141,93,48,30
2022-06-04,Vung Tau,Vung Tau City,22,5,2,3,1
2022-06-04,Vung Tau,Vung Tau City,23,2,0,2,0
2022-06-05,Binh Duong,Ben Cat,7,1,0,1,1
2022-06-05,Binh Duong,Ben Cat,8,2,0,2,0
2022-06-05,Binh Duong,Ben Cat,9,2,1,1,1
2022-06-05,Binh Duong,Ben Cat,10,3,0,3,2
2022-06-05,Binh Duong,Ben Cat,11,2,0,2,1
2022-06-05,Binh Duong,Ben Cat,12,2,0,2,1
2022-06-05,Binh Duong,Ben Cat,16,2,0,2,2
2022-06-05,Binh Duong,Ben Cat,17,1,0,1,1
2022-06-05,Binh Duong,Ben Cat,19,1,1,0,0
2022-06-05,Binh Duong,Di An,6,4,0,4,3
2022-06-05,Binh Duong,Di An,7,8,1,7,7
2022-06-05,Binh Duong,Di An,8,10,7,3,2
2022-06-05,Binh Duong,Di An,9,19,12,7,5
2022-06-05,Binh Duong,Di An,10,42,28,14,11
2022-06-05,Binh Duong,Di An,11,45,26,19,15
2022-06-05,Binh Duong,Di An,12,37,28,9,5
2022-06-05,Binh Duong,Di An,13,56,30,26,20
2022-06-05,Binh Duong,Di An,14,48,21,27,20
2022-06-05,Binh Duong,Di An,15,41,17,24,19
2022-06-05,Binh Duong,Di An,16,39,26,13,12
2022-06-05,Binh Duong,Di An,17,29,20,9,9
2022-06-05,Binh Duong,Di An,18,44,28,16,10
2022-06-05,Binh Duong,Di An,19,40,20,20,16
2022-06-05,Binh Duong,Di An,20,39,15,24,16
2022-06-05,Binh Duong,Di An,21,12,5,7,6
2022-06-05,Binh Duong,Di An,22,2,0,2,0
2022-06-05,Binh Duong,Tan Uyen,7,3,0,3,3
2022-06-05,Binh Duong,Tan Uyen,9,1,1,0,0
2022-06-05,Binh Duong,Tan Uyen,10,1,1,0,0
2022-06-05,Binh Duong,Tan Uyen,11,4,3,1,1
2022-06-05,Binh Duong,Tan Uyen,12,3,1,2,0
2022-06-05,Binh Duong,Tan Uyen,13,1,1,0,0
2022-06-05,Binh Duong,Tan Uyen,14,2,1,1,1
2022-06-05,Binh Duong,Tan Uyen,15,3,1,2,0
2022-06-05,Binh Duong,Tan Uyen,16,3,1,2,0
2022-06-05,Binh Duong,Tan Uyen,17,2,1,1,1
2022-06-05,Binh Duong,Tan Uyen,19,2,0,2,2
2022-06-05,Binh Duong,Tan Uyen,20,1,0,1,0
2022-06-05,Binh Duong,Tan Uyen,21,2,1,1,1
2022-06-05,Binh Duong,Thu Dau Mot Town,2,1,1,0,0
2022-06-05,Binh Duong,Thu Dau Mot Town,5,1,1,0,0
2022-06-05,Binh Duong,Thu Dau Mot Town,6,42,27,15,5
2022-06-05,Binh Duong,Thu Dau Mot Town,7,131,113,18,3
2022-06-05,Binh Duong,Thu Dau Mot Town,8,233,214,19,3
2022-06-05,Binh Duong,Thu Dau Mot Town,9,311,285,26,6
2022-06-05,Binh Duong,Thu Dau Mot Town,10,371,350,21,3
2022-06-05,Binh Duong,Thu Dau Mot Town,11,590,542,48,4
2022-06-05,Binh Duong,Thu Dau Mot Town,12,569,536,33,4
2022-06-05,Binh Duong,Thu Dau Mot Town,13,502,482,20,4
2022-06-05,Binh Duong,Thu Dau Mot Town,14,362,335,27,3
2022-06-05,Binh Duong,Thu Dau Mot Town,15,370,354,16,2
2022-06-05,Binh Duong,Thu Dau Mot Town,16,342,316,26,6
2022-06-05,Binh Duong,Thu Dau Mot Town,17,412,390,22,5
2022-06-05,Binh Duong,Thu Dau Mot Town,18,458,424,34,9
2022-06-05,Binh Duong,Thu Dau Mot Town,19,466,424,42,6
2022-06-05,Binh Duong,Thu Dau Mot Town,20,293,257,36,3
2022-06-05,Binh Duong,Thu Dau Mot Town,21,109,85,24,0
2022-06-05,Binh Duong,Thuan An,0,1,1,0,0
2022-06-05,Binh Duong,Thuan An,6,5,1,4,0
2022-06-05,Binh Duong,Thuan An,7,15,5,10,4
2022-06-05,Binh Duong,Thuan An,8,19,14,5,1
2022-06-05,Binh Duong,Thuan An,9,38,30,8,5
2022-06-05,Binh Duong,Thuan An,10,50,38,12,3
2022-06-05,Binh Duong,Thuan An,11,94,66,28,16
2022-06-05,Binh Duong,Thuan An,12,97,66,31,26
2022-06-05,Binh Duong,Thuan An,13,57,47,10,3
2022-06-05,Binh Duong,Thuan An,14,54,41,13,8
2022-06-05,Binh Duong,Thuan An,15,60,53,7,2
2022-06-05,Binh Duong,Thuan An,16,46,35,11,2
2022-06-05,Binh Duong,Thuan An,17,53,44,9,3
2022-06-05,Binh Duong,Thuan An,18,48,42,6,3
2022-06-05,Binh Duong,Thuan An,19,56,38,18,15
2022-06-05,Binh Duong,Thuan An,20,50,29,21,17
2022-06-05,Binh Duong,Thuan An,21,14,10,4,1
2022-06-05,Can Tho City,Binh Thuy District,6,2,0,2,1
2022-06-05,Can Tho City,Binh Thuy District,7,2,2,0,0
2022-06-05,Can Tho City,Binh Thuy District,8,5,5,0,0
2022-06-05,Can Tho City,Binh Thuy District,9,3,2,1,1
2022-06-05,Can Tho City,Binh Thuy District,10,12,10,2,0
2022-06-05,Can Tho City,Binh Thuy District,11,10,9,1,0
2022-06-05,Can Tho City,Binh Thuy District,12,18,16,2,2
2022-06-05,Can Tho City,Binh Thuy District,13,17,16,1,0
2022-06-05,Can Tho City,Binh Thuy District,14,6,6,0,0
2022-06-05,Can Tho City,Binh Thuy District,15,14,12,2,0
2022-06-05,Can Tho City,Binh Thuy District,16,7,5,2,1
2022-06-05,Can Tho City,Binh Thuy District,17,10,10,0,0
2022-06-05,Can Tho City,Binh Thuy District,18,10,10,0,0
2022-06-05,Can Tho City,Binh Thuy District,19,26,21,5,0
2022-06-05,Can Tho City,Binh Thuy District,20,7,5,2,0
2022-06-05,Can Tho City,Binh Thuy District,21,1,1,0,0
2022-06-05,Can Tho City,Cai Rang District,2,1,0,1,1
2022-06-05,Can Tho City,Cai Rang District,6,2,2,0,0
2022-06-05,Can Tho City,Cai Rang District,7,7,6,1,1
2022-06-05,Can Tho City,Cai Rang District,8,8,7,1,1
2022-06-05,Can Tho City,Cai Rang District,9,10,10,0,0
2022-06-05,Can Tho City,Cai Rang District,10,11,11,0,0
2022-06-05,Can Tho City,Cai Rang District,11,14,14,0,0
2022-06-05,Can Tho City,Cai Rang District,12,13,13,0,0
2022-06-05,Can Tho City,Cai Rang District,13,13,11,2,0
2022-06-05,Can Tho City,Cai Rang District,14,10,9,1,1
2022-06-05,Can Tho City,Cai Rang District,15,7,5,2,0
2022-06-05,Can Tho City,Cai Rang District,16,14,13,1,0
2022-06-05,Can Tho City,Cai Rang District,17,12,10,2,0
2022-06-05,Can Tho City,Cai Rang District,18,10,10,0,0
2022-06-05,Can Tho City,Cai Rang District,19,11,11,0,0
2022-06-05,Can Tho City,Cai Rang District,20,10,6,4,1
2022-06-05,Can Tho City,Cai Rang District,21,2,0,2,1
2022-06-05,Can Tho City,Ninh Kieu District,0,1,1,0,0
2022-06-05,Can Tho City,Ninh Kieu District,1,2,2,0,0
2022-06-05,Can Tho City,Ninh Kieu District,2,1,0,1,0
2022-06-05,Can Tho City,Ninh Kieu District,3,2,1,1,0
2022-06-05,Can Tho City,Ninh Kieu District,4,1,1,0,0
2022-06-05,Can Tho City,Ninh Kieu District,5,2,2,0,0
2022-06-05,Can Tho City,Ninh Kieu District,6,56,53,3,0
2022-06-05,Can Tho City,Ninh Kieu District,7,134,120,14,2
2022-06-05,Can Tho City,Ninh Kieu District,8,220,209,11,0
2022-06-05,Can Tho City,Ninh Kieu District,9,343,322,21,1
2022-06-05,Can Tho City,Ninh Kieu District,10,519,489,30,0
2022-06-05,Can Tho City,Ninh Kieu District,11,767,718,49,5
2022-06-05,Can Tho City,Ninh Kieu District,12,649,614,35,0
2022-06-05,Can Tho City,Ninh Kieu District,13,509,488,21,0
2022-06-05,Can Tho City,Ninh Kieu District,14,434,404,30,0
2022-06-05,Can Tho City,Ninh Kieu District,15,438,414,24,0
2022-06-05,Can Tho City,Ninh Kieu District,16,501,473,28,0
2022-06-05,Can Tho City,Ninh Kieu District,17,504,476,28,0
2022-06-05,Can Tho City,Ninh Kieu District,18,545,520,25,0
2022-06-05,Can Tho City,Ninh Kieu District,19,521,494,27,0
2022-06-05,Can Tho City,Ninh Kieu District,20,440,409,31,3
2022-06-05,Can Tho City,Ninh Kieu District,21,206,185,21,1
2022-06-05,Can Tho City,Ninh Kieu District,22,2,0,2,0
2022-06-05,Dong Nai,Bien Hoa City,0,1,1,0,0
2022-06-05,Dong Nai,Bien Hoa City,4,1,1,0,0
2022-06-05,Dong Nai,Bien Hoa City,6,65,34,31,16
2022-06-05,Dong Nai,Bien Hoa City,7,176,143,33,15
2022-06-05,Dong Nai,Bien Hoa City,8,339,278,61,16
2022-06-05,Dong Nai,Bien Hoa City,9,510,427,83,27
2022-06-05,Dong Nai,Bien Hoa City,10,821,730,91,28
2022-06-05,Dong Nai,Bien Hoa City,11,1180,1037,143,48
2022-06-05,Dong Nai,Bien Hoa City,12,1133,1004,129,32
2022-06-05,Dong Nai,Bien Hoa City,13,851,780,71,10
2022-06-05,Dong Nai,Bien Hoa City,14,691,629,62,17
2022-06-05,Dong Nai,Bien Hoa City,15,653,558,95,37
2022-06-05,Dong Nai,Bien Hoa City,16,652,563,89,34
2022-06-05,Dong Nai,Bien Hoa City,17,707,618,89,23
2022-06-05,Dong Nai,Bien Hoa City,18,769,663,106,37
2022-06-05,Dong Nai,Bien Hoa City,19,815,654,161,66
2022-06-05,Dong Nai,Bien Hoa City,20,630,450,180,81
2022-06-05,Dong Nai,Bien Hoa City,21,305,187,118,59
2022-06-05,Dong Nai,Bien Hoa City,22,4,0,4,0
2022-06-05,Dong Nai,Bien Hoa City,23,1,0,1,0
2022-06-05,Dong Nai,Long Khanh,11,1,0,1,0
2022-06-05,Dong Nai,Long Khanh,14,1,0,1,1
2022-06-05,Dong Nai,Long Khanh,18,1,0,1,1
2022-06-05,Dong Nai,Long Thanh,9,1,1,0,0
2022-06-05,Dong Nai,Long Thanh,11,4,1,3,2
2022-06-05,Dong Nai,Long Thanh,12,1,0,1,1
2022-06-05,Dong Nai,Long Thanh,13,1,0,1,0
2022-06-05,Dong Nai,Long Thanh,21,3,0,3,2
2022-06-05,Dong Nai,Nhon trach,9,1,0,1,1
2022-06-05,Dong Nai,Nhon trach,15,1,0,1,1
2022-06-05,Dong Nai,Nhon trach,18,1,0,1,0
2022-06-05,Dong Nai,Nhon trach,20,1,0,1,1
2022-06-05,Dong Nai,Trang Bom,9,1,0,1,1
2022-06-05,Dong Nai,Trang Bom,10,1,0,1,1
2022-06-05,Dong Nai,Trang Bom,11,2,0,2,2
2022-06-05,Dong Nai,Trang Bom,12,3,0,3,2
2022-06-05,Dong Nai,Trang Bom,14,3,0,3,3
2022-06-05,Dong Nai,Trang Bom,16,1,0,1,1
2022-06-05,Dong Nai,Trang Bom,19,2,1,1,0
2022-06-05,Hai Phong City,An Duong,7,1,0,1,1
2022-06-05,Hai Phong City,An Duong,8,4,1,3,3
2022-06-05,Hai Phong City,An Duong,9,3,3,0,0
2022-06-05,Hai Phong City,An Duong,10,5,5,0,0
2022-06-05,Hai Phong City,An Duong,11,3,2,1,1
2022-06-05,Hai Phong City,An Duong,12,4,2,2,1
2022-06-05,Hai Phong City,An Duong,13,3,3,0,0
2022-06-05,Hai Phong City,An Duong,14,3,2,1,1
2022-06-05,Hai Phong City,An Duong,15,4,2,2,0
2022-06-05,Hai Phong City,An Duong,16,3,1,2,0
2022-06-05,Hai Phong City,An Duong,17,2,0,2,1
2022-06-05,Hai Phong City,An Duong,18,1,0,1,1
2022-06-05,Hai Phong City,An Duong,19,2,0,2,1
2022-06-05,Hai Phong City,An Duong,20,1,0,1,1
2022-06-05,Hai Phong City,An Duong,21,2,0,2,2
2022-06-05,Hai Phong City,Do Son District,17,2,0,2,1
2022-06-05,Hai Phong City,Do Son District,19,1,0,1,1
2022-06-05,Hai Phong City,Duong Kinh District,9,1,0,1,0
2022-06-05,Hai Phong City,Hai An District,6,1,0,1,1
2022-06-05,Hai Phong City,Hai An District,7,11,8,3,0
2022-06-05,Hai Phong City,Hai An District,8,19,15,4,2
2022-06-05,Hai Phong City,Hai An District,9,11,9,2,0
2022-06-05,Hai Phong City,Hai An District,10,31,23,8,3
2022-06-05,Hai Phong City,Hai An District,11,55,44,11,7
2022-06-05,Hai Phong City,Hai An District,12,30,25,5,2
2022-06-05,Hai Phong City,Hai An District,13,24,20,4,3
2022-06-05,Hai Phong City,Hai An District,14,20,15,5,3
2022-06-05,Hai Phong City,Hai An District,15,22,18,4,3
2022-06-05,Hai Phong City,Hai An District,16,17,14,3,3
2022-06-05,Hai Phong City,Hai An District,17,18,16,2,1
2022-06-05,Hai Phong City,Hai An District,18,32,21,11,2
2022-06-05,Hai Phong City,Hai An District,19,34,21,13,7
2022-06-05,Hai Phong City,Hai An District,20,23,15,8,5
2022-06-05,Hai Phong City,Hai An District,21,11,9,2,1
2022-06-05,Hai Phong City,Hong Bang District,6,1,0,1,0
2022-06-05,Hai Phong City,Hong Bang District,7,10,6,4,2
2022-06-05,Hai Phong City,Hong Bang District,8,22,20,2,0
2022-06-05,Hai Phong City,Hong Bang District,9,42,34,8,2
2022-06-05,Hai Phong City,Hong Bang District,10,70,63,7,4
2022-06-05,Hai Phong City,Hong Bang District,11,163,105,58,42
2022-06-05,Hai Phong City,Hong Bang District,12,124,73,51,36
2022-06-05,Hai Phong City,Hong Bang District,13,43,31,12,6
2022-06-05,Hai Phong City,Hong Bang District,14,58,42,16,9
2022-06-05,Hai Phong City,Hong Bang District,15,62,42,20,11
2022-06-05,Hai Phong City,Hong Bang District,16,39,26,13,8
2022-06-05,Hai Phong City,Hong Bang District,17,59,46,13,7
2022-06-05,Hai Phong City,Hong Bang District,18,85,64,21,10
2022-06-05,Hai Phong City,Hong Bang District,19,65,42,23,14
2022-06-05,Hai Phong City,Hong Bang District,20,51,31,20,13
2022-06-05,Hai Phong City,Hong Bang District,21,21,11,10,5
2022-06-05,Hai Phong City,Kien An District,2,1,1,0,0
2022-06-05,Hai Phong City,Kien An District,7,1,0,1,1
2022-06-05,Hai Phong City,Kien An District,8,11,5,6,3
2022-06-05,Hai Phong City,Kien An District,9,17,11,6,2
2022-06-05,Hai Phong City,Kien An District,10,16,15,1,1
2022-06-05,Hai Phong City,Kien An District,11,20,15,5,2
2022-06-05,Hai Phong City,Kien An District,12,18,13,5,1
2022-06-05,Hai Phong City,Kien An District,13,15,12,3,2
2022-06-05,Hai Phong City,Kien An District,14,19,15,4,3
2022-06-05,Hai Phong City,Kien An District,15,11,8,3,3
2022-06-05,Hai Phong City,Kien An District,16,12,9,3,0
2022-06-05,Hai Phong City,Kien An District,17,13,10,3,3
2022-06-05,Hai Phong City,Kien An District,18,16,6,10,9
2022-06-05,Hai Phong City,Kien An District,19,24,10,14,10
2022-06-05,Hai Phong City,Kien An District,20,17,5,12,8
2022-06-05,Hai Phong City,Kien An District,21,6,1,5,3
2022-06-05,Hai Phong City,Le Chan District,0,1,0,1,0
2022-06-05,Hai Phong City,Le Chan District,5,1,0,1,0
2022-06-05,Hai Phong City,Le Chan District,6,3,2,1,1
2022-06-05,Hai Phong City,Le Chan District,7,40,25,15,8
2022-06-05,Hai Phong City,Le Chan District,8,80,68,12,0
2022-06-05,Hai Phong City,Le Chan District,9,130,113,17,1
2022-06-05,Hai Phong City,Le Chan District,10,236,194,42,13
2022-06-05,Hai Phong City,Le Chan District,11,392,289,103,76
2022-06-05,Hai Phong City,Le Chan District,12,340,224,116,83
2022-06-05,Hai Phong City,Le Chan District,13,204,145,59,23
2022-06-05,Hai Phong City,Le Chan District,14,176,132,44,24
2022-06-05,Hai Phong City,Le Chan District,15,193,149,44,24
2022-06-05,Hai Phong City,Le Chan District,16,183,153,30,16
2022-06-05,Hai Phong City,Le Chan District,17,225,183,42,21
2022-06-05,Hai Phong City,Le Chan District,18,233,184,49,34
2022-06-05,Hai Phong City,Le Chan District,19,240,178,62,31
2022-06-05,Hai Phong City,Le Chan District,20,188,129,59,32
2022-06-05,Hai Phong City,Le Chan District,21,103,66,37,17
2022-06-05,Hai Phong City,Le Chan District,22,2,0,2,0
2022-06-05,Hai Phong City,Ngo Quyen District,0,1,1,0,0
2022-06-05,Hai Phong City,Ngo Quyen District,1,2,1,1,1
2022-06-05,Hai Phong City,Ngo Quyen District,3,1,0,1,0
2022-06-05,Hai Phong City,Ngo Quyen District,6,1,0,1,1
2022-06-05,Hai Phong City,Ngo Quyen District,7,30,21,9,5
2022-06-05,Hai Phong City,Ngo Quyen District,8,58,53,5,1
2022-06-05,Hai Phong City,Ngo Quyen District,9,92,79,13,1
2022-06-05,Hai Phong City,Ngo Quyen District,10,175,140,35,17
2022-06-05,Hai Phong City,Ngo Quyen District,11,341,239,102,67
2022-06-05,Hai Phong City,Ngo Quyen District,12,270,196,74,40
2022-06-05,Hai Phong City,Ngo Quyen District,13,143,119,24,4
2022-06-05,Hai Phong City,Ngo Quyen District,14,144,118,26,6
2022-06-05,Hai Phong City,Ngo Quyen District,15,169,141,28,11
2022-06-05,Hai Phong City,Ngo Quyen District,16,145,126,19,3
2022-06-05,Hai Phong City,Ngo Quyen District,17,157,131,26,9
2022-06-05,Hai Phong City,Ngo Quyen District,18,199,159,40,17
2022-06-05,Hai Phong City,Ngo Quyen District,19,194,132,62,20
2022-06-05,Hai Phong City,Ngo Quyen District,20,136,101,35,20
2022-06-05,Hai Phong City,Ngo Quyen District,21,96,51,45,26
2022-06-05,Hai Phong City,Thuy Nguyen,11,2,0,2,2
2022-06-05,Hai Phong City,Thuy Nguyen,12,6,0,6,6
2022-06-05,Hai Phong City,Thuy Nguyen,13,4,0,4,1
2022-06-05,Hai Phong City,Thuy Nguyen,14,1,0,1,0
2022-06-05,Hai Phong City,Thuy Nguyen,16,2,0,2,2
2022-06-05,Hai Phong City,Thuy Nguyen,17,2,0,2,1
2022-06-05,Hai Phong City,Thuy Nguyen,21,2,0,2,1
2022-06-05,Hue City,Hue City,1,2,2,0,0
2022-06-05,Hue City,Hue City,2,2,2,0,0
2022-06-05,Hue City,Hue City,5,4,3,1,1
2022-06-05,Hue City,Hue City,6,76,64,12,4
2022-06-05,Hue City,Hue City,7,216,195,21,2
2022-06-05,Hue City,Hue City,8,335,311,24,1
2022-06-05,Hue City,Hue City,9,328,298,30,2
2022-06-05,Hue City,Hue City,10,550,505,45,0
2022-06-05,Hue City,Hue City,11,923,841,82,12
2022-06-05,Hue City,Hue City,12,659,609,50,2
2022-06-05,Hue City,Hue City,13,484,451,33,0
2022-06-05,Hue City,Hue City,14,420,374,46,1
2022-06-05,Hue City,Hue City,15,496,449,47,9
2022-06-05,Hue City,Hue City,16,459,412,47,2
2022-06-05,Hue City,Hue City,17,531,488,43,1
2022-06-05,Hue City,Hue City,18,595,543,52,3
2022-06-05,Hue City,Hue City,19,693,612,81,17
2022-06-05,Hue City,Hue City,20,529,402,127,60
2022-06-05,Hue City,Hue City,21,283,208,75,19
2022-06-05,Hue City,Hue City,22,1,0,1,0
2022-06-05,Hue City,Huong Thuy,10,3,3,0,0
2022-06-05,Hue City,Huong Thuy,11,3,2,1,0
2022-06-05,Hue City,Huong Thuy,13,2,1,1,1
2022-06-05,Hue City,Huong Thuy,14,1,1,0,0
2022-06-05,Hue City,Huong Thuy,18,1,1,0,0
2022-06-05,Hue City,Huong Thuy,19,5,2,3,3
2022-06-05,Hue City,Huong Thuy,20,4,2,2,1
2022-06-05,Hue City,Huong Tra,18,1,0,1,1
2022-06-05,Hue City,Phu Vang,7,1,1,0,0
2022-06-05,Hue City,Phu Vang,9,2,2,0,0
2022-06-05,Hue City,Phu Vang,10,2,1,1,0
2022-06-05,Hue City,Phu Vang,11,4,4,0,0
2022-06-05,Hue City,Phu Vang,12,2,2,0,0
2022-06-05,Hue City,Phu Vang,13,3,1,2,0
2022-06-05,Hue City,Phu Vang,14,3,1,2,2
2022-06-05,Hue City,Phu Vang,15,1,1,0,0
2022-06-05,Hue City,Phu Vang,16,7,4,3,1
2022-06-05,Hue City,Phu Vang,17,3,3,0,0
2022-06-05,Hue City,Phu Vang,18,4,3,1,0
2022-06-05,Hue City,Phu Vang,19,4,1,3,1
2022-06-05,Hue City,Phu Vang,20,2,1,1,1
2022-06-05,Hue City,Phu Vang,21,1,1,0,0
2022-06-05,Vung Tau,Ba Ria City,6,2,0,2,2
2022-06-05,Vung Tau,Ba Ria City,7,1,0,1,1
2022-06-05,Vung Tau,Ba Ria City,8,3,3,0,0
2022-06-05,Vung Tau,Ba Ria City,9,5,2,3,0
2022-06-05,Vung Tau,Ba Ria City,10,4,4,0,0
2022-06-05,Vung Tau,Ba Ria City,11,7,5,2,2
2022-06-05,Vung Tau,Ba Ria City,12,11,5,6,6
2022-06-05,Vung Tau,Ba Ria City,13,7,2,5,5
2022-06-05,Vung Tau,Ba Ria City,14,3,3,0,0
2022-06-05,Vung Tau,Ba Ria City,15,6,3,3,1
2022-06-05,Vung Tau,Ba Ria City,16,5,3,2,1
2022-06-05,Vung Tau,Ba Ria City,17,2,0,2,0
2022-06-05,Vung Tau,Ba Ria City,18,8,4,4,2
2022-06-05,Vung Tau,Ba Ria City,19,6,2,4,2
2022-06-05,Vung Tau,Ba Ria City,20,1,1,0,0
2022-06-05,Vung Tau,Ba Ria City,21,1,0,1,1
2022-06-05,Vung Tau,Tan Thanh,12,1,0,1,1
2022-06-05,Vung Tau,Vung Tau City,0,1,1,0,0
2022-06-05,Vung Tau,Vung Tau City,1,2,2,0,0
2022-06-05,Vung Tau,Vung Tau City,5,1,0,1,1
2022-06-05,Vung Tau,Vung Tau City,6,58,37,21,12
2022-06-05,Vung Tau,Vung Tau City,7,144,102,42,27
2022-06-05,Vung Tau,Vung Tau City,8,245,186,59,38
2022-06-05,Vung Tau,Vung Tau City,9,233,210,23,9
2022-06-05,Vung Tau,Vung Tau City,10,307,264,43,15
2022-06-05,Vung Tau,Vung Tau City,11,487,405,82,37
2022-06-05,Vung Tau,Vung Tau City,12,406,363,43,11
2022-06-05,Vung Tau,Vung Tau City,13,241,217,24,6
2022-06-05,Vung Tau,Vung Tau City,14,251,228,23,3
2022-06-05,Vung Tau,Vung Tau City,15,249,228,21,10
2022-06-05,Vung Tau,Vung Tau City,16,222,203,19,4
2022-06-05,Vung Tau,Vung Tau City,17,262,246,16,1
2022-06-05,Vung Tau,Vung Tau City,18,370,299,71,46
2022-06-05,Vung Tau,Vung Tau City,19,360,258,102,62
2022-06-05,Vung Tau,Vung Tau City,20,279,182,97,56
2022-06-05,Vung Tau,Vung Tau City,21,110,68,42,26
2022-06-05,Vung Tau,Vung Tau City,22,1,0,1,0
2022-06-06,Bac Ninh,Bác Ninh City,1,4,0,4,0
2022-06-06,Bac Ninh,Bác Ninh City,4,2,0,2,1
2022-06-06,Bac Ninh,Bác Ninh City,5,2,1,1,0
2022-06-06,Bac Ninh,Bác Ninh City,6,5,4,1,0
2022-06-06,Bac Ninh,Bác Ninh City,7,53,49,4,2
2022-06-06,Bac Ninh,Bác Ninh City,8,161,121,40,24
2022-06-06,Bac Ninh,Bác Ninh City,9,179,149,30,5
2022-06-06,Bac Ninh,Bác Ninh City,10,165,150,15,1
2022-06-06,Bac Ninh,Bác Ninh City,11,331,297,34,12
2022-06-06,Bac Ninh,Bác Ninh City,12,229,208,21,5
2022-06-06,Bac Ninh,Bác Ninh City,13,164,153,11,0
2022-06-06,Bac Ninh,Bác Ninh City,14,163,153,10,0
2022-06-06,Bac Ninh,Bác Ninh City,15,122,114,8,0
2022-06-06,Bac Ninh,Bác Ninh City,16,115,110,5,0
2022-06-06,Bac Ninh,Bác Ninh City,17,137,128,9,0
2022-06-06,Bac Ninh,Bác Ninh City,18,169,158,11,0
2022-06-06,Bac Ninh,Bác Ninh City,19,171,158,13,0
2022-06-06,Bac Ninh,Bác Ninh City,20,168,142,26,8
2022-06-06,Bac Ninh,Bác Ninh City,21,97,78,19,6
2022-06-06,Bac Ninh,Bác Ninh City,22,2,0,2,0
2022-06-06,Bac Ninh,Bác Ninh City,23,2,2,0,0
2022-06-06,Bac Ninh,Luong Tai,9,1,0,1,1
2022-06-06,Bac Ninh,Luong Tai,17,1,0,1,1
2022-06-06,Bac Ninh,Que Vo,7,1,0,1,1
2022-06-06,Bac Ninh,Que Vo,8,2,0,2,1
2022-06-06,Bac Ninh,Que Vo,10,2,1,1,1
2022-06-06,Bac Ninh,Que Vo,11,1,1,0,0
2022-06-06,Bac Ninh,Que Vo,12,1,1,0,0
2022-06-06,Bac Ninh,Que Vo,13,3,2,1,0
2022-06-06,Bac Ninh,Que Vo,14,1,1,0,0
2022-06-06,Bac Ninh,Que Vo,16,2,0,2,2
2022-06-06,Bac Ninh,Que Vo,17,1,0,1,1
2022-06-06,Bac Ninh,Que Vo,21,1,0,1,1
2022-06-06,Bac Ninh,Tien Du,12,1,0,1,0
2022-06-06,Bac Ninh,Tien Du,13,4,0,4,4
2022-06-06,Bac Ninh,Tien Du,17,5,0,5,4
2022-06-06,Bac Ninh,Tien Du,20,2,0,2,2
2022-06-06,Bac Ninh,Tu Son,10,1,0,1,1
2022-06-06,Bac Ninh,Tu Son,14,1,0,1,1
2022-06-06,Bac Ninh,Tu Son,15,1,0,1,1
2022-06-06,Bac Ninh,Tu Son,17,2,0,2,2
2022-06-06,Bac Ninh,Tu Son,18,1,0,1,1
2022-06-06,Bac Ninh,Tu Son,21,1,0,1,1
2022-06-06,Binh Duong,Ben Cat,11,1,0,1,1
2022-06-06,Binh Duong,Ben Cat,13,4,0,4,4
2022-06-06,Binh Duong,Ben Cat,14,1,0,1,1
2022-06-06,Binh Duong,Ben Cat,15,1,0,1,1
2022-06-06,Binh Duong,Ben Cat,18,3,1,2,2
2022-06-06,Binh Duong,Ben Cat,19,3,0,3,2
2022-06-06,Binh Duong,Ben Cat,21,1,0,1,1
2022-06-06,Binh Duong,Di An,7,7,3,4,3
2022-06-06,Binh Duong,Di An,8,21,8,13,10
2022-06-06,Binh Duong,Di An,9,52,24,28,23
2022-06-06,Binh Duong,Di An,10,53,34,19,14
2022-06-06,Binh Duong,Di An,11,74,37,37,30
2022-06-06,Binh Duong,Di An,12,47,31,16,14
2022-06-06,Binh Duong,Di An,13,72,49,23,16
2022-06-06,Binh Duong,Di An,14,52,35,17,13
2022-06-06,Binh Duong,Di An,15,60,30,30,23
2022-06-06,Binh Duong,Di An,16,47,28,19,17
2022-06-06,Binh Duong,Di An,17,53,42,11,5
2022-06-06,Binh Duong,Di An,18,52,34,18,8
2022-06-06,Binh Duong,Di An,19,48,29,19,13
2022-06-06,Binh Duong,Di An,20,43,23,20,16
2022-06-06,Binh Duong,Di An,21,20,12,8,7
2022-06-06,Binh Duong,Phu Giao,8,1,0,1,1
2022-06-06,Binh Duong,Tan Uyen,9,4,1,3,3
2022-06-06,Binh Duong,Tan Uyen,10,1,1,0,0
2022-06-06,Binh Duong,Tan Uyen,11,3,1,2,2
2022-06-06,Binh Duong,Tan Uyen,12,3,2,1,1
2022-06-06,Binh Duong,Tan Uyen,13,5,2,3,3
2022-06-06,Binh Duong,Tan Uyen,14,2,2,0,0
2022-06-06,Binh Duong,Tan Uyen,15,1,0,1,1
2022-06-06,Binh Duong,Tan Uyen,16,1,0,1,1
2022-06-06,Binh Duong,Tan Uyen,18,2,0,2,2
2022-06-06,Binh Duong,Tan Uyen,19,2,1,1,1
2022-06-06,Binh Duong,Tan Uyen,20,2,1,1,0
2022-06-06,Binh Duong,Thu Dau Mot Town,0,1,0,1,0
2022-06-06,Binh Duong,Thu Dau Mot Town,5,3,1,2,0
2022-06-06,Binh Duong,Thu Dau Mot Town,6,40,34,6,4
2022-06-06,Binh Duong,Thu Dau Mot Town,7,131,120,11,4
2022-06-06,Binh Duong,Thu Dau Mot Town,8,272,249,23,1
2022-06-06,Binh Duong,Thu Dau Mot Town,9,314,299,15,0
2022-06-06,Binh Duong,Thu Dau Mot Town,10,539,509,30,3
2022-06-06,Binh Duong,Thu Dau Mot Town,11,737,693,44,11
2022-06-06,Binh Duong,Thu Dau Mot Town,12,545,522,23,2
2022-06-06,Binh Duong,Thu Dau Mot Town,13,620,585,35,4
2022-06-06,Binh Duong,Thu Dau Mot Town,14,462,430,32,12
2022-06-06,Binh Duong,Thu Dau Mot Town,15,399,377,22,2
2022-06-06,Binh Duong,Thu Dau Mot Town,16,324,302,22,1
2022-06-06,Binh Duong,Thu Dau Mot Town,17,421,395,26,0
2022-06-06,Binh Duong,Thu Dau Mot Town,18,492,464,28,8
2022-06-06,Binh Duong,Thu Dau Mot Town,19,405,376,29,2
2022-06-06,Binh Duong,Thu Dau Mot Town,20,298,266,32,2
2022-06-06,Binh Duong,Thu Dau Mot Town,21,170,142,28,6
2022-06-06,Binh Duong,Thu Dau Mot Town,22,5,0,5,2
2022-06-06,Binh Duong,Thu Dau Mot Town,23,1,0,1,1
2022-06-06,Binh Duong,Thuan An,5,1,1,0,0
2022-06-06,Binh Duong,Thuan An,6,2,0,2,2
2022-06-06,Binh Duong,Thuan An,7,7,2,5,4
2022-06-06,Binh Duong,Thuan An,8,27,21,6,2
2022-06-06,Binh Duong,Thuan An,9,45,31,14,10
2022-06-06,Binh Duong,Thuan An,10,73,53,20,9
2022-06-06,Binh Duong,Thuan An,11,100,75,25,17
2022-06-06,Binh Duong,Thuan An,12,101,82,19,12
2022-06-06,Binh Duong,Thuan An,13,104,69,35,29
2022-06-06,Binh Duong,Thuan An,14,73,51,22,8
2022-06-06,Binh Duong,Thuan An,15,63,48,15,10
2022-06-06,Binh Duong,Thuan An,16,52,44,8,4
2022-06-06,Binh Duong,Thuan An,17,49,44,5,5
2022-06-06,Binh Duong,Thuan An,18,54,50,4,1
2022-06-06,Binh Duong,Thuan An,19,52,45,7,1
2022-06-06,Binh Duong,Thuan An,20,33,23,10,2
2022-06-06,Binh Duong,Thuan An,21,27,10,17,15
2022-06-06,Binh Duong,Thuan An,22,3,0,3,0
2022-06-06,Can Tho City,Binh Thuy District,7,3,2,1,1
2022-06-06,Can Tho City,Binh Thuy District,8,3,3,0,0
2022-06-06,Can Tho City,Binh Thuy District,9,9,9,0,0
2022-06-06,Can Tho City,Binh Thuy District,10,11,10,1,0
2022-06-06,Can Tho City,Binh Thuy District,11,16,13,3,1
2022-06-06,Can Tho City,Binh Thuy District,12,11,9,2,0
2022-06-06,Can Tho City,Binh Thuy District,13,12,9,3,0
2022-06-06,Can Tho City,Binh Thuy District,14,11,11,0,0
2022-06-06,Can Tho City,Binh Thuy District,15,15,14,1,1
2022-06-06,Can Tho City,Binh Thuy District,16,15,15,0,0
2022-06-06,Can Tho City,Binh Thuy District,17,6,6,0,0
2022-06-06,Can Tho City,Binh Thuy District,18,14,12,2,2
2022-06-06,Can Tho City,Binh Thuy District,19,12,11,1,1
2022-06-06,Can Tho City,Binh Thuy District,20,11,10,1,0
2022-06-06,Can Tho City,Binh Thuy District,21,6,5,1,0
2022-06-06,Can Tho City,Cai Rang District,5,1,1,0,0
2022-06-06,Can Tho City,Cai Rang District,6,2,0,2,1
2022-06-06,Can Tho City,Cai Rang District,7,4,3,1,1
2022-06-06,Can Tho City,Cai Rang District,8,5,5,0,0
2022-06-06,Can Tho City,Cai Rang District,9,7,6,1,0
2022-06-06,Can Tho City,Cai Rang District,10,14,12,2,0
2022-06-06,Can Tho City,Cai Rang District,11,22,21,1,0
2022-06-06,Can Tho City,Cai Rang District,12,18,17,1,0
2022-06-06,Can Tho City,Cai Rang District,13,10,10,0,0
2022-06-06,Can Tho City,Cai Rang District,14,16,15,1,1
2022-06-06,Can Tho City,Cai Rang District,15,9,9,0,0
2022-06-06,Can Tho City,Cai Rang District,16,12,12,0,0
2022-06-06,Can Tho City,Cai Rang District,17,15,13,2,0
2022-06-06,Can Tho City,Cai Rang District,18,18,17,1,0
2022-06-06,Can Tho City,Cai Rang District,19,21,17,4,0
2022-06-06,Can Tho City,Cai Rang District,20,16,14,2,1
2022-06-06,Can Tho City,Cai Rang District,21,6,3,3,1
2022-06-06,Can Tho City,Ninh Kieu District,0,13,8,5,0
2022-06-06,Can Tho City,Ninh Kieu District,1,2,0,2,0
2022-06-06,Can Tho City,Ninh Kieu District,2,4,4,0,0
2022-06-06,Can Tho City,Ninh Kieu District,3,2,2,0,0
2022-06-06,Can Tho City,Ninh Kieu District,4,3,0,3,0
2022-06-06,Can Tho City,Ninh Kieu District,5,6,5,1,0
2022-06-06,Can Tho City,Ninh Kieu District,6,55,51,4,0
2022-06-06,Can Tho City,Ninh Kieu District,7,135,131,4,0
2022-06-06,Can Tho City,Ninh Kieu District,8,313,283,30,0
2022-06-06,Can Tho City,Ninh Kieu District,9,384,366,18,0
2022-06-06,Can Tho City,Ninh Kieu District,10,602,570,32,1
2022-06-06,Can Tho City,Ninh Kieu District,11,1036,963,73,14
2022-06-06,Can Tho City,Ninh Kieu District,12,751,715,36,1
2022-06-06,Can Tho City,Ninh Kieu District,13,641,604,37,0
2022-06-06,Can Tho City,Ninh Kieu District,14,532,519,13,0
2022-06-06,Can Tho City,Ninh Kieu District,15,504,476,28,0
2022-06-06,Can Tho City,Ninh Kieu District,16,544,523,21,0
2022-06-06,Can Tho City,Ninh Kieu District,17,584,554,30,0
2022-06-06,Can Tho City,Ninh Kieu District,18,671,639,32,0
2022-06-06,Can Tho City,Ninh Kieu District,19,593,573,20,0
2022-06-06,Can Tho City,Ninh Kieu District,20,488,468,20,0
2022-06-06,Can Tho City,Ninh Kieu District,21,252,228,24,1
2022-06-06,Can Tho City,Ninh Kieu District,22,3,1,2,0
2022-06-06,Can Tho City,O Mon District,10,2,0,2,1
2022-06-06,Dong Nai,Bien Hoa City,0,9,4,5,2
2022-06-06,Dong Nai,Bien Hoa City,1,5,3,2,1
2022-06-06,Dong Nai,Bien Hoa City,2,3,3,0,0
2022-06-06,Dong Nai,Bien Hoa City,3,2,0,2,1
2022-06-06,Dong Nai,Bien Hoa City,4,1,0,1,0
2022-06-06,Dong Nai,Bien Hoa City,5,3,2,1,1
2022-06-06,Dong Nai,Bien Hoa City,6,62,33,29,19
2022-06-06,Dong Nai,Bien Hoa City,7,205,153,52,24
2022-06-06,Dong Nai,Bien Hoa City,8,358,303,55,16
2022-06-06,Dong Nai,Bien Hoa City,9,523,454,69,18
2022-06-06,Dong Nai,Bien Hoa City,10,869,776,93,16
2022-06-06,Dong Nai,Bien Hoa City,11,1344,1172,172,73
2022-06-06,Dong Nai,Bien Hoa City,12,975,892,83,28
2022-06-06,Dong Nai,Bien Hoa City,13,1096,975,121,51
2022-06-06,Dong Nai,Bien Hoa City,14,876,760,116,55
2022-06-06,Dong Nai,Bien Hoa City,15,718,619,99,48
2022-06-06,Dong Nai,Bien Hoa City,16,582,515,67,21
2022-06-06,Dong Nai,Bien Hoa City,17,625,572,53,9
2022-06-06,Dong Nai,Bien Hoa City,18,707,653,54,7
2022-06-06,Dong Nai,Bien Hoa City,19,721,657,64,7
2022-06-06,Dong Nai,Bien Hoa City,20,574,475,99,27
2022-06-06,Dong Nai,Bien Hoa City,21,265,168,97,40
2022-06-06,Dong Nai,Bien Hoa City,23,1,0,1,0
2022-06-06,Dong Nai,Cam My,17,1,0,1,1
2022-06-06,Dong Nai,Long Khanh,15,1,0,1,1
2022-06-06,Dong Nai,Long Khanh,16,1,0,1,1
2022-06-06,Dong Nai,Long Thanh,5,1,0,1,0
2022-06-06,Dong Nai,Long Thanh,8,1,0,1,1
2022-06-06,Dong Nai,Long Thanh,9,1,0,1,1
2022-06-06,Dong Nai,Long Thanh,10,2,0,2,2
2022-06-06,Dong Nai,Long Thanh,11,3,0,3,3
2022-06-06,Dong Nai,Long Thanh,12,9,0,9,9
2022-06-06,Dong Nai,Long Thanh,13,5,0,5,5
2022-06-06,Dong Nai,Long Thanh,14,1,0,1,1
2022-06-06,Dong Nai,Long Thanh,15,2,0,2,2
2022-06-06,Dong Nai,Long Thanh,16,2,0,2,1
2022-06-06,Dong Nai,Long Thanh,17,1,0,1,1
2022-06-06,Dong Nai,Long Thanh,18,2,0,2,2
2022-06-06,Dong Nai,Long Thanh,20,1,0,1,1
2022-06-06,Dong Nai,Nhon trach,7,1,0,1,1
2022-06-06,Dong Nai,Nhon trach,10,1,0,1,1
2022-06-06,Dong Nai,Nhon trach,11,1,0,1,1
2022-06-06,Dong Nai,Trang Bom,11,2,0,2,2
2022-06-06,Dong Nai,Trang Bom,12,2,0,2,2
2022-06-06,Dong Nai,Trang Bom,13,5,0,5,4
2022-06-06,Dong Nai,Trang Bom,14,2,0,2,1
2022-06-06,Dong Nai,Trang Bom,15,1,0,1,1
2022-06-06,Dong Nai,Trang Bom,16,2,0,2,2
2022-06-06,Dong Nai,Trang Bom,17,1,0,1,1
2022-06-06,Dong Nai,Trang Bom,18,1,0,1,1
2022-06-06,Dong Nai,Trang Bom,20,1,0,1,1
2022-06-06,Dong Nai,Trang Bom,21,1,0,1,0
2022-06-06,Hai Phong City,An Duong,7,1,0,1,1
2022-06-06,Hai Phong City,An Duong,8,4,0,4,2
2022-06-06,Hai Phong City,An Duong,9,7,1,6,4
2022-06-06,Hai Phong City,An Duong,10,6,1,5,2
2022-06-06,Hai Phong City,An Duong,11,2,2,0,0
2022-06-06,Hai Phong City,An Duong,12,4,0,4,2
2022-06-06,Hai Phong City,An Duong,13,3,1,2,1
2022-06-06,Hai Phong City,An Duong,14,5,3,2,1
2022-06-06,Hai Phong City,An Duong,15,3,2,1,0
2022-06-06,Hai Phong City,An Duong,16,2,1,1,1
2022-06-06,Hai Phong City,An Duong,17,6,2,4,4
2022-06-06,Hai Phong City,An Duong,18,1,0,1,1
2022-06-06,Hai Phong City,An Duong,19,1,0,1,1
2022-06-06,Hai Phong City,An Duong,20,4,1,3,2
2022-06-06,Hai Phong City,An Duong,21,9,1,8,5
2022-06-06,Hai Phong City,Hai An District,7,17,7,10,9
2022-06-06,Hai Phong City,Hai An District,8,26,11,15,13
2022-06-06,Hai Phong City,Hai An District,9,16,11,5,2
2022-06-06,Hai Phong City,Hai An District,10,34,28,6,3
2022-06-06,Hai Phong City,Hai An District,11,64,54,10,8
2022-06-06,Hai Phong City,Hai An District,12,23,22,1,0
2022-06-06,Hai Phong City,Hai An District,13,21,17,4,2
2022-06-06,Hai Phong City,Hai An District,14,19,16,3,3
2022-06-06,Hai Phong City,Hai An District,15,25,23,2,1
2022-06-06,Hai Phong City,Hai An District,16,13,11,2,0
2022-06-06,Hai Phong City,Hai An District,17,24,17,7,4
2022-06-06,Hai Phong City,Hai An District,18,33,28,5,2
2022-06-06,Hai Phong City,Hai An District,19,22,19,3,0
2022-06-06,Hai Phong City,Hai An District,20,29,20,9,3
2022-06-06,Hai Phong City,Hai An District,21,6,4,2,2
2022-06-06,Hai Phong City,Hong Bang District,1,1,0,1,1
2022-06-06,Hai Phong City,Hong Bang District,6,2,1,1,0
2022-06-06,Hai Phong City,Hong Bang District,7,20,15,5,4
2022-06-06,Hai Phong City,Hong Bang District,8,44,35,9,5
2022-06-06,Hai Phong City,Hong Bang District,9,44,33,11,6
2022-06-06,Hai Phong City,Hong Bang District,10,72,61,11,6
2022-06-06,Hai Phong City,Hong Bang District,11,119,93,26,11
2022-06-06,Hai Phong City,Hong Bang District,12,68,54,14,2
2022-06-06,Hai Phong City,Hong Bang District,13,56,45,11,2
2022-06-06,Hai Phong City,Hong Bang District,14,51,40,11,4
2022-06-06,Hai Phong City,Hong Bang District,15,54,37,17,2
2022-06-06,Hai Phong City,Hong Bang District,16,33,27,6,1
2022-06-06,Hai Phong City,Hong Bang District,17,39,35,4,1
2022-06-06,Hai Phong City,Hong Bang District,18,52,41,11,4
2022-06-06,Hai Phong City,Hong Bang District,19,48,37,11,3
2022-06-06,Hai Phong City,Hong Bang District,20,34,27,7,4
2022-06-06,Hai Phong City,Hong Bang District,21,26,16,10,2
2022-06-06,Hai Phong City,Kien An District,0,1,0,1,0
2022-06-06,Hai Phong City,Kien An District,6,1,0,1,1
2022-06-06,Hai Phong City,Kien An District,8,3,0,3,2
2022-06-06,Hai Phong City,Kien An District,9,15,13,2,1
2022-06-06,Hai Phong City,Kien An District,10,21,15,6,5
2022-06-06,Hai Phong City,Kien An District,11,11,10,1,0
2022-06-06,Hai Phong City,Kien An District,12,11,11,0,0
2022-06-06,Hai Phong City,Kien An District,13,16,14,2,2
2022-06-06,Hai Phong City,Kien An District,14,12,10,2,1
2022-06-06,Hai Phong City,Kien An District,15,27,22,5,1
2022-06-06,Hai Phong City,Kien An District,16,20,13,7,3
2022-06-06,Hai Phong City,Kien An District,17,24,19,5,4
2022-06-06,Hai Phong City,Kien An District,18,24,21,3,0
2022-06-06,Hai Phong City,Kien An District,19,17,11,6,1
2022-06-06,Hai Phong City,Kien An District,20,18,16,2,0
2022-06-06,Hai Phong City,Kien An District,21,2,1,1,1
2022-06-06,Hai Phong City,Kien An District,22,1,0,1,0
2022-06-06,Hai Phong City,Le Chan District,0,5,4,1,1
2022-06-06,Hai Phong City,Le Chan District,1,1,0,1,0
2022-06-06,Hai Phong City,Le Chan District,3,1,1,0,0
2022-06-06,Hai Phong City,Le Chan District,4,2,1,1,0
2022-06-06,Hai Phong City,Le Chan District,6,4,2,2,1
2022-06-06,Hai Phong City,Le Chan District,7,43,34,9,5
2022-06-06,Hai Phong City,Le Chan District,8,100,83,17,6
2022-06-06,Hai Phong City,Le Chan District,9,114,70,44,32
2022-06-06,Hai Phong City,Le Chan District,10,203,172,31,7
2022-06-06,Hai Phong City,Le Chan District,11,327,276,51,27
2022-06-06,Hai Phong City,Le Chan District,12,268,232,36,12
2022-06-06,Hai Phong City,Le Chan District,13,171,148,23,3
2022-06-06,Hai Phong City,Le Chan District,14,171,135,36,10
2022-06-06,Hai Phong City,Le Chan District,15,200,168,32,15
2022-06-06,Hai Phong City,Le Chan District,16,187,166,21,5
2022-06-06,Hai Phong City,Le Chan District,17,201,178,23,3
2022-06-06,Hai Phong City,Le Chan District,18,245,217,28,4
2022-06-06,Hai Phong City,Le Chan District,19,231,198,33,9
2022-06-06,Hai Phong City,Le Chan District,20,186,143,43,19
2022-06-06,Hai Phong City,Le Chan District,21,94,56,38,19
2022-06-06,Hai Phong City,Ngo Quyen District,0,2,1,1,1
2022-06-06,Hai Phong City,Ngo Quyen District,1,2,2,0,0
2022-06-06,Hai Phong City,Ngo Quyen District,3,2,1,1,1
2022-06-06,Hai Phong City,Ngo Quyen District,4,1,0,1,0
2022-06-06,Hai Phong City,Ngo Quyen District,5,1,0,1,0
2022-06-06,Hai Phong City,Ngo Quyen District,6,1,0,1,1
2022-06-06,Hai Phong City,Ngo Quyen District,7,30,17,13,11
2022-06-06,Hai Phong City,Ngo Quyen District,8,107,86,21,11
2022-06-06,Hai Phong City,Ngo Quyen District,9,86,65,21,13
2022-06-06,Hai Phong City,Ngo Quyen District,10,171,144,27,10
2022-06-06,Hai Phong City,Ngo Quyen District,11,292,245,47,18
2022-06-06,Hai Phong City,Ngo Quyen District,12,200,177,23,7
2022-06-06,Hai Phong City,Ngo Quyen District,13,174,156,18,2
2022-06-06,Hai Phong City,Ngo Quyen District,14,199,164,35,15
2022-06-06,Hai Phong City,Ngo Quyen District,15,181,161,20,9
2022-06-06,Hai Phong City,Ngo Quyen District,16,186,160,26,7
2022-06-06,Hai Phong City,Ngo Quyen District,17,187,167,20,3
2022-06-06,Hai Phong City,Ngo Quyen District,18,180,159,21,6
2022-06-06,Hai Phong City,Ngo Quyen District,19,242,209,33,17
2022-06-06,Hai Phong City,Ngo Quyen District,20,157,133,24,12
2022-06-06,Hai Phong City,Ngo Quyen District,21,98,69,29,9
2022-06-06,Hai Phong City,Ngo Quyen District,22,1,0,1,0
2022-06-06,Hai Phong City,Thuy Nguyen,0,1,0,1,0
2022-06-06,Hai Phong City,Thuy Nguyen,10,2,0,2,2
2022-06-06,Hai Phong City,Thuy Nguyen,11,2,0,2,2
2022-06-06,Hai Phong City,Thuy Nguyen,12,1,0,1,1
2022-06-06,Hai Phong City,Thuy Nguyen,14,2,0,2,1
2022-06-06,Hai Phong City,Thuy Nguyen,15,4,0,4,4
2022-06-06,Hai Phong City,Thuy Nguyen,16,1,0,1,1
2022-06-06,Hai Phong City,Thuy Nguyen,19,1,0,1,1
2022-06-06,Hai Phong City,Thuy Nguyen,20,1,0,1,1
2022-06-06,Hue City,Hue City,0,11,10,1,0
2022-06-06,Hue City,Hue City,1,3,3,0,0
2022-06-06,Hue City,Hue City,3,5,1,4,0
2022-06-06,Hue City,Hue City,5,5,2,3,0
2022-06-06,Hue City,Hue City,6,90,81,9,6
2022-06-06,Hue City,Hue City,7,233,212,21,3
2022-06-06,Hue City,Hue City,8,393,359,34,5
2022-06-06,Hue City,Hue City,9,385,363,22,0
2022-06-06,Hue City,Hue City,10,575,523,52,6
2022-06-06,Hue City,Hue City,11,1130,1024,106,19
2022-06-06,Hue City,Hue City,12,682,624,58,6
2022-06-06,Hue City,Hue City,13,643,582,61,0
2022-06-06,Hue City,Hue City,14,522,487,35,1
2022-06-06,Hue City,Hue City,15,429,391,38,2
2022-06-06,Hue City,Hue City,16,524,482,42,3
2022-06-06,Hue City,Hue City,17,558,521,37,4
2022-06-06,Hue City,Hue City,18,645,598,47,1
2022-06-06,Hue City,Hue City,19,836,754,82,7
2022-06-06,Hue City,Hue City,20,558,486,72,26
2022-06-06,Hue City,Hue City,21,359,271,88,39
2022-06-06,Hue City,Hue City,22,1,0,1,0
2022-06-06,Hue City,Huong Thuy,6,1,1,0,0
2022-06-06,Hue City,Huong Thuy,10,1,1,0,0
2022-06-06,Hue City,Huong Thuy,12,1,1,0,0
2022-06-06,Hue City,Huong Thuy,13,1,1,0,0
2022-06-06,Hue City,Huong Thuy,15,3,3,0,0
2022-06-06,Hue City,Huong Thuy,17,3,2,1,1
2022-06-06,Hue City,Huong Thuy,18,1,1,0,0
2022-06-06,Hue City,Huong Thuy,19,1,1,0,0
2022-06-06,Hue City,Huong Thuy,20,1,0,1,1
2022-06-06,Hue City,Huong Tra,10,2,2,0,0
2022-06-06,Hue City,Huong Tra,21,1,1,0,0
2022-06-06,Hue City,Phu Vang,7,1,1,0,0
2022-06-06,Hue City,Phu Vang,10,4,3,1,0
2022-06-06,Hue City,Phu Vang,12,1,1,0,0
2022-06-06,Hue City,Phu Vang,13,4,4,0,0
2022-06-06,Hue City,Phu Vang,14,1,1,0,0
2022-06-06,Hue City,Phu Vang,15,2,1,1,1
2022-06-06,Hue City,Phu Vang,17,4,3,1,0
2022-06-06,Hue City,Phu Vang,18,3,2,1,1
2022-06-06,Hue City,Phu Vang,19,4,4,0,0
2022-06-06,Hue City,Phu Vang,20,2,1,1,0
2022-06-06,Hue City,Phu Vang,21,1,1,0,0
2022-06-06,Khanh Hoa,Cam Ranh City,10,1,0,1,1
2022-06-06,Khanh Hoa,Cam Ranh City,13,1,0,1,1
2022-06-06,Khanh Hoa,Cam Ranh City,15,3,0,3,3
2022-06-06,Khanh Hoa,Cam Ranh City,16,1,0,1,1
2022-06-06,Khanh Hoa,Cam Ranh City,19,1,0,1,1
2022-06-06,Khanh Hoa,Dien Khanh,14,1,0,1,1
2022-06-06,Khanh Hoa,Dien Khanh,15,2,0,2,2
2022-06-06,Khanh Hoa,Dien Khanh,21,1,0,1,1
2022-06-06,Khanh Hoa,Nha Trang City,0,8,5,3,0
2022-06-06,Khanh Hoa,Nha Trang City,1,1,0,1,0
2022-06-06,Khanh Hoa,Nha Trang City,2,2,1,1,0
2022-06-06,Khanh Hoa,Nha Trang City,5,2,2,0,0
2022-06-06,Khanh Hoa,Nha Trang City,6,65,60,5,1
2022-06-06,Khanh Hoa,Nha Trang City,7,154,134,20,2
2022-06-06,Khanh Hoa,Nha Trang City,8,231,211,20,1
2022-06-06,Khanh Hoa,Nha Trang City,9,221,210,11,0
2022-06-06,Khanh Hoa,Nha Trang City,10,264,233,31,2
2022-06-06,Khanh Hoa,Nha Trang City,11,419,390,29,0
2022-06-06,Khanh Hoa,Nha Trang City,12,301,270,31,2
2022-06-06,Khanh Hoa,Nha Trang City,13,345,325,20,0
2022-06-06,Khanh Hoa,Nha Trang City,14,270,256,14,0
2022-06-06,Khanh Hoa,Nha Trang City,15,229,208,21,2
2022-06-06,Khanh Hoa,Nha Trang City,16,297,284,13,1
2022-06-06,Khanh Hoa,Nha Trang City,17,216,205,11,0
2022-06-06,Khanh Hoa,Nha Trang City,18,317,289,28,1
2022-06-06,Khanh Hoa,Nha Trang City,19,336,303,33,3
2022-06-06,Khanh Hoa,Nha Trang City,20,236,207,29,0
2022-06-06,Khanh Hoa,Nha Trang City,21,112,96,16,3
2022-06-06,Lam Dong,Da Lat City,6,2,2,0,0
2022-06-06,Lam Dong,Da Lat City,7,63,47,16,11
2022-06-06,Lam Dong,Da Lat City,8,99,67,32,19
2022-06-06,Lam Dong,Da Lat City,9,113,87,26,13
2022-06-06,Lam Dong,Da Lat City,10,115,91,24,2
2022-06-06,Lam Dong,Da Lat City,11,141,126,15,2
2022-06-06,Lam Dong,Da Lat City,12,143,124,19,5
2022-06-06,Lam Dong,Da Lat City,13,140,120,20,8
2022-06-06,Lam Dong,Da Lat City,14,106,84,22,17
2022-06-06,Lam Dong,Da Lat City,15,120,94,26,19
2022-06-06,Lam Dong,Da Lat City,16,115,88,27,18
2022-06-06,Lam Dong,Da Lat City,17,130,92,38,26
2022-06-06,Lam Dong,Da Lat City,18,144,108,36,19
2022-06-06,Lam Dong,Da Lat City,19,136,102,34,18
2022-06-06,Lam Dong,Da Lat City,20,98,71,27,15
2022-06-06,Lam Dong,Da Lat City,21,47,35,12,8
2022-06-06,Lam Dong,Da Lat City,22,4,1,3,1
2022-06-06,Lam Dong,Da Lat City,23,2,0,2,2
2022-06-06,Nghe An,Vinh City,0,4,1,3,0
2022-06-06,Nghe An,Vinh City,1,5,2,3,0
2022-06-06,Nghe An,Vinh City,2,1,1,0,0
2022-06-06,Nghe An,Vinh City,3,1,1,0,0
2022-06-06,Nghe An,Vinh City,5,3,0,3,1
2022-06-06,Nghe An,Vinh City,6,11,5,6,1
2022-06-06,Nghe An,Vinh City,7,161,135,26,6
2022-06-06,Nghe An,Vinh City,8,191,172,19,0
2022-06-06,Nghe An,Vinh City,9,198,162,36,1
2022-06-06,Nghe An,Vinh City,10,279,238,41,10
2022-06-06,Nghe An,Vinh City,11,482,381,101,50
2022-06-06,Nghe An,Vinh City,12,350,280,70,24
2022-06-06,Nghe An,Vinh City,13,175,140,35,1
2022-06-06,Nghe An,Vinh City,14,231,192,39,3
2022-06-06,Nghe An,Vinh City,15,259,218,41,9
2022-06-06,Nghe An,Vinh City,16,168,130,38,14
2022-06-06,Nghe An,Vinh City,17,208,175,33,4
2022-06-06,Nghe An,Vinh City,18,270,223,47,7
2022-06-06,Nghe An,Vinh City,19,231,182,49,15
2022-06-06,Nghe An,Vinh City,20,160,128,32,10
2022-06-06,Nghe An,Vinh City,21,120,61,59,31
2022-06-06,Nghe An,Vinh City,22,1,0,1,0
2022-06-06,Quang Nam,Hoi An City,0,2,0,2,2
2022-06-06,Quang Nam,Hoi An City,5,1,1,0,0
2022-06-06,Quang Nam,Hoi An City,7,16,13,3,3
2022-06-06,Quang Nam,Hoi An City,8,25,19,6,3
2022-06-06,Quang Nam,Hoi An City,9,24,21,3,0
2022-06-06,Quang Nam,Hoi An City,10,31,25,6,2
2022-06-06,Quang Nam,Hoi An City,11,35,22,13,7
2022-06-06,Quang Nam,Hoi An City,12,59,30,29,19
2022-06-06,Quang Nam,Hoi An City,13,48,37,11,6
2022-06-06,Quang Nam,Hoi An City,14,49,38,11,3
2022-06-06,Quang Nam,Hoi An City,15,39,31,8,3
2022-06-06,Quang Nam,Hoi An City,16,31,18,13,10
2022-06-06,Quang Nam,Hoi An City,17,55,32,23,15
2022-06-06,Quang Nam,Hoi An City,18,63,39,24,15
2022-06-06,Quang Nam,Hoi An City,19,56,36,20,17
2022-06-06,Quang Nam,Hoi An City,20,50,26,24,13
2022-06-06,Quang Nam,Hoi An City,21,35,14,21,16
2022-06-06,Quang Nam,Tam Ky City,10,1,0,1,1
2022-06-06,Quang Ninh,Cam Pha City,10,2,0,2,0
2022-06-06,Quang Ninh,Cam Pha City,11,4,0,4,3
2022-06-06,Quang Ninh,Cam Pha City,12,3,0,3,1
2022-06-06,Quang Ninh,Cam Pha City,13,1,0,1,1
2022-06-06,Quang Ninh,Cam Pha City,15,3,0,3,1
2022-06-06,Quang Ninh,Cam Pha City,16,1,0,1,1
2022-06-06,Quang Ninh,Cam Pha City,20,1,0,1,1
2022-06-06,Quang Ninh,Ha Long City,6,4,0,4,2
2022-06-06,Quang Ninh,Ha Long City,7,18,13,5,3
2022-06-06,Quang Ninh,Ha Long City,8,47,40,7,1
2022-06-06,Quang Ninh,Ha Long City,9,56,46,10,5
2022-06-06,Quang Ninh,Ha Long City,10,77,50,27,20
2022-06-06,Quang Ninh,Ha Long City,11,125,97,28,9
2022-06-06,Quang Ninh,Ha Long City,12,92,71,21,8
2022-06-06,Quang Ninh,Ha Long City,13,48,35,13,8
2022-06-06,Quang Ninh,Ha Long City,14,59,43,16,6
2022-06-06,Quang Ninh,Ha Long City,15,55,44,11,5
2022-06-06,Quang Ninh,Ha Long City,16,43,35,8,3
2022-06-06,Quang Ninh,Ha Long City,17,54,43,11,5
2022-06-06,Quang Ninh,Ha Long City,18,89,70,19,5
2022-06-06,Quang Ninh,Ha Long City,19,61,41,20,9
2022-06-06,Quang Ninh,Ha Long City,20,68,45,23,14
2022-06-06,Quang Ninh,Ha Long City,21,1,0,1,0
2022-06-06,Quang Ninh,Ha Long City,23,3,1,2,0
2022-06-06,Quang Ninh,Uong Bi City,9,2,0,2,2
2022-06-06,Quang Ninh,Uong Bi City,10,1,0,1,1
2022-06-06,Quang Ninh,Uong Bi City,19,1,0,1,1
2022-06-06,Quang Ninh,Uong Bi City,20,1,0,1,1
2022-06-06,Thai Nguyen,Thai Nguyen City,0,5,3,2,1
2022-06-06,Thai Nguyen,Thai Nguyen City,1,1,1,0,0
2022-06-06,Thai Nguyen,Thai Nguyen City,2,1,1,0,0
2022-06-06,Thai Nguyen,Thai Nguyen City,3,1,1,0,0
2022-06-06,Thai Nguyen,Thai Nguyen City,4,1,0,1,1
2022-06-06,Thai Nguyen,Thai Nguyen City,5,1,1,0,0
2022-06-06,Thai Nguyen,Thai Nguyen City,6,2,0,2,2
2022-06-06,Thai Nguyen,Thai Nguyen City,7,75,63,12,7
2022-06-06,Thai Nguyen,Thai Nguyen City,8,145,129,16,1
2022-06-06,Thai Nguyen,Thai Nguyen City,9,139,127,12,0
2022-06-06,Thai Nguyen,Thai Nguyen City,10,204,178,26,1
2022-06-06,Thai Nguyen,Thai Nguyen City,11,401,351,50,22
2022-06-06,Thai Nguyen,Thai Nguyen City,12,279,255,24,1
2022-06-06,Thai Nguyen,Thai Nguyen City,13,179,159,20,3
2022-06-06,Thai Nguyen,Thai Nguyen City,14,155,137,18,2
2022-06-06,Thai Nguyen,Thai Nguyen City,15,173,156,17,1
2022-06-06,Thai Nguyen,Thai Nguyen City,16,146,127,19,2
2022-06-06,Thai Nguyen,Thai Nguyen City,17,162,148,14,3
2022-06-06,Thai Nguyen,Thai Nguyen City,18,216,206,10,0
2022-06-06,Thai Nguyen,Thai Nguyen City,19,269,240,29,0
2022-06-06,Thai Nguyen,Thai Nguyen City,20,218,192,26,4
2022-06-06,Thai Nguyen,Thai Nguyen City,21,164,131,33,0
2022-06-06,Thai Nguyen,Thai Nguyen City,22,2,0,2,0
2022-06-06,Vung Tau,Ba Ria City,7,3,0,3,2
2022-06-06,Vung Tau,Ba Ria City,8,2,1,1,1
2022-06-06,Vung Tau,Ba Ria City,9,10,7,3,1
2022-06-06,Vung Tau,Ba Ria City,10,11,4,7,6
2022-06-06,Vung Tau,Ba Ria City,11,20,7,13,11
2022-06-06,Vung Tau,Ba Ria City,12,5,1,4,3
2022-06-06,Vung Tau,Ba Ria City,13,10,2,8,7
2022-06-06,Vung Tau,Ba Ria City,14,13,1,12,12
2022-06-06,Vung Tau,Ba Ria City,15,8,3,5,5
2022-06-06,Vung Tau,Ba Ria City,16,3,2,1,1
2022-06-06,Vung Tau,Ba Ria City,17,10,3,7,6
2022-06-06,Vung Tau,Ba Ria City,18,6,0,6,5
2022-06-06,Vung Tau,Ba Ria City,19,8,0,8,8
2022-06-06,Vung Tau,Ba Ria City,20,6,0,6,4
2022-06-06,Vung Tau,Ba Ria City,21,1,0,1,1
2022-06-06,Vung Tau,Vung Tau City,0,2,1,1,0
2022-06-06,Vung Tau,Vung Tau City,1,1,0,1,0
2022-06-06,Vung Tau,Vung Tau City,2,2,0,2,0
2022-06-06,Vung Tau,Vung Tau City,5,3,2,1,1
2022-06-06,Vung Tau,Vung Tau City,6,53,33,20,8
2022-06-06,Vung Tau,Vung Tau City,7,112,94,18,3
2022-06-06,Vung Tau,Vung Tau City,8,202,176,26,8
2022-06-06,Vung Tau,Vung Tau City,9,193,172,21,6
2022-06-06,Vung Tau,Vung Tau City,10,234,216,18,3
2022-06-06,Vung Tau,Vung Tau City,11,390,353,37,12
2022-06-06,Vung Tau,Vung Tau City,12,301,278,23,1
2022-06-06,Vung Tau,Vung Tau City,13,250,235,15,0
2022-06-06,Vung Tau,Vung Tau City,14,295,274,21,5
2022-06-06,Vung Tau,Vung Tau City,15,250,227,23,2
2022-06-06,Vung Tau,Vung Tau City,16,225,208,17,1
2022-06-06,Vung Tau,Vung Tau City,17,248,222,26,5
2022-06-06,Vung Tau,Vung Tau City,18,332,305,27,4
2022-06-06,Vung Tau,Vung Tau City,19,281,243,38,20
2022-06-06,Vung Tau,Vung Tau City,20,269,69,200,168
2022-06-06,Vung Tau,Vung Tau City,21,254,39,215,165
2022-06-06,Vung Tau,Vung Tau City,22,1,0,1,0
2022-06-07,Bac Ninh,Bác Ninh City,0,1,0,1,0
2022-06-07,Bac Ninh,Bác Ninh City,6,8,5,3,0
2022-06-07,Bac Ninh,Bác Ninh City,7,63,47,16,13
2022-06-07,Bac Ninh,Bác Ninh City,8,136,121,15,1
2022-06-07,Bac Ninh,Bác Ninh City,9,119,111,8,0
2022-06-07,Bac Ninh,Bác Ninh City,10,158,137,21,4
2022-06-07,Bac Ninh,Bác Ninh City,11,332,294,38,11
2022-06-07,Bac Ninh,Bác Ninh City,12,187,166,21,4
2022-06-07,Bac Ninh,Bác Ninh City,13,127,121,6,0
2022-06-07,Bac Ninh,Bác Ninh City,14,122,115,7,2
2022-06-07,Bac Ninh,Bác Ninh City,15,132,119,13,0
2022-06-07,Bac Ninh,Bác Ninh City,16,116,103,13,1
2022-06-07,Bac Ninh,Bác Ninh City,17,106,98,8,1
2022-06-07,Bac Ninh,Bác Ninh City,18,161,145,16,7
2022-06-07,Bac Ninh,Bác Ninh City,19,168,139,29,14
2022-06-07,Bac Ninh,Bác Ninh City,20,156,106,50,27
2022-06-07,Bac Ninh,Bác Ninh City,21,97,69,28,19
2022-06-07,Bac Ninh,Bác Ninh City,23,1,0,1,0
2022-06-07,Bac Ninh,Luong Tai,13,1,0,1,1
2022-06-07,Bac Ninh,Luong Tai,15,1,0,1,1
2022-06-07,Bac Ninh,Que Vo,8,1,0,1,1
2022-06-07,Bac Ninh,Que Vo,9,1,1,0,0
2022-06-07,Bac Ninh,Que Vo,11,5,0,5,5
2022-06-07,Bac Ninh,Que Vo,13,2,0,2,2
2022-06-07,Bac Ninh,Tien Du,0,1,0,1,1
2022-06-07,Bac Ninh,Tien Du,7,1,0,1,1
2022-06-07,Bac Ninh,Tien Du,8,1,0,1,1
2022-06-07,Bac Ninh,Tien Du,9,1,0,1,1
2022-06-07,Bac Ninh,Tien Du,10,1,0,1,1
2022-06-07,Bac Ninh,Tien Du,12,2,0,2,0
2022-06-07,Bac Ninh,Tien Du,14,2,0,2,1
2022-06-07,Bac Ninh,Tien Du,15,1,0,1,1
2022-06-07,Bac Ninh,Tien Du,18,2,0,2,2
2022-06-07,Bac Ninh,Tu Son,10,1,0,1,0
2022-06-07,Bac Ninh,Tu Son,11,1,1,0,0
2022-06-07,Bac Ninh,Tu Son,12,2,0,2,2
2022-06-07,Bac Ninh,Tu Son,14,1,0,1,1
2022-06-07,Bac Ninh,Tu Son,15,1,0,1,1
2022-06-07,Bac Ninh,Tu Son,18,1,0,1,1
2022-06-07,Bac Ninh,Tu Son,19,1,0,1,1
2022-06-07,Binh Duong,Ben Cat,7,1,0,1,1
2022-06-07,Binh Duong,Ben Cat,12,3,0,3,3
2022-06-07,Binh Duong,Ben Cat,14,1,0,1,1
2022-06-07,Binh Duong,Ben Cat,15,4,0,4,2
2022-06-07,Binh Duong,Ben Cat,18,2,0,2,2
2022-06-07,Binh Duong,Di An,6,3,0,3,3
2022-06-07,Binh Duong,Di An,7,3,1,2,2
2022-06-07,Binh Duong,Di An,8,14,3,11,9
2022-06-07,Binh Duong,Di An,9,17,14,3,3
2022-06-07,Binh Duong,Di An,10,43,28,15,9
2022-06-07,Binh Duong,Di An,11,60,40,20,17
2022-06-07,Binh Duong,Di An,12,36,26,10,3
2022-06-07,Binh Duong,Di An,13,37,31,6,5
2022-06-07,Binh Duong,Di An,14,43,28,15,11
2022-06-07,Binh Duong,Di An,15,29,23,6,1
2022-06-07,Binh Duong,Di An,16,27,22,5,5
2022-06-07,Binh Duong,Di An,17,36,17,19,13
2022-06-07,Binh Duong,Di An,18,52,26,26,17
2022-06-07,Binh Duong,Di An,19,37,22,15,13
2022-06-07,Binh Duong,Di An,20,31,17,14,10
2022-06-07,Binh Duong,Di An,21,17,7,10,8
2022-06-07,Binh Duong,Tan Uyen,8,2,1,1,1
2022-06-07,Binh Duong,Tan Uyen,9,3,1,2,1
2022-06-07,Binh Duong,Tan Uyen,10,3,0,3,2
2022-06-07,Binh Duong,Tan Uyen,11,1,1,0,0
2022-06-07,Binh Duong,Tan Uyen,12,3,2,1,1
2022-06-07,Binh Duong,Tan Uyen,13,1,1,0,0
2022-06-07,Binh Duong,Tan Uyen,14,2,1,1,1
2022-06-07,Binh Duong,Tan Uyen,15,3,0,3,3
2022-06-07,Binh Duong,Tan Uyen,16,3,1,2,2
2022-06-07,Binh Duong,Tan Uyen,17,2,1,1,0
2022-06-07,Binh Duong,Tan Uyen,18,3,2,1,1
2022-06-07,Binh Duong,Tan Uyen,19,1,1,0,0
2022-06-07,Binh Duong,Tan Uyen,20,2,0,2,2
2022-06-07,Binh Duong,Tan Uyen,21,5,0,5,4
2022-06-07,Binh Duong,Thu Dau Mot Town,3,1,1,0,0
2022-06-07,Binh Duong,Thu Dau Mot Town,5,3,3,0,0
2022-06-07,Binh Duong,Thu Dau Mot Town,6,36,31,5,2
2022-06-07,Binh Duong,Thu Dau Mot Town,7,124,111,13,0
2022-06-07,Binh Duong,Thu Dau Mot Town,8,233,217,16,1
2022-06-07,Binh Duong,Thu Dau Mot Town,9,284,265,19,5
2022-06-07,Binh Duong,Thu Dau Mot Town,10,411,382,29,7
2022-06-07,Binh Duong,Thu Dau Mot Town,11,690,650,40,5
2022-06-07,Binh Duong,Thu Dau Mot Town,12,517,497,20,4
2022-06-07,Binh Duong,Thu Dau Mot Town,13,515,491,24,0
2022-06-07,Binh Duong,Thu Dau Mot Town,14,412,394,18,5
2022-06-07,Binh Duong,Thu Dau Mot Town,15,342,322,20,6
2022-06-07,Binh Duong,Thu Dau Mot Town,16,285,269,16,4
2022-06-07,Binh Duong,Thu Dau Mot Town,17,396,377,19,4
2022-06-07,Binh Duong,Thu Dau Mot Town,18,421,387,34,8
2022-06-07,Binh Duong,Thu Dau Mot Town,19,372,343,29,5
2022-06-07,Binh Duong,Thu Dau Mot Town,20,305,273,32,3
2022-06-07,Binh Duong,Thu Dau Mot Town,21,115,101,14,3
2022-06-07,Binh Duong,Thu Dau Mot Town,22,2,1,1,0
2022-06-07,Binh Duong,Thuan An,6,2,0,2,2
2022-06-07,Binh Duong,Thuan An,7,8,3,5,4
2022-06-07,Binh Duong,Thuan An,8,25,17,8,5
2022-06-07,Binh Duong,Thuan An,9,30,25,5,4
2022-06-07,Binh Duong,Thuan An,10,64,51,13,9
2022-06-07,Binh Duong,Thuan An,11,99,70,29,24
2022-06-07,Binh Duong,Thuan An,12,91,61,30,16
2022-06-07,Binh Duong,Thuan An,13,99,55,44,31
2022-06-07,Binh Duong,Thuan An,14,86,58,28,19
2022-06-07,Binh Duong,Thuan An,15,44,36,8,5
2022-06-07,Binh Duong,Thuan An,16,47,37,10,3
2022-06-07,Binh Duong,Thuan An,17,37,30,7,6
2022-06-07,Binh Duong,Thuan An,18,53,36,17,10
2022-06-07,Binh Duong,Thuan An,19,53,40,13,8
2022-06-07,Binh Duong,Thuan An,20,26,22,4,2
2022-06-07,Binh Duong,Thuan An,21,18,9,9,4
2022-06-07,Can Tho City,Binh Thuy District,6,1,1,0,0
2022-06-07,Can Tho City,Binh Thuy District,8,5,5,0,0
2022-06-07,Can Tho City,Binh Thuy District,9,7,6,1,0
2022-06-07,Can Tho City,Binh Thuy District,10,8,8,0,0
2022-06-07,Can Tho City,Binh Thuy District,11,12,10,2,0
2022-06-07,Can Tho City,Binh Thuy District,12,15,14,1,0
2022-06-07,Can Tho City,Binh Thuy District,13,13,13,0,0
2022-06-07,Can Tho City,Binh Thuy District,14,14,14,0,0
2022-06-07,Can Tho City,Binh Thuy District,15,7,6,1,0
2022-06-07,Can Tho City,Binh Thuy District,16,5,4,1,0
2022-06-07,Can Tho City,Binh Thuy District,17,17,16,1,0
2022-06-07,Can Tho City,Binh Thuy District,18,11,10,1,0
2022-06-07,Can Tho City,Binh Thuy District,19,11,11,0,0
2022-06-07,Can Tho City,Binh Thuy District,20,11,8,3,1
2022-06-07,Can Tho City,Binh Thuy District,21,2,1,1,0
2022-06-07,Can Tho City,Cai Rang District,6,1,1,0,0
2022-06-07,Can Tho City,Cai Rang District,7,3,2,1,0
2022-06-07,Can Tho City,Cai Rang District,8,10,9,1,1
2022-06-07,Can Tho City,Cai Rang District,9,9,9,0,0
2022-06-07,Can Tho City,Cai Rang District,10,12,11,1,0
2022-06-07,Can Tho City,Cai Rang District,11,21,19,2,0
2022-06-07,Can Tho City,Cai Rang District,12,12,12,0,0
2022-06-07,Can Tho City,Cai Rang District,13,12,9,3,3
2022-06-07,Can Tho City,Cai Rang District,14,20,17,3,1
2022-06-07,Can Tho City,Cai Rang District,15,7,7,0,0
2022-06-07,Can Tho City,Cai Rang District,16,7,3,4,2
2022-06-07,Can Tho City,Cai Rang District,17,17,15,2,0
2022-06-07,Can Tho City,Cai Rang District,18,14,13,1,0
2022-06-07,Can Tho City,Cai Rang District,19,7,7,0,0
2022-06-07,Can Tho City,Cai Rang District,20,11,11,0,0
2022-06-07,Can Tho City,Cai Rang District,21,4,3,1,1
2022-06-07,Can Tho City,Ninh Kieu District,0,1,1,0,0
2022-06-07,Can Tho City,Ninh Kieu District,1,2,0,2,0
2022-06-07,Can Tho City,Ninh Kieu District,2,2,2,0,0
2022-06-07,Can Tho City,Ninh Kieu District,3,1,1,0,0
2022-06-07,Can Tho City,Ninh Kieu District,5,5,3,2,2
2022-06-07,Can Tho City,Ninh Kieu District,6,52,43,9,0
2022-06-07,Can Tho City,Ninh Kieu District,7,114,111,3,0
2022-06-07,Can Tho City,Ninh Kieu District,8,238,225,13,2
2022-06-07,Can Tho City,Ninh Kieu District,9,306,289,17,0
2022-06-07,Can Tho City,Ninh Kieu District,10,586,565,21,0
2022-06-07,Can Tho City,Ninh Kieu District,11,854,812,42,3
2022-06-07,Can Tho City,Ninh Kieu District,12,598,572,26,0
2022-06-07,Can Tho City,Ninh Kieu District,13,505,487,18,0
2022-06-07,Can Tho City,Ninh Kieu District,14,386,367,19,0
2022-06-07,Can Tho City,Ninh Kieu District,15,265,247,18,0
2022-06-07,Can Tho City,Ninh Kieu District,16,455,425,30,1
2022-06-07,Can Tho City,Ninh Kieu District,17,681,654,27,0
2022-06-07,Can Tho City,Ninh Kieu District,18,577,540,37,0
2022-06-07,Can Tho City,Ninh Kieu District,19,464,443,21,0
2022-06-07,Can Tho City,Ninh Kieu District,20,371,350,21,0
2022-06-07,Can Tho City,Ninh Kieu District,21,208,191,17,1
2022-06-07,Can Tho City,Ninh Kieu District,22,5,0,5,0
2022-06-07,Can Tho City,Ninh Kieu District,23,1,0,1,0
2022-06-07,Dong Nai,Bien Hoa City,0,3,1,2,0
2022-06-07,Dong Nai,Bien Hoa City,1,1,0,1,1
2022-06-07,Dong Nai,Bien Hoa City,3,1,1,0,0
2022-06-07,Dong Nai,Bien Hoa City,4,1,1,0,0
2022-06-07,Dong Nai,Bien Hoa City,5,8,4,4,1
2022-06-07,Dong Nai,Bien Hoa City,6,60,35,25,17
2022-06-07,Dong Nai,Bien Hoa City,7,203,174,29,16
2022-06-07,Dong Nai,Bien Hoa City,8,338,299,39,7
2022-06-07,Dong Nai,Bien Hoa City,9,398,356,42,5
2022-06-07,Dong Nai,Bien Hoa City,10,842,749,93,23
2022-06-07,Dong Nai,Bien Hoa City,11,1225,1098,127,44
2022-06-07,Dong Nai,Bien Hoa City,12,982,858,124,43
2022-06-07,Dong Nai,Bien Hoa City,13,966,847,119,70
2022-06-07,Dong Nai,Bien Hoa City,14,801,692,109,48
2022-06-07,Dong Nai,Bien Hoa City,15,620,540,80,37
2022-06-07,Dong Nai,Bien Hoa City,16,535,486,49,17
2022-06-07,Dong Nai,Bien Hoa City,17,582,525,57,13
2022-06-07,Dong Nai,Bien Hoa City,18,702,631,71,19
2022-06-07,Dong Nai,Bien Hoa City,19,617,572,45,5
2022-06-07,Dong Nai,Bien Hoa City,20,512,451,61,15
2022-06-07,Dong Nai,Bien Hoa City,21,223,160,63,30
2022-06-07,Dong Nai,Bien Hoa City,22,1,0,1,0
2022-06-07,Dong Nai,Cam My,11,1,0,1,1
2022-06-07,Dong Nai,Long Khanh,16,1,0,1,1
2022-06-07,Dong Nai,Long Khanh,17,2,0,2,2
2022-06-07,Dong Nai,Long Khanh,18,1,0,1,1
2022-06-07,Dong Nai,Long Khanh,20,1,0,1,1
2022-06-07,Dong Nai,Long Thanh,8,1,0,1,1
2022-06-07,Dong Nai,Long Thanh,9,2,0,2,1
2022-06-07,Dong Nai,Long Thanh,10,2,0,2,2
2022-06-07,Dong Nai,Long Thanh,11,4,0,4,4
2022-06-07,Dong Nai,Long Thanh,12,5,0,5,3
2022-06-07,Dong Nai,Long Thanh,13,3,0,3,3
2022-06-07,Dong Nai,Long Thanh,14,1,0,1,1
2022-06-07,Dong Nai,Long Thanh,16,1,0,1,1
2022-06-07,Dong Nai,Long Thanh,19,1,0,1,1
2022-06-07,Dong Nai,Nhon trach,9,1,0,1,1
2022-06-07,Dong Nai,Nhon trach,11,1,0,1,1
2022-06-07,Dong Nai,Nhon trach,13,1,0,1,1
2022-06-07,Dong Nai,Nhon trach,14,1,0,1,1
2022-06-07,Dong Nai,Nhon trach,19,1,0,1,1
2022-06-07,Dong Nai,Trang Bom,0,1,0,1,0
2022-06-07,Dong Nai,Trang Bom,10,4,0,4,4
2022-06-07,Dong Nai,Trang Bom,11,2,0,2,2
2022-06-07,Dong Nai,Trang Bom,12,1,1,0,0
2022-06-07,Dong Nai,Trang Bom,14,1,0,1,1
2022-06-07,Dong Nai,Trang Bom,19,1,0,1,1
2022-06-07,Hai Phong City,An Duong,9,6,0,6,6
2022-06-07,Hai Phong City,An Duong,10,6,2,4,4
2022-06-07,Hai Phong City,An Duong,11,2,1,1,1
2022-06-07,Hai Phong City,An Duong,12,4,2,2,2
2022-06-07,Hai Phong City,An Duong,13,3,2,1,1
2022-06-07,Hai Phong City,An Duong,14,2,2,0,0
2022-06-07,Hai Phong City,An Duong,15,4,3,1,1
2022-06-07,Hai Phong City,An Duong,16,3,1,2,2
2022-06-07,Hai Phong City,An Duong,17,2,1,1,0
2022-06-07,Hai Phong City,An Duong,18,2,1,1,1
2022-06-07,Hai Phong City,An Duong,19,2,0,2,1
2022-06-07,Hai Phong City,An Duong,20,4,0,4,2
2022-06-07,Hai Phong City,An Duong,21,1,0,1,0
2022-06-07,Hai Phong City,Do Son District,12,1,0,1,0
2022-06-07,Hai Phong City,Do Son District,16,1,0,1,1
2022-06-07,Hai Phong City,Hai An District,7,6,2,4,3
2022-06-07,Hai Phong City,Hai An District,8,26,11,15,12
2022-06-07,Hai Phong City,Hai An District,9,17,14,3,2
2022-06-07,Hai Phong City,Hai An District,10,34,28,6,4
2022-06-07,Hai Phong City,Hai An District,11,41,33,8,4
2022-06-07,Hai Phong City,Hai An District,12,31,27,4,1
2022-06-07,Hai Phong City,Hai An District,13,9,8,1,1
2022-06-07,Hai Phong City,Hai An District,14,29,21,8,3
2022-06-07,Hai Phong City,Hai An District,15,28,24,4,1
2022-06-07,Hai Phong City,Hai An District,16,20,14,6,0
2022-06-07,Hai Phong City,Hai An District,17,21,18,3,0
2022-06-07,Hai Phong City,Hai An District,18,26,22,4,1
2022-06-07,Hai Phong City,Hai An District,19,18,14,4,2
2022-06-07,Hai Phong City,Hai An District,20,24,18,6,5
2022-06-07,Hai Phong City,Hai An District,21,14,9,5,4
2022-06-07,Hai Phong City,Hong Bang District,6,1,0,1,0
2022-06-07,Hai Phong City,Hong Bang District,7,15,4,11,6
2022-06-07,Hai Phong City,Hong Bang District,8,47,31,16,12
2022-06-07,Hai Phong City,Hong Bang District,9,49,37,12,7
2022-06-07,Hai Phong City,Hong Bang District,10,56,49,7,2
2022-06-07,Hai Phong City,Hong Bang District,11,101,80,21,11
2022-06-07,Hai Phong City,Hong Bang District,12,63,58,5,3
2022-06-07,Hai Phong City,Hong Bang District,13,43,32,11,3
2022-06-07,Hai Phong City,Hong Bang District,14,50,39,11,8
2022-06-07,Hai Phong City,Hong Bang District,15,38,31,7,3
2022-06-07,Hai Phong City,Hong Bang District,16,45,38,7,3
2022-06-07,Hai Phong City,Hong Bang District,17,35,28,7,2
2022-06-07,Hai Phong City,Hong Bang District,18,55,46,9,5
2022-06-07,Hai Phong City,Hong Bang District,19,49,32,17,13
2022-06-07,Hai Phong City,Hong Bang District,20,34,27,7,6
2022-06-07,Hai Phong City,Hong Bang District,21,16,8,8,5
2022-06-07,Hai Phong City,Kien An District,7,5,1,4,4
2022-06-07,Hai Phong City,Kien An District,8,3,1,2,1
2022-06-07,Hai Phong City,Kien An District,9,6,5,1,0
2022-06-07,Hai Phong City,Kien An District,10,12,8,4,0
2022-06-07,Hai Phong City,Kien An District,11,7,5,2,1
2022-06-07,Hai Phong City,Kien An District,12,13,12,1,1
2022-06-07,Hai Phong City,Kien An District,13,13,11,2,0
2022-06-07,Hai Phong City,Kien An District,14,5,2,3,3
2022-06-07,Hai Phong City,Kien An District,15,10,6,4,2
2022-06-07,Hai Phong City,Kien An District,16,10,6,4,4
2022-06-07,Hai Phong City,Kien An District,17,11,10,1,0
2022-06-07,Hai Phong City,Kien An District,18,15,10,5,2
2022-06-07,Hai Phong City,Kien An District,19,15,6,9,9
2022-06-07,Hai Phong City,Kien An District,20,22,4,18,15
2022-06-07,Hai Phong City,Kien An District,21,3,1,2,1
2022-06-07,Hai Phong City,Le Chan District,0,2,0,2,1
2022-06-07,Hai Phong City,Le Chan District,6,3,2,1,0
2022-06-07,Hai Phong City,Le Chan District,7,51,31,20,14
2022-06-07,Hai Phong City,Le Chan District,8,89,56,33,24
2022-06-07,Hai Phong City,Le Chan District,9,105,85,20,5
2022-06-07,Hai Phong City,Le Chan District,10,172,153,19,9
2022-06-07,Hai Phong City,Le Chan District,11,331,269,62,30
2022-06-07,Hai Phong City,Le Chan District,12,199,176,23,5
2022-06-07,Hai Phong City,Le Chan District,13,150,128,22,6
2022-06-07,Hai Phong City,Le Chan District,14,135,115,20,9
2022-06-07,Hai Phong City,Le Chan District,15,170,144,26,14
2022-06-07,Hai Phong City,Le Chan District,16,165,140,25,6
2022-06-07,Hai Phong City,Le Chan District,17,141,128,13,3
2022-06-07,Hai Phong City,Le Chan District,18,217,193,24,8
2022-06-07,Hai Phong City,Le Chan District,19,220,177,43,19
2022-06-07,Hai Phong City,Le Chan District,20,152,117,35,14
2022-06-07,Hai Phong City,Le Chan District,21,74,52,22,10
2022-06-07,Hai Phong City,Ngo Quyen District,0,2,0,2,2
2022-06-07,Hai Phong City,Ngo Quyen District,1,2,0,2,0
2022-06-07,Hai Phong City,Ngo Quyen District,3,1,0,1,0
2022-06-07,Hai Phong City,Ngo Quyen District,7,29,13,16,15
2022-06-07,Hai Phong City,Ngo Quyen District,8,85,45,40,33
2022-06-07,Hai Phong City,Ngo Quyen District,9,78,63,15,6
2022-06-07,Hai Phong City,Ngo Quyen District,10,120,100,20,9
2022-06-07,Hai Phong City,Ngo Quyen District,11,247,198,49,35
2022-06-07,Hai Phong City,Ngo Quyen District,12,156,139,17,5
2022-06-07,Hai Phong City,Ngo Quyen District,13,113,99,14,3
2022-06-07,Hai Phong City,Ngo Quyen District,14,168,137,31,9
2022-06-07,Hai Phong City,Ngo Quyen District,15,155,138,17,8
2022-06-07,Hai Phong City,Ngo Quyen District,16,127,109,18,6
2022-06-07,Hai Phong City,Ngo Quyen District,17,133,118,15,3
2022-06-07,Hai Phong City,Ngo Quyen District,18,150,124,26,7
2022-06-07,Hai Phong City,Ngo Quyen District,19,173,151,22,10
2022-06-07,Hai Phong City,Ngo Quyen District,20,111,100,11,6
2022-06-07,Hai Phong City,Ngo Quyen District,21,63,51,12,8
2022-06-07,Hai Phong City,Thuy Nguyen,3,1,0,1,0
2022-06-07,Hai Phong City,Thuy Nguyen,6,1,0,1,1
2022-06-07,Hai Phong City,Thuy Nguyen,8,1,0,1,1
2022-06-07,Hai Phong City,Thuy Nguyen,9,2,0,2,2
2022-06-07,Hai Phong City,Thuy Nguyen,10,3,1,2,2
2022-06-07,Hai Phong City,Thuy Nguyen,11,1,0,1,1
2022-06-07,Hai Phong City,Thuy Nguyen,13,3,0,3,3
2022-06-07,Hai Phong City,Thuy Nguyen,14,1,0,1,1
2022-06-07,Hai Phong City,Thuy Nguyen,17,1,0,1,1
2022-06-07,Hai Phong City,Thuy Nguyen,18,1,0,1,1
2022-06-07,Hue City,Hue City,0,3,3,0,0
2022-06-07,Hue City,Hue City,1,2,1,1,0
2022-06-07,Hue City,Hue City,5,6,5,1,0
2022-06-07,Hue City,Hue City,6,101,83,18,2
2022-06-07,Hue City,Hue City,7,188,176,12,0
2022-06-07,Hue City,Hue City,8,339,316,23,1
2022-06-07,Hue City,Hue City,9,292,273,19,1
2022-06-07,Hue City,Hue City,10,409,387,22,0
2022-06-07,Hue City,Hue City,11,968,896,72,12
2022-06-07,Hue City,Hue City,12,667,624,43,1
2022-06-07,Hue City,Hue City,13,422,394,28,0
2022-06-07,Hue City,Hue City,14,397,360,37,1
2022-06-07,Hue City,Hue City,15,485,453,32,2
2022-06-07,Hue City,Hue City,16,388,353,35,6
2022-06-07,Hue City,Hue City,17,471,436,35,2
2022-06-07,Hue City,Hue City,18,564,535,29,2
2022-06-07,Hue City,Hue City,19,680,610,70,8
2022-06-07,Hue City,Hue City,20,470,413,57,8
2022-06-07,Hue City,Hue City,21,279,226,53,12
2022-06-07,Hue City,Hue City,22,2,0,2,0
2022-06-07,Hue City,Hue City,23,1,0,1,0
2022-06-07,Hue City,Huong Thuy,6,1,0,1,0
2022-06-07,Hue City,Huong Thuy,8,1,1,0,0
2022-06-07,Hue City,Huong Thuy,9,1,1,0,0
2022-06-07,Hue City,Huong Thuy,11,1,1,0,0
2022-06-07,Hue City,Huong Thuy,13,1,0,1,1
2022-06-07,Hue City,Huong Thuy,15,1,1,0,0
2022-06-07,Hue City,Huong Thuy,16,1,1,0,0
2022-06-07,Hue City,Huong Thuy,17,2,2,0,0
2022-06-07,Hue City,Huong Thuy,18,2,2,0,0
2022-06-07,Hue City,Huong Thuy,19,4,1,3,0
2022-06-07,Hue City,Huong Thuy,20,4,1,3,2
2022-06-07,Hue City,Huong Thuy,21,1,0,1,1
2022-06-07,Hue City,Huong Tra,11,1,1,0,0
2022-06-07,Hue City,Huong Tra,12,3,3,0,0
2022-06-07,Hue City,Huong Tra,16,2,1,1,1
2022-06-07,Hue City,Huong Tra,18,2,2,0,0
2022-06-07,Hue City,Huong Tra,20,1,0,1,0
2022-06-07,Hue City,Phu Vang,6,1,0,1,1
2022-06-07,Hue City,Phu Vang,8,1,1,0,0
2022-06-07,Hue City,Phu Vang,10,2,2,0,0
2022-06-07,Hue City,Phu Vang,11,5,4,1,1
2022-06-07,Hue City,Phu Vang,13,2,2,0,0
2022-06-07,Hue City,Phu Vang,15,3,3,0,0
2022-06-07,Hue City,Phu Vang,16,2,1,1,1
2022-06-07,Hue City,Phu Vang,17,4,3,1,1
2022-06-07,Hue City,Phu Vang,18,3,2,1,1
2022-06-07,Hue City,Phu Vang,19,2,1,1,1
2022-06-07,Hue City,Phu Vang,21,3,0,3,2
2022-06-07,Khanh Hoa,Cam Ranh City,14,1,0,1,1
2022-06-07,Khanh Hoa,Dien Khanh,9,1,0,1,1
2022-06-07,Khanh Hoa,Dien Khanh,11,1,0,1,1
2022-06-07,Khanh Hoa,Dien Khanh,19,2,0,2,1
2022-06-07,Khanh Hoa,Nha Trang City,0,4,1,3,1
2022-06-07,Khanh Hoa,Nha Trang City,1,1,1,0,0
2022-06-07,Khanh Hoa,Nha Trang City,4,1,1,0,0
2022-06-07,Khanh Hoa,Nha Trang City,5,3,2,1,1
2022-06-07,Khanh Hoa,Nha Trang City,6,52,45,7,5
2022-06-07,Khanh Hoa,Nha Trang City,7,130,124,6,2
2022-06-07,Khanh Hoa,Nha Trang City,8,230,204,26,2
2022-06-07,Khanh Hoa,Nha Trang City,9,188,179,9,0
2022-06-07,Khanh Hoa,Nha Trang City,10,213,198,15,0
2022-06-07,Khanh Hoa,Nha Trang City,11,388,365,23,0
2022-06-07,Khanh Hoa,Nha Trang City,12,285,270,15,0
2022-06-07,Khanh Hoa,Nha Trang City,13,305,275,30,4
2022-06-07,Khanh Hoa,Nha Trang City,14,274,255,19,0
2022-06-07,Khanh Hoa,Nha Trang City,15,199,188,11,0
2022-06-07,Khanh Hoa,Nha Trang City,16,231,214,17,0
2022-06-07,Khanh Hoa,Nha Trang City,17,261,247,14,1
2022-06-07,Khanh Hoa,Nha Trang City,18,313,293,20,2
2022-06-07,Khanh Hoa,Nha Trang City,19,236,215,21,2
2022-06-07,Khanh Hoa,Nha Trang City,20,177,153,24,3
2022-06-07,Khanh Hoa,Nha Trang City,21,96,64,32,13
2022-06-07,Khanh Hoa,Nha Trang City,22,2,0,2,0
2022-06-07,Lam Dong,Da Lat City,0,1,0,1,0
2022-06-07,Lam Dong,Da Lat City,6,4,2,2,2
2022-06-07,Lam Dong,Da Lat City,7,59,33,26,24
2022-06-07,Lam Dong,Da Lat City,8,111,60,51,40
2022-06-07,Lam Dong,Da Lat City,9,97,79,18,4
2022-06-07,Lam Dong,Da Lat City,10,106,83,23,4
2022-06-07,Lam Dong,Da Lat City,11,150,126,24,5
2022-06-07,Lam Dong,Da Lat City,12,171,142,29,11
2022-06-07,Lam Dong,Da Lat City,13,136,108,28,11
2022-06-07,Lam Dong,Da Lat City,14,103,78,25,11
2022-06-07,Lam Dong,Da Lat City,15,127,79,48,41
2022-06-07,Lam Dong,Da Lat City,16,127,82,45,30
2022-06-07,Lam Dong,Da Lat City,17,142,102,40,22
2022-06-07,Lam Dong,Da Lat City,18,151,112,39,21
2022-06-07,Lam Dong,Da Lat City,19,140,99,41,24
2022-06-07,Lam Dong,Da Lat City,20,109,74,35,20
2022-06-07,Lam Dong,Da Lat City,21,87,47,40,27
2022-06-07,Lam Dong,Da Lat City,22,2,0,2,2
2022-06-07,Lam Dong,Da Lat City,23,1,0,1,0
2022-06-07,Nghe An,Vinh City,5,1,1,0,0
2022-06-07,Nghe An,Vinh City,6,3,2,1,0
2022-06-07,Nghe An,Vinh City,7,142,126,16,2
2022-06-07,Nghe An,Vinh City,8,177,162,15,2
2022-06-07,Nghe An,Vinh City,9,157,136,21,2
2022-06-07,Nghe An,Vinh City,10,228,203,25,1
2022-06-07,Nghe An,Vinh City,11,415,359,56,16
2022-06-07,Nghe An,Vinh City,12,227,202,25,1
2022-06-07,Nghe An,Vinh City,13,135,120,15,3
2022-06-07,Nghe An,Vinh City,14,168,142,26,3
2022-06-07,Nghe An,Vinh City,15,175,151,24,2
2022-06-07,Nghe An,Vinh City,16,129,122,7,0
2022-06-07,Nghe An,Vinh City,17,161,143,18,0
2022-06-07,Nghe An,Vinh City,18,230,194,36,6
2022-06-07,Nghe An,Vinh City,19,204,154,50,21
2022-06-07,Nghe An,Vinh City,20,149,120,29,9
2022-06-07,Nghe An,Vinh City,21,72,51,21,8
2022-06-07,Nghe An,Vinh City,22,2,0,2,0
2022-06-07,Quang Nam,Hoi An City,6,1,1,0,0
2022-06-07,Quang Nam,Hoi An City,7,14,9,5,3
2022-06-07,Quang Nam,Hoi An City,8,21,16,5,0
2022-06-07,Quang Nam,Hoi An City,9,24,19,5,0
2022-06-07,Quang Nam,Hoi An City,10,29,27,2,1
2022-06-07,Quang Nam,Hoi An City,11,37,32,5,2
2022-06-07,Quang Nam,Hoi An City,12,51,37,14,9
2022-06-07,Quang Nam,Hoi An City,13,23,16,7,5
2022-06-07,Quang Nam,Hoi An City,14,44,28,16,12
2022-06-07,Quang Nam,Hoi An City,15,51,38,13,10
2022-06-07,Quang Nam,Hoi An City,16,28,24,4,1
2022-06-07,Quang Nam,Hoi An City,17,41,36,5,3
2022-06-07,Quang Nam,Hoi An City,18,46,23,23,19
2022-06-07,Quang Nam,Hoi An City,19,119,31,88,69
2022-06-07,Quang Nam,Hoi An City,20,98,28,70,59
2022-06-07,Quang Nam,Hoi An City,21,37,12,25,19
2022-06-07,Quang Nam,Hoi An City,22,1,0,1,0
2022-06-07,Quang Nam,Tam Ky City,12,1,0,1,1
2022-06-07,Quang Nam,Tam Ky City,16,2,0,2,2
2022-06-07,Quang Ninh,Cam Pha City,7,1,0,1,1
2022-06-07,Quang Ninh,Cam Pha City,8,1,0,1,1
2022-06-07,Quang Ninh,Cam Pha City,11,2,0,2,2
2022-06-07,Quang Ninh,Cam Pha City,12,2,0,2,2
2022-06-07,Quang Ninh,Cam Pha City,15,1,0,1,1
2022-06-07,Quang Ninh,Cam Pha City,16,2,0,2,2
2022-06-07,Quang Ninh,Ha Long City,7,25,15,10,7
2022-06-07,Quang Ninh,Ha Long City,8,80,39,41,32
2022-06-07,Quang Ninh,Ha Long City,9,56,31,25,15
2022-06-07,Quang Ninh,Ha Long City,10,83,63,20,5
2022-06-07,Quang Ninh,Ha Long City,11,143,113,30,12
2022-06-07,Quang Ninh,Ha Long City,12,100,75,25,3
2022-06-07,Quang Ninh,Ha Long City,13,64,46,18,8
2022-06-07,Quang Ninh,Ha Long City,14,64,49,15,9
2022-06-07,Quang Ninh,Ha Long City,15,64,40,24,18
2022-06-07,Quang Ninh,Ha Long City,16,57,37,20,5
2022-06-07,Quang Ninh,Ha Long City,17,55,42,13,6
2022-06-07,Quang Ninh,Ha Long City,18,64,48,16,5
2022-06-07,Quang Ninh,Ha Long City,19,64,42,22,9
2022-06-07,Quang Ninh,Ha Long City,20,66,44,22,14
2022-06-07,Quang Ninh,Ha Long City,23,1,0,1,0
2022-06-07,Quang Ninh,Uong Bi City,14,1,0,1,1
2022-06-07,Thai Nguyen,Dong Hy,7,1,0,1,1
2022-06-07,Thai Nguyen,Thai Nguyen City,0,6,4,2,0
2022-06-07,Thai Nguyen,Thai Nguyen City,2,1,1,0,0
2022-06-07,Thai Nguyen,Thai Nguyen City,3,1,1,0,0
2022-06-07,Thai Nguyen,Thai Nguyen City,6,5,4,1,0
2022-06-07,Thai Nguyen,Thai Nguyen City,7,75,73,2,0
2022-06-07,Thai Nguyen,Thai Nguyen City,8,143,127,16,1
2022-06-07,Thai Nguyen,Thai Nguyen City,9,114,104,10,1
2022-06-07,Thai Nguyen,Thai Nguyen City,10,184,161,23,1
2022-06-07,Thai Nguyen,Thai Nguyen City,11,354,328,26,1
2022-06-07,Thai Nguyen,Thai Nguyen City,12,239,222,17,0
2022-06-07,Thai Nguyen,Thai Nguyen City,13,140,131,9,0
2022-06-07,Thai Nguyen,Thai Nguyen City,14,164,150,14,1
2022-06-07,Thai Nguyen,Thai Nguyen City,15,162,154,8,1
2022-06-07,Thai Nguyen,Thai Nguyen City,16,116,105,11,0
2022-06-07,Thai Nguyen,Thai Nguyen City,17,136,126,10,0
2022-06-07,Thai Nguyen,Thai Nguyen City,18,213,205,8,0
2022-06-07,Thai Nguyen,Thai Nguyen City,19,256,235,21,0
2022-06-07,Thai Nguyen,Thai Nguyen City,20,188,176,12,0
2022-06-07,Thai Nguyen,Thai Nguyen City,21,120,111,9,0
2022-06-07,Vung Tau,Ba Ria City,8,12,2,10,10
2022-06-07,Vung Tau,Ba Ria City,9,12,1,11,9
2022-06-07,Vung Tau,Ba Ria City,10,9,1,8,7
2022-06-07,Vung Tau,Ba Ria City,11,6,2,4,3
2022-06-07,Vung Tau,Ba Ria City,12,11,4,7,7
2022-06-07,Vung Tau,Ba Ria City,13,13,3,10,10
2022-06-07,Vung Tau,Ba Ria City,14,3,2,1,1
2022-06-07,Vung Tau,Ba Ria City,15,7,1,6,6
2022-06-07,Vung Tau,Ba Ria City,16,8,0,8,8
2022-06-07,Vung Tau,Ba Ria City,17,9,1,8,7
2022-06-07,Vung Tau,Ba Ria City,18,9,0,9,7
2022-06-07,Vung Tau,Ba Ria City,19,9,2,7,6
2022-06-07,Vung Tau,Ba Ria City,20,6,0,6,6
2022-06-07,Vung Tau,Ba Ria City,21,4,0,4,3
2022-06-07,Vung Tau,Chau Duc,14,1,0,1,1
2022-06-07,Vung Tau,Chau Duc,15,1,0,1,1
2022-06-07,Vung Tau,Long Dien,11,1,0,1,1
2022-06-07,Vung Tau,Tan Thanh,11,1,0,1,1
2022-06-07,Vung Tau,Tan Thanh,12,1,0,1,1
2022-06-07,Vung Tau,Tan Thanh,13,1,0,1,1
2022-06-07,Vung Tau,Vung Tau City,2,2,1,1,1
2022-06-07,Vung Tau,Vung Tau City,3,3,2,1,0
2022-06-07,Vung Tau,Vung Tau City,5,4,0,4,2
2022-06-07,Vung Tau,Vung Tau City,6,45,28,17,13
2022-06-07,Vung Tau,Vung Tau City,7,104,93,11,3
2022-06-07,Vung Tau,Vung Tau City,8,155,140,15,2
2022-06-07,Vung Tau,Vung Tau City,9,194,173,21,1
2022-06-07,Vung Tau,Vung Tau City,10,213,195,18,5
2022-06-07,Vung Tau,Vung Tau City,11,419,380,39,8
2022-06-07,Vung Tau,Vung Tau City,12,262,253,9,4
2022-06-07,Vung Tau,Vung Tau City,13,232,223,9,0
2022-06-07,Vung Tau,Vung Tau City,14,266,250,16,6
2022-06-07,Vung Tau,Vung Tau City,15,219,204,15,4
2022-06-07,Vung Tau,Vung Tau City,16,192,176,16,2
2022-06-07,Vung Tau,Vung Tau City,17,299,279,20,3
2022-06-07,Vung Tau,Vung Tau City,18,290,268,22,4
2022-06-07,Vung Tau,Vung Tau City,19,282,133,149,122
2022-06-07,Vung Tau,Vung Tau City,20,441,56,385,331
2022-06-07,Vung Tau,Vung Tau City,21,294,28,266,229
2022-06-08,Bac Ninh,Bác Ninh City,0,1,1,0,0
2022-06-08,Bac Ninh,Bác Ninh City,1,1,0,1,0
2022-06-08,Bac Ninh,Bác Ninh City,5,1,0,1,1
2022-06-08,Bac Ninh,Bác Ninh City,6,3,2,1,1
2022-06-08,Bac Ninh,Bác Ninh City,7,66,57,9,2
2022-06-08,Bac Ninh,Bác Ninh City,8,134,122,12,3
2022-06-08,Bac Ninh,Bác Ninh City,9,113,101,12,4
2022-06-08,Bac Ninh,Bác Ninh City,10,212,187,25,0
2022-06-08,Bac Ninh,Bác Ninh City,11,329,288,41,11
2022-06-08,Bac Ninh,Bác Ninh City,12,204,190,14,3
2022-06-08,Bac Ninh,Bác Ninh City,13,149,134,15,2
2022-06-08,Bac Ninh,Bác Ninh City,14,132,121,11,0
2022-06-08,Bac Ninh,Bác Ninh City,15,121,108,13,2
2022-06-08,Bac Ninh,Bác Ninh City,16,137,116,21,6
2022-06-08,Bac Ninh,Bác Ninh City,17,143,128,15,1
2022-06-08,Bac Ninh,Bác Ninh City,18,211,187,24,8
2022-06-08,Bac Ninh,Bác Ninh City,19,171,152,19,6
2022-06-08,Bac Ninh,Bác Ninh City,20,147,122,25,7
2022-06-08,Bac Ninh,Bác Ninh City,21,98,51,47,34
2022-06-08,Bac Ninh,Bác Ninh City,22,3,1,2,0
2022-06-08,Bac Ninh,Que Vo,7,1,0,1,1
2022-06-08,Bac Ninh,Que Vo,8,1,1,0,0
2022-06-08,Bac Ninh,Que Vo,9,1,1,0,0
2022-06-08,Bac Ninh,Que Vo,10,1,0,1,1
2022-06-08,Bac Ninh,Que Vo,11,1,1,0,0
2022-06-08,Bac Ninh,Que Vo,12,1,1,0,0
2022-06-08,Bac Ninh,Que Vo,19,3,0,3,3
2022-06-08,Bac Ninh,Tien Du,10,1,0,1,1
2022-06-08,Bac Ninh,Tien Du,11,2,0,2,2
2022-06-08,Bac Ninh,Tien Du,13,1,0,1,1
2022-06-08,Bac Ninh,Tien Du,16,1,0,1,1
2022-06-08,Bac Ninh,Tien Du,18,2,0,2,2
2022-06-08,Bac Ninh,Tien Du,20,1,0,1,1
2022-06-08,Bac Ninh,Tu Son,11,2,0,2,1
2022-06-08,Bac Ninh,Tu Son,12,3,0,3,2
2022-06-08,Bac Ninh,Tu Son,14,1,0,1,0
2022-06-08,Bac Ninh,Tu Son,15,1,0,1,1
2022-06-08,Bac Ninh,Tu Son,16,2,0,2,2
2022-06-08,Bac Ninh,Tu Son,17,2,0,2,2
2022-06-08,Bac Ninh,Tu Son,18,2,0,2,2
2022-06-08,Bac Ninh,Tu Son,20,5,0,5,5
2022-06-08,Bac Ninh,Tu Son,21,1,0,1,1
2022-06-08,Binh Duong,Ben Cat,8,1,0,1,1
2022-06-08,Binh Duong,Ben Cat,12,2,0,2,2
2022-06-08,Binh Duong,Ben Cat,13,5,1,4,2
2022-06-08,Binh Duong,Ben Cat,14,3,0,3,2
2022-06-08,Binh Duong,Ben Cat,15,1,0,1,0
2022-06-08,Binh Duong,Ben Cat,16,1,0,1,1
2022-06-08,Binh Duong,Ben Cat,19,1,0,1,0
2022-06-08,Binh Duong,Di An,5,1,0,1,1
2022-06-08,Binh Duong,Di An,6,1,1,0,0
2022-06-08,Binh Duong,Di An,7,3,1,2,2
2022-06-08,Binh Duong,Di An,8,18,8,10,7
2022-06-08,Binh Duong,Di An,9,28,17,11,7
2022-06-08,Binh Duong,Di An,10,37,18,19,16
2022-06-08,Binh Duong,Di An,11,59,25,34,28
2022-06-08,Binh Duong,Di An,12,58,35,23,18
2022-06-08,Binh Duong,Di An,13,56,34,22,14
2022-06-08,Binh Duong,Di An,14,24,13,11,6
2022-06-08,Binh Duong,Di An,15,23,15,8,6
2022-06-08,Binh Duong,Di An,16,40,18,22,18
2022-06-08,Binh Duong,Di An,17,40,24,16,13
2022-06-08,Binh Duong,Di An,18,35,27,8,4
2022-06-08,Binh Duong,Di An,19,26,23,3,1
2022-06-08,Binh Duong,Di An,20,23,12,11,10
2022-06-08,Binh Duong,Di An,21,13,7,6,1
2022-06-08,Binh Duong,Tan Uyen,8,2,0,2,2
2022-06-08,Binh Duong,Tan Uyen,9,1,1,0,0
2022-06-08,Binh Duong,Tan Uyen,10,3,1,2,2
2022-06-08,Binh Duong,Tan Uyen,11,1,1,0,0
2022-06-08,Binh Duong,Tan Uyen,12,5,2,3,3
2022-06-08,Binh Duong,Tan Uyen,13,11,4,7,7
2022-06-08,Binh Duong,Tan Uyen,14,6,3,3,2
2022-06-08,Binh Duong,Tan Uyen,15,1,1,0,0
2022-06-08,Binh Duong,Tan Uyen,16,2,1,1,1
2022-06-08,Binh Duong,Tan Uyen,17,6,2,4,4
2022-06-08,Binh Duong,Tan Uyen,18,5,1,4,4
2022-06-08,Binh Duong,Tan Uyen,19,2,1,1,0
2022-06-08,Binh Duong,Tan Uyen,20,1,0,1,1
2022-06-08,Binh Duong,Tan Uyen,21,2,0,2,2
2022-06-08,Binh Duong,Thu Dau Mot Town,0,1,0,1,0
2022-06-08,Binh Duong,Thu Dau Mot Town,1,1,1,0,0
2022-06-08,Binh Duong,Thu Dau Mot Town,3,1,0,1,0
2022-06-08,Binh Duong,Thu Dau Mot Town,4,1,1,0,0
2022-06-08,Binh Duong,Thu Dau Mot Town,5,1,0,1,0
2022-06-08,Binh Duong,Thu Dau Mot Town,6,27,25,2,2
2022-06-08,Binh Duong,Thu Dau Mot Town,7,129,123,6,0
2022-06-08,Binh Duong,Thu Dau Mot Town,8,224,204,20,2
2022-06-08,Binh Duong,Thu Dau Mot Town,9,268,257,11,2
2022-06-08,Binh Duong,Thu Dau Mot Town,10,436,410,26,3
2022-06-08,Binh Duong,Thu Dau Mot Town,11,710,668,42,5
2022-06-08,Binh Duong,Thu Dau Mot Town,12,521,497,24,2
2022-06-08,Binh Duong,Thu Dau Mot Town,13,519,486,33,2
2022-06-08,Binh Duong,Thu Dau Mot Town,14,392,371,21,0
2022-06-08,Binh Duong,Thu Dau Mot Town,15,279,260,19,5
2022-06-08,Binh Duong,Thu Dau Mot Town,16,281,266,15,5
2022-06-08,Binh Duong,Thu Dau Mot Town,17,335,319,16,3
2022-06-08,Binh Duong,Thu Dau Mot Town,18,465,430,35,6
2022-06-08,Binh Duong,Thu Dau Mot Town,19,396,354,42,6
2022-06-08,Binh Duong,Thu Dau Mot Town,20,307,280,27,4
2022-06-08,Binh Duong,Thu Dau Mot Town,21,127,110,17,4
2022-06-08,Binh Duong,Thu Dau Mot Town,22,2,0,2,0
2022-06-08,Binh Duong,Thuan An,6,6,0,6,5
2022-06-08,Binh Duong,Thuan An,7,13,8,5,3
2022-06-08,Binh Duong,Thuan An,8,22,14,8,6
2022-06-08,Binh Duong,Thuan An,9,41,28,13,8
2022-06-08,Binh Duong,Thuan An,10,86,58,28,16
2022-06-08,Binh Duong,Thuan An,11,98,59,39,25
2022-06-08,Binh Duong,Thuan An,12,88,60,28,19
2022-06-08,Binh Duong,Thuan An,13,112,73,39,25
2022-06-08,Binh Duong,Thuan An,14,83,60,23,17
2022-06-08,Binh Duong,Thuan An,15,53,41,12,10
2022-06-08,Binh Duong,Thuan An,16,32,29,3,0
2022-06-08,Binh Duong,Thuan An,17,51,43,8,0
2022-06-08,Binh Duong,Thuan An,18,54,40,14,7
2022-06-08,Binh Duong,Thuan An,19,70,47,23,9
2022-06-08,Binh Duong,Thuan An,20,37,26,11,8
2022-06-08,Binh Duong,Thuan An,21,32,13,19,11
2022-06-08,Binh Duong,Thuan An,22,1,0,1,0
2022-06-08,Can Tho City,Binh Thuy District,7,3,1,2,0
2022-06-08,Can Tho City,Binh Thuy District,8,9,8,1,0
2022-06-08,Can Tho City,Binh Thuy District,9,4,3,1,0
2022-06-08,Can Tho City,Binh Thuy District,10,13,11,2,1
2022-06-08,Can Tho City,Binh Thuy District,11,13,11,2,0
2022-06-08,Can Tho City,Binh Thuy District,12,16,14,2,0
2022-06-08,Can Tho City,Binh Thuy District,13,13,11,2,2
2022-06-08,Can Tho City,Binh Thuy District,14,11,10,1,0
2022-06-08,Can Tho City,Binh Thuy District,15,13,13,0,0
2022-06-08,Can Tho City,Binh Thuy District,16,9,9,0,0
2022-06-08,Can Tho City,Binh Thuy District,17,10,10,0,0
2022-06-08,Can Tho City,Binh Thuy District,18,13,13,0,0
2022-06-08,Can Tho City,Binh Thuy District,19,9,8,1,0
2022-06-08,Can Tho City,Binh Thuy District,20,7,5,2,0
2022-06-08,Can Tho City,Binh Thuy District,21,3,2,1,0
2022-06-08,Can Tho City,Cai Rang District,6,3,2,1,0
2022-06-08,Can Tho City,Cai Rang District,7,6,2,4,3
2022-06-08,Can Tho City,Cai Rang District,8,6,4,2,2
2022-06-08,Can Tho City,Cai Rang District,9,9,8,1,1
2022-06-08,Can Tho City,Cai Rang District,10,11,11,0,0
2022-06-08,Can Tho City,Cai Rang District,11,16,14,2,0
2022-06-08,Can Tho City,Cai Rang District,12,17,17,0,0
2022-06-08,Can Tho City,Cai Rang District,13,16,15,1,0
2022-06-08,Can Tho City,Cai Rang District,14,8,7,1,0
2022-06-08,Can Tho City,Cai Rang District,15,8,7,1,0
2022-06-08,Can Tho City,Cai Rang District,16,10,9,1,0
2022-06-08,Can Tho City,Cai Rang District,17,10,9,1,0
2022-06-08,Can Tho City,Cai Rang District,18,9,9,0,0
2022-06-08,Can Tho City,Cai Rang District,19,14,10,4,1
2022-06-08,Can Tho City,Cai Rang District,20,2,2,0,0
2022-06-08,Can Tho City,Cai Rang District,21,3,2,1,1
2022-06-08,Can Tho City,Ninh Kieu District,0,1,1,0,0
2022-06-08,Can Tho City,Ninh Kieu District,1,1,1,0,0
2022-06-08,Can Tho City,Ninh Kieu District,2,2,1,1,0
2022-06-08,Can Tho City,Ninh Kieu District,3,1,1,0,0
2022-06-08,Can Tho City,Ninh Kieu District,4,1,1,0,0
2022-06-08,Can Tho City,Ninh Kieu District,5,4,3,1,0
2022-06-08,Can Tho City,Ninh Kieu District,6,51,45,6,3
2022-06-08,Can Tho City,Ninh Kieu District,7,127,113,14,0
2022-06-08,Can Tho City,Ninh Kieu District,8,245,234,11,0
2022-06-08,Can Tho City,Ninh Kieu District,9,310,292,18,0
2022-06-08,Can Tho City,Ninh Kieu District,10,604,584,20,0
2022-06-08,Can Tho City,Ninh Kieu District,11,889,843,46,6
2022-06-08,Can Tho City,Ninh Kieu District,12,609,587,22,0
2022-06-08,Can Tho City,Ninh Kieu District,13,491,471,20,0
2022-06-08,Can Tho City,Ninh Kieu District,14,457,440,17,0
2022-06-08,Can Tho City,Ninh Kieu District,15,401,385,16,0
2022-06-08,Can Tho City,Ninh Kieu District,16,421,393,28,0
2022-06-08,Can Tho City,Ninh Kieu District,17,549,527,22,0
2022-06-08,Can Tho City,Ninh Kieu District,18,591,567,24,0
2022-06-08,Can Tho City,Ninh Kieu District,19,486,453,33,0
2022-06-08,Can Tho City,Ninh Kieu District,20,409,386,23,0
2022-06-08,Can Tho City,Ninh Kieu District,21,201,179,22,0
2022-06-08,Can Tho City,Ninh Kieu District,22,1,0,1,0
2022-06-08,Dong Nai,Bien Hoa City,1,2,0,2,0
2022-06-08,Dong Nai,Bien Hoa City,2,2,2,0,0
2022-06-08,Dong Nai,Bien Hoa City,4,1,1,0,0
2022-06-08,Dong Nai,Bien Hoa City,6,49,33,16,13
2022-06-08,Dong Nai,Bien Hoa City,7,209,165,44,25
2022-06-08,Dong Nai,Bien Hoa City,8,326,284,42,11
2022-06-08,Dong Nai,Bien Hoa City,9,422,379,43,11
2022-06-08,Dong Nai,Bien Hoa City,10,865,789,76,31
2022-06-08,Dong Nai,Bien Hoa City,11,1187,1073,114,42
2022-06-08,Dong Nai,Bien Hoa City,12,914,827,87,24
2022-06-08,Dong Nai,Bien Hoa City,13,956,851,105,55
2022-06-08,Dong Nai,Bien Hoa City,14,832,737,95,43
2022-06-08,Dong Nai,Bien Hoa City,15,605,533,72,32
2022-06-08,Dong Nai,Bien Hoa City,16,585,521,64,24
2022-06-08,Dong Nai,Bien Hoa City,17,619,552,67,27
2022-06-08,Dong Nai,Bien Hoa City,18,700,632,68,12
2022-06-08,Dong Nai,Bien Hoa City,19,673,584,89,30
2022-06-08,Dong Nai,Bien Hoa City,20,551,414,137,53
2022-06-08,Dong Nai,Bien Hoa City,21,224,168,56,26
2022-06-08,Dong Nai,Bien Hoa City,22,1,1,0,0
2022-06-08,Dong Nai,Long Khanh,8,1,0,1,1
2022-06-08,Dong Nai,Long Khanh,9,1,0,1,0
2022-06-08,Dong Nai,Long Khanh,11,3,0,3,3
2022-06-08,Dong Nai,Long Khanh,13,1,0,1,1
2022-06-08,Dong Nai,Long Khanh,17,2,0,2,2
2022-06-08,Dong Nai,Long Khanh,18,1,0,1,1
2022-06-08,Dong Nai,Long Thanh,11,2,0,2,2
2022-06-08,Dong Nai,Long Thanh,12,1,0,1,1
2022-06-08,Dong Nai,Long Thanh,13,1,0,1,1
2022-06-08,Dong Nai,Long Thanh,16,1,0,1,1
2022-06-08,Dong Nai,Long Thanh,20,2,0,2,2
2022-06-08,Dong Nai,Long Thanh,21,2,0,2,1
2022-06-08,Dong Nai,Trang Bom,11,1,0,1,1
2022-06-08,Dong Nai,Trang Bom,12,1,0,1,1
2022-06-08,Dong Nai,Trang Bom,13,3,1,2,2
2022-06-08,Dong Nai,Trang Bom,14,2,0,2,2
2022-06-08,Dong Nai,Trang Bom,15,1,1,0,0
2022-06-08,Dong Nai,Trang Bom,16,1,0,1,1
2022-06-08,Dong Nai,Trang Bom,17,1,0,1,1
2022-06-08,Hai Phong City,An Duong,7,1,1,0,0
2022-06-08,Hai Phong City,An Duong,8,2,0,2,2
2022-06-08,Hai Phong City,An Duong,9,2,1,1,1
2022-06-08,Hai Phong City,An Duong,10,6,1,5,4
2022-06-08,Hai Phong City,An Duong,11,5,2,3,1
2022-06-08,Hai Phong City,An Duong,13,3,0,3,3
2022-06-08,Hai Phong City,An Duong,14,4,1,3,2
2022-06-08,Hai Phong City,An Duong,15,3,3,0,0
2022-06-08,Hai Phong City,An Duong,16,6,5,1,0
2022-06-08,Hai Phong City,An Duong,17,2,0,2,0
2022-06-08,Hai Phong City,An Duong,18,2,1,1,1
2022-06-08,Hai Phong City,An Duong,19,1,0,1,0
2022-06-08,Hai Phong City,Do Son District,17,2,0,2,2
2022-06-08,Hai Phong City,Do Son District,21,1,0,1,1
2022-06-08,Hai Phong City,Duong Kinh District,9,1,0,1,1
2022-06-08,Hai Phong City,Duong Kinh District,11,1,0,1,1
2022-06-08,Hai Phong City,Duong Kinh District,18,1,0,1,1
2022-06-08,Hai Phong City,Hai An District,5,1,1,0,0
2022-06-08,Hai Phong City,Hai An District,7,7,4,3,3
2022-06-08,Hai Phong City,Hai An District,8,12,8,4,2
2022-06-08,Hai Phong City,Hai An District,9,13,10,3,1
2022-06-08,Hai Phong City,Hai An District,10,24,14,10,4
2022-06-08,Hai Phong City,Hai An District,11,58,31,27,16
2022-06-08,Hai Phong City,Hai An District,12,40,22,18,14
2022-06-08,Hai Phong City,Hai An District,13,31,25,6,2
2022-06-08,Hai Phong City,Hai An District,14,9,6,3,2
2022-06-08,Hai Phong City,Hai An District,15,28,15,13,6
2022-06-08,Hai Phong City,Hai An District,16,25,14,11,7
2022-06-08,Hai Phong City,Hai An District,17,33,23,10,4
2022-06-08,Hai Phong City,Hai An District,18,31,23,8,3
2022-06-08,Hai Phong City,Hai An District,19,32,22,10,7
2022-06-08,Hai Phong City,Hai An District,20,37,26,11,6
2022-06-08,Hai Phong City,Hai An District,21,18,12,6,2
2022-06-08,Hai Phong City,Hong Bang District,5,1,0,1,0
2022-06-08,Hai Phong City,Hong Bang District,6,1,0,1,1
2022-06-08,Hai Phong City,Hong Bang District,7,14,11,3,1
2022-06-08,Hai Phong City,Hong Bang District,8,34,29,5,3
2022-06-08,Hai Phong City,Hong Bang District,9,35,30,5,3
2022-06-08,Hai Phong City,Hong Bang District,10,62,47,15,5
2022-06-08,Hai Phong City,Hong Bang District,11,123,89,34,23
2022-06-08,Hai Phong City,Hong Bang District,12,70,49,21,13
2022-06-08,Hai Phong City,Hong Bang District,13,55,38,17,12
2022-06-08,Hai Phong City,Hong Bang District,14,44,35,9,7
2022-06-08,Hai Phong City,Hong Bang District,15,46,18,28,26
2022-06-08,Hai Phong City,Hong Bang District,16,56,39,17,13
2022-06-08,Hai Phong City,Hong Bang District,17,70,63,7,5
2022-06-08,Hai Phong City,Hong Bang District,18,62,50,12,6
2022-06-08,Hai Phong City,Hong Bang District,19,63,51,12,7
2022-06-08,Hai Phong City,Hong Bang District,20,39,25,14,9
2022-06-08,Hai Phong City,Hong Bang District,21,17,14,3,2
2022-06-08,Hai Phong City,Kien An District,7,1,1,0,0
2022-06-08,Hai Phong City,Kien An District,8,3,1,2,2
2022-06-08,Hai Phong City,Kien An District,9,5,3,2,1
2022-06-08,Hai Phong City,Kien An District,10,14,10,4,2
2022-06-08,Hai Phong City,Kien An District,11,9,4,5,2
2022-06-08,Hai Phong City,Kien An District,12,7,6,1,0
2022-06-08,Hai Phong City,Kien An District,13,14,5,9,5
2022-06-08,Hai Phong City,Kien An District,14,7,0,7,6
2022-06-08,Hai Phong City,Kien An District,15,12,5,7,3
2022-06-08,Hai Phong City,Kien An District,16,9,5,4,2
2022-06-08,Hai Phong City,Kien An District,17,19,6,13,10
2022-06-08,Hai Phong City,Kien An District,18,30,9,21,20
2022-06-08,Hai Phong City,Kien An District,19,21,9,12,8
2022-06-08,Hai Phong City,Kien An District,20,10,7,3,3
2022-06-08,Hai Phong City,Kien An District,21,1,0,1,1
2022-06-08,Hai Phong City,Le Chan District,6,5,2,3,1
2022-06-08,Hai Phong City,Le Chan District,7,29,24,5,2
2022-06-08,Hai Phong City,Le Chan District,8,95,60,35,21
2022-06-08,Hai Phong City,Le Chan District,9,99,86,13,4
2022-06-08,Hai Phong City,Le Chan District,10,201,165,36,16
2022-06-08,Hai Phong City,Le Chan District,11,311,246,65,43
2022-06-08,Hai Phong City,Le Chan District,12,213,169,44,29
2022-06-08,Hai Phong City,Le Chan District,13,130,101,29,16
2022-06-08,Hai Phong City,Le Chan District,14,147,109,38,22
2022-06-08,Hai Phong City,Le Chan District,15,226,128,98,81
2022-06-08,Hai Phong City,Le Chan District,16,214,145,69,42
2022-06-08,Hai Phong City,Le Chan District,17,216,171,45,23
2022-06-08,Hai Phong City,Le Chan District,18,267,213,54,31
2022-06-08,Hai Phong City,Le Chan District,19,224,174,50,29
2022-06-08,Hai Phong City,Le Chan District,20,166,129,37,19
2022-06-08,Hai Phong City,Le Chan District,21,81,45,36,27
2022-06-08,Hai Phong City,Ngo Quyen District,6,3,1,2,0
2022-06-08,Hai Phong City,Ngo Quyen District,7,23,16,7,6
2022-06-08,Hai Phong City,Ngo Quyen District,8,78,59,19,10
2022-06-08,Hai Phong City,Ngo Quyen District,9,74,65,9,1
2022-06-08,Hai Phong City,Ngo Quyen District,10,144,116,28,14
2022-06-08,Hai Phong City,Ngo Quyen District,11,309,219,90,63
2022-06-08,Hai Phong City,Ngo Quyen District,12,195,152,43,26
2022-06-08,Hai Phong City,Ngo Quyen District,13,117,94,23,9
2022-06-08,Hai Phong City,Ngo Quyen District,14,143,106,37,24
2022-06-08,Hai Phong City,Ngo Quyen District,15,201,99,102,91
2022-06-08,Hai Phong City,Ngo Quyen District,16,186,132,54,39
2022-06-08,Hai Phong City,Ngo Quyen District,17,154,131,23,12
2022-06-08,Hai Phong City,Ngo Quyen District,18,193,158,35,22
2022-06-08,Hai Phong City,Ngo Quyen District,19,208,150,58,28
2022-06-08,Hai Phong City,Ngo Quyen District,20,158,124,34,16
2022-06-08,Hai Phong City,Ngo Quyen District,21,66,45,21,11
2022-06-08,Hai Phong City,Ngo Quyen District,22,1,0,1,0
2022-06-08,Hai Phong City,Thuy Nguyen,7,1,0,1,1
2022-06-08,Hai Phong City,Thuy Nguyen,10,1,0,1,1
2022-06-08,Hai Phong City,Thuy Nguyen,11,4,0,4,4
2022-06-08,Hai Phong City,Thuy Nguyen,14,3,0,3,2
2022-06-08,Hai Phong City,Thuy Nguyen,15,1,0,1,1
2022-06-08,Hai Phong City,Thuy Nguyen,16,4,0,4,4
2022-06-08,Hai Phong City,Thuy Nguyen,17,3,0,3,3
2022-06-08,Hai Phong City,Thuy Nguyen,18,2,0,2,2
2022-06-08,Hai Phong City,Thuy Nguyen,19,3,0,3,3
2022-06-08,Hai Phong City,Thuy Nguyen,20,1,0,1,1
2022-06-08,Hue City,Hue City,0,3,1,2,0
2022-06-08,Hue City,Hue City,1,3,1,2,1
2022-06-08,Hue City,Hue City,2,1,1,0,0
2022-06-08,Hue City,Hue City,5,4,3,1,1
2022-06-08,Hue City,Hue City,6,65,60,5,1
2022-06-08,Hue City,Hue City,7,197,183,14,0
2022-06-08,Hue City,Hue City,8,326,305,21,2
2022-06-08,Hue City,Hue City,9,290,263,27,0
2022-06-08,Hue City,Hue City,10,396,370,26,0
2022-06-08,Hue City,Hue City,11,927,845,82,7
2022-06-08,Hue City,Hue City,12,614,557,57,1
2022-06-08,Hue City,Hue City,13,332,306,26,1
2022-06-08,Hue City,Hue City,14,365,348,17,2
2022-06-08,Hue City,Hue City,15,401,376,25,2
2022-06-08,Hue City,Hue City,16,372,343,29,3
2022-06-08,Hue City,Hue City,17,488,447,41,2
2022-06-08,Hue City,Hue City,18,571,524,47,5
2022-06-08,Hue City,Hue City,19,615,553,62,7
2022-06-08,Hue City,Hue City,20,541,424,117,49
2022-06-08,Hue City,Hue City,21,273,205,68,26
2022-06-08,Hue City,Hue City,22,2,0,2,1
2022-06-08,Hue City,Huong Thuy,7,1,1,0,0
2022-06-08,Hue City,Huong Thuy,9,1,1,0,0
2022-06-08,Hue City,Huong Thuy,10,1,1,0,0
2022-06-08,Hue City,Huong Thuy,11,1,1,0,0
2022-06-08,Hue City,Huong Thuy,13,1,0,1,1
2022-06-08,Hue City,Huong Thuy,14,1,0,1,0
2022-06-08,Hue City,Huong Thuy,16,2,2,0,0
2022-06-08,Hue City,Huong Thuy,17,1,1,0,0
2022-06-08,Hue City,Huong Thuy,19,1,0,1,1
2022-06-08,Hue City,Huong Thuy,20,1,1,0,0
2022-06-08,Hue City,Huong Thuy,21,2,0,2,1
2022-06-08,Hue City,Huong Tra,16,2,1,1,1
2022-06-08,Hue City,Huong Tra,17,2,2,0,0
2022-06-08,Hue City,Huong Tra,20,1,1,0,0
2022-06-08,Hue City,Phu Vang,7,1,1,0,0
2022-06-08,Hue City,Phu Vang,8,2,2,0,0
2022-06-08,Hue City,Phu Vang,9,3,3,0,0
2022-06-08,Hue City,Phu Vang,10,1,1,0,0
2022-06-08,Hue City,Phu Vang,11,2,1,1,1
2022-06-08,Hue City,Phu Vang,13,2,0,2,0
2022-06-08,Hue City,Phu Vang,14,4,3,1,1
2022-06-08,Hue City,Phu Vang,15,2,2,0,0
2022-06-08,Hue City,Phu Vang,17,1,1,0,0
2022-06-08,Hue City,Phu Vang,19,1,1,0,0
2022-06-08,Hue City,Phu Vang,20,3,1,2,1
2022-06-08,Hue City,Phu Vang,21,4,1,3,2
2022-06-08,Khanh Hoa,Dien Khanh,11,1,0,1,1
2022-06-08,Khanh Hoa,Dien Khanh,17,1,1,0,0
2022-06-08,Khanh Hoa,Nha Trang City,0,2,2,0,0
2022-06-08,Khanh Hoa,Nha Trang City,5,4,3,1,0
2022-06-08,Khanh Hoa,Nha Trang City,6,36,29,7,1
2022-06-08,Khanh Hoa,Nha Trang City,7,128,121,7,0
2022-06-08,Khanh Hoa,Nha Trang City,8,212,197,15,2
2022-06-08,Khanh Hoa,Nha Trang City,9,215,198,17,1
2022-06-08,Khanh Hoa,Nha Trang City,10,213,199,14,4
2022-06-08,Khanh Hoa,Nha Trang City,11,375,348,27,0
2022-06-08,Khanh Hoa,Nha Trang City,12,308,290,18,1
2022-06-08,Khanh Hoa,Nha Trang City,13,277,256,21,1
2022-06-08,Khanh Hoa,Nha Trang City,14,269,254,15,0
2022-06-08,Khanh Hoa,Nha Trang City,15,212,192,20,3
2022-06-08,Khanh Hoa,Nha Trang City,16,206,192,14,0
2022-06-08,Khanh Hoa,Nha Trang City,17,235,213,22,0
2022-06-08,Khanh Hoa,Nha Trang City,18,311,279,32,0
2022-06-08,Khanh Hoa,Nha Trang City,19,345,297,48,3
2022-06-08,Khanh Hoa,Nha Trang City,20,202,170,32,4
2022-06-08,Khanh Hoa,Nha Trang City,21,94,67,27,7
2022-06-08,Khanh Hoa,Nha Trang City,22,1,0,1,0
2022-06-08,Khanh Hoa,Nha Trang City,23,1,0,1,0
2022-06-08,Lam Dong,Da Lat City,0,1,1,0,0
2022-06-08,Lam Dong,Da Lat City,6,3,2,1,0
2022-06-08,Lam Dong,Da Lat City,7,54,38,16,14
2022-06-08,Lam Dong,Da Lat City,8,100,71,29,22
2022-06-08,Lam Dong,Da Lat City,9,92,78,14,3
2022-06-08,Lam Dong,Da Lat City,10,101,90,11,1
2022-06-08,Lam Dong,Da Lat City,11,157,128,29,11
2022-06-08,Lam Dong,Da Lat City,12,137,119,18,9
2022-06-08,Lam Dong,Da Lat City,13,121,87,34,20
2022-06-08,Lam Dong,Da Lat City,14,108,90,18,11
2022-06-08,Lam Dong,Da Lat City,15,108,83,25,11
2022-06-08,Lam Dong,Da Lat City,16,109,87,22,5
2022-06-08,Lam Dong,Da Lat City,17,120,99,21,3
2022-06-08,Lam Dong,Da Lat City,18,119,111,8,3
2022-06-08,Lam Dong,Da Lat City,19,123,94,29,9
2022-06-08,Lam Dong,Da Lat City,20,107,71,36,19
2022-06-08,Lam Dong,Da Lat City,21,64,31,33,16
2022-06-08,Nghe An,Vinh City,0,1,0,1,0
2022-06-08,Nghe An,Vinh City,5,1,1,0,0
2022-06-08,Nghe An,Vinh City,6,5,3,2,1
2022-06-08,Nghe An,Vinh City,7,142,118,24,2
2022-06-08,Nghe An,Vinh City,8,196,168,28,2
2022-06-08,Nghe An,Vinh City,9,185,151,34,5
2022-06-08,Nghe An,Vinh City,10,220,181,39,8
2022-06-08,Nghe An,Vinh City,11,401,343,58,38
2022-06-08,Nghe An,Vinh City,12,261,216,45,9
2022-06-08,Nghe An,Vinh City,13,142,124,18,4
2022-06-08,Nghe An,Vinh City,14,169,146,23,2
2022-06-08,Nghe An,Vinh City,15,179,158,21,0
2022-06-08,Nghe An,Vinh City,16,166,145,21,1
2022-06-08,Nghe An,Vinh City,17,159,136,23,1
2022-06-08,Nghe An,Vinh City,18,253,209,44,6
2022-06-08,Nghe An,Vinh City,19,205,159,46,16
2022-06-08,Nghe An,Vinh City,20,155,107,48,24
2022-06-08,Nghe An,Vinh City,21,108,62,46,30
2022-06-08,Nghe An,Vinh City,22,3,1,2,0
2022-06-08,Quang Nam,Dien Ban,9,1,0,1,1
2022-06-08,Quang Nam,Dien Ban,14,3,0,3,0
2022-06-08,Quang Nam,Hoi An City,0,1,0,1,0
2022-06-08,Quang Nam,Hoi An City,6,1,1,0,0
2022-06-08,Quang Nam,Hoi An City,7,19,7,12,9
2022-06-08,Quang Nam,Hoi An City,8,19,15,4,0
2022-06-08,Quang Nam,Hoi An City,9,22,16,6,0
2022-06-08,Quang Nam,Hoi An City,10,20,20,0,0
2022-06-08,Quang Nam,Hoi An City,11,41,31,10,5
2022-06-08,Quang Nam,Hoi An City,12,55,45,10,6
2022-06-08,Quang Nam,Hoi An City,13,44,35,9,5
2022-06-08,Quang Nam,Hoi An City,14,32,28,4,1
2022-06-08,Quang Nam,Hoi An City,15,40,33,7,3
2022-06-08,Quang Nam,Hoi An City,16,36,28,8,1
2022-06-08,Quang Nam,Hoi An City,17,36,32,4,3
2022-06-08,Quang Nam,Hoi An City,18,61,48,13,6
2022-06-08,Quang Nam,Hoi An City,19,66,45,21,14
2022-06-08,Quang Nam,Hoi An City,20,49,34,15,7
2022-06-08,Quang Nam,Hoi An City,21,39,14,25,20
2022-06-08,Quang Nam,Hoi An City,22,2,0,2,0
2022-06-08,Quang Nam,Tam Ky City,6,1,0,1,1
2022-06-08,Quang Nam,Tam Ky City,9,1,0,1,1
2022-06-08,Quang Nam,Tam Ky City,12,2,0,2,2
2022-06-08,Quang Nam,Tam Ky City,14,1,0,1,1
2022-06-08,Quang Ninh,Cam Pha City,10,4,0,4,4
2022-06-08,Quang Ninh,Cam Pha City,11,3,0,3,3
2022-06-08,Quang Ninh,Cam Pha City,13,2,0,2,1
2022-06-08,Quang Ninh,Cam Pha City,14,2,0,2,2
2022-06-08,Quang Ninh,Cam Pha City,15,1,0,1,1
2022-06-08,Quang Ninh,Cam Pha City,18,3,0,3,2
2022-06-08,Quang Ninh,Cam Pha City,19,1,0,1,1
2022-06-08,Quang Ninh,Cam Pha City,20,1,0,1,1
2022-06-08,Quang Ninh,Ha Long City,0,1,1,0,0
2022-06-08,Quang Ninh,Ha Long City,7,24,13,11,2
2022-06-08,Quang Ninh,Ha Long City,8,63,49,14,7
2022-06-08,Quang Ninh,Ha Long City,9,41,28,13,6
2022-06-08,Quang Ninh,Ha Long City,10,58,46,12,3
2022-06-08,Quang Ninh,Ha Long City,11,125,108,17,8
2022-06-08,Quang Ninh,Ha Long City,12,86,64,22,10
2022-06-08,Quang Ninh,Ha Long City,13,72,51,21,10
2022-06-08,Quang Ninh,Ha Long City,14,61,40,21,11
2022-06-08,Quang Ninh,Ha Long City,15,64,29,35,24
2022-06-08,Quang Ninh,Ha Long City,16,43,29,14,4
2022-06-08,Quang Ninh,Ha Long City,17,47,39,8,4
2022-06-08,Quang Ninh,Ha Long City,18,62,45,17,9
2022-06-08,Quang Ninh,Ha Long City,19,67,41,26,16
2022-06-08,Quang Ninh,Ha Long City,20,72,36,36,25
2022-06-08,Quang Ninh,Uong Bi City,16,1,0,1,1
2022-06-08,Quang Ninh,Uong Bi City,20,1,0,1,1
2022-06-08,Thai Nguyen,Thai Nguyen City,0,7,2,5,0
2022-06-08,Thai Nguyen,Thai Nguyen City,6,3,3,0,0
2022-06-08,Thai Nguyen,Thai Nguyen City,7,93,85,8,0
2022-06-08,Thai Nguyen,Thai Nguyen City,8,144,130,14,1
2022-06-08,Thai Nguyen,Thai Nguyen City,9,114,108,6,0
2022-06-08,Thai Nguyen,Thai Nguyen City,10,206,194,12,1
2022-06-08,Thai Nguyen,Thai Nguyen City,11,392,364,28,2
2022-06-08,Thai Nguyen,Thai Nguyen City,12,234,209,25,1
2022-06-08,Thai Nguyen,Thai Nguyen City,13,163,151,12,0
2022-06-08,Thai Nguyen,Thai Nguyen City,14,169,155,14,1
2022-06-08,Thai Nguyen,Thai Nguyen City,15,142,127,15,3
2022-06-08,Thai Nguyen,Thai Nguyen City,16,134,118,16,2
2022-06-08,Thai Nguyen,Thai Nguyen City,17,185,166,19,0
2022-06-08,Thai Nguyen,Thai Nguyen City,18,266,248,18,0
2022-06-08,Thai Nguyen,Thai Nguyen City,19,239,223,16,0
2022-06-08,Thai Nguyen,Thai Nguyen City,20,188,171,17,2
2022-06-08,Thai Nguyen,Thai Nguyen City,21,125,102,23,2
2022-06-08,Vung Tau,Ba Ria City,7,2,0,2,0
2022-06-08,Vung Tau,Ba Ria City,8,6,4,2,2
2022-06-08,Vung Tau,Ba Ria City,9,7,4,3,3
2022-06-08,Vung Tau,Ba Ria City,10,13,2,11,8
2022-06-08,Vung Tau,Ba Ria City,11,9,4,5,4
2022-06-08,Vung Tau,Ba Ria City,12,17,3,14,11
2022-06-08,Vung Tau,Ba Ria City,13,14,4,10,9
2022-06-08,Vung Tau,Ba Ria City,14,7,2,5,5
2022-06-08,Vung Tau,Ba Ria City,15,10,3,7,7
2022-06-08,Vung Tau,Ba Ria City,16,9,2,7,6
2022-06-08,Vung Tau,Ba Ria City,17,7,1,6,6
2022-06-08,Vung Tau,Ba Ria City,18,15,4,11,11
2022-06-08,Vung Tau,Ba Ria City,19,6,0,6,6
2022-06-08,Vung Tau,Ba Ria City,20,4,0,4,4
2022-06-08,Vung Tau,Ba Ria City,21,3,0,3,3
2022-06-08,Vung Tau,Chau Duc,15,1,0,1,1
2022-06-08,Vung Tau,Chau Duc,16,2,0,2,1
2022-06-08,Vung Tau,Chau Duc,21,1,0,1,1
2022-06-08,Vung Tau,Vung Tau City,2,2,1,1,0
2022-06-08,Vung Tau,Vung Tau City,4,1,1,0,0
2022-06-08,Vung Tau,Vung Tau City,5,1,1,0,0
2022-06-08,Vung Tau,Vung Tau City,6,52,28,24,12
2022-06-08,Vung Tau,Vung Tau City,7,115,107,8,3
2022-06-08,Vung Tau,Vung Tau City,8,189,175,14,2
2022-06-08,Vung Tau,Vung Tau City,9,164,157,7,0
2022-06-08,Vung Tau,Vung Tau City,10,207,194,13,6
2022-06-08,Vung Tau,Vung Tau City,11,399,355,44,15
2022-06-08,Vung Tau,Vung Tau City,12,293,277,16,2
2022-06-08,Vung Tau,Vung Tau City,13,239,228,11,0
2022-06-08,Vung Tau,Vung Tau City,14,281,264,17,1
2022-06-08,Vung Tau,Vung Tau City,15,258,239,19,2
2022-06-08,Vung Tau,Vung Tau City,16,225,214,11,2
2022-06-08,Vung Tau,Vung Tau City,17,238,217,21,4
2022-06-08,Vung Tau,Vung Tau City,18,305,280,25,6
2022-06-08,Vung Tau,Vung Tau City,19,301,261,40,16
2022-06-08,Vung Tau,Vung Tau City,20,210,170,40,17
2022-06-08,Vung Tau,Vung Tau City,21,99,84,15,5
2022-06-08,Vung Tau,Vung Tau City,22,1,0,1,0
2022-06-08,Vung Tau,Vung Tau City,23,1,0,1,0
2022-06-09,Bac Ninh,Bác Ninh City,0,1,1,0,0
2022-06-09,Bac Ninh,Bác Ninh City,1,2,1,1,0
2022-06-09,Bac Ninh,Bác Ninh City,6,2,1,1,0
2022-06-09,Bac Ninh,Bác Ninh City,7,84,58,26,17
2022-06-09,Bac Ninh,Bác Ninh City,8,119,104,15,1
2022-06-09,Bac Ninh,Bác Ninh City,9,89,79,10,0
2022-06-09,Bac Ninh,Bác Ninh City,10,162,149,13,1
2022-06-09,Bac Ninh,Bác Ninh City,11,347,322,25,7
2022-06-09,Bac Ninh,Bác Ninh City,12,209,195,14,4
2022-06-09,Bac Ninh,Bác Ninh City,13,149,135,14,2
2022-06-09,Bac Ninh,Bác Ninh City,14,136,123,13,3
2022-06-09,Bac Ninh,Bác Ninh City,15,120,114,6,1
2022-06-09,Bac Ninh,Bác Ninh City,16,102,92,10,1
2022-06-09,Bac Ninh,Bác Ninh City,17,109,106,3,0
2022-06-09,Bac Ninh,Bác Ninh City,18,171,157,14,1
2022-06-09,Bac Ninh,Bác Ninh City,19,198,166,32,19
2022-06-09,Bac Ninh,Bác Ninh City,20,147,128,19,4
2022-06-09,Bac Ninh,Bác Ninh City,21,106,81,25,11
2022-06-09,Bac Ninh,Bác Ninh City,22,1,0,1,0
2022-06-09,Bac Ninh,Bác Ninh City,23,1,1,0,0
2022-06-09,Bac Ninh,Que Vo,7,1,1,0,0
2022-06-09,Bac Ninh,Que Vo,9,1,0,1,1
2022-06-09,Bac Ninh,Que Vo,10,1,0,1,1
2022-06-09,Bac Ninh,Que Vo,11,1,0,1,1
2022-06-09,Bac Ninh,Que Vo,14,1,0,1,0
2022-06-09,Bac Ninh,Que Vo,17,1,0,1,1
2022-06-09,Bac Ninh,Que Vo,19,1,0,1,1
2022-06-09,Bac Ninh,Que Vo,20,1,0,1,1
2022-06-09,Bac Ninh,Que Vo,21,2,0,2,1
2022-06-09,Bac Ninh,Tien Du,9,2,0,2,2
2022-06-09,Bac Ninh,Tien Du,12,2,0,2,2
2022-06-09,Bac Ninh,Tien Du,13,1,0,1,1
2022-06-09,Bac Ninh,Tien Du,14,7,0,7,7
2022-06-09,Bac Ninh,Tien Du,15,3,0,3,3
2022-06-09,Bac Ninh,Tien Du,16,1,0,1,1
2022-06-09,Bac Ninh,Tien Du,17,3,0,3,3
2022-06-09,Bac Ninh,Tien Du,18,1,0,1,1
2022-06-09,Bac Ninh,Tien Du,19,1,0,1,1
2022-06-09,Bac Ninh,Tien Du,21,1,0,1,1
2022-06-09,Bac Ninh,Tu Son,8,1,0,1,1
2022-06-09,Bac Ninh,Tu Son,10,1,0,1,1
2022-06-09,Bac Ninh,Tu Son,11,1,0,1,1
2022-06-09,Bac Ninh,Tu Son,14,2,0,2,2
2022-06-09,Bac Ninh,Tu Son,15,3,0,3,3
2022-06-09,Bac Ninh,Tu Son,16,2,0,2,2
2022-06-09,Bac Ninh,Tu Son,19,1,0,1,1
2022-06-09,Bac Ninh,Tu Son,20,4,0,4,4
2022-06-09,Bac Ninh,Tu Son,21,1,0,1,1
2022-06-09,Bac Ninh,Yen Phong,10,1,0,1,1
2022-06-09,Binh Duong,Ben Cat,10,1,0,1,1
2022-06-09,Binh Duong,Ben Cat,11,3,0,3,2
2022-06-09,Binh Duong,Ben Cat,13,3,0,3,3
2022-06-09,Binh Duong,Ben Cat,15,1,0,1,1
2022-06-09,Binh Duong,Ben Cat,17,1,0,1,1
2022-06-09,Binh Duong,Ben Cat,18,1,0,1,1
2022-06-09,Binh Duong,Ben Cat,20,1,0,1,1
2022-06-09,Binh Duong,Di An,7,4,0,4,4
2022-06-09,Binh Duong,Di An,8,21,9,12,11
2022-06-09,Binh Duong,Di An,9,20,13,7,6
2022-06-09,Binh Duong,Di An,10,46,21,25,20
2022-06-09,Binh Duong,Di An,11,45,29,16,12
2022-06-09,Binh Duong,Di An,12,53,37,16,11
2022-06-09,Binh Duong,Di An,13,44,28,16,11
2022-06-09,Binh Duong,Di An,14,47,36,11,6
2022-06-09,Binh Duong,Di An,15,21,16,5,2
2022-06-09,Binh Duong,Di An,16,17,15,2,1
2022-06-09,Binh Duong,Di An,17,27,22,5,4
2022-06-09,Binh Duong,Di An,18,44,23,21,17
2022-06-09,Binh Duong,Di An,19,38,22,16,7
2022-06-09,Binh Duong,Di An,20,26,15,11,8
2022-06-09,Binh Duong,Di An,21,14,1,13,10
2022-06-09,Binh Duong,Tan Uyen,8,2,0,2,2
2022-06-09,Binh Duong,Tan Uyen,9,2,0,2,2
2022-06-09,Binh Duong,Tan Uyen,10,3,2,1,1
2022-06-09,Binh Duong,Tan Uyen,11,2,2,0,0
2022-06-09,Binh Duong,Tan Uyen,12,5,3,2,2
2022-06-09,Binh Duong,Tan Uyen,13,2,1,1,0
2022-06-09,Binh Duong,Tan Uyen,14,2,0,2,1
2022-06-09,Binh Duong,Tan Uyen,15,1,1,0,0
2022-06-09,Binh Duong,Tan Uyen,16,3,1,2,2
2022-06-09,Binh Duong,Tan Uyen,17,3,0,3,2
2022-06-09,Binh Duong,Tan Uyen,18,2,0,2,2
2022-06-09,Binh Duong,Tan Uyen,19,2,1,1,0
2022-06-09,Binh Duong,Tan Uyen,20,3,0,3,2
2022-06-09,Binh Duong,Tan Uyen,21,1,0,1,1
2022-06-09,Binh Duong,Thu Dau Mot Town,0,1,1,0,0
2022-06-09,Binh Duong,Thu Dau Mot Town,5,2,1,1,1
2022-06-09,Binh Duong,Thu Dau Mot Town,6,32,27,5,1
2022-06-09,Binh Duong,Thu Dau Mot Town,7,140,134,6,2
2022-06-09,Binh Duong,Thu Dau Mot Town,8,242,222,20,2
2022-06-09,Binh Duong,Thu Dau Mot Town,9,296,276,20,2
2022-06-09,Binh Duong,Thu Dau Mot Town,10,427,403,24,6
2022-06-09,Binh Duong,Thu Dau Mot Town,11,782,720,62,4
2022-06-09,Binh Duong,Thu Dau Mot Town,12,555,508,47,11
2022-06-09,Binh Duong,Thu Dau Mot Town,13,507,457,50,19
2022-06-09,Binh Duong,Thu Dau Mot Town,14,387,358,29,2
2022-06-09,Binh Duong,Thu Dau Mot Town,15,293,275,18,1
2022-06-09,Binh Duong,Thu Dau Mot Town,16,301,283,18,4
2022-06-09,Binh Duong,Thu Dau Mot Town,17,364,342,22,1
2022-06-09,Binh Duong,Thu Dau Mot Town,18,453,424,29,2
2022-06-09,Binh Duong,Thu Dau Mot Town,19,423,361,62,17
2022-06-09,Binh Duong,Thu Dau Mot Town,20,304,257,47,27
2022-06-09,Binh Duong,Thu Dau Mot Town,21,132,88,44,28
2022-06-09,Binh Duong,Thu Dau Mot Town,22,2,0,2,1
2022-06-09,Binh Duong,Thuan An,6,3,2,1,1
2022-06-09,Binh Duong,Thuan An,7,6,4,2,1
2022-06-09,Binh Duong,Thuan An,8,29,11,18,13
2022-06-09,Binh Duong,Thuan An,9,37,29,8,7
2022-06-09,Binh Duong,Thuan An,10,77,55,22,20
2022-06-09,Binh Duong,Thuan An,11,91,66,25,15
2022-06-09,Binh Duong,Thuan An,12,113,86,27,17
2022-06-09,Binh Duong,Thuan An,13,77,55,22,12
2022-06-09,Binh Duong,Thuan An,14,72,54,18,13
2022-06-09,Binh Duong,Thuan An,15,50,35,15,6
2022-06-09,Binh Duong,Thuan An,16,46,29,17,8
2022-06-09,Binh Duong,Thuan An,17,35,27,8,1
2022-06-09,Binh Duong,Thuan An,18,58,48,10,1
2022-06-09,Binh Duong,Thuan An,19,54,41,13,5
2022-06-09,Binh Duong,Thuan An,20,48,28,20,13
2022-06-09,Binh Duong,Thuan An,21,29,3,26,23
2022-06-09,Can Tho City,Binh Thuy District,8,2,2,0,0
2022-06-09,Can Tho City,Binh Thuy District,9,4,4,0,0
2022-06-09,Can Tho City,Binh Thuy District,10,10,10,0,0
2022-06-09,Can Tho City,Binh Thuy District,11,13,12,1,0
2022-06-09,Can Tho City,Binh Thuy District,12,15,14,1,0
2022-06-09,Can Tho City,Binh Thuy District,13,9,8,1,0
2022-06-09,Can Tho City,Binh Thuy District,14,10,9,1,0
2022-06-09,Can Tho City,Binh Thuy District,15,3,3,0,0
2022-06-09,Can Tho City,Binh Thuy District,16,12,11,1,0
2022-06-09,Can Tho City,Binh Thuy District,17,14,14,0,0
2022-06-09,Can Tho City,Binh Thuy District,18,10,10,0,0
2022-06-09,Can Tho City,Binh Thuy District,19,12,12,0,0
2022-06-09,Can Tho City,Binh Thuy District,20,9,7,2,0
2022-06-09,Can Tho City,Binh Thuy District,21,2,2,0,0
2022-06-09,Can Tho City,Cai Rang District,8,6,6,0,0
2022-06-09,Can Tho City,Cai Rang District,9,10,10,0,0
2022-06-09,Can Tho City,Cai Rang District,10,10,8,2,0
2022-06-09,Can Tho City,Cai Rang District,11,19,17,2,0
2022-06-09,Can Tho City,Cai Rang District,12,16,15,1,0
2022-06-09,Can Tho City,Cai Rang District,13,8,7,1,0
2022-06-09,Can Tho City,Cai Rang District,14,11,11,0,0
2022-06-09,Can Tho City,Cai Rang District,15,10,10,0,0
2022-06-09,Can Tho City,Cai Rang District,16,4,4,0,0
2022-06-09,Can Tho City,Cai Rang District,17,14,11,3,0
2022-06-09,Can Tho City,Cai Rang District,18,15,11,4,0
2022-06-09,Can Tho City,Cai Rang District,19,21,19,2,0
2022-06-09,Can Tho City,Cai Rang District,20,7,7,0,0
2022-06-09,Can Tho City,Cai Rang District,21,3,2,1,1
2022-06-09,Can Tho City,Ninh Kieu District,1,1,1,0,0
2022-06-09,Can Tho City,Ninh Kieu District,2,2,1,1,0
2022-06-09,Can Tho City,Ninh Kieu District,4,1,0,1,1
2022-06-09,Can Tho City,Ninh Kieu District,5,3,2,1,0
2022-06-09,Can Tho City,Ninh Kieu District,6,41,38,3,0
2022-06-09,Can Tho City,Ninh Kieu District,7,105,101,4,0
2022-06-09,Can Tho City,Ninh Kieu District,8,251,237,14,0
2022-06-09,Can Tho City,Ninh Kieu District,9,321,303,18,0
2022-06-09,Can Tho City,Ninh Kieu District,10,528,502,26,2
2022-06-09,Can Tho City,Ninh Kieu District,11,927,880,47,0
2022-06-09,Can Tho City,Ninh Kieu District,12,648,617,31,0
2022-06-09,Can Tho City,Ninh Kieu District,13,521,508,13,0
2022-06-09,Can Tho City,Ninh Kieu District,14,473,444,29,0
2022-06-09,Can Tho City,Ninh Kieu District,15,355,336,19,0
2022-06-09,Can Tho City,Ninh Kieu District,16,398,376,22,0
2022-06-09,Can Tho City,Ninh Kieu District,17,552,528,24,0
2022-06-09,Can Tho City,Ninh Kieu District,18,551,529,22,0
2022-06-09,Can Tho City,Ninh Kieu District,19,500,464,36,0
2022-06-09,Can Tho City,Ninh Kieu District,20,349,322,27,0
2022-06-09,Can Tho City,Ninh Kieu District,21,187,166,21,0
2022-06-09,Can Tho City,O Mon District,13,2,0,2,2
2022-06-09,Can Tho City,O Mon District,14,2,0,2,2
2022-06-09,Can Tho City,O Mon District,15,1,0,1,0
2022-06-09,Can Tho City,Phong Dien,10,1,0,1,1
2022-06-09,Dong Nai,Bien Hoa City,1,3,1,2,0
2022-06-09,Dong Nai,Bien Hoa City,5,1,0,1,1
2022-06-09,Dong Nai,Bien Hoa City,6,64,38,26,20
2022-06-09,Dong Nai,Bien Hoa City,7,173,148,25,17
2022-06-09,Dong Nai,Bien Hoa City,8,295,262,33,8
2022-06-09,Dong Nai,Bien Hoa City,9,422,373,49,7
2022-06-09,Dong Nai,Bien Hoa City,10,891,792,99,37
2022-06-09,Dong Nai,Bien Hoa City,11,1240,1119,121,32
2022-06-09,Dong Nai,Bien Hoa City,12,998,905,93,25
2022-06-09,Dong Nai,Bien Hoa City,13,994,890,104,41
2022-06-09,Dong Nai,Bien Hoa City,14,759,656,103,43
2022-06-09,Dong Nai,Bien Hoa City,15,620,560,60,17
2022-06-09,Dong Nai,Bien Hoa City,16,587,531,56,17
2022-06-09,Dong Nai,Bien Hoa City,17,643,585,58,12
2022-06-09,Dong Nai,Bien Hoa City,18,642,601,41,5
2022-06-09,Dong Nai,Bien Hoa City,19,685,619,66,12
2022-06-09,Dong Nai,Bien Hoa City,20,451,386,65,30
2022-06-09,Dong Nai,Bien Hoa City,21,236,121,115,66
2022-06-09,Dong Nai,Bien Hoa City,22,4,0,4,0
2022-06-09,Dong Nai,Long Khanh,11,1,0,1,1
2022-06-09,Dong Nai,Long Thanh,11,3,0,3,3
2022-06-09,Dong Nai,Long Thanh,12,2,0,2,2
2022-06-09,Dong Nai,Long Thanh,13,5,0,5,4
2022-06-09,Dong Nai,Long Thanh,14,6,0,6,6
2022-06-09,Dong Nai,Long Thanh,15,2,0,2,1
2022-06-09,Dong Nai,Long Thanh,18,1,0,1,1
2022-06-09,Dong Nai,Nhon trach,10,1,0,1,1
2022-06-09,Dong Nai,Nhon trach,11,1,0,1,0
2022-06-09,Dong Nai,Nhon trach,12,1,0,1,1
2022-06-09,Dong Nai,Nhon trach,14,1,0,1,1
2022-06-09,Dong Nai,Nhon trach,15,1,0,1,1
2022-06-09,Dong Nai,Nhon trach,17,1,0,1,1
2022-06-09,Dong Nai,Nhon trach,19,2,0,2,2
2022-06-09,Dong Nai,Trang Bom,9,1,0,1,1
2022-06-09,Dong Nai,Trang Bom,11,1,0,1,1
2022-06-09,Dong Nai,Trang Bom,12,2,0,2,2
2022-06-09,Dong Nai,Trang Bom,13,1,0,1,1
2022-06-09,Dong Nai,Trang Bom,14,3,1,2,2
2022-06-09,Dong Nai,Trang Bom,16,2,0,2,1
2022-06-09,Dong Nai,Trang Bom,21,1,0,1,0
2022-06-09,Hai Phong City,An Duong,8,9,4,5,5
2022-06-09,Hai Phong City,An Duong,9,3,0,3,2
2022-06-09,Hai Phong City,An Duong,10,7,6,1,1
2022-06-09,Hai Phong City,An Duong,11,10,6,4,4
2022-06-09,Hai Phong City,An Duong,12,2,0,2,2
2022-06-09,Hai Phong City,An Duong,13,4,0,4,4
2022-06-09,Hai Phong City,An Duong,14,3,1,2,1
2022-06-09,Hai Phong City,An Duong,15,2,2,0,0
2022-06-09,Hai Phong City,An Duong,16,4,2,2,2
2022-06-09,Hai Phong City,An Duong,17,4,1,3,1
2022-06-09,Hai Phong City,An Duong,18,1,1,0,0
2022-06-09,Hai Phong City,An Duong,19,1,0,1,1
2022-06-09,Hai Phong City,An Duong,20,6,2,4,4
2022-06-09,Hai Phong City,An Duong,21,2,0,2,2
2022-06-09,Hai Phong City,Duong Kinh District,14,1,0,1,1
2022-06-09,Hai Phong City,Duong Kinh District,17,1,1,0,0
2022-06-09,Hai Phong City,Duong Kinh District,20,1,0,1,1
2022-06-09,Hai Phong City,Hai An District,6,1,0,1,1
2022-06-09,Hai Phong City,Hai An District,7,9,6,3,3
2022-06-09,Hai Phong City,Hai An District,8,18,12,6,6
2022-06-09,Hai Phong City,Hai An District,9,21,11,10,3
2022-06-09,Hai Phong City,Hai An District,10,31,26,5,4
2022-06-09,Hai Phong City,Hai An District,11,50,42,8,2
2022-06-09,Hai Phong City,Hai An District,12,23,17,6,3
2022-06-09,Hai Phong City,Hai An District,13,18,15,3,1
2022-06-09,Hai Phong City,Hai An District,14,22,10,12,8
2022-06-09,Hai Phong City,Hai An District,15,19,13,6,3
2022-06-09,Hai Phong City,Hai An District,16,19,18,1,0
2022-06-09,Hai Phong City,Hai An District,17,13,12,1,0
2022-06-09,Hai Phong City,Hai An District,18,22,17,5,4
2022-06-09,Hai Phong City,Hai An District,19,17,14,3,0
2022-06-09,Hai Phong City,Hai An District,20,21,15,6,3
2022-06-09,Hai Phong City,Hai An District,21,14,10,4,1
2022-06-09,Hai Phong City,Hong Bang District,0,1,0,1,0
2022-06-09,Hai Phong City,Hong Bang District,3,1,1,0,0
2022-06-09,Hai Phong City,Hong Bang District,7,10,9,1,0
2022-06-09,Hai Phong City,Hong Bang District,8,42,31,11,6
2022-06-09,Hai Phong City,Hong Bang District,9,27,22,5,2
2022-06-09,Hai Phong City,Hong Bang District,10,53,44,9,6
2022-06-09,Hai Phong City,Hong Bang District,11,120,89,31,18
2022-06-09,Hai Phong City,Hong Bang District,12,67,52,15,3
2022-06-09,Hai Phong City,Hong Bang District,13,30,26,4,2
2022-06-09,Hai Phong City,Hong Bang District,14,50,36,14,8
2022-06-09,Hai Phong City,Hong Bang District,15,54,46,8,4
2022-06-09,Hai Phong City,Hong Bang District,16,46,37,9,3
2022-06-09,Hai Phong City,Hong Bang District,17,40,27,13,7
2022-06-09,Hai Phong City,Hong Bang District,18,49,39,10,3
2022-06-09,Hai Phong City,Hong Bang District,19,43,32,11,4
2022-06-09,Hai Phong City,Hong Bang District,20,29,23,6,3
2022-06-09,Hai Phong City,Hong Bang District,21,15,7,8,7
2022-06-09,Hai Phong City,Kien An District,7,2,1,1,0
2022-06-09,Hai Phong City,Kien An District,8,4,2,2,1
2022-06-09,Hai Phong City,Kien An District,9,14,9,5,1
2022-06-09,Hai Phong City,Kien An District,10,13,7,6,4
2022-06-09,Hai Phong City,Kien An District,11,13,8,5,2
2022-06-09,Hai Phong City,Kien An District,12,12,6,6,4
2022-06-09,Hai Phong City,Kien An District,13,16,4,12,10
2022-06-09,Hai Phong City,Kien An District,14,11,3,8,6
2022-06-09,Hai Phong City,Kien An District,15,18,11,7,5
2022-06-09,Hai Phong City,Kien An District,16,5,4,1,1
2022-06-09,Hai Phong City,Kien An District,17,5,1,4,0
2022-06-09,Hai Phong City,Kien An District,18,10,8,2,0
2022-06-09,Hai Phong City,Kien An District,19,15,12,3,1
2022-06-09,Hai Phong City,Kien An District,20,8,7,1,1
2022-06-09,Hai Phong City,Kien An District,21,9,4,5,1
2022-06-09,Hai Phong City,Le Chan District,0,1,1,0,0
2022-06-09,Hai Phong City,Le Chan District,5,2,2,0,0
2022-06-09,Hai Phong City,Le Chan District,6,2,1,1,1
2022-06-09,Hai Phong City,Le Chan District,7,34,27,7,3
2022-06-09,Hai Phong City,Le Chan District,8,56,49,7,3
2022-06-09,Hai Phong City,Le Chan District,9,89,74,15,2
2022-06-09,Hai Phong City,Le Chan District,10,190,169,21,7
2022-06-09,Hai Phong City,Le Chan District,11,326,265,61,34
2022-06-09,Hai Phong City,Le Chan District,12,215,189,26,8
2022-06-09,Hai Phong City,Le Chan District,13,144,128,16,5
2022-06-09,Hai Phong City,Le Chan District,14,171,130,41,22
2022-06-09,Hai Phong City,Le Chan District,15,170,151,19,6
2022-06-09,Hai Phong City,Le Chan District,16,171,149,22,10
2022-06-09,Hai Phong City,Le Chan District,17,176,146,30,11
2022-06-09,Hai Phong City,Le Chan District,18,198,176,22,5
2022-06-09,Hai Phong City,Le Chan District,19,215,190,25,5
2022-06-09,Hai Phong City,Le Chan District,20,141,127,14,2
2022-06-09,Hai Phong City,Le Chan District,21,73,52,21,6
2022-06-09,Hai Phong City,Ngo Quyen District,0,1,0,1,0
2022-06-09,Hai Phong City,Ngo Quyen District,1,1,0,1,0
2022-06-09,Hai Phong City,Ngo Quyen District,3,2,0,2,0
2022-06-09,Hai Phong City,Ngo Quyen District,5,1,1,0,0
2022-06-09,Hai Phong City,Ngo Quyen District,6,2,1,1,1
2022-06-09,Hai Phong City,Ngo Quyen District,7,25,19,6,6
2022-06-09,Hai Phong City,Ngo Quyen District,8,87,62,25,19
2022-06-09,Hai Phong City,Ngo Quyen District,9,90,76,14,5
2022-06-09,Hai Phong City,Ngo Quyen District,10,136,115,21,7
2022-06-09,Hai Phong City,Ngo Quyen District,11,264,206,58,43
2022-06-09,Hai Phong City,Ngo Quyen District,12,188,164,24,6
2022-06-09,Hai Phong City,Ngo Quyen District,13,113,102,11,2
2022-06-09,Hai Phong City,Ngo Quyen District,14,155,128,27,11
2022-06-09,Hai Phong City,Ngo Quyen District,15,139,122,17,5
2022-06-09,Hai Phong City,Ngo Quyen District,16,131,120,11,1
2022-06-09,Hai Phong City,Ngo Quyen District,17,112,99,13,4
2022-06-09,Hai Phong City,Ngo Quyen District,18,146,129,17,5
2022-06-09,Hai Phong City,Ngo Quyen District,19,141,132,9,3
2022-06-09,Hai Phong City,Ngo Quyen District,20,110,98,12,4
2022-06-09,Hai Phong City,Ngo Quyen District,21,58,39,19,11
2022-06-09,Hai Phong City,Thuy Nguyen,10,1,0,1,1
2022-06-09,Hai Phong City,Thuy Nguyen,12,1,0,1,1
2022-06-09,Hai Phong City,Thuy Nguyen,13,1,0,1,1
2022-06-09,Hai Phong City,Thuy Nguyen,14,1,0,1,1
2022-06-09,Hai Phong City,Thuy Nguyen,16,2,0,2,2
2022-06-09,Hue City,Hue City,0,1,1,0,0
2022-06-09,Hue City,Hue City,2,1,1,0,0
2022-06-09,Hue City,Hue City,4,1,1,0,0
2022-06-09,Hue City,Hue City,6,53,44,9,2
2022-06-09,Hue City,Hue City,7,191,177,14,1
2022-06-09,Hue City,Hue City,8,300,276,24,3
2022-06-09,Hue City,Hue City,9,303,278,25,0
2022-06-09,Hue City,Hue City,10,469,440,29,0
2022-06-09,Hue City,Hue City,11,938,856,82,10
2022-06-09,Hue City,Hue City,12,606,563,43,1
2022-06-09,Hue City,Hue City,13,327,304,23,0
2022-06-09,Hue City,Hue City,14,328,303,25,2
2022-06-09,Hue City,Hue City,15,404,362,42,3
2022-06-09,Hue City,Hue City,16,358,316,42,3
2022-06-09,Hue City,Hue City,17,417,377,40,2
2022-06-09,Hue City,Hue City,18,605,555,50,1
2022-06-09,Hue City,Hue City,19,614,546,68,5
2022-06-09,Hue City,Hue City,20,380,336,44,1
2022-06-09,Hue City,Hue City,21,233,199,34,6
2022-06-09,Hue City,Hue City,22,5,1,4,0
2022-06-09,Hue City,Huong Thuy,8,3,0,3,2
2022-06-09,Hue City,Huong Thuy,9,2,1,1,1
2022-06-09,Hue City,Huong Thuy,10,4,3,1,0
2022-06-09,Hue City,Huong Thuy,12,1,0,1,0
2022-06-09,Hue City,Huong Thuy,13,1,1,0,0
2022-06-09,Hue City,Huong Thuy,17,1,1,0,0
2022-06-09,Hue City,Huong Thuy,18,4,3,1,1
2022-06-09,Hue City,Huong Thuy,19,1,1,0,0
2022-06-09,Hue City,Huong Thuy,20,1,1,0,0
2022-06-09,Hue City,Huong Thuy,21,1,0,1,1
2022-06-09,Hue City,Huong Tra,18,1,1,0,0
2022-06-09,Hue City,Phu Vang,7,1,0,1,1
2022-06-09,Hue City,Phu Vang,8,3,2,1,1
2022-06-09,Hue City,Phu Vang,10,1,1,0,0
2022-06-09,Hue City,Phu Vang,11,2,2,0,0
2022-06-09,Hue City,Phu Vang,12,6,2,4,3
2022-06-09,Hue City,Phu Vang,13,4,2,2,1
2022-06-09,Hue City,Phu Vang,14,3,2,1,0
2022-06-09,Hue City,Phu Vang,15,2,1,1,1
2022-06-09,Hue City,Phu Vang,16,2,2,0,0
2022-06-09,Hue City,Phu Vang,19,2,1,1,1
2022-06-09,Hue City,Phu Vang,20,2,1,1,1
2022-06-09,Hue City,Phu Vang,21,6,2,4,3
2022-06-09,Khanh Hoa,Cam Ranh City,13,2,0,2,2
2022-06-09,Khanh Hoa,Cam Ranh City,14,1,0,1,1
2022-06-09,Khanh Hoa,Cam Ranh City,17,1,0,1,1
2022-06-09,Khanh Hoa,Cam Ranh City,18,1,0,1,1
2022-06-09,Khanh Hoa,Dien Khanh,20,1,0,1,0
2022-06-09,Khanh Hoa,Nha Trang City,4,1,0,1,1
2022-06-09,Khanh Hoa,Nha Trang City,5,2,2,0,0
2022-06-09,Khanh Hoa,Nha Trang City,6,38,29,9,1
2022-06-09,Khanh Hoa,Nha Trang City,7,132,114,18,1
2022-06-09,Khanh Hoa,Nha Trang City,8,197,180,17,0
2022-06-09,Khanh Hoa,Nha Trang City,9,191,175,16,1
2022-06-09,Khanh Hoa,Nha Trang City,10,215,201,14,0
2022-06-09,Khanh Hoa,Nha Trang City,11,391,362,29,7
2022-06-09,Khanh Hoa,Nha Trang City,12,353,316,37,7
2022-06-09,Khanh Hoa,Nha Trang City,13,257,238,19,0
2022-06-09,Khanh Hoa,Nha Trang City,14,234,220,14,2
2022-06-09,Khanh Hoa,Nha Trang City,15,221,206,15,1
2022-06-09,Khanh Hoa,Nha Trang City,16,185,166,19,1
2022-06-09,Khanh Hoa,Nha Trang City,17,197,186,11,1
2022-06-09,Khanh Hoa,Nha Trang City,18,268,245,23,1
2022-06-09,Khanh Hoa,Nha Trang City,19,270,238,32,0
2022-06-09,Khanh Hoa,Nha Trang City,20,200,174,26,2
2022-06-09,Khanh Hoa,Nha Trang City,21,87,71,16,1
2022-06-09,Khanh Hoa,Nha Trang City,23,1,0,1,0
2022-06-09,Lam Dong,Da Lat City,6,2,1,1,1
2022-06-09,Lam Dong,Da Lat City,7,53,37,16,13
2022-06-09,Lam Dong,Da Lat City,8,94,65,29,25
2022-06-09,Lam Dong,Da Lat City,9,91,74,17,8
2022-06-09,Lam Dong,Da Lat City,10,98,85,13,2
2022-06-09,Lam Dong,Da Lat City,11,166,131,35,15
2022-06-09,Lam Dong,Da Lat City,12,188,124,64,41
2022-06-09,Lam Dong,Da Lat City,13,123,102,21,10
2022-06-09,Lam Dong,Da Lat City,14,118,76,42,29
2022-06-09,Lam Dong,Da Lat City,15,88,78,10,6
2022-06-09,Lam Dong,Da Lat City,16,112,92,20,10
2022-06-09,Lam Dong,Da Lat City,17,106,88,18,4
2022-06-09,Lam Dong,Da Lat City,18,200,123,77,55
2022-06-09,Lam Dong,Da Lat City,19,187,113,74,57
2022-06-09,Lam Dong,Da Lat City,20,124,85,39,23
2022-06-09,Lam Dong,Da Lat City,21,81,43,38,27
2022-06-09,Lam Dong,Da Lat City,22,1,0,1,1
2022-06-09,Nghe An,Do luong,6,1,0,1,1
2022-06-09,Nghe An,Do luong,9,1,0,1,1
2022-06-09,Nghe An,Quynh Luu,10,1,0,1,1
2022-06-09,Nghe An,Vinh City,0,2,2,0,0
2022-06-09,Nghe An,Vinh City,5,2,1,1,0
2022-06-09,Nghe An,Vinh City,6,6,5,1,0
2022-06-09,Nghe An,Vinh City,7,129,122,7,0
2022-06-09,Nghe An,Vinh City,8,190,174,16,1
2022-06-09,Nghe An,Vinh City,9,166,149,17,1
2022-06-09,Nghe An,Vinh City,10,221,195,26,1
2022-06-09,Nghe An,Vinh City,11,412,362,50,20
2022-06-09,Nghe An,Vinh City,12,236,209,27,2
2022-06-09,Nghe An,Vinh City,13,150,131,19,1
2022-06-09,Nghe An,Vinh City,14,162,145,17,1
2022-06-09,Nghe An,Vinh City,15,203,181,22,5
2022-06-09,Nghe An,Vinh City,16,145,127,18,0
2022-06-09,Nghe An,Vinh City,17,142,133,9,0
2022-06-09,Nghe An,Vinh City,18,174,157,17,1
2022-06-09,Nghe An,Vinh City,19,204,171,33,11
2022-06-09,Nghe An,Vinh City,20,126,107,19,5
2022-06-09,Nghe An,Vinh City,21,93,52,41,24
2022-06-09,Nghe An,Vinh City,22,1,0,1,1
2022-06-09,Quang Nam,Hoi An City,6,1,1,0,0
2022-06-09,Quang Nam,Hoi An City,7,14,10,4,2
2022-06-09,Quang Nam,Hoi An City,8,16,14,2,0
2022-06-09,Quang Nam,Hoi An City,9,20,20,0,0
2022-06-09,Quang Nam,Hoi An City,10,29,21,8,3
2022-06-09,Quang Nam,Hoi An City,11,30,21,9,3
2022-06-09,Quang Nam,Hoi An City,12,48,40,8,3
2022-06-09,Quang Nam,Hoi An City,13,40,34,6,2
2022-06-09,Quang Nam,Hoi An City,14,30,26,4,1
2022-06-09,Quang Nam,Hoi An City,15,39,35,4,2
2022-06-09,Quang Nam,Hoi An City,16,27,25,2,0
2022-06-09,Quang Nam,Hoi An City,17,34,29,5,0
2022-06-09,Quang Nam,Hoi An City,18,41,36,5,2
2022-06-09,Quang Nam,Hoi An City,19,54,45,9,2
2022-06-09,Quang Nam,Hoi An City,20,35,26,9,5
2022-06-09,Quang Nam,Hoi An City,21,33,14,19,9
2022-06-09,Quang Nam,Tam Ky City,7,1,0,1,1
2022-06-09,Quang Nam,Tam Ky City,8,1,0,1,1
2022-06-09,Quang Nam,Tam Ky City,11,1,0,1,1
2022-06-09,Quang Nam,Tam Ky City,12,1,0,1,1
2022-06-09,Quang Nam,Tam Ky City,14,1,0,1,1
2022-06-09,Quang Nam,Tam Ky City,15,3,0,3,2
2022-06-09,Quang Ninh,Cam Pha City,6,1,0,1,1
2022-06-09,Quang Ninh,Cam Pha City,8,2,0,2,1
2022-06-09,Quang Ninh,Cam Pha City,9,1,0,1,0
2022-06-09,Quang Ninh,Cam Pha City,11,1,0,1,1
2022-06-09,Quang Ninh,Cam Pha City,12,1,0,1,1
2022-06-09,Quang Ninh,Cam Pha City,13,1,0,1,1
2022-06-09,Quang Ninh,Cam Pha City,15,3,0,3,3
2022-06-09,Quang Ninh,Cam Pha City,16,1,0,1,1
2022-06-09,Quang Ninh,Cam Pha City,17,1,0,1,1
2022-06-09,Quang Ninh,Cam Pha City,18,2,0,2,2
2022-06-09,Quang Ninh,Cam Pha City,19,1,0,1,1
2022-06-09,Quang Ninh,Ha Long City,7,25,20,5,2
2022-06-09,Quang Ninh,Ha Long City,8,41,32,9,5
2022-06-09,Quang Ninh,Ha Long City,9,51,37,14,5
2022-06-09,Quang Ninh,Ha Long City,10,67,47,20,3
2022-06-09,Quang Ninh,Ha Long City,11,137,102,35,18
2022-06-09,Quang Ninh,Ha Long City,12,103,82,21,7
2022-06-09,Quang Ninh,Ha Long City,13,74,57,17,6
2022-06-09,Quang Ninh,Ha Long City,14,78,53,25,12
2022-06-09,Quang Ninh,Ha Long City,15,72,60,12,2
2022-06-09,Quang Ninh,Ha Long City,16,28,24,4,1
2022-06-09,Quang Ninh,Ha Long City,17,50,39,11,6
2022-06-09,Quang Ninh,Ha Long City,18,53,39,14,10
2022-06-09,Quang Ninh,Ha Long City,19,63,43,20,12
2022-06-09,Quang Ninh,Ha Long City,20,63,33,30,17
2022-06-09,Quang Ninh,Ha Long City,21,1,0,1,1
2022-06-09,Quang Ninh,Uong Bi City,10,1,0,1,1
2022-06-09,Quang Ninh,Uong Bi City,11,1,0,1,1
2022-06-09,Quang Ninh,Uong Bi City,13,2,0,2,2
2022-06-09,Quang Ninh,Uong Bi City,14,2,0,2,1
2022-06-09,Quang Ninh,Uong Bi City,15,1,0,1,1
2022-06-09,Thai Nguyen,Dong Hy,10,1,0,1,1
2022-06-09,Thai Nguyen,Dong Hy,11,2,2,0,0
2022-06-09,Thai Nguyen,Dong Hy,17,1,1,0,0
2022-06-09,Thai Nguyen,Dong Hy,19,1,0,1,0
2022-06-09,Thai Nguyen,Pho Yen,15,1,0,1,1
2022-06-09,Thai Nguyen,Pho Yen,19,1,0,1,1
2022-06-09,Thai Nguyen,Thai Nguyen City,0,1,0,1,0
2022-06-09,Thai Nguyen,Thai Nguyen City,1,1,1,0,0
2022-06-09,Thai Nguyen,Thai Nguyen City,6,5,5,0,0
2022-06-09,Thai Nguyen,Thai Nguyen City,7,96,89,7,2
2022-06-09,Thai Nguyen,Thai Nguyen City,8,139,123,16,0
2022-06-09,Thai Nguyen,Thai Nguyen City,9,136,123,13,0
2022-06-09,Thai Nguyen,Thai Nguyen City,10,174,158,16,0
2022-06-09,Thai Nguyen,Thai Nguyen City,11,396,367,29,2
2022-06-09,Thai Nguyen,Thai Nguyen City,12,254,237,17,1
2022-06-09,Thai Nguyen,Thai Nguyen City,13,178,156,22,4
2022-06-09,Thai Nguyen,Thai Nguyen City,14,208,184,24,10
2022-06-09,Thai Nguyen,Thai Nguyen City,15,202,181,21,0
2022-06-09,Thai Nguyen,Thai Nguyen City,16,145,140,5,0
2022-06-09,Thai Nguyen,Thai Nguyen City,17,144,129,15,3
2022-06-09,Thai Nguyen,Thai Nguyen City,18,211,199,12,1
2022-06-09,Thai Nguyen,Thai Nguyen City,19,253,227,26,1
2022-06-09,Thai Nguyen,Thai Nguyen City,20,173,155,18,0
2022-06-09,Thai Nguyen,Thai Nguyen City,21,100,91,9,1
2022-06-09,Thai Nguyen,Thai Nguyen City,22,2,0,2,0
2022-06-09,Thai Nguyen,Thai Nguyen City,23,1,0,1,0
2022-06-09,Vung Tau,Ba Ria City,7,1,1,0,0
2022-06-09,Vung Tau,Ba Ria City,8,7,4,3,2
2022-06-09,Vung Tau,Ba Ria City,9,7,4,3,3
2022-06-09,Vung Tau,Ba Ria City,10,10,5,5,5
2022-06-09,Vung Tau,Ba Ria City,11,12,6,6,6
2022-06-09,Vung Tau,Ba Ria City,12,17,5,12,12
2022-06-09,Vung Tau,Ba Ria City,13,10,6,4,2
2022-06-09,Vung Tau,Ba Ria City,14,7,2,5,5
2022-06-09,Vung Tau,Ba Ria City,15,6,1,5,5
2022-06-09,Vung Tau,Ba Ria City,16,3,3,0,0
2022-06-09,Vung Tau,Ba Ria City,17,6,2,4,3
2022-06-09,Vung Tau,Ba Ria City,18,9,4,5,3
2022-06-09,Vung Tau,Ba Ria City,19,6,1,5,5
2022-06-09,Vung Tau,Ba Ria City,20,5,0,5,4
2022-06-09,Vung Tau,Ba Ria City,21,3,0,3,2
2022-06-09,Vung Tau,Chau Duc,8,2,0,2,1
2022-06-09,Vung Tau,Chau Duc,12,1,0,1,0
2022-06-09,Vung Tau,Chau Duc,14,1,0,1,1
2022-06-09,Vung Tau,Chau Duc,16,1,0,1,1
2022-06-09,Vung Tau,Vung Tau City,0,1,0,1,0
2022-06-09,Vung Tau,Vung Tau City,3,1,0,1,0
2022-06-09,Vung Tau,Vung Tau City,5,2,0,2,0
2022-06-09,Vung Tau,Vung Tau City,6,44,31,13,8
2022-06-09,Vung Tau,Vung Tau City,7,102,92,10,1
2022-06-09,Vung Tau,Vung Tau City,8,180,155,25,5
2022-06-09,Vung Tau,Vung Tau City,9,213,200,13,2
2022-06-09,Vung Tau,Vung Tau City,10,215,199,16,2
2022-06-09,Vung Tau,Vung Tau City,11,421,387,34,11
2022-06-09,Vung Tau,Vung Tau City,12,316,288,28,1
2022-06-09,Vung Tau,Vung Tau City,13,252,231,21,5
2022-06-09,Vung Tau,Vung Tau City,14,289,271,18,2
2022-06-09,Vung Tau,Vung Tau City,15,244,232,12,1
2022-06-09,Vung Tau,Vung Tau City,16,198,182,16,0
2022-06-09,Vung Tau,Vung Tau City,17,238,226,12,1
2022-06-09,Vung Tau,Vung Tau City,18,331,306,25,2
2022-06-09,Vung Tau,Vung Tau City,19,284,254,30,3
2022-06-09,Vung Tau,Vung Tau City,20,205,171,34,4
2022-06-09,Vung Tau,Vung Tau City,21,112,75,37,8
2022-06-09,Vung Tau,Vung Tau City,22,1,0,1,0
2022-06-10,Bac Ninh,Bác Ninh City,6,6,4,2,1
2022-06-10,Bac Ninh,Bác Ninh City,7,78,66,12,6
2022-06-10,Bac Ninh,Bác Ninh City,8,137,115,22,6
2022-06-10,Bac Ninh,Bác Ninh City,9,119,112,7,0
2022-06-10,Bac Ninh,Bác Ninh City,10,160,145,15,2
2022-06-10,Bac Ninh,Bác Ninh City,11,338,305,33,14
2022-06-10,Bac Ninh,Bác Ninh City,12,236,210,26,1
2022-06-10,Bac Ninh,Bác Ninh City,13,157,145,12,2
2022-06-10,Bac Ninh,Bác Ninh City,14,170,156,14,5
2022-06-10,Bac Ninh,Bác Ninh City,15,155,141,14,2
2022-06-10,Bac Ninh,Bác Ninh City,16,106,98,8,1
2022-06-10,Bac Ninh,Bác Ninh City,17,170,132,38,16
2022-06-10,Bac Ninh,Bác Ninh City,18,175,163,12,3
2022-06-10,Bac Ninh,Bác Ninh City,19,231,178,53,26
2022-06-10,Bac Ninh,Bác Ninh City,20,232,108,124,95
2022-06-10,Bac Ninh,Bác Ninh City,21,147,41,106,90
2022-06-10,Bac Ninh,Luong Tai,19,2,0,2,2
2022-06-10,Bac Ninh,Luong Tai,20,1,0,1,1
2022-06-10,Bac Ninh,Que Vo,9,1,0,1,1
2022-06-10,Bac Ninh,Que Vo,10,2,1,1,0
2022-06-10,Bac Ninh,Que Vo,11,1,0,1,1
2022-06-10,Bac Ninh,Que Vo,13,1,1,0,0
2022-06-10,Bac Ninh,Que Vo,14,3,1,2,0
2022-06-10,Bac Ninh,Que Vo,15,2,1,1,0
2022-06-10,Bac Ninh,Que Vo,18,1,0,1,0
2022-06-10,Bac Ninh,Que Vo,19,2,0,2,0
2022-06-10,Bac Ninh,Que Vo,20,1,0,1,1
2022-06-10,Bac Ninh,Que Vo,21,2,0,2,2
2022-06-10,Bac Ninh,Tien Du,12,1,0,1,1
2022-06-10,Bac Ninh,Tien Du,13,2,0,2,2
2022-06-10,Bac Ninh,Tien Du,14,3,0,3,3
2022-06-10,Bac Ninh,Tien Du,15,2,0,2,2
2022-06-10,Bac Ninh,Tien Du,16,1,0,1,1
2022-06-10,Bac Ninh,Tien Du,17,1,0,1,1
2022-06-10,Bac Ninh,Tien Du,19,2,0,2,2
2022-06-10,Bac Ninh,Tien Du,20,1,0,1,1
2022-06-10,Bac Ninh,Tien Du,21,1,0,1,1
2022-06-10,Bac Ninh,Tu Son,10,3,0,3,3
2022-06-10,Bac Ninh,Tu Son,11,2,0,2,1
2022-06-10,Bac Ninh,Tu Son,12,2,0,2,2
2022-06-10,Bac Ninh,Tu Son,13,1,0,1,1
2022-06-10,Bac Ninh,Tu Son,14,1,0,1,1
2022-06-10,Bac Ninh,Tu Son,17,1,0,1,1
2022-06-10,Bac Ninh,Tu Son,19,1,0,1,1
2022-06-10,Bac Ninh,Tu Son,20,4,0,4,4
2022-06-10,Bac Ninh,Tu Son,21,1,0,1,1
2022-06-10,Binh Duong,Ben Cat,8,1,0,1,1
2022-06-10,Binh Duong,Ben Cat,9,1,0,1,1
2022-06-10,Binh Duong,Ben Cat,11,3,0,3,2
2022-06-10,Binh Duong,Ben Cat,12,2,0,2,2
2022-06-10,Binh Duong,Ben Cat,13,1,0,1,1
2022-06-10,Binh Duong,Ben Cat,14,1,0,1,0
2022-06-10,Binh Duong,Ben Cat,17,1,0,1,1
2022-06-10,Binh Duong,Ben Cat,18,1,0,1,0
2022-06-10,Binh Duong,Ben Cat,20,1,0,1,0
2022-06-10,Binh Duong,Di An,7,5,1,4,2
2022-06-10,Binh Duong,Di An,8,9,7,2,2
2022-06-10,Binh Duong,Di An,9,23,19,4,4
2022-06-10,Binh Duong,Di An,10,37,24,13,9
2022-06-10,Binh Duong,Di An,11,52,27,25,21
2022-06-10,Binh Duong,Di An,12,45,29,16,15
2022-06-10,Binh Duong,Di An,13,50,32,18,15
2022-06-10,Binh Duong,Di An,14,33,14,19,18
2022-06-10,Binh Duong,Di An,15,37,24,13,7
2022-06-10,Binh Duong,Di An,16,27,21,6,6
2022-06-10,Binh Duong,Di An,17,29,21,8,6
2022-06-10,Binh Duong,Di An,18,46,26,20,13
2022-06-10,Binh Duong,Di An,19,36,18,18,10
2022-06-10,Binh Duong,Di An,20,23,14,9,4
2022-06-10,Binh Duong,Di An,21,13,7,6,4
2022-06-10,Binh Duong,Tan Uyen,7,3,1,2,2
2022-06-10,Binh Duong,Tan Uyen,8,3,0,3,3
2022-06-10,Binh Duong,Tan Uyen,9,4,0,4,4
2022-06-10,Binh Duong,Tan Uyen,10,2,0,2,1
2022-06-10,Binh Duong,Tan Uyen,11,3,1,2,1
2022-06-10,Binh Duong,Tan Uyen,12,4,0,4,4
2022-06-10,Binh Duong,Tan Uyen,13,5,3,2,2
2022-06-10,Binh Duong,Tan Uyen,14,3,1,2,2
2022-06-10,Binh Duong,Tan Uyen,15,1,0,1,0
2022-06-10,Binh Duong,Tan Uyen,17,4,3,1,1
2022-06-10,Binh Duong,Tan Uyen,18,5,2,3,3
2022-06-10,Binh Duong,Tan Uyen,19,4,1,3,3
2022-06-10,Binh Duong,Tan Uyen,20,2,1,1,1
2022-06-10,Binh Duong,Tan Uyen,21,2,0,2,1
2022-06-10,Binh Duong,Thu Dau Mot Town,0,2,2,0,0
2022-06-10,Binh Duong,Thu Dau Mot Town,5,1,1,0,0
2022-06-10,Binh Duong,Thu Dau Mot Town,6,36,27,9,4
2022-06-10,Binh Duong,Thu Dau Mot Town,7,139,128,11,5
2022-06-10,Binh Duong,Thu Dau Mot Town,8,252,229,23,9
2022-06-10,Binh Duong,Thu Dau Mot Town,9,298,267,31,5
2022-06-10,Binh Duong,Thu Dau Mot Town,10,440,407,33,7
2022-06-10,Binh Duong,Thu Dau Mot Town,11,749,690,59,27
2022-06-10,Binh Duong,Thu Dau Mot Town,12,513,483,30,7
2022-06-10,Binh Duong,Thu Dau Mot Town,13,506,476,30,7
2022-06-10,Binh Duong,Thu Dau Mot Town,14,468,432,36,11
2022-06-10,Binh Duong,Thu Dau Mot Town,15,307,281,26,7
2022-06-10,Binh Duong,Thu Dau Mot Town,16,283,258,25,4
2022-06-10,Binh Duong,Thu Dau Mot Town,17,389,371,18,5
2022-06-10,Binh Duong,Thu Dau Mot Town,18,401,374,27,8
2022-06-10,Binh Duong,Thu Dau Mot Town,19,403,373,30,6
2022-06-10,Binh Duong,Thu Dau Mot Town,20,297,248,49,12
2022-06-10,Binh Duong,Thu Dau Mot Town,21,122,94,28,11
2022-06-10,Binh Duong,Thu Dau Mot Town,22,1,0,1,0
2022-06-10,Binh Duong,Thuan An,1,1,0,1,1
2022-06-10,Binh Duong,Thuan An,5,1,0,1,1
2022-06-10,Binh Duong,Thuan An,6,5,0,5,4
2022-06-10,Binh Duong,Thuan An,7,11,6,5,3
2022-06-10,Binh Duong,Thuan An,8,23,17,6,3
2022-06-10,Binh Duong,Thuan An,9,39,30,9,7
2022-06-10,Binh Duong,Thuan An,10,66,47,19,12
2022-06-10,Binh Duong,Thuan An,11,110,77,33,19
2022-06-10,Binh Duong,Thuan An,12,97,58,39,30
2022-06-10,Binh Duong,Thuan An,13,99,60,39,27
2022-06-10,Binh Duong,Thuan An,14,66,53,13,8
2022-06-10,Binh Duong,Thuan An,15,59,35,24,17
2022-06-10,Binh Duong,Thuan An,16,52,38,14,9
2022-06-10,Binh Duong,Thuan An,17,41,32,9,2
2022-06-10,Binh Duong,Thuan An,18,64,46,18,10
2022-06-10,Binh Duong,Thuan An,19,53,41,12,11
2022-06-10,Binh Duong,Thuan An,20,51,27,24,12
2022-06-10,Binh Duong,Thuan An,21,36,18,18,9
2022-06-10,Can Tho City,Binh Thuy District,6,4,2,2,1
2022-06-10,Can Tho City,Binh Thuy District,7,5,4,1,0
2022-06-10,Can Tho City,Binh Thuy District,8,7,7,0,0
2022-06-10,Can Tho City,Binh Thuy District,9,4,4,0,0
2022-06-10,Can Tho City,Binh Thuy District,10,17,17,0,0
2022-06-10,Can Tho City,Binh Thuy District,11,18,16,2,2
2022-06-10,Can Tho City,Binh Thuy District,12,16,13,3,0
2022-06-10,Can Tho City,Binh Thuy District,13,8,7,1,1
2022-06-10,Can Tho City,Binh Thuy District,14,16,16,0,0
2022-06-10,Can Tho City,Binh Thuy District,15,7,7,0,0
2022-06-10,Can Tho City,Binh Thuy District,16,7,7,0,0
2022-06-10,Can Tho City,Binh Thuy District,17,24,20,4,1
2022-06-10,Can Tho City,Binh Thuy District,18,12,10,2,1
2022-06-10,Can Tho City,Binh Thuy District,19,11,11,0,0
2022-06-10,Can Tho City,Binh Thuy District,20,5,4,1,0
2022-06-10,Can Tho City,Binh Thuy District,21,2,2,0,0
2022-06-10,Can Tho City,Cai Rang District,6,3,2,1,1
2022-06-10,Can Tho City,Cai Rang District,7,6,5,1,1
2022-06-10,Can Tho City,Cai Rang District,8,5,4,1,1
2022-06-10,Can Tho City,Cai Rang District,9,7,7,0,0
2022-06-10,Can Tho City,Cai Rang District,10,18,16,2,0
2022-06-10,Can Tho City,Cai Rang District,11,9,9,0,0
2022-06-10,Can Tho City,Cai Rang District,12,15,11,4,3
2022-06-10,Can Tho City,Cai Rang District,13,13,9,4,2
2022-06-10,Can Tho City,Cai Rang District,14,12,11,1,0
2022-06-10,Can Tho City,Cai Rang District,15,6,6,0,0
2022-06-10,Can Tho City,Cai Rang District,16,8,7,1,0
2022-06-10,Can Tho City,Cai Rang District,17,10,10,0,0
2022-06-10,Can Tho City,Cai Rang District,18,12,11,1,0
2022-06-10,Can Tho City,Cai Rang District,19,9,9,0,0
2022-06-10,Can Tho City,Cai Rang District,20,4,4,0,0
2022-06-10,Can Tho City,Cai Rang District,21,7,5,2,1
2022-06-10,Can Tho City,Ninh Kieu District,0,1,1,0,0
2022-06-10,Can Tho City,Ninh Kieu District,2,1,1,0,0
2022-06-10,Can Tho City,Ninh Kieu District,4,1,0,1,1
2022-06-10,Can Tho City,Ninh Kieu District,5,1,0,1,1
2022-06-10,Can Tho City,Ninh Kieu District,6,54,49,5,1
2022-06-10,Can Tho City,Ninh Kieu District,7,123,117,6,0
2022-06-10,Can Tho City,Ninh Kieu District,8,234,218,16,0
2022-06-10,Can Tho City,Ninh Kieu District,9,326,312,14,0
2022-06-10,Can Tho City,Ninh Kieu District,10,595,570,25,0
2022-06-10,Can Tho City,Ninh Kieu District,11,906,854,52,3
2022-06-10,Can Tho City,Ninh Kieu District,12,656,642,14,0
2022-06-10,Can Tho City,Ninh Kieu District,13,536,518,18,0
2022-06-10,Can Tho City,Ninh Kieu District,14,433,412,21,0
2022-06-10,Can Tho City,Ninh Kieu District,15,370,351,19,2
2022-06-10,Can Tho City,Ninh Kieu District,16,430,409,21,0
2022-06-10,Can Tho City,Ninh Kieu District,17,513,481,32,0
2022-06-10,Can Tho City,Ninh Kieu District,18,554,536,18,0
2022-06-10,Can Tho City,Ninh Kieu District,19,496,469,27,0
2022-06-10,Can Tho City,Ninh Kieu District,20,339,314,25,2
2022-06-10,Can Tho City,Ninh Kieu District,21,201,185,16,1
2022-06-10,Can Tho City,Ninh Kieu District,22,3,1,2,0
2022-06-10,Can Tho City,Ninh Kieu District,23,2,1,1,0
2022-06-10,Can Tho City,O Mon District,13,3,0,3,2
2022-06-10,Dong Nai,Bien Hoa City,0,4,4,0,0
2022-06-10,Dong Nai,Bien Hoa City,5,3,0,3,2
2022-06-10,Dong Nai,Bien Hoa City,6,61,28,33,25
2022-06-10,Dong Nai,Bien Hoa City,7,166,140,26,16
2022-06-10,Dong Nai,Bien Hoa City,8,341,293,48,12
2022-06-10,Dong Nai,Bien Hoa City,9,459,417,42,10
2022-06-10,Dong Nai,Bien Hoa City,10,830,755,75,27
2022-06-10,Dong Nai,Bien Hoa City,11,1264,1112,152,60
2022-06-10,Dong Nai,Bien Hoa City,12,969,875,94,24
2022-06-10,Dong Nai,Bien Hoa City,13,995,889,106,53
2022-06-10,Dong Nai,Bien Hoa City,14,792,693,99,50
2022-06-10,Dong Nai,Bien Hoa City,15,619,526,93,26
2022-06-10,Dong Nai,Bien Hoa City,16,568,494,74,22
2022-06-10,Dong Nai,Bien Hoa City,17,636,562,74,27
2022-06-10,Dong Nai,Bien Hoa City,18,713,644,69,25
2022-06-10,Dong Nai,Bien Hoa City,19,776,658,118,37
2022-06-10,Dong Nai,Bien Hoa City,20,586,458,128,60
2022-06-10,Dong Nai,Bien Hoa City,21,252,161,91,35
2022-06-10,Dong Nai,Bien Hoa City,22,5,3,2,0
2022-06-10,Dong Nai,Bien Hoa City,23,2,1,1,0
2022-06-10,Dong Nai,Long Khanh,10,1,0,1,1
2022-06-10,Dong Nai,Long Khanh,22,2,0,2,0
2022-06-10,Dong Nai,Long Thanh,9,2,0,2,2
2022-06-10,Dong Nai,Long Thanh,11,3,0,3,3
2022-06-10,Dong Nai,Long Thanh,12,2,0,2,1
2022-06-10,Dong Nai,Long Thanh,13,1,0,1,1
2022-06-10,Dong Nai,Long Thanh,14,2,0,2,1
2022-06-10,Dong Nai,Long Thanh,15,2,0,2,2
2022-06-10,Dong Nai,Long Thanh,18,3,0,3,3
2022-06-10,Dong Nai,Long Thanh,19,1,0,1,1
2022-06-10,Dong Nai,Nhon trach,12,2,0,2,2
2022-06-10,Dong Nai,Nhon trach,13,1,0,1,1
2022-06-10,Dong Nai,Trang Bom,12,1,0,1,1
2022-06-10,Dong Nai,Trang Bom,13,3,0,3,2
2022-06-10,Dong Nai,Trang Bom,17,1,0,1,0
2022-06-10,Dong Nai,Trang Bom,21,2,0,2,0
2022-06-10,Hai Phong City,An Duong,7,1,0,1,1
2022-06-10,Hai Phong City,An Duong,8,5,0,5,5
2022-06-10,Hai Phong City,An Duong,9,6,2,4,4
2022-06-10,Hai Phong City,An Duong,10,3,3,0,0
2022-06-10,Hai Phong City,An Duong,11,5,1,4,4
2022-06-10,Hai Phong City,An Duong,12,5,1,4,4
2022-06-10,Hai Phong City,An Duong,13,3,0,3,2
2022-06-10,Hai Phong City,An Duong,14,3,2,1,1
2022-06-10,Hai Phong City,An Duong,15,5,2,3,1
2022-06-10,Hai Phong City,An Duong,16,1,1,0,0
2022-06-10,Hai Phong City,An Duong,17,4,0,4,2
2022-06-10,Hai Phong City,An Duong,18,4,0,4,3
2022-06-10,Hai Phong City,Duong Kinh District,16,3,0,3,2
2022-06-10,Hai Phong City,Hai An District,6,1,0,1,1
2022-06-10,Hai Phong City,Hai An District,7,8,3,5,5
2022-06-10,Hai Phong City,Hai An District,8,23,13,10,6
2022-06-10,Hai Phong City,Hai An District,9,25,19,6,4
2022-06-10,Hai Phong City,Hai An District,10,26,15,11,6
2022-06-10,Hai Phong City,Hai An District,11,34,31,3,1
2022-06-10,Hai Phong City,Hai An District,12,22,18,4,1
2022-06-10,Hai Phong City,Hai An District,13,22,16,6,4
2022-06-10,Hai Phong City,Hai An District,14,25,13,12,11
2022-06-10,Hai Phong City,Hai An District,15,31,21,10,8
2022-06-10,Hai Phong City,Hai An District,16,17,14,3,1
2022-06-10,Hai Phong City,Hai An District,17,20,13,7,5
2022-06-10,Hai Phong City,Hai An District,18,32,20,12,7
2022-06-10,Hai Phong City,Hai An District,19,30,18,12,9
2022-06-10,Hai Phong City,Hai An District,20,6,3,3,1
2022-06-10,Hai Phong City,Hai An District,21,15,7,8,7
2022-06-10,Hai Phong City,Hai An District,22,1,0,1,0
2022-06-10,Hai Phong City,Hong Bang District,3,1,1,0,0
2022-06-10,Hai Phong City,Hong Bang District,5,1,0,1,1
2022-06-10,Hai Phong City,Hong Bang District,7,20,11,9,6
2022-06-10,Hai Phong City,Hong Bang District,8,47,39,8,6
2022-06-10,Hai Phong City,Hong Bang District,9,31,25,6,4
2022-06-10,Hai Phong City,Hong Bang District,10,49,44,5,2
2022-06-10,Hai Phong City,Hong Bang District,11,117,86,31,7
2022-06-10,Hai Phong City,Hong Bang District,12,61,54,7,4
2022-06-10,Hai Phong City,Hong Bang District,13,49,37,12,8
2022-06-10,Hai Phong City,Hong Bang District,14,46,35,11,4
2022-06-10,Hai Phong City,Hong Bang District,15,60,45,15,8
2022-06-10,Hai Phong City,Hong Bang District,16,32,26,6,4
2022-06-10,Hai Phong City,Hong Bang District,17,40,33,7,3
2022-06-10,Hai Phong City,Hong Bang District,18,61,42,19,14
2022-06-10,Hai Phong City,Hong Bang District,19,69,33,36,25
2022-06-10,Hai Phong City,Hong Bang District,20,28,21,7,5
2022-06-10,Hai Phong City,Hong Bang District,21,21,12,9,5
2022-06-10,Hai Phong City,Hong Bang District,23,1,1,0,0
2022-06-10,Hai Phong City,Kien An District,7,3,1,2,1
2022-06-10,Hai Phong City,Kien An District,8,8,6,2,2
2022-06-10,Hai Phong City,Kien An District,9,8,5,3,2
2022-06-10,Hai Phong City,Kien An District,10,8,7,1,0
2022-06-10,Hai Phong City,Kien An District,11,13,11,2,0
2022-06-10,Hai Phong City,Kien An District,12,7,3,4,3
2022-06-10,Hai Phong City,Kien An District,13,7,3,4,4
2022-06-10,Hai Phong City,Kien An District,14,10,5,5,4
2022-06-10,Hai Phong City,Kien An District,15,14,9,5,5
2022-06-10,Hai Phong City,Kien An District,16,11,5,6,2
2022-06-10,Hai Phong City,Kien An District,17,11,4,7,7
2022-06-10,Hai Phong City,Kien An District,18,8,5,3,1
2022-06-10,Hai Phong City,Kien An District,19,12,7,5,4
2022-06-10,Hai Phong City,Kien An District,20,7,5,2,1
2022-06-10,Hai Phong City,Kien An District,21,9,3,6,3
2022-06-10,Hai Phong City,Le Chan District,3,1,0,1,1
2022-06-10,Hai Phong City,Le Chan District,4,1,0,1,1
2022-06-10,Hai Phong City,Le Chan District,5,2,1,1,0
2022-06-10,Hai Phong City,Le Chan District,6,1,1,0,0
2022-06-10,Hai Phong City,Le Chan District,7,43,31,12,6
2022-06-10,Hai Phong City,Le Chan District,8,83,70,13,5
2022-06-10,Hai Phong City,Le Chan District,9,102,89,13,7
2022-06-10,Hai Phong City,Le Chan District,10,179,158,21,5
2022-06-10,Hai Phong City,Le Chan District,11,322,287,35,13
2022-06-10,Hai Phong City,Le Chan District,12,237,213,24,12
2022-06-10,Hai Phong City,Le Chan District,13,133,111,22,7
2022-06-10,Hai Phong City,Le Chan District,14,160,130,30,16
2022-06-10,Hai Phong City,Le Chan District,15,167,122,45,26
2022-06-10,Hai Phong City,Le Chan District,16,151,128,23,10
2022-06-10,Hai Phong City,Le Chan District,17,172,139,33,13
2022-06-10,Hai Phong City,Le Chan District,18,214,169,45,22
2022-06-10,Hai Phong City,Le Chan District,19,280,171,109,77
2022-06-10,Hai Phong City,Le Chan District,20,158,118,40,21
2022-06-10,Hai Phong City,Le Chan District,21,83,55,28,10
2022-06-10,Hai Phong City,Ngo Quyen District,0,1,0,1,0
2022-06-10,Hai Phong City,Ngo Quyen District,2,2,1,1,0
2022-06-10,Hai Phong City,Ngo Quyen District,4,1,0,1,0
2022-06-10,Hai Phong City,Ngo Quyen District,6,1,0,1,1
2022-06-10,Hai Phong City,Ngo Quyen District,7,29,22,7,4
2022-06-10,Hai Phong City,Ngo Quyen District,8,78,63,15,9
2022-06-10,Hai Phong City,Ngo Quyen District,9,77,68,9,6
2022-06-10,Hai Phong City,Ngo Quyen District,10,125,109,16,5
2022-06-10,Hai Phong City,Ngo Quyen District,11,230,198,32,12
2022-06-10,Hai Phong City,Ngo Quyen District,12,176,152,24,3
2022-06-10,Hai Phong City,Ngo Quyen District,13,121,102,19,6
2022-06-10,Hai Phong City,Ngo Quyen District,14,132,117,15,6
2022-06-10,Hai Phong City,Ngo Quyen District,15,151,108,43,17
2022-06-10,Hai Phong City,Ngo Quyen District,16,107,99,8,2
2022-06-10,Hai Phong City,Ngo Quyen District,17,119,104,15,5
2022-06-10,Hai Phong City,Ngo Quyen District,18,170,138,32,17
2022-06-10,Hai Phong City,Ngo Quyen District,19,179,124,55,36
2022-06-10,Hai Phong City,Ngo Quyen District,20,134,107,27,14
2022-06-10,Hai Phong City,Ngo Quyen District,21,80,51,29,16
2022-06-10,Hai Phong City,Ngo Quyen District,22,1,0,1,0
2022-06-10,Hai Phong City,Thuy Nguyen,11,2,0,2,2
2022-06-10,Hai Phong City,Thuy Nguyen,12,2,0,2,2
2022-06-10,Hai Phong City,Thuy Nguyen,13,3,0,3,3
2022-06-10,Hai Phong City,Thuy Nguyen,15,5,0,5,3
2022-06-10,Hai Phong City,Thuy Nguyen,19,1,0,1,1
2022-06-10,Hai Phong City,Thuy Nguyen,20,2,0,2,2
2022-06-10,Hue City,Hue City,0,1,0,1,0
2022-06-10,Hue City,Hue City,1,1,1,0,0
2022-06-10,Hue City,Hue City,2,1,1,0,0
2022-06-10,Hue City,Hue City,4,1,0,1,0
2022-06-10,Hue City,Hue City,5,2,2,0,0
2022-06-10,Hue City,Hue City,6,65,61,4,3
2022-06-10,Hue City,Hue City,7,206,187,19,3
2022-06-10,Hue City,Hue City,8,313,283,30,0
2022-06-10,Hue City,Hue City,9,286,275,11,0
2022-06-10,Hue City,Hue City,10,505,475,30,0
2022-06-10,Hue City,Hue City,11,968,889,79,9
2022-06-10,Hue City,Hue City,12,597,559,38,1
2022-06-10,Hue City,Hue City,13,396,366,30,0
2022-06-10,Hue City,Hue City,14,404,373,31,1
2022-06-10,Hue City,Hue City,15,397,361,36,0
2022-06-10,Hue City,Hue City,16,398,369,29,0
2022-06-10,Hue City,Hue City,17,471,440,31,5
2022-06-10,Hue City,Hue City,18,583,540,43,1
2022-06-10,Hue City,Hue City,19,568,517,51,3
2022-06-10,Hue City,Hue City,20,435,378,57,6
2022-06-10,Hue City,Hue City,21,261,193,68,22
2022-06-10,Hue City,Hue City,22,4,2,2,1
2022-06-10,Hue City,Hue City,23,3,1,2,0
2022-06-10,Hue City,Huong Thuy,8,2,0,2,2
2022-06-10,Hue City,Huong Thuy,9,4,2,2,2
2022-06-10,Hue City,Huong Thuy,10,2,1,1,0
2022-06-10,Hue City,Huong Thuy,11,1,1,0,0
2022-06-10,Hue City,Huong Thuy,14,2,1,1,0
2022-06-10,Hue City,Huong Thuy,15,2,0,2,1
2022-06-10,Hue City,Huong Thuy,16,2,2,0,0
2022-06-10,Hue City,Huong Thuy,17,2,0,2,1
2022-06-10,Hue City,Huong Thuy,18,1,0,1,0
2022-06-10,Hue City,Huong Thuy,19,1,1,0,0
2022-06-10,Hue City,Huong Thuy,20,2,1,1,0
2022-06-10,Hue City,Huong Tra,19,1,0,1,1
2022-06-10,Hue City,Huong Tra,21,1,0,1,1
2022-06-10,Hue City,Phu Vang,7,2,1,1,0
2022-06-10,Hue City,Phu Vang,8,1,1,0,0
2022-06-10,Hue City,Phu Vang,9,2,0,2,1
2022-06-10,Hue City,Phu Vang,10,6,1,5,2
2022-06-10,Hue City,Phu Vang,11,5,4,1,0
2022-06-10,Hue City,Phu Vang,12,3,3,0,0
2022-06-10,Hue City,Phu Vang,13,1,1,0,0
2022-06-10,Hue City,Phu Vang,14,3,3,0,0
2022-06-10,Hue City,Phu Vang,15,2,1,1,1
2022-06-10,Hue City,Phu Vang,18,1,1,0,0
2022-06-10,Hue City,Phu Vang,21,1,1,0,0
2022-06-10,Khanh Hoa,Cam Ranh City,9,1,0,1,1
2022-06-10,Khanh Hoa,Cam Ranh City,18,1,0,1,1
2022-06-10,Khanh Hoa,Dien Khanh,20,1,0,1,1
2022-06-10,Khanh Hoa,Nha Trang City,1,1,1,0,0
2022-06-10,Khanh Hoa,Nha Trang City,4,4,1,3,0
2022-06-10,Khanh Hoa,Nha Trang City,5,1,0,1,1
2022-06-10,Khanh Hoa,Nha Trang City,6,60,51,9,1
2022-06-10,Khanh Hoa,Nha Trang City,7,151,137,14,1
2022-06-10,Khanh Hoa,Nha Trang City,8,234,222,12,2
2022-06-10,Khanh Hoa,Nha Trang City,9,212,188,24,1
2022-06-10,Khanh Hoa,Nha Trang City,10,260,242,18,1
2022-06-10,Khanh Hoa,Nha Trang City,11,387,357,30,2
2022-06-10,Khanh Hoa,Nha Trang City,12,311,289,22,1
2022-06-10,Khanh Hoa,Nha Trang City,13,288,267,21,4
2022-06-10,Khanh Hoa,Nha Trang City,14,277,256,21,2
2022-06-10,Khanh Hoa,Nha Trang City,15,197,184,13,0
2022-06-10,Khanh Hoa,Nha Trang City,16,198,177,21,0
2022-06-10,Khanh Hoa,Nha Trang City,17,223,201,22,0
2022-06-10,Khanh Hoa,Nha Trang City,18,255,245,10,0
2022-06-10,Khanh Hoa,Nha Trang City,19,235,219,16,0
2022-06-10,Khanh Hoa,Nha Trang City,20,157,141,16,0
2022-06-10,Khanh Hoa,Nha Trang City,21,117,74,43,24
2022-06-10,Khanh Hoa,Nha Trang City,22,1,0,1,0
2022-06-10,Lam Dong,Da Lat City,1,1,0,1,0
2022-06-10,Lam Dong,Da Lat City,6,6,3,3,3
2022-06-10,Lam Dong,Da Lat City,7,63,39,24,20
2022-06-10,Lam Dong,Da Lat City,8,74,64,10,3
2022-06-10,Lam Dong,Da Lat City,9,93,75,18,9
2022-06-10,Lam Dong,Da Lat City,10,100,88,12,0
2022-06-10,Lam Dong,Da Lat City,11,142,117,25,10
2022-06-10,Lam Dong,Da Lat City,12,160,123,37,22
2022-06-10,Lam Dong,Da Lat City,13,129,86,43,34
2022-06-10,Lam Dong,Da Lat City,14,130,95,35,22
2022-06-10,Lam Dong,Da Lat City,15,102,91,11,4
2022-06-10,Lam Dong,Da Lat City,16,106,85,21,8
2022-06-10,Lam Dong,Da Lat City,17,159,111,48,32
2022-06-10,Lam Dong,Da Lat City,18,164,123,41,21
2022-06-10,Lam Dong,Da Lat City,19,134,94,40,18
2022-06-10,Lam Dong,Da Lat City,20,102,77,25,14
2022-06-10,Lam Dong,Da Lat City,21,64,50,14,11
2022-06-10,Lam Dong,Da Lat City,22,1,0,1,0
2022-06-10,Nghe An,Do luong,8,1,0,1,1
2022-06-10,Nghe An,Quynh Luu,9,1,0,1,1
2022-06-10,Nghe An,Vinh City,4,1,1,0,0
2022-06-10,Nghe An,Vinh City,5,1,1,0,0
2022-06-10,Nghe An,Vinh City,6,9,8,1,1
2022-06-10,Nghe An,Vinh City,7,158,138,20,5
2022-06-10,Nghe An,Vinh City,8,234,207,27,0
2022-06-10,Nghe An,Vinh City,9,151,142,9,0
2022-06-10,Nghe An,Vinh City,10,225,196,29,1
2022-06-10,Nghe An,Vinh City,11,454,361,93,40
2022-06-10,Nghe An,Vinh City,12,280,243,37,15
2022-06-10,Nghe An,Vinh City,13,150,134,16,2
2022-06-10,Nghe An,Vinh City,14,201,163,38,10
2022-06-10,Nghe An,Vinh City,15,205,167,38,5
2022-06-10,Nghe An,Vinh City,16,125,108,17,3
2022-06-10,Nghe An,Vinh City,17,139,120,19,2
2022-06-10,Nghe An,Vinh City,18,175,149,26,3
2022-06-10,Nghe An,Vinh City,19,189,123,66,34
2022-06-10,Nghe An,Vinh City,20,157,92,65,45
2022-06-10,Nghe An,Vinh City,21,109,52,57,38
2022-06-10,Nghe An,Vinh City,22,1,0,1,0
2022-06-10,Quang Nam,Hoi An City,3,1,1,0,0
2022-06-10,Quang Nam,Hoi An City,6,1,1,0,0
2022-06-10,Quang Nam,Hoi An City,7,15,7,8,7
2022-06-10,Quang Nam,Hoi An City,8,21,18,3,2
2022-06-10,Quang Nam,Hoi An City,9,23,19,4,0
2022-06-10,Quang Nam,Hoi An City,10,33,24,9,1
2022-06-10,Quang Nam,Hoi An City,11,39,34,5,2
2022-06-10,Quang Nam,Hoi An City,12,54,32,22,18
2022-06-10,Quang Nam,Hoi An City,13,38,33,5,4
2022-06-10,Quang Nam,Hoi An City,14,32,25,7,4
2022-06-10,Quang Nam,Hoi An City,15,53,38,15,7
2022-06-10,Quang Nam,Hoi An City,16,37,33,4,1
2022-06-10,Quang Nam,Hoi An City,17,24,24,0,0
2022-06-10,Quang Nam,Hoi An City,18,53,44,9,2
2022-06-10,Quang Nam,Hoi An City,19,31,24,7,1
2022-06-10,Quang Nam,Hoi An City,20,52,40,12,6
2022-06-10,Quang Nam,Hoi An City,21,28,12,16,10
2022-06-10,Quang Nam,Tam Ky City,12,3,0,3,3
2022-06-10,Quang Nam,Tam Ky City,14,1,0,1,1
2022-06-10,Quang Ninh,Cam Pha City,9,1,0,1,1
2022-06-10,Quang Ninh,Cam Pha City,10,1,0,1,1
2022-06-10,Quang Ninh,Cam Pha City,11,1,0,1,1
2022-06-10,Quang Ninh,Cam Pha City,12,2,0,2,2
2022-06-10,Quang Ninh,Cam Pha City,15,2,0,2,2
2022-06-10,Quang Ninh,Cam Pha City,17,1,0,1,1
2022-06-10,Quang Ninh,Cam Pha City,18,1,0,1,1
2022-06-10,Quang Ninh,Cam Pha City,19,1,0,1,1
2022-06-10,Quang Ninh,Ha Long City,0,1,0,1,0
2022-06-10,Quang Ninh,Ha Long City,1,2,1,1,1
2022-06-10,Quang Ninh,Ha Long City,3,1,1,0,0
2022-06-10,Quang Ninh,Ha Long City,5,1,0,1,0
2022-06-10,Quang Ninh,Ha Long City,6,1,0,1,0
2022-06-10,Quang Ninh,Ha Long City,7,20,15,5,2
2022-06-10,Quang Ninh,Ha Long City,8,57,44,13,4
2022-06-10,Quang Ninh,Ha Long City,9,54,42,12,2
2022-06-10,Quang Ninh,Ha Long City,10,60,48,12,4
2022-06-10,Quang Ninh,Ha Long City,11,137,107,30,9
2022-06-10,Quang Ninh,Ha Long City,12,98,80,18,8
2022-06-10,Quang Ninh,Ha Long City,13,83,61,22,10
2022-06-10,Quang Ninh,Ha Long City,14,79,55,24,17
2022-06-10,Quang Ninh,Ha Long City,15,78,53,25,15
2022-06-10,Quang Ninh,Ha Long City,16,67,48,19,8
2022-06-10,Quang Ninh,Ha Long City,17,50,45,5,3
2022-06-10,Quang Ninh,Ha Long City,18,78,54,24,12
2022-06-10,Quang Ninh,Ha Long City,19,61,46,15,6
2022-06-10,Quang Ninh,Ha Long City,20,56,30,26,19
2022-06-10,Quang Ninh,Uong Bi City,9,1,0,1,1
2022-06-10,Thai Nguyen,Dong Hy,10,1,0,1,1
2022-06-10,Thai Nguyen,Thai Nguyen City,0,3,1,2,0
2022-06-10,Thai Nguyen,Thai Nguyen City,1,1,1,0,0
2022-06-10,Thai Nguyen,Thai Nguyen City,5,1,1,0,0
2022-06-10,Thai Nguyen,Thai Nguyen City,6,7,5,2,0
2022-06-10,Thai Nguyen,Thai Nguyen City,7,98,88,10,2
2022-06-10,Thai Nguyen,Thai Nguyen City,8,121,110,11,1
2022-06-10,Thai Nguyen,Thai Nguyen City,9,111,105,6,0
2022-06-10,Thai Nguyen,Thai Nguyen City,10,174,162,12,1
2022-06-10,Thai Nguyen,Thai Nguyen City,11,409,371,38,6
2022-06-10,Thai Nguyen,Thai Nguyen City,12,274,256,18,0
2022-06-10,Thai Nguyen,Thai Nguyen City,13,152,141,11,0
2022-06-10,Thai Nguyen,Thai Nguyen City,14,158,147,11,3
2022-06-10,Thai Nguyen,Thai Nguyen City,15,161,142,19,2
2022-06-10,Thai Nguyen,Thai Nguyen City,16,134,128,6,0
2022-06-10,Thai Nguyen,Thai Nguyen City,17,155,146,9,0
2022-06-10,Thai Nguyen,Thai Nguyen City,18,262,238,24,0
2022-06-10,Thai Nguyen,Thai Nguyen City,19,249,232,17,1
2022-06-10,Thai Nguyen,Thai Nguyen City,20,183,169,14,3
2022-06-10,Thai Nguyen,Thai Nguyen City,21,153,107,46,14
2022-06-10,Thai Nguyen,Thai Nguyen City,23,1,1,0,0
2022-06-10,Vung Tau,Ba Ria City,8,6,4,2,2
2022-06-10,Vung Tau,Ba Ria City,9,7,2,5,5
2022-06-10,Vung Tau,Ba Ria City,10,8,5,3,3
2022-06-10,Vung Tau,Ba Ria City,11,1,1,0,0
2022-06-10,Vung Tau,Ba Ria City,12,11,4,7,4
2022-06-10,Vung Tau,Ba Ria City,13,12,2,10,8
2022-06-10,Vung Tau,Ba Ria City,14,9,3,6,6
2022-06-10,Vung Tau,Ba Ria City,15,6,2,4,2
2022-06-10,Vung Tau,Ba Ria City,16,3,1,2,1
2022-06-10,Vung Tau,Ba Ria City,17,3,1,2,2
2022-06-10,Vung Tau,Ba Ria City,18,1,1,0,0
2022-06-10,Vung Tau,Ba Ria City,19,7,0,7,7
2022-06-10,Vung Tau,Ba Ria City,20,2,0,2,2
2022-06-10,Vung Tau,Tan Thanh,10,1,0,1,1
2022-06-10,Vung Tau,Vung Tau City,0,2,1,1,1
2022-06-10,Vung Tau,Vung Tau City,1,1,0,1,0
2022-06-10,Vung Tau,Vung Tau City,6,53,34,19,15
2022-06-10,Vung Tau,Vung Tau City,7,143,112,31,9
2022-06-10,Vung Tau,Vung Tau City,8,174,162,12,2
2022-06-10,Vung Tau,Vung Tau City,9,199,186,13,1
2022-06-10,Vung Tau,Vung Tau City,10,223,207,16,4
2022-06-10,Vung Tau,Vung Tau City,11,394,364,30,3
2022-06-10,Vung Tau,Vung Tau City,12,330,300,30,5
2022-06-10,Vung Tau,Vung Tau City,13,255,235,20,5
2022-06-10,Vung Tau,Vung Tau City,14,305,290,15,3
2022-06-10,Vung Tau,Vung Tau City,15,259,239,20,1
2022-06-10,Vung Tau,Vung Tau City,16,198,187,11,1
2022-06-10,Vung Tau,Vung Tau City,17,275,259,16,0
2022-06-10,Vung Tau,Vung Tau City,18,305,282,23,3
2022-06-10,Vung Tau,Vung Tau City,19,296,263,33,6
2022-06-10,Vung Tau,Vung Tau City,20,206,179,27,4
2022-06-10,Vung Tau,Vung Tau City,21,119,94,25,10
2022-06-10,Vung Tau,Vung Tau City,23,1,1,0,0
2022-06-11,Bac Ninh,Bác Ninh City,0,1,0,1,0
2022-06-11,Bac Ninh,Bác Ninh City,1,2,2,0,0
2022-06-11,Bac Ninh,Bác Ninh City,6,3,3,0,0
2022-06-11,Bac Ninh,Bác Ninh City,7,87,58,29,21
2022-06-11,Bac Ninh,Bác Ninh City,8,131,120,11,1
2022-06-11,Bac Ninh,Bác Ninh City,9,102,94,8,2
2022-06-11,Bac Ninh,Bác Ninh City,10,192,183,9,1
2022-06-11,Bac Ninh,Bác Ninh City,11,340,281,59,24
2022-06-11,Bac Ninh,Bác Ninh City,12,229,210,19,1
2022-06-11,Bac Ninh,Bác Ninh City,13,151,139,12,1
2022-06-11,Bac Ninh,Bác Ninh City,14,163,145,18,0
2022-06-11,Bac Ninh,Bác Ninh City,15,157,140,17,0
2022-06-11,Bac Ninh,Bác Ninh City,16,124,112,12,0
2022-06-11,Bac Ninh,Bác Ninh City,17,159,148,11,0
2022-06-11,Bac Ninh,Bác Ninh City,18,218,194,24,5
2022-06-11,Bac Ninh,Bác Ninh City,19,195,165,30,5
2022-06-11,Bac Ninh,Bác Ninh City,20,170,130,40,17
2022-06-11,Bac Ninh,Bác Ninh City,21,97,57,40,31
2022-06-11,Bac Ninh,Bác Ninh City,22,2,0,2,0
2022-06-11,Bac Ninh,Bác Ninh City,23,2,1,1,0
2022-06-11,Bac Ninh,Luong Tai,16,1,0,1,1
2022-06-11,Bac Ninh,Que Vo,8,2,1,1,0
2022-06-11,Bac Ninh,Que Vo,9,1,0,1,1
2022-06-11,Bac Ninh,Que Vo,11,1,0,1,1
2022-06-11,Bac Ninh,Que Vo,13,1,0,1,0
2022-06-11,Bac Ninh,Que Vo,15,1,1,0,0
2022-06-11,Bac Ninh,Tien Du,9,2,0,2,2
2022-06-11,Bac Ninh,Tien Du,11,1,0,1,1
2022-06-11,Bac Ninh,Tien Du,12,2,0,2,2
2022-06-11,Bac Ninh,Tien Du,17,1,0,1,1
2022-06-11,Bac Ninh,Tien Du,21,3,0,3,1
2022-06-11,Bac Ninh,Tu Son,8,1,0,1,1
2022-06-11,Bac Ninh,Tu Son,9,1,0,1,1
2022-06-11,Bac Ninh,Tu Son,10,3,0,3,3
2022-06-11,Bac Ninh,Tu Son,12,1,0,1,1
2022-06-11,Bac Ninh,Tu Son,13,1,0,1,1
2022-06-11,Bac Ninh,Tu Son,16,3,0,3,2
2022-06-11,Bac Ninh,Tu Son,17,2,0,2,2
2022-06-11,Bac Ninh,Tu Son,18,3,0,3,2
2022-06-11,Bac Ninh,Tu Son,19,1,0,1,1
2022-06-11,Binh Duong,Ben Cat,9,3,0,3,3
2022-06-11,Binh Duong,Ben Cat,10,1,0,1,0
2022-06-11,Binh Duong,Ben Cat,11,4,0,4,2
2022-06-11,Binh Duong,Ben Cat,12,3,0,3,2
2022-06-11,Binh Duong,Ben Cat,13,1,0,1,1
2022-06-11,Binh Duong,Ben Cat,17,1,0,1,1
2022-06-11,Binh Duong,Ben Cat,18,1,0,1,1
2022-06-11,Binh Duong,Ben Cat,20,1,0,1,1
2022-06-11,Binh Duong,Di An,6,1,0,1,1
2022-06-11,Binh Duong,Di An,7,7,0,7,5
2022-06-11,Binh Duong,Di An,8,27,7,20,16
2022-06-11,Binh Duong,Di An,9,26,12,14,11
2022-06-11,Binh Duong,Di An,10,45,28,17,14
2022-06-11,Binh Duong,Di An,11,59,34,25,15
2022-06-11,Binh Duong,Di An,12,47,35,12,12
2022-06-11,Binh Duong,Di An,13,49,30,19,13
2022-06-11,Binh Duong,Di An,14,32,24,8,7
2022-06-11,Binh Duong,Di An,15,28,20,8,6
2022-06-11,Binh Duong,Di An,16,52,38,14,7
2022-06-11,Binh Duong,Di An,17,32,17,15,10
2022-06-11,Binh Duong,Di An,18,50,23,27,20
2022-06-11,Binh Duong,Di An,19,45,28,17,13
2022-06-11,Binh Duong,Di An,20,31,22,9,4
2022-06-11,Binh Duong,Di An,21,11,3,8,8
2022-06-11,Binh Duong,Di An,23,1,0,1,0
2022-06-11,Binh Duong,Tan Uyen,8,3,0,3,3
2022-06-11,Binh Duong,Tan Uyen,9,8,2,6,4
2022-06-11,Binh Duong,Tan Uyen,10,5,3,2,0
2022-06-11,Binh Duong,Tan Uyen,11,5,3,2,2
2022-06-11,Binh Duong,Tan Uyen,12,5,4,1,0
2022-06-11,Binh Duong,Tan Uyen,13,6,1,5,4
2022-06-11,Binh Duong,Tan Uyen,14,5,3,2,2
2022-06-11,Binh Duong,Tan Uyen,15,4,2,2,0
2022-06-11,Binh Duong,Tan Uyen,16,3,2,1,1
2022-06-11,Binh Duong,Tan Uyen,17,4,2,2,2
2022-06-11,Binh Duong,Tan Uyen,18,6,3,3,2
2022-06-11,Binh Duong,Tan Uyen,19,2,0,2,2
2022-06-11,Binh Duong,Tan Uyen,20,2,1,1,1
2022-06-11,Binh Duong,Tan Uyen,21,1,0,1,1
2022-06-11,Binh Duong,Thu Dau Mot Town,0,1,1,0,0
2022-06-11,Binh Duong,Thu Dau Mot Town,2,1,1,0,0
2022-06-11,Binh Duong,Thu Dau Mot Town,6,32,28,4,2
2022-06-11,Binh Duong,Thu Dau Mot Town,7,147,129,18,7
2022-06-11,Binh Duong,Thu Dau Mot Town,8,280,251,29,5
2022-06-11,Binh Duong,Thu Dau Mot Town,9,310,287,23,5
2022-06-11,Binh Duong,Thu Dau Mot Town,10,462,428,34,11
2022-06-11,Binh Duong,Thu Dau Mot Town,11,663,620,43,8
2022-06-11,Binh Duong,Thu Dau Mot Town,12,628,580,48,6
2022-06-11,Binh Duong,Thu Dau Mot Town,13,498,461,37,5
2022-06-11,Binh Duong,Thu Dau Mot Town,14,404,380,24,2
2022-06-11,Binh Duong,Thu Dau Mot Town,15,354,331,23,1
2022-06-11,Binh Duong,Thu Dau Mot Town,16,320,305,15,0
2022-06-11,Binh Duong,Thu Dau Mot Town,17,335,322,13,5
2022-06-11,Binh Duong,Thu Dau Mot Town,18,446,400,46,9
2022-06-11,Binh Duong,Thu Dau Mot Town,19,440,405,35,4
2022-06-11,Binh Duong,Thu Dau Mot Town,20,306,274,32,5
2022-06-11,Binh Duong,Thu Dau Mot Town,21,160,127,33,12
2022-06-11,Binh Duong,Thu Dau Mot Town,22,3,1,2,0
2022-06-11,Binh Duong,Thuan An,0,1,0,1,0
2022-06-11,Binh Duong,Thuan An,6,5,0,5,3
2022-06-11,Binh Duong,Thuan An,7,12,7,5,3
2022-06-11,Binh Duong,Thuan An,8,25,15,10,8
2022-06-11,Binh Duong,Thuan An,9,52,32,20,14
2022-06-11,Binh Duong,Thuan An,10,90,62,28,20
2022-06-11,Binh Duong,Thuan An,11,83,55,28,23
2022-06-11,Binh Duong,Thuan An,12,107,66,41,35
2022-06-11,Binh Duong,Thuan An,13,114,59,55,43
2022-06-11,Binh Duong,Thuan An,14,68,41,27,22
2022-06-11,Binh Duong,Thuan An,15,46,38,8,4
2022-06-11,Binh Duong,Thuan An,16,61,49,12,4
2022-06-11,Binh Duong,Thuan An,17,62,44,18,12
2022-06-11,Binh Duong,Thuan An,18,65,47,18,12
2022-06-11,Binh Duong,Thuan An,19,65,40,25,15
2022-06-11,Binh Duong,Thuan An,20,45,31,14,12
2022-06-11,Binh Duong,Thuan An,21,26,11,15,12
2022-06-11,Binh Duong,Thuan An,22,1,0,1,1
2022-06-11,Can Tho City,Binh Thuy District,8,7,5,2,1
2022-06-11,Can Tho City,Binh Thuy District,9,5,5,0,0
2022-06-11,Can Tho City,Binh Thuy District,10,12,11,1,0
2022-06-11,Can Tho City,Binh Thuy District,11,8,7,1,0
2022-06-11,Can Tho City,Binh Thuy District,12,16,16,0,0
2022-06-11,Can Tho City,Binh Thuy District,13,7,7,0,0
2022-06-11,Can Tho City,Binh Thuy District,14,9,9,0,0
2022-06-11,Can Tho City,Binh Thuy District,15,12,12,0,0
2022-06-11,Can Tho City,Binh Thuy District,16,17,17,0,0
2022-06-11,Can Tho City,Binh Thuy District,17,19,17,2,0
2022-06-11,Can Tho City,Binh Thuy District,18,19,16,3,2
2022-06-11,Can Tho City,Binh Thuy District,19,10,8,2,1
2022-06-11,Can Tho City,Binh Thuy District,20,14,14,0,0
2022-06-11,Can Tho City,Binh Thuy District,21,5,3,2,0
2022-06-11,Can Tho City,Cai Rang District,6,7,3,4,4
2022-06-11,Can Tho City,Cai Rang District,7,4,4,0,0
2022-06-11,Can Tho City,Cai Rang District,8,6,6,0,0
2022-06-11,Can Tho City,Cai Rang District,9,8,8,0,0
2022-06-11,Can Tho City,Cai Rang District,10,10,10,0,0
2022-06-11,Can Tho City,Cai Rang District,11,29,25,4,0
2022-06-11,Can Tho City,Cai Rang District,12,15,12,3,1
2022-06-11,Can Tho City,Cai Rang District,13,12,12,0,0
2022-06-11,Can Tho City,Cai Rang District,14,12,11,1,1
2022-06-11,Can Tho City,Cai Rang District,15,10,9,1,0
2022-06-11,Can Tho City,Cai Rang District,16,11,11,0,0
2022-06-11,Can Tho City,Cai Rang District,17,10,10,0,0
2022-06-11,Can Tho City,Cai Rang District,18,15,13,2,0
2022-06-11,Can Tho City,Cai Rang District,19,8,7,1,0
2022-06-11,Can Tho City,Cai Rang District,20,15,14,1,0
2022-06-11,Can Tho City,Cai Rang District,21,7,5,2,2
2022-06-11,Can Tho City,Cai Rang District,23,1,0,1,1
2022-06-11,Can Tho City,Ninh Kieu District,0,2,2,0,0
2022-06-11,Can Tho City,Ninh Kieu District,1,1,0,1,0
2022-06-11,Can Tho City,Ninh Kieu District,5,2,1,1,0
2022-06-11,Can Tho City,Ninh Kieu District,6,41,39,2,0
2022-06-11,Can Tho City,Ninh Kieu District,7,133,123,10,1
2022-06-11,Can Tho City,Ninh Kieu District,8,243,230,13,0
2022-06-11,Can Tho City,Ninh Kieu District,9,322,309,13,2
2022-06-11,Can Tho City,Ninh Kieu District,10,547,530,17,0
2022-06-11,Can Tho City,Ninh Kieu District,11,844,795,49,3
2022-06-11,Can Tho City,Ninh Kieu District,12,746,717,29,1
2022-06-11,Can Tho City,Ninh Kieu District,13,565,529,36,0
2022-06-11,Can Tho City,Ninh Kieu District,14,501,473,28,1
2022-06-11,Can Tho City,Ninh Kieu District,15,423,405,18,1
2022-06-11,Can Tho City,Ninh Kieu District,16,407,388,19,0
2022-06-11,Can Tho City,Ninh Kieu District,17,542,513,29,0
2022-06-11,Can Tho City,Ninh Kieu District,18,611,591,20,0
2022-06-11,Can Tho City,Ninh Kieu District,19,514,495,19,0
2022-06-11,Can Tho City,Ninh Kieu District,20,337,309,28,1
2022-06-11,Can Tho City,Ninh Kieu District,21,204,186,18,2
2022-06-11,Can Tho City,Ninh Kieu District,22,2,1,1,0
2022-06-11,Can Tho City,Ninh Kieu District,23,1,1,0,0
2022-06-11,Dong Nai,Bien Hoa City,0,1,1,0,0
2022-06-11,Dong Nai,Bien Hoa City,1,2,1,1,0
2022-06-11,Dong Nai,Bien Hoa City,2,3,2,1,0
2022-06-11,Dong Nai,Bien Hoa City,3,1,1,0,0
2022-06-11,Dong Nai,Bien Hoa City,4,1,1,0,0
2022-06-11,Dong Nai,Bien Hoa City,5,2,0,2,1
2022-06-11,Dong Nai,Bien Hoa City,6,59,42,17,5
2022-06-11,Dong Nai,Bien Hoa City,7,159,139,20,6
2022-06-11,Dong Nai,Bien Hoa City,8,342,306,36,11
2022-06-11,Dong Nai,Bien Hoa City,9,547,490,57,15
2022-06-11,Dong Nai,Bien Hoa City,10,857,776,81,24
2022-06-11,Dong Nai,Bien Hoa City,11,1174,1078,96,27
2022-06-11,Dong Nai,Bien Hoa City,12,1082,993,89,30
2022-06-11,Dong Nai,Bien Hoa City,13,918,825,93,20
2022-06-11,Dong Nai,Bien Hoa City,14,713,640,73,24
2022-06-11,Dong Nai,Bien Hoa City,15,643,562,81,26
2022-06-11,Dong Nai,Bien Hoa City,16,586,537,49,24
2022-06-11,Dong Nai,Bien Hoa City,17,687,603,84,37
2022-06-11,Dong Nai,Bien Hoa City,18,746,627,119,57
2022-06-11,Dong Nai,Bien Hoa City,19,890,642,248,144
2022-06-11,Dong Nai,Bien Hoa City,20,669,459,210,126
2022-06-11,Dong Nai,Bien Hoa City,21,327,197,130,74
2022-06-11,Dong Nai,Bien Hoa City,22,9,1,8,2
2022-06-11,Dong Nai,Bien Hoa City,23,1,0,1,1
2022-06-11,Dong Nai,Cam My,19,2,0,2,2
2022-06-11,Dong Nai,Long Khanh,8,1,0,1,0
2022-06-11,Dong Nai,Long Khanh,12,1,0,1,1
2022-06-11,Dong Nai,Long Thanh,9,1,0,1,1
2022-06-11,Dong Nai,Long Thanh,10,2,0,2,1
2022-06-11,Dong Nai,Long Thanh,15,5,0,5,5
2022-06-11,Dong Nai,Long Thanh,18,1,0,1,1
2022-06-11,Dong Nai,Long Thanh,19,4,0,4,4
2022-06-11,Dong Nai,Long Thanh,21,1,0,1,1
2022-06-11,Dong Nai,Nhon trach,10,2,0,2,2
2022-06-11,Dong Nai,Nhon trach,18,1,0,1,1
2022-06-11,Dong Nai,Trang Bom,9,2,0,2,2
2022-06-11,Dong Nai,Trang Bom,10,4,0,4,4
2022-06-11,Dong Nai,Trang Bom,11,1,0,1,1
2022-06-11,Dong Nai,Trang Bom,12,1,0,1,1
2022-06-11,Dong Nai,Trang Bom,17,1,0,1,1
2022-06-11,Dong Nai,Trang Bom,18,2,0,2,2
2022-06-11,Dong Nai,Trang Bom,20,1,0,1,1
2022-06-11,Dong Nai,Trang Bom,21,1,0,1,1
2022-06-11,Hai Phong City,An Duong,7,2,1,1,1
2022-06-11,Hai Phong City,An Duong,8,3,1,2,1
2022-06-11,Hai Phong City,An Duong,9,1,1,0,0
2022-06-11,Hai Phong City,An Duong,10,1,1,0,0
2022-06-11,Hai Phong City,An Duong,11,7,6,1,1
2022-06-11,Hai Phong City,An Duong,12,6,2,4,4
2022-06-11,Hai Phong City,An Duong,13,8,3,5,4
2022-06-11,Hai Phong City,An Duong,14,5,4,1,0
2022-06-11,Hai Phong City,An Duong,15,4,1,3,1
2022-06-11,Hai Phong City,An Duong,16,1,0,1,1
2022-06-11,Hai Phong City,An Duong,17,3,2,1,0
2022-06-11,Hai Phong City,An Duong,18,3,0,3,2
2022-06-11,Hai Phong City,An Duong,19,2,2,0,0
2022-06-11,Hai Phong City,An Duong,20,3,2,1,0
2022-06-11,Hai Phong City,An Duong,21,1,1,0,0
2022-06-11,Hai Phong City,Do Son District,20,1,0,1,1
2022-06-11,Hai Phong City,Duong Kinh District,12,1,0,1,1
2022-06-11,Hai Phong City,Duong Kinh District,17,1,0,1,1
2022-06-11,Hai Phong City,Duong Kinh District,20,1,0,1,1
2022-06-11,Hai Phong City,Hai An District,0,1,0,1,0
2022-06-11,Hai Phong City,Hai An District,6,1,0,1,1
2022-06-11,Hai Phong City,Hai An District,7,4,3,1,0
2022-06-11,Hai Phong City,Hai An District,8,8,7,1,1
2022-06-11,Hai Phong City,Hai An District,9,13,10,3,1
2022-06-11,Hai Phong City,Hai An District,10,32,24,8,2
2022-06-11,Hai Phong City,Hai An District,11,54,44,10,2
2022-06-11,Hai Phong City,Hai An District,12,31,24,7,1
2022-06-11,Hai Phong City,Hai An District,13,27,19,8,3
2022-06-11,Hai Phong City,Hai An District,14,19,10,9,7
2022-06-11,Hai Phong City,Hai An District,15,21,12,9,5
2022-06-11,Hai Phong City,Hai An District,16,22,15,7,3
2022-06-11,Hai Phong City,Hai An District,17,26,23,3,1
2022-06-11,Hai Phong City,Hai An District,18,24,19,5,0
2022-06-11,Hai Phong City,Hai An District,19,22,17,5,1
2022-06-11,Hai Phong City,Hai An District,20,20,19,1,0
2022-06-11,Hai Phong City,Hai An District,21,13,8,5,1
2022-06-11,Hai Phong City,Hong Bang District,7,13,11,2,0
2022-06-11,Hai Phong City,Hong Bang District,8,38,26,12,2
2022-06-11,Hai Phong City,Hong Bang District,9,43,38,5,0
2022-06-11,Hai Phong City,Hong Bang District,10,66,55,11,0
2022-06-11,Hai Phong City,Hong Bang District,11,87,78,9,5
2022-06-11,Hai Phong City,Hong Bang District,12,86,77,9,4
2022-06-11,Hai Phong City,Hong Bang District,13,36,33,3,0
2022-06-11,Hai Phong City,Hong Bang District,14,35,27,8,6
2022-06-11,Hai Phong City,Hong Bang District,15,46,35,11,4
2022-06-11,Hai Phong City,Hong Bang District,16,31,28,3,1
2022-06-11,Hai Phong City,Hong Bang District,17,52,46,6,0
2022-06-11,Hai Phong City,Hong Bang District,18,56,42,14,6
2022-06-11,Hai Phong City,Hong Bang District,19,51,38,13,9
2022-06-11,Hai Phong City,Hong Bang District,20,35,27,8,4
2022-06-11,Hai Phong City,Hong Bang District,21,11,9,2,0
2022-06-11,Hai Phong City,Kien An District,7,3,0,3,2
2022-06-11,Hai Phong City,Kien An District,8,1,1,0,0
2022-06-11,Hai Phong City,Kien An District,9,4,2,2,0
2022-06-11,Hai Phong City,Kien An District,10,9,7,2,1
2022-06-11,Hai Phong City,Kien An District,11,13,9,4,3
2022-06-11,Hai Phong City,Kien An District,12,15,6,9,9
2022-06-11,Hai Phong City,Kien An District,13,16,3,13,10
2022-06-11,Hai Phong City,Kien An District,14,9,4,5,4
2022-06-11,Hai Phong City,Kien An District,15,7,1,6,4
2022-06-11,Hai Phong City,Kien An District,16,13,3,10,9
2022-06-11,Hai Phong City,Kien An District,17,9,3,6,3
2022-06-11,Hai Phong City,Kien An District,18,7,5,2,2
2022-06-11,Hai Phong City,Kien An District,19,12,5,7,5
2022-06-11,Hai Phong City,Kien An District,20,7,3,4,2
2022-06-11,Hai Phong City,Kien An District,21,11,4,7,7
2022-06-11,Hai Phong City,Le Chan District,1,1,1,0,0
2022-06-11,Hai Phong City,Le Chan District,3,1,0,1,0
2022-06-11,Hai Phong City,Le Chan District,6,3,1,2,1
2022-06-11,Hai Phong City,Le Chan District,7,44,37,7,1
2022-06-11,Hai Phong City,Le Chan District,8,79,68,11,2
2022-06-11,Hai Phong City,Le Chan District,9,94,84,10,1
2022-06-11,Hai Phong City,Le Chan District,10,194,169,25,8
2022-06-11,Hai Phong City,Le Chan District,11,335,293,42,18
2022-06-11,Hai Phong City,Le Chan District,12,242,215,27,6
2022-06-11,Hai Phong City,Le Chan District,13,143,128,15,6
2022-06-11,Hai Phong City,Le Chan District,14,144,130,14,8
2022-06-11,Hai Phong City,Le Chan District,15,201,161,40,19
2022-06-11,Hai Phong City,Le Chan District,16,168,140,28,9
2022-06-11,Hai Phong City,Le Chan District,17,195,161,34,9
2022-06-11,Hai Phong City,Le Chan District,18,230,202,28,15
2022-06-11,Hai Phong City,Le Chan District,19,227,187,40,20
2022-06-11,Hai Phong City,Le Chan District,20,141,114,27,5
2022-06-11,Hai Phong City,Le Chan District,21,67,45,22,10
2022-06-11,Hai Phong City,Le Chan District,22,1,0,1,0
2022-06-11,Hai Phong City,Le Chan District,23,2,1,1,1
2022-06-11,Hai Phong City,Ngo Quyen District,3,1,1,0,0
2022-06-11,Hai Phong City,Ngo Quyen District,7,19,14,5,3
2022-06-11,Hai Phong City,Ngo Quyen District,8,55,45,10,3
2022-06-11,Hai Phong City,Ngo Quyen District,9,67,61,6,0
2022-06-11,Hai Phong City,Ngo Quyen District,10,145,130,15,2
2022-06-11,Hai Phong City,Ngo Quyen District,11,231,206,25,12
2022-06-11,Hai Phong City,Ngo Quyen District,12,161,143,18,9
2022-06-11,Hai Phong City,Ngo Quyen District,13,116,107,9,1
2022-06-11,Hai Phong City,Ngo Quyen District,14,152,116,36,22
2022-06-11,Hai Phong City,Ngo Quyen District,15,146,116,30,20
2022-06-11,Hai Phong City,Ngo Quyen District,16,121,104,17,4
2022-06-11,Hai Phong City,Ngo Quyen District,17,138,116,22,5
2022-06-11,Hai Phong City,Ngo Quyen District,18,164,144,20,7
2022-06-11,Hai Phong City,Ngo Quyen District,19,181,139,42,13
2022-06-11,Hai Phong City,Ngo Quyen District,20,116,94,22,1
2022-06-11,Hai Phong City,Ngo Quyen District,21,72,53,19,8
2022-06-11,Hai Phong City,Ngo Quyen District,22,1,0,1,0
2022-06-11,Hai Phong City,Thuy Nguyen,8,1,0,1,1
2022-06-11,Hai Phong City,Thuy Nguyen,9,1,0,1,1
2022-06-11,Hai Phong City,Thuy Nguyen,11,4,0,4,4
2022-06-11,Hai Phong City,Thuy Nguyen,13,4,0,4,4
2022-06-11,Hai Phong City,Thuy Nguyen,14,4,0,4,3
2022-06-11,Hai Phong City,Thuy Nguyen,15,1,0,1,1
2022-06-11,Hai Phong City,Thuy Nguyen,16,4,0,4,3
2022-06-11,Hai Phong City,Thuy Nguyen,18,1,0,1,1
2022-06-11,Hai Phong City,Thuy Nguyen,19,3,0,3,3
2022-06-11,Hai Phong City,Thuy Nguyen,21,1,0,1,1
2022-06-11,Hue City,Hue City,0,1,1,0,0
2022-06-11,Hue City,Hue City,2,2,1,1,0
2022-06-11,Hue City,Hue City,4,1,0,1,0
2022-06-11,Hue City,Hue City,5,3,2,1,0
2022-06-11,Hue City,Hue City,6,98,76,22,5
2022-06-11,Hue City,Hue City,7,207,193,14,0
2022-06-11,Hue City,Hue City,8,329,306,23,0
2022-06-11,Hue City,Hue City,9,344,322,22,1
2022-06-11,Hue City,Hue City,10,467,437,30,0
2022-06-11,Hue City,Hue City,11,938,851,87,14
2022-06-11,Hue City,Hue City,12,676,626,50,1
2022-06-11,Hue City,Hue City,13,415,372,43,0
2022-06-11,Hue City,Hue City,14,349,327,22,4
2022-06-11,Hue City,Hue City,15,458,418,40,8
2022-06-11,Hue City,Hue City,16,448,412,36,3
2022-06-11,Hue City,Hue City,17,439,404,35,3
2022-06-11,Hue City,Hue City,18,599,562,37,2
2022-06-11,Hue City,Hue City,19,664,587,77,15
2022-06-11,Hue City,Hue City,20,459,372,87,17
2022-06-11,Hue City,Hue City,21,281,205,76,36
2022-06-11,Hue City,Hue City,22,3,1,2,0
2022-06-11,Hue City,Hue City,23,1,1,0,0
2022-06-11,Hue City,Huong Thuy,7,2,1,1,1
2022-06-11,Hue City,Huong Thuy,10,1,1,0,0
2022-06-11,Hue City,Huong Thuy,11,3,3,0,0
2022-06-11,Hue City,Huong Thuy,12,2,2,0,0
2022-06-11,Hue City,Huong Thuy,13,2,1,1,0
2022-06-11,Hue City,Huong Thuy,14,1,1,0,0
2022-06-11,Hue City,Huong Thuy,16,2,1,1,1
2022-06-11,Hue City,Huong Thuy,18,3,2,1,0
2022-06-11,Hue City,Huong Thuy,19,4,1,3,0
2022-06-11,Hue City,Huong Thuy,20,1,0,1,1
2022-06-11,Hue City,Huong Tra,13,1,1,0,0
2022-06-11,Hue City,Phu Vang,7,1,1,0,0
2022-06-11,Hue City,Phu Vang,9,1,1,0,0
2022-06-11,Hue City,Phu Vang,10,3,3,0,0
2022-06-11,Hue City,Phu Vang,11,2,2,0,0
2022-06-11,Hue City,Phu Vang,12,2,1,1,1
2022-06-11,Hue City,Phu Vang,13,3,3,0,0
2022-06-11,Hue City,Phu Vang,14,3,1,2,1
2022-06-11,Hue City,Phu Vang,15,5,1,4,3
2022-06-11,Hue City,Phu Vang,16,3,2,1,1
2022-06-11,Hue City,Phu Vang,17,2,1,1,0
2022-06-11,Hue City,Phu Vang,18,2,2,0,0
2022-06-11,Hue City,Phu Vang,19,1,1,0,0
2022-06-11,Hue City,Phu Vang,20,1,0,1,0
2022-06-11,Khanh Hoa,Cam Ranh City,12,1,0,1,0
2022-06-11,Khanh Hoa,Dien Khanh,7,1,0,1,1
2022-06-11,Khanh Hoa,Dien Khanh,8,1,0,1,1
2022-06-11,Khanh Hoa,Dien Khanh,10,1,0,1,1
2022-06-11,Khanh Hoa,Dien Khanh,15,1,0,1,1
2022-06-11,Khanh Hoa,Dien Khanh,16,1,0,1,1
2022-06-11,Khanh Hoa,Nha Trang City,0,1,1,0,0
2022-06-11,Khanh Hoa,Nha Trang City,5,1,1,0,0
2022-06-11,Khanh Hoa,Nha Trang City,6,43,35,8,0
2022-06-11,Khanh Hoa,Nha Trang City,7,125,112,13,2
2022-06-11,Khanh Hoa,Nha Trang City,8,216,203,13,0
2022-06-11,Khanh Hoa,Nha Trang City,9,182,168,14,1
2022-06-11,Khanh Hoa,Nha Trang City,10,215,200,15,4
2022-06-11,Khanh Hoa,Nha Trang City,11,377,348,29,2
2022-06-11,Khanh Hoa,Nha Trang City,12,340,314,26,2
2022-06-11,Khanh Hoa,Nha Trang City,13,262,251,11,0
2022-06-11,Khanh Hoa,Nha Trang City,14,221,205,16,0
2022-06-11,Khanh Hoa,Nha Trang City,15,221,193,28,5
2022-06-11,Khanh Hoa,Nha Trang City,16,235,219,16,2
2022-06-11,Khanh Hoa,Nha Trang City,17,221,200,21,0
2022-06-11,Khanh Hoa,Nha Trang City,18,316,296,20,2
2022-06-11,Khanh Hoa,Nha Trang City,19,288,268,20,0
2022-06-11,Khanh Hoa,Nha Trang City,20,206,183,23,3
2022-06-11,Khanh Hoa,Nha Trang City,21,141,105,36,13
2022-06-11,Khanh Hoa,Nha Trang City,22,3,1,2,0
2022-06-11,Lam Dong,Bao Loc City,9,2,0,2,0
2022-06-11,Lam Dong,Bao Loc City,10,1,0,1,0
2022-06-11,Lam Dong,Da Lat City,4,1,0,1,1
2022-06-11,Lam Dong,Da Lat City,6,5,2,3,1
2022-06-11,Lam Dong,Da Lat City,7,64,41,23,20
2022-06-11,Lam Dong,Da Lat City,8,87,71,16,9
2022-06-11,Lam Dong,Da Lat City,9,105,87,18,4
2022-06-11,Lam Dong,Da Lat City,10,133,102,31,9
2022-06-11,Lam Dong,Da Lat City,11,151,130,21,10
2022-06-11,Lam Dong,Da Lat City,12,186,131,55,43
2022-06-11,Lam Dong,Da Lat City,13,143,109,34,29
2022-06-11,Lam Dong,Da Lat City,14,135,80,55,40
2022-06-11,Lam Dong,Da Lat City,15,175,98,77,61
2022-06-11,Lam Dong,Da Lat City,16,160,92,68,55
2022-06-11,Lam Dong,Da Lat City,17,184,104,80,63
2022-06-11,Lam Dong,Da Lat City,18,196,114,82,58
2022-06-11,Lam Dong,Da Lat City,19,176,97,79,64
2022-06-11,Lam Dong,Da Lat City,20,147,63,84,67
2022-06-11,Lam Dong,Da Lat City,21,107,42,65,46
2022-06-11,Lam Dong,Da Lat City,22,4,0,4,2
2022-06-11,Lam Dong,Da Lat City,23,1,0,1,0
2022-06-11,Nghe An,Vinh City,0,1,0,1,0
2022-06-11,Nghe An,Vinh City,4,1,0,1,0
2022-06-11,Nghe An,Vinh City,6,4,1,3,0
2022-06-11,Nghe An,Vinh City,7,139,120,19,0
2022-06-11,Nghe An,Vinh City,8,177,162,15,0
2022-06-11,Nghe An,Vinh City,9,174,161,13,1
2022-06-11,Nghe An,Vinh City,10,221,187,34,12
2022-06-11,Nghe An,Vinh City,11,466,366,100,51
2022-06-11,Nghe An,Vinh City,12,277,227,50,17
2022-06-11,Nghe An,Vinh City,13,138,121,17,2
2022-06-11,Nghe An,Vinh City,14,203,174,29,11
2022-06-11,Nghe An,Vinh City,15,190,163,27,8
2022-06-11,Nghe An,Vinh City,16,145,130,15,4
2022-06-11,Nghe An,Vinh City,17,179,147,32,8
2022-06-11,Nghe An,Vinh City,18,238,202,36,15
2022-06-11,Nghe An,Vinh City,19,190,140,50,22
2022-06-11,Nghe An,Vinh City,20,177,93,84,47
2022-06-11,Nghe An,Vinh City,21,116,42,74,43
2022-06-11,Quang Nam,Hoi An City,6,1,0,1,1
2022-06-11,Quang Nam,Hoi An City,7,22,12,10,9
2022-06-11,Quang Nam,Hoi An City,8,19,10,9,3
2022-06-11,Quang Nam,Hoi An City,9,21,18,3,1
2022-06-11,Quang Nam,Hoi An City,10,27,24,3,0
2022-06-11,Quang Nam,Hoi An City,11,57,36,21,17
2022-06-11,Quang Nam,Hoi An City,12,67,46,21,14
2022-06-11,Quang Nam,Hoi An City,13,40,33,7,4
2022-06-11,Quang Nam,Hoi An City,14,61,43,18,16
2022-06-11,Quang Nam,Hoi An City,15,68,48,20,13
2022-06-11,Quang Nam,Hoi An City,16,55,42,13,8
2022-06-11,Quang Nam,Hoi An City,17,46,36,10,6
2022-06-11,Quang Nam,Hoi An City,18,76,48,28,18
2022-06-11,Quang Nam,Hoi An City,19,105,53,52,30
2022-06-11,Quang Nam,Hoi An City,20,95,37,58,46
2022-06-11,Quang Nam,Hoi An City,21,60,14,46,36
2022-06-11,Quang Nam,Tam Ky City,13,2,0,2,1
2022-06-11,Quang Ninh,Cam Pha City,10,1,0,1,1
2022-06-11,Quang Ninh,Cam Pha City,11,4,0,4,3
2022-06-11,Quang Ninh,Cam Pha City,12,4,0,4,3
2022-06-11,Quang Ninh,Cam Pha City,14,1,0,1,1
2022-06-11,Quang Ninh,Cam Pha City,15,2,0,2,2
2022-06-11,Quang Ninh,Cam Pha City,19,2,0,2,2
2022-06-11,Quang Ninh,Cam Pha City,20,1,0,1,1
2022-06-11,Quang Ninh,Ha Long City,6,1,0,1,1
2022-06-11,Quang Ninh,Ha Long City,7,24,18,6,3
2022-06-11,Quang Ninh,Ha Long City,8,57,39,18,9
2022-06-11,Quang Ninh,Ha Long City,9,47,29,18,15
2022-06-11,Quang Ninh,Ha Long City,10,53,44,9,4
2022-06-11,Quang Ninh,Ha Long City,11,109,92,17,7
2022-06-11,Quang Ninh,Ha Long City,12,99,67,32,14
2022-06-11,Quang Ninh,Ha Long City,13,78,54,24,13
2022-06-11,Quang Ninh,Ha Long City,14,76,62,14,9
2022-06-11,Quang Ninh,Ha Long City,15,71,49,22,13
2022-06-11,Quang Ninh,Ha Long City,16,73,45,28,16
2022-06-11,Quang Ninh,Ha Long City,17,65,41,24,15
2022-06-11,Quang Ninh,Ha Long City,18,70,41,29,18
2022-06-11,Quang Ninh,Ha Long City,19,94,63,31,15
2022-06-11,Quang Ninh,Ha Long City,20,77,40,37,21
2022-06-11,Quang Ninh,Ha Long City,21,3,0,3,0
2022-06-11,Thai Nguyen,Dong Hy,7,1,1,0,0
2022-06-11,Thai Nguyen,Dong Hy,10,2,0,2,2
2022-06-11,Thai Nguyen,Dong Hy,11,3,2,1,1
2022-06-11,Thai Nguyen,Dong Hy,16,1,0,1,1
2022-06-11,Thai Nguyen,Dong Hy,17,1,0,1,0
2022-06-11,Thai Nguyen,Dong Hy,19,1,0,1,1
2022-06-11,Thai Nguyen,Dong Hy,20,1,1,0,0
2022-06-11,Thai Nguyen,Dong Hy,21,1,1,0,0
2022-06-11,Thai Nguyen,Thai Nguyen City,0,4,3,1,0
2022-06-11,Thai Nguyen,Thai Nguyen City,1,3,3,0,0
2022-06-11,Thai Nguyen,Thai Nguyen City,4,1,0,1,0
2022-06-11,Thai Nguyen,Thai Nguyen City,6,10,6,4,1
2022-06-11,Thai Nguyen,Thai Nguyen City,7,126,95,31,15
2022-06-11,Thai Nguyen,Thai Nguyen City,8,182,165,17,5
2022-06-11,Thai Nguyen,Thai Nguyen City,9,134,123,11,1
2022-06-11,Thai Nguyen,Thai Nguyen City,10,206,185,21,2
2022-06-11,Thai Nguyen,Thai Nguyen City,11,440,391,49,9
2022-06-11,Thai Nguyen,Thai Nguyen City,12,307,274,33,7
2022-06-11,Thai Nguyen,Thai Nguyen City,13,172,162,10,1
2022-06-11,Thai Nguyen,Thai Nguyen City,14,177,158,19,0
2022-06-11,Thai Nguyen,Thai Nguyen City,15,147,131,16,2
2022-06-11,Thai Nguyen,Thai Nguyen City,16,132,122,10,1
2022-06-11,Thai Nguyen,Thai Nguyen City,17,179,166,13,1
2022-06-11,Thai Nguyen,Thai Nguyen City,18,241,222,19,1
2022-06-11,Thai Nguyen,Thai Nguyen City,19,294,261,33,4
2022-06-11,Thai Nguyen,Thai Nguyen City,20,190,165,25,1
2022-06-11,Thai Nguyen,Thai Nguyen City,21,147,111,36,16
2022-06-11,Thai Nguyen,Thai Nguyen City,22,1,0,1,0
2022-06-11,Thai Nguyen,Thai Nguyen City,23,1,1,0,0
2022-06-11,Vung Tau,Ba Ria City,7,1,1,0,0
2022-06-11,Vung Tau,Ba Ria City,8,2,1,1,1
2022-06-11,Vung Tau,Ba Ria City,9,4,1,3,3
2022-06-11,Vung Tau,Ba Ria City,10,5,4,1,1
2022-06-11,Vung Tau,Ba Ria City,11,14,8,6,3
2022-06-11,Vung Tau,Ba Ria City,12,5,3,2,1
2022-06-11,Vung Tau,Ba Ria City,13,5,1,4,2
2022-06-11,Vung Tau,Ba Ria City,14,14,5,9,8
2022-06-11,Vung Tau,Ba Ria City,15,2,2,0,0
2022-06-11,Vung Tau,Ba Ria City,16,4,4,0,0
2022-06-11,Vung Tau,Ba Ria City,17,8,4,4,3
2022-06-11,Vung Tau,Ba Ria City,18,1,1,0,0
2022-06-11,Vung Tau,Ba Ria City,19,6,3,3,1
2022-06-11,Vung Tau,Ba Ria City,20,5,0,5,4
2022-06-11,Vung Tau,Ba Ria City,21,4,0,4,4
2022-06-11,Vung Tau,Chau Duc,15,2,0,2,2
2022-06-11,Vung Tau,Chau Duc,16,2,0,2,0
2022-06-11,Vung Tau,Tan Thanh,11,1,0,1,1
2022-06-11,Vung Tau,Tan Thanh,13,1,0,1,1
2022-06-11,Vung Tau,Vung Tau City,1,1,1,0,0
2022-06-11,Vung Tau,Vung Tau City,2,2,1,1,0
2022-06-11,Vung Tau,Vung Tau City,5,2,0,2,1
2022-06-11,Vung Tau,Vung Tau City,6,45,33,12,6
2022-06-11,Vung Tau,Vung Tau City,7,128,120,8,3
2022-06-11,Vung Tau,Vung Tau City,8,228,219,9,1
2022-06-11,Vung Tau,Vung Tau City,9,207,197,10,1
2022-06-11,Vung Tau,Vung Tau City,10,298,282,16,1
2022-06-11,Vung Tau,Vung Tau City,11,431,393,38,7
2022-06-11,Vung Tau,Vung Tau City,12,386,355,31,3
2022-06-11,Vung Tau,Vung Tau City,13,275,254,21,2
2022-06-11,Vung Tau,Vung Tau City,14,279,266,13,1
2022-06-11,Vung Tau,Vung Tau City,15,258,241,17,1
2022-06-11,Vung Tau,Vung Tau City,16,226,206,20,7
2022-06-11,Vung Tau,Vung Tau City,17,306,283,23,7
2022-06-11,Vung Tau,Vung Tau City,18,345,302,43,8
2022-06-11,Vung Tau,Vung Tau City,19,341,294,47,15
2022-06-11,Vung Tau,Vung Tau City,20,241,182,59,19
2022-06-11,Vung Tau,Vung Tau City,21,193,105,88,54
2022-06-11,Vung Tau,Vung Tau City,22,7,0,7,2
2022-06-11,Vung Tau,Vung Tau City,23,2,0,2,1
2022-06-12,Bac Ninh,Bác Ninh City,2,1,0,1,0
2022-06-12,Bac Ninh,Bác Ninh City,6,5,4,1,1
2022-06-12,Bac Ninh,Bác Ninh City,7,59,53,6,3
2022-06-12,Bac Ninh,Bác Ninh City,8,114,103,11,0
2022-06-12,Bac Ninh,Bác Ninh City,9,135,115,20,1
2022-06-12,Bac Ninh,Bác Ninh City,10,202,185,17,2
2022-06-12,Bac Ninh,Bác Ninh City,11,406,288,118,81
2022-06-12,Bac Ninh,Bác Ninh City,12,349,253,96,63
2022-06-12,Bac Ninh,Bác Ninh City,13,180,162,18,5
2022-06-12,Bac Ninh,Bác Ninh City,14,162,144,18,8
2022-06-12,Bac Ninh,Bác Ninh City,15,164,124,40,20
2022-06-12,Bac Ninh,Bác Ninh City,16,141,120,21,0
2022-06-12,Bac Ninh,Bác Ninh City,17,156,132,24,3
2022-06-12,Bac Ninh,Bác Ninh City,18,192,170,22,9
2022-06-12,Bac Ninh,Bác Ninh City,19,230,145,85,59
2022-06-12,Bac Ninh,Bác Ninh City,20,242,106,136,107
2022-06-12,Bac Ninh,Bác Ninh City,21,144,54,90,71
2022-06-12,Bac Ninh,Bác Ninh City,22,1,0,1,0
2022-06-12,Bac Ninh,Que Vo,9,1,0,1,0
2022-06-12,Bac Ninh,Que Vo,12,3,1,2,2
2022-06-12,Bac Ninh,Que Vo,14,1,1,0,0
2022-06-12,Bac Ninh,Que Vo,16,1,0,1,1
2022-06-12,Bac Ninh,Que Vo,17,1,1,0,0
2022-06-12,Bac Ninh,Que Vo,18,1,0,1,1
2022-06-12,Bac Ninh,Que Vo,19,3,1,2,2
2022-06-12,Bac Ninh,Tien Du,8,5,0,5,5
2022-06-12,Bac Ninh,Tien Du,10,1,0,1,1
2022-06-12,Bac Ninh,Tien Du,11,2,0,2,2
2022-06-12,Bac Ninh,Tien Du,12,5,0,5,5
2022-06-12,Bac Ninh,Tien Du,13,4,0,4,4
2022-06-12,Bac Ninh,Tien Du,15,1,0,1,1
2022-06-12,Bac Ninh,Tien Du,16,2,0,2,2
2022-06-12,Bac Ninh,Tien Du,17,2,0,2,2
2022-06-12,Bac Ninh,Tien Du,18,5,0,5,4
2022-06-12,Bac Ninh,Tien Du,19,3,0,3,3
2022-06-12,Bac Ninh,Tien Du,21,1,0,1,1
2022-06-12,Bac Ninh,Tu Son,9,1,0,1,1
2022-06-12,Bac Ninh,Tu Son,11,3,0,3,3
2022-06-12,Bac Ninh,Tu Son,12,2,0,2,2
2022-06-12,Bac Ninh,Tu Son,13,1,0,1,1
2022-06-12,Bac Ninh,Tu Son,15,2,0,2,1
2022-06-12,Bac Ninh,Tu Son,16,2,0,2,2
2022-06-12,Bac Ninh,Tu Son,17,4,1,3,3
2022-06-12,Bac Ninh,Tu Son,18,1,0,1,1
2022-06-12,Binh Duong,Ben Cat,8,1,0,1,1
2022-06-12,Binh Duong,Ben Cat,9,1,0,1,1
2022-06-12,Binh Duong,Ben Cat,10,1,1,0,0
2022-06-12,Binh Duong,Ben Cat,13,1,0,1,1
2022-06-12,Binh Duong,Ben Cat,14,1,0,1,1
2022-06-12,Binh Duong,Ben Cat,15,3,0,3,3
2022-06-12,Binh Duong,Ben Cat,17,2,0,2,2
2022-06-12,Binh Duong,Ben Cat,18,3,0,3,3
2022-06-12,Binh Duong,Ben Cat,19,2,0,2,2
2022-06-12,Binh Duong,Ben Cat,20,2,0,2,2
2022-06-12,Binh Duong,Di An,6,2,0,2,2
2022-06-12,Binh Duong,Di An,7,8,2,6,6
2022-06-12,Binh Duong,Di An,8,19,11,8,8
2022-06-12,Binh Duong,Di An,9,29,16,13,10
2022-06-12,Binh Duong,Di An,10,47,27,20,19
2022-06-12,Binh Duong,Di An,11,79,32,47,42
2022-06-12,Binh Duong,Di An,12,76,44,32,22
2022-06-12,Binh Duong,Di An,13,48,36,12,6
2022-06-12,Binh Duong,Di An,14,45,28,17,15
2022-06-12,Binh Duong,Di An,15,32,15,17,10
2022-06-12,Binh Duong,Di An,16,37,15,22,16
2022-06-12,Binh Duong,Di An,17,56,14,42,38
2022-06-12,Binh Duong,Di An,18,107,24,83,76
2022-06-12,Binh Duong,Di An,19,78,26,52,43
2022-06-12,Binh Duong,Di An,20,27,9,18,14
2022-06-12,Binh Duong,Di An,21,16,5,11,9
2022-06-12,Binh Duong,Tan Uyen,9,2,2,0,0
2022-06-12,Binh Duong,Tan Uyen,10,5,0,5,5
2022-06-12,Binh Duong,Tan Uyen,11,4,2,2,1
2022-06-12,Binh Duong,Tan Uyen,12,5,4,1,1
2022-06-12,Binh Duong,Tan Uyen,13,2,2,0,0
2022-06-12,Binh Duong,Tan Uyen,14,3,1,2,2
2022-06-12,Binh Duong,Tan Uyen,15,2,2,0,0
2022-06-12,Binh Duong,Tan Uyen,16,2,1,1,1
2022-06-12,Binh Duong,Tan Uyen,17,6,1,5,4
2022-06-12,Binh Duong,Tan Uyen,18,9,3,6,5
2022-06-12,Binh Duong,Tan Uyen,19,3,0,3,2
2022-06-12,Binh Duong,Tan Uyen,20,4,0,4,3
2022-06-12,Binh Duong,Tan Uyen,21,1,0,1,1
2022-06-12,Binh Duong,Thu Dau Mot Town,5,4,3,1,1
2022-06-12,Binh Duong,Thu Dau Mot Town,6,35,30,5,4
2022-06-12,Binh Duong,Thu Dau Mot Town,7,127,112,15,1
2022-06-12,Binh Duong,Thu Dau Mot Town,8,248,234,14,0
2022-06-12,Binh Duong,Thu Dau Mot Town,9,331,312,19,0
2022-06-12,Binh Duong,Thu Dau Mot Town,10,472,442,30,4
2022-06-12,Binh Duong,Thu Dau Mot Town,11,668,634,34,3
2022-06-12,Binh Duong,Thu Dau Mot Town,12,628,577,51,15
2022-06-12,Binh Duong,Thu Dau Mot Town,13,457,426,31,8
2022-06-12,Binh Duong,Thu Dau Mot Town,14,346,317,29,2
2022-06-12,Binh Duong,Thu Dau Mot Town,15,329,298,31,8
2022-06-12,Binh Duong,Thu Dau Mot Town,16,375,343,32,10
2022-06-12,Binh Duong,Thu Dau Mot Town,17,571,415,156,103
2022-06-12,Binh Duong,Thu Dau Mot Town,18,703,387,316,261
2022-06-12,Binh Duong,Thu Dau Mot Town,19,638,402,236,174
2022-06-12,Binh Duong,Thu Dau Mot Town,20,369,280,89,48
2022-06-12,Binh Duong,Thu Dau Mot Town,21,129,101,28,8
2022-06-12,Binh Duong,Thuan An,0,1,0,1,1
2022-06-12,Binh Duong,Thuan An,1,2,1,1,1
2022-06-12,Binh Duong,Thuan An,6,7,1,6,4
2022-06-12,Binh Duong,Thuan An,7,4,3,1,1
2022-06-12,Binh Duong,Thuan An,8,27,15,12,9
2022-06-12,Binh Duong,Thuan An,9,38,21,17,11
2022-06-12,Binh Duong,Thuan An,10,83,54,29,25
2022-06-12,Binh Duong,Thuan An,11,121,72,49,33
2022-06-12,Binh Duong,Thuan An,12,105,69,36,24
2022-06-12,Binh Duong,Thuan An,13,94,54,40,30
2022-06-12,Binh Duong,Thuan An,14,51,38,13,7
2022-06-12,Binh Duong,Thuan An,15,80,58,22,16
2022-06-12,Binh Duong,Thuan An,16,59,33,26,24
2022-06-12,Binh Duong,Thuan An,17,79,40,39,34
2022-06-12,Binh Duong,Thuan An,18,96,39,57,47
2022-06-12,Binh Duong,Thuan An,19,92,41,51,43
2022-06-12,Binh Duong,Thuan An,20,74,29,45,35
2022-06-12,Binh Duong,Thuan An,21,32,9,23,18
2022-06-12,Can Tho City,Binh Thuy District,6,1,1,0,0
2022-06-12,Can Tho City,Binh Thuy District,7,3,2,1,0
2022-06-12,Can Tho City,Binh Thuy District,8,3,2,1,1
2022-06-12,Can Tho City,Binh Thuy District,9,10,10,0,0
2022-06-12,Can Tho City,Binh Thuy District,10,9,9,0,0
2022-06-12,Can Tho City,Binh Thuy District,11,16,15,1,0
2022-06-12,Can Tho City,Binh Thuy District,12,19,17,2,0
2022-06-12,Can Tho City,Binh Thuy District,13,13,12,1,0
2022-06-12,Can Tho City,Binh Thuy District,14,8,5,3,2
2022-06-12,Can Tho City,Binh Thuy District,15,10,9,1,0
2022-06-12,Can Tho City,Binh Thuy District,16,13,12,1,0
2022-06-12,Can Tho City,Binh Thuy District,17,13,12,1,0
2022-06-12,Can Tho City,Binh Thuy District,18,20,18,2,0
2022-06-12,Can Tho City,Binh Thuy District,19,18,16,2,0
2022-06-12,Can Tho City,Binh Thuy District,20,7,7,0,0
2022-06-12,Can Tho City,Binh Thuy District,21,3,1,2,1
2022-06-12,Can Tho City,Cai Rang District,6,3,1,2,2
2022-06-12,Can Tho City,Cai Rang District,7,10,5,5,1
2022-06-12,Can Tho City,Cai Rang District,8,14,12,2,0
2022-06-12,Can Tho City,Cai Rang District,9,5,4,1,0
2022-06-12,Can Tho City,Cai Rang District,10,12,11,1,1
2022-06-12,Can Tho City,Cai Rang District,11,13,12,1,0
2022-06-12,Can Tho City,Cai Rang District,12,15,14,1,0
2022-06-12,Can Tho City,Cai Rang District,13,5,4,1,1
2022-06-12,Can Tho City,Cai Rang District,14,7,5,2,2
2022-06-12,Can Tho City,Cai Rang District,15,8,7,1,1
2022-06-12,Can Tho City,Cai Rang District,16,20,17,3,2
2022-06-12,Can Tho City,Cai Rang District,17,12,11,1,1
2022-06-12,Can Tho City,Cai Rang District,18,16,16,0,0
2022-06-12,Can Tho City,Cai Rang District,19,11,10,1,0
2022-06-12,Can Tho City,Cai Rang District,20,3,3,0,0
2022-06-12,Can Tho City,Cai Rang District,21,5,5,0,0
2022-06-12,Can Tho City,Ninh Kieu District,0,1,1,0,0
2022-06-12,Can Tho City,Ninh Kieu District,1,1,1,0,0
2022-06-12,Can Tho City,Ninh Kieu District,3,1,1,0,0
2022-06-12,Can Tho City,Ninh Kieu District,5,2,2,0,0
2022-06-12,Can Tho City,Ninh Kieu District,6,45,41,4,0
2022-06-12,Can Tho City,Ninh Kieu District,7,113,102,11,1
2022-06-12,Can Tho City,Ninh Kieu District,8,253,235,18,0
2022-06-12,Can Tho City,Ninh Kieu District,9,354,328,26,0
2022-06-12,Can Tho City,Ninh Kieu District,10,539,510,29,0
2022-06-12,Can Tho City,Ninh Kieu District,11,795,758,37,3
2022-06-12,Can Tho City,Ninh Kieu District,12,712,690,22,0
2022-06-12,Can Tho City,Ninh Kieu District,13,489,460,29,0
2022-06-12,Can Tho City,Ninh Kieu District,14,360,350,10,0
2022-06-12,Can Tho City,Ninh Kieu District,15,424,405,19,1
2022-06-12,Can Tho City,Ninh Kieu District,16,493,459,34,12
2022-06-12,Can Tho City,Ninh Kieu District,17,608,569,39,4
2022-06-12,Can Tho City,Ninh Kieu District,18,608,576,32,0
2022-06-12,Can Tho City,Ninh Kieu District,19,591,562,29,0
2022-06-12,Can Tho City,Ninh Kieu District,20,383,353,30,3
2022-06-12,Can Tho City,Ninh Kieu District,21,234,208,26,8
2022-06-12,Can Tho City,Ninh Kieu District,22,3,0,3,0
2022-06-12,Can Tho City,O Mon District,9,1,0,1,1
2022-06-12,Dong Nai,Bien Hoa City,0,2,1,1,0
2022-06-12,Dong Nai,Bien Hoa City,1,2,0,2,0
2022-06-12,Dong Nai,Bien Hoa City,3,5,3,2,0
2022-06-12,Dong Nai,Bien Hoa City,4,1,0,1,1
2022-06-12,Dong Nai,Bien Hoa City,5,1,1,0,0
2022-06-12,Dong Nai,Bien Hoa City,6,57,34,23,17
2022-06-12,Dong Nai,Bien Hoa City,7,174,132,42,22
2022-06-12,Dong Nai,Bien Hoa City,8,313,259,54,39
2022-06-12,Dong Nai,Bien Hoa City,9,522,443,79,30
2022-06-12,Dong Nai,Bien Hoa City,10,894,742,152,76
2022-06-12,Dong Nai,Bien Hoa City,11,1325,1094,231,151
2022-06-12,Dong Nai,Bien Hoa City,12,1177,1037,140,56
2022-06-12,Dong Nai,Bien Hoa City,13,819,710,109,31
2022-06-12,Dong Nai,Bien Hoa City,14,520,458,62,27
2022-06-12,Dong Nai,Bien Hoa City,15,560,418,142,88
2022-06-12,Dong Nai,Bien Hoa City,16,829,547,282,217
2022-06-12,Dong Nai,Bien Hoa City,17,1317,584,733,630
2022-06-12,Dong Nai,Bien Hoa City,18,1386,682,704,591
2022-06-12,Dong Nai,Bien Hoa City,19,936,615,321,214
2022-06-12,Dong Nai,Bien Hoa City,20,551,421,130,64
2022-06-12,Dong Nai,Bien Hoa City,21,220,176,44,13
2022-06-12,Dong Nai,Bien Hoa City,22,4,1,3,0
2022-06-12,Dong Nai,Long Khanh,7,1,0,1,1
2022-06-12,Dong Nai,Long Khanh,13,1,0,1,0
2022-06-12,Dong Nai,Long Khanh,14,1,0,1,1
2022-06-12,Dong Nai,Long Khanh,15,2,0,2,1
2022-06-12,Dong Nai,Long Khanh,16,1,0,1,1
2022-06-12,Dong Nai,Long Khanh,20,1,0,1,1
2022-06-12,Dong Nai,Long Thanh,12,2,0,2,2
2022-06-12,Dong Nai,Long Thanh,13,5,0,5,5
2022-06-12,Dong Nai,Long Thanh,14,4,0,4,4
2022-06-12,Dong Nai,Long Thanh,15,2,0,2,2
2022-06-12,Dong Nai,Long Thanh,17,1,0,1,1
2022-06-12,Dong Nai,Long Thanh,20,2,0,2,1
2022-06-12,Dong Nai,Nhon trach,13,2,0,2,1
2022-06-12,Dong Nai,Nhon trach,20,1,0,1,1
2022-06-12,Dong Nai,Trang Bom,6,2,0,2,2
2022-06-12,Dong Nai,Trang Bom,7,1,0,1,1
2022-06-12,Dong Nai,Trang Bom,8,1,0,1,1
2022-06-12,Dong Nai,Trang Bom,11,1,0,1,1
2022-06-12,Dong Nai,Trang Bom,14,1,0,1,1
2022-06-12,Hai Phong City,An Duong,8,2,0,2,2
2022-06-12,Hai Phong City,An Duong,10,6,1,5,5
2022-06-12,Hai Phong City,An Duong,11,7,6,1,1
2022-06-12,Hai Phong City,An Duong,12,6,2,4,4
2022-06-12,Hai Phong City,An Duong,13,9,0,9,8
2022-06-12,Hai Phong City,An Duong,14,6,1,5,3
2022-06-12,Hai Phong City,An Duong,15,5,1,4,3
2022-06-12,Hai Phong City,An Duong,16,4,1,3,3
2022-06-12,Hai Phong City,An Duong,17,1,1,0,0
2022-06-12,Hai Phong City,An Duong,18,5,0,5,3
2022-06-12,Hai Phong City,An Duong,19,4,1,3,1
2022-06-12,Hai Phong City,An Duong,20,2,0,2,1
2022-06-12,Hai Phong City,An Duong,21,7,0,7,4
2022-06-12,Hai Phong City,Duong Kinh District,14,1,0,1,1
2022-06-12,Hai Phong City,Duong Kinh District,15,1,0,1,1
2022-06-12,Hai Phong City,Hai An District,7,7,6,1,1
2022-06-12,Hai Phong City,Hai An District,8,19,12,7,7
2022-06-12,Hai Phong City,Hai An District,9,18,12,6,4
2022-06-12,Hai Phong City,Hai An District,10,26,20,6,1
2022-06-12,Hai Phong City,Hai An District,11,62,46,16,8
2022-06-12,Hai Phong City,Hai An District,12,36,25,11,5
2022-06-12,Hai Phong City,Hai An District,13,26,17,9,5
2022-06-12,Hai Phong City,Hai An District,14,17,9,8,7
2022-06-12,Hai Phong City,Hai An District,15,19,12,7,3
2022-06-12,Hai Phong City,Hai An District,16,17,11,6,3
2022-06-12,Hai Phong City,Hai An District,17,24,15,9,7
2022-06-12,Hai Phong City,Hai An District,18,22,13,9,2
2022-06-12,Hai Phong City,Hai An District,19,29,20,9,8
2022-06-12,Hai Phong City,Hai An District,20,22,10,12,10
2022-06-12,Hai Phong City,Hai An District,21,21,7,14,11
2022-06-12,Hai Phong City,Hong Bang District,7,10,6,4,3
2022-06-12,Hai Phong City,Hong Bang District,8,16,15,1,1
2022-06-12,Hai Phong City,Hong Bang District,9,46,38,8,1
2022-06-12,Hai Phong City,Hong Bang District,10,56,37,19,12
2022-06-12,Hai Phong City,Hong Bang District,11,131,78,53,39
2022-06-12,Hai Phong City,Hong Bang District,12,102,61,41,29
2022-06-12,Hai Phong City,Hong Bang District,13,53,41,12,7
2022-06-12,Hai Phong City,Hong Bang District,14,35,30,5,4
2022-06-12,Hai Phong City,Hong Bang District,15,47,38,9,8
2022-06-12,Hai Phong City,Hong Bang District,16,38,30,8,7
2022-06-12,Hai Phong City,Hong Bang District,17,44,33,11,7
2022-06-12,Hai Phong City,Hong Bang District,18,59,38,21,19
2022-06-12,Hai Phong City,Hong Bang District,19,58,32,26,16
2022-06-12,Hai Phong City,Hong Bang District,20,36,19,17,10
2022-06-12,Hai Phong City,Hong Bang District,21,16,8,8,7
2022-06-12,Hai Phong City,Kien An District,6,1,0,1,1
2022-06-12,Hai Phong City,Kien An District,7,2,1,1,0
2022-06-12,Hai Phong City,Kien An District,8,2,1,1,0
2022-06-12,Hai Phong City,Kien An District,9,10,3,7,6
2022-06-12,Hai Phong City,Kien An District,10,20,15,5,5
2022-06-12,Hai Phong City,Kien An District,11,19,12,7,3
2022-06-12,Hai Phong City,Kien An District,12,29,13,16,14
2022-06-12,Hai Phong City,Kien An District,13,11,8,3,2
2022-06-12,Hai Phong City,Kien An District,14,7,3,4,1
2022-06-12,Hai Phong City,Kien An District,15,10,4,6,3
2022-06-12,Hai Phong City,Kien An District,16,20,5,15,15
2022-06-12,Hai Phong City,Kien An District,17,10,5,5,5
2022-06-12,Hai Phong City,Kien An District,18,13,6,7,5
2022-06-12,Hai Phong City,Kien An District,19,13,6,7,5
2022-06-12,Hai Phong City,Kien An District,20,7,6,1,0
2022-06-12,Hai Phong City,Kien An District,21,4,1,3,2
2022-06-12,Hai Phong City,Le Chan District,3,1,1,0,0
2022-06-12,Hai Phong City,Le Chan District,6,6,1,5,4
2022-06-12,Hai Phong City,Le Chan District,7,39,26,13,11
2022-06-12,Hai Phong City,Le Chan District,8,82,77,5,2
2022-06-12,Hai Phong City,Le Chan District,9,109,94,15,3
2022-06-12,Hai Phong City,Le Chan District,10,236,188,48,18
2022-06-12,Hai Phong City,Le Chan District,11,375,262,113,76
2022-06-12,Hai Phong City,Le Chan District,12,313,233,80,52
2022-06-12,Hai Phong City,Le Chan District,13,179,131,48,20
2022-06-12,Hai Phong City,Le Chan District,14,171,128,43,22
2022-06-12,Hai Phong City,Le Chan District,15,204,148,56,33
2022-06-12,Hai Phong City,Le Chan District,16,159,139,20,8
2022-06-12,Hai Phong City,Le Chan District,17,194,150,44,22
2022-06-12,Hai Phong City,Le Chan District,18,237,175,62,39
2022-06-12,Hai Phong City,Le Chan District,19,236,155,81,62
2022-06-12,Hai Phong City,Le Chan District,20,177,103,74,56
2022-06-12,Hai Phong City,Le Chan District,21,97,56,41,20
2022-06-12,Hai Phong City,Ngo Quyen District,0,1,0,1,1
2022-06-12,Hai Phong City,Ngo Quyen District,2,1,1,0,0
2022-06-12,Hai Phong City,Ngo Quyen District,3,2,1,1,1
2022-06-12,Hai Phong City,Ngo Quyen District,5,1,0,1,1
2022-06-12,Hai Phong City,Ngo Quyen District,6,1,1,0,0
2022-06-12,Hai Phong City,Ngo Quyen District,7,13,9,4,2
2022-06-12,Hai Phong City,Ngo Quyen District,8,57,47,10,4
2022-06-12,Hai Phong City,Ngo Quyen District,9,87,75,12,0
2022-06-12,Hai Phong City,Ngo Quyen District,10,158,134,24,9
2022-06-12,Hai Phong City,Ngo Quyen District,11,303,209,94,57
2022-06-12,Hai Phong City,Ngo Quyen District,12,219,164,55,30
2022-06-12,Hai Phong City,Ngo Quyen District,13,148,116,32,9
2022-06-12,Hai Phong City,Ngo Quyen District,14,117,104,13,6
2022-06-12,Hai Phong City,Ngo Quyen District,15,174,117,57,39
2022-06-12,Hai Phong City,Ngo Quyen District,16,148,124,24,11
2022-06-12,Hai Phong City,Ngo Quyen District,17,198,153,45,24
2022-06-12,Hai Phong City,Ngo Quyen District,18,225,176,49,30
2022-06-12,Hai Phong City,Ngo Quyen District,19,216,136,80,59
2022-06-12,Hai Phong City,Ngo Quyen District,20,148,85,63,53
2022-06-12,Hai Phong City,Ngo Quyen District,21,73,38,35,27
2022-06-12,Hai Phong City,Ngo Quyen District,22,3,0,3,0
2022-06-12,Hai Phong City,Thuy Nguyen,7,2,0,2,2
2022-06-12,Hai Phong City,Thuy Nguyen,13,1,0,1,1
2022-06-12,Hai Phong City,Thuy Nguyen,14,1,0,1,1
2022-06-12,Hai Phong City,Thuy Nguyen,15,1,0,1,1
2022-06-12,Hai Phong City,Thuy Nguyen,16,1,0,1,1
2022-06-12,Hai Phong City,Thuy Nguyen,19,1,0,1,1
2022-06-12,Hai Phong City,Thuy Nguyen,21,1,0,1,1
2022-06-12,Hue City,Hue City,0,3,2,1,0
2022-06-12,Hue City,Hue City,1,1,1,0,0
2022-06-12,Hue City,Hue City,2,2,0,2,0
2022-06-12,Hue City,Hue City,5,2,1,1,0
2022-06-12,Hue City,Hue City,6,65,60,5,1
2022-06-12,Hue City,Hue City,7,215,195,20,3
2022-06-12,Hue City,Hue City,8,357,319,38,2
2022-06-12,Hue City,Hue City,9,385,351,34,1
2022-06-12,Hue City,Hue City,10,549,502,47,0
2022-06-12,Hue City,Hue City,11,979,868,111,17
2022-06-12,Hue City,Hue City,12,690,630,60,2
2022-06-12,Hue City,Hue City,13,396,367,29,0
2022-06-12,Hue City,Hue City,14,351,322,29,0
2022-06-12,Hue City,Hue City,15,423,389,34,0
2022-06-12,Hue City,Hue City,16,464,419,45,4
2022-06-12,Hue City,Hue City,17,652,554,98,21
2022-06-12,Hue City,Hue City,18,740,623,117,52
2022-06-12,Hue City,Hue City,19,740,539,201,116
2022-06-12,Hue City,Hue City,20,506,377,129,65
2022-06-12,Hue City,Hue City,21,276,229,47,10
2022-06-12,Hue City,Hue City,22,5,1,4,1
2022-06-12,Hue City,Hue City,23,1,0,1,0
2022-06-12,Hue City,Huong Thuy,9,3,2,1,0
2022-06-12,Hue City,Huong Thuy,10,1,1,0,0
2022-06-12,Hue City,Huong Thuy,11,2,0,2,0
2022-06-12,Hue City,Huong Thuy,12,4,2,2,2
2022-06-12,Hue City,Huong Thuy,13,1,1,0,0
2022-06-12,Hue City,Huong Thuy,16,1,1,0,0
2022-06-12,Hue City,Huong Thuy,17,3,0,3,2
2022-06-12,Hue City,Huong Thuy,18,1,0,1,1
2022-06-12,Hue City,Huong Thuy,19,1,1,0,0
2022-06-12,Hue City,Huong Thuy,20,1,0,1,1
2022-06-12,Hue City,Huong Tra,11,1,0,1,0
2022-06-12,Hue City,Huong Tra,15,1,1,0,0
2022-06-12,Hue City,Huong Tra,17,1,0,1,1
2022-06-12,Hue City,Huong Tra,19,1,1,0,0
2022-06-12,Hue City,Huong Tra,21,1,1,0,0
2022-06-12,Hue City,Phu Vang,8,1,1,0,0
2022-06-12,Hue City,Phu Vang,9,3,2,1,1
2022-06-12,Hue City,Phu Vang,10,2,2,0,0
2022-06-12,Hue City,Phu Vang,11,5,4,1,1
2022-06-12,Hue City,Phu Vang,12,4,3,1,1
2022-06-12,Hue City,Phu Vang,13,1,1,0,0
2022-06-12,Hue City,Phu Vang,14,3,1,2,1
2022-06-12,Hue City,Phu Vang,15,2,2,0,0
2022-06-12,Hue City,Phu Vang,16,1,1,0,0
2022-06-12,Hue City,Phu Vang,17,4,4,0,0
2022-06-12,Hue City,Phu Vang,18,1,1,0,0
2022-06-12,Hue City,Phu Vang,19,3,2,1,0
2022-06-12,Khanh Hoa,Cam Ranh City,15,1,0,1,1
2022-06-12,Khanh Hoa,Cam Ranh City,16,2,0,2,2
2022-06-12,Khanh Hoa,Dien Khanh,9,3,0,3,3
2022-06-12,Khanh Hoa,Dien Khanh,14,4,0,4,4
2022-06-12,Khanh Hoa,Dien Khanh,15,2,0,2,2
2022-06-12,Khanh Hoa,Dien Khanh,16,2,0,2,2
2022-06-12,Khanh Hoa,Nha Trang City,0,1,1,0,0
2022-06-12,Khanh Hoa,Nha Trang City,1,1,1,0,0
2022-06-12,Khanh Hoa,Nha Trang City,6,44,34,10,2
2022-06-12,Khanh Hoa,Nha Trang City,7,128,120,8,2
2022-06-12,Khanh Hoa,Nha Trang City,8,170,155,15,4
2022-06-12,Khanh Hoa,Nha Trang City,9,231,209,22,3
2022-06-12,Khanh Hoa,Nha Trang City,10,263,244,19,0
2022-06-12,Khanh Hoa,Nha Trang City,11,441,349,92,54
2022-06-12,Khanh Hoa,Nha Trang City,12,387,329,58,28
2022-06-12,Khanh Hoa,Nha Trang City,13,273,244,29,5
2022-06-12,Khanh Hoa,Nha Trang City,14,214,193,21,3
2022-06-12,Khanh Hoa,Nha Trang City,15,195,182,13,2
2022-06-12,Khanh Hoa,Nha Trang City,16,212,186,26,3
2022-06-12,Khanh Hoa,Nha Trang City,17,248,222,26,4
2022-06-12,Khanh Hoa,Nha Trang City,18,357,262,95,54
2022-06-12,Khanh Hoa,Nha Trang City,19,403,254,149,118
2022-06-12,Khanh Hoa,Nha Trang City,20,268,167,101,70
2022-06-12,Khanh Hoa,Nha Trang City,21,163,86,77,52
2022-06-12,Khanh Hoa,Nha Trang City,22,3,0,3,1
2022-06-12,Lam Dong,Da Lat City,6,8,2,6,5
2022-06-12,Lam Dong,Da Lat City,7,80,32,48,40
2022-06-12,Lam Dong,Da Lat City,8,109,61,48,40
2022-06-12,Lam Dong,Da Lat City,9,101,75,26,17
2022-06-12,Lam Dong,Da Lat City,10,107,86,21,7
2022-06-12,Lam Dong,Da Lat City,11,160,114,46,39
2022-06-12,Lam Dong,Da Lat City,12,196,133,63,50
2022-06-12,Lam Dong,Da Lat City,13,129,102,27,17
2022-06-12,Lam Dong,Da Lat City,14,116,95,21,7
2022-06-12,Lam Dong,Da Lat City,15,139,93,46,31
2022-06-12,Lam Dong,Da Lat City,16,134,91,43,37
2022-06-12,Lam Dong,Da Lat City,17,133,97,36,19
2022-06-12,Lam Dong,Da Lat City,18,175,99,76,60
2022-06-12,Lam Dong,Da Lat City,19,216,91,125,99
2022-06-12,Lam Dong,Da Lat City,20,166,61,105,91
2022-06-12,Lam Dong,Da Lat City,21,78,35,43,32
2022-06-12,Lam Dong,Da Lat City,22,1,0,1,0
2022-06-12,Nghe An,Vinh City,0,2,1,1,0
2022-06-12,Nghe An,Vinh City,5,1,0,1,0
2022-06-12,Nghe An,Vinh City,6,2,1,1,0
2022-06-12,Nghe An,Vinh City,7,106,90,16,4
2022-06-12,Nghe An,Vinh City,8,172,145,27,4
2022-06-12,Nghe An,Vinh City,9,165,145,20,4
2022-06-12,Nghe An,Vinh City,10,238,193,45,15
2022-06-12,Nghe An,Vinh City,11,424,314,110,64
2022-06-12,Nghe An,Vinh City,12,293,215,78,41
2022-06-12,Nghe An,Vinh City,13,180,146,34,12
2022-06-12,Nghe An,Vinh City,14,182,147,35,8
2022-06-12,Nghe An,Vinh City,15,244,167,77,44
2022-06-12,Nghe An,Vinh City,16,220,153,67,45
2022-06-12,Nghe An,Vinh City,17,170,144,26,8
2022-06-12,Nghe An,Vinh City,18,241,190,51,25
2022-06-12,Nghe An,Vinh City,19,222,145,77,36
2022-06-12,Nghe An,Vinh City,20,160,105,55,32
2022-06-12,Nghe An,Vinh City,21,135,51,84,63
2022-06-12,Quang Nam,Hoi An City,7,34,8,26,25
2022-06-12,Quang Nam,Hoi An City,8,43,29,14,7
2022-06-12,Quang Nam,Hoi An City,9,42,25,17,8
2022-06-12,Quang Nam,Hoi An City,10,72,50,22,5
2022-06-12,Quang Nam,Hoi An City,11,77,42,35,21
2022-06-12,Quang Nam,Hoi An City,12,69,36,33,24
2022-06-12,Quang Nam,Hoi An City,13,55,30,25,21
2022-06-12,Quang Nam,Hoi An City,14,38,29,9,7
2022-06-12,Quang Nam,Hoi An City,15,36,32,4,1
2022-06-12,Quang Nam,Hoi An City,16,44,39,5,3
2022-06-12,Quang Nam,Hoi An City,17,42,34,8,2
2022-06-12,Quang Nam,Hoi An City,18,56,34,22,16
2022-06-12,Quang Nam,Hoi An City,19,84,29,55,42
2022-06-12,Quang Nam,Hoi An City,20,54,20,34,27
2022-06-12,Quang Nam,Hoi An City,21,26,12,14,7
2022-06-12,Quang Nam,Hoi An City,22,1,0,1,0
2022-06-12,Quang Ninh,Cam Pha City,8,1,0,1,1
2022-06-12,Quang Ninh,Cam Pha City,11,3,0,3,3
2022-06-12,Quang Ninh,Cam Pha City,13,1,0,1,1
2022-06-12,Quang Ninh,Cam Pha City,14,3,0,3,2
2022-06-12,Quang Ninh,Cam Pha City,15,1,0,1,1
2022-06-12,Quang Ninh,Cam Pha City,18,2,0,2,2
2022-06-12,Quang Ninh,Cam Pha City,19,2,0,2,2
2022-06-12,Quang Ninh,Cam Pha City,20,1,0,1,1
2022-06-12,Quang Ninh,Ha Long City,6,2,1,1,0
2022-06-12,Quang Ninh,Ha Long City,7,18,15,3,3
2022-06-12,Quang Ninh,Ha Long City,8,46,34,12,7
2022-06-12,Quang Ninh,Ha Long City,9,58,34,24,12
2022-06-12,Quang Ninh,Ha Long City,10,90,68,22,9
2022-06-12,Quang Ninh,Ha Long City,11,144,114,30,13
2022-06-12,Quang Ninh,Ha Long City,12,116,80,36,18
2022-06-12,Quang Ninh,Ha Long City,13,77,51,26,10
2022-06-12,Quang Ninh,Ha Long City,14,60,41,19,10
2022-06-12,Quang Ninh,Ha Long City,15,47,40,7,2
2022-06-12,Quang Ninh,Ha Long City,16,62,38,24,11
2022-06-12,Quang Ninh,Ha Long City,17,69,45,24,12
2022-06-12,Quang Ninh,Ha Long City,18,67,46,21,8
2022-06-12,Quang Ninh,Ha Long City,19,81,58,23,11
2022-06-12,Quang Ninh,Ha Long City,20,63,42,21,11
2022-06-12,Quang Ninh,Ha Long City,21,1,0,1,0
2022-06-12,Thai Nguyen,Dong Hy,20,1,0,1,0
2022-06-12,Thai Nguyen,Dong Hy,21,1,0,1,0
2022-06-12,Thai Nguyen,Pho Yen,20,1,0,1,1
2022-06-12,Thai Nguyen,Thai Nguyen City,0,3,3,0,0
2022-06-12,Thai Nguyen,Thai Nguyen City,5,2,0,2,0
2022-06-12,Thai Nguyen,Thai Nguyen City,6,4,1,3,0
2022-06-12,Thai Nguyen,Thai Nguyen City,7,79,72,7,1
2022-06-12,Thai Nguyen,Thai Nguyen City,8,124,112,12,1
2022-06-12,Thai Nguyen,Thai Nguyen City,9,114,103,11,2
2022-06-12,Thai Nguyen,Thai Nguyen City,10,261,226,35,3
2022-06-12,Thai Nguyen,Thai Nguyen City,11,436,377,59,12
2022-06-12,Thai Nguyen,Thai Nguyen City,12,304,282,22,3
2022-06-12,Thai Nguyen,Thai Nguyen City,13,183,164,19,0
2022-06-12,Thai Nguyen,Thai Nguyen City,14,185,166,19,2
2022-06-12,Thai Nguyen,Thai Nguyen City,15,181,165,16,0
2022-06-12,Thai Nguyen,Thai Nguyen City,16,166,145,21,2
2022-06-12,Thai Nguyen,Thai Nguyen City,17,150,145,5,1
2022-06-12,Thai Nguyen,Thai Nguyen City,18,238,218,20,1
2022-06-12,Thai Nguyen,Thai Nguyen City,19,258,240,18,1
2022-06-12,Thai Nguyen,Thai Nguyen City,20,198,181,17,0
2022-06-12,Thai Nguyen,Thai Nguyen City,21,150,118,32,2
2022-06-12,Thai Nguyen,Thai Nguyen City,22,4,2,2,0
2022-06-12,Thai Nguyen,Thai Nguyen City,23,1,0,1,0
2022-06-12,Vung Tau,Ba Ria City,7,2,0,2,2
2022-06-12,Vung Tau,Ba Ria City,8,7,0,7,7
2022-06-12,Vung Tau,Ba Ria City,9,7,0,7,6
2022-06-12,Vung Tau,Ba Ria City,10,8,0,8,8
2022-06-12,Vung Tau,Ba Ria City,11,20,0,20,19
2022-06-12,Vung Tau,Ba Ria City,12,23,0,23,22
2022-06-12,Vung Tau,Ba Ria City,13,18,0,18,15
2022-06-12,Vung Tau,Ba Ria City,14,11,0,11,11
2022-06-12,Vung Tau,Ba Ria City,15,6,1,5,5
2022-06-12,Vung Tau,Ba Ria City,16,10,2,8,7
2022-06-12,Vung Tau,Ba Ria City,17,4,1,3,3
2022-06-12,Vung Tau,Ba Ria City,18,9,2,7,7
2022-06-12,Vung Tau,Ba Ria City,19,6,0,6,5
2022-06-12,Vung Tau,Ba Ria City,20,5,0,5,4
2022-06-12,Vung Tau,Ba Ria City,21,3,0,3,3
2022-06-12,Vung Tau,Chau Duc,10,1,0,1,1
2022-06-12,Vung Tau,Tan Thanh,12,1,0,1,1
2022-06-12,Vung Tau,Vung Tau City,0,2,1,1,0
2022-06-12,Vung Tau,Vung Tau City,1,4,4,0,0
2022-06-12,Vung Tau,Vung Tau City,4,1,0,1,1
2022-06-12,Vung Tau,Vung Tau City,5,2,0,2,0
2022-06-12,Vung Tau,Vung Tau City,6,77,42,35,19
2022-06-12,Vung Tau,Vung Tau City,7,200,130,70,52
2022-06-12,Vung Tau,Vung Tau City,8,232,187,45,29
2022-06-12,Vung Tau,Vung Tau City,9,274,239,35,11
2022-06-12,Vung Tau,Vung Tau City,10,341,293,48,18
2022-06-12,Vung Tau,Vung Tau City,11,546,413,133,85
2022-06-12,Vung Tau,Vung Tau City,12,404,367,37,12
2022-06-12,Vung Tau,Vung Tau City,13,321,302,19,2
2022-06-12,Vung Tau,Vung Tau City,14,271,260,11,1
2022-06-12,Vung Tau,Vung Tau City,15,241,226,15,3
2022-06-12,Vung Tau,Vung Tau City,16,264,245,19,4
2022-06-12,Vung Tau,Vung Tau City,17,311,270,41,22
2022-06-12,Vung Tau,Vung Tau City,18,376,289,87,58
2022-06-12,Vung Tau,Vung Tau City,19,352,243,109,76
2022-06-12,Vung Tau,Vung Tau City,20,242,161,81,58
2022-06-12,Vung Tau,Vung Tau City,21,151,83,68,53
2022-06-12,Vung Tau,Vung Tau City,22,2,0,2,1
2022-06-13,Bac Ninh,Bác Ninh City,0,2,1,1,0
2022-06-13,Bac Ninh,Bác Ninh City,2,1,1,0,0
2022-06-13,Bac Ninh,Bác Ninh City,6,7,6,1,0
2022-06-13,Bac Ninh,Bác Ninh City,7,72,62,10,4
2022-06-13,Bac Ninh,Bác Ninh City,8,162,131,31,14
2022-06-13,Bac Ninh,Bác Ninh City,9,141,123,18,3
2022-06-13,Bac Ninh,Bác Ninh City,10,191,171,20,8
2022-06-13,Bac Ninh,Bác Ninh City,11,378,338,40,13
2022-06-13,Bac Ninh,Bác Ninh City,12,224,203,21,3
2022-06-13,Bac Ninh,Bác Ninh City,13,168,148,20,7
2022-06-13,Bac Ninh,Bác Ninh City,14,159,142,17,1
2022-06-13,Bac Ninh,Bác Ninh City,15,150,137,13,1
2022-06-13,Bac Ninh,Bác Ninh City,16,128,118,10,0
2022-06-13,Bac Ninh,Bác Ninh City,17,119,108,11,3
2022-06-13,Bac Ninh,Bác Ninh City,18,141,130,11,2
2022-06-13,Bac Ninh,Bác Ninh City,19,212,127,85,62
2022-06-13,Bac Ninh,Bác Ninh City,20,173,76,97,71
2022-06-13,Bac Ninh,Bác Ninh City,21,154,59,95,76
2022-06-13,Bac Ninh,Bác Ninh City,22,3,0,3,0
2022-06-13,Bac Ninh,Bác Ninh City,23,2,1,1,1
2022-06-13,Bac Ninh,Que Vo,8,1,1,0,0
2022-06-13,Bac Ninh,Que Vo,9,1,1,0,0
2022-06-13,Bac Ninh,Que Vo,11,2,0,2,2
2022-06-13,Bac Ninh,Que Vo,12,1,0,1,1
2022-06-13,Bac Ninh,Que Vo,13,1,0,1,1
2022-06-13,Bac Ninh,Tien Du,8,1,0,1,1
2022-06-13,Bac Ninh,Tien Du,10,2,0,2,1
2022-06-13,Bac Ninh,Tien Du,11,4,0,4,2
2022-06-13,Bac Ninh,Tien Du,12,3,0,3,3
2022-06-13,Bac Ninh,Tien Du,13,1,0,1,1
2022-06-13,Bac Ninh,Tien Du,14,3,0,3,2
2022-06-13,Bac Ninh,Tien Du,20,2,0,2,2
2022-06-13,Bac Ninh,Tu Son,8,2,0,2,2
2022-06-13,Bac Ninh,Tu Son,10,4,0,4,4
2022-06-13,Bac Ninh,Tu Son,11,2,0,2,2
2022-06-13,Bac Ninh,Tu Son,12,2,0,2,1
2022-06-13,Bac Ninh,Tu Son,13,1,0,1,1
2022-06-13,Bac Ninh,Tu Son,14,2,0,2,2
2022-06-13,Bac Ninh,Tu Son,17,3,0,3,1
2022-06-13,Bac Ninh,Tu Son,18,2,0,2,1
2022-06-13,Bac Ninh,Tu Son,20,2,0,2,2
2022-06-13,Bac Ninh,Tu Son,21,2,0,2,2
2022-06-13,Binh Duong,Ben Cat,7,1,0,1,1
2022-06-13,Binh Duong,Ben Cat,8,3,0,3,3
2022-06-13,Binh Duong,Ben Cat,9,2,0,2,2
2022-06-13,Binh Duong,Ben Cat,11,3,0,3,3
2022-06-13,Binh Duong,Ben Cat,12,2,0,2,1
2022-06-13,Binh Duong,Ben Cat,13,1,0,1,1
2022-06-13,Binh Duong,Ben Cat,14,1,0,1,1
2022-06-13,Binh Duong,Ben Cat,15,1,0,1,1
2022-06-13,Binh Duong,Ben Cat,17,3,0,3,2
2022-06-13,Binh Duong,Ben Cat,18,3,0,3,3
2022-06-13,Binh Duong,Di An,7,8,0,8,7
2022-06-13,Binh Duong,Di An,8,17,6,11,8
2022-06-13,Binh Duong,Di An,9,24,11,13,11
2022-06-13,Binh Duong,Di An,10,41,24,17,15
2022-06-13,Binh Duong,Di An,11,47,33,14,8
2022-06-13,Binh Duong,Di An,12,50,37,13,6
2022-06-13,Binh Duong,Di An,13,33,21,12,8
2022-06-13,Binh Duong,Di An,14,40,26,14,12
2022-06-13,Binh Duong,Di An,15,32,25,7,4
2022-06-13,Binh Duong,Di An,16,15,14,1,1
2022-06-13,Binh Duong,Di An,17,18,16,2,2
2022-06-13,Binh Duong,Di An,18,34,28,6,4
2022-06-13,Binh Duong,Di An,19,25,19,6,2
2022-06-13,Binh Duong,Di An,20,16,9,7,5
2022-06-13,Binh Duong,Di An,21,10,5,5,4
2022-06-13,Binh Duong,Tan Uyen,10,2,1,1,0
2022-06-13,Binh Duong,Tan Uyen,11,3,2,1,0
2022-06-13,Binh Duong,Tan Uyen,12,2,1,1,1
2022-06-13,Binh Duong,Tan Uyen,13,4,2,2,2
2022-06-13,Binh Duong,Tan Uyen,14,7,3,4,4
2022-06-13,Binh Duong,Tan Uyen,15,3,1,2,2
2022-06-13,Binh Duong,Tan Uyen,18,6,4,2,1
2022-06-13,Binh Duong,Tan Uyen,19,3,2,1,0
2022-06-13,Binh Duong,Tan Uyen,20,1,0,1,1
2022-06-13,Binh Duong,Tan Uyen,21,2,0,2,2
2022-06-13,Binh Duong,Tan Uyen,22,1,0,1,0
2022-06-13,Binh Duong,Thu Dau Mot Town,0,1,0,1,0
2022-06-13,Binh Duong,Thu Dau Mot Town,1,2,1,1,0
2022-06-13,Binh Duong,Thu Dau Mot Town,5,1,1,0,0
2022-06-13,Binh Duong,Thu Dau Mot Town,6,38,28,10,8
2022-06-13,Binh Duong,Thu Dau Mot Town,7,130,116,14,7
2022-06-13,Binh Duong,Thu Dau Mot Town,8,245,221,24,10
2022-06-13,Binh Duong,Thu Dau Mot Town,9,283,266,17,2
2022-06-13,Binh Duong,Thu Dau Mot Town,10,411,385,26,6
2022-06-13,Binh Duong,Thu Dau Mot Town,11,754,684,70,33
2022-06-13,Binh Duong,Thu Dau Mot Town,12,561,523,38,4
2022-06-13,Binh Duong,Thu Dau Mot Town,13,477,457,20,3
2022-06-13,Binh Duong,Thu Dau Mot Town,14,366,344,22,4
2022-06-13,Binh Duong,Thu Dau Mot Town,15,309,293,16,1
2022-06-13,Binh Duong,Thu Dau Mot Town,16,293,278,15,3
2022-06-13,Binh Duong,Thu Dau Mot Town,17,366,347,19,5
2022-06-13,Binh Duong,Thu Dau Mot Town,18,391,366,25,6
2022-06-13,Binh Duong,Thu Dau Mot Town,19,381,346,35,16
2022-06-13,Binh Duong,Thu Dau Mot Town,20,289,263,26,4
2022-06-13,Binh Duong,Thu Dau Mot Town,21,141,120,21,5
2022-06-13,Binh Duong,Thu Dau Mot Town,22,2,0,2,0
2022-06-13,Binh Duong,Thuan An,6,1,0,1,1
2022-06-13,Binh Duong,Thuan An,7,3,3,0,0
2022-06-13,Binh Duong,Thuan An,8,25,11,14,10
2022-06-13,Binh Duong,Thuan An,9,45,28,17,15
2022-06-13,Binh Duong,Thuan An,10,66,50,16,12
2022-06-13,Binh Duong,Thuan An,11,104,80,24,12
2022-06-13,Binh Duong,Thuan An,12,83,65,18,15
2022-06-13,Binh Duong,Thuan An,13,79,61,18,9
2022-06-13,Binh Duong,Thuan An,14,77,55,22,10
2022-06-13,Binh Duong,Thuan An,15,56,42,14,5
2022-06-13,Binh Duong,Thuan An,16,43,30,13,13
2022-06-13,Binh Duong,Thuan An,17,40,33,7,5
2022-06-13,Binh Duong,Thuan An,18,53,42,11,5
2022-06-13,Binh Duong,Thuan An,19,70,48,22,11
2022-06-13,Binh Duong,Thuan An,20,40,28,12,10
2022-06-13,Binh Duong,Thuan An,21,39,11,28,21
2022-06-13,Can Tho City,Binh Thuy District,6,1,1,0,0
2022-06-13,Can Tho City,Binh Thuy District,7,2,2,0,0
2022-06-13,Can Tho City,Binh Thuy District,8,4,4,0,0
2022-06-13,Can Tho City,Binh Thuy District,9,5,5,0,0
2022-06-13,Can Tho City,Binh Thuy District,10,11,10,1,1
2022-06-13,Can Tho City,Binh Thuy District,11,19,14,5,2
2022-06-13,Can Tho City,Binh Thuy District,12,11,10,1,0
2022-06-13,Can Tho City,Binh Thuy District,13,12,12,0,0
2022-06-13,Can Tho City,Binh Thuy District,14,13,12,1,1
2022-06-13,Can Tho City,Binh Thuy District,15,8,7,1,0
2022-06-13,Can Tho City,Binh Thuy District,16,11,8,3,2
2022-06-13,Can Tho City,Binh Thuy District,17,18,17,1,0
2022-06-13,Can Tho City,Binh Thuy District,18,3,2,1,0
2022-06-13,Can Tho City,Binh Thuy District,19,8,8,0,0
2022-06-13,Can Tho City,Binh Thuy District,20,6,4,2,0
2022-06-13,Can Tho City,Binh Thuy District,21,5,4,1,0
2022-06-13,Can Tho City,Cai Rang District,6,2,2,0,0
2022-06-13,Can Tho City,Cai Rang District,7,2,2,0,0
2022-06-13,Can Tho City,Cai Rang District,8,9,5,4,2
2022-06-13,Can Tho City,Cai Rang District,9,5,5,0,0
2022-06-13,Can Tho City,Cai Rang District,10,12,11,1,1
2022-06-13,Can Tho City,Cai Rang District,11,15,14,1,1
2022-06-13,Can Tho City,Cai Rang District,12,10,10,0,0
2022-06-13,Can Tho City,Cai Rang District,13,12,12,0,0
2022-06-13,Can Tho City,Cai Rang District,14,10,9,1,0
2022-06-13,Can Tho City,Cai Rang District,15,9,9,0,0
2022-06-13,Can Tho City,Cai Rang District,16,13,13,0,0
2022-06-13,Can Tho City,Cai Rang District,17,19,17,2,0
2022-06-13,Can Tho City,Cai Rang District,18,9,8,1,0
2022-06-13,Can Tho City,Cai Rang District,19,10,8,2,1
2022-06-13,Can Tho City,Cai Rang District,20,12,10,2,0
2022-06-13,Can Tho City,Cai Rang District,21,2,1,1,1
2022-06-13,Can Tho City,Ninh Kieu District,0,4,2,2,1
2022-06-13,Can Tho City,Ninh Kieu District,3,1,0,1,0
2022-06-13,Can Tho City,Ninh Kieu District,4,1,1,0,0
2022-06-13,Can Tho City,Ninh Kieu District,5,1,1,0,0
2022-06-13,Can Tho City,Ninh Kieu District,6,53,47,6,5
2022-06-13,Can Tho City,Ninh Kieu District,7,124,114,10,0
2022-06-13,Can Tho City,Ninh Kieu District,8,197,184,13,0
2022-06-13,Can Tho City,Ninh Kieu District,9,333,314,19,0
2022-06-13,Can Tho City,Ninh Kieu District,10,603,577,26,0
2022-06-13,Can Tho City,Ninh Kieu District,11,847,792,55,11
2022-06-13,Can Tho City,Ninh Kieu District,12,666,632,34,4
2022-06-13,Can Tho City,Ninh Kieu District,13,548,522,26,0
2022-06-13,Can Tho City,Ninh Kieu District,14,414,387,27,0
2022-06-13,Can Tho City,Ninh Kieu District,15,401,391,10,0
2022-06-13,Can Tho City,Ninh Kieu District,16,459,438,21,0
2022-06-13,Can Tho City,Ninh Kieu District,17,526,493,33,0
2022-06-13,Can Tho City,Ninh Kieu District,18,511,480,31,0
2022-06-13,Can Tho City,Ninh Kieu District,19,473,442,31,0
2022-06-13,Can Tho City,Ninh Kieu District,20,335,315,20,1
2022-06-13,Can Tho City,Ninh Kieu District,21,205,185,20,2
2022-06-13,Can Tho City,Ninh Kieu District,22,1,0,1,0
2022-06-13,Can Tho City,Thoi Lai,12,1,0,1,1
2022-06-13,Can Tho City,Thoi Lai,19,1,0,1,1
2022-06-13,Dong Nai,Bien Hoa City,0,3,1,2,0
2022-06-13,Dong Nai,Bien Hoa City,1,1,0,1,0
2022-06-13,Dong Nai,Bien Hoa City,2,2,1,1,1
2022-06-13,Dong Nai,Bien Hoa City,5,2,1,1,1
2022-06-13,Dong Nai,Bien Hoa City,6,47,30,17,11
2022-06-13,Dong Nai,Bien Hoa City,7,206,145,61,44
2022-06-13,Dong Nai,Bien Hoa City,8,338,279,59,26
2022-06-13,Dong Nai,Bien Hoa City,9,465,420,45,11
2022-06-13,Dong Nai,Bien Hoa City,10,844,764,80,18
2022-06-13,Dong Nai,Bien Hoa City,11,1204,1062,142,50
2022-06-13,Dong Nai,Bien Hoa City,12,954,865,89,26
2022-06-13,Dong Nai,Bien Hoa City,13,828,734,94,39
2022-06-13,Dong Nai,Bien Hoa City,14,761,677,84,25
2022-06-13,Dong Nai,Bien Hoa City,15,589,529,60,20
2022-06-13,Dong Nai,Bien Hoa City,16,556,480,76,33
2022-06-13,Dong Nai,Bien Hoa City,17,634,568,66,19
2022-06-13,Dong Nai,Bien Hoa City,18,659,611,48,7
2022-06-13,Dong Nai,Bien Hoa City,19,709,617,92,26
2022-06-13,Dong Nai,Bien Hoa City,20,465,381,84,34
2022-06-13,Dong Nai,Bien Hoa City,21,252,169,83,38
2022-06-13,Dong Nai,Bien Hoa City,22,2,0,2,0
2022-06-13,Dong Nai,Long Khanh,15,1,0,1,1
2022-06-13,Dong Nai,Long Khanh,17,1,0,1,1
2022-06-13,Dong Nai,Long Thanh,10,1,0,1,1
2022-06-13,Dong Nai,Long Thanh,12,4,0,4,4
2022-06-13,Dong Nai,Long Thanh,13,4,0,4,4
2022-06-13,Dong Nai,Long Thanh,14,1,0,1,1
2022-06-13,Dong Nai,Nhon trach,9,1,0,1,1
2022-06-13,Dong Nai,Nhon trach,10,1,0,1,1
2022-06-13,Dong Nai,Nhon trach,12,1,0,1,1
2022-06-13,Dong Nai,Nhon trach,15,1,0,1,1
2022-06-13,Dong Nai,Trang Bom,10,5,0,5,4
2022-06-13,Dong Nai,Trang Bom,11,3,1,2,2
2022-06-13,Dong Nai,Trang Bom,12,1,0,1,1
2022-06-13,Dong Nai,Trang Bom,15,3,1,2,1
2022-06-13,Dong Nai,Trang Bom,18,4,0,4,3
2022-06-13,Dong Nai,Trang Bom,19,2,0,2,2
2022-06-13,Dong Nai,Vinh Cuu,15,1,0,1,1
2022-06-13,Hai Phong City,An Duong,2,1,0,1,0
2022-06-13,Hai Phong City,An Duong,6,1,0,1,0
2022-06-13,Hai Phong City,An Duong,7,2,0,2,1
2022-06-13,Hai Phong City,An Duong,9,3,2,1,0
2022-06-13,Hai Phong City,An Duong,10,6,4,2,1
2022-06-13,Hai Phong City,An Duong,11,16,8,8,6
2022-06-13,Hai Phong City,An Duong,12,8,6,2,1
2022-06-13,Hai Phong City,An Duong,13,8,1,7,5
2022-06-13,Hai Phong City,An Duong,14,11,3,8,8
2022-06-13,Hai Phong City,An Duong,15,11,4,7,6
2022-06-13,Hai Phong City,An Duong,16,5,1,4,4
2022-06-13,Hai Phong City,An Duong,17,1,0,1,0
2022-06-13,Hai Phong City,An Duong,18,3,0,3,3
2022-06-13,Hai Phong City,An Duong,20,1,0,1,0
2022-06-13,Hai Phong City,Duong Kinh District,9,1,0,1,1
2022-06-13,Hai Phong City,Hai An District,2,1,0,1,0
2022-06-13,Hai Phong City,Hai An District,6,1,1,0,0
2022-06-13,Hai Phong City,Hai An District,7,9,5,4,3
2022-06-13,Hai Phong City,Hai An District,8,15,11,4,2
2022-06-13,Hai Phong City,Hai An District,9,17,12,5,0
2022-06-13,Hai Phong City,Hai An District,10,25,22,3,2
2022-06-13,Hai Phong City,Hai An District,11,58,35,23,18
2022-06-13,Hai Phong City,Hai An District,12,23,13,10,7
2022-06-13,Hai Phong City,Hai An District,13,30,16,14,9
2022-06-13,Hai Phong City,Hai An District,14,36,18,18,9
2022-06-13,Hai Phong City,Hai An District,15,31,19,12,8
2022-06-13,Hai Phong City,Hai An District,16,11,9,2,2
2022-06-13,Hai Phong City,Hai An District,17,24,21,3,2
2022-06-13,Hai Phong City,Hai An District,18,30,26,4,0
2022-06-13,Hai Phong City,Hai An District,19,22,15,7,1
2022-06-13,Hai Phong City,Hai An District,20,22,20,2,0
2022-06-13,Hai Phong City,Hai An District,21,7,2,5,4
2022-06-13,Hai Phong City,Hong Bang District,6,1,0,1,0
2022-06-13,Hai Phong City,Hong Bang District,7,28,11,17,14
2022-06-13,Hai Phong City,Hong Bang District,8,46,32,14,13
2022-06-13,Hai Phong City,Hong Bang District,9,51,39,12,4
2022-06-13,Hai Phong City,Hong Bang District,10,65,55,10,4
2022-06-13,Hai Phong City,Hong Bang District,11,110,89,21,17
2022-06-13,Hai Phong City,Hong Bang District,12,69,55,14,9
2022-06-13,Hai Phong City,Hong Bang District,13,41,36,5,1
2022-06-13,Hai Phong City,Hong Bang District,14,46,33,13,6
2022-06-13,Hai Phong City,Hong Bang District,15,49,31,18,11
2022-06-13,Hai Phong City,Hong Bang District,16,30,28,2,0
2022-06-13,Hai Phong City,Hong Bang District,17,52,35,17,10
2022-06-13,Hai Phong City,Hong Bang District,18,62,47,15,11
2022-06-13,Hai Phong City,Hong Bang District,19,31,23,8,6
2022-06-13,Hai Phong City,Hong Bang District,20,24,16,8,8
2022-06-13,Hai Phong City,Hong Bang District,21,11,4,7,5
2022-06-13,Hai Phong City,Kien An District,7,6,1,5,5
2022-06-13,Hai Phong City,Kien An District,8,14,3,11,7
2022-06-13,Hai Phong City,Kien An District,9,7,2,5,5
2022-06-13,Hai Phong City,Kien An District,10,6,3,3,2
2022-06-13,Hai Phong City,Kien An District,11,17,13,4,1
2022-06-13,Hai Phong City,Kien An District,12,11,9,2,0
2022-06-13,Hai Phong City,Kien An District,13,6,4,2,2
2022-06-13,Hai Phong City,Kien An District,14,14,5,9,8
2022-06-13,Hai Phong City,Kien An District,15,13,6,7,5
2022-06-13,Hai Phong City,Kien An District,16,12,6,6,2
2022-06-13,Hai Phong City,Kien An District,17,9,5,4,2
2022-06-13,Hai Phong City,Kien An District,18,12,7,5,4
2022-06-13,Hai Phong City,Kien An District,19,10,6,4,3
2022-06-13,Hai Phong City,Kien An District,20,13,4,9,9
2022-06-13,Hai Phong City,Kien An District,21,6,0,6,6
2022-06-13,Hai Phong City,Le Chan District,0,3,0,3,2
2022-06-13,Hai Phong City,Le Chan District,2,2,1,1,0
2022-06-13,Hai Phong City,Le Chan District,7,43,26,17,14
2022-06-13,Hai Phong City,Le Chan District,8,81,66,15,7
2022-06-13,Hai Phong City,Le Chan District,9,100,83,17,1
2022-06-13,Hai Phong City,Le Chan District,10,210,177,33,12
2022-06-13,Hai Phong City,Le Chan District,11,395,265,130,95
2022-06-13,Hai Phong City,Le Chan District,12,247,196,51,24
2022-06-13,Hai Phong City,Le Chan District,13,128,100,28,18
2022-06-13,Hai Phong City,Le Chan District,14,141,111,30,22
2022-06-13,Hai Phong City,Le Chan District,15,162,122,40,19
2022-06-13,Hai Phong City,Le Chan District,16,151,131,20,7
2022-06-13,Hai Phong City,Le Chan District,17,181,143,38,17
2022-06-13,Hai Phong City,Le Chan District,18,163,129,34,16
2022-06-13,Hai Phong City,Le Chan District,19,191,160,31,8
2022-06-13,Hai Phong City,Le Chan District,20,134,91,43,22
2022-06-13,Hai Phong City,Le Chan District,21,89,54,35,19
2022-06-13,Hai Phong City,Le Chan District,22,1,0,1,0
2022-06-13,Hai Phong City,Ngo Quyen District,7,30,14,16,9
2022-06-13,Hai Phong City,Ngo Quyen District,8,85,53,32,24
2022-06-13,Hai Phong City,Ngo Quyen District,9,81,62,19,11
2022-06-13,Hai Phong City,Ngo Quyen District,10,148,114,34,27
2022-06-13,Hai Phong City,Ngo Quyen District,11,318,227,91,63
2022-06-13,Hai Phong City,Ngo Quyen District,12,180,150,30,20
2022-06-13,Hai Phong City,Ngo Quyen District,13,117,87,30,18
2022-06-13,Hai Phong City,Ngo Quyen District,14,146,104,42,24
2022-06-13,Hai Phong City,Ngo Quyen District,15,148,115,33,23
2022-06-13,Hai Phong City,Ngo Quyen District,16,106,91,15,7
2022-06-13,Hai Phong City,Ngo Quyen District,17,156,120,36,16
2022-06-13,Hai Phong City,Ngo Quyen District,18,159,130,29,13
2022-06-13,Hai Phong City,Ngo Quyen District,19,140,118,22,4
2022-06-13,Hai Phong City,Ngo Quyen District,20,113,83,30,11
2022-06-13,Hai Phong City,Ngo Quyen District,21,63,36,27,18
2022-06-13,Hai Phong City,Thuy Nguyen,10,1,0,1,1
2022-06-13,Hai Phong City,Thuy Nguyen,11,1,1,0,0
2022-06-13,Hai Phong City,Thuy Nguyen,12,2,0,2,2
2022-06-13,Hai Phong City,Thuy Nguyen,14,2,0,2,2
2022-06-13,Hai Phong City,Thuy Nguyen,18,1,0,1,1
2022-06-13,Hai Phong City,Thuy Nguyen,19,1,0,1,1
2022-06-13,Hue City,Hue City,0,1,0,1,0
2022-06-13,Hue City,Hue City,2,1,1,0,0
2022-06-13,Hue City,Hue City,5,4,3,1,1
2022-06-13,Hue City,Hue City,6,70,49,21,6
2022-06-13,Hue City,Hue City,7,205,186,19,0
2022-06-13,Hue City,Hue City,8,317,286,31,2
2022-06-13,Hue City,Hue City,9,307,282,25,0
2022-06-13,Hue City,Hue City,10,514,485,29,1
2022-06-13,Hue City,Hue City,11,1078,930,148,51
2022-06-13,Hue City,Hue City,12,690,632,58,3
2022-06-13,Hue City,Hue City,13,412,384,28,0
2022-06-13,Hue City,Hue City,14,365,336,29,0
2022-06-13,Hue City,Hue City,15,435,395,40,1
2022-06-13,Hue City,Hue City,16,394,362,32,0
2022-06-13,Hue City,Hue City,17,499,445,54,3
2022-06-13,Hue City,Hue City,18,558,517,41,2
2022-06-13,Hue City,Hue City,19,583,534,49,0
2022-06-13,Hue City,Hue City,20,437,378,59,6
2022-06-13,Hue City,Hue City,21,281,195,86,38
2022-06-13,Hue City,Hue City,22,3,2,1,1
2022-06-13,Hue City,Hue City,23,5,0,5,0
2022-06-13,Hue City,Huong Thuy,6,1,1,0,0
2022-06-13,Hue City,Huong Thuy,7,1,1,0,0
2022-06-13,Hue City,Huong Thuy,10,1,1,0,0
2022-06-13,Hue City,Huong Thuy,12,1,0,1,1
2022-06-13,Hue City,Huong Thuy,13,4,2,2,0
2022-06-13,Hue City,Huong Thuy,15,1,0,1,0
2022-06-13,Hue City,Huong Thuy,16,2,1,1,0
2022-06-13,Hue City,Huong Thuy,17,1,0,1,1
2022-06-13,Hue City,Huong Thuy,18,2,0,2,1
2022-06-13,Hue City,Huong Thuy,19,1,1,0,0
2022-06-13,Hue City,Huong Thuy,21,5,1,4,0
2022-06-13,Hue City,Huong Tra,20,1,0,1,0
2022-06-13,Hue City,Phu Vang,9,1,1,0,0
2022-06-13,Hue City,Phu Vang,10,3,2,1,0
2022-06-13,Hue City,Phu Vang,11,2,2,0,0
2022-06-13,Hue City,Phu Vang,12,2,1,1,0
2022-06-13,Hue City,Phu Vang,13,6,4,2,0
2022-06-13,Hue City,Phu Vang,14,1,0,1,0
2022-06-13,Hue City,Phu Vang,15,5,1,4,4
2022-06-13,Hue City,Phu Vang,16,2,0,2,2
2022-06-13,Hue City,Phu Vang,17,2,2,0,0
2022-06-13,Hue City,Phu Vang,18,3,1,2,1
2022-06-13,Hue City,Phu Vang,19,8,3,5,3
2022-06-13,Hue City,Phu Vang,20,1,0,1,1
2022-06-13,Khanh Hoa,Cam Ranh City,9,1,0,1,1
2022-06-13,Khanh Hoa,Cam Ranh City,14,1,0,1,1
2022-06-13,Khanh Hoa,Dien Khanh,7,1,0,1,1
2022-06-13,Khanh Hoa,Dien Khanh,8,2,0,2,2
2022-06-13,Khanh Hoa,Nha Trang City,0,6,2,4,0
2022-06-13,Khanh Hoa,Nha Trang City,5,3,2,1,1
2022-06-13,Khanh Hoa,Nha Trang City,6,47,30,17,7
2022-06-13,Khanh Hoa,Nha Trang City,7,145,133,12,2
2022-06-13,Khanh Hoa,Nha Trang City,8,227,210,17,1
2022-06-13,Khanh Hoa,Nha Trang City,9,191,170,21,3
2022-06-13,Khanh Hoa,Nha Trang City,10,254,233,21,2
2022-06-13,Khanh Hoa,Nha Trang City,11,406,361,45,10
2022-06-13,Khanh Hoa,Nha Trang City,12,324,292,32,8
2022-06-13,Khanh Hoa,Nha Trang City,13,268,249,19,0
2022-06-13,Khanh Hoa,Nha Trang City,14,289,255,34,2
2022-06-13,Khanh Hoa,Nha Trang City,15,217,196,21,4
2022-06-13,Khanh Hoa,Nha Trang City,16,174,162,12,0
2022-06-13,Khanh Hoa,Nha Trang City,17,220,198,22,0
2022-06-13,Khanh Hoa,Nha Trang City,18,228,211,17,0
2022-06-13,Khanh Hoa,Nha Trang City,19,231,216,15,0
2022-06-13,Khanh Hoa,Nha Trang City,20,181,163,18,4
2022-06-13,Khanh Hoa,Nha Trang City,21,103,73,30,10
2022-06-13,Lam Dong,Da Lat City,5,1,1,0,0
2022-06-13,Lam Dong,Da Lat City,6,5,1,4,1
2022-06-13,Lam Dong,Da Lat City,7,46,30,16,11
2022-06-13,Lam Dong,Da Lat City,8,81,66,15,11
2022-06-13,Lam Dong,Da Lat City,9,101,82,19,11
2022-06-13,Lam Dong,Da Lat City,10,116,90,26,14
2022-06-13,Lam Dong,Da Lat City,11,179,116,63,44
2022-06-13,Lam Dong,Da Lat City,12,161,111,50,30
2022-06-13,Lam Dong,Da Lat City,13,141,101,40,23
2022-06-13,Lam Dong,Da Lat City,14,128,91,37,25
2022-06-13,Lam Dong,Da Lat City,15,94,76,18,8
2022-06-13,Lam Dong,Da Lat City,16,117,83,34,26
2022-06-13,Lam Dong,Da Lat City,17,109,77,32,16
2022-06-13,Lam Dong,Da Lat City,18,99,87,12,4
2022-06-13,Lam Dong,Da Lat City,19,109,83,26,12
2022-06-13,Lam Dong,Da Lat City,20,70,47,23,15
2022-06-13,Lam Dong,Da Lat City,21,63,32,31,18
2022-06-13,Nghe An,Vinh City,0,1,1,0,0
2022-06-13,Nghe An,Vinh City,1,1,0,1,0
2022-06-13,Nghe An,Vinh City,3,1,1,0,0
2022-06-13,Nghe An,Vinh City,4,2,1,1,0
2022-06-13,Nghe An,Vinh City,6,1,1,0,0
2022-06-13,Nghe An,Vinh City,7,150,131,19,3
2022-06-13,Nghe An,Vinh City,8,211,192,19,2
2022-06-13,Nghe An,Vinh City,9,153,129,24,1
2022-06-13,Nghe An,Vinh City,10,243,206,37,15
2022-06-13,Nghe An,Vinh City,11,459,350,109,62
2022-06-13,Nghe An,Vinh City,12,287,244,43,17
2022-06-13,Nghe An,Vinh City,13,192,151,41,8
2022-06-13,Nghe An,Vinh City,14,208,173,35,11
2022-06-13,Nghe An,Vinh City,15,208,171,37,11
2022-06-13,Nghe An,Vinh City,16,157,141,16,2
2022-06-13,Nghe An,Vinh City,17,160,138,22,2
2022-06-13,Nghe An,Vinh City,18,139,122,17,2
2022-06-13,Nghe An,Vinh City,19,169,146,23,3
2022-06-13,Nghe An,Vinh City,20,116,96,20,5
2022-06-13,Nghe An,Vinh City,21,82,45,37,27
2022-06-13,Quang Nam,Hoi An City,7,11,7,4,2
2022-06-13,Quang Nam,Hoi An City,8,25,21,4,0
2022-06-13,Quang Nam,Hoi An City,9,22,18,4,0
2022-06-13,Quang Nam,Hoi An City,10,26,22,4,0
2022-06-13,Quang Nam,Hoi An City,11,47,40,7,0
2022-06-13,Quang Nam,Hoi An City,12,42,38,4,0
2022-06-13,Quang Nam,Hoi An City,13,33,23,10,3
2022-06-13,Quang Nam,Hoi An City,14,41,31,10,5
2022-06-13,Quang Nam,Hoi An City,15,43,35,8,3
2022-06-13,Quang Nam,Hoi An City,16,34,32,2,1
2022-06-13,Quang Nam,Hoi An City,17,28,24,4,0
2022-06-13,Quang Nam,Hoi An City,18,30,23,7,0
2022-06-13,Quang Nam,Hoi An City,19,47,34,13,3
2022-06-13,Quang Nam,Hoi An City,20,34,27,7,1
2022-06-13,Quang Nam,Hoi An City,21,28,20,8,5
2022-06-13,Quang Nam,Tam Ky City,10,1,0,1,1
2022-06-13,Quang Nam,Tam Ky City,13,3,0,3,2
2022-06-13,Quang Ninh,Cam Pha City,11,1,0,1,1
2022-06-13,Quang Ninh,Cam Pha City,12,1,0,1,0
2022-06-13,Quang Ninh,Cam Pha City,13,2,0,2,2
2022-06-13,Quang Ninh,Cam Pha City,17,2,0,2,2
2022-06-13,Quang Ninh,Cam Pha City,19,1,0,1,1
2022-06-13,Quang Ninh,Ha Long City,0,1,0,1,0
2022-06-13,Quang Ninh,Ha Long City,6,2,1,1,0
2022-06-13,Quang Ninh,Ha Long City,7,25,17,8,3
2022-06-13,Quang Ninh,Ha Long City,8,52,32,20,12
2022-06-13,Quang Ninh,Ha Long City,9,51,27,24,9
2022-06-13,Quang Ninh,Ha Long City,10,86,61,25,12
2022-06-13,Quang Ninh,Ha Long City,11,133,106,27,12
2022-06-13,Quang Ninh,Ha Long City,12,96,70,26,8
2022-06-13,Quang Ninh,Ha Long City,13,108,69,39,22
2022-06-13,Quang Ninh,Ha Long City,14,70,51,19,12
2022-06-13,Quang Ninh,Ha Long City,15,55,40,15,5
2022-06-13,Quang Ninh,Ha Long City,16,45,38,7,4
2022-06-13,Quang Ninh,Ha Long City,17,43,22,21,14
2022-06-13,Quang Ninh,Ha Long City,18,70,37,33,25
2022-06-13,Quang Ninh,Ha Long City,19,54,31,23,16
2022-06-13,Quang Ninh,Ha Long City,20,62,20,42,27
2022-06-13,Quang Ninh,Ha Long City,21,3,0,3,0
2022-06-13,Quang Ninh,Uong Bi City,17,1,0,1,1
2022-06-13,Thai Nguyen,Dong Hy,12,1,1,0,0
2022-06-13,Thai Nguyen,Dong Hy,17,1,0,1,1
2022-06-13,Thai Nguyen,Dong Hy,18,1,0,1,1
2022-06-13,Thai Nguyen,Thai Nguyen City,0,4,3,1,0
2022-06-13,Thai Nguyen,Thai Nguyen City,1,1,0,1,0
2022-06-13,Thai Nguyen,Thai Nguyen City,2,1,1,0,0
2022-06-13,Thai Nguyen,Thai Nguyen City,5,3,2,1,1
2022-06-13,Thai Nguyen,Thai Nguyen City,6,2,2,0,0
2022-06-13,Thai Nguyen,Thai Nguyen City,7,61,57,4,1
2022-06-13,Thai Nguyen,Thai Nguyen City,8,138,119,19,1
2022-06-13,Thai Nguyen,Thai Nguyen City,9,130,121,9,3
2022-06-13,Thai Nguyen,Thai Nguyen City,10,195,172,23,1
2022-06-13,Thai Nguyen,Thai Nguyen City,11,370,342,28,2
2022-06-13,Thai Nguyen,Thai Nguyen City,12,271,252,19,1
2022-06-13,Thai Nguyen,Thai Nguyen City,13,167,147,20,2
2022-06-13,Thai Nguyen,Thai Nguyen City,14,177,150,27,2
2022-06-13,Thai Nguyen,Thai Nguyen City,15,153,136,17,2
2022-06-13,Thai Nguyen,Thai Nguyen City,16,106,97,9,0
2022-06-13,Thai Nguyen,Thai Nguyen City,17,154,143,11,0
2022-06-13,Thai Nguyen,Thai Nguyen City,18,211,192,19,4
2022-06-13,Thai Nguyen,Thai Nguyen City,19,175,139,36,18
2022-06-13,Thai Nguyen,Thai Nguyen City,20,174,153,21,5
2022-06-13,Thai Nguyen,Thai Nguyen City,21,115,91,24,8
2022-06-13,Thai Nguyen,Thai Nguyen City,22,3,0,3,0
2022-06-13,Vung Tau,Ba Ria City,5,1,0,1,1
2022-06-13,Vung Tau,Ba Ria City,8,6,2,4,4
2022-06-13,Vung Tau,Ba Ria City,9,5,3,2,1
2022-06-13,Vung Tau,Ba Ria City,10,8,7,1,1
2022-06-13,Vung Tau,Ba Ria City,11,8,5,3,3
2022-06-13,Vung Tau,Ba Ria City,12,8,4,4,4
2022-06-13,Vung Tau,Ba Ria City,13,3,2,1,1
2022-06-13,Vung Tau,Ba Ria City,14,10,6,4,3
2022-06-13,Vung Tau,Ba Ria City,15,8,6,2,1
2022-06-13,Vung Tau,Ba Ria City,16,8,4,4,3
2022-06-13,Vung Tau,Ba Ria City,17,2,2,0,0
2022-06-13,Vung Tau,Ba Ria City,18,3,1,2,2
2022-06-13,Vung Tau,Ba Ria City,19,3,0,3,1
2022-06-13,Vung Tau,Ba Ria City,20,2,0,2,2
2022-06-13,Vung Tau,Ba Ria City,21,1,0,1,1
2022-06-13,Vung Tau,Vung Tau City,0,1,0,1,1
2022-06-13,Vung Tau,Vung Tau City,2,1,1,0,0
2022-06-13,Vung Tau,Vung Tau City,3,1,1,0,0
2022-06-13,Vung Tau,Vung Tau City,5,2,0,2,0
2022-06-13,Vung Tau,Vung Tau City,6,26,25,1,1
2022-06-13,Vung Tau,Vung Tau City,7,104,96,8,4
2022-06-13,Vung Tau,Vung Tau City,8,196,176,20,10
2022-06-13,Vung Tau,Vung Tau City,9,209,176,33,8
2022-06-13,Vung Tau,Vung Tau City,10,218,201,17,2
2022-06-13,Vung Tau,Vung Tau City,11,353,313,40,11
2022-06-13,Vung Tau,Vung Tau City,12,308,290,18,2
2022-06-13,Vung Tau,Vung Tau City,13,226,206,20,6
2022-06-13,Vung Tau,Vung Tau City,14,262,239,23,3
2022-06-13,Vung Tau,Vung Tau City,15,230,214,16,4
2022-06-13,Vung Tau,Vung Tau City,16,227,209,18,3
2022-06-13,Vung Tau,Vung Tau City,17,227,211,16,4
2022-06-13,Vung Tau,Vung Tau City,18,330,287,43,5
2022-06-13,Vung Tau,Vung Tau City,19,283,250,33,9
2022-06-13,Vung Tau,Vung Tau City,20,176,147,29,12
2022-06-13,Vung Tau,Vung Tau City,21,114,88,26,14
2022-06-13,Vung Tau,Vung Tau City,22,1,0,1,0
2022-06-13,Vung Tau,Vung Tau City,23,1,0,1,0
2022-06-14,Bac Ninh,Bác Ninh City,6,5,3,2,2
2022-06-14,Bac Ninh,Bác Ninh City,7,99,69,30,24
2022-06-14,Bac Ninh,Bác Ninh City,8,166,134,32,24
2022-06-14,Bac Ninh,Bác Ninh City,9,132,111,21,2
2022-06-14,Bac Ninh,Bác Ninh City,10,178,163,15,1
2022-06-14,Bac Ninh,Bác Ninh City,11,359,322,37,5
2022-06-14,Bac Ninh,Bác Ninh City,12,240,210,30,3
2022-06-14,Bac Ninh,Bác Ninh City,13,140,129,11,2
2022-06-14,Bac Ninh,Bác Ninh City,14,179,163,16,10
2022-06-14,Bac Ninh,Bác Ninh City,15,155,139,16,3
2022-06-14,Bac Ninh,Bác Ninh City,16,107,100,7,0
2022-06-14,Bac Ninh,Bác Ninh City,17,129,120,9,1
2022-06-14,Bac Ninh,Bác Ninh City,18,163,151,12,1
2022-06-14,Bac Ninh,Bác Ninh City,19,185,169,16,3
2022-06-14,Bac Ninh,Bác Ninh City,20,140,123,17,4
2022-06-14,Bac Ninh,Bác Ninh City,21,102,88,14,5
2022-06-14,Bac Ninh,Que Vo,7,1,1,0,0
2022-06-14,Bac Ninh,Que Vo,9,3,1,2,2
2022-06-14,Bac Ninh,Que Vo,10,1,0,1,1
2022-06-14,Bac Ninh,Que Vo,11,1,0,1,0
2022-06-14,Bac Ninh,Que Vo,12,4,2,2,1
2022-06-14,Bac Ninh,Que Vo,13,2,2,0,0
2022-06-14,Bac Ninh,Que Vo,14,5,0,5,5
2022-06-14,Bac Ninh,Que Vo,15,1,0,1,1
2022-06-14,Bac Ninh,Que Vo,16,1,0,1,1
2022-06-14,Bac Ninh,Que Vo,17,2,0,2,2
2022-06-14,Bac Ninh,Que Vo,21,1,0,1,0
2022-06-14,Bac Ninh,Tien Du,11,2,0,2,1
2022-06-14,Bac Ninh,Tien Du,14,2,0,2,2
2022-06-14,Bac Ninh,Tien Du,15,1,0,1,1
2022-06-14,Bac Ninh,Tien Du,16,3,0,3,3
2022-06-14,Bac Ninh,Tien Du,18,1,0,1,0
2022-06-14,Bac Ninh,Tien Du,19,4,1,3,3
2022-06-14,Bac Ninh,Tien Du,20,2,0,2,2
2022-06-14,Bac Ninh,Tu Son,10,1,0,1,1
2022-06-14,Bac Ninh,Tu Son,12,1,0,1,1
2022-06-14,Bac Ninh,Tu Son,15,2,0,2,2
2022-06-14,Bac Ninh,Tu Son,16,3,0,3,2
2022-06-14,Bac Ninh,Tu Son,17,1,0,1,0
2022-06-14,Bac Ninh,Tu Son,19,2,0,2,2
2022-06-14,Bac Ninh,Tu Son,20,1,0,1,1
2022-06-14,Bac Ninh,Tu Son,21,1,0,1,1
2022-06-14,Binh Duong,Ben Cat,9,1,0,1,1
2022-06-14,Binh Duong,Ben Cat,10,4,0,4,4
2022-06-14,Binh Duong,Ben Cat,12,2,0,2,2
2022-06-14,Binh Duong,Ben Cat,13,1,0,1,0
2022-06-14,Binh Duong,Ben Cat,14,1,1,0,0
2022-06-14,Binh Duong,Ben Cat,15,1,0,1,1
2022-06-14,Binh Duong,Ben Cat,17,1,0,1,1
2022-06-14,Binh Duong,Ben Cat,19,1,1,0,0
2022-06-14,Binh Duong,Di An,6,2,0,2,2
2022-06-14,Binh Duong,Di An,7,3,0,3,3
2022-06-14,Binh Duong,Di An,8,12,6,6,4
2022-06-14,Binh Duong,Di An,9,26,19,7,3
2022-06-14,Binh Duong,Di An,10,41,28,13,9
2022-06-14,Binh Duong,Di An,11,34,25,9,3
2022-06-14,Binh Duong,Di An,12,38,29,9,6
2022-06-14,Binh Duong,Di An,13,32,23,9,5
2022-06-14,Binh Duong,Di An,14,26,19,7,4
2022-06-14,Binh Duong,Di An,15,19,15,4,3
2022-06-14,Binh Duong,Di An,16,26,23,3,1
2022-06-14,Binh Duong,Di An,17,16,14,2,2
2022-06-14,Binh Duong,Di An,18,45,29,16,6
2022-06-14,Binh Duong,Di An,19,46,24,22,20
2022-06-14,Binh Duong,Di An,20,36,16,20,14
2022-06-14,Binh Duong,Di An,21,14,9,5,4
2022-06-14,Binh Duong,Di An,23,1,0,1,0
2022-06-14,Binh Duong,Tan Uyen,6,1,0,1,1
2022-06-14,Binh Duong,Tan Uyen,7,1,0,1,1
2022-06-14,Binh Duong,Tan Uyen,9,3,0,3,3
2022-06-14,Binh Duong,Tan Uyen,10,1,1,0,0
2022-06-14,Binh Duong,Tan Uyen,11,11,4,7,5
2022-06-14,Binh Duong,Tan Uyen,12,7,1,6,3
2022-06-14,Binh Duong,Tan Uyen,13,4,2,2,1
2022-06-14,Binh Duong,Tan Uyen,14,7,4,3,3
2022-06-14,Binh Duong,Tan Uyen,15,1,1,0,0
2022-06-14,Binh Duong,Tan Uyen,16,2,1,1,1
2022-06-14,Binh Duong,Tan Uyen,17,1,1,0,0
2022-06-14,Binh Duong,Tan Uyen,18,4,1,3,2
2022-06-14,Binh Duong,Tan Uyen,19,1,1,0,0
2022-06-14,Binh Duong,Tan Uyen,20,5,2,3,2
2022-06-14,Binh Duong,Tan Uyen,21,2,0,2,2
2022-06-14,Binh Duong,Thu Dau Mot Town,5,3,0,3,2
2022-06-14,Binh Duong,Thu Dau Mot Town,6,43,35,8,6
2022-06-14,Binh Duong,Thu Dau Mot Town,7,127,122,5,0
2022-06-14,Binh Duong,Thu Dau Mot Town,8,220,203,17,1
2022-06-14,Binh Duong,Thu Dau Mot Town,9,263,237,26,3
2022-06-14,Binh Duong,Thu Dau Mot Town,10,441,402,39,9
2022-06-14,Binh Duong,Thu Dau Mot Town,11,715,674,41,10
2022-06-14,Binh Duong,Thu Dau Mot Town,12,510,481,29,5
2022-06-14,Binh Duong,Thu Dau Mot Town,13,493,474,19,0
2022-06-14,Binh Duong,Thu Dau Mot Town,14,391,359,32,8
2022-06-14,Binh Duong,Thu Dau Mot Town,15,317,302,15,1
2022-06-14,Binh Duong,Thu Dau Mot Town,16,291,275,16,6
2022-06-14,Binh Duong,Thu Dau Mot Town,17,354,321,33,4
2022-06-14,Binh Duong,Thu Dau Mot Town,18,380,356,24,6
2022-06-14,Binh Duong,Thu Dau Mot Town,19,364,344,20,6
2022-06-14,Binh Duong,Thu Dau Mot Town,20,290,247,43,9
2022-06-14,Binh Duong,Thu Dau Mot Town,21,141,120,21,6
2022-06-14,Binh Duong,Thu Dau Mot Town,22,1,0,1,0
2022-06-14,Binh Duong,Thuan An,6,2,0,2,2
2022-06-14,Binh Duong,Thuan An,7,10,7,3,3
2022-06-14,Binh Duong,Thuan An,8,22,13,9,7
2022-06-14,Binh Duong,Thuan An,9,38,19,19,12
2022-06-14,Binh Duong,Thuan An,10,76,49,27,19
2022-06-14,Binh Duong,Thuan An,11,86,66,20,11
2022-06-14,Binh Duong,Thuan An,12,70,50,20,11
2022-06-14,Binh Duong,Thuan An,13,78,57,21,15
2022-06-14,Binh Duong,Thuan An,14,51,38,13,6
2022-06-14,Binh Duong,Thuan An,15,45,37,8,5
2022-06-14,Binh Duong,Thuan An,16,44,40,4,4
2022-06-14,Binh Duong,Thuan An,17,56,50,6,3
2022-06-14,Binh Duong,Thuan An,18,46,32,14,6
2022-06-14,Binh Duong,Thuan An,19,55,41,14,9
2022-06-14,Binh Duong,Thuan An,20,38,26,12,9
2022-06-14,Binh Duong,Thuan An,21,26,12,14,9
2022-06-14,Can Tho City,Binh Thuy District,6,4,1,3,1
2022-06-14,Can Tho City,Binh Thuy District,7,2,2,0,0
2022-06-14,Can Tho City,Binh Thuy District,8,3,3,0,0
2022-06-14,Can Tho City,Binh Thuy District,9,4,4,0,0
2022-06-14,Can Tho City,Binh Thuy District,10,8,7,1,1
2022-06-14,Can Tho City,Binh Thuy District,11,11,8,3,0
2022-06-14,Can Tho City,Binh Thuy District,12,7,6,1,0
2022-06-14,Can Tho City,Binh Thuy District,13,5,5,0,0
2022-06-14,Can Tho City,Binh Thuy District,14,14,14,0,0
2022-06-14,Can Tho City,Binh Thuy District,15,11,11,0,0
2022-06-14,Can Tho City,Binh Thuy District,16,10,8,2,0
2022-06-14,Can Tho City,Binh Thuy District,17,11,10,1,0
2022-06-14,Can Tho City,Binh Thuy District,18,23,23,0,0
2022-06-14,Can Tho City,Binh Thuy District,19,17,17,0,0
2022-06-14,Can Tho City,Binh Thuy District,20,11,7,4,1
2022-06-14,Can Tho City,Binh Thuy District,21,1,1,0,0
2022-06-14,Can Tho City,Cai Rang District,6,2,2,0,0
2022-06-14,Can Tho City,Cai Rang District,7,7,2,5,5
2022-06-14,Can Tho City,Cai Rang District,8,5,5,0,0
2022-06-14,Can Tho City,Cai Rang District,9,6,6,0,0
2022-06-14,Can Tho City,Cai Rang District,10,9,9,0,0
2022-06-14,Can Tho City,Cai Rang District,11,12,11,1,0
2022-06-14,Can Tho City,Cai Rang District,12,6,6,0,0
2022-06-14,Can Tho City,Cai Rang District,13,13,13,0,0
2022-06-14,Can Tho City,Cai Rang District,14,9,7,2,0
2022-06-14,Can Tho City,Cai Rang District,15,10,10,0,0
2022-06-14,Can Tho City,Cai Rang District,16,10,8,2,0
2022-06-14,Can Tho City,Cai Rang District,17,8,8,0,0
2022-06-14,Can Tho City,Cai Rang District,18,15,13,2,2
2022-06-14,Can Tho City,Cai Rang District,19,13,12,1,0
2022-06-14,Can Tho City,Cai Rang District,20,13,12,1,0
2022-06-14,Can Tho City,Cai Rang District,21,2,2,0,0
2022-06-14,Can Tho City,Ninh Kieu District,0,1,1,0,0
2022-06-14,Can Tho City,Ninh Kieu District,1,1,1,0,0
2022-06-14,Can Tho City,Ninh Kieu District,2,1,0,1,0
2022-06-14,Can Tho City,Ninh Kieu District,3,4,2,2,0
2022-06-14,Can Tho City,Ninh Kieu District,4,2,0,2,0
2022-06-14,Can Tho City,Ninh Kieu District,5,3,2,1,1
2022-06-14,Can Tho City,Ninh Kieu District,6,53,41,12,6
2022-06-14,Can Tho City,Ninh Kieu District,7,139,128,11,0
2022-06-14,Can Tho City,Ninh Kieu District,8,235,225,10,0
2022-06-14,Can Tho City,Ninh Kieu District,9,318,306,12,0
2022-06-14,Can Tho City,Ninh Kieu District,10,556,525,31,0
2022-06-14,Can Tho City,Ninh Kieu District,11,873,813,60,7
2022-06-14,Can Tho City,Ninh Kieu District,12,609,593,16,0
2022-06-14,Can Tho City,Ninh Kieu District,13,548,528,20,0
2022-06-14,Can Tho City,Ninh Kieu District,14,413,393,20,0
2022-06-14,Can Tho City,Ninh Kieu District,15,405,390,15,0
2022-06-14,Can Tho City,Ninh Kieu District,16,415,403,12,0
2022-06-14,Can Tho City,Ninh Kieu District,17,543,515,28,0
2022-06-14,Can Tho City,Ninh Kieu District,18,600,561,39,0
2022-06-14,Can Tho City,Ninh Kieu District,19,465,451,14,0
2022-06-14,Can Tho City,Ninh Kieu District,20,408,376,32,0
2022-06-14,Can Tho City,Ninh Kieu District,21,186,172,14,1
2022-06-14,Can Tho City,Ninh Kieu District,22,3,0,3,0
2022-06-14,Can Tho City,O Mon District,11,1,0,1,1
2022-06-14,Can Tho City,O Mon District,14,1,0,1,1
2022-06-14,Can Tho City,Thoi Lai,9,1,0,1,1
2022-06-14,Can Tho City,Thoi Lai,14,1,0,1,1
2022-06-14,Dong Nai,Bien Hoa City,0,1,1,0,0
2022-06-14,Dong Nai,Bien Hoa City,1,2,0,2,0
2022-06-14,Dong Nai,Bien Hoa City,2,2,0,2,0
2022-06-14,Dong Nai,Bien Hoa City,3,1,1,0,0
2022-06-14,Dong Nai,Bien Hoa City,4,2,1,1,0
2022-06-14,Dong Nai,Bien Hoa City,6,56,34,22,16
2022-06-14,Dong Nai,Bien Hoa City,7,191,152,39,15
2022-06-14,Dong Nai,Bien Hoa City,8,347,293,54,24
2022-06-14,Dong Nai,Bien Hoa City,9,432,391,41,7
2022-06-14,Dong Nai,Bien Hoa City,10,816,692,124,31
2022-06-14,Dong Nai,Bien Hoa City,11,1232,1118,114,37
2022-06-14,Dong Nai,Bien Hoa City,12,959,876,83,15
2022-06-14,Dong Nai,Bien Hoa City,13,919,842,77,21
2022-06-14,Dong Nai,Bien Hoa City,14,795,712,83,31
2022-06-14,Dong Nai,Bien Hoa City,15,595,541,54,23
2022-06-14,Dong Nai,Bien Hoa City,16,533,464,69,26
2022-06-14,Dong Nai,Bien Hoa City,17,612,543,69,17
2022-06-14,Dong Nai,Bien Hoa City,18,631,575,56,11
2022-06-14,Dong Nai,Bien Hoa City,19,653,575,78,29
2022-06-14,Dong Nai,Bien Hoa City,20,466,402,64,11
2022-06-14,Dong Nai,Bien Hoa City,21,234,167,67,28
2022-06-14,Dong Nai,Bien Hoa City,22,4,0,4,0
2022-06-14,Dong Nai,Long Thanh,9,1,0,1,1
2022-06-14,Dong Nai,Long Thanh,10,5,0,5,5
2022-06-14,Dong Nai,Long Thanh,11,2,0,2,2
2022-06-14,Dong Nai,Long Thanh,12,2,0,2,2
2022-06-14,Dong Nai,Long Thanh,13,1,0,1,1
2022-06-14,Dong Nai,Long Thanh,14,1,0,1,1
2022-06-14,Dong Nai,Long Thanh,15,3,0,3,3
2022-06-14,Dong Nai,Long Thanh,16,1,0,1,1
2022-06-14,Dong Nai,Long Thanh,18,1,0,1,1
2022-06-14,Dong Nai,Long Thanh,19,1,0,1,1
2022-06-14,Dong Nai,Long Thanh,20,1,0,1,1
2022-06-14,Dong Nai,Nhon trach,8,2,0,2,2
2022-06-14,Dong Nai,Nhon trach,9,2,0,2,2
2022-06-14,Dong Nai,Nhon trach,14,1,0,1,1
2022-06-14,Dong Nai,Nhon trach,15,1,0,1,1
2022-06-14,Dong Nai,Nhon trach,17,2,0,2,2
2022-06-14,Dong Nai,Nhon trach,18,1,0,1,1
2022-06-14,Dong Nai,Nhon trach,19,1,0,1,1
2022-06-14,Dong Nai,Trang Bom,11,4,0,4,3
2022-06-14,Dong Nai,Trang Bom,12,3,0,3,1
2022-06-14,Dong Nai,Trang Bom,14,2,0,2,2
2022-06-14,Dong Nai,Trang Bom,15,3,0,3,3
2022-06-14,Hai Phong City,An Duong,6,1,1,0,0
2022-06-14,Hai Phong City,An Duong,7,1,0,1,1
2022-06-14,Hai Phong City,An Duong,8,2,0,2,2
2022-06-14,Hai Phong City,An Duong,9,3,3,0,0
2022-06-14,Hai Phong City,An Duong,10,7,5,2,1
2022-06-14,Hai Phong City,An Duong,11,9,7,2,2
2022-06-14,Hai Phong City,An Duong,12,9,2,7,6
2022-06-14,Hai Phong City,An Duong,13,3,0,3,2
2022-06-14,Hai Phong City,An Duong,14,6,4,2,1
2022-06-14,Hai Phong City,An Duong,15,2,1,1,1
2022-06-14,Hai Phong City,An Duong,16,1,1,0,0
2022-06-14,Hai Phong City,An Duong,17,2,2,0,0
2022-06-14,Hai Phong City,An Duong,18,6,3,3,3
2022-06-14,Hai Phong City,An Duong,19,1,0,1,1
2022-06-14,Hai Phong City,An Duong,20,7,0,7,7
2022-06-14,Hai Phong City,An Duong,21,4,0,4,3
2022-06-14,Hai Phong City,Do Son District,12,2,0,2,2
2022-06-14,Hai Phong City,Duong Kinh District,14,1,0,1,0
2022-06-14,Hai Phong City,Duong Kinh District,20,1,0,1,1
2022-06-14,Hai Phong City,Hai An District,7,4,1,3,1
2022-06-14,Hai Phong City,Hai An District,8,14,7,7,4
2022-06-14,Hai Phong City,Hai An District,9,13,10,3,1
2022-06-14,Hai Phong City,Hai An District,10,39,28,11,2
2022-06-14,Hai Phong City,Hai An District,11,39,33,6,2
2022-06-14,Hai Phong City,Hai An District,12,22,19,3,1
2022-06-14,Hai Phong City,Hai An District,13,20,15,5,4
2022-06-14,Hai Phong City,Hai An District,14,20,10,10,8
2022-06-14,Hai Phong City,Hai An District,15,16,13,3,1
2022-06-14,Hai Phong City,Hai An District,16,19,17,2,1
2022-06-14,Hai Phong City,Hai An District,17,19,18,1,0
2022-06-14,Hai Phong City,Hai An District,18,23,18,5,2
2022-06-14,Hai Phong City,Hai An District,19,27,12,15,12
2022-06-14,Hai Phong City,Hai An District,20,20,9,11,7
2022-06-14,Hai Phong City,Hai An District,21,13,4,9,5
2022-06-14,Hai Phong City,Hong Bang District,2,1,1,0,0
2022-06-14,Hai Phong City,Hong Bang District,5,1,0,1,1
2022-06-14,Hai Phong City,Hong Bang District,6,1,0,1,0
2022-06-14,Hai Phong City,Hong Bang District,7,17,6,11,8
2022-06-14,Hai Phong City,Hong Bang District,8,49,37,12,9
2022-06-14,Hai Phong City,Hong Bang District,9,40,36,4,0
2022-06-14,Hai Phong City,Hong Bang District,10,61,55,6,3
2022-06-14,Hai Phong City,Hong Bang District,11,94,77,17,6
2022-06-14,Hai Phong City,Hong Bang District,12,58,48,10,4
2022-06-14,Hai Phong City,Hong Bang District,13,38,30,8,4
2022-06-14,Hai Phong City,Hong Bang District,14,60,43,17,11
2022-06-14,Hai Phong City,Hong Bang District,15,50,40,10,7
2022-06-14,Hai Phong City,Hong Bang District,16,41,33,8,3
2022-06-14,Hai Phong City,Hong Bang District,17,45,37,8,0
2022-06-14,Hai Phong City,Hong Bang District,18,70,47,23,17
2022-06-14,Hai Phong City,Hong Bang District,19,88,32,56,47
2022-06-14,Hai Phong City,Hong Bang District,20,49,23,26,16
2022-06-14,Hai Phong City,Hong Bang District,21,18,13,5,3
2022-06-14,Hai Phong City,Kien An District,7,3,1,2,2
2022-06-14,Hai Phong City,Kien An District,8,2,0,2,2
2022-06-14,Hai Phong City,Kien An District,9,1,0,1,1
2022-06-14,Hai Phong City,Kien An District,10,7,2,5,5
2022-06-14,Hai Phong City,Kien An District,11,20,9,11,9
2022-06-14,Hai Phong City,Kien An District,12,13,8,5,2
2022-06-14,Hai Phong City,Kien An District,13,15,6,9,9
2022-06-14,Hai Phong City,Kien An District,14,13,10,3,1
2022-06-14,Hai Phong City,Kien An District,15,12,10,2,2
2022-06-14,Hai Phong City,Kien An District,16,12,8,4,3
2022-06-14,Hai Phong City,Kien An District,17,6,6,0,0
2022-06-14,Hai Phong City,Kien An District,18,13,5,8,8
2022-06-14,Hai Phong City,Kien An District,19,10,2,8,7
2022-06-14,Hai Phong City,Kien An District,20,16,3,13,12
2022-06-14,Hai Phong City,Kien An District,21,4,1,3,3
2022-06-14,Hai Phong City,Le Chan District,0,1,1,0,0
2022-06-14,Hai Phong City,Le Chan District,6,4,1,3,2
2022-06-14,Hai Phong City,Le Chan District,7,57,28,29,25
2022-06-14,Hai Phong City,Le Chan District,8,87,66,21,13
2022-06-14,Hai Phong City,Le Chan District,9,84,78,6,1
2022-06-14,Hai Phong City,Le Chan District,10,161,140,21,5
2022-06-14,Hai Phong City,Le Chan District,11,305,262,43,19
2022-06-14,Hai Phong City,Le Chan District,12,201,171,30,10
2022-06-14,Hai Phong City,Le Chan District,13,157,128,29,12
2022-06-14,Hai Phong City,Le Chan District,14,185,143,42,28
2022-06-14,Hai Phong City,Le Chan District,15,189,151,38,20
2022-06-14,Hai Phong City,Le Chan District,16,180,161,19,6
2022-06-14,Hai Phong City,Le Chan District,17,177,143,34,13
2022-06-14,Hai Phong City,Le Chan District,18,226,182,44,20
2022-06-14,Hai Phong City,Le Chan District,19,268,138,130,102
2022-06-14,Hai Phong City,Le Chan District,20,176,108,68,45
2022-06-14,Hai Phong City,Le Chan District,21,91,49,42,21
2022-06-14,Hai Phong City,Le Chan District,23,1,0,1,0
2022-06-14,Hai Phong City,Ngo Quyen District,1,1,0,1,0
2022-06-14,Hai Phong City,Ngo Quyen District,2,2,0,2,1
2022-06-14,Hai Phong City,Ngo Quyen District,7,20,10,10,7
2022-06-14,Hai Phong City,Ngo Quyen District,8,88,59,29,20
2022-06-14,Hai Phong City,Ngo Quyen District,9,77,72,5,0
2022-06-14,Hai Phong City,Ngo Quyen District,10,129,115,14,2
2022-06-14,Hai Phong City,Ngo Quyen District,11,239,208,31,12
2022-06-14,Hai Phong City,Ngo Quyen District,12,149,130,19,7
2022-06-14,Hai Phong City,Ngo Quyen District,13,121,94,27,11
2022-06-14,Hai Phong City,Ngo Quyen District,14,169,137,32,14
2022-06-14,Hai Phong City,Ngo Quyen District,15,151,121,30,15
2022-06-14,Hai Phong City,Ngo Quyen District,16,98,87,11,2
2022-06-14,Hai Phong City,Ngo Quyen District,17,105,90,15,5
2022-06-14,Hai Phong City,Ngo Quyen District,18,136,108,28,15
2022-06-14,Hai Phong City,Ngo Quyen District,19,182,82,100,83
2022-06-14,Hai Phong City,Ngo Quyen District,20,155,97,58,42
2022-06-14,Hai Phong City,Ngo Quyen District,21,81,44,37,15
2022-06-14,Hai Phong City,Thuy Nguyen,10,1,0,1,1
2022-06-14,Hai Phong City,Thuy Nguyen,11,1,0,1,1
2022-06-14,Hai Phong City,Thuy Nguyen,14,2,0,2,2
2022-06-14,Hai Phong City,Thuy Nguyen,15,5,0,5,4
2022-06-14,Hai Phong City,Thuy Nguyen,16,3,0,3,3
2022-06-14,Hai Phong City,Thuy Nguyen,19,3,0,3,2
2022-06-14,Hai Phong City,Thuy Nguyen,20,3,0,3,3
2022-06-14,Hue City,Hue City,0,4,2,2,1
2022-06-14,Hue City,Hue City,1,2,2,0,0
2022-06-14,Hue City,Hue City,4,1,1,0,0
2022-06-14,Hue City,Hue City,5,1,1,0,0
2022-06-14,Hue City,Hue City,6,74,65,9,5
2022-06-14,Hue City,Hue City,7,231,213,18,2
2022-06-14,Hue City,Hue City,8,378,356,22,0
2022-06-14,Hue City,Hue City,9,294,274,20,0
2022-06-14,Hue City,Hue City,10,459,435,24,1
2022-06-14,Hue City,Hue City,11,978,894,84,9
2022-06-14,Hue City,Hue City,12,678,618,60,4
2022-06-14,Hue City,Hue City,13,348,326,22,1
2022-06-14,Hue City,Hue City,14,450,418,32,4
2022-06-14,Hue City,Hue City,15,450,398,52,5
2022-06-14,Hue City,Hue City,16,440,396,44,10
2022-06-14,Hue City,Hue City,17,472,430,42,1
2022-06-14,Hue City,Hue City,18,546,500,46,1
2022-06-14,Hue City,Hue City,19,566,511,55,0
2022-06-14,Hue City,Hue City,20,420,367,53,4
2022-06-14,Hue City,Hue City,21,277,203,74,30
2022-06-14,Hue City,Hue City,22,1,0,1,0
2022-06-14,Hue City,Hue City,23,1,0,1,0
2022-06-14,Hue City,Huong Thuy,7,1,1,0,0
2022-06-14,Hue City,Huong Thuy,8,1,0,1,1
2022-06-14,Hue City,Huong Thuy,9,1,0,1,1
2022-06-14,Hue City,Huong Thuy,10,1,1,0,0
2022-06-14,Hue City,Huong Thuy,11,1,1,0,0
2022-06-14,Hue City,Huong Thuy,13,3,3,0,0
2022-06-14,Hue City,Huong Thuy,14,1,0,1,0
2022-06-14,Hue City,Huong Thuy,15,1,1,0,0
2022-06-14,Hue City,Huong Thuy,19,3,2,1,0
2022-06-14,Hue City,Huong Thuy,21,1,0,1,1
2022-06-14,Hue City,Huong Tra,8,1,1,0,0
2022-06-14,Hue City,Huong Tra,11,1,1,0,0
2022-06-14,Hue City,Huong Tra,19,3,2,1,1
2022-06-14,Hue City,Phu Vang,7,2,0,2,2
2022-06-14,Hue City,Phu Vang,8,8,5,3,0
2022-06-14,Hue City,Phu Vang,10,1,0,1,0
2022-06-14,Hue City,Phu Vang,11,5,3,2,2
2022-06-14,Hue City,Phu Vang,12,1,0,1,1
2022-06-14,Hue City,Phu Vang,13,1,0,1,1
2022-06-14,Hue City,Phu Vang,14,3,3,0,0
2022-06-14,Hue City,Phu Vang,15,1,1,0,0
2022-06-14,Hue City,Phu Vang,16,3,3,0,0
2022-06-14,Hue City,Phu Vang,19,1,1,0,0
2022-06-14,Hue City,Phu Vang,20,1,1,0,0
2022-06-14,Khanh Hoa,Cam Ranh City,11,1,0,1,1
2022-06-14,Khanh Hoa,Dien Khanh,7,2,0,2,2
2022-06-14,Khanh Hoa,Dien Khanh,13,1,1,0,0
2022-06-14,Khanh Hoa,Dien Khanh,18,1,0,1,1
2022-06-14,Khanh Hoa,Nha Trang City,0,3,1,2,0
2022-06-14,Khanh Hoa,Nha Trang City,5,2,1,1,0
2022-06-14,Khanh Hoa,Nha Trang City,6,29,28,1,0
2022-06-14,Khanh Hoa,Nha Trang City,7,120,108,12,0
2022-06-14,Khanh Hoa,Nha Trang City,8,219,205,14,5
2022-06-14,Khanh Hoa,Nha Trang City,9,189,177,12,2
2022-06-14,Khanh Hoa,Nha Trang City,10,226,206,20,1
2022-06-14,Khanh Hoa,Nha Trang City,11,409,369,40,12
2022-06-14,Khanh Hoa,Nha Trang City,12,326,283,43,13
2022-06-14,Khanh Hoa,Nha Trang City,13,258,240,18,3
2022-06-14,Khanh Hoa,Nha Trang City,14,261,248,13,0
2022-06-14,Khanh Hoa,Nha Trang City,15,212,192,20,2
2022-06-14,Khanh Hoa,Nha Trang City,16,189,179,10,1
2022-06-14,Khanh Hoa,Nha Trang City,17,197,179,18,0
2022-06-14,Khanh Hoa,Nha Trang City,18,299,269,30,2
2022-06-14,Khanh Hoa,Nha Trang City,19,265,234,31,0
2022-06-14,Khanh Hoa,Nha Trang City,20,179,156,23,1
2022-06-14,Khanh Hoa,Nha Trang City,21,100,71,29,6
2022-06-14,Khanh Hoa,Nha Trang City,22,3,1,2,1
2022-06-14,Khanh Hoa,Nha Trang City,23,1,1,0,0
2022-06-14,Lam Dong,Da Lat City,1,1,0,1,0
2022-06-14,Lam Dong,Da Lat City,5,1,1,0,0
2022-06-14,Lam Dong,Da Lat City,6,1,1,0,0
2022-06-14,Lam Dong,Da Lat City,7,48,37,11,6
2022-06-14,Lam Dong,Da Lat City,8,98,73,25,11
2022-06-14,Lam Dong,Da Lat City,9,104,80,24,13
2022-06-14,Lam Dong,Da Lat City,10,84,72,12,5
2022-06-14,Lam Dong,Da Lat City,11,158,109,49,34
2022-06-14,Lam Dong,Da Lat City,12,172,134,38,22
2022-06-14,Lam Dong,Da Lat City,13,134,92,42,26
2022-06-14,Lam Dong,Da Lat City,14,107,87,20,7
2022-06-14,Lam Dong,Da Lat City,15,92,78,14,7
2022-06-14,Lam Dong,Da Lat City,16,85,67,18,16
2022-06-14,Lam Dong,Da Lat City,17,140,98,42,27
2022-06-14,Lam Dong,Da Lat City,18,145,103,42,21
2022-06-14,Lam Dong,Da Lat City,19,121,94,27,8
2022-06-14,Lam Dong,Da Lat City,20,101,76,25,19
2022-06-14,Lam Dong,Da Lat City,21,54,31,23,13
2022-06-14,Lam Dong,Da Lat City,22,1,1,0,0
2022-06-14,Nghe An,Vinh City,1,1,1,0,0
2022-06-14,Nghe An,Vinh City,6,3,3,0,0
2022-06-14,Nghe An,Vinh City,7,123,108,15,3
2022-06-14,Nghe An,Vinh City,8,197,168,29,2
2022-06-14,Nghe An,Vinh City,9,169,149,20,0
2022-06-14,Nghe An,Vinh City,10,262,227,35,4
2022-06-14,Nghe An,Vinh City,11,417,331,86,27
2022-06-14,Nghe An,Vinh City,12,257,220,37,8
2022-06-14,Nghe An,Vinh City,13,157,130,27,2
2022-06-14,Nghe An,Vinh City,14,212,175,37,6
2022-06-14,Nghe An,Vinh City,15,175,153,22,4
2022-06-14,Nghe An,Vinh City,16,108,101,7,0
2022-06-14,Nghe An,Vinh City,17,166,124,42,13
2022-06-14,Nghe An,Vinh City,18,223,166,57,12
2022-06-14,Nghe An,Vinh City,19,177,140,37,10
2022-06-14,Nghe An,Vinh City,20,165,108,57,37
2022-06-14,Nghe An,Vinh City,21,88,60,28,12
2022-06-14,Nghe An,Vinh City,22,1,0,1,0
2022-06-14,Quang Nam,Hoi An City,7,11,9,2,1
2022-06-14,Quang Nam,Hoi An City,8,28,21,7,4
2022-06-14,Quang Nam,Hoi An City,9,19,16,3,1
2022-06-14,Quang Nam,Hoi An City,10,33,24,9,2
2022-06-14,Quang Nam,Hoi An City,11,48,41,7,2
2022-06-14,Quang Nam,Hoi An City,12,35,31,4,2
2022-06-14,Quang Nam,Hoi An City,13,35,29,6,2
2022-06-14,Quang Nam,Hoi An City,14,33,26,7,5
2022-06-14,Quang Nam,Hoi An City,15,40,33,7,2
2022-06-14,Quang Nam,Hoi An City,16,36,28,8,4
2022-06-14,Quang Nam,Hoi An City,17,30,29,1,0
2022-06-14,Quang Nam,Hoi An City,18,51,39,12,7
2022-06-14,Quang Nam,Hoi An City,19,52,32,20,13
2022-06-14,Quang Nam,Hoi An City,20,65,30,35,29
2022-06-14,Quang Nam,Hoi An City,21,33,8,25,21
2022-06-14,Quang Nam,Tam Ky City,13,1,0,1,1
2022-06-14,Quang Nam,Tam Ky City,14,1,0,1,1
2022-06-14,Quang Ninh,Cam Pha City,8,1,0,1,1
2022-06-14,Quang Ninh,Cam Pha City,10,1,0,1,1
2022-06-14,Quang Ninh,Cam Pha City,11,1,0,1,1
2022-06-14,Quang Ninh,Cam Pha City,15,1,0,1,1
2022-06-14,Quang Ninh,Cam Pha City,16,1,0,1,1
2022-06-14,Quang Ninh,Cam Pha City,19,1,0,1,1
2022-06-14,Quang Ninh,Ha Long City,0,1,1,0,0
2022-06-14,Quang Ninh,Ha Long City,7,25,16,9,4
2022-06-14,Quang Ninh,Ha Long City,8,50,37,13,5
2022-06-14,Quang Ninh,Ha Long City,9,66,47,19,12
2022-06-14,Quang Ninh,Ha Long City,10,71,45,26,9
2022-06-14,Quang Ninh,Ha Long City,11,111,98,13,9
2022-06-14,Quang Ninh,Ha Long City,12,75,67,8,3
2022-06-14,Quang Ninh,Ha Long City,13,67,47,20,11
2022-06-14,Quang Ninh,Ha Long City,14,56,46,10,5
2022-06-14,Quang Ninh,Ha Long City,15,71,58,13,5
2022-06-14,Quang Ninh,Ha Long City,16,53,41,12,4
2022-06-14,Quang Ninh,Ha Long City,17,64,49,15,7
2022-06-14,Quang Ninh,Ha Long City,18,59,41,18,5
2022-06-14,Quang Ninh,Ha Long City,19,54,35,19,13
2022-06-14,Quang Ninh,Ha Long City,20,53,19,34,17
2022-06-14,Quang Ninh,Ha Long City,21,2,0,2,0
2022-06-14,Thai Nguyen,Dong Hy,11,2,1,1,0
2022-06-14,Thai Nguyen,Dong Hy,12,2,1,1,1
2022-06-14,Thai Nguyen,Dong Hy,20,1,0,1,0
2022-06-14,Thai Nguyen,Thai Nguyen City,0,2,2,0,0
2022-06-14,Thai Nguyen,Thai Nguyen City,1,1,0,1,0
2022-06-14,Thai Nguyen,Thai Nguyen City,5,1,1,0,0
2022-06-14,Thai Nguyen,Thai Nguyen City,6,3,1,2,0
2022-06-14,Thai Nguyen,Thai Nguyen City,7,95,87,8,3
2022-06-14,Thai Nguyen,Thai Nguyen City,8,113,99,14,1
2022-06-14,Thai Nguyen,Thai Nguyen City,9,119,105,14,3
2022-06-14,Thai Nguyen,Thai Nguyen City,10,196,171,25,4
2022-06-14,Thai Nguyen,Thai Nguyen City,11,372,347,25,0
2022-06-14,Thai Nguyen,Thai Nguyen City,12,232,219,13,2
2022-06-14,Thai Nguyen,Thai Nguyen City,13,141,129,12,0
2022-06-14,Thai Nguyen,Thai Nguyen City,14,167,150,17,2
2022-06-14,Thai Nguyen,Thai Nguyen City,15,145,131,14,1
2022-06-14,Thai Nguyen,Thai Nguyen City,16,129,115,14,1
2022-06-14,Thai Nguyen,Thai Nguyen City,17,131,115,16,0
2022-06-14,Thai Nguyen,Thai Nguyen City,18,205,193,12,0
2022-06-14,Thai Nguyen,Thai Nguyen City,19,238,208,30,2
2022-06-14,Thai Nguyen,Thai Nguyen City,20,149,136,13,0
2022-06-14,Thai Nguyen,Thai Nguyen City,21,117,101,16,3
2022-06-14,Thai Nguyen,Thai Nguyen City,22,2,1,1,0
2022-06-14,Vung Tau,Ba Ria City,8,2,1,1,1
2022-06-14,Vung Tau,Ba Ria City,9,12,6,6,6
2022-06-14,Vung Tau,Ba Ria City,10,8,6,2,1
2022-06-14,Vung Tau,Ba Ria City,11,6,4,2,2
2022-06-14,Vung Tau,Ba Ria City,12,6,4,2,2
2022-06-14,Vung Tau,Ba Ria City,13,6,3,3,3
2022-06-14,Vung Tau,Ba Ria City,14,5,1,4,2
2022-06-14,Vung Tau,Ba Ria City,15,5,5,0,0
2022-06-14,Vung Tau,Ba Ria City,16,9,5,4,2
2022-06-14,Vung Tau,Ba Ria City,17,5,1,4,3
2022-06-14,Vung Tau,Ba Ria City,18,12,5,7,6
2022-06-14,Vung Tau,Ba Ria City,19,4,1,3,2
2022-06-14,Vung Tau,Ba Ria City,20,7,1,6,5
2022-06-14,Vung Tau,Ba Ria City,21,3,0,3,2
2022-06-14,Vung Tau,Vung Tau City,0,2,0,2,0
2022-06-14,Vung Tau,Vung Tau City,4,1,1,0,0
2022-06-14,Vung Tau,Vung Tau City,5,2,1,1,1
2022-06-14,Vung Tau,Vung Tau City,6,37,35,2,1
2022-06-14,Vung Tau,Vung Tau City,7,95,84,11,5
2022-06-14,Vung Tau,Vung Tau City,8,186,167,19,2
2022-06-14,Vung Tau,Vung Tau City,9,183,168,15,2
2022-06-14,Vung Tau,Vung Tau City,10,227,208,19,2
2022-06-14,Vung Tau,Vung Tau City,11,331,301,30,10
2022-06-14,Vung Tau,Vung Tau City,12,332,301,31,6
2022-06-14,Vung Tau,Vung Tau City,13,238,222,16,3
2022-06-14,Vung Tau,Vung Tau City,14,257,233,24,8
2022-06-14,Vung Tau,Vung Tau City,15,267,252,15,3
2022-06-14,Vung Tau,Vung Tau City,16,184,172,12,1
2022-06-14,Vung Tau,Vung Tau City,17,256,226,30,3
2022-06-14,Vung Tau,Vung Tau City,18,286,260,26,1
2022-06-14,Vung Tau,Vung Tau City,19,278,249,29,3
2022-06-14,Vung Tau,Vung Tau City,20,224,187,37,13
2022-06-14,Vung Tau,Vung Tau City,21,92,76,16,7
2022-06-14,Vung Tau,Vung Tau City,22,1,0,1,0
2022-06-15,Bac Ninh,Bác Ninh City,1,2,2,0,0
2022-06-15,Bac Ninh,Bác Ninh City,6,9,4,5,1
2022-06-15,Bac Ninh,Bác Ninh City,7,71,67,4,1
2022-06-15,Bac Ninh,Bác Ninh City,8,128,122,6,1
2022-06-15,Bac Ninh,Bác Ninh City,9,133,116,17,2
2022-06-15,Bac Ninh,Bác Ninh City,10,157,143,14,1
2022-06-15,Bac Ninh,Bác Ninh City,11,332,300,32,8
2022-06-15,Bac Ninh,Bác Ninh City,12,244,223,21,1
2022-06-15,Bac Ninh,Bác Ninh City,13,167,154,13,0
2022-06-15,Bac Ninh,Bác Ninh City,14,130,120,10,2
2022-06-15,Bac Ninh,Bác Ninh City,15,122,108,14,1
2022-06-15,Bac Ninh,Bác Ninh City,16,136,125,11,0
2022-06-15,Bac Ninh,Bác Ninh City,17,126,118,8,2
2022-06-15,Bac Ninh,Bác Ninh City,18,165,158,7,0
2022-06-15,Bac Ninh,Bác Ninh City,19,181,168,13,1
2022-06-15,Bac Ninh,Bác Ninh City,20,170,143,27,7
2022-06-15,Bac Ninh,Bác Ninh City,21,102,68,34,21
2022-06-15,Bac Ninh,Bác Ninh City,22,1,0,1,0
2022-06-15,Bac Ninh,Bác Ninh City,23,1,0,1,0
2022-06-15,Bac Ninh,Luong Tai,14,1,0,1,1
2022-06-15,Bac Ninh,Luong Tai,15,1,0,1,1
2022-06-15,Bac Ninh,Luong Tai,20,1,0,1,1
2022-06-15,Bac Ninh,Que Vo,8,1,0,1,1
2022-06-15,Bac Ninh,Que Vo,9,2,2,0,0
2022-06-15,Bac Ninh,Que Vo,13,2,1,1,1
2022-06-15,Bac Ninh,Que Vo,14,2,1,1,1
2022-06-15,Bac Ninh,Que Vo,15,1,0,1,1
2022-06-15,Bac Ninh,Que Vo,17,1,0,1,1
2022-06-15,Bac Ninh,Que Vo,18,3,0,3,2
2022-06-15,Bac Ninh,Que Vo,19,2,0,2,1
2022-06-15,Bac Ninh,Que Vo,20,1,0,1,1
2022-06-15,Bac Ninh,Tien Du,10,1,0,1,0
2022-06-15,Bac Ninh,Tien Du,11,3,0,3,2
2022-06-15,Bac Ninh,Tien Du,12,2,0,2,2
2022-06-15,Bac Ninh,Tien Du,13,1,0,1,1
2022-06-15,Bac Ninh,Tien Du,14,1,0,1,1
2022-06-15,Bac Ninh,Tien Du,16,2,0,2,2
2022-06-15,Bac Ninh,Tien Du,17,2,0,2,2
2022-06-15,Bac Ninh,Tu Son,10,1,0,1,1
2022-06-15,Bac Ninh,Tu Son,12,4,0,4,4
2022-06-15,Bac Ninh,Tu Son,13,2,0,2,1
2022-06-15,Bac Ninh,Tu Son,14,1,0,1,1
2022-06-15,Bac Ninh,Tu Son,16,3,0,3,2
2022-06-15,Bac Ninh,Tu Son,17,4,0,4,4
2022-06-15,Bac Ninh,Tu Son,19,1,0,1,0
2022-06-15,Bac Ninh,Tu Son,20,3,0,3,3
2022-06-15,Binh Duong,Ben Cat,7,2,0,2,2
2022-06-15,Binh Duong,Ben Cat,10,1,0,1,0
2022-06-15,Binh Duong,Ben Cat,11,1,0,1,1
2022-06-15,Binh Duong,Ben Cat,15,1,0,1,1
2022-06-15,Binh Duong,Ben Cat,17,3,0,3,3
2022-06-15,Binh Duong,Ben Cat,18,3,0,3,3
2022-06-15,Binh Duong,Ben Cat,19,2,0,2,2
2022-06-15,Binh Duong,Ben Cat,20,1,0,1,1
2022-06-15,Binh Duong,Di An,2,1,0,1,0
2022-06-15,Binh Duong,Di An,7,5,1,4,4
2022-06-15,Binh Duong,Di An,8,14,5,9,9
2022-06-15,Binh Duong,Di An,9,29,15,14,11
2022-06-15,Binh Duong,Di An,10,35,23,12,6
2022-06-15,Binh Duong,Di An,11,45,40,5,3
2022-06-15,Binh Duong,Di An,12,32,22,10,8
2022-06-15,Binh Duong,Di An,13,45,22,23,21
2022-06-15,Binh Duong,Di An,14,36,26,10,7
2022-06-15,Binh Duong,Di An,15,26,22,4,4
2022-06-15,Binh Duong,Di An,16,23,16,7,5
2022-06-15,Binh Duong,Di An,17,34,27,7,6
2022-06-15,Binh Duong,Di An,18,22,18,4,1
2022-06-15,Binh Duong,Di An,19,22,18,4,2
2022-06-15,Binh Duong,Di An,20,21,14,7,3
2022-06-15,Binh Duong,Di An,21,14,8,6,4
2022-06-15,Binh Duong,Di An,22,1,0,1,0
2022-06-15,Binh Duong,Tan Uyen,8,1,1,0,0
2022-06-15,Binh Duong,Tan Uyen,9,5,1,4,3
2022-06-15,Binh Duong,Tan Uyen,10,7,2,5,4
2022-06-15,Binh Duong,Tan Uyen,11,2,2,0,0
2022-06-15,Binh Duong,Tan Uyen,12,1,0,1,1
2022-06-15,Binh Duong,Tan Uyen,13,5,2,3,2
2022-06-15,Binh Duong,Tan Uyen,14,2,1,1,0
2022-06-15,Binh Duong,Tan Uyen,15,5,3,2,0
2022-06-15,Binh Duong,Tan Uyen,16,3,1,2,2
2022-06-15,Binh Duong,Tan Uyen,17,3,2,1,1
2022-06-15,Binh Duong,Tan Uyen,18,3,2,1,0
2022-06-15,Binh Duong,Tan Uyen,19,1,1,0,0
2022-06-15,Binh Duong,Tan Uyen,20,4,1,3,3
2022-06-15,Binh Duong,Thu Dau Mot Town,5,3,2,1,0
2022-06-15,Binh Duong,Thu Dau Mot Town,6,32,29,3,3
2022-06-15,Binh Duong,Thu Dau Mot Town,7,121,108,13,3
2022-06-15,Binh Duong,Thu Dau Mot Town,8,249,231,18,6
2022-06-15,Binh Duong,Thu Dau Mot Town,9,298,273,25,3
2022-06-15,Binh Duong,Thu Dau Mot Town,10,442,408,34,2
2022-06-15,Binh Duong,Thu Dau Mot Town,11,774,712,62,10
2022-06-15,Binh Duong,Thu Dau Mot Town,12,481,455,26,3
2022-06-15,Binh Duong,Thu Dau Mot Town,13,421,391,30,3
2022-06-15,Binh Duong,Thu Dau Mot Town,14,271,243,28,2
2022-06-15,Binh Duong,Thu Dau Mot Town,15,349,318,31,2
2022-06-15,Binh Duong,Thu Dau Mot Town,16,345,331,14,2
2022-06-15,Binh Duong,Thu Dau Mot Town,17,393,374,19,2
2022-06-15,Binh Duong,Thu Dau Mot Town,18,465,440,25,2
2022-06-15,Binh Duong,Thu Dau Mot Town,19,383,354,29,5
2022-06-15,Binh Duong,Thu Dau Mot Town,20,271,239,32,13
2022-06-15,Binh Duong,Thu Dau Mot Town,21,135,116,19,4
2022-06-15,Binh Duong,Thuan An,2,1,0,1,0
2022-06-15,Binh Duong,Thuan An,6,2,0,2,2
2022-06-15,Binh Duong,Thuan An,7,8,3,5,4
2022-06-15,Binh Duong,Thuan An,8,24,17,7,4
2022-06-15,Binh Duong,Thuan An,9,46,36,10,5
2022-06-15,Binh Duong,Thuan An,10,65,53,12,3
2022-06-15,Binh Duong,Thuan An,11,95,80,15,5
2022-06-15,Binh Duong,Thuan An,12,68,54,14,5
2022-06-15,Binh Duong,Thuan An,13,95,72,23,10
2022-06-15,Binh Duong,Thuan An,14,42,34,8,6
2022-06-15,Binh Duong,Thuan An,15,52,41,11,2
2022-06-15,Binh Duong,Thuan An,16,48,38,10,4
2022-06-15,Binh Duong,Thuan An,17,47,41,6,1
2022-06-15,Binh Duong,Thuan An,18,40,36,4,0
2022-06-15,Binh Duong,Thuan An,19,35,32,3,2
2022-06-15,Binh Duong,Thuan An,20,34,23,11,6
2022-06-15,Binh Duong,Thuan An,21,30,6,24,12
2022-06-15,Binh Duong,Thuan An,22,2,0,2,0
2022-06-15,Can Tho City,Binh Thuy District,7,3,2,1,0
2022-06-15,Can Tho City,Binh Thuy District,8,5,3,2,0
2022-06-15,Can Tho City,Binh Thuy District,9,5,4,1,1
2022-06-15,Can Tho City,Binh Thuy District,10,11,10,1,0
2022-06-15,Can Tho City,Binh Thuy District,11,19,18,1,0
2022-06-15,Can Tho City,Binh Thuy District,12,12,11,1,0
2022-06-15,Can Tho City,Binh Thuy District,13,6,6,0,0
2022-06-15,Can Tho City,Binh Thuy District,14,13,11,2,0
2022-06-15,Can Tho City,Binh Thuy District,15,15,15,0,0
2022-06-15,Can Tho City,Binh Thuy District,16,11,10,1,0
2022-06-15,Can Tho City,Binh Thuy District,17,9,9,0,0
2022-06-15,Can Tho City,Binh Thuy District,18,8,7,1,0
2022-06-15,Can Tho City,Binh Thuy District,19,6,6,0,0
2022-06-15,Can Tho City,Binh Thuy District,20,9,9,0,0
2022-06-15,Can Tho City,Binh Thuy District,21,4,4,0,0
2022-06-15,Can Tho City,Cai Rang District,6,2,2,0,0
2022-06-15,Can Tho City,Cai Rang District,7,3,3,0,0
2022-06-15,Can Tho City,Cai Rang District,8,7,6,1,1
2022-06-15,Can Tho City,Cai Rang District,9,14,11,3,2
2022-06-15,Can Tho City,Cai Rang District,10,13,10,3,1
2022-06-15,Can Tho City,Cai Rang District,11,24,19,5,1
2022-06-15,Can Tho City,Cai Rang District,12,15,11,4,1
2022-06-15,Can Tho City,Cai Rang District,13,10,8,2,1
2022-06-15,Can Tho City,Cai Rang District,14,11,9,2,2
2022-06-15,Can Tho City,Cai Rang District,15,8,6,2,0
2022-06-15,Can Tho City,Cai Rang District,16,8,8,0,0
2022-06-15,Can Tho City,Cai Rang District,17,15,14,1,0
2022-06-15,Can Tho City,Cai Rang District,18,12,12,0,0
2022-06-15,Can Tho City,Cai Rang District,19,12,9,3,0
2022-06-15,Can Tho City,Cai Rang District,20,16,15,1,0
2022-06-15,Can Tho City,Cai Rang District,21,2,2,0,0
2022-06-15,Can Tho City,Ninh Kieu District,0,4,3,1,0
2022-06-15,Can Tho City,Ninh Kieu District,1,3,2,1,0
2022-06-15,Can Tho City,Ninh Kieu District,2,2,2,0,0
2022-06-15,Can Tho City,Ninh Kieu District,5,5,4,1,0
2022-06-15,Can Tho City,Ninh Kieu District,6,30,28,2,0
2022-06-15,Can Tho City,Ninh Kieu District,7,128,121,7,0
2022-06-15,Can Tho City,Ninh Kieu District,8,225,209,16,0
2022-06-15,Can Tho City,Ninh Kieu District,9,282,260,22,0
2022-06-15,Can Tho City,Ninh Kieu District,10,584,563,21,1
2022-06-15,Can Tho City,Ninh Kieu District,11,814,769,45,7
2022-06-15,Can Tho City,Ninh Kieu District,12,691,669,22,1
2022-06-15,Can Tho City,Ninh Kieu District,13,532,512,20,3
2022-06-15,Can Tho City,Ninh Kieu District,14,439,420,19,0
2022-06-15,Can Tho City,Ninh Kieu District,15,385,369,16,0
2022-06-15,Can Tho City,Ninh Kieu District,16,416,398,18,0
2022-06-15,Can Tho City,Ninh Kieu District,17,481,451,30,0
2022-06-15,Can Tho City,Ninh Kieu District,18,527,487,40,0
2022-06-15,Can Tho City,Ninh Kieu District,19,472,449,23,0
2022-06-15,Can Tho City,Ninh Kieu District,20,384,353,31,0
2022-06-15,Can Tho City,Ninh Kieu District,21,192,180,12,0
2022-06-15,Can Tho City,Ninh Kieu District,22,1,0,1,0
2022-06-15,Can Tho City,O Mon District,20,1,0,1,0
2022-06-15,Can Tho City,Thoi Lai,19,1,0,1,1
2022-06-15,Dong Nai,Bien Hoa City,0,2,1,1,0
2022-06-15,Dong Nai,Bien Hoa City,1,3,2,1,0
2022-06-15,Dong Nai,Bien Hoa City,2,2,0,2,0
2022-06-15,Dong Nai,Bien Hoa City,6,53,35,18,13
2022-06-15,Dong Nai,Bien Hoa City,7,173,141,32,13
2022-06-15,Dong Nai,Bien Hoa City,8,277,241,36,13
2022-06-15,Dong Nai,Bien Hoa City,9,453,408,45,12
2022-06-15,Dong Nai,Bien Hoa City,10,842,757,85,16
2022-06-15,Dong Nai,Bien Hoa City,11,1144,1047,97,20
2022-06-15,Dong Nai,Bien Hoa City,12,865,799,66,10
2022-06-15,Dong Nai,Bien Hoa City,13,951,866,85,19
2022-06-15,Dong Nai,Bien Hoa City,14,627,572,55,11
2022-06-15,Dong Nai,Bien Hoa City,15,449,403,46,10
2022-06-15,Dong Nai,Bien Hoa City,16,604,535,69,20
2022-06-15,Dong Nai,Bien Hoa City,17,640,577,63,15
2022-06-15,Dong Nai,Bien Hoa City,18,679,632,47,5
2022-06-15,Dong Nai,Bien Hoa City,19,699,635,64,16
2022-06-15,Dong Nai,Bien Hoa City,20,464,398,66,19
2022-06-15,Dong Nai,Bien Hoa City,21,211,153,58,13
2022-06-15,Dong Nai,Bien Hoa City,22,2,0,2,0
2022-06-15,Dong Nai,Long Khanh,13,2,0,2,2
2022-06-15,Dong Nai,Long Khanh,15,1,0,1,1
2022-06-15,Dong Nai,Long Khanh,19,1,0,1,1
2022-06-15,Dong Nai,Long Thanh,9,1,0,1,1
2022-06-15,Dong Nai,Long Thanh,10,5,0,5,4
2022-06-15,Dong Nai,Long Thanh,12,1,0,1,1
2022-06-15,Dong Nai,Long Thanh,13,1,0,1,1
2022-06-15,Dong Nai,Long Thanh,16,1,0,1,0
2022-06-15,Dong Nai,Long Thanh,17,1,0,1,1
2022-06-15,Dong Nai,Long Thanh,19,3,0,3,3
2022-06-15,Dong Nai,Nhon trach,8,1,0,1,1
2022-06-15,Dong Nai,Nhon trach,11,2,0,2,2
2022-06-15,Dong Nai,Nhon trach,12,1,0,1,1
2022-06-15,Dong Nai,Nhon trach,15,2,0,2,2
2022-06-15,Dong Nai,Trang Bom,11,3,0,3,0
2022-06-15,Dong Nai,Trang Bom,16,2,1,1,0
2022-06-15,Dong Nai,Trang Bom,18,3,0,3,3
2022-06-15,Dong Nai,Trang Bom,20,1,0,1,0
2022-06-15,Dong Nai,Trang Bom,21,1,0,1,1
2022-06-15,Hai Phong City,An Duong,7,1,0,1,1
2022-06-15,Hai Phong City,An Duong,8,5,1,4,2
2022-06-15,Hai Phong City,An Duong,10,3,2,1,1
2022-06-15,Hai Phong City,An Duong,11,4,3,1,0
2022-06-15,Hai Phong City,An Duong,12,2,0,2,2
2022-06-15,Hai Phong City,An Duong,13,5,0,5,5
2022-06-15,Hai Phong City,An Duong,14,9,2,7,7
2022-06-15,Hai Phong City,An Duong,15,5,2,3,3
2022-06-15,Hai Phong City,An Duong,16,1,0,1,0
2022-06-15,Hai Phong City,An Duong,17,1,0,1,1
2022-06-15,Hai Phong City,An Duong,19,3,2,1,0
2022-06-15,Hai Phong City,An Duong,20,2,0,2,2
2022-06-15,Hai Phong City,An Duong,21,1,1,0,0
2022-06-15,Hai Phong City,Do Son District,18,2,0,2,2
2022-06-15,Hai Phong City,Duong Kinh District,10,1,0,1,1
2022-06-15,Hai Phong City,Duong Kinh District,20,1,0,1,1
2022-06-15,Hai Phong City,Hai An District,7,7,5,2,2
2022-06-15,Hai Phong City,Hai An District,8,15,9,6,3
2022-06-15,Hai Phong City,Hai An District,9,19,18,1,1
2022-06-15,Hai Phong City,Hai An District,10,25,18,7,2
2022-06-15,Hai Phong City,Hai An District,11,31,28,3,3
2022-06-15,Hai Phong City,Hai An District,12,20,15,5,3
2022-06-15,Hai Phong City,Hai An District,13,16,10,6,0
2022-06-15,Hai Phong City,Hai An District,14,21,17,4,4
2022-06-15,Hai Phong City,Hai An District,15,20,15,5,2
2022-06-15,Hai Phong City,Hai An District,16,23,22,1,0
2022-06-15,Hai Phong City,Hai An District,17,28,23,5,0
2022-06-15,Hai Phong City,Hai An District,18,24,22,2,1
2022-06-15,Hai Phong City,Hai An District,19,19,17,2,0
2022-06-15,Hai Phong City,Hai An District,20,13,12,1,1
2022-06-15,Hai Phong City,Hai An District,21,12,9,3,2
2022-06-15,Hai Phong City,Hong Bang District,2,1,0,1,1
2022-06-15,Hai Phong City,Hong Bang District,7,13,11,2,2
2022-06-15,Hai Phong City,Hong Bang District,8,33,21,12,6
2022-06-15,Hai Phong City,Hong Bang District,9,39,26,13,2
2022-06-15,Hai Phong City,Hong Bang District,10,53,48,5,0
2022-06-15,Hai Phong City,Hong Bang District,11,96,86,10,3
2022-06-15,Hai Phong City,Hong Bang District,12,44,39,5,3
2022-06-15,Hai Phong City,Hong Bang District,13,39,30,9,3
2022-06-15,Hai Phong City,Hong Bang District,14,42,33,9,5
2022-06-15,Hai Phong City,Hong Bang District,15,57,51,6,5
2022-06-15,Hai Phong City,Hong Bang District,16,46,42,4,2
2022-06-15,Hai Phong City,Hong Bang District,17,58,50,8,3
2022-06-15,Hai Phong City,Hong Bang District,18,60,50,10,1
2022-06-15,Hai Phong City,Hong Bang District,19,53,42,11,4
2022-06-15,Hai Phong City,Hong Bang District,20,37,22,15,9
2022-06-15,Hai Phong City,Hong Bang District,21,8,6,2,1
2022-06-15,Hai Phong City,Hong Bang District,23,1,0,1,0
2022-06-15,Hai Phong City,Kien An District,7,3,0,3,2
2022-06-15,Hai Phong City,Kien An District,8,6,0,6,5
2022-06-15,Hai Phong City,Kien An District,9,7,4,3,3
2022-06-15,Hai Phong City,Kien An District,10,7,6,1,1
2022-06-15,Hai Phong City,Kien An District,11,13,12,1,1
2022-06-15,Hai Phong City,Kien An District,12,11,7,4,4
2022-06-15,Hai Phong City,Kien An District,13,15,5,10,7
2022-06-15,Hai Phong City,Kien An District,14,22,8,14,12
2022-06-15,Hai Phong City,Kien An District,15,22,11,11,7
2022-06-15,Hai Phong City,Kien An District,16,7,6,1,0
2022-06-15,Hai Phong City,Kien An District,17,6,6,0,0
2022-06-15,Hai Phong City,Kien An District,18,10,9,1,0
2022-06-15,Hai Phong City,Kien An District,19,9,8,1,1
2022-06-15,Hai Phong City,Kien An District,20,10,6,4,3
2022-06-15,Hai Phong City,Kien An District,21,6,2,4,2
2022-06-15,Hai Phong City,Le Chan District,0,1,1,0,0
2022-06-15,Hai Phong City,Le Chan District,6,1,1,0,0
2022-06-15,Hai Phong City,Le Chan District,7,33,27,6,4
2022-06-15,Hai Phong City,Le Chan District,8,60,51,9,8
2022-06-15,Hai Phong City,Le Chan District,9,100,87,13,0
2022-06-15,Hai Phong City,Le Chan District,10,163,146,17,1
2022-06-15,Hai Phong City,Le Chan District,11,281,267,14,6
2022-06-15,Hai Phong City,Le Chan District,12,217,193,24,2
2022-06-15,Hai Phong City,Le Chan District,13,130,117,13,1
2022-06-15,Hai Phong City,Le Chan District,14,148,123,25,10
2022-06-15,Hai Phong City,Le Chan District,15,178,150,28,16
2022-06-15,Hai Phong City,Le Chan District,16,158,143,15,5
2022-06-15,Hai Phong City,Le Chan District,17,166,147,19,5
2022-06-15,Hai Phong City,Le Chan District,18,182,162,20,6
2022-06-15,Hai Phong City,Le Chan District,19,188,168,20,5
2022-06-15,Hai Phong City,Le Chan District,20,147,120,27,9
2022-06-15,Hai Phong City,Le Chan District,21,58,44,14,4
2022-06-15,Hai Phong City,Ngo Quyen District,0,1,1,0,0
2022-06-15,Hai Phong City,Ngo Quyen District,6,4,1,3,1
2022-06-15,Hai Phong City,Ngo Quyen District,7,22,13,9,8
2022-06-15,Hai Phong City,Ngo Quyen District,8,87,65,22,9
2022-06-15,Hai Phong City,Ngo Quyen District,9,81,73,8,1
2022-06-15,Hai Phong City,Ngo Quyen District,10,119,112,7,1
2022-06-15,Hai Phong City,Ngo Quyen District,11,225,202,23,8
2022-06-15,Hai Phong City,Ngo Quyen District,12,150,134,16,5
2022-06-15,Hai Phong City,Ngo Quyen District,13,120,105,15,4
2022-06-15,Hai Phong City,Ngo Quyen District,14,167,148,19,4
2022-06-15,Hai Phong City,Ngo Quyen District,15,142,121,21,3
2022-06-15,Hai Phong City,Ngo Quyen District,16,131,121,10,1
2022-06-15,Hai Phong City,Ngo Quyen District,17,135,118,17,6
2022-06-15,Hai Phong City,Ngo Quyen District,18,148,136,12,4
2022-06-15,Hai Phong City,Ngo Quyen District,19,150,128,22,4
2022-06-15,Hai Phong City,Ngo Quyen District,20,114,94,20,5
2022-06-15,Hai Phong City,Ngo Quyen District,21,67,46,21,4
2022-06-15,Hai Phong City,Ngo Quyen District,22,1,0,1,0
2022-06-15,Hai Phong City,Ngo Quyen District,23,1,0,1,0
2022-06-15,Hai Phong City,Thuy Nguyen,10,1,1,0,0
2022-06-15,Hai Phong City,Thuy Nguyen,11,5,1,4,2
2022-06-15,Hai Phong City,Thuy Nguyen,14,1,0,1,1
2022-06-15,Hai Phong City,Thuy Nguyen,18,1,0,1,1
2022-06-15,Hue City,Hue City,0,3,1,2,0
2022-06-15,Hue City,Hue City,1,2,1,1,0
2022-06-15,Hue City,Hue City,3,2,2,0,0
2022-06-15,Hue City,Hue City,4,1,1,0,0
2022-06-15,Hue City,Hue City,5,3,1,2,0
2022-06-15,Hue City,Hue City,6,71,65,6,2
2022-06-15,Hue City,Hue City,7,201,182,19,1
2022-06-15,Hue City,Hue City,8,330,311,19,0
2022-06-15,Hue City,Hue City,9,261,241,20,0
2022-06-15,Hue City,Hue City,10,436,400,36,0
2022-06-15,Hue City,Hue City,11,886,808,78,8
2022-06-15,Hue City,Hue City,12,566,526,40,1
2022-06-15,Hue City,Hue City,13,417,376,41,1
2022-06-15,Hue City,Hue City,14,411,371,40,0
2022-06-15,Hue City,Hue City,15,414,378,36,2
2022-06-15,Hue City,Hue City,16,419,382,37,3
2022-06-15,Hue City,Hue City,17,489,461,28,2
2022-06-15,Hue City,Hue City,18,550,507,43,4
2022-06-15,Hue City,Hue City,19,679,628,51,4
2022-06-15,Hue City,Hue City,20,439,397,42,1
2022-06-15,Hue City,Hue City,21,281,203,78,32
2022-06-15,Hue City,Huong Thuy,7,2,2,0,0
2022-06-15,Hue City,Huong Thuy,8,2,1,1,0
2022-06-15,Hue City,Huong Thuy,11,1,1,0,0
2022-06-15,Hue City,Huong Thuy,13,1,1,0,0
2022-06-15,Hue City,Huong Thuy,14,2,0,2,1
2022-06-15,Hue City,Huong Thuy,15,2,2,0,0
2022-06-15,Hue City,Huong Thuy,17,1,1,0,0
2022-06-15,Hue City,Huong Thuy,18,1,1,0,0
2022-06-15,Hue City,Huong Thuy,20,1,0,1,0
2022-06-15,Hue City,Huong Thuy,21,1,1,0,0
2022-06-15,Hue City,Huong Tra,10,1,1,0,0
2022-06-15,Hue City,Huong Tra,18,1,1,0,0
2022-06-15,Hue City,Huong Tra,20,1,1,0,0
2022-06-15,Hue City,Phu Vang,10,1,1,0,0
2022-06-15,Hue City,Phu Vang,11,4,4,0,0
2022-06-15,Hue City,Phu Vang,12,5,4,1,1
2022-06-15,Hue City,Phu Vang,13,1,1,0,0
2022-06-15,Hue City,Phu Vang,14,1,0,1,1
2022-06-15,Hue City,Phu Vang,15,2,0,2,0
2022-06-15,Hue City,Phu Vang,16,1,1,0,0
2022-06-15,Hue City,Phu Vang,17,1,1,0,0
2022-06-15,Hue City,Phu Vang,18,3,3,0,0
2022-06-15,Hue City,Phu Vang,19,1,1,0,0
2022-06-15,Hue City,Phu Vang,20,2,0,2,0
2022-06-15,Hue City,Phu Vang,21,4,1,3,1
2022-06-15,Khanh Hoa,Cam Ranh City,12,2,0,2,2
2022-06-15,Khanh Hoa,Cam Ranh City,13,2,0,2,2
2022-06-15,Khanh Hoa,Cam Ranh City,16,1,0,1,0
2022-06-15,Khanh Hoa,Dien Khanh,7,1,0,1,1
2022-06-15,Khanh Hoa,Dien Khanh,8,2,0,2,2
2022-06-15,Khanh Hoa,Dien Khanh,10,1,0,1,1
2022-06-15,Khanh Hoa,Dien Khanh,19,1,0,1,1
2022-06-15,Khanh Hoa,Dien Khanh,20,1,0,1,0
2022-06-15,Khanh Hoa,Dien Khanh,21,1,0,1,1
2022-06-15,Khanh Hoa,Nha Trang City,0,1,1,0,0
2022-06-15,Khanh Hoa,Nha Trang City,1,1,1,0,0
2022-06-15,Khanh Hoa,Nha Trang City,3,1,1,0,0
2022-06-15,Khanh Hoa,Nha Trang City,4,1,1,0,0
2022-06-15,Khanh Hoa,Nha Trang City,6,33,29,4,2
2022-06-15,Khanh Hoa,Nha Trang City,7,137,127,10,0
2022-06-15,Khanh Hoa,Nha Trang City,8,196,183,13,1
2022-06-15,Khanh Hoa,Nha Trang City,9,188,165,23,0
2022-06-15,Khanh Hoa,Nha Trang City,10,241,229,12,0
2022-06-15,Khanh Hoa,Nha Trang City,11,392,361,31,1
2022-06-15,Khanh Hoa,Nha Trang City,12,308,272,36,1
2022-06-15,Khanh Hoa,Nha Trang City,13,322,304,18,0
2022-06-15,Khanh Hoa,Nha Trang City,14,266,249,17,3
2022-06-15,Khanh Hoa,Nha Trang City,15,267,249,18,0
2022-06-15,Khanh Hoa,Nha Trang City,16,277,255,22,0
2022-06-15,Khanh Hoa,Nha Trang City,17,195,181,14,0
2022-06-15,Khanh Hoa,Nha Trang City,18,279,251,28,0
2022-06-15,Khanh Hoa,Nha Trang City,19,258,238,20,1
2022-06-15,Khanh Hoa,Nha Trang City,20,209,179,30,2
2022-06-15,Khanh Hoa,Nha Trang City,21,105,68,37,23
2022-06-15,Lam Dong,Da Lat City,0,3,0,3,0
2022-06-15,Lam Dong,Da Lat City,1,3,0,3,0
2022-06-15,Lam Dong,Da Lat City,2,2,0,2,1
2022-06-15,Lam Dong,Da Lat City,5,1,1,0,0
2022-06-15,Lam Dong,Da Lat City,7,52,34,18,15
2022-06-15,Lam Dong,Da Lat City,8,101,72,29,21
2022-06-15,Lam Dong,Da Lat City,9,99,76,23,11
2022-06-15,Lam Dong,Da Lat City,10,75,67,8,1
2022-06-15,Lam Dong,Da Lat City,11,145,124,21,10
2022-06-15,Lam Dong,Da Lat City,12,137,115,22,13
2022-06-15,Lam Dong,Da Lat City,13,146,97,49,32
2022-06-15,Lam Dong,Da Lat City,14,101,87,14,7
2022-06-15,Lam Dong,Da Lat City,15,102,89,13,4
2022-06-15,Lam Dong,Da Lat City,16,100,94,6,2
2022-06-15,Lam Dong,Da Lat City,17,120,90,30,18
2022-06-15,Lam Dong,Da Lat City,18,123,99,24,13
2022-06-15,Lam Dong,Da Lat City,19,128,91,37,18
2022-06-15,Lam Dong,Da Lat City,20,109,75,34,26
2022-06-15,Lam Dong,Da Lat City,21,68,32,36,26
2022-06-15,Lam Dong,Da Lat City,22,1,0,1,0
2022-06-15,Nghe An,Vinh City,0,4,4,0,0
2022-06-15,Nghe An,Vinh City,6,5,4,1,1
2022-06-15,Nghe An,Vinh City,7,136,110,26,5
2022-06-15,Nghe An,Vinh City,8,189,166,23,1
2022-06-15,Nghe An,Vinh City,9,122,115,7,1
2022-06-15,Nghe An,Vinh City,10,180,155,25,0
2022-06-15,Nghe An,Vinh City,11,346,313,33,8
2022-06-15,Nghe An,Vinh City,12,228,205,23,1
2022-06-15,Nghe An,Vinh City,13,130,110,20,3
2022-06-15,Nghe An,Vinh City,14,165,141,24,0
2022-06-15,Nghe An,Vinh City,15,202,176,26,2
2022-06-15,Nghe An,Vinh City,16,156,135,21,0
2022-06-15,Nghe An,Vinh City,17,130,119,11,0
2022-06-15,Nghe An,Vinh City,18,189,158,31,2
2022-06-15,Nghe An,Vinh City,19,182,159,23,3
2022-06-15,Nghe An,Vinh City,20,140,112,28,6
2022-06-15,Nghe An,Vinh City,21,82,59,23,2
2022-06-15,Nghe An,Vinh City,22,1,0,1,0
2022-06-15,Quang Nam,Hoi An City,7,17,13,4,1
2022-06-15,Quang Nam,Hoi An City,8,20,12,8,1
2022-06-15,Quang Nam,Hoi An City,9,26,20,6,1
2022-06-15,Quang Nam,Hoi An City,10,29,26,3,0
2022-06-15,Quang Nam,Hoi An City,11,45,39,6,0
2022-06-15,Quang Nam,Hoi An City,12,37,29,8,1
2022-06-15,Quang Nam,Hoi An City,13,38,30,8,4
2022-06-15,Quang Nam,Hoi An City,14,42,33,9,2
2022-06-15,Quang Nam,Hoi An City,15,36,30,6,3
2022-06-15,Quang Nam,Hoi An City,16,26,23,3,0
2022-06-15,Quang Nam,Hoi An City,17,40,33,7,3
2022-06-15,Quang Nam,Hoi An City,18,58,41,17,13
2022-06-15,Quang Nam,Hoi An City,19,45,27,18,7
2022-06-15,Quang Nam,Hoi An City,20,36,24,12,8
2022-06-15,Quang Nam,Hoi An City,21,27,11,16,16
2022-06-15,Quang Nam,Tam Ky City,9,4,0,4,4
2022-06-15,Quang Nam,Tam Ky City,13,2,0,2,2
2022-06-15,Quang Nam,Tam Ky City,16,2,0,2,2
2022-06-15,Quang Ninh,Cam Pha City,8,2,0,2,1
2022-06-15,Quang Ninh,Cam Pha City,11,1,0,1,1
2022-06-15,Quang Ninh,Cam Pha City,12,3,0,3,2
2022-06-15,Quang Ninh,Cam Pha City,18,1,0,1,1
2022-06-15,Quang Ninh,Ha Long City,2,1,0,1,1
2022-06-15,Quang Ninh,Ha Long City,7,31,17,14,5
2022-06-15,Quang Ninh,Ha Long City,8,54,46,8,5
2022-06-15,Quang Ninh,Ha Long City,9,45,36,9,3
2022-06-15,Quang Ninh,Ha Long City,10,68,54,14,3
2022-06-15,Quang Ninh,Ha Long City,11,131,106,25,8
2022-06-15,Quang Ninh,Ha Long City,12,89,75,14,4
2022-06-15,Quang Ninh,Ha Long City,13,78,65,13,8
2022-06-15,Quang Ninh,Ha Long City,14,69,54,15,3
2022-06-15,Quang Ninh,Ha Long City,15,55,43,12,1
2022-06-15,Quang Ninh,Ha Long City,16,41,32,9,3
2022-06-15,Quang Ninh,Ha Long City,17,33,28,5,2
2022-06-15,Quang Ninh,Ha Long City,18,44,36,8,6
2022-06-15,Quang Ninh,Ha Long City,19,73,41,32,16
2022-06-15,Quang Ninh,Ha Long City,20,50,40,10,4
2022-06-15,Quang Ninh,Ha Long City,21,2,0,2,0
2022-06-15,Quang Ninh,Uong Bi City,11,1,0,1,1
2022-06-15,Thai Nguyen,Dong Hy,9,1,0,1,1
2022-06-15,Thai Nguyen,Dong Hy,18,1,1,0,0
2022-06-15,Thai Nguyen,Thai Nguyen City,0,3,2,1,0
2022-06-15,Thai Nguyen,Thai Nguyen City,2,1,0,1,0
2022-06-15,Thai Nguyen,Thai Nguyen City,4,1,1,0,0
2022-06-15,Thai Nguyen,Thai Nguyen City,6,2,2,0,0
2022-06-15,Thai Nguyen,Thai Nguyen City,7,88,81,7,1
2022-06-15,Thai Nguyen,Thai Nguyen City,8,139,118,21,1
2022-06-15,Thai Nguyen,Thai Nguyen City,9,144,121,23,2
2022-06-15,Thai Nguyen,Thai Nguyen City,10,183,167,16,1
2022-06-15,Thai Nguyen,Thai Nguyen City,11,375,343,32,0
2022-06-15,Thai Nguyen,Thai Nguyen City,12,241,220,21,2
2022-06-15,Thai Nguyen,Thai Nguyen City,13,172,158,14,1
2022-06-15,Thai Nguyen,Thai Nguyen City,14,162,144,18,1
2022-06-15,Thai Nguyen,Thai Nguyen City,15,135,131,4,1
2022-06-15,Thai Nguyen,Thai Nguyen City,16,125,121,4,1
2022-06-15,Thai Nguyen,Thai Nguyen City,17,149,138,11,1
2022-06-15,Thai Nguyen,Thai Nguyen City,18,186,181,5,0
2022-06-15,Thai Nguyen,Thai Nguyen City,19,232,208,24,1
2022-06-15,Thai Nguyen,Thai Nguyen City,20,181,167,14,1
2022-06-15,Thai Nguyen,Thai Nguyen City,21,122,107,15,0
2022-06-15,Vung Tau,Ba Ria City,7,2,1,1,1
2022-06-15,Vung Tau,Ba Ria City,8,4,2,2,0
2022-06-15,Vung Tau,Ba Ria City,9,10,4,6,4
2022-06-15,Vung Tau,Ba Ria City,10,2,2,0,0
2022-06-15,Vung Tau,Ba Ria City,11,5,3,2,1
2022-06-15,Vung Tau,Ba Ria City,12,9,5,4,3
2022-06-15,Vung Tau,Ba Ria City,13,8,7,1,1
2022-06-15,Vung Tau,Ba Ria City,14,8,7,1,0
2022-06-15,Vung Tau,Ba Ria City,15,4,2,2,2
2022-06-15,Vung Tau,Ba Ria City,16,6,1,5,4
2022-06-15,Vung Tau,Ba Ria City,17,5,2,3,3
2022-06-15,Vung Tau,Ba Ria City,18,5,1,4,3
2022-06-15,Vung Tau,Ba Ria City,19,3,0,3,3
2022-06-15,Vung Tau,Ba Ria City,20,3,0,3,3
2022-06-15,Vung Tau,Chau Duc,20,1,0,1,1
2022-06-15,Vung Tau,Vung Tau City,0,1,1,0,0
2022-06-15,Vung Tau,Vung Tau City,1,1,0,1,0
2022-06-15,Vung Tau,Vung Tau City,2,1,1,0,0
2022-06-15,Vung Tau,Vung Tau City,5,1,0,1,0
2022-06-15,Vung Tau,Vung Tau City,6,43,34,9,2
2022-06-15,Vung Tau,Vung Tau City,7,121,111,10,2
2022-06-15,Vung Tau,Vung Tau City,8,188,162,26,8
2022-06-15,Vung Tau,Vung Tau City,9,174,166,8,1
2022-06-15,Vung Tau,Vung Tau City,10,233,204,29,3
2022-06-15,Vung Tau,Vung Tau City,11,383,357,26,3
2022-06-15,Vung Tau,Vung Tau City,12,321,294,27,1
2022-06-15,Vung Tau,Vung Tau City,13,230,215,15,2
2022-06-15,Vung Tau,Vung Tau City,14,292,266,26,4
2022-06-15,Vung Tau,Vung Tau City,15,254,240,14,0
2022-06-15,Vung Tau,Vung Tau City,16,223,204,19,3
2022-06-15,Vung Tau,Vung Tau City,17,245,225,20,2
2022-06-15,Vung Tau,Vung Tau City,18,293,269,24,4
2022-06-15,Vung Tau,Vung Tau City,19,250,231,19,1
2022-06-15,Vung Tau,Vung Tau City,20,194,168,26,7
2022-06-15,Vung Tau,Vung Tau City,21,113,89,24,11
2022-06-15,Vung Tau,Vung Tau City,22,2,0,2,1
2022-06-16,Bac Ninh,Bác Ninh City,5,1,0,1,0
2022-06-16,Bac Ninh,Bác Ninh City,6,1,0,1,0
2022-06-16,Bac Ninh,Bác Ninh City,7,72,66,6,2
2022-06-16,Bac Ninh,Bác Ninh City,8,150,126,24,6
2022-06-16,Bac Ninh,Bác Ninh City,9,115,105,10,0
2022-06-16,Bac Ninh,Bác Ninh City,10,158,147,11,1
2022-06-16,Bac Ninh,Bác Ninh City,11,362,327,35,10
2022-06-16,Bac Ninh,Bác Ninh City,12,225,205,20,3
2022-06-16,Bac Ninh,Bác Ninh City,13,180,161,19,11
2022-06-16,Bac Ninh,Bác Ninh City,14,177,158,19,5
2022-06-16,Bac Ninh,Bác Ninh City,15,145,130,15,0
2022-06-16,Bac Ninh,Bác Ninh City,16,119,116,3,1
2022-06-16,Bac Ninh,Bác Ninh City,17,135,127,8,0
2022-06-16,Bac Ninh,Bác Ninh City,18,168,152,16,0
2022-06-16,Bac Ninh,Bác Ninh City,19,173,145,28,10
2022-06-16,Bac Ninh,Bác Ninh City,20,147,129,18,9
2022-06-16,Bac Ninh,Bác Ninh City,21,97,64,33,20
2022-06-16,Bac Ninh,Bác Ninh City,22,1,0,1,0
2022-06-16,Bac Ninh,Bác Ninh City,23,1,1,0,0
2022-06-16,Bac Ninh,Que Vo,10,1,0,1,1
2022-06-16,Bac Ninh,Que Vo,12,1,1,0,0
2022-06-16,Bac Ninh,Que Vo,13,3,0,3,3
2022-06-16,Bac Ninh,Que Vo,14,2,2,0,0
2022-06-16,Bac Ninh,Que Vo,15,1,0,1,0
2022-06-16,Bac Ninh,Que Vo,16,1,0,1,1
2022-06-16,Bac Ninh,Que Vo,18,1,0,1,1
2022-06-16,Bac Ninh,Que Vo,20,1,0,1,1
2022-06-16,Bac Ninh,Que Vo,21,3,0,3,3
2022-06-16,Bac Ninh,Tien Du,11,2,0,2,2
2022-06-16,Bac Ninh,Tien Du,14,5,0,5,5
2022-06-16,Bac Ninh,Tien Du,15,4,0,4,4
2022-06-16,Bac Ninh,Tien Du,17,1,0,1,1
2022-06-16,Bac Ninh,Tien Du,18,1,0,1,1
2022-06-16,Bac Ninh,Tien Du,20,2,0,2,1
2022-06-16,Bac Ninh,Tu Son,9,1,0,1,0
2022-06-16,Bac Ninh,Tu Son,10,1,0,1,1
2022-06-16,Bac Ninh,Tu Son,12,1,0,1,1
2022-06-16,Bac Ninh,Tu Son,13,3,0,3,3
2022-06-16,Bac Ninh,Tu Son,14,1,0,1,1
2022-06-16,Bac Ninh,Tu Son,15,2,0,2,2
2022-06-16,Bac Ninh,Tu Son,16,1,0,1,1
2022-06-16,Bac Ninh,Tu Son,17,1,0,1,1
2022-06-16,Bac Ninh,Tu Son,19,1,0,1,1
2022-06-16,Binh Duong,Ben Cat,9,2,0,2,2
2022-06-16,Binh Duong,Ben Cat,10,3,1,2,2
2022-06-16,Binh Duong,Ben Cat,11,2,0,2,1
2022-06-16,Binh Duong,Ben Cat,12,1,0,1,1
2022-06-16,Binh Duong,Ben Cat,13,1,0,1,1
2022-06-16,Binh Duong,Ben Cat,15,1,0,1,1
2022-06-16,Binh Duong,Ben Cat,16,2,0,2,2
2022-06-16,Binh Duong,Ben Cat,17,1,0,1,1
2022-06-16,Binh Duong,Ben Cat,19,1,0,1,1
2022-06-16,Binh Duong,Di An,7,6,1,5,5
2022-06-16,Binh Duong,Di An,8,18,10,8,7
2022-06-16,Binh Duong,Di An,9,24,14,10,7
2022-06-16,Binh Duong,Di An,10,37,32,5,4
2022-06-16,Binh Duong,Di An,11,53,42,11,4
2022-06-16,Binh Duong,Di An,12,49,30,19,14
2022-06-16,Binh Duong,Di An,13,50,37,13,10
2022-06-16,Binh Duong,Di An,14,34,20,14,10
2022-06-16,Binh Duong,Di An,15,35,28,7,2
2022-06-16,Binh Duong,Di An,16,28,22,6,2
2022-06-16,Binh Duong,Di An,17,28,23,5,1
2022-06-16,Binh Duong,Di An,18,20,17,3,3
2022-06-16,Binh Duong,Di An,19,37,20,17,9
2022-06-16,Binh Duong,Di An,20,25,14,11,10
2022-06-16,Binh Duong,Di An,21,19,8,11,10
2022-06-16,Binh Duong,Tan Uyen,7,1,1,0,0
2022-06-16,Binh Duong,Tan Uyen,8,1,1,0,0
2022-06-16,Binh Duong,Tan Uyen,9,1,0,1,1
2022-06-16,Binh Duong,Tan Uyen,10,4,2,2,1
2022-06-16,Binh Duong,Tan Uyen,11,4,0,4,3
2022-06-16,Binh Duong,Tan Uyen,12,3,2,1,1
2022-06-16,Binh Duong,Tan Uyen,13,3,3,0,0
2022-06-16,Binh Duong,Tan Uyen,14,4,2,2,2
2022-06-16,Binh Duong,Tan Uyen,15,4,3,1,0
2022-06-16,Binh Duong,Tan Uyen,16,1,1,0,0
2022-06-16,Binh Duong,Tan Uyen,17,2,0,2,2
2022-06-16,Binh Duong,Tan Uyen,18,4,1,3,1
2022-06-16,Binh Duong,Tan Uyen,19,2,1,1,1
2022-06-16,Binh Duong,Tan Uyen,20,2,0,2,1
2022-06-16,Binh Duong,Tan Uyen,21,1,0,1,1
2022-06-16,Binh Duong,Thu Dau Mot Town,3,1,1,0,0
2022-06-16,Binh Duong,Thu Dau Mot Town,6,44,36,8,4
2022-06-16,Binh Duong,Thu Dau Mot Town,7,137,127,10,1
2022-06-16,Binh Duong,Thu Dau Mot Town,8,242,227,15,2
2022-06-16,Binh Duong,Thu Dau Mot Town,9,293,272,21,2
2022-06-16,Binh Duong,Thu Dau Mot Town,10,460,426,34,5
2022-06-16,Binh Duong,Thu Dau Mot Town,11,720,666,54,8
2022-06-16,Binh Duong,Thu Dau Mot Town,12,496,464,32,6
2022-06-16,Binh Duong,Thu Dau Mot Town,13,498,475,23,4
2022-06-16,Binh Duong,Thu Dau Mot Town,14,437,415,22,2
2022-06-16,Binh Duong,Thu Dau Mot Town,15,367,347,20,1
2022-06-16,Binh Duong,Thu Dau Mot Town,16,317,285,32,4
2022-06-16,Binh Duong,Thu Dau Mot Town,17,375,349,26,6
2022-06-16,Binh Duong,Thu Dau Mot Town,18,394,376,18,0
2022-06-16,Binh Duong,Thu Dau Mot Town,19,386,358,28,3
2022-06-16,Binh Duong,Thu Dau Mot Town,20,294,255,39,6
2022-06-16,Binh Duong,Thu Dau Mot Town,21,117,103,14,3
2022-06-16,Binh Duong,Thu Dau Mot Town,23,1,0,1,0
2022-06-16,Binh Duong,Thuan An,6,2,2,0,0
2022-06-16,Binh Duong,Thuan An,7,10,8,2,1
2022-06-16,Binh Duong,Thuan An,8,19,14,5,3
2022-06-16,Binh Duong,Thuan An,9,39,33,6,2
2022-06-16,Binh Duong,Thuan An,10,73,64,9,3
2022-06-16,Binh Duong,Thuan An,11,99,88,11,5
2022-06-16,Binh Duong,Thuan An,12,59,56,3,1
2022-06-16,Binh Duong,Thuan An,13,95,67,28,15
2022-06-16,Binh Duong,Thuan An,14,74,57,17,14
2022-06-16,Binh Duong,Thuan An,15,51,46,5,2
2022-06-16,Binh Duong,Thuan An,16,46,38,8,4
2022-06-16,Binh Duong,Thuan An,17,38,30,8,6
2022-06-16,Binh Duong,Thuan An,18,39,34,5,0
2022-06-16,Binh Duong,Thuan An,19,47,37,10,2
2022-06-16,Binh Duong,Thuan An,20,49,30,19,12
2022-06-16,Binh Duong,Thuan An,21,19,10,9,5
2022-06-16,Binh Duong,Thuan An,22,1,0,1,0
2022-06-16,Can Tho City,Binh Thuy District,6,2,2,0,0
2022-06-16,Can Tho City,Binh Thuy District,7,1,1,0,0
2022-06-16,Can Tho City,Binh Thuy District,8,2,2,0,0
2022-06-16,Can Tho City,Binh Thuy District,9,4,4,0,0
2022-06-16,Can Tho City,Binh Thuy District,10,7,7,0,0
2022-06-16,Can Tho City,Binh Thuy District,11,15,13,2,0
2022-06-16,Can Tho City,Binh Thuy District,12,7,6,1,0
2022-06-16,Can Tho City,Binh Thuy District,13,11,9,2,0
2022-06-16,Can Tho City,Binh Thuy District,14,13,11,2,1
2022-06-16,Can Tho City,Binh Thuy District,15,8,6,2,1
2022-06-16,Can Tho City,Binh Thuy District,16,4,4,0,0
2022-06-16,Can Tho City,Binh Thuy District,17,4,4,0,0
2022-06-16,Can Tho City,Binh Thuy District,18,14,14,0,0
2022-06-16,Can Tho City,Binh Thuy District,19,8,8,0,0
2022-06-16,Can Tho City,Binh Thuy District,20,6,5,1,0
2022-06-16,Can Tho City,Binh Thuy District,21,8,6,2,1
2022-06-16,Can Tho City,Cai Rang District,6,6,2,4,4
2022-06-16,Can Tho City,Cai Rang District,7,3,3,0,0
2022-06-16,Can Tho City,Cai Rang District,8,6,6,0,0
2022-06-16,Can Tho City,Cai Rang District,9,10,8,2,0
2022-06-16,Can Tho City,Cai Rang District,10,13,11,2,2
2022-06-16,Can Tho City,Cai Rang District,11,19,17,2,2
2022-06-16,Can Tho City,Cai Rang District,12,17,12,5,0
2022-06-16,Can Tho City,Cai Rang District,13,10,10,0,0
2022-06-16,Can Tho City,Cai Rang District,14,8,8,0,0
2022-06-16,Can Tho City,Cai Rang District,15,12,8,4,1
2022-06-16,Can Tho City,Cai Rang District,16,8,6,2,1
2022-06-16,Can Tho City,Cai Rang District,17,6,5,1,0
2022-06-16,Can Tho City,Cai Rang District,18,24,20,4,0
2022-06-16,Can Tho City,Cai Rang District,19,14,14,0,0
2022-06-16,Can Tho City,Cai Rang District,20,13,10,3,1
2022-06-16,Can Tho City,Cai Rang District,21,1,1,0,0
2022-06-16,Can Tho City,Ninh Kieu District,0,4,2,2,0
2022-06-16,Can Tho City,Ninh Kieu District,2,2,1,1,0
2022-06-16,Can Tho City,Ninh Kieu District,6,60,51,9,4
2022-06-16,Can Tho City,Ninh Kieu District,7,146,143,3,0
2022-06-16,Can Tho City,Ninh Kieu District,8,269,264,5,0
2022-06-16,Can Tho City,Ninh Kieu District,9,320,303,17,0
2022-06-16,Can Tho City,Ninh Kieu District,10,555,536,19,0
2022-06-16,Can Tho City,Ninh Kieu District,11,896,853,43,5
2022-06-16,Can Tho City,Ninh Kieu District,12,666,636,30,0
2022-06-16,Can Tho City,Ninh Kieu District,13,545,521,24,0
2022-06-16,Can Tho City,Ninh Kieu District,14,431,408,23,0
2022-06-16,Can Tho City,Ninh Kieu District,15,359,339,20,0
2022-06-16,Can Tho City,Ninh Kieu District,16,418,393,25,0
2022-06-16,Can Tho City,Ninh Kieu District,17,525,493,32,0
2022-06-16,Can Tho City,Ninh Kieu District,18,551,526,25,0
2022-06-16,Can Tho City,Ninh Kieu District,19,484,457,27,1
2022-06-16,Can Tho City,Ninh Kieu District,20,346,326,20,0
2022-06-16,Can Tho City,Ninh Kieu District,21,197,182,15,1
2022-06-16,Can Tho City,Ninh Kieu District,22,2,1,1,0
2022-06-16,Can Tho City,Ninh Kieu District,23,1,0,1,0
2022-06-16,Can Tho City,O Mon District,11,1,0,1,1
2022-06-16,Can Tho City,O Mon District,21,1,0,1,1
2022-06-16,Dong Nai,Bien Hoa City,0,3,2,1,0
2022-06-16,Dong Nai,Bien Hoa City,2,1,1,0,0
2022-06-16,Dong Nai,Bien Hoa City,3,1,1,0,0
2022-06-16,Dong Nai,Bien Hoa City,5,1,1,0,0
2022-06-16,Dong Nai,Bien Hoa City,6,49,31,18,13
2022-06-16,Dong Nai,Bien Hoa City,7,180,158,22,9
2022-06-16,Dong Nai,Bien Hoa City,8,337,297,40,5
2022-06-16,Dong Nai,Bien Hoa City,9,485,444,41,4
2022-06-16,Dong Nai,Bien Hoa City,10,892,810,82,10
2022-06-16,Dong Nai,Bien Hoa City,11,1205,1102,103,14
2022-06-16,Dong Nai,Bien Hoa City,12,973,898,75,8
2022-06-16,Dong Nai,Bien Hoa City,13,938,872,66,16
2022-06-16,Dong Nai,Bien Hoa City,14,782,721,61,18
2022-06-16,Dong Nai,Bien Hoa City,15,579,540,39,2
2022-06-16,Dong Nai,Bien Hoa City,16,509,473,36,8
2022-06-16,Dong Nai,Bien Hoa City,17,586,540,46,6
2022-06-16,Dong Nai,Bien Hoa City,18,695,649,46,4
2022-06-16,Dong Nai,Bien Hoa City,19,686,617,69,15
2022-06-16,Dong Nai,Bien Hoa City,20,472,409,63,12
2022-06-16,Dong Nai,Bien Hoa City,21,215,173,42,8
2022-06-16,Dong Nai,Bien Hoa City,22,2,0,2,0
2022-06-16,Dong Nai,Bien Hoa City,23,1,0,1,0
2022-06-16,Dong Nai,Long Khanh,14,1,0,1,1
2022-06-16,Dong Nai,Long Khanh,17,1,0,1,1
2022-06-16,Dong Nai,Long Thanh,11,7,0,7,5
2022-06-16,Dong Nai,Long Thanh,12,2,0,2,1
2022-06-16,Dong Nai,Long Thanh,14,2,0,2,2
2022-06-16,Dong Nai,Long Thanh,15,1,0,1,1
2022-06-16,Dong Nai,Long Thanh,18,3,0,3,1
2022-06-16,Dong Nai,Long Thanh,20,1,0,1,1
2022-06-16,Dong Nai,Nhon trach,8,2,0,2,2
2022-06-16,Dong Nai,Nhon trach,9,2,0,2,2
2022-06-16,Dong Nai,Nhon trach,10,3,0,3,3
2022-06-16,Dong Nai,Nhon trach,11,1,0,1,0
2022-06-16,Dong Nai,Nhon trach,14,5,0,5,3
2022-06-16,Dong Nai,Nhon trach,15,1,0,1,1
2022-06-16,Dong Nai,Nhon trach,16,1,0,1,1
2022-06-16,Dong Nai,Nhon trach,17,3,0,3,3
2022-06-16,Dong Nai,Nhon trach,18,1,0,1,0
2022-06-16,Dong Nai,Nhon trach,20,1,0,1,1
2022-06-16,Dong Nai,Trang Bom,10,1,0,1,1
2022-06-16,Dong Nai,Trang Bom,11,1,1,0,0
2022-06-16,Dong Nai,Trang Bom,12,1,0,1,1
2022-06-16,Dong Nai,Trang Bom,15,1,0,1,1
2022-06-16,Hai Phong City,An Duong,8,4,1,3,2
2022-06-16,Hai Phong City,An Duong,9,4,2,2,2
2022-06-16,Hai Phong City,An Duong,10,6,6,0,0
2022-06-16,Hai Phong City,An Duong,11,11,3,8,7
2022-06-16,Hai Phong City,An Duong,12,8,0,8,4
2022-06-16,Hai Phong City,An Duong,13,7,1,6,5
2022-06-16,Hai Phong City,An Duong,14,6,1,5,3
2022-06-16,Hai Phong City,An Duong,15,2,1,1,1
2022-06-16,Hai Phong City,An Duong,16,2,0,2,2
2022-06-16,Hai Phong City,An Duong,17,2,0,2,2
2022-06-16,Hai Phong City,An Duong,18,4,2,2,2
2022-06-16,Hai Phong City,An Duong,19,4,0,4,2
2022-06-16,Hai Phong City,An Duong,21,1,0,1,1
2022-06-16,Hai Phong City,Hai An District,6,2,1,1,0
2022-06-16,Hai Phong City,Hai An District,7,6,5,1,1
2022-06-16,Hai Phong City,Hai An District,8,11,8,3,3
2022-06-16,Hai Phong City,Hai An District,9,22,21,1,0
2022-06-16,Hai Phong City,Hai An District,10,29,24,5,2
2022-06-16,Hai Phong City,Hai An District,11,58,42,16,5
2022-06-16,Hai Phong City,Hai An District,12,37,32,5,3
2022-06-16,Hai Phong City,Hai An District,13,22,13,9,4
2022-06-16,Hai Phong City,Hai An District,14,14,10,4,2
2022-06-16,Hai Phong City,Hai An District,15,25,20,5,0
2022-06-16,Hai Phong City,Hai An District,16,28,22,6,2
2022-06-16,Hai Phong City,Hai An District,17,24,21,3,1
2022-06-16,Hai Phong City,Hai An District,18,24,19,5,1
2022-06-16,Hai Phong City,Hai An District,19,20,15,5,2
2022-06-16,Hai Phong City,Hai An District,20,14,12,2,0
2022-06-16,Hai Phong City,Hai An District,21,8,3,5,1
2022-06-16,Hai Phong City,Hong Bang District,0,1,1,0,0
2022-06-16,Hai Phong City,Hong Bang District,3,1,0,1,1
2022-06-16,Hai Phong City,Hong Bang District,6,1,1,0,0
2022-06-16,Hai Phong City,Hong Bang District,7,10,9,1,1
2022-06-16,Hai Phong City,Hong Bang District,8,25,23,2,0
2022-06-16,Hai Phong City,Hong Bang District,9,32,28,4,1
2022-06-16,Hai Phong City,Hong Bang District,10,59,52,7,3
2022-06-16,Hai Phong City,Hong Bang District,11,114,86,28,15
2022-06-16,Hai Phong City,Hong Bang District,12,64,56,8,4
2022-06-16,Hai Phong City,Hong Bang District,13,55,46,9,2
2022-06-16,Hai Phong City,Hong Bang District,14,46,40,6,4
2022-06-16,Hai Phong City,Hong Bang District,15,49,44,5,3
2022-06-16,Hai Phong City,Hong Bang District,16,44,38,6,1
2022-06-16,Hai Phong City,Hong Bang District,17,38,34,4,1
2022-06-16,Hai Phong City,Hong Bang District,18,66,54,12,1
2022-06-16,Hai Phong City,Hong Bang District,19,49,43,6,1
2022-06-16,Hai Phong City,Hong Bang District,20,37,30,7,1
2022-06-16,Hai Phong City,Hong Bang District,21,19,14,5,1
2022-06-16,Hai Phong City,Kien An District,6,1,0,1,0
2022-06-16,Hai Phong City,Kien An District,7,3,1,2,1
2022-06-16,Hai Phong City,Kien An District,8,3,2,1,1
2022-06-16,Hai Phong City,Kien An District,9,4,2,2,2
2022-06-16,Hai Phong City,Kien An District,10,11,9,2,0
2022-06-16,Hai Phong City,Kien An District,11,17,12,5,1
2022-06-16,Hai Phong City,Kien An District,12,18,16,2,0
2022-06-16,Hai Phong City,Kien An District,13,9,8,1,1
2022-06-16,Hai Phong City,Kien An District,14,20,10,10,6
2022-06-16,Hai Phong City,Kien An District,15,14,9,5,1
2022-06-16,Hai Phong City,Kien An District,16,15,8,7,2
2022-06-16,Hai Phong City,Kien An District,17,10,6,4,3
2022-06-16,Hai Phong City,Kien An District,18,6,6,0,0
2022-06-16,Hai Phong City,Kien An District,19,18,12,6,2
2022-06-16,Hai Phong City,Kien An District,20,13,10,3,1
2022-06-16,Hai Phong City,Kien An District,21,4,1,3,2
2022-06-16,Hai Phong City,Le Chan District,0,2,1,1,0
2022-06-16,Hai Phong City,Le Chan District,2,1,0,1,0
2022-06-16,Hai Phong City,Le Chan District,5,1,1,0,0
2022-06-16,Hai Phong City,Le Chan District,6,1,0,1,0
2022-06-16,Hai Phong City,Le Chan District,7,26,22,4,1
2022-06-16,Hai Phong City,Le Chan District,8,98,84,14,8
2022-06-16,Hai Phong City,Le Chan District,9,91,79,12,1
2022-06-16,Hai Phong City,Le Chan District,10,189,170,19,3
2022-06-16,Hai Phong City,Le Chan District,11,327,277,50,15
2022-06-16,Hai Phong City,Le Chan District,12,236,217,19,7
2022-06-16,Hai Phong City,Le Chan District,13,161,141,20,4
2022-06-16,Hai Phong City,Le Chan District,14,141,122,19,10
2022-06-16,Hai Phong City,Le Chan District,15,167,140,27,10
2022-06-16,Hai Phong City,Le Chan District,16,156,137,19,2
2022-06-16,Hai Phong City,Le Chan District,17,153,138,15,3
2022-06-16,Hai Phong City,Le Chan District,18,231,182,49,15
2022-06-16,Hai Phong City,Le Chan District,19,198,171,27,3
2022-06-16,Hai Phong City,Le Chan District,20,136,120,16,7
2022-06-16,Hai Phong City,Le Chan District,21,73,57,16,1
2022-06-16,Hai Phong City,Le Chan District,22,1,0,1,0
2022-06-16,Hai Phong City,Ngo Quyen District,7,19,15,4,2
2022-06-16,Hai Phong City,Ngo Quyen District,8,79,76,3,1
2022-06-16,Hai Phong City,Ngo Quyen District,9,86,73,13,0
2022-06-16,Hai Phong City,Ngo Quyen District,10,120,109,11,1
2022-06-16,Hai Phong City,Ngo Quyen District,11,307,267,40,22
2022-06-16,Hai Phong City,Ngo Quyen District,12,173,160,13,4
2022-06-16,Hai Phong City,Ngo Quyen District,13,133,110,23,8
2022-06-16,Hai Phong City,Ngo Quyen District,14,128,112,16,7
2022-06-16,Hai Phong City,Ngo Quyen District,15,136,119,17,8
2022-06-16,Hai Phong City,Ngo Quyen District,16,118,104,14,0
2022-06-16,Hai Phong City,Ngo Quyen District,17,131,111,20,6
2022-06-16,Hai Phong City,Ngo Quyen District,18,134,110,24,5
2022-06-16,Hai Phong City,Ngo Quyen District,19,149,127,22,5
2022-06-16,Hai Phong City,Ngo Quyen District,20,101,88,13,2
2022-06-16,Hai Phong City,Ngo Quyen District,21,62,44,18,8
2022-06-16,Hai Phong City,Ngo Quyen District,23,1,0,1,0
2022-06-16,Hai Phong City,Thuy Nguyen,12,1,0,1,1
2022-06-16,Hai Phong City,Thuy Nguyen,16,1,0,1,1
2022-06-16,Hai Phong City,Thuy Nguyen,18,1,0,1,1
2022-06-16,Hai Phong City,Thuy Nguyen,19,2,0,2,2
2022-06-16,Hue City,Hue City,0,2,1,1,0
2022-06-16,Hue City,Hue City,3,2,2,0,0
2022-06-16,Hue City,Hue City,5,3,3,0,0
2022-06-16,Hue City,Hue City,6,57,56,1,0
2022-06-16,Hue City,Hue City,7,212,202,10,2
2022-06-16,Hue City,Hue City,8,346,318,28,0
2022-06-16,Hue City,Hue City,9,287,262,25,1
2022-06-16,Hue City,Hue City,10,448,409,39,1
2022-06-16,Hue City,Hue City,11,923,854,69,8
2022-06-16,Hue City,Hue City,12,588,549,39,2
2022-06-16,Hue City,Hue City,13,380,352,28,1
2022-06-16,Hue City,Hue City,14,387,356,31,3
2022-06-16,Hue City,Hue City,15,427,386,41,8
2022-06-16,Hue City,Hue City,16,397,367,30,4
2022-06-16,Hue City,Hue City,17,505,457,48,1
2022-06-16,Hue City,Hue City,18,564,514,50,1
2022-06-16,Hue City,Hue City,19,587,538,49,4
2022-06-16,Hue City,Hue City,20,425,370,55,4
2022-06-16,Hue City,Hue City,21,239,190,49,4
2022-06-16,Hue City,Hue City,22,4,0,4,2
2022-06-16,Hue City,Huong Thuy,6,1,1,0,0
2022-06-16,Hue City,Huong Thuy,10,1,1,0,0
2022-06-16,Hue City,Huong Thuy,11,4,2,2,0
2022-06-16,Hue City,Huong Thuy,12,2,1,1,1
2022-06-16,Hue City,Huong Thuy,13,1,0,1,1
2022-06-16,Hue City,Huong Thuy,17,5,3,2,0
2022-06-16,Hue City,Huong Thuy,18,7,5,2,0
2022-06-16,Hue City,Huong Thuy,19,3,1,2,1
2022-06-16,Hue City,Huong Thuy,21,4,1,3,2
2022-06-16,Hue City,Huong Tra,18,1,0,1,1
2022-06-16,Hue City,Phu Vang,7,2,1,1,0
2022-06-16,Hue City,Phu Vang,8,1,1,0,0
2022-06-16,Hue City,Phu Vang,10,1,1,0,0
2022-06-16,Hue City,Phu Vang,11,2,1,1,1
2022-06-16,Hue City,Phu Vang,12,3,2,1,0
2022-06-16,Hue City,Phu Vang,14,1,1,0,0
2022-06-16,Hue City,Phu Vang,15,4,1,3,3
2022-06-16,Hue City,Phu Vang,16,1,1,0,0
2022-06-16,Hue City,Phu Vang,17,4,3,1,0
2022-06-16,Hue City,Phu Vang,18,5,5,0,0
2022-06-16,Hue City,Phu Vang,19,3,2,1,1
2022-06-16,Hue City,Phu Vang,20,3,2,1,0
2022-06-16,Khanh Hoa,Cam Ranh City,13,1,0,1,1
2022-06-16,Khanh Hoa,Cam Ranh City,14,1,0,1,1
2022-06-16,Khanh Hoa,Nha Trang City,0,1,1,0,0
2022-06-16,Khanh Hoa,Nha Trang City,4,1,1,0,0
2022-06-16,Khanh Hoa,Nha Trang City,5,1,1,0,0
2022-06-16,Khanh Hoa,Nha Trang City,6,42,40,2,2
2022-06-16,Khanh Hoa,Nha Trang City,7,120,115,5,2
2022-06-16,Khanh Hoa,Nha Trang City,8,206,189,17,3
2022-06-16,Khanh Hoa,Nha Trang City,9,201,188,13,0
2022-06-16,Khanh Hoa,Nha Trang City,10,222,208,14,1
2022-06-16,Khanh Hoa,Nha Trang City,11,431,401,30,1
2022-06-16,Khanh Hoa,Nha Trang City,12,314,300,14,1
2022-06-16,Khanh Hoa,Nha Trang City,13,328,313,15,1
2022-06-16,Khanh Hoa,Nha Trang City,14,297,278,19,0
2022-06-16,Khanh Hoa,Nha Trang City,15,226,213,13,1
2022-06-16,Khanh Hoa,Nha Trang City,16,222,198,24,0
2022-06-16,Khanh Hoa,Nha Trang City,17,229,210,19,1
2022-06-16,Khanh Hoa,Nha Trang City,18,247,224,23,2
2022-06-16,Khanh Hoa,Nha Trang City,19,251,227,24,2
2022-06-16,Khanh Hoa,Nha Trang City,20,179,155,24,6
2022-06-16,Khanh Hoa,Nha Trang City,21,90,62,28,6
2022-06-16,Khanh Hoa,Nha Trang City,22,3,0,3,1
2022-06-16,Lam Dong,Da Lat City,0,1,0,1,0
2022-06-16,Lam Dong,Da Lat City,5,2,0,2,1
2022-06-16,Lam Dong,Da Lat City,6,7,3,4,4
2022-06-16,Lam Dong,Da Lat City,7,63,33,30,26
2022-06-16,Lam Dong,Da Lat City,8,120,76,44,25
2022-06-16,Lam Dong,Da Lat City,9,111,79,32,19
2022-06-16,Lam Dong,Da Lat City,10,115,102,13,4
2022-06-16,Lam Dong,Da Lat City,11,163,115,48,33
2022-06-16,Lam Dong,Da Lat City,12,143,114,29,21
2022-06-16,Lam Dong,Da Lat City,13,103,92,11,7
2022-06-16,Lam Dong,Da Lat City,14,125,91,34,20
2022-06-16,Lam Dong,Da Lat City,15,124,89,35,15
2022-06-16,Lam Dong,Da Lat City,16,109,99,10,1
2022-06-16,Lam Dong,Da Lat City,17,107,85,22,12
2022-06-16,Lam Dong,Da Lat City,18,115,96,19,14
2022-06-16,Lam Dong,Da Lat City,19,137,91,46,26
2022-06-16,Lam Dong,Da Lat City,20,100,55,45,31
2022-06-16,Lam Dong,Da Lat City,21,87,22,65,50
2022-06-16,Lam Dong,Da Lat City,22,1,1,0,0
2022-06-16,Nghe An,Vinh City,0,2,2,0,0
2022-06-16,Nghe An,Vinh City,1,1,0,1,0
2022-06-16,Nghe An,Vinh City,2,2,0,2,0
2022-06-16,Nghe An,Vinh City,6,4,4,0,0
2022-06-16,Nghe An,Vinh City,7,145,128,17,3
2022-06-16,Nghe An,Vinh City,8,160,143,17,1
2022-06-16,Nghe An,Vinh City,9,142,119,23,1
2022-06-16,Nghe An,Vinh City,10,244,217,27,7
2022-06-16,Nghe An,Vinh City,11,444,379,65,38
2022-06-16,Nghe An,Vinh City,12,296,229,67,27
2022-06-16,Nghe An,Vinh City,13,165,138,27,11
2022-06-16,Nghe An,Vinh City,14,229,166,63,25
2022-06-16,Nghe An,Vinh City,15,203,173,30,12
2022-06-16,Nghe An,Vinh City,16,128,109,19,2
2022-06-16,Nghe An,Vinh City,17,158,141,17,0
2022-06-16,Nghe An,Vinh City,18,176,155,21,6
2022-06-16,Nghe An,Vinh City,19,204,159,45,9
2022-06-16,Nghe An,Vinh City,20,148,118,30,2
2022-06-16,Nghe An,Vinh City,21,70,52,18,4
2022-06-16,Nghe An,Vinh City,22,1,0,1,0
2022-06-16,Nghe An,Vinh City,23,1,1,0,0
2022-06-16,Quang Nam,Dien Ban,14,1,0,1,1
2022-06-16,Quang Nam,Hoi An City,7,13,8,5,4
2022-06-16,Quang Nam,Hoi An City,8,29,16,13,3
2022-06-16,Quang Nam,Hoi An City,9,24,15,9,3
2022-06-16,Quang Nam,Hoi An City,10,33,26,7,3
2022-06-16,Quang Nam,Hoi An City,11,46,35,11,7
2022-06-16,Quang Nam,Hoi An City,12,45,41,4,3
2022-06-16,Quang Nam,Hoi An City,13,29,22,7,3
2022-06-16,Quang Nam,Hoi An City,14,36,27,9,3
2022-06-16,Quang Nam,Hoi An City,15,38,30,8,2
2022-06-16,Quang Nam,Hoi An City,16,29,26,3,1
2022-06-16,Quang Nam,Hoi An City,17,31,28,3,1
2022-06-16,Quang Nam,Hoi An City,18,49,41,8,3
2022-06-16,Quang Nam,Hoi An City,19,64,33,31,26
2022-06-16,Quang Nam,Hoi An City,20,39,26,13,9
2022-06-16,Quang Nam,Hoi An City,21,32,12,20,15
2022-06-16,Quang Ninh,Cam Pha City,13,1,0,1,1
2022-06-16,Quang Ninh,Cam Pha City,14,4,0,4,4
2022-06-16,Quang Ninh,Cam Pha City,16,1,0,1,1
2022-06-16,Quang Ninh,Cam Pha City,17,2,0,2,2
2022-06-16,Quang Ninh,Cam Pha City,19,1,0,1,1
2022-06-16,Quang Ninh,Ha Long City,5,2,1,1,0
2022-06-16,Quang Ninh,Ha Long City,7,19,15,4,0
2022-06-16,Quang Ninh,Ha Long City,8,55,45,10,1
2022-06-16,Quang Ninh,Ha Long City,9,43,33,10,1
2022-06-16,Quang Ninh,Ha Long City,10,72,55,17,3
2022-06-16,Quang Ninh,Ha Long City,11,144,123,21,5
2022-06-16,Quang Ninh,Ha Long City,12,108,90,18,9
2022-06-16,Quang Ninh,Ha Long City,13,62,45,17,12
2022-06-16,Quang Ninh,Ha Long City,14,51,39,12,3
2022-06-16,Quang Ninh,Ha Long City,15,60,43,17,9
2022-06-16,Quang Ninh,Ha Long City,16,41,27,14,3
2022-06-16,Quang Ninh,Ha Long City,17,33,27,6,2
2022-06-16,Quang Ninh,Ha Long City,18,54,42,12,6
2022-06-16,Quang Ninh,Ha Long City,19,54,37,17,8
2022-06-16,Quang Ninh,Ha Long City,20,46,31,15,8
2022-06-16,Quang Ninh,Ha Long City,21,1,0,1,0
2022-06-16,Quang Ninh,Ha Long City,23,1,0,1,0
2022-06-16,Thai Nguyen,Dong Hy,12,2,2,0,0
2022-06-16,Thai Nguyen,Dong Hy,13,2,1,1,0
2022-06-16,Thai Nguyen,Dong Hy,20,1,0,1,1
2022-06-16,Thai Nguyen,Pho Yen,19,3,0,3,1
2022-06-16,Thai Nguyen,Pho Yen,20,1,0,1,1
2022-06-16,Thai Nguyen,Thai Nguyen City,0,5,5,0,0
2022-06-16,Thai Nguyen,Thai Nguyen City,2,1,1,0,0
2022-06-16,Thai Nguyen,Thai Nguyen City,6,2,1,1,0
2022-06-16,Thai Nguyen,Thai Nguyen City,7,85,80,5,1
2022-06-16,Thai Nguyen,Thai Nguyen City,8,140,129,11,1
2022-06-16,Thai Nguyen,Thai Nguyen City,9,123,109,14,0
2022-06-16,Thai Nguyen,Thai Nguyen City,10,169,148,21,0
2022-06-16,Thai Nguyen,Thai Nguyen City,11,357,334,23,1
2022-06-16,Thai Nguyen,Thai Nguyen City,12,252,230,22,2
2022-06-16,Thai Nguyen,Thai Nguyen City,13,156,144,12,0
2022-06-16,Thai Nguyen,Thai Nguyen City,14,161,142,19,2
2022-06-16,Thai Nguyen,Thai Nguyen City,15,135,127,8,0
2022-06-16,Thai Nguyen,Thai Nguyen City,16,141,125,16,0
2022-06-16,Thai Nguyen,Thai Nguyen City,17,134,118,16,0
2022-06-16,Thai Nguyen,Thai Nguyen City,18,203,184,19,1
2022-06-16,Thai Nguyen,Thai Nguyen City,19,250,234,16,0
2022-06-16,Thai Nguyen,Thai Nguyen City,20,174,158,16,4
2022-06-16,Thai Nguyen,Thai Nguyen City,21,136,115,21,0
2022-06-16,Thai Nguyen,Thai Nguyen City,22,2,1,1,0
2022-06-16,Vung Tau,Ba Ria City,7,1,1,0,0
2022-06-16,Vung Tau,Ba Ria City,8,1,1,0,0
2022-06-16,Vung Tau,Ba Ria City,9,3,2,1,0
2022-06-16,Vung Tau,Ba Ria City,10,2,1,1,1
2022-06-16,Vung Tau,Ba Ria City,11,11,6,5,4
2022-06-16,Vung Tau,Ba Ria City,12,7,3,4,4
2022-06-16,Vung Tau,Ba Ria City,13,10,5,5,5
2022-06-16,Vung Tau,Ba Ria City,14,7,4,3,0
2022-06-16,Vung Tau,Ba Ria City,15,6,4,2,1
2022-06-16,Vung Tau,Ba Ria City,16,7,6,1,1
2022-06-16,Vung Tau,Ba Ria City,17,4,2,2,2
2022-06-16,Vung Tau,Ba Ria City,18,10,1,9,6
2022-06-16,Vung Tau,Ba Ria City,19,8,3,5,3
2022-06-16,Vung Tau,Ba Ria City,20,5,0,5,5
2022-06-16,Vung Tau,Ba Ria City,21,5,0,5,4
2022-06-16,Vung Tau,Vung Tau City,0,1,0,1,0
2022-06-16,Vung Tau,Vung Tau City,3,2,0,2,0
2022-06-16,Vung Tau,Vung Tau City,4,1,1,0,0
2022-06-16,Vung Tau,Vung Tau City,5,2,0,2,0
2022-06-16,Vung Tau,Vung Tau City,6,38,25,13,9
2022-06-16,Vung Tau,Vung Tau City,7,109,99,10,1
2022-06-16,Vung Tau,Vung Tau City,8,164,154,10,4
2022-06-16,Vung Tau,Vung Tau City,9,165,150,15,3
2022-06-16,Vung Tau,Vung Tau City,10,188,173,15,0
2022-06-16,Vung Tau,Vung Tau City,11,383,352,31,3
2022-06-16,Vung Tau,Vung Tau City,12,318,291,27,0
2022-06-16,Vung Tau,Vung Tau City,13,238,217,21,6
2022-06-16,Vung Tau,Vung Tau City,14,257,243,14,1
2022-06-16,Vung Tau,Vung Tau City,15,233,216,17,4
2022-06-16,Vung Tau,Vung Tau City,16,207,192,15,1
2022-06-16,Vung Tau,Vung Tau City,17,233,217,16,0
2022-06-16,Vung Tau,Vung Tau City,18,344,305,39,5
2022-06-16,Vung Tau,Vung Tau City,19,274,233,41,10
2022-06-16,Vung Tau,Vung Tau City,20,206,172,34,11
2022-06-16,Vung Tau,Vung Tau City,21,101,77,24,7
2022-06-17,Bac Ninh,Bác Ninh City,0,1,1,0,0
2022-06-17,Bac Ninh,Bác Ninh City,6,5,4,1,0
2022-06-17,Bac Ninh,Bác Ninh City,7,71,64,7,0
2022-06-17,Bac Ninh,Bác Ninh City,8,165,139,26,6
2022-06-17,Bac Ninh,Bác Ninh City,9,152,134,18,3
2022-06-17,Bac Ninh,Bác Ninh City,10,187,163,24,8
2022-06-17,Bac Ninh,Bác Ninh City,11,388,317,71,36
2022-06-17,Bac Ninh,Bác Ninh City,12,232,203,29,5
2022-06-17,Bac Ninh,Bác Ninh City,13,161,149,12,2
2022-06-17,Bac Ninh,Bác Ninh City,14,149,127,22,9
2022-06-17,Bac Ninh,Bác Ninh City,15,136,123,13,2
2022-06-17,Bac Ninh,Bác Ninh City,16,120,108,12,2
2022-06-17,Bac Ninh,Bác Ninh City,17,146,135,11,1
2022-06-17,Bac Ninh,Bác Ninh City,18,166,155,11,0
2022-06-17,Bac Ninh,Bác Ninh City,19,185,172,13,3
2022-06-17,Bac Ninh,Bác Ninh City,20,142,132,10,2
2022-06-17,Bac Ninh,Bác Ninh City,21,92,79,13,5
2022-06-17,Bac Ninh,Bác Ninh City,22,2,1,1,0
2022-06-17,Bac Ninh,Bác Ninh City,23,1,1,0,0
2022-06-17,Bac Ninh,Que Vo,8,2,0,2,2
2022-06-17,Bac Ninh,Que Vo,9,1,0,1,0
2022-06-17,Bac Ninh,Que Vo,11,2,2,0,0
2022-06-17,Bac Ninh,Que Vo,13,3,3,0,0
2022-06-17,Bac Ninh,Que Vo,14,3,1,2,2
2022-06-17,Bac Ninh,Que Vo,15,4,2,2,2
2022-06-17,Bac Ninh,Que Vo,18,2,0,2,2
2022-06-17,Bac Ninh,Que Vo,20,1,0,1,1
2022-06-17,Bac Ninh,Tien Du,8,1,0,1,1
2022-06-17,Bac Ninh,Tien Du,12,3,0,3,2
2022-06-17,Bac Ninh,Tien Du,15,1,0,1,1
2022-06-17,Bac Ninh,Tien Du,16,1,0,1,1
2022-06-17,Bac Ninh,Tien Du,19,1,0,1,1
2022-06-17,Bac Ninh,Tien Du,20,3,0,3,3
2022-06-17,Bac Ninh,Tu Son,10,5,0,5,3
2022-06-17,Bac Ninh,Tu Son,11,3,0,3,3
2022-06-17,Bac Ninh,Tu Son,12,1,0,1,1
2022-06-17,Bac Ninh,Tu Son,16,1,0,1,1
2022-06-17,Bac Ninh,Tu Son,20,1,0,1,1
2022-06-17,Binh Duong,Ben Cat,8,1,0,1,1
2022-06-17,Binh Duong,Ben Cat,10,2,0,2,2
2022-06-17,Binh Duong,Ben Cat,12,1,0,1,1
2022-06-17,Binh Duong,Ben Cat,16,1,0,1,1
2022-06-17,Binh Duong,Ben Cat,17,1,0,1,1
2022-06-17,Binh Duong,Ben Cat,19,1,0,1,1
2022-06-17,Binh Duong,Di An,6,4,0,4,4
2022-06-17,Binh Duong,Di An,7,3,0,3,3
2022-06-17,Binh Duong,Di An,8,15,7,8,7
2022-06-17,Binh Duong,Di An,9,22,15,7,5
2022-06-17,Binh Duong,Di An,10,31,22,9,3
2022-06-17,Binh Duong,Di An,11,51,35,16,5
2022-06-17,Binh Duong,Di An,12,41,34,7,1
2022-06-17,Binh Duong,Di An,13,53,32,21,13
2022-06-17,Binh Duong,Di An,14,55,31,24,15
2022-06-17,Binh Duong,Di An,15,34,22,12,2
2022-06-17,Binh Duong,Di An,16,19,9,10,5
2022-06-17,Binh Duong,Di An,17,37,27,10,5
2022-06-17,Binh Duong,Di An,18,34,29,5,3
2022-06-17,Binh Duong,Di An,19,31,20,11,7
2022-06-17,Binh Duong,Di An,20,25,14,11,9
2022-06-17,Binh Duong,Di An,21,17,7,10,9
2022-06-17,Binh Duong,Tan Uyen,8,1,0,1,1
2022-06-17,Binh Duong,Tan Uyen,10,7,3,4,3
2022-06-17,Binh Duong,Tan Uyen,11,2,1,1,1
2022-06-17,Binh Duong,Tan Uyen,12,4,3,1,1
2022-06-17,Binh Duong,Tan Uyen,13,3,2,1,1
2022-06-17,Binh Duong,Tan Uyen,14,4,4,0,0
2022-06-17,Binh Duong,Tan Uyen,15,1,1,0,0
2022-06-17,Binh Duong,Tan Uyen,18,4,2,2,1
2022-06-17,Binh Duong,Tan Uyen,19,3,2,1,1
2022-06-17,Binh Duong,Tan Uyen,20,3,3,0,0
2022-06-17,Binh Duong,Tan Uyen,21,1,0,1,1
2022-06-17,Binh Duong,Thu Dau Mot Town,5,2,2,0,0
2022-06-17,Binh Duong,Thu Dau Mot Town,6,39,32,7,2
2022-06-17,Binh Duong,Thu Dau Mot Town,7,137,126,11,3
2022-06-17,Binh Duong,Thu Dau Mot Town,8,244,227,17,4
2022-06-17,Binh Duong,Thu Dau Mot Town,9,274,253,21,3
2022-06-17,Binh Duong,Thu Dau Mot Town,10,412,378,34,6
2022-06-17,Binh Duong,Thu Dau Mot Town,11,662,601,61,19
2022-06-17,Binh Duong,Thu Dau Mot Town,12,488,436,52,19
2022-06-17,Binh Duong,Thu Dau Mot Town,13,493,461,32,5
2022-06-17,Binh Duong,Thu Dau Mot Town,14,390,369,21,2
2022-06-17,Binh Duong,Thu Dau Mot Town,15,328,311,17,3
2022-06-17,Binh Duong,Thu Dau Mot Town,16,288,272,16,3
2022-06-17,Binh Duong,Thu Dau Mot Town,17,388,353,35,11
2022-06-17,Binh Duong,Thu Dau Mot Town,18,451,421,30,12
2022-06-17,Binh Duong,Thu Dau Mot Town,19,404,368,36,9
2022-06-17,Binh Duong,Thu Dau Mot Town,20,260,237,23,2
2022-06-17,Binh Duong,Thu Dau Mot Town,21,126,108,18,3
2022-06-17,Binh Duong,Thu Dau Mot Town,22,1,0,1,0
2022-06-17,Binh Duong,Thu Dau Mot Town,23,2,1,1,0
2022-06-17,Binh Duong,Thuan An,0,1,1,0,0
2022-06-17,Binh Duong,Thuan An,6,2,2,0,0
2022-06-17,Binh Duong,Thuan An,7,11,9,2,1
2022-06-17,Binh Duong,Thuan An,8,14,12,2,2
2022-06-17,Binh Duong,Thuan An,9,40,26,14,10
2022-06-17,Binh Duong,Thuan An,10,89,68,21,11
2022-06-17,Binh Duong,Thuan An,11,77,65,12,3
2022-06-17,Binh Duong,Thuan An,12,55,49,6,4
2022-06-17,Binh Duong,Thuan An,13,88,65,23,19
2022-06-17,Binh Duong,Thuan An,14,75,48,27,19
2022-06-17,Binh Duong,Thuan An,15,58,45,13,4
2022-06-17,Binh Duong,Thuan An,16,50,34,16,13
2022-06-17,Binh Duong,Thuan An,17,46,32,14,7
2022-06-17,Binh Duong,Thuan An,18,39,39,0,0
2022-06-17,Binh Duong,Thuan An,19,53,44,9,1
2022-06-17,Binh Duong,Thuan An,20,47,34,13,8
2022-06-17,Binh Duong,Thuan An,21,16,14,2,1
2022-06-17,Binh Duong,Thuan An,23,1,1,0,0
2022-06-17,Can Tho City,Binh Thuy District,6,2,0,2,1
2022-06-17,Can Tho City,Binh Thuy District,7,2,0,2,0
2022-06-17,Can Tho City,Binh Thuy District,8,5,4,1,0
2022-06-17,Can Tho City,Binh Thuy District,9,11,8,3,0
2022-06-17,Can Tho City,Binh Thuy District,10,8,8,0,0
2022-06-17,Can Tho City,Binh Thuy District,11,17,16,1,0
2022-06-17,Can Tho City,Binh Thuy District,12,9,7,2,2
2022-06-17,Can Tho City,Binh Thuy District,13,12,12,0,0
2022-06-17,Can Tho City,Binh Thuy District,14,10,10,0,0
2022-06-17,Can Tho City,Binh Thuy District,15,7,7,0,0
2022-06-17,Can Tho City,Binh Thuy District,16,8,7,1,1
2022-06-17,Can Tho City,Binh Thuy District,17,11,11,0,0
2022-06-17,Can Tho City,Binh Thuy District,18,19,18,1,0
2022-06-17,Can Tho City,Binh Thuy District,19,11,10,1,0
2022-06-17,Can Tho City,Binh Thuy District,20,5,5,0,0
2022-06-17,Can Tho City,Binh Thuy District,21,2,2,0,0
2022-06-17,Can Tho City,Cai Rang District,2,1,0,1,1
2022-06-17,Can Tho City,Cai Rang District,6,2,0,2,0
2022-06-17,Can Tho City,Cai Rang District,7,3,3,0,0
2022-06-17,Can Tho City,Cai Rang District,8,9,8,1,1
2022-06-17,Can Tho City,Cai Rang District,9,8,6,2,0
2022-06-17,Can Tho City,Cai Rang District,10,11,10,1,0
2022-06-17,Can Tho City,Cai Rang District,11,21,20,1,0
2022-06-17,Can Tho City,Cai Rang District,12,17,15,2,0
2022-06-17,Can Tho City,Cai Rang District,13,11,9,2,0
2022-06-17,Can Tho City,Cai Rang District,14,14,6,8,5
2022-06-17,Can Tho City,Cai Rang District,15,11,10,1,0
2022-06-17,Can Tho City,Cai Rang District,16,5,5,0,0
2022-06-17,Can Tho City,Cai Rang District,17,11,11,0,0
2022-06-17,Can Tho City,Cai Rang District,18,16,16,0,0
2022-06-17,Can Tho City,Cai Rang District,19,10,10,0,0
2022-06-17,Can Tho City,Cai Rang District,20,6,5,1,1
2022-06-17,Can Tho City,Cai Rang District,21,7,5,2,0
2022-06-17,Can Tho City,Ninh Kieu District,4,3,2,1,0
2022-06-17,Can Tho City,Ninh Kieu District,5,1,1,0,0
2022-06-17,Can Tho City,Ninh Kieu District,6,52,45,7,0
2022-06-17,Can Tho City,Ninh Kieu District,7,144,131,13,0
2022-06-17,Can Tho City,Ninh Kieu District,8,221,216,5,0
2022-06-17,Can Tho City,Ninh Kieu District,9,321,302,19,0
2022-06-17,Can Tho City,Ninh Kieu District,10,655,612,43,0
2022-06-17,Can Tho City,Ninh Kieu District,11,908,840,68,3
2022-06-17,Can Tho City,Ninh Kieu District,12,661,632,29,0
2022-06-17,Can Tho City,Ninh Kieu District,13,554,528,26,0
2022-06-17,Can Tho City,Ninh Kieu District,14,432,417,15,0
2022-06-17,Can Tho City,Ninh Kieu District,15,376,368,8,0
2022-06-17,Can Tho City,Ninh Kieu District,16,419,396,23,0
2022-06-17,Can Tho City,Ninh Kieu District,17,517,491,26,0
2022-06-17,Can Tho City,Ninh Kieu District,18,627,600,27,2
2022-06-17,Can Tho City,Ninh Kieu District,19,522,493,29,0
2022-06-17,Can Tho City,Ninh Kieu District,20,402,377,25,0
2022-06-17,Can Tho City,Ninh Kieu District,21,221,201,20,1
2022-06-17,Can Tho City,Ninh Kieu District,22,1,0,1,0
2022-06-17,Can Tho City,Ninh Kieu District,23,5,3,2,0
2022-06-17,Dong Nai,Bien Hoa City,0,3,1,2,1
2022-06-17,Dong Nai,Bien Hoa City,6,58,42,16,10
2022-06-17,Dong Nai,Bien Hoa City,7,194,171,23,6
2022-06-17,Dong Nai,Bien Hoa City,8,370,325,45,7
2022-06-17,Dong Nai,Bien Hoa City,9,399,353,46,3
2022-06-17,Dong Nai,Bien Hoa City,10,805,734,71,16
2022-06-17,Dong Nai,Bien Hoa City,11,1177,1075,102,28
2022-06-17,Dong Nai,Bien Hoa City,12,909,831,78,17
2022-06-17,Dong Nai,Bien Hoa City,13,915,838,77,19
2022-06-17,Dong Nai,Bien Hoa City,14,752,680,72,11
2022-06-17,Dong Nai,Bien Hoa City,15,519,465,54,14
2022-06-17,Dong Nai,Bien Hoa City,16,554,493,61,15
2022-06-17,Dong Nai,Bien Hoa City,17,618,556,62,12
2022-06-17,Dong Nai,Bien Hoa City,18,691,641,50,4
2022-06-17,Dong Nai,Bien Hoa City,19,701,623,78,26
2022-06-17,Dong Nai,Bien Hoa City,20,489,418,71,29
2022-06-17,Dong Nai,Bien Hoa City,21,269,184,85,27
2022-06-17,Dong Nai,Bien Hoa City,22,5,2,3,1
2022-06-17,Dong Nai,Long Khanh,8,1,0,1,1
2022-06-17,Dong Nai,Long Khanh,10,1,0,1,0
2022-06-17,Dong Nai,Long Khanh,11,2,0,2,2
2022-06-17,Dong Nai,Long Khanh,12,1,0,1,1
2022-06-17,Dong Nai,Long Thanh,9,1,0,1,0
2022-06-17,Dong Nai,Long Thanh,10,2,0,2,2
2022-06-17,Dong Nai,Long Thanh,12,1,0,1,1
2022-06-17,Dong Nai,Long Thanh,18,1,0,1,1
2022-06-17,Dong Nai,Long Thanh,19,2,0,2,2
2022-06-17,Dong Nai,Nhon trach,9,1,0,1,1
2022-06-17,Dong Nai,Nhon trach,10,2,0,2,0
2022-06-17,Dong Nai,Nhon trach,12,1,0,1,1
2022-06-17,Dong Nai,Nhon trach,13,2,0,2,2
2022-06-17,Dong Nai,Nhon trach,14,2,0,2,2
2022-06-17,Dong Nai,Trang Bom,9,1,0,1,1
2022-06-17,Dong Nai,Trang Bom,10,3,0,3,2
2022-06-17,Dong Nai,Trang Bom,11,2,0,2,2
2022-06-17,Dong Nai,Trang Bom,12,1,0,1,1
2022-06-17,Dong Nai,Trang Bom,13,1,0,1,1
2022-06-17,Dong Nai,Trang Bom,14,1,0,1,1
2022-06-17,Dong Nai,Trang Bom,15,1,0,1,1
2022-06-17,Hai Phong City,An Duong,9,3,1,2,1
2022-06-17,Hai Phong City,An Duong,10,6,1,5,4
2022-06-17,Hai Phong City,An Duong,11,16,2,14,10
2022-06-17,Hai Phong City,An Duong,12,10,4,6,3
2022-06-17,Hai Phong City,An Duong,13,4,0,4,4
2022-06-17,Hai Phong City,An Duong,14,5,3,2,2
2022-06-17,Hai Phong City,An Duong,15,5,0,5,5
2022-06-17,Hai Phong City,An Duong,16,3,3,0,0
2022-06-17,Hai Phong City,An Duong,17,2,0,2,1
2022-06-17,Hai Phong City,An Duong,19,3,1,2,2
2022-06-17,Hai Phong City,An Duong,20,3,0,3,2
2022-06-17,Hai Phong City,An Duong,21,1,0,1,0
2022-06-17,Hai Phong City,Duong Kinh District,9,1,0,1,1
2022-06-17,Hai Phong City,Duong Kinh District,15,1,0,1,1
2022-06-17,Hai Phong City,Duong Kinh District,16,1,0,1,0
2022-06-17,Hai Phong City,Hai An District,7,6,4,2,2
2022-06-17,Hai Phong City,Hai An District,8,25,17,8,4
2022-06-17,Hai Phong City,Hai An District,9,15,12,3,1
2022-06-17,Hai Phong City,Hai An District,10,40,31,9,2
2022-06-17,Hai Phong City,Hai An District,11,54,40,14,11
2022-06-17,Hai Phong City,Hai An District,12,27,20,7,4
2022-06-17,Hai Phong City,Hai An District,13,23,18,5,5
2022-06-17,Hai Phong City,Hai An District,14,24,15,9,5
2022-06-17,Hai Phong City,Hai An District,15,19,16,3,2
2022-06-17,Hai Phong City,Hai An District,16,16,9,7,0
2022-06-17,Hai Phong City,Hai An District,17,19,14,5,1
2022-06-17,Hai Phong City,Hai An District,18,27,22,5,1
2022-06-17,Hai Phong City,Hai An District,19,23,15,8,2
2022-06-17,Hai Phong City,Hai An District,20,13,12,1,0
2022-06-17,Hai Phong City,Hai An District,21,10,8,2,2
2022-06-17,Hai Phong City,Hai An District,23,1,0,1,0
2022-06-17,Hai Phong City,Hong Bang District,0,1,1,0,0
2022-06-17,Hai Phong City,Hong Bang District,2,1,0,1,0
2022-06-17,Hai Phong City,Hong Bang District,7,14,9,5,2
2022-06-17,Hai Phong City,Hong Bang District,8,45,39,6,1
2022-06-17,Hai Phong City,Hong Bang District,9,32,29,3,2
2022-06-17,Hai Phong City,Hong Bang District,10,72,57,15,4
2022-06-17,Hai Phong City,Hong Bang District,11,132,100,32,18
2022-06-17,Hai Phong City,Hong Bang District,12,46,41,5,0
2022-06-17,Hai Phong City,Hong Bang District,13,57,45,12,8
2022-06-17,Hai Phong City,Hong Bang District,14,51,40,11,6
2022-06-17,Hai Phong City,Hong Bang District,15,52,38,14,6
2022-06-17,Hai Phong City,Hong Bang District,16,49,42,7,2
2022-06-17,Hai Phong City,Hong Bang District,17,48,44,4,1
2022-06-17,Hai Phong City,Hong Bang District,18,46,42,4,0
2022-06-17,Hai Phong City,Hong Bang District,19,62,47,15,4
2022-06-17,Hai Phong City,Hong Bang District,20,39,35,4,1
2022-06-17,Hai Phong City,Hong Bang District,21,14,12,2,1
2022-06-17,Hai Phong City,Kien An District,6,1,0,1,1
2022-06-17,Hai Phong City,Kien An District,7,3,0,3,3
2022-06-17,Hai Phong City,Kien An District,8,4,1,3,2
2022-06-17,Hai Phong City,Kien An District,9,8,4,4,0
2022-06-17,Hai Phong City,Kien An District,10,8,6,2,0
2022-06-17,Hai Phong City,Kien An District,11,15,13,2,1
2022-06-17,Hai Phong City,Kien An District,12,10,8,2,1
2022-06-17,Hai Phong City,Kien An District,13,10,7,3,1
2022-06-17,Hai Phong City,Kien An District,14,12,7,5,5
2022-06-17,Hai Phong City,Kien An District,15,21,11,10,8
2022-06-17,Hai Phong City,Kien An District,16,12,10,2,1
2022-06-17,Hai Phong City,Kien An District,17,5,4,1,0
2022-06-17,Hai Phong City,Kien An District,18,8,5,3,0
2022-06-17,Hai Phong City,Kien An District,19,11,8,3,0
2022-06-17,Hai Phong City,Kien An District,20,12,7,5,4
2022-06-17,Hai Phong City,Kien An District,21,3,1,2,2
2022-06-17,Hai Phong City,Le Chan District,1,1,1,0,0
2022-06-17,Hai Phong City,Le Chan District,6,3,2,1,0
2022-06-17,Hai Phong City,Le Chan District,7,39,34,5,1
2022-06-17,Hai Phong City,Le Chan District,8,77,62,15,7
2022-06-17,Hai Phong City,Le Chan District,9,94,79,15,2
2022-06-17,Hai Phong City,Le Chan District,10,210,190,20,3
2022-06-17,Hai Phong City,Le Chan District,11,376,299,77,39
2022-06-17,Hai Phong City,Le Chan District,12,207,178,29,10
2022-06-17,Hai Phong City,Le Chan District,13,157,129,28,11
2022-06-17,Hai Phong City,Le Chan District,14,161,123,38,21
2022-06-17,Hai Phong City,Le Chan District,15,190,148,42,17
2022-06-17,Hai Phong City,Le Chan District,16,149,137,12,2
2022-06-17,Hai Phong City,Le Chan District,17,179,160,19,3
2022-06-17,Hai Phong City,Le Chan District,18,212,192,20,3
2022-06-17,Hai Phong City,Le Chan District,19,191,164,27,8
2022-06-17,Hai Phong City,Le Chan District,20,146,123,23,6
2022-06-17,Hai Phong City,Le Chan District,21,78,60,18,4
2022-06-17,Hai Phong City,Le Chan District,22,2,0,2,0
2022-06-17,Hai Phong City,Ngo Quyen District,0,1,1,0,0
2022-06-17,Hai Phong City,Ngo Quyen District,3,1,0,1,0
2022-06-17,Hai Phong City,Ngo Quyen District,4,1,1,0,0
2022-06-17,Hai Phong City,Ngo Quyen District,6,1,1,0,0
2022-06-17,Hai Phong City,Ngo Quyen District,7,21,20,1,0
2022-06-17,Hai Phong City,Ngo Quyen District,8,69,56,13,9
2022-06-17,Hai Phong City,Ngo Quyen District,9,86,74,12,1
2022-06-17,Hai Phong City,Ngo Quyen District,10,145,128,17,9
2022-06-17,Hai Phong City,Ngo Quyen District,11,252,219,33,21
2022-06-17,Hai Phong City,Ngo Quyen District,12,197,161,36,13
2022-06-17,Hai Phong City,Ngo Quyen District,13,144,123,21,9
2022-06-17,Hai Phong City,Ngo Quyen District,14,166,136,30,14
2022-06-17,Hai Phong City,Ngo Quyen District,15,158,126,32,13
2022-06-17,Hai Phong City,Ngo Quyen District,16,115,106,9,2
2022-06-17,Hai Phong City,Ngo Quyen District,17,115,103,12,2
2022-06-17,Hai Phong City,Ngo Quyen District,18,151,131,20,2
2022-06-17,Hai Phong City,Ngo Quyen District,19,148,126,22,9
2022-06-17,Hai Phong City,Ngo Quyen District,20,116,100,16,2
2022-06-17,Hai Phong City,Ngo Quyen District,21,50,35,15,6
2022-06-17,Hai Phong City,Thuy Nguyen,7,1,0,1,1
2022-06-17,Hai Phong City,Thuy Nguyen,13,1,0,1,1
2022-06-17,Hai Phong City,Thuy Nguyen,14,1,0,1,1
2022-06-17,Hai Phong City,Thuy Nguyen,16,2,0,2,2
2022-06-17,Hai Phong City,Thuy Nguyen,17,1,0,1,1
2022-06-17,Hai Phong City,Thuy Nguyen,18,2,0,2,2
2022-06-17,Hai Phong City,Thuy Nguyen,21,1,0,1,1
2022-06-17,Hue City,Hue City,0,2,1,1,0
2022-06-17,Hue City,Hue City,2,1,1,0,0
2022-06-17,Hue City,Hue City,4,2,1,1,0
2022-06-17,Hue City,Hue City,6,69,65,4,1
2022-06-17,Hue City,Hue City,7,183,168,15,2
2022-06-17,Hue City,Hue City,8,333,308,25,1
2022-06-17,Hue City,Hue City,9,294,271,23,0
2022-06-17,Hue City,Hue City,10,477,434,43,2
2022-06-17,Hue City,Hue City,11,953,861,92,11
2022-06-17,Hue City,Hue City,12,644,599,45,0
2022-06-17,Hue City,Hue City,13,358,321,37,1
2022-06-17,Hue City,Hue City,14,424,390,34,1
2022-06-17,Hue City,Hue City,15,407,381,26,2
2022-06-17,Hue City,Hue City,16,353,330,23,1
2022-06-17,Hue City,Hue City,17,433,404,29,1
2022-06-17,Hue City,Hue City,18,535,496,39,1
2022-06-17,Hue City,Hue City,19,605,548,57,4
2022-06-17,Hue City,Hue City,20,443,387,56,10
2022-06-17,Hue City,Hue City,21,244,197,47,8
2022-06-17,Hue City,Hue City,22,6,3,3,1
2022-06-17,Hue City,Hue City,23,3,2,1,0
2022-06-17,Hue City,Huong Thuy,6,1,1,0,0
2022-06-17,Hue City,Huong Thuy,7,1,1,0,0
2022-06-17,Hue City,Huong Thuy,9,1,1,0,0
2022-06-17,Hue City,Huong Thuy,10,1,1,0,0
2022-06-17,Hue City,Huong Thuy,11,4,1,3,3
2022-06-17,Hue City,Huong Thuy,13,1,0,1,0
2022-06-17,Hue City,Huong Thuy,14,4,2,2,0
2022-06-17,Hue City,Huong Thuy,17,5,1,4,3
2022-06-17,Hue City,Huong Thuy,18,2,2,0,0
2022-06-17,Hue City,Huong Thuy,19,4,4,0,0
2022-06-17,Hue City,Huong Thuy,20,2,0,2,2
2022-06-17,Hue City,Huong Thuy,21,1,1,0,0
2022-06-17,Hue City,Huong Tra,20,1,0,1,0
2022-06-17,Hue City,Phu Vang,6,1,1,0,0
2022-06-17,Hue City,Phu Vang,7,1,1,0,0
2022-06-17,Hue City,Phu Vang,8,1,1,0,0
2022-06-17,Hue City,Phu Vang,11,3,0,3,2
2022-06-17,Hue City,Phu Vang,12,2,2,0,0
2022-06-17,Hue City,Phu Vang,14,5,3,2,1
2022-06-17,Hue City,Phu Vang,15,3,2,1,0
2022-06-17,Hue City,Phu Vang,16,1,0,1,1
2022-06-17,Hue City,Phu Vang,17,7,1,6,3
2022-06-17,Hue City,Phu Vang,18,2,1,1,1
2022-06-17,Hue City,Phu Vang,19,5,2,3,3
2022-06-17,Khanh Hoa,Dien Khanh,7,1,0,1,0
2022-06-17,Khanh Hoa,Dien Khanh,8,1,0,1,1
2022-06-17,Khanh Hoa,Dien Khanh,19,1,0,1,0
2022-06-17,Khanh Hoa,Dien Khanh,21,1,0,1,1
2022-06-17,Khanh Hoa,Nha Trang City,0,2,1,1,0
2022-06-17,Khanh Hoa,Nha Trang City,1,2,2,0,0
2022-06-17,Khanh Hoa,Nha Trang City,4,1,1,0,0
2022-06-17,Khanh Hoa,Nha Trang City,5,3,1,2,2
2022-06-17,Khanh Hoa,Nha Trang City,6,57,44,13,9
2022-06-17,Khanh Hoa,Nha Trang City,7,131,118,13,0
2022-06-17,Khanh Hoa,Nha Trang City,8,222,210,12,1
2022-06-17,Khanh Hoa,Nha Trang City,9,211,195,16,2
2022-06-17,Khanh Hoa,Nha Trang City,10,244,227,17,0
2022-06-17,Khanh Hoa,Nha Trang City,11,437,411,26,2
2022-06-17,Khanh Hoa,Nha Trang City,12,330,310,20,1
2022-06-17,Khanh Hoa,Nha Trang City,13,265,244,21,0
2022-06-17,Khanh Hoa,Nha Trang City,14,252,234,18,1
2022-06-17,Khanh Hoa,Nha Trang City,15,241,216,25,2
2022-06-17,Khanh Hoa,Nha Trang City,16,176,157,19,0
2022-06-17,Khanh Hoa,Nha Trang City,17,205,196,9,0
2022-06-17,Khanh Hoa,Nha Trang City,18,222,208,14,0
2022-06-17,Khanh Hoa,Nha Trang City,19,265,218,47,17
2022-06-17,Khanh Hoa,Nha Trang City,20,229,167,62,31
2022-06-17,Khanh Hoa,Nha Trang City,21,122,66,56,33
2022-06-17,Khanh Hoa,Nha Trang City,22,5,2,3,0
2022-06-17,Khanh Hoa,Nha Trang City,23,3,1,2,1
2022-06-17,Lam Dong,Da Lat City,5,3,0,3,0
2022-06-17,Lam Dong,Da Lat City,6,3,0,3,0
2022-06-17,Lam Dong,Da Lat City,7,42,36,6,5
2022-06-17,Lam Dong,Da Lat City,8,90,67,23,15
2022-06-17,Lam Dong,Da Lat City,9,117,95,22,14
2022-06-17,Lam Dong,Da Lat City,10,123,98,25,8
2022-06-17,Lam Dong,Da Lat City,11,170,126,44,28
2022-06-17,Lam Dong,Da Lat City,12,191,118,73,45
2022-06-17,Lam Dong,Da Lat City,13,141,99,42,27
2022-06-17,Lam Dong,Da Lat City,14,147,62,85,69
2022-06-17,Lam Dong,Da Lat City,15,157,86,71,56
2022-06-17,Lam Dong,Da Lat City,16,119,79,40,31
2022-06-17,Lam Dong,Da Lat City,17,141,90,51,38
2022-06-17,Lam Dong,Da Lat City,18,184,94,90,66
2022-06-17,Lam Dong,Da Lat City,19,149,93,56,46
2022-06-17,Lam Dong,Da Lat City,20,113,70,43,33
2022-06-17,Lam Dong,Da Lat City,21,114,37,77,64
2022-06-17,Lam Dong,Da Lat City,22,2,0,2,1
2022-06-17,Nghe An,Vinh City,2,1,0,1,0
2022-06-17,Nghe An,Vinh City,5,2,1,1,0
2022-06-17,Nghe An,Vinh City,6,5,2,3,1
2022-06-17,Nghe An,Vinh City,7,146,129,17,2
2022-06-17,Nghe An,Vinh City,8,197,181,16,0
2022-06-17,Nghe An,Vinh City,9,158,130,28,0
2022-06-17,Nghe An,Vinh City,10,303,248,55,21
2022-06-17,Nghe An,Vinh City,11,473,358,115,59
2022-06-17,Nghe An,Vinh City,12,254,212,42,8
2022-06-17,Nghe An,Vinh City,13,181,151,30,4
2022-06-17,Nghe An,Vinh City,14,219,177,42,19
2022-06-17,Nghe An,Vinh City,15,185,152,33,6
2022-06-17,Nghe An,Vinh City,16,162,137,25,7
2022-06-17,Nghe An,Vinh City,17,142,123,19,7
2022-06-17,Nghe An,Vinh City,18,228,176,52,18
2022-06-17,Nghe An,Vinh City,19,192,162,30,15
2022-06-17,Nghe An,Vinh City,20,156,116,40,16
2022-06-17,Nghe An,Vinh City,21,122,72,50,32
2022-06-17,Nghe An,Vinh City,22,2,0,2,1
2022-06-17,Quang Nam,Hoi An City,6,1,1,0,0
2022-06-17,Quang Nam,Hoi An City,7,13,10,3,1
2022-06-17,Quang Nam,Hoi An City,8,22,21,1,0
2022-06-17,Quang Nam,Hoi An City,9,29,25,4,0
2022-06-17,Quang Nam,Hoi An City,10,23,18,5,3
2022-06-17,Quang Nam,Hoi An City,11,46,38,8,3
2022-06-17,Quang Nam,Hoi An City,12,40,38,2,0
2022-06-17,Quang Nam,Hoi An City,13,28,23,5,2
2022-06-17,Quang Nam,Hoi An City,14,33,30,3,0
2022-06-17,Quang Nam,Hoi An City,15,36,33,3,1
2022-06-17,Quang Nam,Hoi An City,16,38,35,3,0
2022-06-17,Quang Nam,Hoi An City,17,39,33,6,0
2022-06-17,Quang Nam,Hoi An City,18,48,41,7,2
2022-06-17,Quang Nam,Hoi An City,19,50,46,4,1
2022-06-17,Quang Nam,Hoi An City,20,65,50,15,5
2022-06-17,Quang Nam,Hoi An City,21,33,23,10,2
2022-06-17,Quang Nam,Hoi An City,22,1,0,1,1
2022-06-17,Quang Nam,Tam Ky City,12,1,0,1,1
2022-06-17,Quang Nam,Tam Ky City,13,4,0,4,4
2022-06-17,Quang Nam,Tam Ky City,14,1,0,1,1
2022-06-17,Quang Nam,Tam Ky City,19,1,0,1,1
2022-06-17,Quang Ninh,Cam Pha City,8,2,0,2,2
2022-06-17,Quang Ninh,Cam Pha City,10,1,0,1,1
2022-06-17,Quang Ninh,Cam Pha City,11,1,0,1,1
2022-06-17,Quang Ninh,Cam Pha City,15,3,0,3,3
2022-06-17,Quang Ninh,Cam Pha City,16,5,0,5,3
2022-06-17,Quang Ninh,Cam Pha City,20,4,0,4,3
2022-06-17,Quang Ninh,Ha Long City,6,2,1,1,0
2022-06-17,Quang Ninh,Ha Long City,7,20,15,5,2
2022-06-17,Quang Ninh,Ha Long City,8,66,49,17,8
2022-06-17,Quang Ninh,Ha Long City,9,63,48,15,5
2022-06-17,Quang Ninh,Ha Long City,10,69,55,14,2
2022-06-17,Quang Ninh,Ha Long City,11,148,122,26,8
2022-06-17,Quang Ninh,Ha Long City,12,71,61,10,2
2022-06-17,Quang Ninh,Ha Long City,13,61,48,13,2
2022-06-17,Quang Ninh,Ha Long City,14,72,58,14,7
2022-06-17,Quang Ninh,Ha Long City,15,41,37,4,1
2022-06-17,Quang Ninh,Ha Long City,16,34,29,5,3
2022-06-17,Quang Ninh,Ha Long City,17,46,36,10,6
2022-06-17,Quang Ninh,Ha Long City,18,51,44,7,1
2022-06-17,Quang Ninh,Ha Long City,19,56,36,20,8
2022-06-17,Quang Ninh,Ha Long City,20,53,27,26,13
2022-06-17,Quang Ninh,Ha Long City,21,1,0,1,0
2022-06-17,Thai Nguyen,Pho Yen,14,1,0,1,1
2022-06-17,Thai Nguyen,Thai Nguyen City,0,1,1,0,0
2022-06-17,Thai Nguyen,Thai Nguyen City,1,1,1,0,0
2022-06-17,Thai Nguyen,Thai Nguyen City,4,1,1,0,0
2022-06-17,Thai Nguyen,Thai Nguyen City,5,5,2,3,1
2022-06-17,Thai Nguyen,Thai Nguyen City,6,7,5,2,0
2022-06-17,Thai Nguyen,Thai Nguyen City,7,93,80,13,1
2022-06-17,Thai Nguyen,Thai Nguyen City,8,148,135,13,0
2022-06-17,Thai Nguyen,Thai Nguyen City,9,112,97,15,0
2022-06-17,Thai Nguyen,Thai Nguyen City,10,198,189,9,1
2022-06-17,Thai Nguyen,Thai Nguyen City,11,374,346,28,1
2022-06-17,Thai Nguyen,Thai Nguyen City,12,266,246,20,1
2022-06-17,Thai Nguyen,Thai Nguyen City,13,196,181,15,0
2022-06-17,Thai Nguyen,Thai Nguyen City,14,180,160,20,5
2022-06-17,Thai Nguyen,Thai Nguyen City,15,157,143,14,2
2022-06-17,Thai Nguyen,Thai Nguyen City,16,144,133,11,0
2022-06-17,Thai Nguyen,Thai Nguyen City,17,146,134,12,0
2022-06-17,Thai Nguyen,Thai Nguyen City,18,178,163,15,0
2022-06-17,Thai Nguyen,Thai Nguyen City,19,219,210,9,0
2022-06-17,Thai Nguyen,Thai Nguyen City,20,183,165,18,1
2022-06-17,Thai Nguyen,Thai Nguyen City,21,123,105,18,1
2022-06-17,Thai Nguyen,Thai Nguyen City,22,2,1,1,0
2022-06-17,Thai Nguyen,Thai Nguyen City,23,1,1,0,0
2022-06-17,Vung Tau,Ba Ria City,7,5,0,5,5
2022-06-17,Vung Tau,Ba Ria City,8,8,2,6,6
2022-06-17,Vung Tau,Ba Ria City,9,12,6,6,5
2022-06-17,Vung Tau,Ba Ria City,10,8,5,3,0
2022-06-17,Vung Tau,Ba Ria City,11,5,2,3,2
2022-06-17,Vung Tau,Ba Ria City,12,11,5,6,5
2022-06-17,Vung Tau,Ba Ria City,13,11,3,8,6
2022-06-17,Vung Tau,Ba Ria City,14,17,6,11,6
2022-06-17,Vung Tau,Ba Ria City,15,7,3,4,4
2022-06-17,Vung Tau,Ba Ria City,16,6,5,1,1
2022-06-17,Vung Tau,Ba Ria City,17,4,2,2,1
2022-06-17,Vung Tau,Ba Ria City,18,7,6,1,1
2022-06-17,Vung Tau,Ba Ria City,19,4,3,1,1
2022-06-17,Vung Tau,Ba Ria City,20,5,0,5,3
2022-06-17,Vung Tau,Ba Ria City,21,1,0,1,1
2022-06-17,Vung Tau,Chau Duc,16,1,0,1,1
2022-06-17,Vung Tau,Tan Thanh,12,1,0,1,1
2022-06-17,Vung Tau,Vung Tau City,0,2,1,1,0
2022-06-17,Vung Tau,Vung Tau City,2,1,0,1,0
2022-06-17,Vung Tau,Vung Tau City,3,1,0,1,0
2022-06-17,Vung Tau,Vung Tau City,5,3,3,0,0
2022-06-17,Vung Tau,Vung Tau City,6,41,33,8,3
2022-06-17,Vung Tau,Vung Tau City,7,98,85,13,1
2022-06-17,Vung Tau,Vung Tau City,8,161,156,5,0
2022-06-17,Vung Tau,Vung Tau City,9,186,178,8,1
2022-06-17,Vung Tau,Vung Tau City,10,220,204,16,1
2022-06-17,Vung Tau,Vung Tau City,11,447,407,40,7
2022-06-17,Vung Tau,Vung Tau City,12,321,294,27,1
2022-06-17,Vung Tau,Vung Tau City,13,260,246,14,1
2022-06-17,Vung Tau,Vung Tau City,14,299,278,21,1
2022-06-17,Vung Tau,Vung Tau City,15,253,234,19,0
2022-06-17,Vung Tau,Vung Tau City,16,241,222,19,1
2022-06-17,Vung Tau,Vung Tau City,17,257,231,26,2
2022-06-17,Vung Tau,Vung Tau City,18,322,288,34,11
2022-06-17,Vung Tau,Vung Tau City,19,283,253,30,7
2022-06-17,Vung Tau,Vung Tau City,20,205,176,29,2
2022-06-17,Vung Tau,Vung Tau City,21,111,89,22,10
2022-06-17,Vung Tau,Vung Tau City,23,1,0,1,0
2022-06-18,Bac Ninh,Bác Ninh City,6,6,5,1,0
2022-06-18,Bac Ninh,Bác Ninh City,7,63,56,7,1
2022-06-18,Bac Ninh,Bác Ninh City,8,118,110,8,3
2022-06-18,Bac Ninh,Bác Ninh City,9,139,131,8,1
2022-06-18,Bac Ninh,Bác Ninh City,10,243,219,24,1
2022-06-18,Bac Ninh,Bác Ninh City,11,381,318,63,23
2022-06-18,Bac Ninh,Bác Ninh City,12,264,227,37,11
2022-06-18,Bac Ninh,Bác Ninh City,13,182,162,20,5
2022-06-18,Bac Ninh,Bác Ninh City,14,172,155,17,1
2022-06-18,Bac Ninh,Bác Ninh City,15,172,151,21,8
2022-06-18,Bac Ninh,Bác Ninh City,16,146,132,14,4
2022-06-18,Bac Ninh,Bác Ninh City,17,116,107,9,2
2022-06-18,Bac Ninh,Bác Ninh City,18,162,155,7,0
2022-06-18,Bac Ninh,Bác Ninh City,19,190,169,21,9
2022-06-18,Bac Ninh,Bác Ninh City,20,192,157,35,17
2022-06-18,Bac Ninh,Bác Ninh City,21,111,82,29,16
2022-06-18,Bac Ninh,Bác Ninh City,22,2,0,2,0
2022-06-18,Bac Ninh,Bác Ninh City,23,2,1,1,0
2022-06-18,Bac Ninh,Que Vo,7,1,1,0,0
2022-06-18,Bac Ninh,Que Vo,10,1,1,0,0
2022-06-18,Bac Ninh,Que Vo,11,1,1,0,0
2022-06-18,Bac Ninh,Que Vo,13,1,0,1,1
2022-06-18,Bac Ninh,Que Vo,14,3,2,1,1
2022-06-18,Bac Ninh,Que Vo,20,1,0,1,1
2022-06-18,Bac Ninh,Tien Du,8,1,0,1,1
2022-06-18,Bac Ninh,Tien Du,10,2,0,2,2
2022-06-18,Bac Ninh,Tien Du,12,3,0,3,3
2022-06-18,Bac Ninh,Tien Du,13,5,0,5,4
2022-06-18,Bac Ninh,Tien Du,14,1,0,1,1
2022-06-18,Bac Ninh,Tien Du,15,2,0,2,2
2022-06-18,Bac Ninh,Tien Du,17,3,0,3,3
2022-06-18,Bac Ninh,Tien Du,20,1,0,1,1
2022-06-18,Bac Ninh,Tu Son,11,1,0,1,1
2022-06-18,Bac Ninh,Tu Son,12,4,0,4,3
2022-06-18,Bac Ninh,Tu Son,15,1,0,1,1
2022-06-18,Bac Ninh,Tu Son,17,1,0,1,1
2022-06-18,Bac Ninh,Tu Son,18,2,0,2,2
2022-06-18,Bac Ninh,Tu Son,20,2,0,2,1
2022-06-18,Bac Ninh,Yen Phong,18,1,1,0,0
2022-06-18,Binh Duong,Ben Cat,10,1,0,1,1
2022-06-18,Binh Duong,Ben Cat,12,1,0,1,1
2022-06-18,Binh Duong,Ben Cat,15,1,0,1,1
2022-06-18,Binh Duong,Ben Cat,18,2,0,2,1
2022-06-18,Binh Duong,Ben Cat,20,2,0,2,1
2022-06-18,Binh Duong,Di An,6,1,0,1,1
2022-06-18,Binh Duong,Di An,7,10,0,10,10
2022-06-18,Binh Duong,Di An,8,21,4,17,14
2022-06-18,Binh Duong,Di An,9,25,13,12,11
2022-06-18,Binh Duong,Di An,10,44,25,19,12
2022-06-18,Binh Duong,Di An,11,40,35,5,3
2022-06-18,Binh Duong,Di An,12,40,30,10,4
2022-06-18,Binh Duong,Di An,13,31,11,20,15
2022-06-18,Binh Duong,Di An,14,35,22,13,9
2022-06-18,Binh Duong,Di An,15,28,22,6,3
2022-06-18,Binh Duong,Di An,16,21,17,4,3
2022-06-18,Binh Duong,Di An,17,44,34,10,5
2022-06-18,Binh Duong,Di An,18,38,34,4,1
2022-06-18,Binh Duong,Di An,19,37,26,11,10
2022-06-18,Binh Duong,Di An,20,35,17,18,14
2022-06-18,Binh Duong,Di An,21,14,7,7,5
2022-06-18,Binh Duong,Tan Uyen,8,1,0,1,1
2022-06-18,Binh Duong,Tan Uyen,9,1,0,1,1
2022-06-18,Binh Duong,Tan Uyen,10,2,1,1,1
2022-06-18,Binh Duong,Tan Uyen,12,3,2,1,1
2022-06-18,Binh Duong,Tan Uyen,13,2,1,1,1
2022-06-18,Binh Duong,Tan Uyen,14,2,1,1,0
2022-06-18,Binh Duong,Tan Uyen,15,2,0,2,2
2022-06-18,Binh Duong,Tan Uyen,16,1,0,1,1
2022-06-18,Binh Duong,Tan Uyen,17,4,2,2,2
2022-06-18,Binh Duong,Tan Uyen,18,3,1,2,1
2022-06-18,Binh Duong,Tan Uyen,19,1,1,0,0
2022-06-18,Binh Duong,Tan Uyen,20,5,0,5,4
2022-06-18,Binh Duong,Tan Uyen,21,3,1,2,2
2022-06-18,Binh Duong,Thu Dau Mot Town,0,1,1,0,0
2022-06-18,Binh Duong,Thu Dau Mot Town,1,1,0,1,0
2022-06-18,Binh Duong,Thu Dau Mot Town,2,2,1,1,0
2022-06-18,Binh Duong,Thu Dau Mot Town,5,1,0,1,1
2022-06-18,Binh Duong,Thu Dau Mot Town,6,50,44,6,2
2022-06-18,Binh Duong,Thu Dau Mot Town,7,114,107,7,1
2022-06-18,Binh Duong,Thu Dau Mot Town,8,229,203,26,5
2022-06-18,Binh Duong,Thu Dau Mot Town,9,269,249,20,3
2022-06-18,Binh Duong,Thu Dau Mot Town,10,425,392,33,5
2022-06-18,Binh Duong,Thu Dau Mot Town,11,634,595,39,9
2022-06-18,Binh Duong,Thu Dau Mot Town,12,546,517,29,2
2022-06-18,Binh Duong,Thu Dau Mot Town,13,435,407,28,6
2022-06-18,Binh Duong,Thu Dau Mot Town,14,389,355,34,7
2022-06-18,Binh Duong,Thu Dau Mot Town,15,334,315,19,3
2022-06-18,Binh Duong,Thu Dau Mot Town,16,339,312,27,6
2022-06-18,Binh Duong,Thu Dau Mot Town,17,363,338,25,8
2022-06-18,Binh Duong,Thu Dau Mot Town,18,415,377,38,14
2022-06-18,Binh Duong,Thu Dau Mot Town,19,427,382,45,4
2022-06-18,Binh Duong,Thu Dau Mot Town,20,286,260,26,8
2022-06-18,Binh Duong,Thu Dau Mot Town,21,151,129,22,4
2022-06-18,Binh Duong,Thu Dau Mot Town,22,2,1,1,0
2022-06-18,Binh Duong,Thu Dau Mot Town,23,1,0,1,0
2022-06-18,Binh Duong,Thuan An,6,1,0,1,0
2022-06-18,Binh Duong,Thuan An,7,11,8,3,2
2022-06-18,Binh Duong,Thuan An,8,34,24,10,2
2022-06-18,Binh Duong,Thuan An,9,47,37,10,4
2022-06-18,Binh Duong,Thuan An,10,58,49,9,5
2022-06-18,Binh Duong,Thuan An,11,82,71,11,2
2022-06-18,Binh Duong,Thuan An,12,79,72,7,2
2022-06-18,Binh Duong,Thuan An,13,63,54,9,4
2022-06-18,Binh Duong,Thuan An,14,60,48,12,2
2022-06-18,Binh Duong,Thuan An,15,46,35,11,6
2022-06-18,Binh Duong,Thuan An,16,41,34,7,2
2022-06-18,Binh Duong,Thuan An,17,42,37,5,1
2022-06-18,Binh Duong,Thuan An,18,49,45,4,2
2022-06-18,Binh Duong,Thuan An,19,50,38,12,7
2022-06-18,Binh Duong,Thuan An,20,53,30,23,15
2022-06-18,Binh Duong,Thuan An,21,33,15,18,13
2022-06-18,Can Tho City,Binh Thuy District,7,2,2,0,0
2022-06-18,Can Tho City,Binh Thuy District,8,5,5,0,0
2022-06-18,Can Tho City,Binh Thuy District,9,5,5,0,0
2022-06-18,Can Tho City,Binh Thuy District,10,10,9,1,0
2022-06-18,Can Tho City,Binh Thuy District,11,17,15,2,0
2022-06-18,Can Tho City,Binh Thuy District,12,17,15,2,0
2022-06-18,Can Tho City,Binh Thuy District,13,15,11,4,0
2022-06-18,Can Tho City,Binh Thuy District,14,5,5,0,0
2022-06-18,Can Tho City,Binh Thuy District,15,15,15,0,0
2022-06-18,Can Tho City,Binh Thuy District,16,12,12,0,0
2022-06-18,Can Tho City,Binh Thuy District,17,10,8,2,0
2022-06-18,Can Tho City,Binh Thuy District,18,15,14,1,0
2022-06-18,Can Tho City,Binh Thuy District,19,14,11,3,0
2022-06-18,Can Tho City,Binh Thuy District,20,7,6,1,0
2022-06-18,Can Tho City,Binh Thuy District,21,3,2,1,0
2022-06-18,Can Tho City,Cai Rang District,2,1,1,0,0
2022-06-18,Can Tho City,Cai Rang District,6,2,1,1,1
2022-06-18,Can Tho City,Cai Rang District,7,6,2,4,1
2022-06-18,Can Tho City,Cai Rang District,8,9,6,3,2
2022-06-18,Can Tho City,Cai Rang District,9,13,11,2,0
2022-06-18,Can Tho City,Cai Rang District,10,9,9,0,0
2022-06-18,Can Tho City,Cai Rang District,11,12,12,0,0
2022-06-18,Can Tho City,Cai Rang District,12,9,9,0,0
2022-06-18,Can Tho City,Cai Rang District,13,12,12,0,0
2022-06-18,Can Tho City,Cai Rang District,14,14,12,2,0
2022-06-18,Can Tho City,Cai Rang District,15,14,11,3,0
2022-06-18,Can Tho City,Cai Rang District,16,14,12,2,0
2022-06-18,Can Tho City,Cai Rang District,17,17,14,3,2
2022-06-18,Can Tho City,Cai Rang District,18,15,15,0,0
2022-06-18,Can Tho City,Cai Rang District,19,16,15,1,0
2022-06-18,Can Tho City,Cai Rang District,20,10,6,4,2
2022-06-18,Can Tho City,Ninh Kieu District,0,4,3,1,0
2022-06-18,Can Tho City,Ninh Kieu District,4,4,2,2,0
2022-06-18,Can Tho City,Ninh Kieu District,5,1,1,0,0
2022-06-18,Can Tho City,Ninh Kieu District,6,29,26,3,2
2022-06-18,Can Tho City,Ninh Kieu District,7,124,122,2,0
2022-06-18,Can Tho City,Ninh Kieu District,8,237,227,10,0
2022-06-18,Can Tho City,Ninh Kieu District,9,357,334,23,0
2022-06-18,Can Tho City,Ninh Kieu District,10,547,521,26,0
2022-06-18,Can Tho City,Ninh Kieu District,11,854,808,46,4
2022-06-18,Can Tho City,Ninh Kieu District,12,680,646,34,0
2022-06-18,Can Tho City,Ninh Kieu District,13,563,526,37,0
2022-06-18,Can Tho City,Ninh Kieu District,14,415,402,13,0
2022-06-18,Can Tho City,Ninh Kieu District,15,351,333,18,1
2022-06-18,Can Tho City,Ninh Kieu District,16,447,430,17,0
2022-06-18,Can Tho City,Ninh Kieu District,17,504,477,27,0
2022-06-18,Can Tho City,Ninh Kieu District,18,475,459,16,0
2022-06-18,Can Tho City,Ninh Kieu District,19,457,435,22,0
2022-06-18,Can Tho City,Ninh Kieu District,20,322,294,28,0
2022-06-18,Can Tho City,Ninh Kieu District,21,233,219,14,0
2022-06-18,Can Tho City,Ninh Kieu District,22,9,1,8,0
2022-06-18,Can Tho City,Ninh Kieu District,23,2,1,1,0
2022-06-18,Dong Nai,Bien Hoa City,0,4,1,3,1
2022-06-18,Dong Nai,Bien Hoa City,3,1,1,0,0
2022-06-18,Dong Nai,Bien Hoa City,5,2,1,1,1
2022-06-18,Dong Nai,Bien Hoa City,6,59,40,19,12
2022-06-18,Dong Nai,Bien Hoa City,7,185,153,32,9
2022-06-18,Dong Nai,Bien Hoa City,8,341,291,50,10
2022-06-18,Dong Nai,Bien Hoa City,9,462,420,42,4
2022-06-18,Dong Nai,Bien Hoa City,10,827,760,67,11
2022-06-18,Dong Nai,Bien Hoa City,11,1224,1115,109,21
2022-06-18,Dong Nai,Bien Hoa City,12,1030,946,84,16
2022-06-18,Dong Nai,Bien Hoa City,13,823,739,84,26
2022-06-18,Dong Nai,Bien Hoa City,14,707,634,73,19
2022-06-18,Dong Nai,Bien Hoa City,15,634,551,83,34
2022-06-18,Dong Nai,Bien Hoa City,16,555,491,64,14
2022-06-18,Dong Nai,Bien Hoa City,17,714,617,97,48
2022-06-18,Dong Nai,Bien Hoa City,18,848,699,149,88
2022-06-18,Dong Nai,Bien Hoa City,19,791,651,140,69
2022-06-18,Dong Nai,Bien Hoa City,20,598,494,104,59
2022-06-18,Dong Nai,Bien Hoa City,21,283,203,80,28
2022-06-18,Dong Nai,Bien Hoa City,22,4,1,3,1
2022-06-18,Dong Nai,Long Khanh,11,1,0,1,1
2022-06-18,Dong Nai,Long Khanh,20,1,0,1,1
2022-06-18,Dong Nai,Long Thanh,10,3,0,3,3
2022-06-18,Dong Nai,Long Thanh,11,1,0,1,1
2022-06-18,Dong Nai,Long Thanh,12,2,0,2,2
2022-06-18,Dong Nai,Long Thanh,13,3,0,3,3
2022-06-18,Dong Nai,Long Thanh,14,1,0,1,1
2022-06-18,Dong Nai,Long Thanh,15,2,0,2,0
2022-06-18,Dong Nai,Long Thanh,18,2,0,2,2
2022-06-18,Dong Nai,Long Thanh,19,1,0,1,0
2022-06-18,Dong Nai,Long Thanh,20,1,0,1,1
2022-06-18,Dong Nai,Long Thanh,21,2,0,2,2
2022-06-18,Dong Nai,Nhon trach,12,2,0,2,2
2022-06-18,Dong Nai,Nhon trach,15,1,0,1,1
2022-06-18,Dong Nai,Nhon trach,19,2,0,2,2
2022-06-18,Dong Nai,Trang Bom,9,1,0,1,1
2022-06-18,Dong Nai,Trang Bom,11,1,0,1,1
2022-06-18,Dong Nai,Trang Bom,12,1,0,1,0
2022-06-18,Dong Nai,Trang Bom,14,3,0,3,3
2022-06-18,Dong Nai,Trang Bom,18,1,0,1,1
2022-06-18,Dong Nai,Trang Bom,19,3,0,3,3
2022-06-18,Dong Nai,Trang Bom,20,2,1,1,1
2022-06-18,Hai Phong City,An Duong,8,3,2,1,1
2022-06-18,Hai Phong City,An Duong,9,1,0,1,1
2022-06-18,Hai Phong City,An Duong,10,10,8,2,1
2022-06-18,Hai Phong City,An Duong,11,11,8,3,3
2022-06-18,Hai Phong City,An Duong,12,5,1,4,2
2022-06-18,Hai Phong City,An Duong,13,6,2,4,4
2022-06-18,Hai Phong City,An Duong,14,6,2,4,2
2022-06-18,Hai Phong City,An Duong,15,8,4,4,3
2022-06-18,Hai Phong City,An Duong,16,4,1,3,2
2022-06-18,Hai Phong City,An Duong,17,3,0,3,1
2022-06-18,Hai Phong City,An Duong,18,3,2,1,1
2022-06-18,Hai Phong City,An Duong,19,3,1,2,0
2022-06-18,Hai Phong City,An Duong,21,1,1,0,0
2022-06-18,Hai Phong City,Duong Kinh District,20,1,0,1,1
2022-06-18,Hai Phong City,Hai An District,7,9,5,4,3
2022-06-18,Hai Phong City,Hai An District,8,11,9,2,1
2022-06-18,Hai Phong City,Hai An District,9,15,12,3,3
2022-06-18,Hai Phong City,Hai An District,10,34,28,6,2
2022-06-18,Hai Phong City,Hai An District,11,48,38,10,6
2022-06-18,Hai Phong City,Hai An District,12,28,20,8,6
2022-06-18,Hai Phong City,Hai An District,13,27,17,10,7
2022-06-18,Hai Phong City,Hai An District,14,27,15,12,6
2022-06-18,Hai Phong City,Hai An District,15,28,20,8,5
2022-06-18,Hai Phong City,Hai An District,16,18,17,1,1
2022-06-18,Hai Phong City,Hai An District,17,23,20,3,0
2022-06-18,Hai Phong City,Hai An District,18,29,25,4,1
2022-06-18,Hai Phong City,Hai An District,19,26,18,8,3
2022-06-18,Hai Phong City,Hai An District,20,31,19,12,9
2022-06-18,Hai Phong City,Hai An District,21,22,12,10,6
2022-06-18,Hai Phong City,Hong Bang District,1,1,1,0,0
2022-06-18,Hai Phong City,Hong Bang District,7,12,8,4,1
2022-06-18,Hai Phong City,Hong Bang District,8,32,24,8,2
2022-06-18,Hai Phong City,Hong Bang District,9,34,27,7,1
2022-06-18,Hai Phong City,Hong Bang District,10,88,73,15,5
2022-06-18,Hai Phong City,Hong Bang District,11,146,104,42,26
2022-06-18,Hai Phong City,Hong Bang District,12,81,74,7,3
2022-06-18,Hai Phong City,Hong Bang District,13,45,32,13,7
2022-06-18,Hai Phong City,Hong Bang District,14,56,43,13,7
2022-06-18,Hai Phong City,Hong Bang District,15,45,33,12,6
2022-06-18,Hai Phong City,Hong Bang District,16,42,37,5,3
2022-06-18,Hai Phong City,Hong Bang District,17,37,34,3,0
2022-06-18,Hai Phong City,Hong Bang District,18,66,52,14,8
2022-06-18,Hai Phong City,Hong Bang District,19,49,39,10,4
2022-06-18,Hai Phong City,Hong Bang District,20,28,18,10,6
2022-06-18,Hai Phong City,Hong Bang District,21,17,8,9,7
2022-06-18,Hai Phong City,Hong Bang District,23,1,1,0,0
2022-06-18,Hai Phong City,Kien An District,6,1,1,0,0
2022-06-18,Hai Phong City,Kien An District,7,2,0,2,1
2022-06-18,Hai Phong City,Kien An District,8,10,5,5,1
2022-06-18,Hai Phong City,Kien An District,9,8,6,2,1
2022-06-18,Hai Phong City,Kien An District,10,14,11,3,1
2022-06-18,Hai Phong City,Kien An District,11,12,9,3,1
2022-06-18,Hai Phong City,Kien An District,12,18,15,3,0
2022-06-18,Hai Phong City,Kien An District,13,13,8,5,4
2022-06-18,Hai Phong City,Kien An District,14,7,2,5,4
2022-06-18,Hai Phong City,Kien An District,15,19,16,3,1
2022-06-18,Hai Phong City,Kien An District,16,8,7,1,1
2022-06-18,Hai Phong City,Kien An District,17,5,4,1,1
2022-06-18,Hai Phong City,Kien An District,18,18,13,5,1
2022-06-18,Hai Phong City,Kien An District,19,14,10,4,0
2022-06-18,Hai Phong City,Kien An District,20,12,7,5,4
2022-06-18,Hai Phong City,Kien An District,21,4,1,3,3
2022-06-18,Hai Phong City,Le Chan District,1,2,1,1,0
2022-06-18,Hai Phong City,Le Chan District,6,2,1,1,0
2022-06-18,Hai Phong City,Le Chan District,7,49,41,8,2
2022-06-18,Hai Phong City,Le Chan District,8,86,69,17,3
2022-06-18,Hai Phong City,Le Chan District,9,102,88,14,4
2022-06-18,Hai Phong City,Le Chan District,10,231,200,31,11
2022-06-18,Hai Phong City,Le Chan District,11,406,329,77,42
2022-06-18,Hai Phong City,Le Chan District,12,286,251,35,14
2022-06-18,Hai Phong City,Le Chan District,13,145,113,32,11
2022-06-18,Hai Phong City,Le Chan District,14,173,132,41,19
2022-06-18,Hai Phong City,Le Chan District,15,180,144,36,15
2022-06-18,Hai Phong City,Le Chan District,16,165,147,18,5
2022-06-18,Hai Phong City,Le Chan District,17,205,177,28,10
2022-06-18,Hai Phong City,Le Chan District,18,223,189,34,13
2022-06-18,Hai Phong City,Le Chan District,19,237,181,56,36
2022-06-18,Hai Phong City,Le Chan District,20,162,124,38,21
2022-06-18,Hai Phong City,Le Chan District,21,97,56,41,25
2022-06-18,Hai Phong City,Le Chan District,22,3,2,1,0
2022-06-18,Hai Phong City,Le Chan District,23,2,1,1,0
2022-06-18,Hai Phong City,Ngo Quyen District,6,1,1,0,0
2022-06-18,Hai Phong City,Ngo Quyen District,7,22,17,5,2
2022-06-18,Hai Phong City,Ngo Quyen District,8,62,56,6,1
2022-06-18,Hai Phong City,Ngo Quyen District,9,100,89,11,3
2022-06-18,Hai Phong City,Ngo Quyen District,10,151,136,15,6
2022-06-18,Hai Phong City,Ngo Quyen District,11,257,209,48,23
2022-06-18,Hai Phong City,Ngo Quyen District,12,168,148,20,10
2022-06-18,Hai Phong City,Ngo Quyen District,13,126,111,15,3
2022-06-18,Hai Phong City,Ngo Quyen District,14,142,115,27,17
2022-06-18,Hai Phong City,Ngo Quyen District,15,143,115,28,16
2022-06-18,Hai Phong City,Ngo Quyen District,16,134,111,23,8
2022-06-18,Hai Phong City,Ngo Quyen District,17,113,98,15,4
2022-06-18,Hai Phong City,Ngo Quyen District,18,151,125,26,4
2022-06-18,Hai Phong City,Ngo Quyen District,19,176,127,49,31
2022-06-18,Hai Phong City,Ngo Quyen District,20,139,98,41,17
2022-06-18,Hai Phong City,Ngo Quyen District,21,95,59,36,21
2022-06-18,Hai Phong City,Ngo Quyen District,22,2,1,1,0
2022-06-18,Hai Phong City,Thuy Nguyen,10,3,0,3,3
2022-06-18,Hai Phong City,Thuy Nguyen,11,3,0,3,1
2022-06-18,Hai Phong City,Thuy Nguyen,14,1,0,1,1
2022-06-18,Hai Phong City,Thuy Nguyen,15,1,0,1,1
2022-06-18,Hai Phong City,Thuy Nguyen,16,1,0,1,1
2022-06-18,Hai Phong City,Thuy Nguyen,17,4,0,4,4
2022-06-18,Hai Phong City,Thuy Nguyen,18,2,0,2,2
2022-06-18,Hue City,Hue City,0,3,2,1,0
2022-06-18,Hue City,Hue City,1,2,2,0,0
2022-06-18,Hue City,Hue City,5,2,2,0,0
2022-06-18,Hue City,Hue City,6,76,66,10,1
2022-06-18,Hue City,Hue City,7,200,192,8,0
2022-06-18,Hue City,Hue City,8,348,318,30,1
2022-06-18,Hue City,Hue City,9,304,285,19,0
2022-06-18,Hue City,Hue City,10,532,487,45,1
2022-06-18,Hue City,Hue City,11,966,878,88,14
2022-06-18,Hue City,Hue City,12,689,615,74,11
2022-06-18,Hue City,Hue City,13,365,327,38,1
2022-06-18,Hue City,Hue City,14,408,363,45,2
2022-06-18,Hue City,Hue City,15,393,368,25,2
2022-06-18,Hue City,Hue City,16,384,356,28,2
2022-06-18,Hue City,Hue City,17,401,373,28,4
2022-06-18,Hue City,Hue City,18,507,460,47,6
2022-06-18,Hue City,Hue City,19,563,500,63,3
2022-06-18,Hue City,Hue City,20,438,374,64,19
2022-06-18,Hue City,Hue City,21,253,192,61,18
2022-06-18,Hue City,Hue City,22,4,1,3,0
2022-06-18,Hue City,Hue City,23,3,2,1,0
2022-06-18,Hue City,Huong Thuy,10,1,1,0,0
2022-06-18,Hue City,Huong Thuy,11,2,2,0,0
2022-06-18,Hue City,Huong Thuy,12,4,1,3,1
2022-06-18,Hue City,Huong Thuy,13,2,1,1,0
2022-06-18,Hue City,Huong Thuy,15,1,0,1,0
2022-06-18,Hue City,Huong Thuy,16,2,0,2,1
2022-06-18,Hue City,Huong Thuy,17,3,3,0,0
2022-06-18,Hue City,Huong Thuy,18,1,1,0,0
2022-06-18,Hue City,Huong Thuy,19,3,1,2,2
2022-06-18,Hue City,Huong Thuy,20,1,1,0,0
2022-06-18,Hue City,Huong Thuy,21,1,0,1,1
2022-06-18,Hue City,Huong Tra,11,1,1,0,0
2022-06-18,Hue City,Huong Tra,15,3,0,3,3
2022-06-18,Hue City,Huong Tra,20,3,1,2,1
2022-06-18,Hue City,Phu Vang,7,2,1,1,0
2022-06-18,Hue City,Phu Vang,8,4,3,1,0
2022-06-18,Hue City,Phu Vang,9,2,2,0,0
2022-06-18,Hue City,Phu Vang,11,1,0,1,0
2022-06-18,Hue City,Phu Vang,12,1,1,0,0
2022-06-18,Hue City,Phu Vang,13,1,1,0,0
2022-06-18,Hue City,Phu Vang,14,3,3,0,0
2022-06-18,Hue City,Phu Vang,16,3,3,0,0
2022-06-18,Hue City,Phu Vang,17,2,1,1,0
2022-06-18,Hue City,Phu Vang,18,3,3,0,0
2022-06-18,Hue City,Phu Vang,19,3,2,1,0
2022-06-18,Hue City,Phu Vang,20,4,2,2,2
2022-06-18,Hue City,Phu Vang,21,3,0,3,3
2022-06-18,Khanh Hoa,Cam Ranh City,19,1,0,1,1
2022-06-18,Khanh Hoa,Cam Ranh City,20,2,0,2,2
2022-06-18,Khanh Hoa,Dien Khanh,15,1,0,1,1
2022-06-18,Khanh Hoa,Dien Khanh,19,2,0,2,1
2022-06-18,Khanh Hoa,Nha Trang City,0,1,1,0,0
2022-06-18,Khanh Hoa,Nha Trang City,1,1,1,0,0
2022-06-18,Khanh Hoa,Nha Trang City,4,1,1,0,0
2022-06-18,Khanh Hoa,Nha Trang City,6,42,34,8,2
2022-06-18,Khanh Hoa,Nha Trang City,7,132,127,5,1
2022-06-18,Khanh Hoa,Nha Trang City,8,225,204,21,3
2022-06-18,Khanh Hoa,Nha Trang City,9,188,174,14,1
2022-06-18,Khanh Hoa,Nha Trang City,10,252,223,29,7
2022-06-18,Khanh Hoa,Nha Trang City,11,391,342,49,19
2022-06-18,Khanh Hoa,Nha Trang City,12,352,317,35,9
2022-06-18,Khanh Hoa,Nha Trang City,13,242,230,12,2
2022-06-18,Khanh Hoa,Nha Trang City,14,203,187,16,0
2022-06-18,Khanh Hoa,Nha Trang City,15,208,190,18,2
2022-06-18,Khanh Hoa,Nha Trang City,16,213,195,18,1
2022-06-18,Khanh Hoa,Nha Trang City,17,241,225,16,4
2022-06-18,Khanh Hoa,Nha Trang City,18,325,267,58,34
2022-06-18,Khanh Hoa,Nha Trang City,19,315,213,102,48
2022-06-18,Khanh Hoa,Nha Trang City,20,212,177,35,11
2022-06-18,Khanh Hoa,Nha Trang City,21,152,90,62,27
2022-06-18,Khanh Hoa,Nha Trang City,22,1,0,1,0
2022-06-18,Khanh Hoa,Nha Trang City,23,1,0,1,0
2022-06-18,Lam Dong,Da Lat City,1,1,0,1,1
2022-06-18,Lam Dong,Da Lat City,5,2,1,1,1
2022-06-18,Lam Dong,Da Lat City,6,10,4,6,4
2022-06-18,Lam Dong,Da Lat City,7,81,37,44,33
2022-06-18,Lam Dong,Da Lat City,8,101,72,29,18
2022-06-18,Lam Dong,Da Lat City,9,109,84,25,8
2022-06-18,Lam Dong,Da Lat City,10,120,90,30,17
2022-06-18,Lam Dong,Da Lat City,11,141,106,35,22
2022-06-18,Lam Dong,Da Lat City,12,227,93,134,112
2022-06-18,Lam Dong,Da Lat City,13,183,65,118,100
2022-06-18,Lam Dong,Da Lat City,14,196,93,103,89
2022-06-18,Lam Dong,Da Lat City,15,172,86,86,60
2022-06-18,Lam Dong,Da Lat City,16,178,90,88,70
2022-06-18,Lam Dong,Da Lat City,17,285,94,191,145
2022-06-18,Lam Dong,Da Lat City,18,298,90,208,185
2022-06-18,Lam Dong,Da Lat City,19,270,93,177,152
2022-06-18,Lam Dong,Da Lat City,20,227,61,166,146
2022-06-18,Lam Dong,Da Lat City,21,126,37,89,71
2022-06-18,Lam Dong,Da Lat City,22,1,1,0,0
2022-06-18,Lam Dong,Da Lat City,23,1,0,1,0
2022-06-18,Nghe An,Vinh City,1,2,1,1,1
2022-06-18,Nghe An,Vinh City,5,1,0,1,1
2022-06-18,Nghe An,Vinh City,6,7,4,3,2
2022-06-18,Nghe An,Vinh City,7,118,100,18,3
2022-06-18,Nghe An,Vinh City,8,190,170,20,1
2022-06-18,Nghe An,Vinh City,9,178,157,21,3
2022-06-18,Nghe An,Vinh City,10,255,215,40,9
2022-06-18,Nghe An,Vinh City,11,452,351,101,60
2022-06-18,Nghe An,Vinh City,12,271,232,39,12
2022-06-18,Nghe An,Vinh City,13,168,150,18,4
2022-06-18,Nghe An,Vinh City,14,186,159,27,9
2022-06-18,Nghe An,Vinh City,15,182,150,32,9
2022-06-18,Nghe An,Vinh City,16,169,132,37,12
2022-06-18,Nghe An,Vinh City,17,174,140,34,10
2022-06-18,Nghe An,Vinh City,18,221,169,52,27
2022-06-18,Nghe An,Vinh City,19,194,127,67,44
2022-06-18,Nghe An,Vinh City,20,166,94,72,45
2022-06-18,Nghe An,Vinh City,21,122,63,59,36
2022-06-18,Nghe An,Vinh City,22,2,0,2,0
2022-06-18,Quang Nam,Dien Ban,12,1,0,1,1
2022-06-18,Quang Nam,Dien Ban,16,1,0,1,1
2022-06-18,Quang Nam,Hoi An City,6,1,0,1,1
2022-06-18,Quang Nam,Hoi An City,7,16,9,7,1
2022-06-18,Quang Nam,Hoi An City,8,23,18,5,2
2022-06-18,Quang Nam,Hoi An City,9,29,25,4,1
2022-06-18,Quang Nam,Hoi An City,10,37,34,3,2
2022-06-18,Quang Nam,Hoi An City,11,71,55,16,5
2022-06-18,Quang Nam,Hoi An City,12,76,62,14,9
2022-06-18,Quang Nam,Hoi An City,13,48,33,15,10
2022-06-18,Quang Nam,Hoi An City,14,46,37,9,4
2022-06-18,Quang Nam,Hoi An City,15,52,45,7,3
2022-06-18,Quang Nam,Hoi An City,16,27,21,6,3
2022-06-18,Quang Nam,Hoi An City,17,62,46,16,6
2022-06-18,Quang Nam,Hoi An City,18,70,50,20,14
2022-06-18,Quang Nam,Hoi An City,19,85,55,30,21
2022-06-18,Quang Nam,Hoi An City,20,85,46,39,28
2022-06-18,Quang Nam,Hoi An City,21,50,22,28,19
2022-06-18,Quang Nam,Tam Ky City,9,2,0,2,0
2022-06-18,Quang Nam,Tam Ky City,10,3,0,3,2
2022-06-18,Quang Nam,Tam Ky City,15,1,0,1,1
2022-06-18,Quang Nam,Tam Ky City,20,1,0,1,0
2022-06-18,Quang Ninh,Cam Pha City,7,1,0,1,0
2022-06-18,Quang Ninh,Cam Pha City,10,1,0,1,1
2022-06-18,Quang Ninh,Cam Pha City,11,2,0,2,1
2022-06-18,Quang Ninh,Cam Pha City,13,1,0,1,1
2022-06-18,Quang Ninh,Cam Pha City,14,3,0,3,2
2022-06-18,Quang Ninh,Cam Pha City,15,1,0,1,1
2022-06-18,Quang Ninh,Cam Pha City,16,2,0,2,2
2022-06-18,Quang Ninh,Cam Pha City,17,1,0,1,1
2022-06-18,Quang Ninh,Cam Pha City,18,2,0,2,2
2022-06-18,Quang Ninh,Ha Long City,0,1,0,1,0
2022-06-18,Quang Ninh,Ha Long City,5,3,1,2,0
2022-06-18,Quang Ninh,Ha Long City,6,1,1,0,0
2022-06-18,Quang Ninh,Ha Long City,7,29,15,14,8
2022-06-18,Quang Ninh,Ha Long City,8,40,29,11,5
2022-06-18,Quang Ninh,Ha Long City,9,66,46,20,11
2022-06-18,Quang Ninh,Ha Long City,10,97,66,31,16
2022-06-18,Quang Ninh,Ha Long City,11,168,115,53,35
2022-06-18,Quang Ninh,Ha Long City,12,145,94,51,33
2022-06-18,Quang Ninh,Ha Long City,13,102,62,40,23
2022-06-18,Quang Ninh,Ha Long City,14,71,45,26,10
2022-06-18,Quang Ninh,Ha Long City,15,95,60,35,20
2022-06-18,Quang Ninh,Ha Long City,16,70,47,23,14
2022-06-18,Quang Ninh,Ha Long City,17,69,57,12,5
2022-06-18,Quang Ninh,Ha Long City,18,72,54,18,8
2022-06-18,Quang Ninh,Ha Long City,19,84,51,33,20
2022-06-18,Quang Ninh,Ha Long City,20,72,40,32,24
2022-06-18,Quang Ninh,Ha Long City,21,4,0,4,0
2022-06-18,Thai Nguyen,Dong Hy,5,1,0,1,1
2022-06-18,Thai Nguyen,Dong Hy,21,2,0,2,1
2022-06-18,Thai Nguyen,Thai Nguyen City,0,1,1,0,0
2022-06-18,Thai Nguyen,Thai Nguyen City,1,1,0,1,0
2022-06-18,Thai Nguyen,Thai Nguyen City,6,9,7,2,1
2022-06-18,Thai Nguyen,Thai Nguyen City,7,99,85,14,2
2022-06-18,Thai Nguyen,Thai Nguyen City,8,155,134,21,0
2022-06-18,Thai Nguyen,Thai Nguyen City,9,154,133,21,5
2022-06-18,Thai Nguyen,Thai Nguyen City,10,245,218,27,1
2022-06-18,Thai Nguyen,Thai Nguyen City,11,422,380,42,5
2022-06-18,Thai Nguyen,Thai Nguyen City,12,329,305,24,0
2022-06-18,Thai Nguyen,Thai Nguyen City,13,187,166,21,2
2022-06-18,Thai Nguyen,Thai Nguyen City,14,191,172,19,2
2022-06-18,Thai Nguyen,Thai Nguyen City,15,166,155,11,0
2022-06-18,Thai Nguyen,Thai Nguyen City,16,159,137,22,2
2022-06-18,Thai Nguyen,Thai Nguyen City,17,160,144,16,3
2022-06-18,Thai Nguyen,Thai Nguyen City,18,245,235,10,2
2022-06-18,Thai Nguyen,Thai Nguyen City,19,337,265,72,33
2022-06-18,Thai Nguyen,Thai Nguyen City,20,244,197,47,25
2022-06-18,Thai Nguyen,Thai Nguyen City,21,152,130,22,6
2022-06-18,Thai Nguyen,Thai Nguyen City,22,4,1,3,0
2022-06-18,Thai Nguyen,Thai Nguyen City,23,1,1,0,0
2022-06-18,Vung Tau,Ba Ria City,7,3,1,2,2
2022-06-18,Vung Tau,Ba Ria City,8,2,2,0,0
2022-06-18,Vung Tau,Ba Ria City,9,12,4,8,4
2022-06-18,Vung Tau,Ba Ria City,10,8,6,2,1
2022-06-18,Vung Tau,Ba Ria City,11,6,5,1,1
2022-06-18,Vung Tau,Ba Ria City,12,11,3,8,5
2022-06-18,Vung Tau,Ba Ria City,13,7,6,1,0
2022-06-18,Vung Tau,Ba Ria City,14,10,4,6,5
2022-06-18,Vung Tau,Ba Ria City,15,8,6,2,2
2022-06-18,Vung Tau,Ba Ria City,16,12,1,11,8
2022-06-18,Vung Tau,Ba Ria City,17,8,0,8,5
2022-06-18,Vung Tau,Ba Ria City,18,5,2,3,2
2022-06-18,Vung Tau,Ba Ria City,19,13,0,13,10
2022-06-18,Vung Tau,Ba Ria City,20,2,0,2,2
2022-06-18,Vung Tau,Ba Ria City,21,3,0,3,2
2022-06-18,Vung Tau,Long Dien,13,1,0,1,1
2022-06-18,Vung Tau,Vung Tau City,0,1,0,1,0
2022-06-18,Vung Tau,Vung Tau City,1,1,1,0,0
2022-06-18,Vung Tau,Vung Tau City,2,1,0,1,0
2022-06-18,Vung Tau,Vung Tau City,3,1,0,1,1
2022-06-18,Vung Tau,Vung Tau City,5,1,1,0,0
2022-06-18,Vung Tau,Vung Tau City,6,58,44,14,7
2022-06-18,Vung Tau,Vung Tau City,7,118,101,17,3
2022-06-18,Vung Tau,Vung Tau City,8,196,179,17,3
2022-06-18,Vung Tau,Vung Tau City,9,218,208,10,0
2022-06-18,Vung Tau,Vung Tau City,10,299,276,23,5
2022-06-18,Vung Tau,Vung Tau City,11,421,379,42,8
2022-06-18,Vung Tau,Vung Tau City,12,422,395,27,5
2022-06-18,Vung Tau,Vung Tau City,13,295,276,19,2
2022-06-18,Vung Tau,Vung Tau City,14,290,272,18,3
2022-06-18,Vung Tau,Vung Tau City,15,259,251,8,2
2022-06-18,Vung Tau,Vung Tau City,16,239,225,14,0
2022-06-18,Vung Tau,Vung Tau City,17,292,277,15,2
2022-06-18,Vung Tau,Vung Tau City,18,377,335,42,13
2022-06-18,Vung Tau,Vung Tau City,19,404,262,142,98
2022-06-18,Vung Tau,Vung Tau City,20,305,182,123,84
2022-06-18,Vung Tau,Vung Tau City,21,129,96,33,14
2022-06-18,Vung Tau,Vung Tau City,22,2,1,1,0
2022-06-18,Vung Tau,Vung Tau City,23,2,1,1,0
2022-06-19,Bac Ninh,Bác Ninh City,6,5,2,3,1
2022-06-19,Bac Ninh,Bác Ninh City,7,62,52,10,2
2022-06-19,Bac Ninh,Bác Ninh City,8,125,111,14,1
2022-06-19,Bac Ninh,Bác Ninh City,9,139,127,12,3
2022-06-19,Bac Ninh,Bác Ninh City,10,284,211,73,39
2022-06-19,Bac Ninh,Bác Ninh City,11,494,283,211,162
2022-06-19,Bac Ninh,Bác Ninh City,12,333,238,95,64
2022-06-19,Bac Ninh,Bác Ninh City,13,210,143,67,48
2022-06-19,Bac Ninh,Bác Ninh City,14,211,134,77,59
2022-06-19,Bac Ninh,Bác Ninh City,15,224,156,68,49
2022-06-19,Bac Ninh,Bác Ninh City,16,151,115,36,26
2022-06-19,Bac Ninh,Bác Ninh City,17,150,131,19,4
2022-06-19,Bac Ninh,Bác Ninh City,18,215,178,37,13
2022-06-19,Bac Ninh,Bác Ninh City,19,224,163,61,25
2022-06-19,Bac Ninh,Bác Ninh City,20,173,129,44,20
2022-06-19,Bac Ninh,Bác Ninh City,21,128,86,42,21
2022-06-19,Bac Ninh,Bác Ninh City,22,1,0,1,0
2022-06-19,Bac Ninh,Que Vo,9,1,0,1,1
2022-06-19,Bac Ninh,Que Vo,13,1,0,1,1
2022-06-19,Bac Ninh,Que Vo,14,2,0,2,2
2022-06-19,Bac Ninh,Que Vo,15,1,0,1,1
2022-06-19,Bac Ninh,Que Vo,17,3,2,1,1
2022-06-19,Bac Ninh,Que Vo,19,2,0,2,2
2022-06-19,Bac Ninh,Que Vo,21,1,0,1,1
2022-06-19,Bac Ninh,Tien Du,10,3,0,3,3
2022-06-19,Bac Ninh,Tien Du,12,1,0,1,1
2022-06-19,Bac Ninh,Tien Du,13,3,0,3,2
2022-06-19,Bac Ninh,Tien Du,14,1,0,1,1
2022-06-19,Bac Ninh,Tien Du,16,2,0,2,2
2022-06-19,Bac Ninh,Tien Du,17,3,0,3,3
2022-06-19,Bac Ninh,Tien Du,19,1,0,1,1
2022-06-19,Bac Ninh,Tien Du,20,3,0,3,3
2022-06-19,Bac Ninh,Tu Son,8,1,0,1,1
2022-06-19,Bac Ninh,Tu Son,10,1,0,1,1
2022-06-19,Bac Ninh,Tu Son,12,7,0,7,7
2022-06-19,Bac Ninh,Tu Son,13,2,0,2,2
2022-06-19,Bac Ninh,Tu Son,14,2,0,2,2
2022-06-19,Bac Ninh,Tu Son,15,4,0,4,4
2022-06-19,Bac Ninh,Tu Son,16,1,0,1,1
2022-06-19,Bac Ninh,Tu Son,21,1,0,1,1
2022-06-19,Bac Ninh,Yen Phong,19,1,0,1,1
2022-06-19,Binh Duong,Ben Cat,9,1,0,1,1
2022-06-19,Binh Duong,Ben Cat,12,2,0,2,2
2022-06-19,Binh Duong,Ben Cat,13,1,0,1,1
2022-06-19,Binh Duong,Ben Cat,17,3,0,3,2
2022-06-19,Binh Duong,Ben Cat,18,1,0,1,1
2022-06-19,Binh Duong,Ben Cat,20,1,0,1,1
2022-06-19,Binh Duong,Di An,6,3,1,2,1
2022-06-19,Binh Duong,Di An,7,8,2,6,4
2022-06-19,Binh Duong,Di An,8,17,9,8,4
2022-06-19,Binh Duong,Di An,9,24,13,11,7
2022-06-19,Binh Duong,Di An,10,43,30,13,9
2022-06-19,Binh Duong,Di An,11,57,40,17,9
2022-06-19,Binh Duong,Di An,12,49,34,15,6
2022-06-19,Binh Duong,Di An,13,46,26,20,12
2022-06-19,Binh Duong,Di An,14,36,30,6,3
2022-06-19,Binh Duong,Di An,15,23,19,4,3
2022-06-19,Binh Duong,Di An,16,35,22,13,7
2022-06-19,Binh Duong,Di An,17,34,18,16,16
2022-06-19,Binh Duong,Di An,18,63,20,43,40
2022-06-19,Binh Duong,Di An,19,69,17,52,42
2022-06-19,Binh Duong,Di An,20,36,15,21,13
2022-06-19,Binh Duong,Di An,21,12,3,9,7
2022-06-19,Binh Duong,Tan Uyen,9,2,1,1,1
2022-06-19,Binh Duong,Tan Uyen,10,4,2,2,2
2022-06-19,Binh Duong,Tan Uyen,11,2,0,2,2
2022-06-19,Binh Duong,Tan Uyen,12,3,2,1,1
2022-06-19,Binh Duong,Tan Uyen,13,6,4,2,2
2022-06-19,Binh Duong,Tan Uyen,14,5,1,4,3
2022-06-19,Binh Duong,Tan Uyen,15,3,0,3,3
2022-06-19,Binh Duong,Tan Uyen,17,4,0,4,4
2022-06-19,Binh Duong,Tan Uyen,18,2,1,1,1
2022-06-19,Binh Duong,Tan Uyen,19,13,1,12,11
2022-06-19,Binh Duong,Tan Uyen,20,1,1,0,0
2022-06-19,Binh Duong,Thu Dau Mot Town,0,6,3,3,0
2022-06-19,Binh Duong,Thu Dau Mot Town,2,1,0,1,0
2022-06-19,Binh Duong,Thu Dau Mot Town,3,2,1,1,0
2022-06-19,Binh Duong,Thu Dau Mot Town,5,1,0,1,0
2022-06-19,Binh Duong,Thu Dau Mot Town,6,42,35,7,2
2022-06-19,Binh Duong,Thu Dau Mot Town,7,144,120,24,2
2022-06-19,Binh Duong,Thu Dau Mot Town,8,238,216,22,1
2022-06-19,Binh Duong,Thu Dau Mot Town,9,282,264,18,1
2022-06-19,Binh Duong,Thu Dau Mot Town,10,400,370,30,2
2022-06-19,Binh Duong,Thu Dau Mot Town,11,630,584,46,8
2022-06-19,Binh Duong,Thu Dau Mot Town,12,538,504,34,10
2022-06-19,Binh Duong,Thu Dau Mot Town,13,467,420,47,11
2022-06-19,Binh Duong,Thu Dau Mot Town,14,329,309,20,6
2022-06-19,Binh Duong,Thu Dau Mot Town,15,320,289,31,8
2022-06-19,Binh Duong,Thu Dau Mot Town,16,306,280,26,4
2022-06-19,Binh Duong,Thu Dau Mot Town,17,422,386,36,10
2022-06-19,Binh Duong,Thu Dau Mot Town,18,564,377,187,133
2022-06-19,Binh Duong,Thu Dau Mot Town,19,519,353,166,113
2022-06-19,Binh Duong,Thu Dau Mot Town,20,304,247,57,29
2022-06-19,Binh Duong,Thu Dau Mot Town,21,151,119,32,5
2022-06-19,Binh Duong,Thu Dau Mot Town,23,1,0,1,0
2022-06-19,Binh Duong,Thuan An,3,1,0,1,0
2022-06-19,Binh Duong,Thuan An,6,6,0,6,5
2022-06-19,Binh Duong,Thuan An,7,10,2,8,5
2022-06-19,Binh Duong,Thuan An,8,14,11,3,3
2022-06-19,Binh Duong,Thuan An,9,47,38,9,6
2022-06-19,Binh Duong,Thuan An,10,82,59,23,10
2022-06-19,Binh Duong,Thuan An,11,86,69,17,6
2022-06-19,Binh Duong,Thuan An,12,84,70,14,3
2022-06-19,Binh Duong,Thuan An,13,63,56,7,5
2022-06-19,Binh Duong,Thuan An,14,44,32,12,7
2022-06-19,Binh Duong,Thuan An,15,46,38,8,6
2022-06-19,Binh Duong,Thuan An,16,45,42,3,1
2022-06-19,Binh Duong,Thuan An,17,66,48,18,8
2022-06-19,Binh Duong,Thuan An,18,82,56,26,22
2022-06-19,Binh Duong,Thuan An,19,75,37,38,28
2022-06-19,Binh Duong,Thuan An,20,47,32,15,7
2022-06-19,Binh Duong,Thuan An,21,32,15,17,8
2022-06-19,Can Tho City,Binh Thuy District,6,2,1,1,1
2022-06-19,Can Tho City,Binh Thuy District,7,2,1,1,0
2022-06-19,Can Tho City,Binh Thuy District,8,3,3,0,0
2022-06-19,Can Tho City,Binh Thuy District,9,3,3,0,0
2022-06-19,Can Tho City,Binh Thuy District,10,10,8,2,0
2022-06-19,Can Tho City,Binh Thuy District,11,19,18,1,0
2022-06-19,Can Tho City,Binh Thuy District,12,13,12,1,0
2022-06-19,Can Tho City,Binh Thuy District,13,7,7,0,0
2022-06-19,Can Tho City,Binh Thuy District,14,8,7,1,1
2022-06-19,Can Tho City,Binh Thuy District,15,5,5,0,0
2022-06-19,Can Tho City,Binh Thuy District,16,7,6,1,1
2022-06-19,Can Tho City,Binh Thuy District,17,26,23,3,0
2022-06-19,Can Tho City,Binh Thuy District,18,21,20,1,0
2022-06-19,Can Tho City,Binh Thuy District,19,13,12,1,1
2022-06-19,Can Tho City,Binh Thuy District,20,10,10,0,0
2022-06-19,Can Tho City,Binh Thuy District,21,4,4,0,0
2022-06-19,Can Tho City,Cai Rang District,6,5,4,1,1
2022-06-19,Can Tho City,Cai Rang District,7,6,4,2,2
2022-06-19,Can Tho City,Cai Rang District,8,13,8,5,2
2022-06-19,Can Tho City,Cai Rang District,9,14,11,3,0
2022-06-19,Can Tho City,Cai Rang District,10,9,9,0,0
2022-06-19,Can Tho City,Cai Rang District,11,23,20,3,1
2022-06-19,Can Tho City,Cai Rang District,12,16,15,1,1
2022-06-19,Can Tho City,Cai Rang District,13,6,5,1,0
2022-06-19,Can Tho City,Cai Rang District,14,9,8,1,0
2022-06-19,Can Tho City,Cai Rang District,15,12,12,0,0
2022-06-19,Can Tho City,Cai Rang District,16,17,11,6,2
2022-06-19,Can Tho City,Cai Rang District,17,19,15,4,0
2022-06-19,Can Tho City,Cai Rang District,18,15,14,1,0
2022-06-19,Can Tho City,Cai Rang District,19,11,9,2,0
2022-06-19,Can Tho City,Cai Rang District,20,5,3,2,0
2022-06-19,Can Tho City,Cai Rang District,21,6,5,1,0
2022-06-19,Can Tho City,Ninh Kieu District,2,1,1,0,0
2022-06-19,Can Tho City,Ninh Kieu District,3,2,1,1,0
2022-06-19,Can Tho City,Ninh Kieu District,4,1,1,0,0
2022-06-19,Can Tho City,Ninh Kieu District,5,1,1,0,0
2022-06-19,Can Tho City,Ninh Kieu District,6,53,39,14,7
2022-06-19,Can Tho City,Ninh Kieu District,7,137,132,5,0
2022-06-19,Can Tho City,Ninh Kieu District,8,240,226,14,0
2022-06-19,Can Tho City,Ninh Kieu District,9,331,318,13,0
2022-06-19,Can Tho City,Ninh Kieu District,10,558,534,24,0
2022-06-19,Can Tho City,Ninh Kieu District,11,795,751,44,4
2022-06-19,Can Tho City,Ninh Kieu District,12,716,688,28,0
2022-06-19,Can Tho City,Ninh Kieu District,13,436,415,21,0
2022-06-19,Can Tho City,Ninh Kieu District,14,391,376,15,0
2022-06-19,Can Tho City,Ninh Kieu District,15,324,301,23,0
2022-06-19,Can Tho City,Ninh Kieu District,16,492,463,29,4
2022-06-19,Can Tho City,Ninh Kieu District,17,532,498,34,0
2022-06-19,Can Tho City,Ninh Kieu District,18,610,576,34,2
2022-06-19,Can Tho City,Ninh Kieu District,19,506,478,28,0
2022-06-19,Can Tho City,Ninh Kieu District,20,433,399,34,0
2022-06-19,Can Tho City,Ninh Kieu District,21,220,197,23,6
2022-06-19,Can Tho City,Ninh Kieu District,22,2,0,2,0
2022-06-19,Dong Nai,Bien Hoa City,0,2,0,2,0
2022-06-19,Dong Nai,Bien Hoa City,1,1,1,0,0
2022-06-19,Dong Nai,Bien Hoa City,4,2,1,1,0
2022-06-19,Dong Nai,Bien Hoa City,5,1,1,0,0
2022-06-19,Dong Nai,Bien Hoa City,6,55,40,15,10
2022-06-19,Dong Nai,Bien Hoa City,7,188,154,34,9
2022-06-19,Dong Nai,Bien Hoa City,8,325,285,40,11
2022-06-19,Dong Nai,Bien Hoa City,9,522,468,54,8
2022-06-19,Dong Nai,Bien Hoa City,10,898,820,78,23
2022-06-19,Dong Nai,Bien Hoa City,11,1223,1098,125,39
2022-06-19,Dong Nai,Bien Hoa City,12,1067,978,89,13
2022-06-19,Dong Nai,Bien Hoa City,13,707,627,80,18
2022-06-19,Dong Nai,Bien Hoa City,14,691,629,62,13
2022-06-19,Dong Nai,Bien Hoa City,15,648,579,69,18
2022-06-19,Dong Nai,Bien Hoa City,16,642,572,70,27
2022-06-19,Dong Nai,Bien Hoa City,17,798,627,171,96
2022-06-19,Dong Nai,Bien Hoa City,18,883,696,187,107
2022-06-19,Dong Nai,Bien Hoa City,19,857,683,174,101
2022-06-19,Dong Nai,Bien Hoa City,20,584,464,120,51
2022-06-19,Dong Nai,Bien Hoa City,21,260,189,71,23
2022-06-19,Dong Nai,Bien Hoa City,22,3,0,3,0
2022-06-19,Dong Nai,Bien Hoa City,23,1,0,1,0
2022-06-19,Dong Nai,Long Khanh,11,1,0,1,1
2022-06-19,Dong Nai,Long Khanh,14,1,0,1,1
2022-06-19,Dong Nai,Long Khanh,15,1,0,1,1
2022-06-19,Dong Nai,Long Khanh,17,1,0,1,1
2022-06-19,Dong Nai,Long Thanh,9,1,0,1,1
2022-06-19,Dong Nai,Long Thanh,10,3,0,3,3
2022-06-19,Dong Nai,Long Thanh,11,2,0,2,2
2022-06-19,Dong Nai,Long Thanh,12,4,0,4,4
2022-06-19,Dong Nai,Long Thanh,13,4,0,4,2
2022-06-19,Dong Nai,Long Thanh,14,1,0,1,1
2022-06-19,Dong Nai,Long Thanh,16,2,0,2,2
2022-06-19,Dong Nai,Long Thanh,17,1,0,1,1
2022-06-19,Dong Nai,Long Thanh,18,2,0,2,2
2022-06-19,Dong Nai,Long Thanh,19,1,0,1,1
2022-06-19,Dong Nai,Long Thanh,21,1,0,1,1
2022-06-19,Dong Nai,Nhon trach,8,1,0,1,1
2022-06-19,Dong Nai,Nhon trach,11,1,0,1,1
2022-06-19,Dong Nai,Nhon trach,20,1,0,1,1
2022-06-19,Dong Nai,Trang Bom,9,1,0,1,1
2022-06-19,Dong Nai,Trang Bom,10,2,0,2,2
2022-06-19,Dong Nai,Trang Bom,14,1,0,1,1
2022-06-19,Dong Nai,Trang Bom,16,1,0,1,1
2022-06-19,Dong Nai,Trang Bom,19,1,0,1,0
2022-06-19,Hai Phong City,An Duong,1,1,0,1,1
2022-06-19,Hai Phong City,An Duong,8,1,1,0,0
2022-06-19,Hai Phong City,An Duong,9,5,2,3,3
2022-06-19,Hai Phong City,An Duong,10,16,5,11,9
2022-06-19,Hai Phong City,An Duong,11,7,4,3,2
2022-06-19,Hai Phong City,An Duong,12,3,1,2,1
2022-06-19,Hai Phong City,An Duong,13,5,2,3,3
2022-06-19,Hai Phong City,An Duong,14,4,3,1,1
2022-06-19,Hai Phong City,An Duong,15,6,3,3,2
2022-06-19,Hai Phong City,An Duong,16,2,0,2,2
2022-06-19,Hai Phong City,An Duong,17,6,4,2,1
2022-06-19,Hai Phong City,An Duong,19,2,1,1,1
2022-06-19,Hai Phong City,An Duong,21,4,0,4,4
2022-06-19,Hai Phong City,Do Son District,11,1,0,1,1
2022-06-19,Hai Phong City,Duong Kinh District,10,1,0,1,1
2022-06-19,Hai Phong City,Duong Kinh District,11,1,0,1,1
2022-06-19,Hai Phong City,Duong Kinh District,17,2,0,2,1
2022-06-19,Hai Phong City,Hai An District,7,9,1,8,6
2022-06-19,Hai Phong City,Hai An District,8,26,14,12,3
2022-06-19,Hai Phong City,Hai An District,9,19,14,5,2
2022-06-19,Hai Phong City,Hai An District,10,52,40,12,5
2022-06-19,Hai Phong City,Hai An District,11,58,44,14,10
2022-06-19,Hai Phong City,Hai An District,12,65,39,26,15
2022-06-19,Hai Phong City,Hai An District,13,24,18,6,1
2022-06-19,Hai Phong City,Hai An District,14,23,19,4,4
2022-06-19,Hai Phong City,Hai An District,15,28,17,11,9
2022-06-19,Hai Phong City,Hai An District,16,13,12,1,0
2022-06-19,Hai Phong City,Hai An District,17,33,20,13,6
2022-06-19,Hai Phong City,Hai An District,18,24,18,6,1
2022-06-19,Hai Phong City,Hai An District,19,32,22,10,6
2022-06-19,Hai Phong City,Hai An District,20,32,19,13,5
2022-06-19,Hai Phong City,Hai An District,21,11,7,4,2
2022-06-19,Hai Phong City,Hong Bang District,0,1,0,1,1
2022-06-19,Hai Phong City,Hong Bang District,1,1,0,1,0
2022-06-19,Hai Phong City,Hong Bang District,6,1,0,1,0
2022-06-19,Hai Phong City,Hong Bang District,7,8,5,3,2
2022-06-19,Hai Phong City,Hong Bang District,8,36,23,13,5
2022-06-19,Hai Phong City,Hong Bang District,9,36,32,4,2
2022-06-19,Hai Phong City,Hong Bang District,10,72,51,21,14
2022-06-19,Hai Phong City,Hong Bang District,11,133,80,53,33
2022-06-19,Hai Phong City,Hong Bang District,12,106,61,45,35
2022-06-19,Hai Phong City,Hong Bang District,13,62,48,14,9
2022-06-19,Hai Phong City,Hong Bang District,14,48,30,18,11
2022-06-19,Hai Phong City,Hong Bang District,15,41,32,9,4
2022-06-19,Hai Phong City,Hong Bang District,16,51,41,10,6
2022-06-19,Hai Phong City,Hong Bang District,17,44,34,10,3
2022-06-19,Hai Phong City,Hong Bang District,18,44,38,6,1
2022-06-19,Hai Phong City,Hong Bang District,19,60,42,18,13
2022-06-19,Hai Phong City,Hong Bang District,20,47,29,18,14
2022-06-19,Hai Phong City,Hong Bang District,21,21,11,10,5
2022-06-19,Hai Phong City,Hong Bang District,22,1,0,1,0
2022-06-19,Hai Phong City,Kien An District,7,4,1,3,2
2022-06-19,Hai Phong City,Kien An District,8,13,2,11,7
2022-06-19,Hai Phong City,Kien An District,9,10,5,5,3
2022-06-19,Hai Phong City,Kien An District,10,20,12,8,6
2022-06-19,Hai Phong City,Kien An District,11,17,8,9,7
2022-06-19,Hai Phong City,Kien An District,12,8,5,3,2
2022-06-19,Hai Phong City,Kien An District,13,11,6,5,2
2022-06-19,Hai Phong City,Kien An District,14,9,6,3,1
2022-06-19,Hai Phong City,Kien An District,15,15,7,8,8
2022-06-19,Hai Phong City,Kien An District,16,20,11,9,5
2022-06-19,Hai Phong City,Kien An District,17,7,5,2,1
2022-06-19,Hai Phong City,Kien An District,18,23,13,10,7
2022-06-19,Hai Phong City,Kien An District,19,16,7,9,6
2022-06-19,Hai Phong City,Kien An District,20,10,8,2,2
2022-06-19,Hai Phong City,Kien An District,21,7,3,4,2
2022-06-19,Hai Phong City,Le Chan District,1,2,1,1,0
2022-06-19,Hai Phong City,Le Chan District,6,3,1,2,0
2022-06-19,Hai Phong City,Le Chan District,7,51,31,20,14
2022-06-19,Hai Phong City,Le Chan District,8,96,74,22,9
2022-06-19,Hai Phong City,Le Chan District,9,142,116,26,10
2022-06-19,Hai Phong City,Le Chan District,10,292,205,87,52
2022-06-19,Hai Phong City,Le Chan District,11,462,289,173,122
2022-06-19,Hai Phong City,Le Chan District,12,358,228,130,93
2022-06-19,Hai Phong City,Le Chan District,13,185,139,46,18
2022-06-19,Hai Phong City,Le Chan District,14,134,105,29,15
2022-06-19,Hai Phong City,Le Chan District,15,228,165,63,38
2022-06-19,Hai Phong City,Le Chan District,16,162,138,24,12
2022-06-19,Hai Phong City,Le Chan District,17,174,135,39,9
2022-06-19,Hai Phong City,Le Chan District,18,234,195,39,20
2022-06-19,Hai Phong City,Le Chan District,19,220,153,67,38
2022-06-19,Hai Phong City,Le Chan District,20,167,114,53,31
2022-06-19,Hai Phong City,Le Chan District,21,73,42,31,18
2022-06-19,Hai Phong City,Ngo Quyen District,0,1,1,0,0
2022-06-19,Hai Phong City,Ngo Quyen District,7,30,20,10,9
2022-06-19,Hai Phong City,Ngo Quyen District,8,84,63,21,13
2022-06-19,Hai Phong City,Ngo Quyen District,9,95,80,15,4
2022-06-19,Hai Phong City,Ngo Quyen District,10,185,148,37,21
2022-06-19,Hai Phong City,Ngo Quyen District,11,340,224,116,76
2022-06-19,Hai Phong City,Ngo Quyen District,12,269,175,94,66
2022-06-19,Hai Phong City,Ngo Quyen District,13,130,109,21,8
2022-06-19,Hai Phong City,Ngo Quyen District,14,154,118,36,21
2022-06-19,Hai Phong City,Ngo Quyen District,15,180,136,44,25
2022-06-19,Hai Phong City,Ngo Quyen District,16,155,128,27,12
2022-06-19,Hai Phong City,Ngo Quyen District,17,151,120,31,10
2022-06-19,Hai Phong City,Ngo Quyen District,18,200,142,58,26
2022-06-19,Hai Phong City,Ngo Quyen District,19,179,135,44,27
2022-06-19,Hai Phong City,Ngo Quyen District,20,135,95,40,26
2022-06-19,Hai Phong City,Ngo Quyen District,21,71,51,20,8
2022-06-19,Hai Phong City,Thuy Nguyen,9,1,0,1,0
2022-06-19,Hai Phong City,Thuy Nguyen,10,1,0,1,0
2022-06-19,Hai Phong City,Thuy Nguyen,11,2,0,2,2
2022-06-19,Hai Phong City,Thuy Nguyen,12,6,1,5,4
2022-06-19,Hai Phong City,Thuy Nguyen,13,3,2,1,1
2022-06-19,Hai Phong City,Thuy Nguyen,15,4,0,4,2
2022-06-19,Hai Phong City,Thuy Nguyen,16,1,0,1,1
2022-06-19,Hai Phong City,Thuy Nguyen,17,1,0,1,1
2022-06-19,Hai Phong City,Thuy Nguyen,18,2,0,2,2
2022-06-19,Hai Phong City,Thuy Nguyen,19,2,0,2,2
2022-06-19,Hai Phong City,Thuy Nguyen,20,1,0,1,1
2022-06-19,Hai Phong City,Thuy Nguyen,21,1,0,1,1
2022-06-19,Hue City,Hue City,0,3,2,1,0
2022-06-19,Hue City,Hue City,1,1,1,0,0
2022-06-19,Hue City,Hue City,2,1,0,1,0
2022-06-19,Hue City,Hue City,3,1,1,0,0
2022-06-19,Hue City,Hue City,4,2,1,1,0
2022-06-19,Hue City,Hue City,5,3,1,2,1
2022-06-19,Hue City,Hue City,6,69,53,16,3
2022-06-19,Hue City,Hue City,7,226,206,20,0
2022-06-19,Hue City,Hue City,8,316,297,19,1
2022-06-19,Hue City,Hue City,9,336,301,35,1
2022-06-19,Hue City,Hue City,10,535,495,40,2
2022-06-19,Hue City,Hue City,11,930,823,107,12
2022-06-19,Hue City,Hue City,12,590,548,42,2
2022-06-19,Hue City,Hue City,13,426,394,32,3
2022-06-19,Hue City,Hue City,14,367,324,43,0
2022-06-19,Hue City,Hue City,15,428,388,40,4
2022-06-19,Hue City,Hue City,16,395,360,35,0
2022-06-19,Hue City,Hue City,17,449,410,39,1
2022-06-19,Hue City,Hue City,18,565,509,56,10
2022-06-19,Hue City,Hue City,19,630,508,122,46
2022-06-19,Hue City,Hue City,20,527,396,131,64
2022-06-19,Hue City,Hue City,21,279,203,76,31
2022-06-19,Hue City,Hue City,22,5,0,5,2
2022-06-19,Hue City,Hue City,23,1,0,1,0
2022-06-19,Hue City,Huong Thuy,8,2,1,1,0
2022-06-19,Hue City,Huong Thuy,10,1,1,0,0
2022-06-19,Hue City,Huong Thuy,11,5,3,2,0
2022-06-19,Hue City,Huong Thuy,12,2,1,1,0
2022-06-19,Hue City,Huong Thuy,17,1,1,0,0
2022-06-19,Hue City,Huong Thuy,18,2,0,2,2
2022-06-19,Hue City,Huong Thuy,19,3,2,1,1
2022-06-19,Hue City,Huong Thuy,21,1,0,1,1
2022-06-19,Hue City,Huong Tra,14,1,0,1,1
2022-06-19,Hue City,Huong Tra,16,1,1,0,0
2022-06-19,Hue City,Huong Tra,20,1,0,1,0
2022-06-19,Hue City,Huong Tra,21,1,1,0,0
2022-06-19,Hue City,Phu Vang,6,1,1,0,0
2022-06-19,Hue City,Phu Vang,7,4,3,1,0
2022-06-19,Hue City,Phu Vang,8,1,1,0,0
2022-06-19,Hue City,Phu Vang,10,3,2,1,1
2022-06-19,Hue City,Phu Vang,11,3,2,1,1
2022-06-19,Hue City,Phu Vang,12,2,2,0,0
2022-06-19,Hue City,Phu Vang,14,6,4,2,2
2022-06-19,Hue City,Phu Vang,15,2,2,0,0
2022-06-19,Hue City,Phu Vang,16,1,0,1,1
2022-06-19,Hue City,Phu Vang,17,2,2,0,0
2022-06-19,Hue City,Phu Vang,18,1,1,0,0
2022-06-19,Hue City,Phu Vang,19,1,1,0,0
2022-06-19,Hue City,Phu Vang,20,3,3,0,0
2022-06-19,Hue City,Phu Vang,21,1,0,1,1
2022-06-19,Khanh Hoa,Dien Khanh,14,1,0,1,1
2022-06-19,Khanh Hoa,Dien Khanh,17,1,0,1,1
2022-06-19,Khanh Hoa,Dien Khanh,19,1,0,1,1
2022-06-19,Khanh Hoa,Nha Trang City,0,1,1,0,0
2022-06-19,Khanh Hoa,Nha Trang City,1,1,1,0,0
2022-06-19,Khanh Hoa,Nha Trang City,5,1,1,0,0
2022-06-19,Khanh Hoa,Nha Trang City,6,44,31,13,1
2022-06-19,Khanh Hoa,Nha Trang City,7,153,142,11,4
2022-06-19,Khanh Hoa,Nha Trang City,8,209,193,16,3
2022-06-19,Khanh Hoa,Nha Trang City,9,208,192,16,0
2022-06-19,Khanh Hoa,Nha Trang City,10,265,246,19,2
2022-06-19,Khanh Hoa,Nha Trang City,11,363,333,30,6
2022-06-19,Khanh Hoa,Nha Trang City,12,339,310,29,6
2022-06-19,Khanh Hoa,Nha Trang City,13,271,251,20,3
2022-06-19,Khanh Hoa,Nha Trang City,14,294,262,32,6
2022-06-19,Khanh Hoa,Nha Trang City,15,246,225,21,5
2022-06-19,Khanh Hoa,Nha Trang City,16,220,205,15,1
2022-06-19,Khanh Hoa,Nha Trang City,17,272,245,27,1
2022-06-19,Khanh Hoa,Nha Trang City,18,355,259,96,60
2022-06-19,Khanh Hoa,Nha Trang City,19,394,198,196,146
2022-06-19,Khanh Hoa,Nha Trang City,20,276,153,123,85
2022-06-19,Khanh Hoa,Nha Trang City,21,111,75,36,16
2022-06-19,Khanh Hoa,Nha Trang City,22,4,0,4,1
2022-06-19,Khanh Hoa,Nha Trang City,23,5,2,3,0
2022-06-19,Lam Dong,Da Lat City,5,1,0,1,1
2022-06-19,Lam Dong,Da Lat City,6,4,1,3,3
2022-06-19,Lam Dong,Da Lat City,7,74,27,47,39
2022-06-19,Lam Dong,Da Lat City,8,112,54,58,46
2022-06-19,Lam Dong,Da Lat City,9,117,61,56,45
2022-06-19,Lam Dong,Da Lat City,10,142,82,60,40
2022-06-19,Lam Dong,Da Lat City,11,182,96,86,72
2022-06-19,Lam Dong,Da Lat City,12,223,88,135,115
2022-06-19,Lam Dong,Da Lat City,13,193,64,129,112
2022-06-19,Lam Dong,Da Lat City,14,174,86,88,72
2022-06-19,Lam Dong,Da Lat City,15,109,86,23,17
2022-06-19,Lam Dong,Da Lat City,16,128,76,52,32
2022-06-19,Lam Dong,Da Lat City,17,97,67,30,18
2022-06-19,Lam Dong,Da Lat City,18,163,93,70,51
2022-06-19,Lam Dong,Da Lat City,19,175,75,100,71
2022-06-19,Lam Dong,Da Lat City,20,154,50,104,91
2022-06-19,Lam Dong,Da Lat City,21,85,26,59,47
2022-06-19,Lam Dong,Da Lat City,22,1,0,1,0
2022-06-19,Lam Dong,Da Lat City,23,1,0,1,0
2022-06-19,Nghe An,Vinh City,5,2,0,2,0
2022-06-19,Nghe An,Vinh City,6,6,5,1,1
2022-06-19,Nghe An,Vinh City,7,125,94,31,7
2022-06-19,Nghe An,Vinh City,8,164,142,22,0
2022-06-19,Nghe An,Vinh City,9,191,160,31,3
2022-06-19,Nghe An,Vinh City,10,323,234,89,49
2022-06-19,Nghe An,Vinh City,11,456,330,126,76
2022-06-19,Nghe An,Vinh City,12,307,236,71,35
2022-06-19,Nghe An,Vinh City,13,154,121,33,11
2022-06-19,Nghe An,Vinh City,14,187,161,26,5
2022-06-19,Nghe An,Vinh City,15,193,155,38,7
2022-06-19,Nghe An,Vinh City,16,174,140,34,12
2022-06-19,Nghe An,Vinh City,17,159,142,17,3
2022-06-19,Nghe An,Vinh City,18,198,156,42,20
2022-06-19,Nghe An,Vinh City,19,199,145,54,25
2022-06-19,Nghe An,Vinh City,20,152,108,44,10
2022-06-19,Nghe An,Vinh City,21,121,70,51,33
2022-06-19,Nghe An,Vinh City,22,4,1,3,0
2022-06-19,Nghe An,Vinh City,23,2,1,1,0
2022-06-19,Quang Nam,Hoi An City,6,3,1,2,1
2022-06-19,Quang Nam,Hoi An City,7,32,12,20,20
2022-06-19,Quang Nam,Hoi An City,8,45,26,19,11
2022-06-19,Quang Nam,Hoi An City,9,48,39,9,3
2022-06-19,Quang Nam,Hoi An City,10,62,46,16,3
2022-06-19,Quang Nam,Hoi An City,11,74,54,20,9
2022-06-19,Quang Nam,Hoi An City,12,55,38,17,5
2022-06-19,Quang Nam,Hoi An City,13,38,37,1,0
2022-06-19,Quang Nam,Hoi An City,14,44,38,6,0
2022-06-19,Quang Nam,Hoi An City,15,62,47,15,10
2022-06-19,Quang Nam,Hoi An City,16,68,38,30,21
2022-06-19,Quang Nam,Hoi An City,17,62,38,24,18
2022-06-19,Quang Nam,Hoi An City,18,45,30,15,5
2022-06-19,Quang Nam,Hoi An City,19,73,27,46,31
2022-06-19,Quang Nam,Hoi An City,20,63,22,41,37
2022-06-19,Quang Nam,Hoi An City,21,51,13,38,28
2022-06-19,Quang Nam,Tam Ky City,15,2,0,2,1
2022-06-19,Quang Ninh,Cam Pha City,11,1,0,1,1
2022-06-19,Quang Ninh,Cam Pha City,12,1,0,1,1
2022-06-19,Quang Ninh,Cam Pha City,16,1,0,1,1
2022-06-19,Quang Ninh,Cam Pha City,17,2,0,2,2
2022-06-19,Quang Ninh,Ha Long City,6,5,2,3,0
2022-06-19,Quang Ninh,Ha Long City,7,21,13,8,4
2022-06-19,Quang Ninh,Ha Long City,8,54,34,20,11
2022-06-19,Quang Ninh,Ha Long City,9,80,52,28,19
2022-06-19,Quang Ninh,Ha Long City,10,111,89,22,12
2022-06-19,Quang Ninh,Ha Long City,11,172,107,65,38
2022-06-19,Quang Ninh,Ha Long City,12,159,85,74,50
2022-06-19,Quang Ninh,Ha Long City,13,106,65,41,24
2022-06-19,Quang Ninh,Ha Long City,14,62,42,20,12
2022-06-19,Quang Ninh,Ha Long City,15,65,46,19,11
2022-06-19,Quang Ninh,Ha Long City,16,50,36,14,7
2022-06-19,Quang Ninh,Ha Long City,17,47,34,13,6
2022-06-19,Quang Ninh,Ha Long City,18,54,41,13,4
2022-06-19,Quang Ninh,Ha Long City,19,73,51,22,8
2022-06-19,Quang Ninh,Ha Long City,20,65,38,27,21
2022-06-19,Quang Ninh,Ha Long City,21,2,0,2,0
2022-06-19,Quang Ninh,Uong Bi City,13,2,0,2,2
2022-06-19,Thai Nguyen,Dong Hy,8,2,0,2,2
2022-06-19,Thai Nguyen,Dong Hy,9,2,0,2,2
2022-06-19,Thai Nguyen,Dong Hy,14,1,0,1,0
2022-06-19,Thai Nguyen,Dong Hy,17,3,0,3,0
2022-06-19,Thai Nguyen,Dong Hy,18,1,1,0,0
2022-06-19,Thai Nguyen,Dong Hy,19,1,0,1,0
2022-06-19,Thai Nguyen,Thai Nguyen City,3,1,1,0,0
2022-06-19,Thai Nguyen,Thai Nguyen City,4,1,0,1,0
2022-06-19,Thai Nguyen,Thai Nguyen City,5,1,1,0,0
2022-06-19,Thai Nguyen,Thai Nguyen City,6,7,5,2,0
2022-06-19,Thai Nguyen,Thai Nguyen City,7,104,90,14,2
2022-06-19,Thai Nguyen,Thai Nguyen City,8,162,128,34,16
2022-06-19,Thai Nguyen,Thai Nguyen City,9,172,158,14,4
2022-06-19,Thai Nguyen,Thai Nguyen City,10,253,221,32,10
2022-06-19,Thai Nguyen,Thai Nguyen City,11,513,361,152,107
2022-06-19,Thai Nguyen,Thai Nguyen City,12,454,276,178,128
2022-06-19,Thai Nguyen,Thai Nguyen City,13,227,187,40,13
2022-06-19,Thai Nguyen,Thai Nguyen City,14,198,170,28,6
2022-06-19,Thai Nguyen,Thai Nguyen City,15,233,158,75,50
2022-06-19,Thai Nguyen,Thai Nguyen City,16,191,170,21,4
2022-06-19,Thai Nguyen,Thai Nguyen City,17,173,150,23,2
2022-06-19,Thai Nguyen,Thai Nguyen City,18,247,228,19,2
2022-06-19,Thai Nguyen,Thai Nguyen City,19,329,257,72,37
2022-06-19,Thai Nguyen,Thai Nguyen City,20,269,186,83,49
2022-06-19,Thai Nguyen,Thai Nguyen City,21,175,133,42,20
2022-06-19,Thai Nguyen,Thai Nguyen City,22,3,2,1,0
2022-06-19,Thai Nguyen,Thai Nguyen City,23,1,1,0,0
2022-06-19,Vung Tau,Ba Ria City,7,1,1,0,0
2022-06-19,Vung Tau,Ba Ria City,8,3,2,1,1
2022-06-19,Vung Tau,Ba Ria City,9,4,4,0,0
2022-06-19,Vung Tau,Ba Ria City,10,4,4,0,0
2022-06-19,Vung Tau,Ba Ria City,11,6,5,1,1
2022-06-19,Vung Tau,Ba Ria City,12,11,6,5,3
2022-06-19,Vung Tau,Ba Ria City,13,4,1,3,2
2022-06-19,Vung Tau,Ba Ria City,14,6,4,2,1
2022-06-19,Vung Tau,Ba Ria City,15,3,2,1,0
2022-06-19,Vung Tau,Ba Ria City,16,4,3,1,0
2022-06-19,Vung Tau,Ba Ria City,17,3,0,3,3
2022-06-19,Vung Tau,Ba Ria City,18,3,2,1,1
2022-06-19,Vung Tau,Ba Ria City,19,6,1,5,5
2022-06-19,Vung Tau,Ba Ria City,20,5,0,5,5
2022-06-19,Vung Tau,Ba Ria City,21,1,0,1,1
2022-06-19,Vung Tau,Long Dien,8,1,0,1,1
2022-06-19,Vung Tau,Tan Thanh,19,1,0,1,1
2022-06-19,Vung Tau,Vung Tau City,1,3,2,1,0
2022-06-19,Vung Tau,Vung Tau City,5,3,2,1,1
2022-06-19,Vung Tau,Vung Tau City,6,87,53,34,24
2022-06-19,Vung Tau,Vung Tau City,7,140,112,28,14
2022-06-19,Vung Tau,Vung Tau City,8,229,205,24,4
2022-06-19,Vung Tau,Vung Tau City,9,255,217,38,12
2022-06-19,Vung Tau,Vung Tau City,10,374,332,42,10
2022-06-19,Vung Tau,Vung Tau City,11,479,439,40,15
2022-06-19,Vung Tau,Vung Tau City,12,384,350,34,4
2022-06-19,Vung Tau,Vung Tau City,13,257,237,20,3
2022-06-19,Vung Tau,Vung Tau City,14,287,268,19,3
2022-06-19,Vung Tau,Vung Tau City,15,262,245,17,1
2022-06-19,Vung Tau,Vung Tau City,16,249,230,19,1
2022-06-19,Vung Tau,Vung Tau City,17,318,288,30,9
2022-06-19,Vung Tau,Vung Tau City,18,348,280,68,34
2022-06-19,Vung Tau,Vung Tau City,19,440,269,171,115
2022-06-19,Vung Tau,Vung Tau City,20,262,187,75,39
2022-06-19,Vung Tau,Vung Tau City,21,127,89,38,20
2022-06-19,Vung Tau,Vung Tau City,22,2,0,2,1
2022-06-20,Bac Ninh,Bác Ninh City,0,1,1,0,0
2022-06-20,Bac Ninh,Bác Ninh City,2,1,0,1,0
2022-06-20,Bac Ninh,Bác Ninh City,6,5,5,0,0
2022-06-20,Bac Ninh,Bác Ninh City,7,83,66,17,6
2022-06-20,Bac Ninh,Bác Ninh City,8,181,140,41,25
2022-06-20,Bac Ninh,Bác Ninh City,9,136,116,20,3
2022-06-20,Bac Ninh,Bác Ninh City,10,203,165,38,7
2022-06-20,Bac Ninh,Bác Ninh City,11,416,339,77,27
2022-06-20,Bac Ninh,Bác Ninh City,12,271,241,30,5
2022-06-20,Bac Ninh,Bác Ninh City,13,180,158,22,9
2022-06-20,Bac Ninh,Bác Ninh City,14,190,149,41,18
2022-06-20,Bac Ninh,Bác Ninh City,15,144,112,32,14
2022-06-20,Bac Ninh,Bác Ninh City,16,82,74,8,0
2022-06-20,Bac Ninh,Bác Ninh City,17,109,105,4,0
2022-06-20,Bac Ninh,Bác Ninh City,18,147,127,20,0
2022-06-20,Bac Ninh,Bác Ninh City,19,153,134,19,1
2022-06-20,Bac Ninh,Bác Ninh City,20,182,124,58,30
2022-06-20,Bac Ninh,Bác Ninh City,21,111,47,64,54
2022-06-20,Bac Ninh,Que Vo,8,1,0,1,1
2022-06-20,Bac Ninh,Que Vo,9,1,0,1,1
2022-06-20,Bac Ninh,Que Vo,10,2,0,2,0
2022-06-20,Bac Ninh,Que Vo,11,3,1,2,1
2022-06-20,Bac Ninh,Que Vo,13,3,0,3,3
2022-06-20,Bac Ninh,Que Vo,14,3,0,3,3
2022-06-20,Bac Ninh,Que Vo,15,1,1,0,0
2022-06-20,Bac Ninh,Que Vo,18,1,0,1,1
2022-06-20,Bac Ninh,Tien Du,12,2,0,2,2
2022-06-20,Bac Ninh,Tien Du,13,2,0,2,1
2022-06-20,Bac Ninh,Tien Du,16,2,0,2,2
2022-06-20,Bac Ninh,Tien Du,17,1,0,1,1
2022-06-20,Bac Ninh,Tien Du,18,1,0,1,1
2022-06-20,Bac Ninh,Tien Du,20,1,0,1,1
2022-06-20,Bac Ninh,Tien Du,21,1,0,1,0
2022-06-20,Bac Ninh,Tu Son,10,2,0,2,2
2022-06-20,Bac Ninh,Tu Son,11,2,0,2,2
2022-06-20,Bac Ninh,Tu Son,12,3,0,3,3
2022-06-20,Bac Ninh,Tu Son,13,2,0,2,1
2022-06-20,Bac Ninh,Tu Son,18,1,0,1,1
2022-06-20,Bac Ninh,Tu Son,19,1,0,1,1
2022-06-20,Binh Duong,Ben Cat,9,1,0,1,0
2022-06-20,Binh Duong,Ben Cat,11,5,0,5,5
2022-06-20,Binh Duong,Ben Cat,12,2,0,2,2
2022-06-20,Binh Duong,Ben Cat,13,1,0,1,1
2022-06-20,Binh Duong,Ben Cat,14,3,0,3,3
2022-06-20,Binh Duong,Ben Cat,18,1,0,1,1
2022-06-20,Binh Duong,Ben Cat,19,7,0,7,5
2022-06-20,Binh Duong,Di An,4,1,1,0,0
2022-06-20,Binh Duong,Di An,6,2,0,2,2
2022-06-20,Binh Duong,Di An,7,6,2,4,3
2022-06-20,Binh Duong,Di An,8,17,9,8,5
2022-06-20,Binh Duong,Di An,9,29,20,9,7
2022-06-20,Binh Duong,Di An,10,30,22,8,2
2022-06-20,Binh Duong,Di An,11,28,25,3,3
2022-06-20,Binh Duong,Di An,12,35,29,6,5
2022-06-20,Binh Duong,Di An,13,43,30,13,3
2022-06-20,Binh Duong,Di An,14,29,24,5,3
2022-06-20,Binh Duong,Di An,15,23,20,3,3
2022-06-20,Binh Duong,Di An,16,33,21,12,9
2022-06-20,Binh Duong,Di An,17,31,21,10,5
2022-06-20,Binh Duong,Di An,18,31,22,9,6
2022-06-20,Binh Duong,Di An,19,40,19,21,13
2022-06-20,Binh Duong,Di An,20,38,12,26,15
2022-06-20,Binh Duong,Di An,21,29,10,19,12
2022-06-20,Binh Duong,Di An,22,1,0,1,0
2022-06-20,Binh Duong,Tan Uyen,9,3,0,3,2
2022-06-20,Binh Duong,Tan Uyen,10,3,1,2,1
2022-06-20,Binh Duong,Tan Uyen,11,6,0,6,5
2022-06-20,Binh Duong,Tan Uyen,12,1,0,1,1
2022-06-20,Binh Duong,Tan Uyen,13,5,2,3,3
2022-06-20,Binh Duong,Tan Uyen,14,9,3,6,5
2022-06-20,Binh Duong,Tan Uyen,15,4,0,4,3
2022-06-20,Binh Duong,Tan Uyen,16,2,0,2,2
2022-06-20,Binh Duong,Tan Uyen,17,1,1,0,0
2022-06-20,Binh Duong,Tan Uyen,18,5,1,4,4
2022-06-20,Binh Duong,Tan Uyen,19,1,0,1,1
2022-06-20,Binh Duong,Tan Uyen,20,1,0,1,1
2022-06-20,Binh Duong,Tan Uyen,21,1,0,1,1
2022-06-20,Binh Duong,Thu Dau Mot Town,2,1,1,0,0
2022-06-20,Binh Duong,Thu Dau Mot Town,3,1,1,0,0
2022-06-20,Binh Duong,Thu Dau Mot Town,4,1,1,0,0
2022-06-20,Binh Duong,Thu Dau Mot Town,6,36,30,6,1
2022-06-20,Binh Duong,Thu Dau Mot Town,7,117,102,15,2
2022-06-20,Binh Duong,Thu Dau Mot Town,8,224,210,14,4
2022-06-20,Binh Duong,Thu Dau Mot Town,9,257,234,23,2
2022-06-20,Binh Duong,Thu Dau Mot Town,10,429,401,28,7
2022-06-20,Binh Duong,Thu Dau Mot Town,11,713,647,66,30
2022-06-20,Binh Duong,Thu Dau Mot Town,12,528,491,37,8
2022-06-20,Binh Duong,Thu Dau Mot Town,13,516,477,39,16
2022-06-20,Binh Duong,Thu Dau Mot Town,14,385,344,41,10
2022-06-20,Binh Duong,Thu Dau Mot Town,15,309,288,21,6
2022-06-20,Binh Duong,Thu Dau Mot Town,16,306,274,32,11
2022-06-20,Binh Duong,Thu Dau Mot Town,17,374,342,32,2
2022-06-20,Binh Duong,Thu Dau Mot Town,18,497,437,60,7
2022-06-20,Binh Duong,Thu Dau Mot Town,19,409,334,75,17
2022-06-20,Binh Duong,Thu Dau Mot Town,20,370,280,90,18
2022-06-20,Binh Duong,Thu Dau Mot Town,21,192,135,57,20
2022-06-20,Binh Duong,Thu Dau Mot Town,22,3,0,3,1
2022-06-20,Binh Duong,Thuan An,6,2,1,1,0
2022-06-20,Binh Duong,Thuan An,7,9,7,2,1
2022-06-20,Binh Duong,Thuan An,8,34,17,17,14
2022-06-20,Binh Duong,Thuan An,9,30,24,6,2
2022-06-20,Binh Duong,Thuan An,10,61,51,10,0
2022-06-20,Binh Duong,Thuan An,11,103,83,20,9
2022-06-20,Binh Duong,Thuan An,12,79,64,15,6
2022-06-20,Binh Duong,Thuan An,13,64,49,15,6
2022-06-20,Binh Duong,Thuan An,14,64,56,8,6
2022-06-20,Binh Duong,Thuan An,15,56,33,23,15
2022-06-20,Binh Duong,Thuan An,16,45,29,16,12
2022-06-20,Binh Duong,Thuan An,17,39,35,4,1
2022-06-20,Binh Duong,Thuan An,18,44,34,10,3
2022-06-20,Binh Duong,Thuan An,19,56,38,18,7
2022-06-20,Binh Duong,Thuan An,20,48,22,26,14
2022-06-20,Binh Duong,Thuan An,21,34,12,22,16
2022-06-20,Can Tho City,Binh Thuy District,5,1,1,0,0
2022-06-20,Can Tho City,Binh Thuy District,8,1,1,0,0
2022-06-20,Can Tho City,Binh Thuy District,9,5,5,0,0
2022-06-20,Can Tho City,Binh Thuy District,10,8,8,0,0
2022-06-20,Can Tho City,Binh Thuy District,11,13,12,1,0
2022-06-20,Can Tho City,Binh Thuy District,12,18,18,0,0
2022-06-20,Can Tho City,Binh Thuy District,13,14,14,0,0
2022-06-20,Can Tho City,Binh Thuy District,14,14,13,1,0
2022-06-20,Can Tho City,Binh Thuy District,15,8,7,1,1
2022-06-20,Can Tho City,Binh Thuy District,16,19,18,1,0
2022-06-20,Can Tho City,Binh Thuy District,17,9,9,0,0
2022-06-20,Can Tho City,Binh Thuy District,18,10,9,1,0
2022-06-20,Can Tho City,Binh Thuy District,19,10,8,2,0
2022-06-20,Can Tho City,Binh Thuy District,20,12,11,1,0
2022-06-20,Can Tho City,Binh Thuy District,21,3,2,1,0
2022-06-20,Can Tho City,Cai Rang District,5,1,0,1,1
2022-06-20,Can Tho City,Cai Rang District,6,2,2,0,0
2022-06-20,Can Tho City,Cai Rang District,7,4,4,0,0
2022-06-20,Can Tho City,Cai Rang District,8,9,8,1,0
2022-06-20,Can Tho City,Cai Rang District,9,9,7,2,1
2022-06-20,Can Tho City,Cai Rang District,10,16,16,0,0
2022-06-20,Can Tho City,Cai Rang District,11,12,11,1,1
2022-06-20,Can Tho City,Cai Rang District,12,16,15,1,0
2022-06-20,Can Tho City,Cai Rang District,13,13,11,2,1
2022-06-20,Can Tho City,Cai Rang District,14,8,8,0,0
2022-06-20,Can Tho City,Cai Rang District,15,8,7,1,0
2022-06-20,Can Tho City,Cai Rang District,16,12,10,2,0
2022-06-20,Can Tho City,Cai Rang District,17,14,12,2,0
2022-06-20,Can Tho City,Cai Rang District,18,13,12,1,0
2022-06-20,Can Tho City,Cai Rang District,19,11,11,0,0
2022-06-20,Can Tho City,Cai Rang District,20,11,8,3,0
2022-06-20,Can Tho City,Cai Rang District,21,5,4,1,0
2022-06-20,Can Tho City,Ninh Kieu District,0,2,2,0,0
2022-06-20,Can Tho City,Ninh Kieu District,3,3,3,0,0
2022-06-20,Can Tho City,Ninh Kieu District,5,6,4,2,1
2022-06-20,Can Tho City,Ninh Kieu District,6,53,48,5,3
2022-06-20,Can Tho City,Ninh Kieu District,7,125,119,6,0
2022-06-20,Can Tho City,Ninh Kieu District,8,238,226,12,0
2022-06-20,Can Tho City,Ninh Kieu District,9,278,266,12,0
2022-06-20,Can Tho City,Ninh Kieu District,10,491,474,17,0
2022-06-20,Can Tho City,Ninh Kieu District,11,843,797,46,6
2022-06-20,Can Tho City,Ninh Kieu District,12,568,552,16,0
2022-06-20,Can Tho City,Ninh Kieu District,13,510,487,23,0
2022-06-20,Can Tho City,Ninh Kieu District,14,359,337,22,0
2022-06-20,Can Tho City,Ninh Kieu District,15,344,330,14,0
2022-06-20,Can Tho City,Ninh Kieu District,16,501,475,26,0
2022-06-20,Can Tho City,Ninh Kieu District,17,570,543,27,0
2022-06-20,Can Tho City,Ninh Kieu District,18,512,447,65,0
2022-06-20,Can Tho City,Ninh Kieu District,19,558,467,91,2
2022-06-20,Can Tho City,Ninh Kieu District,20,428,358,70,1
2022-06-20,Can Tho City,Ninh Kieu District,21,255,216,39,0
2022-06-20,Can Tho City,Ninh Kieu District,22,2,0,2,0
2022-06-20,Can Tho City,O Mon District,13,1,0,1,1
2022-06-20,Can Tho City,Phong Dien,13,1,0,1,0
2022-06-20,Dong Nai,Bien Hoa City,2,1,1,0,0
2022-06-20,Dong Nai,Bien Hoa City,5,1,1,0,0
2022-06-20,Dong Nai,Bien Hoa City,6,39,24,15,7
2022-06-20,Dong Nai,Bien Hoa City,7,180,149,31,11
2022-06-20,Dong Nai,Bien Hoa City,8,322,280,42,10
2022-06-20,Dong Nai,Bien Hoa City,9,469,410,59,10
2022-06-20,Dong Nai,Bien Hoa City,10,771,689,82,10
2022-06-20,Dong Nai,Bien Hoa City,11,1202,1074,128,38
2022-06-20,Dong Nai,Bien Hoa City,12,987,913,74,14
2022-06-20,Dong Nai,Bien Hoa City,13,867,786,81,19
2022-06-20,Dong Nai,Bien Hoa City,14,784,699,85,23
2022-06-20,Dong Nai,Bien Hoa City,15,551,467,84,16
2022-06-20,Dong Nai,Bien Hoa City,16,483,432,51,12
2022-06-20,Dong Nai,Bien Hoa City,17,623,554,69,27
2022-06-20,Dong Nai,Bien Hoa City,18,863,676,187,57
2022-06-20,Dong Nai,Bien Hoa City,19,912,651,261,125
2022-06-20,Dong Nai,Bien Hoa City,20,718,460,258,137
2022-06-20,Dong Nai,Bien Hoa City,21,324,186,138,65
2022-06-20,Dong Nai,Bien Hoa City,22,1,0,1,0
2022-06-20,Dong Nai,Long Khanh,11,1,0,1,1
2022-06-20,Dong Nai,Long Khanh,15,3,0,3,3
2022-06-20,Dong Nai,Long Khanh,17,1,0,1,1
2022-06-20,Dong Nai,Long Thanh,11,1,0,1,0
2022-06-20,Dong Nai,Long Thanh,12,3,0,3,3
2022-06-20,Dong Nai,Long Thanh,15,1,0,1,1
2022-06-20,Dong Nai,Long Thanh,16,1,0,1,1
2022-06-20,Dong Nai,Long Thanh,17,1,0,1,1
2022-06-20,Dong Nai,Long Thanh,21,1,0,1,1
2022-06-20,Dong Nai,Nhon trach,9,1,0,1,1
2022-06-20,Dong Nai,Nhon trach,19,1,0,1,1
2022-06-20,Dong Nai,Nhon trach,20,1,0,1,1
2022-06-20,Dong Nai,Trang Bom,9,2,0,2,0
2022-06-20,Dong Nai,Trang Bom,10,4,0,4,3
2022-06-20,Dong Nai,Trang Bom,21,2,0,2,2
2022-06-20,Hai Phong City,An Duong,7,1,0,1,1
2022-06-20,Hai Phong City,An Duong,8,3,1,2,1
2022-06-20,Hai Phong City,An Duong,9,4,2,2,1
2022-06-20,Hai Phong City,An Duong,10,9,5,4,4
2022-06-20,Hai Phong City,An Duong,11,8,4,4,4
2022-06-20,Hai Phong City,An Duong,12,4,3,1,0
2022-06-20,Hai Phong City,An Duong,13,5,4,1,1
2022-06-20,Hai Phong City,An Duong,14,3,2,1,1
2022-06-20,Hai Phong City,An Duong,15,5,3,2,1
2022-06-20,Hai Phong City,An Duong,16,2,1,1,1
2022-06-20,Hai Phong City,An Duong,17,1,1,0,0
2022-06-20,Hai Phong City,An Duong,18,5,5,0,0
2022-06-20,Hai Phong City,An Duong,19,3,3,0,0
2022-06-20,Hai Phong City,An Duong,20,1,0,1,1
2022-06-20,Hai Phong City,An Duong,21,2,0,2,2
2022-06-20,Hai Phong City,Do Son District,14,1,0,1,1
2022-06-20,Hai Phong City,Do Son District,15,1,0,1,1
2022-06-20,Hai Phong City,Do Son District,16,1,0,1,1
2022-06-20,Hai Phong City,Do Son District,17,1,0,1,1
2022-06-20,Hai Phong City,Duong Kinh District,15,1,0,1,1
2022-06-20,Hai Phong City,Hai An District,6,1,0,1,1
2022-06-20,Hai Phong City,Hai An District,7,9,6,3,1
2022-06-20,Hai Phong City,Hai An District,8,20,13,7,4
2022-06-20,Hai Phong City,Hai An District,9,15,11,4,2
2022-06-20,Hai Phong City,Hai An District,10,33,25,8,3
2022-06-20,Hai Phong City,Hai An District,11,49,37,12,7
2022-06-20,Hai Phong City,Hai An District,12,25,23,2,0
2022-06-20,Hai Phong City,Hai An District,13,15,10,5,1
2022-06-20,Hai Phong City,Hai An District,14,23,17,6,2
2022-06-20,Hai Phong City,Hai An District,15,18,13,5,1
2022-06-20,Hai Phong City,Hai An District,16,8,7,1,0
2022-06-20,Hai Phong City,Hai An District,17,20,18,2,1
2022-06-20,Hai Phong City,Hai An District,18,22,18,4,0
2022-06-20,Hai Phong City,Hai An District,19,27,17,10,0
2022-06-20,Hai Phong City,Hai An District,20,19,18,1,0
2022-06-20,Hai Phong City,Hai An District,21,11,9,2,1
2022-06-20,Hai Phong City,Hong Bang District,7,19,12,7,7
2022-06-20,Hai Phong City,Hong Bang District,8,31,27,4,0
2022-06-20,Hai Phong City,Hong Bang District,9,35,30,5,1
2022-06-20,Hai Phong City,Hong Bang District,10,67,50,17,3
2022-06-20,Hai Phong City,Hong Bang District,11,119,90,29,21
2022-06-20,Hai Phong City,Hong Bang District,12,70,52,18,5
2022-06-20,Hai Phong City,Hong Bang District,13,52,45,7,3
2022-06-20,Hai Phong City,Hong Bang District,14,46,42,4,1
2022-06-20,Hai Phong City,Hong Bang District,15,59,47,12,2
2022-06-20,Hai Phong City,Hong Bang District,16,35,31,4,1
2022-06-20,Hai Phong City,Hong Bang District,17,36,32,4,1
2022-06-20,Hai Phong City,Hong Bang District,18,55,42,13,1
2022-06-20,Hai Phong City,Hong Bang District,19,56,44,12,0
2022-06-20,Hai Phong City,Hong Bang District,20,36,29,7,3
2022-06-20,Hai Phong City,Hong Bang District,21,13,9,4,0
2022-06-20,Hai Phong City,Kien An District,7,3,2,1,0
2022-06-20,Hai Phong City,Kien An District,8,1,1,0,0
2022-06-20,Hai Phong City,Kien An District,9,5,5,0,0
2022-06-20,Hai Phong City,Kien An District,10,14,11,3,1
2022-06-20,Hai Phong City,Kien An District,11,10,9,1,0
2022-06-20,Hai Phong City,Kien An District,12,15,12,3,2
2022-06-20,Hai Phong City,Kien An District,13,4,3,1,0
2022-06-20,Hai Phong City,Kien An District,14,9,5,4,3
2022-06-20,Hai Phong City,Kien An District,15,12,6,6,5
2022-06-20,Hai Phong City,Kien An District,16,9,7,2,2
2022-06-20,Hai Phong City,Kien An District,17,9,5,4,3
2022-06-20,Hai Phong City,Kien An District,18,10,7,3,0
2022-06-20,Hai Phong City,Kien An District,19,10,8,2,1
2022-06-20,Hai Phong City,Kien An District,20,12,5,7,5
2022-06-20,Hai Phong City,Kien An District,21,7,0,7,4
2022-06-20,Hai Phong City,Le Chan District,4,2,1,1,1
2022-06-20,Hai Phong City,Le Chan District,6,3,1,2,1
2022-06-20,Hai Phong City,Le Chan District,7,34,29,5,2
2022-06-20,Hai Phong City,Le Chan District,8,91,76,15,1
2022-06-20,Hai Phong City,Le Chan District,9,88,79,9,1
2022-06-20,Hai Phong City,Le Chan District,10,189,165,24,7
2022-06-20,Hai Phong City,Le Chan District,11,410,299,111,71
2022-06-20,Hai Phong City,Le Chan District,12,252,206,46,20
2022-06-20,Hai Phong City,Le Chan District,13,128,112,16,4
2022-06-20,Hai Phong City,Le Chan District,14,130,118,12,3
2022-06-20,Hai Phong City,Le Chan District,15,151,128,23,12
2022-06-20,Hai Phong City,Le Chan District,16,130,113,17,3
2022-06-20,Hai Phong City,Le Chan District,17,138,119,19,1
2022-06-20,Hai Phong City,Le Chan District,18,197,156,41,4
2022-06-20,Hai Phong City,Le Chan District,19,166,138,28,1
2022-06-20,Hai Phong City,Le Chan District,20,138,114,24,2
2022-06-20,Hai Phong City,Le Chan District,21,86,65,21,5
2022-06-20,Hai Phong City,Le Chan District,22,2,0,2,0
2022-06-20,Hai Phong City,Ngo Quyen District,0,1,0,1,0
2022-06-20,Hai Phong City,Ngo Quyen District,6,1,0,1,0
2022-06-20,Hai Phong City,Ngo Quyen District,7,22,15,7,5
2022-06-20,Hai Phong City,Ngo Quyen District,8,93,84,9,3
2022-06-20,Hai Phong City,Ngo Quyen District,9,75,69,6,0
2022-06-20,Hai Phong City,Ngo Quyen District,10,156,143,13,5
2022-06-20,Hai Phong City,Ngo Quyen District,11,286,214,72,42
2022-06-20,Hai Phong City,Ngo Quyen District,12,224,184,40,18
2022-06-20,Hai Phong City,Ngo Quyen District,13,134,117,17,8
2022-06-20,Hai Phong City,Ngo Quyen District,14,135,113,22,10
2022-06-20,Hai Phong City,Ngo Quyen District,15,128,117,11,3
2022-06-20,Hai Phong City,Ngo Quyen District,16,114,99,15,4
2022-06-20,Hai Phong City,Ngo Quyen District,17,130,107,23,3
2022-06-20,Hai Phong City,Ngo Quyen District,18,147,119,28,2
2022-06-20,Hai Phong City,Ngo Quyen District,19,143,111,32,4
2022-06-20,Hai Phong City,Ngo Quyen District,20,135,107,28,1
2022-06-20,Hai Phong City,Ngo Quyen District,21,71,47,24,5
2022-06-20,Hai Phong City,Thuy Nguyen,11,2,0,2,2
2022-06-20,Hai Phong City,Thuy Nguyen,12,1,0,1,1
2022-06-20,Hai Phong City,Thuy Nguyen,13,1,0,1,0
2022-06-20,Hai Phong City,Thuy Nguyen,14,3,0,3,2
2022-06-20,Hai Phong City,Thuy Nguyen,17,3,0,3,3
2022-06-20,Hai Phong City,Thuy Nguyen,18,1,0,1,1
2022-06-20,Hai Phong City,Thuy Nguyen,19,1,0,1,1
2022-06-20,Hue City,Hue City,0,2,2,0,0
2022-06-20,Hue City,Hue City,1,2,2,0,0
2022-06-20,Hue City,Hue City,4,1,1,0,0
2022-06-20,Hue City,Hue City,5,2,1,1,0
2022-06-20,Hue City,Hue City,6,64,57,7,3
2022-06-20,Hue City,Hue City,7,218,202,16,1
2022-06-20,Hue City,Hue City,8,308,289,19,1
2022-06-20,Hue City,Hue City,9,304,284,20,0
2022-06-20,Hue City,Hue City,10,446,415,31,0
2022-06-20,Hue City,Hue City,11,945,852,93,17
2022-06-20,Hue City,Hue City,12,648,615,33,1
2022-06-20,Hue City,Hue City,13,388,361,27,0
2022-06-20,Hue City,Hue City,14,425,399,26,0
2022-06-20,Hue City,Hue City,15,413,378,35,1
2022-06-20,Hue City,Hue City,16,370,342,28,1
2022-06-20,Hue City,Hue City,17,393,372,21,0
2022-06-20,Hue City,Hue City,18,519,435,84,0
2022-06-20,Hue City,Hue City,19,638,509,129,2
2022-06-20,Hue City,Hue City,20,476,393,83,6
2022-06-20,Hue City,Hue City,21,374,197,177,89
2022-06-20,Hue City,Hue City,22,9,1,8,2
2022-06-20,Hue City,Huong Thuy,6,1,1,0,0
2022-06-20,Hue City,Huong Thuy,10,3,3,0,0
2022-06-20,Hue City,Huong Thuy,11,1,0,1,0
2022-06-20,Hue City,Huong Thuy,15,1,1,0,0
2022-06-20,Hue City,Huong Thuy,16,1,1,0,0
2022-06-20,Hue City,Huong Thuy,17,1,1,0,0
2022-06-20,Hue City,Huong Thuy,18,3,2,1,0
2022-06-20,Hue City,Huong Thuy,20,2,1,1,1
2022-06-20,Hue City,Huong Thuy,21,1,0,1,1
2022-06-20,Hue City,Huong Tra,13,1,1,0,0
2022-06-20,Hue City,Huong Tra,14,1,1,0,0
2022-06-20,Hue City,Huong Tra,18,1,1,0,0
2022-06-20,Hue City,Phu Vang,7,2,2,0,0
2022-06-20,Hue City,Phu Vang,8,1,1,0,0
2022-06-20,Hue City,Phu Vang,9,2,2,0,0
2022-06-20,Hue City,Phu Vang,10,3,3,0,0
2022-06-20,Hue City,Phu Vang,11,2,0,2,2
2022-06-20,Hue City,Phu Vang,12,2,1,1,1
2022-06-20,Hue City,Phu Vang,13,3,3,0,0
2022-06-20,Hue City,Phu Vang,14,1,1,0,0
2022-06-20,Hue City,Phu Vang,15,3,2,1,0
2022-06-20,Hue City,Phu Vang,16,4,2,2,1
2022-06-20,Hue City,Phu Vang,17,2,1,1,0
2022-06-20,Hue City,Phu Vang,18,3,2,1,0
2022-06-20,Hue City,Phu Vang,19,4,3,1,1
2022-06-20,Hue City,Phu Vang,20,2,1,1,1
2022-06-20,Hue City,Phu Vang,21,2,0,2,2
2022-06-20,Khanh Hoa,Nha Trang City,0,2,2,0,0
2022-06-20,Khanh Hoa,Nha Trang City,2,1,1,0,0
2022-06-20,Khanh Hoa,Nha Trang City,4,1,1,0,0
2022-06-20,Khanh Hoa,Nha Trang City,5,1,1,0,0
2022-06-20,Khanh Hoa,Nha Trang City,6,39,33,6,3
2022-06-20,Khanh Hoa,Nha Trang City,7,154,139,15,3
2022-06-20,Khanh Hoa,Nha Trang City,8,234,212,22,0
2022-06-20,Khanh Hoa,Nha Trang City,9,196,182,14,0
2022-06-20,Khanh Hoa,Nha Trang City,10,267,248,19,4
2022-06-20,Khanh Hoa,Nha Trang City,11,439,380,59,28
2022-06-20,Khanh Hoa,Nha Trang City,12,333,308,25,7
2022-06-20,Khanh Hoa,Nha Trang City,13,279,258,21,2
2022-06-20,Khanh Hoa,Nha Trang City,14,228,217,11,2
2022-06-20,Khanh Hoa,Nha Trang City,15,208,200,8,1
2022-06-20,Khanh Hoa,Nha Trang City,16,186,178,8,0
2022-06-20,Khanh Hoa,Nha Trang City,17,204,184,20,0
2022-06-20,Khanh Hoa,Nha Trang City,18,252,219,33,0
2022-06-20,Khanh Hoa,Nha Trang City,19,240,212,28,1
2022-06-20,Khanh Hoa,Nha Trang City,20,230,179,51,4
2022-06-20,Khanh Hoa,Nha Trang City,21,108,72,36,10
2022-06-20,Khanh Hoa,Nha Trang City,22,3,1,2,0
2022-06-20,Khanh Hoa,Nha Trang City,23,1,1,0,0
2022-06-20,Lam Dong,Da Lat City,0,1,0,1,1
2022-06-20,Lam Dong,Da Lat City,6,5,0,5,2
2022-06-20,Lam Dong,Da Lat City,7,62,38,24,18
2022-06-20,Lam Dong,Da Lat City,8,88,67,21,13
2022-06-20,Lam Dong,Da Lat City,9,83,70,13,2
2022-06-20,Lam Dong,Da Lat City,10,88,76,12,2
2022-06-20,Lam Dong,Da Lat City,11,148,117,31,25
2022-06-20,Lam Dong,Da Lat City,12,128,96,32,21
2022-06-20,Lam Dong,Da Lat City,13,143,91,52,34
2022-06-20,Lam Dong,Da Lat City,14,107,66,41,33
2022-06-20,Lam Dong,Da Lat City,15,112,73,39,27
2022-06-20,Lam Dong,Da Lat City,16,133,71,62,52
2022-06-20,Lam Dong,Da Lat City,17,148,74,74,56
2022-06-20,Lam Dong,Da Lat City,18,180,85,95,65
2022-06-20,Lam Dong,Da Lat City,19,152,77,75,47
2022-06-20,Lam Dong,Da Lat City,20,146,56,90,64
2022-06-20,Lam Dong,Da Lat City,21,90,43,47,33
2022-06-20,Lam Dong,Da Lat City,22,2,0,2,0
2022-06-20,Nghe An,Vinh City,5,1,0,1,0
2022-06-20,Nghe An,Vinh City,6,5,3,2,0
2022-06-20,Nghe An,Vinh City,7,137,113,24,8
2022-06-20,Nghe An,Vinh City,8,196,169,27,11
2022-06-20,Nghe An,Vinh City,9,194,170,24,2
2022-06-20,Nghe An,Vinh City,10,260,227,33,6
2022-06-20,Nghe An,Vinh City,11,514,385,129,68
2022-06-20,Nghe An,Vinh City,12,242,215,27,5
2022-06-20,Nghe An,Vinh City,13,150,131,19,3
2022-06-20,Nghe An,Vinh City,14,224,187,37,9
2022-06-20,Nghe An,Vinh City,15,180,156,24,2
2022-06-20,Nghe An,Vinh City,16,136,110,26,0
2022-06-20,Nghe An,Vinh City,17,142,122,20,2
2022-06-20,Nghe An,Vinh City,18,187,158,29,1
2022-06-20,Nghe An,Vinh City,19,218,176,42,4
2022-06-20,Nghe An,Vinh City,20,155,104,51,4
2022-06-20,Nghe An,Vinh City,21,117,74,43,22
2022-06-20,Nghe An,Vinh City,22,1,0,1,0
2022-06-20,Quang Nam,Hoi An City,6,1,0,1,1
2022-06-20,Quang Nam,Hoi An City,7,18,11,7,2
2022-06-20,Quang Nam,Hoi An City,8,37,24,13,4
2022-06-20,Quang Nam,Hoi An City,9,31,21,10,7
2022-06-20,Quang Nam,Hoi An City,10,51,34,17,3
2022-06-20,Quang Nam,Hoi An City,11,47,35,12,7
2022-06-20,Quang Nam,Hoi An City,12,42,30,12,9
2022-06-20,Quang Nam,Hoi An City,13,36,26,10,4
2022-06-20,Quang Nam,Hoi An City,14,48,33,15,9
2022-06-20,Quang Nam,Hoi An City,15,41,28,13,8
2022-06-20,Quang Nam,Hoi An City,16,46,42,4,3
2022-06-20,Quang Nam,Hoi An City,17,31,26,5,1
2022-06-20,Quang Nam,Hoi An City,18,54,43,11,3
2022-06-20,Quang Nam,Hoi An City,19,64,43,21,11
2022-06-20,Quang Nam,Hoi An City,20,40,25,15,6
2022-06-20,Quang Nam,Hoi An City,21,34,10,24,16
2022-06-20,Quang Nam,Hoi An City,23,1,0,1,1
2022-06-20,Quang Nam,Tam Ky City,11,1,0,1,1
2022-06-20,Quang Ninh,Cam Pha City,4,1,0,1,0
2022-06-20,Quang Ninh,Cam Pha City,7,1,0,1,1
2022-06-20,Quang Ninh,Cam Pha City,14,1,0,1,1
2022-06-20,Quang Ninh,Cam Pha City,15,1,0,1,1
2022-06-20,Quang Ninh,Cam Pha City,18,1,0,1,1
2022-06-20,Quang Ninh,Ha Long City,2,1,1,0,0
2022-06-20,Quang Ninh,Ha Long City,6,1,1,0,0
2022-06-20,Quang Ninh,Ha Long City,7,30,29,1,0
2022-06-20,Quang Ninh,Ha Long City,8,47,42,5,2
2022-06-20,Quang Ninh,Ha Long City,9,54,43,11,6
2022-06-20,Quang Ninh,Ha Long City,10,90,71,19,5
2022-06-20,Quang Ninh,Ha Long City,11,156,125,31,19
2022-06-20,Quang Ninh,Ha Long City,12,113,86,27,17
2022-06-20,Quang Ninh,Ha Long City,13,65,44,21,13
2022-06-20,Quang Ninh,Ha Long City,14,84,65,19,4
2022-06-20,Quang Ninh,Ha Long City,15,74,54,20,7
2022-06-20,Quang Ninh,Ha Long City,16,46,36,10,6
2022-06-20,Quang Ninh,Ha Long City,17,39,28,11,3
2022-06-20,Quang Ninh,Ha Long City,18,47,32,15,7
2022-06-20,Quang Ninh,Ha Long City,19,66,31,35,14
2022-06-20,Quang Ninh,Ha Long City,20,73,39,34,15
2022-06-20,Quang Ninh,Ha Long City,21,2,0,2,0
2022-06-20,Thai Nguyen,Dong Hy,12,2,0,2,2
2022-06-20,Thai Nguyen,Dong Hy,14,1,0,1,1
2022-06-20,Thai Nguyen,Pho Yen,8,3,0,3,3
2022-06-20,Thai Nguyen,Pho Yen,10,1,0,1,1
2022-06-20,Thai Nguyen,Pho Yen,12,3,0,3,3
2022-06-20,Thai Nguyen,Pho Yen,13,1,0,1,1
2022-06-20,Thai Nguyen,Thai Nguyen City,0,3,3,0,0
2022-06-20,Thai Nguyen,Thai Nguyen City,5,1,1,0,0
2022-06-20,Thai Nguyen,Thai Nguyen City,6,10,6,4,1
2022-06-20,Thai Nguyen,Thai Nguyen City,7,95,83,12,6
2022-06-20,Thai Nguyen,Thai Nguyen City,8,150,139,11,2
2022-06-20,Thai Nguyen,Thai Nguyen City,9,177,155,22,2
2022-06-20,Thai Nguyen,Thai Nguyen City,10,187,173,14,2
2022-06-20,Thai Nguyen,Thai Nguyen City,11,444,385,59,23
2022-06-20,Thai Nguyen,Thai Nguyen City,12,315,285,30,5
2022-06-20,Thai Nguyen,Thai Nguyen City,13,189,172,17,3
2022-06-20,Thai Nguyen,Thai Nguyen City,14,222,176,46,7
2022-06-20,Thai Nguyen,Thai Nguyen City,15,188,156,32,1
2022-06-20,Thai Nguyen,Thai Nguyen City,16,122,108,14,0
2022-06-20,Thai Nguyen,Thai Nguyen City,17,152,136,16,0
2022-06-20,Thai Nguyen,Thai Nguyen City,18,175,155,20,0
2022-06-20,Thai Nguyen,Thai Nguyen City,19,246,194,52,0
2022-06-20,Thai Nguyen,Thai Nguyen City,20,203,170,33,1
2022-06-20,Thai Nguyen,Thai Nguyen City,21,145,119,26,9
2022-06-20,Thai Nguyen,Thai Nguyen City,22,2,1,1,0
2022-06-20,Vung Tau,Ba Ria City,7,1,1,0,0
2022-06-20,Vung Tau,Ba Ria City,8,4,4,0,0
2022-06-20,Vung Tau,Ba Ria City,9,6,2,4,3
2022-06-20,Vung Tau,Ba Ria City,10,10,5,5,4
2022-06-20,Vung Tau,Ba Ria City,11,11,7,4,1
2022-06-20,Vung Tau,Ba Ria City,12,7,5,2,2
2022-06-20,Vung Tau,Ba Ria City,13,10,5,5,3
2022-06-20,Vung Tau,Ba Ria City,14,10,6,4,4
2022-06-20,Vung Tau,Ba Ria City,15,7,3,4,3
2022-06-20,Vung Tau,Ba Ria City,16,11,3,8,3
2022-06-20,Vung Tau,Ba Ria City,17,11,3,8,5
2022-06-20,Vung Tau,Ba Ria City,18,9,4,5,2
2022-06-20,Vung Tau,Ba Ria City,19,5,3,2,2
2022-06-20,Vung Tau,Ba Ria City,20,16,12,4,3
2022-06-20,Vung Tau,Ba Ria City,21,15,10,5,1
2022-06-20,Vung Tau,Chau Duc,19,1,0,1,0
2022-06-20,Vung Tau,Tan Thanh,20,2,0,2,0
2022-06-20,Vung Tau,Vung Tau City,0,1,0,1,0
2022-06-20,Vung Tau,Vung Tau City,1,3,2,1,0
2022-06-20,Vung Tau,Vung Tau City,5,2,1,1,1
2022-06-20,Vung Tau,Vung Tau City,6,38,28,10,0
2022-06-20,Vung Tau,Vung Tau City,7,133,120,13,5
2022-06-20,Vung Tau,Vung Tau City,8,197,170,27,13
2022-06-20,Vung Tau,Vung Tau City,9,215,186,29,5
2022-06-20,Vung Tau,Vung Tau City,10,262,234,28,3
2022-06-20,Vung Tau,Vung Tau City,11,381,355,26,8
2022-06-20,Vung Tau,Vung Tau City,12,308,287,21,3
2022-06-20,Vung Tau,Vung Tau City,13,238,221,17,2
2022-06-20,Vung Tau,Vung Tau City,14,241,224,17,0
2022-06-20,Vung Tau,Vung Tau City,15,253,234,19,4
2022-06-20,Vung Tau,Vung Tau City,16,196,188,8,0
2022-06-20,Vung Tau,Vung Tau City,17,251,224,27,2
2022-06-20,Vung Tau,Vung Tau City,18,317,263,54,10
2022-06-20,Vung Tau,Vung Tau City,19,306,225,81,13
2022-06-20,Vung Tau,Vung Tau City,20,261,164,97,43
2022-06-20,Vung Tau,Vung Tau City,21,141,81,60,30
2022-06-20,Vung Tau,Vung Tau City,22,2,1,1,0
2022-06-21,Bac Ninh,Bác Ninh City,6,4,4,0,0
2022-06-21,Bac Ninh,Bác Ninh City,7,81,69,12,2
2022-06-21,Bac Ninh,Bác Ninh City,8,146,131,15,0
2022-06-21,Bac Ninh,Bác Ninh City,9,137,128,9,1
2022-06-21,Bac Ninh,Bác Ninh City,10,186,166,20,0
2022-06-21,Bac Ninh,Bác Ninh City,11,450,379,71,43
2022-06-21,Bac Ninh,Bác Ninh City,12,221,204,17,3
2022-06-21,Bac Ninh,Bác Ninh City,13,158,141,17,8
2022-06-21,Bac Ninh,Bác Ninh City,14,180,156,24,4
2022-06-21,Bac Ninh,Bác Ninh City,15,154,137,17,4
2022-06-21,Bac Ninh,Bác Ninh City,16,122,115,7,1
2022-06-21,Bac Ninh,Bác Ninh City,17,122,111,11,2
2022-06-21,Bac Ninh,Bác Ninh City,18,165,152,13,2
2022-06-21,Bac Ninh,Bác Ninh City,19,206,185,21,3
2022-06-21,Bac Ninh,Bác Ninh City,20,148,115,33,14
2022-06-21,Bac Ninh,Bác Ninh City,21,122,79,43,33
2022-06-21,Bac Ninh,Bác Ninh City,22,1,0,1,1
2022-06-21,Bac Ninh,Que Vo,7,2,1,1,1
2022-06-21,Bac Ninh,Que Vo,13,5,0,5,5
2022-06-21,Bac Ninh,Que Vo,14,2,0,2,2
2022-06-21,Bac Ninh,Que Vo,15,4,2,2,1
2022-06-21,Bac Ninh,Que Vo,17,3,1,2,2
2022-06-21,Bac Ninh,Que Vo,19,1,0,1,1
2022-06-21,Bac Ninh,Tien Du,11,2,0,2,0
2022-06-21,Bac Ninh,Tien Du,13,2,0,2,2
2022-06-21,Bac Ninh,Tien Du,14,5,0,5,5
2022-06-21,Bac Ninh,Tien Du,15,1,0,1,1
2022-06-21,Bac Ninh,Tien Du,16,2,0,2,1
2022-06-21,Bac Ninh,Tien Du,17,1,0,1,1
2022-06-21,Bac Ninh,Tien Du,18,1,0,1,1
2022-06-21,Bac Ninh,Tien Du,21,2,0,2,2
2022-06-21,Bac Ninh,Tu Son,10,2,0,2,2
2022-06-21,Bac Ninh,Tu Son,11,4,0,4,4
2022-06-21,Bac Ninh,Tu Son,12,2,0,2,1
2022-06-21,Bac Ninh,Tu Son,14,4,0,4,4
2022-06-21,Bac Ninh,Tu Son,15,1,0,1,1
2022-06-21,Bac Ninh,Tu Son,16,1,0,1,1
2022-06-21,Bac Ninh,Tu Son,18,2,0,2,1
2022-06-21,Binh Duong,Ben Cat,8,2,0,2,2
2022-06-21,Binh Duong,Ben Cat,9,1,0,1,1
2022-06-21,Binh Duong,Ben Cat,10,2,0,2,1
2022-06-21,Binh Duong,Ben Cat,11,1,0,1,1
2022-06-21,Binh Duong,Ben Cat,12,1,0,1,1
2022-06-21,Binh Duong,Ben Cat,14,2,0,2,2
2022-06-21,Binh Duong,Ben Cat,16,2,0,2,1
2022-06-21,Binh Duong,Ben Cat,17,2,0,2,2
2022-06-21,Binh Duong,Ben Cat,18,3,1,2,2
2022-06-21,Binh Duong,Ben Cat,20,1,0,1,1
2022-06-21,Binh Duong,Ben Cat,21,1,0,1,0
2022-06-21,Binh Duong,Di An,6,1,0,1,1
2022-06-21,Binh Duong,Di An,7,4,1,3,2
2022-06-21,Binh Duong,Di An,8,19,6,13,11
2022-06-21,Binh Duong,Di An,9,34,16,18,11
2022-06-21,Binh Duong,Di An,10,42,27,15,8
2022-06-21,Binh Duong,Di An,11,54,39,15,10
2022-06-21,Binh Duong,Di An,12,40,27,13,9
2022-06-21,Binh Duong,Di An,13,66,28,38,25
2022-06-21,Binh Duong,Di An,14,33,16,17,9
2022-06-21,Binh Duong,Di An,15,27,13,14,8
2022-06-21,Binh Duong,Di An,16,33,21,12,9
2022-06-21,Binh Duong,Di An,17,19,12,7,5
2022-06-21,Binh Duong,Di An,18,24,17,7,3
2022-06-21,Binh Duong,Di An,19,39,13,26,20
2022-06-21,Binh Duong,Di An,20,24,15,9,7
2022-06-21,Binh Duong,Di An,21,11,4,7,1
2022-06-21,Binh Duong,Phu Giao,21,1,0,1,0
2022-06-21,Binh Duong,Tan Uyen,8,1,0,1,1
2022-06-21,Binh Duong,Tan Uyen,9,1,1,0,0
2022-06-21,Binh Duong,Tan Uyen,11,1,1,0,0
2022-06-21,Binh Duong,Tan Uyen,12,3,1,2,0
2022-06-21,Binh Duong,Tan Uyen,13,1,1,0,0
2022-06-21,Binh Duong,Tan Uyen,14,2,1,1,1
2022-06-21,Binh Duong,Tan Uyen,16,1,1,0,0
2022-06-21,Binh Duong,Tan Uyen,18,5,1,4,4
2022-06-21,Binh Duong,Tan Uyen,19,4,1,3,3
2022-06-21,Binh Duong,Tan Uyen,20,2,1,1,1
2022-06-21,Binh Duong,Tan Uyen,21,2,1,1,1
2022-06-21,Binh Duong,Thu Dau Mot Town,2,2,1,1,0
2022-06-21,Binh Duong,Thu Dau Mot Town,5,1,1,0,0
2022-06-21,Binh Duong,Thu Dau Mot Town,6,52,43,9,6
2022-06-21,Binh Duong,Thu Dau Mot Town,7,130,123,7,2
2022-06-21,Binh Duong,Thu Dau Mot Town,8,267,240,27,4
2022-06-21,Binh Duong,Thu Dau Mot Town,9,259,239,20,1
2022-06-21,Binh Duong,Thu Dau Mot Town,10,430,411,19,1
2022-06-21,Binh Duong,Thu Dau Mot Town,11,683,631,52,18
2022-06-21,Binh Duong,Thu Dau Mot Town,12,493,462,31,8
2022-06-21,Binh Duong,Thu Dau Mot Town,13,486,443,43,8
2022-06-21,Binh Duong,Thu Dau Mot Town,14,394,359,35,5
2022-06-21,Binh Duong,Thu Dau Mot Town,15,276,249,27,7
2022-06-21,Binh Duong,Thu Dau Mot Town,16,305,278,27,7
2022-06-21,Binh Duong,Thu Dau Mot Town,17,336,320,16,5
2022-06-21,Binh Duong,Thu Dau Mot Town,18,404,379,25,3
2022-06-21,Binh Duong,Thu Dau Mot Town,19,355,310,45,13
2022-06-21,Binh Duong,Thu Dau Mot Town,20,308,271,37,15
2022-06-21,Binh Duong,Thu Dau Mot Town,21,151,109,42,13
2022-06-21,Binh Duong,Thu Dau Mot Town,23,1,0,1,0
2022-06-21,Binh Duong,Thuan An,6,2,0,2,2
2022-06-21,Binh Duong,Thuan An,7,7,2,5,3
2022-06-21,Binh Duong,Thuan An,8,18,13,5,3
2022-06-21,Binh Duong,Thuan An,9,45,34,11,6
2022-06-21,Binh Duong,Thuan An,10,62,52,10,2
2022-06-21,Binh Duong,Thuan An,11,83,65,18,11
2022-06-21,Binh Duong,Thuan An,12,86,68,18,7
2022-06-21,Binh Duong,Thuan An,13,77,60,17,8
2022-06-21,Binh Duong,Thuan An,14,74,41,33,20
2022-06-21,Binh Duong,Thuan An,15,38,20,18,12
2022-06-21,Binh Duong,Thuan An,16,47,37,10,7
2022-06-21,Binh Duong,Thuan An,17,52,41,11,8
2022-06-21,Binh Duong,Thuan An,18,51,39,12,3
2022-06-21,Binh Duong,Thuan An,19,42,32,10,6
2022-06-21,Binh Duong,Thuan An,20,51,34,17,12
2022-06-21,Binh Duong,Thuan An,21,18,12,6,5
2022-06-21,Can Tho City,Binh Thuy District,7,1,1,0,0
2022-06-21,Can Tho City,Binh Thuy District,8,5,3,2,0
2022-06-21,Can Tho City,Binh Thuy District,9,7,7,0,0
2022-06-21,Can Tho City,Binh Thuy District,10,8,7,1,0
2022-06-21,Can Tho City,Binh Thuy District,11,19,18,1,0
2022-06-21,Can Tho City,Binh Thuy District,12,10,10,0,0
2022-06-21,Can Tho City,Binh Thuy District,13,13,13,0,0
2022-06-21,Can Tho City,Binh Thuy District,14,15,14,1,0
2022-06-21,Can Tho City,Binh Thuy District,15,14,13,1,0
2022-06-21,Can Tho City,Binh Thuy District,16,11,11,0,0
2022-06-21,Can Tho City,Binh Thuy District,17,7,7,0,0
2022-06-21,Can Tho City,Binh Thuy District,18,15,14,1,0
2022-06-21,Can Tho City,Binh Thuy District,19,13,13,0,0
2022-06-21,Can Tho City,Binh Thuy District,20,8,8,0,0
2022-06-21,Can Tho City,Cai Rang District,0,1,1,0,0
2022-06-21,Can Tho City,Cai Rang District,7,5,3,2,0
2022-06-21,Can Tho City,Cai Rang District,8,12,10,2,2
2022-06-21,Can Tho City,Cai Rang District,9,11,9,2,2
2022-06-21,Can Tho City,Cai Rang District,10,6,5,1,0
2022-06-21,Can Tho City,Cai Rang District,11,14,13,1,1
2022-06-21,Can Tho City,Cai Rang District,12,8,8,0,0
2022-06-21,Can Tho City,Cai Rang District,13,6,6,0,0
2022-06-21,Can Tho City,Cai Rang District,14,17,14,3,2
2022-06-21,Can Tho City,Cai Rang District,15,7,6,1,1
2022-06-21,Can Tho City,Cai Rang District,16,13,10,3,0
2022-06-21,Can Tho City,Cai Rang District,17,5,5,0,0
2022-06-21,Can Tho City,Cai Rang District,18,16,16,0,0
2022-06-21,Can Tho City,Cai Rang District,19,19,18,1,0
2022-06-21,Can Tho City,Cai Rang District,20,12,10,2,0
2022-06-21,Can Tho City,Cai Rang District,21,2,2,0,0
2022-06-21,Can Tho City,Ninh Kieu District,0,2,1,1,0
2022-06-21,Can Tho City,Ninh Kieu District,5,2,1,1,1
2022-06-21,Can Tho City,Ninh Kieu District,6,54,46,8,2
2022-06-21,Can Tho City,Ninh Kieu District,7,113,106,7,1
2022-06-21,Can Tho City,Ninh Kieu District,8,237,222,15,0
2022-06-21,Can Tho City,Ninh Kieu District,9,327,313,14,0
2022-06-21,Can Tho City,Ninh Kieu District,10,570,546,24,0
2022-06-21,Can Tho City,Ninh Kieu District,11,878,826,52,7
2022-06-21,Can Tho City,Ninh Kieu District,12,636,613,23,0
2022-06-21,Can Tho City,Ninh Kieu District,13,540,500,40,0
2022-06-21,Can Tho City,Ninh Kieu District,14,444,417,27,0
2022-06-21,Can Tho City,Ninh Kieu District,15,391,367,24,0
2022-06-21,Can Tho City,Ninh Kieu District,16,437,416,21,1
2022-06-21,Can Tho City,Ninh Kieu District,17,511,487,24,1
2022-06-21,Can Tho City,Ninh Kieu District,18,601,569,32,0
2022-06-21,Can Tho City,Ninh Kieu District,19,461,431,30,0
2022-06-21,Can Tho City,Ninh Kieu District,20,353,335,18,0
2022-06-21,Can Tho City,Ninh Kieu District,21,233,218,15,1
2022-06-21,Can Tho City,Ninh Kieu District,22,1,0,1,0
2022-06-21,Dong Nai,Bien Hoa City,0,3,3,0,0
2022-06-21,Dong Nai,Bien Hoa City,1,1,1,0,0
2022-06-21,Dong Nai,Bien Hoa City,2,4,1,3,0
2022-06-21,Dong Nai,Bien Hoa City,3,3,0,3,0
2022-06-21,Dong Nai,Bien Hoa City,4,2,1,1,0
2022-06-21,Dong Nai,Bien Hoa City,5,4,2,2,2
2022-06-21,Dong Nai,Bien Hoa City,6,61,43,18,12
2022-06-21,Dong Nai,Bien Hoa City,7,176,146,30,13
2022-06-21,Dong Nai,Bien Hoa City,8,308,269,39,12
2022-06-21,Dong Nai,Bien Hoa City,9,491,440,51,5
2022-06-21,Dong Nai,Bien Hoa City,10,807,734,73,10
2022-06-21,Dong Nai,Bien Hoa City,11,1080,934,146,49
2022-06-21,Dong Nai,Bien Hoa City,12,843,761,82,21
2022-06-21,Dong Nai,Bien Hoa City,13,857,764,93,10
2022-06-21,Dong Nai,Bien Hoa City,14,749,667,82,20
2022-06-21,Dong Nai,Bien Hoa City,15,486,436,50,11
2022-06-21,Dong Nai,Bien Hoa City,16,526,483,43,9
2022-06-21,Dong Nai,Bien Hoa City,17,578,526,52,12
2022-06-21,Dong Nai,Bien Hoa City,18,673,627,46,7
2022-06-21,Dong Nai,Bien Hoa City,19,687,597,90,19
2022-06-21,Dong Nai,Bien Hoa City,20,521,439,82,24
2022-06-21,Dong Nai,Bien Hoa City,21,225,190,35,6
2022-06-21,Dong Nai,Bien Hoa City,22,3,0,3,0
2022-06-21,Dong Nai,Long Khanh,12,1,0,1,1
2022-06-21,Dong Nai,Long Khanh,17,1,0,1,1
2022-06-21,Dong Nai,Long Thanh,9,1,0,1,1
2022-06-21,Dong Nai,Long Thanh,10,2,0,2,2
2022-06-21,Dong Nai,Long Thanh,11,3,0,3,3
2022-06-21,Dong Nai,Long Thanh,12,2,0,2,2
2022-06-21,Dong Nai,Long Thanh,13,1,0,1,1
2022-06-21,Dong Nai,Long Thanh,14,1,0,1,1
2022-06-21,Dong Nai,Long Thanh,18,1,0,1,1
2022-06-21,Dong Nai,Long Thanh,19,2,0,2,2
2022-06-21,Dong Nai,Nhon trach,8,2,0,2,1
2022-06-21,Dong Nai,Nhon trach,9,1,0,1,1
2022-06-21,Dong Nai,Nhon trach,10,1,0,1,1
2022-06-21,Dong Nai,Nhon trach,11,1,0,1,1
2022-06-21,Dong Nai,Nhon trach,12,1,0,1,1
2022-06-21,Dong Nai,Nhon trach,15,1,0,1,1
2022-06-21,Dong Nai,Nhon trach,19,1,0,1,1
2022-06-21,Dong Nai,Nhon trach,21,1,0,1,1
2022-06-21,Dong Nai,Trang Bom,7,1,0,1,0
2022-06-21,Dong Nai,Trang Bom,13,4,1,3,3
2022-06-21,Dong Nai,Trang Bom,14,1,0,1,1
2022-06-21,Hai Phong City,An Duong,6,1,0,1,0
2022-06-21,Hai Phong City,An Duong,7,3,0,3,3
2022-06-21,Hai Phong City,An Duong,9,5,2,3,2
2022-06-21,Hai Phong City,An Duong,10,8,6,2,1
2022-06-21,Hai Phong City,An Duong,11,8,4,4,3
2022-06-21,Hai Phong City,An Duong,12,7,3,4,2
2022-06-21,Hai Phong City,An Duong,13,6,4,2,2
2022-06-21,Hai Phong City,An Duong,14,6,3,3,1
2022-06-21,Hai Phong City,An Duong,15,1,1,0,0
2022-06-21,Hai Phong City,An Duong,16,2,1,1,1
2022-06-21,Hai Phong City,An Duong,17,1,1,0,0
2022-06-21,Hai Phong City,An Duong,18,1,1,0,0
2022-06-21,Hai Phong City,An Duong,19,1,0,1,1
2022-06-21,Hai Phong City,An Duong,20,1,0,1,0
2022-06-21,Hai Phong City,An Duong,21,2,1,1,0
2022-06-21,Hai Phong City,Do Son District,11,1,0,1,1
2022-06-21,Hai Phong City,Duong Kinh District,9,1,0,1,1
2022-06-21,Hai Phong City,Duong Kinh District,14,1,0,1,1
2022-06-21,Hai Phong City,Duong Kinh District,20,1,0,1,1
2022-06-21,Hai Phong City,Hai An District,7,4,4,0,0
2022-06-21,Hai Phong City,Hai An District,8,16,13,3,0
2022-06-21,Hai Phong City,Hai An District,9,15,11,4,1
2022-06-21,Hai Phong City,Hai An District,10,32,26,6,2
2022-06-21,Hai Phong City,Hai An District,11,43,37,6,1
2022-06-21,Hai Phong City,Hai An District,12,22,16,6,1
2022-06-21,Hai Phong City,Hai An District,13,22,13,9,3
2022-06-21,Hai Phong City,Hai An District,14,16,9,7,3
2022-06-21,Hai Phong City,Hai An District,15,24,20,4,0
2022-06-21,Hai Phong City,Hai An District,16,10,10,0,0
2022-06-21,Hai Phong City,Hai An District,17,21,17,4,0
2022-06-21,Hai Phong City,Hai An District,18,24,15,9,2
2022-06-21,Hai Phong City,Hai An District,19,15,13,2,1
2022-06-21,Hai Phong City,Hai An District,20,9,7,2,0
2022-06-21,Hai Phong City,Hai An District,21,9,3,6,5
2022-06-21,Hai Phong City,Hong Bang District,7,15,13,2,1
2022-06-21,Hai Phong City,Hong Bang District,8,42,33,9,2
2022-06-21,Hai Phong City,Hong Bang District,9,39,30,9,3
2022-06-21,Hai Phong City,Hong Bang District,10,74,62,12,2
2022-06-21,Hai Phong City,Hong Bang District,11,119,87,32,11
2022-06-21,Hai Phong City,Hong Bang District,12,78,64,14,5
2022-06-21,Hai Phong City,Hong Bang District,13,55,39,16,6
2022-06-21,Hai Phong City,Hong Bang District,14,64,50,14,7
2022-06-21,Hai Phong City,Hong Bang District,15,49,42,7,4
2022-06-21,Hai Phong City,Hong Bang District,16,35,30,5,0
2022-06-21,Hai Phong City,Hong Bang District,17,36,30,6,2
2022-06-21,Hai Phong City,Hong Bang District,18,64,53,11,5
2022-06-21,Hai Phong City,Hong Bang District,19,34,31,3,0
2022-06-21,Hai Phong City,Hong Bang District,20,37,31,6,5
2022-06-21,Hai Phong City,Hong Bang District,21,14,9,5,3
2022-06-21,Hai Phong City,Hong Bang District,23,1,0,1,0
2022-06-21,Hai Phong City,Kien An District,4,1,1,0,0
2022-06-21,Hai Phong City,Kien An District,7,2,1,1,1
2022-06-21,Hai Phong City,Kien An District,8,9,0,9,7
2022-06-21,Hai Phong City,Kien An District,9,9,6,3,1
2022-06-21,Hai Phong City,Kien An District,10,18,16,2,0
2022-06-21,Hai Phong City,Kien An District,11,14,11,3,0
2022-06-21,Hai Phong City,Kien An District,12,9,8,1,0
2022-06-21,Hai Phong City,Kien An District,13,6,4,2,2
2022-06-21,Hai Phong City,Kien An District,14,14,10,4,2
2022-06-21,Hai Phong City,Kien An District,15,11,9,2,1
2022-06-21,Hai Phong City,Kien An District,16,7,7,0,0
2022-06-21,Hai Phong City,Kien An District,17,11,7,4,3
2022-06-21,Hai Phong City,Kien An District,18,8,5,3,0
2022-06-21,Hai Phong City,Kien An District,19,9,7,2,1
2022-06-21,Hai Phong City,Kien An District,20,10,9,1,0
2022-06-21,Hai Phong City,Kien An District,21,10,5,5,2
2022-06-21,Hai Phong City,Le Chan District,1,1,1,0,0
2022-06-21,Hai Phong City,Le Chan District,6,1,1,0,0
2022-06-21,Hai Phong City,Le Chan District,7,40,35,5,3
2022-06-21,Hai Phong City,Le Chan District,8,90,78,12,6
2022-06-21,Hai Phong City,Le Chan District,9,104,89,15,1
2022-06-21,Hai Phong City,Le Chan District,10,194,180,14,4
2022-06-21,Hai Phong City,Le Chan District,11,378,332,46,15
2022-06-21,Hai Phong City,Le Chan District,12,230,195,35,4
2022-06-21,Hai Phong City,Le Chan District,13,163,134,29,7
2022-06-21,Hai Phong City,Le Chan District,14,174,140,34,21
2022-06-21,Hai Phong City,Le Chan District,15,169,142,27,10
2022-06-21,Hai Phong City,Le Chan District,16,154,134,20,3
2022-06-21,Hai Phong City,Le Chan District,17,163,140,23,3
2022-06-21,Hai Phong City,Le Chan District,18,193,172,21,1
2022-06-21,Hai Phong City,Le Chan District,19,171,149,22,4
2022-06-21,Hai Phong City,Le Chan District,20,117,103,14,3
2022-06-21,Hai Phong City,Le Chan District,21,77,63,14,3
2022-06-21,Hai Phong City,Ngo Quyen District,6,1,0,1,0
2022-06-21,Hai Phong City,Ngo Quyen District,7,22,17,5,2
2022-06-21,Hai Phong City,Ngo Quyen District,8,65,55,10,4
2022-06-21,Hai Phong City,Ngo Quyen District,9,92,81,11,2
2022-06-21,Hai Phong City,Ngo Quyen District,10,172,145,27,2
2022-06-21,Hai Phong City,Ngo Quyen District,11,249,214,35,15
2022-06-21,Hai Phong City,Ngo Quyen District,12,166,143,23,8
2022-06-21,Hai Phong City,Ngo Quyen District,13,128,102,26,7
2022-06-21,Hai Phong City,Ngo Quyen District,14,142,117,25,12
2022-06-21,Hai Phong City,Ngo Quyen District,15,159,132,27,13
2022-06-21,Hai Phong City,Ngo Quyen District,16,117,107,10,1
2022-06-21,Hai Phong City,Ngo Quyen District,17,125,112,13,2
2022-06-21,Hai Phong City,Ngo Quyen District,18,167,150,17,3
2022-06-21,Hai Phong City,Ngo Quyen District,19,163,150,13,3
2022-06-21,Hai Phong City,Ngo Quyen District,20,119,103,16,6
2022-06-21,Hai Phong City,Ngo Quyen District,21,68,59,9,4
2022-06-21,Hai Phong City,Thuy Nguyen,7,1,0,1,1
2022-06-21,Hai Phong City,Thuy Nguyen,10,1,0,1,1
2022-06-21,Hai Phong City,Thuy Nguyen,11,1,0,1,1
2022-06-21,Hai Phong City,Thuy Nguyen,12,2,1,1,1
2022-06-21,Hai Phong City,Thuy Nguyen,14,1,0,1,1
2022-06-21,Hai Phong City,Thuy Nguyen,15,1,0,1,1
2022-06-21,Hai Phong City,Thuy Nguyen,18,1,0,1,1
2022-06-21,Hai Phong City,Thuy Nguyen,20,6,0,6,5
2022-06-21,Hue City,Hue City,0,1,1,0,0
2022-06-21,Hue City,Hue City,1,2,2,0,0
2022-06-21,Hue City,Hue City,5,5,3,2,0
2022-06-21,Hue City,Hue City,6,82,63,19,5
2022-06-21,Hue City,Hue City,7,228,213,15,1
2022-06-21,Hue City,Hue City,8,306,289,17,1
2022-06-21,Hue City,Hue City,9,324,293,31,1
2022-06-21,Hue City,Hue City,10,446,418,28,0
2022-06-21,Hue City,Hue City,11,909,798,111,11
2022-06-21,Hue City,Hue City,12,563,521,42,2
2022-06-21,Hue City,Hue City,13,382,356,26,1
2022-06-21,Hue City,Hue City,14,393,359,34,5
2022-06-21,Hue City,Hue City,15,438,392,46,2
2022-06-21,Hue City,Hue City,16,368,330,38,6
2022-06-21,Hue City,Hue City,17,427,400,27,1
2022-06-21,Hue City,Hue City,18,541,497,44,1
2022-06-21,Hue City,Hue City,19,626,553,73,4
2022-06-21,Hue City,Hue City,20,554,440,114,51
2022-06-21,Hue City,Hue City,21,301,218,83,51
2022-06-21,Hue City,Hue City,22,3,0,3,1
2022-06-21,Hue City,Huong Thuy,10,1,1,0,0
2022-06-21,Hue City,Huong Thuy,11,6,2,4,2
2022-06-21,Hue City,Huong Thuy,12,1,1,0,0
2022-06-21,Hue City,Huong Thuy,15,1,1,0,0
2022-06-21,Hue City,Huong Thuy,16,1,0,1,0
2022-06-21,Hue City,Huong Thuy,17,5,1,4,2
2022-06-21,Hue City,Huong Thuy,19,1,1,0,0
2022-06-21,Hue City,Huong Thuy,20,3,1,2,0
2022-06-21,Hue City,Huong Tra,9,1,1,0,0
2022-06-21,Hue City,Huong Tra,17,2,0,2,0
2022-06-21,Hue City,Huong Tra,19,1,1,0,0
2022-06-21,Hue City,Huong Tra,20,1,1,0,0
2022-06-21,Hue City,Huong Tra,21,2,2,0,0
2022-06-21,Hue City,Phu Vang,6,2,0,2,0
2022-06-21,Hue City,Phu Vang,9,4,2,2,1
2022-06-21,Hue City,Phu Vang,10,2,1,1,0
2022-06-21,Hue City,Phu Vang,11,4,4,0,0
2022-06-21,Hue City,Phu Vang,12,3,1,2,0
2022-06-21,Hue City,Phu Vang,13,1,0,1,0
2022-06-21,Hue City,Phu Vang,14,2,2,0,0
2022-06-21,Hue City,Phu Vang,15,2,2,0,0
2022-06-21,Hue City,Phu Vang,17,4,2,2,0
2022-06-21,Hue City,Phu Vang,18,3,2,1,1
2022-06-21,Hue City,Phu Vang,19,2,1,1,0
2022-06-21,Hue City,Phu Vang,20,3,1,2,1
2022-06-21,Hue City,Phu Vang,21,1,0,1,1
2022-06-21,Khanh Hoa,Dien Khanh,20,1,0,1,1
2022-06-21,Khanh Hoa,Nha Trang City,0,1,1,0,0
2022-06-21,Khanh Hoa,Nha Trang City,5,3,1,2,0
2022-06-21,Khanh Hoa,Nha Trang City,6,45,36,9,1
2022-06-21,Khanh Hoa,Nha Trang City,7,139,127,12,4
2022-06-21,Khanh Hoa,Nha Trang City,8,205,185,20,1
2022-06-21,Khanh Hoa,Nha Trang City,9,185,169,16,0
2022-06-21,Khanh Hoa,Nha Trang City,10,220,205,15,0
2022-06-21,Khanh Hoa,Nha Trang City,11,392,364,28,2
2022-06-21,Khanh Hoa,Nha Trang City,12,316,303,13,0
2022-06-21,Khanh Hoa,Nha Trang City,13,300,275,25,1
2022-06-21,Khanh Hoa,Nha Trang City,14,275,253,22,0
2022-06-21,Khanh Hoa,Nha Trang City,15,218,206,12,0
2022-06-21,Khanh Hoa,Nha Trang City,16,187,176,11,2
2022-06-21,Khanh Hoa,Nha Trang City,17,223,206,17,1
2022-06-21,Khanh Hoa,Nha Trang City,18,305,281,24,1
2022-06-21,Khanh Hoa,Nha Trang City,19,269,249,20,1
2022-06-21,Khanh Hoa,Nha Trang City,20,189,163,26,1
2022-06-21,Khanh Hoa,Nha Trang City,21,122,79,43,7
2022-06-21,Khanh Hoa,Nha Trang City,22,1,0,1,0
2022-06-21,Khanh Hoa,Nha Trang City,23,2,1,1,0
2022-06-21,Lam Dong,Da Lat City,1,1,1,0,0
2022-06-21,Lam Dong,Da Lat City,3,2,0,2,0
2022-06-21,Lam Dong,Da Lat City,6,6,2,4,3
2022-06-21,Lam Dong,Da Lat City,7,43,24,19,11
2022-06-21,Lam Dong,Da Lat City,8,123,71,52,41
2022-06-21,Lam Dong,Da Lat City,9,95,65,30,23
2022-06-21,Lam Dong,Da Lat City,10,103,84,19,10
2022-06-21,Lam Dong,Da Lat City,11,159,100,59,41
2022-06-21,Lam Dong,Da Lat City,12,147,120,27,13
2022-06-21,Lam Dong,Da Lat City,13,120,82,38,21
2022-06-21,Lam Dong,Da Lat City,14,117,74,43,33
2022-06-21,Lam Dong,Da Lat City,15,117,80,37,26
2022-06-21,Lam Dong,Da Lat City,16,136,85,51,36
2022-06-21,Lam Dong,Da Lat City,17,160,82,78,54
2022-06-21,Lam Dong,Da Lat City,18,205,110,95,78
2022-06-21,Lam Dong,Da Lat City,19,170,117,53,36
2022-06-21,Lam Dong,Da Lat City,20,106,65,41,28
2022-06-21,Lam Dong,Da Lat City,21,69,25,44,36
2022-06-21,Lam Dong,Da Lat City,22,1,0,1,0
2022-06-21,Nghe An,Hung Nguyen,20,1,0,1,1
2022-06-21,Nghe An,Vinh City,5,1,0,1,0
2022-06-21,Nghe An,Vinh City,6,4,3,1,1
2022-06-21,Nghe An,Vinh City,7,134,119,15,5
2022-06-21,Nghe An,Vinh City,8,172,152,20,3
2022-06-21,Nghe An,Vinh City,9,183,156,27,0
2022-06-21,Nghe An,Vinh City,10,214,189,25,2
2022-06-21,Nghe An,Vinh City,11,429,366,63,16
2022-06-21,Nghe An,Vinh City,12,227,212,15,0
2022-06-21,Nghe An,Vinh City,13,147,114,33,2
2022-06-21,Nghe An,Vinh City,14,202,165,37,1
2022-06-21,Nghe An,Vinh City,15,210,189,21,2
2022-06-21,Nghe An,Vinh City,16,123,115,8,1
2022-06-21,Nghe An,Vinh City,17,166,139,27,5
2022-06-21,Nghe An,Vinh City,18,197,164,33,1
2022-06-21,Nghe An,Vinh City,19,184,149,35,6
2022-06-21,Nghe An,Vinh City,20,133,122,11,1
2022-06-21,Nghe An,Vinh City,21,113,81,32,9
2022-06-21,Nghe An,Vinh City,22,3,1,2,1
2022-06-21,Quang Nam,Dien Ban,13,1,0,1,1
2022-06-21,Quang Nam,Hoi An City,7,13,11,2,0
2022-06-21,Quang Nam,Hoi An City,8,17,15,2,0
2022-06-21,Quang Nam,Hoi An City,9,23,19,4,1
2022-06-21,Quang Nam,Hoi An City,10,36,28,8,3
2022-06-21,Quang Nam,Hoi An City,11,48,43,5,0
2022-06-21,Quang Nam,Hoi An City,12,55,41,14,2
2022-06-21,Quang Nam,Hoi An City,13,31,26,5,0
2022-06-21,Quang Nam,Hoi An City,14,41,31,10,7
2022-06-21,Quang Nam,Hoi An City,15,32,26,6,3
2022-06-21,Quang Nam,Hoi An City,16,40,34,6,2
2022-06-21,Quang Nam,Hoi An City,17,31,23,8,1
2022-06-21,Quang Nam,Hoi An City,18,44,37,7,4
2022-06-21,Quang Nam,Hoi An City,19,55,42,13,7
2022-06-21,Quang Nam,Hoi An City,20,41,30,11,7
2022-06-21,Quang Nam,Hoi An City,21,28,15,13,11
2022-06-21,Quang Nam,Tam Ky City,11,1,0,1,1
2022-06-21,Quang Nam,Tam Ky City,12,1,0,1,1
2022-06-21,Quang Ninh,Cam Pha City,8,1,0,1,1
2022-06-21,Quang Ninh,Cam Pha City,11,1,0,1,1
2022-06-21,Quang Ninh,Cam Pha City,13,1,0,1,1
2022-06-21,Quang Ninh,Cam Pha City,14,2,0,2,2
2022-06-21,Quang Ninh,Cam Pha City,15,1,0,1,1
2022-06-21,Quang Ninh,Cam Pha City,20,2,0,2,2
2022-06-21,Quang Ninh,Ha Long City,1,1,0,1,1
2022-06-21,Quang Ninh,Ha Long City,6,1,0,1,0
2022-06-21,Quang Ninh,Ha Long City,7,41,23,18,9
2022-06-21,Quang Ninh,Ha Long City,8,66,44,22,11
2022-06-21,Quang Ninh,Ha Long City,9,66,48,18,8
2022-06-21,Quang Ninh,Ha Long City,10,100,75,25,11
2022-06-21,Quang Ninh,Ha Long City,11,145,126,19,10
2022-06-21,Quang Ninh,Ha Long City,12,115,84,31,19
2022-06-21,Quang Ninh,Ha Long City,13,96,56,40,21
2022-06-21,Quang Ninh,Ha Long City,14,86,58,28,11
2022-06-21,Quang Ninh,Ha Long City,15,59,36,23,10
2022-06-21,Quang Ninh,Ha Long City,16,41,33,8,3
2022-06-21,Quang Ninh,Ha Long City,17,38,29,9,1
2022-06-21,Quang Ninh,Ha Long City,18,51,47,4,1
2022-06-21,Quang Ninh,Ha Long City,19,61,44,17,7
2022-06-21,Quang Ninh,Ha Long City,20,51,28,23,8
2022-06-21,Quang Ninh,Ha Long City,21,2,0,2,0
2022-06-21,Quang Ninh,Ha Long City,23,1,0,1,0
2022-06-21,Thai Nguyen,Dong Hy,8,1,1,0,0
2022-06-21,Thai Nguyen,Dong Hy,21,1,0,1,1
2022-06-21,Thai Nguyen,Thai Nguyen City,0,5,4,1,0
2022-06-21,Thai Nguyen,Thai Nguyen City,6,5,4,1,0
2022-06-21,Thai Nguyen,Thai Nguyen City,7,110,97,13,2
2022-06-21,Thai Nguyen,Thai Nguyen City,8,166,147,19,2
2022-06-21,Thai Nguyen,Thai Nguyen City,9,160,146,14,1
2022-06-21,Thai Nguyen,Thai Nguyen City,10,268,240,28,4
2022-06-21,Thai Nguyen,Thai Nguyen City,11,455,392,63,20
2022-06-21,Thai Nguyen,Thai Nguyen City,12,264,244,20,2
2022-06-21,Thai Nguyen,Thai Nguyen City,13,160,146,14,0
2022-06-21,Thai Nguyen,Thai Nguyen City,14,210,171,39,4
2022-06-21,Thai Nguyen,Thai Nguyen City,15,210,190,20,1
2022-06-21,Thai Nguyen,Thai Nguyen City,16,140,127,13,2
2022-06-21,Thai Nguyen,Thai Nguyen City,17,168,155,13,1
2022-06-21,Thai Nguyen,Thai Nguyen City,18,174,159,15,0
2022-06-21,Thai Nguyen,Thai Nguyen City,19,271,248,23,3
2022-06-21,Thai Nguyen,Thai Nguyen City,20,205,177,28,2
2022-06-21,Thai Nguyen,Thai Nguyen City,21,149,124,25,3
2022-06-21,Thai Nguyen,Thai Nguyen City,22,1,1,0,0
2022-06-21,Vung Tau,Ba Ria City,7,1,0,1,0
2022-06-21,Vung Tau,Ba Ria City,8,3,3,0,0
2022-06-21,Vung Tau,Ba Ria City,9,7,3,4,2
2022-06-21,Vung Tau,Ba Ria City,10,3,2,1,0
2022-06-21,Vung Tau,Ba Ria City,11,11,2,9,8
2022-06-21,Vung Tau,Ba Ria City,12,9,0,9,8
2022-06-21,Vung Tau,Ba Ria City,13,21,1,20,16
2022-06-21,Vung Tau,Ba Ria City,14,11,6,5,4
2022-06-21,Vung Tau,Ba Ria City,15,7,1,6,6
2022-06-21,Vung Tau,Ba Ria City,16,6,2,4,4
2022-06-21,Vung Tau,Ba Ria City,17,10,2,8,8
2022-06-21,Vung Tau,Ba Ria City,19,2,0,2,2
2022-06-21,Vung Tau,Ba Ria City,20,3,0,3,2
2022-06-21,Vung Tau,Chau Duc,9,1,0,1,1
2022-06-21,Vung Tau,Tan Thanh,11,1,0,1,0
2022-06-21,Vung Tau,Vung Tau City,2,2,2,0,0
2022-06-21,Vung Tau,Vung Tau City,4,1,0,1,0
2022-06-21,Vung Tau,Vung Tau City,6,30,24,6,0
2022-06-21,Vung Tau,Vung Tau City,7,124,110,14,2
2022-06-21,Vung Tau,Vung Tau City,8,210,196,14,2
2022-06-21,Vung Tau,Vung Tau City,9,219,198,21,0
2022-06-21,Vung Tau,Vung Tau City,10,243,220,23,3
2022-06-21,Vung Tau,Vung Tau City,11,409,380,29,4
2022-06-21,Vung Tau,Vung Tau City,12,316,299,17,0
2022-06-21,Vung Tau,Vung Tau City,13,260,235,25,1
2022-06-21,Vung Tau,Vung Tau City,14,243,220,23,2
2022-06-21,Vung Tau,Vung Tau City,15,223,206,17,4
2022-06-21,Vung Tau,Vung Tau City,16,204,189,15,0
2022-06-21,Vung Tau,Vung Tau City,17,232,213,19,0
2022-06-21,Vung Tau,Vung Tau City,18,302,276,26,4
2022-06-21,Vung Tau,Vung Tau City,19,290,267,23,4
2022-06-21,Vung Tau,Vung Tau City,20,166,154,12,2
2022-06-21,Vung Tau,Vung Tau City,21,94,76,18,7
2022-06-21,Vung Tau,Vung Tau City,22,2,1,1,1
2022-06-22,Bac Ninh,Bác Ninh City,1,1,0,1,0
2022-06-22,Bac Ninh,Bác Ninh City,4,1,1,0,0
2022-06-22,Bac Ninh,Bác Ninh City,6,3,3,0,0
2022-06-22,Bac Ninh,Bác Ninh City,7,84,76,8,3
2022-06-22,Bac Ninh,Bác Ninh City,8,133,129,4,0
2022-06-22,Bac Ninh,Bác Ninh City,9,115,105,10,1
2022-06-22,Bac Ninh,Bác Ninh City,10,210,198,12,0
2022-06-22,Bac Ninh,Bác Ninh City,11,394,340,54,20
2022-06-22,Bac Ninh,Bác Ninh City,12,236,218,18,2
2022-06-22,Bac Ninh,Bác Ninh City,13,171,160,11,0
2022-06-22,Bac Ninh,Bác Ninh City,14,173,133,40,15
2022-06-22,Bac Ninh,Bác Ninh City,15,137,126,11,3
2022-06-22,Bac Ninh,Bác Ninh City,16,106,101,5,1
2022-06-22,Bac Ninh,Bác Ninh City,17,107,100,7,1
2022-06-22,Bac Ninh,Bác Ninh City,18,159,148,11,2
2022-06-22,Bac Ninh,Bác Ninh City,19,190,169,21,5
2022-06-22,Bac Ninh,Bác Ninh City,20,132,113,19,12
2022-06-22,Bac Ninh,Bác Ninh City,21,120,78,42,23
2022-06-22,Bac Ninh,Bác Ninh City,22,2,2,0,0
2022-06-22,Bac Ninh,Que Vo,7,1,1,0,0
2022-06-22,Bac Ninh,Que Vo,8,2,0,2,2
2022-06-22,Bac Ninh,Que Vo,9,3,2,1,1
2022-06-22,Bac Ninh,Que Vo,10,2,1,1,0
2022-06-22,Bac Ninh,Que Vo,13,4,2,2,2
2022-06-22,Bac Ninh,Que Vo,14,1,0,1,1
2022-06-22,Bac Ninh,Que Vo,15,2,1,1,1
2022-06-22,Bac Ninh,Que Vo,17,1,1,0,0
2022-06-22,Bac Ninh,Que Vo,19,1,0,1,1
2022-06-22,Bac Ninh,Tien Du,10,1,0,1,1
2022-06-22,Bac Ninh,Tien Du,11,1,0,1,1
2022-06-22,Bac Ninh,Tien Du,12,1,0,1,1
2022-06-22,Bac Ninh,Tien Du,13,1,0,1,1
2022-06-22,Bac Ninh,Tien Du,14,1,0,1,1
2022-06-22,Bac Ninh,Tien Du,15,2,0,2,2
2022-06-22,Bac Ninh,Tien Du,16,3,0,3,3
2022-06-22,Bac Ninh,Tien Du,17,4,0,4,4
2022-06-22,Bac Ninh,Tien Du,18,1,0,1,0
2022-06-22,Bac Ninh,Tien Du,19,3,0,3,1
2022-06-22,Bac Ninh,Tien Du,20,3,0,3,3
2022-06-22,Bac Ninh,Tien Du,21,2,0,2,2
2022-06-22,Bac Ninh,Tu Son,11,5,0,5,5
2022-06-22,Bac Ninh,Tu Son,13,3,0,3,3
2022-06-22,Bac Ninh,Tu Son,14,3,0,3,3
2022-06-22,Bac Ninh,Tu Son,16,1,0,1,1
2022-06-22,Bac Ninh,Tu Son,17,1,0,1,1
2022-06-22,Binh Duong,Ben Cat,8,1,0,1,1
2022-06-22,Binh Duong,Ben Cat,11,1,0,1,1
2022-06-22,Binh Duong,Ben Cat,13,3,0,3,2
2022-06-22,Binh Duong,Ben Cat,14,6,0,6,6
2022-06-22,Binh Duong,Ben Cat,15,2,0,2,2
2022-06-22,Binh Duong,Ben Cat,16,1,0,1,1
2022-06-22,Binh Duong,Ben Cat,17,2,0,2,2
2022-06-22,Binh Duong,Ben Cat,18,2,0,2,2
2022-06-22,Binh Duong,Ben Cat,19,2,0,2,2
2022-06-22,Binh Duong,Di An,6,3,0,3,3
2022-06-22,Binh Duong,Di An,7,5,3,2,2
2022-06-22,Binh Duong,Di An,8,13,7,6,5
2022-06-22,Binh Duong,Di An,9,25,15,10,4
2022-06-22,Binh Duong,Di An,10,42,28,14,6
2022-06-22,Binh Duong,Di An,11,30,22,8,5
2022-06-22,Binh Duong,Di An,12,45,32,13,8
2022-06-22,Binh Duong,Di An,13,35,30,5,4
2022-06-22,Binh Duong,Di An,14,39,18,21,18
2022-06-22,Binh Duong,Di An,15,17,3,14,9
2022-06-22,Binh Duong,Di An,16,20,8,12,7
2022-06-22,Binh Duong,Di An,17,34,25,9,6
2022-06-22,Binh Duong,Di An,18,32,24,8,2
2022-06-22,Binh Duong,Di An,19,36,20,16,8
2022-06-22,Binh Duong,Di An,20,24,11,13,6
2022-06-22,Binh Duong,Di An,21,17,5,12,6
2022-06-22,Binh Duong,Tan Uyen,9,1,0,1,1
2022-06-22,Binh Duong,Tan Uyen,10,4,3,1,1
2022-06-22,Binh Duong,Tan Uyen,11,5,0,5,4
2022-06-22,Binh Duong,Tan Uyen,12,6,2,4,2
2022-06-22,Binh Duong,Tan Uyen,13,3,3,0,0
2022-06-22,Binh Duong,Tan Uyen,14,2,1,1,1
2022-06-22,Binh Duong,Tan Uyen,15,1,0,1,1
2022-06-22,Binh Duong,Tan Uyen,17,3,1,2,2
2022-06-22,Binh Duong,Tan Uyen,18,1,0,1,1
2022-06-22,Binh Duong,Tan Uyen,19,2,2,0,0
2022-06-22,Binh Duong,Tan Uyen,20,4,3,1,0
2022-06-22,Binh Duong,Tan Uyen,21,1,0,1,1
2022-06-22,Binh Duong,Thu Dau Mot Town,0,1,1,0,0
2022-06-22,Binh Duong,Thu Dau Mot Town,5,1,1,0,0
2022-06-22,Binh Duong,Thu Dau Mot Town,6,42,37,5,5
2022-06-22,Binh Duong,Thu Dau Mot Town,7,113,106,7,2
2022-06-22,Binh Duong,Thu Dau Mot Town,8,200,191,9,2
2022-06-22,Binh Duong,Thu Dau Mot Town,9,252,243,9,0
2022-06-22,Binh Duong,Thu Dau Mot Town,10,386,366,20,3
2022-06-22,Binh Duong,Thu Dau Mot Town,11,696,644,52,15
2022-06-22,Binh Duong,Thu Dau Mot Town,12,514,475,39,7
2022-06-22,Binh Duong,Thu Dau Mot Town,13,479,460,19,3
2022-06-22,Binh Duong,Thu Dau Mot Town,14,402,367,35,7
2022-06-22,Binh Duong,Thu Dau Mot Town,15,257,233,24,6
2022-06-22,Binh Duong,Thu Dau Mot Town,16,326,288,38,8
2022-06-22,Binh Duong,Thu Dau Mot Town,17,464,416,48,9
2022-06-22,Binh Duong,Thu Dau Mot Town,18,403,378,25,8
2022-06-22,Binh Duong,Thu Dau Mot Town,19,393,360,33,8
2022-06-22,Binh Duong,Thu Dau Mot Town,20,262,237,25,3
2022-06-22,Binh Duong,Thu Dau Mot Town,21,113,106,7,0
2022-06-22,Binh Duong,Thu Dau Mot Town,22,1,0,1,0
2022-06-22,Binh Duong,Thuan An,6,3,1,2,1
2022-06-22,Binh Duong,Thuan An,7,6,4,2,2
2022-06-22,Binh Duong,Thuan An,8,24,18,6,3
2022-06-22,Binh Duong,Thuan An,9,30,23,7,0
2022-06-22,Binh Duong,Thuan An,10,80,66,14,10
2022-06-22,Binh Duong,Thuan An,11,82,71,11,4
2022-06-22,Binh Duong,Thuan An,12,80,67,13,6
2022-06-22,Binh Duong,Thuan An,13,83,67,16,8
2022-06-22,Binh Duong,Thuan An,14,61,37,24,20
2022-06-22,Binh Duong,Thuan An,15,38,23,15,11
2022-06-22,Binh Duong,Thuan An,16,30,24,6,3
2022-06-22,Binh Duong,Thuan An,17,42,32,10,5
2022-06-22,Binh Duong,Thuan An,18,52,38,14,7
2022-06-22,Binh Duong,Thuan An,19,44,42,2,1
2022-06-22,Binh Duong,Thuan An,20,45,33,12,8
2022-06-22,Binh Duong,Thuan An,21,19,14,5,3
2022-06-22,Can Tho City,Binh Thuy District,7,1,1,0,0
2022-06-22,Can Tho City,Binh Thuy District,8,7,7,0,0
2022-06-22,Can Tho City,Binh Thuy District,9,4,4,0,0
2022-06-22,Can Tho City,Binh Thuy District,10,5,5,0,0
2022-06-22,Can Tho City,Binh Thuy District,11,10,10,0,0
2022-06-22,Can Tho City,Binh Thuy District,12,10,7,3,2
2022-06-22,Can Tho City,Binh Thuy District,13,16,15,1,0
2022-06-22,Can Tho City,Binh Thuy District,14,9,9,0,0
2022-06-22,Can Tho City,Binh Thuy District,15,8,8,0,0
2022-06-22,Can Tho City,Binh Thuy District,16,12,12,0,0
2022-06-22,Can Tho City,Binh Thuy District,17,18,15,3,0
2022-06-22,Can Tho City,Binh Thuy District,18,13,13,0,0
2022-06-22,Can Tho City,Binh Thuy District,19,23,21,2,1
2022-06-22,Can Tho City,Binh Thuy District,20,6,4,2,0
2022-06-22,Can Tho City,Binh Thuy District,21,6,2,4,4
2022-06-22,Can Tho City,Cai Rang District,6,3,2,1,1
2022-06-22,Can Tho City,Cai Rang District,7,4,3,1,1
2022-06-22,Can Tho City,Cai Rang District,8,15,10,5,3
2022-06-22,Can Tho City,Cai Rang District,9,4,3,1,0
2022-06-22,Can Tho City,Cai Rang District,10,8,7,1,0
2022-06-22,Can Tho City,Cai Rang District,11,11,11,0,0
2022-06-22,Can Tho City,Cai Rang District,12,14,14,0,0
2022-06-22,Can Tho City,Cai Rang District,13,16,16,0,0
2022-06-22,Can Tho City,Cai Rang District,14,3,3,0,0
2022-06-22,Can Tho City,Cai Rang District,15,6,4,2,1
2022-06-22,Can Tho City,Cai Rang District,16,12,8,4,0
2022-06-22,Can Tho City,Cai Rang District,17,9,9,0,0
2022-06-22,Can Tho City,Cai Rang District,18,9,9,0,0
2022-06-22,Can Tho City,Cai Rang District,19,14,14,0,0
2022-06-22,Can Tho City,Cai Rang District,20,7,6,1,0
2022-06-22,Can Tho City,Cai Rang District,21,6,5,1,1
2022-06-22,Can Tho City,Ninh Kieu District,3,1,0,1,0
2022-06-22,Can Tho City,Ninh Kieu District,4,1,0,1,0
2022-06-22,Can Tho City,Ninh Kieu District,5,4,1,3,0
2022-06-22,Can Tho City,Ninh Kieu District,6,42,35,7,5
2022-06-22,Can Tho City,Ninh Kieu District,7,139,133,6,1
2022-06-22,Can Tho City,Ninh Kieu District,8,213,199,14,0
2022-06-22,Can Tho City,Ninh Kieu District,9,316,300,16,0
2022-06-22,Can Tho City,Ninh Kieu District,10,524,500,24,1
2022-06-22,Can Tho City,Ninh Kieu District,11,813,784,29,2
2022-06-22,Can Tho City,Ninh Kieu District,12,639,610,29,0
2022-06-22,Can Tho City,Ninh Kieu District,13,520,493,27,0
2022-06-22,Can Tho City,Ninh Kieu District,14,449,427,22,0
2022-06-22,Can Tho City,Ninh Kieu District,15,330,312,18,0
2022-06-22,Can Tho City,Ninh Kieu District,16,454,437,17,0
2022-06-22,Can Tho City,Ninh Kieu District,17,558,535,23,0
2022-06-22,Can Tho City,Ninh Kieu District,18,578,556,22,0
2022-06-22,Can Tho City,Ninh Kieu District,19,457,437,20,0
2022-06-22,Can Tho City,Ninh Kieu District,20,374,354,20,0
2022-06-22,Can Tho City,Ninh Kieu District,21,213,193,20,0
2022-06-22,Can Tho City,Ninh Kieu District,23,1,0,1,0
2022-06-22,Dong Nai,Bien Hoa City,0,1,1,0,0
2022-06-22,Dong Nai,Bien Hoa City,1,2,1,1,0
2022-06-22,Dong Nai,Bien Hoa City,2,1,0,1,0
2022-06-22,Dong Nai,Bien Hoa City,3,1,0,1,0
2022-06-22,Dong Nai,Bien Hoa City,5,3,2,1,1
2022-06-22,Dong Nai,Bien Hoa City,6,42,32,10,5
2022-06-22,Dong Nai,Bien Hoa City,7,167,145,22,10
2022-06-22,Dong Nai,Bien Hoa City,8,330,291,39,2
2022-06-22,Dong Nai,Bien Hoa City,9,466,432,34,8
2022-06-22,Dong Nai,Bien Hoa City,10,736,663,73,11
2022-06-22,Dong Nai,Bien Hoa City,11,1091,973,118,32
2022-06-22,Dong Nai,Bien Hoa City,12,833,769,64,10
2022-06-22,Dong Nai,Bien Hoa City,13,832,790,42,11
2022-06-22,Dong Nai,Bien Hoa City,14,737,674,63,17
2022-06-22,Dong Nai,Bien Hoa City,15,508,438,70,28
2022-06-22,Dong Nai,Bien Hoa City,16,601,547,54,9
2022-06-22,Dong Nai,Bien Hoa City,17,655,603,52,9
2022-06-22,Dong Nai,Bien Hoa City,18,710,657,53,8
2022-06-22,Dong Nai,Bien Hoa City,19,651,574,77,20
2022-06-22,Dong Nai,Bien Hoa City,20,521,458,63,8
2022-06-22,Dong Nai,Bien Hoa City,21,225,166,59,24
2022-06-22,Dong Nai,Bien Hoa City,22,2,0,2,0
2022-06-22,Dong Nai,Bien Hoa City,23,2,0,2,0
2022-06-22,Dong Nai,Long Khanh,16,1,0,1,1
2022-06-22,Dong Nai,Long Khanh,18,1,0,1,1
2022-06-22,Dong Nai,Long Khanh,19,1,0,1,1
2022-06-22,Dong Nai,Long Thanh,4,1,0,1,1
2022-06-22,Dong Nai,Long Thanh,9,1,0,1,1
2022-06-22,Dong Nai,Long Thanh,12,1,0,1,1
2022-06-22,Dong Nai,Long Thanh,13,1,0,1,1
2022-06-22,Dong Nai,Long Thanh,14,1,0,1,1
2022-06-22,Dong Nai,Nhon trach,10,1,0,1,1
2022-06-22,Dong Nai,Nhon trach,13,1,0,1,1
2022-06-22,Dong Nai,Nhon trach,14,1,0,1,1
2022-06-22,Dong Nai,Trang Bom,15,1,0,1,1
2022-06-22,Dong Nai,Trang Bom,16,1,0,1,1
2022-06-22,Dong Nai,Trang Bom,20,1,0,1,1
2022-06-22,Dong Nai,Vinh Cuu,11,1,1,0,0
2022-06-22,Hai Phong City,An Duong,3,1,0,1,1
2022-06-22,Hai Phong City,An Duong,7,2,0,2,0
2022-06-22,Hai Phong City,An Duong,8,1,1,0,0
2022-06-22,Hai Phong City,An Duong,9,3,2,1,0
2022-06-22,Hai Phong City,An Duong,10,3,2,1,1
2022-06-22,Hai Phong City,An Duong,11,2,2,0,0
2022-06-22,Hai Phong City,An Duong,12,5,3,2,2
2022-06-22,Hai Phong City,An Duong,13,5,3,2,1
2022-06-22,Hai Phong City,An Duong,14,9,3,6,2
2022-06-22,Hai Phong City,An Duong,15,2,1,1,1
2022-06-22,Hai Phong City,An Duong,16,2,2,0,0
2022-06-22,Hai Phong City,An Duong,19,1,1,0,0
2022-06-22,Hai Phong City,An Duong,20,2,0,2,1
2022-06-22,Hai Phong City,An Duong,21,4,0,4,2
2022-06-22,Hai Phong City,Do Son District,9,1,0,1,1
2022-06-22,Hai Phong City,Do Son District,11,1,0,1,1
2022-06-22,Hai Phong City,Do Son District,12,1,0,1,1
2022-06-22,Hai Phong City,Duong Kinh District,17,1,1,0,0
2022-06-22,Hai Phong City,Hai An District,7,11,4,7,5
2022-06-22,Hai Phong City,Hai An District,8,25,18,7,4
2022-06-22,Hai Phong City,Hai An District,9,19,17,2,0
2022-06-22,Hai Phong City,Hai An District,10,42,34,8,3
2022-06-22,Hai Phong City,Hai An District,11,50,49,1,1
2022-06-22,Hai Phong City,Hai An District,12,26,23,3,1
2022-06-22,Hai Phong City,Hai An District,13,18,16,2,2
2022-06-22,Hai Phong City,Hai An District,14,22,16,6,4
2022-06-22,Hai Phong City,Hai An District,15,18,14,4,2
2022-06-22,Hai Phong City,Hai An District,16,20,17,3,3
2022-06-22,Hai Phong City,Hai An District,17,19,16,3,1
2022-06-22,Hai Phong City,Hai An District,18,15,14,1,0
2022-06-22,Hai Phong City,Hai An District,19,20,14,6,0
2022-06-22,Hai Phong City,Hai An District,20,12,9,3,1
2022-06-22,Hai Phong City,Hai An District,21,12,9,3,2
2022-06-22,Hai Phong City,Hong Bang District,7,16,10,6,4
2022-06-22,Hai Phong City,Hong Bang District,8,34,28,6,2
2022-06-22,Hai Phong City,Hong Bang District,9,35,31,4,1
2022-06-22,Hai Phong City,Hong Bang District,10,65,59,6,0
2022-06-22,Hai Phong City,Hong Bang District,11,136,114,22,5
2022-06-22,Hai Phong City,Hong Bang District,12,78,70,8,2
2022-06-22,Hai Phong City,Hong Bang District,13,55,46,9,3
2022-06-22,Hai Phong City,Hong Bang District,14,50,41,9,2
2022-06-22,Hai Phong City,Hong Bang District,15,39,37,2,1
2022-06-22,Hai Phong City,Hong Bang District,16,33,30,3,0
2022-06-22,Hai Phong City,Hong Bang District,17,40,35,5,0
2022-06-22,Hai Phong City,Hong Bang District,18,46,39,7,1
2022-06-22,Hai Phong City,Hong Bang District,19,54,45,9,2
2022-06-22,Hai Phong City,Hong Bang District,20,32,25,7,2
2022-06-22,Hai Phong City,Hong Bang District,21,15,12,3,1
2022-06-22,Hai Phong City,Kien An District,7,7,5,2,0
2022-06-22,Hai Phong City,Kien An District,8,11,6,5,3
2022-06-22,Hai Phong City,Kien An District,9,6,5,1,0
2022-06-22,Hai Phong City,Kien An District,10,14,12,2,0
2022-06-22,Hai Phong City,Kien An District,11,19,15,4,2
2022-06-22,Hai Phong City,Kien An District,12,9,7,2,1
2022-06-22,Hai Phong City,Kien An District,13,6,4,2,0
2022-06-22,Hai Phong City,Kien An District,14,10,7,3,1
2022-06-22,Hai Phong City,Kien An District,15,7,7,0,0
2022-06-22,Hai Phong City,Kien An District,16,6,5,1,0
2022-06-22,Hai Phong City,Kien An District,17,8,6,2,0
2022-06-22,Hai Phong City,Kien An District,18,9,5,4,2
2022-06-22,Hai Phong City,Kien An District,19,10,9,1,0
2022-06-22,Hai Phong City,Kien An District,20,9,7,2,0
2022-06-22,Hai Phong City,Kien An District,21,4,3,1,0
2022-06-22,Hai Phong City,Le Chan District,0,1,0,1,0
2022-06-22,Hai Phong City,Le Chan District,2,1,1,0,0
2022-06-22,Hai Phong City,Le Chan District,3,1,0,1,0
2022-06-22,Hai Phong City,Le Chan District,5,1,1,0,0
2022-06-22,Hai Phong City,Le Chan District,7,47,38,9,4
2022-06-22,Hai Phong City,Le Chan District,8,90,82,8,0
2022-06-22,Hai Phong City,Le Chan District,9,93,83,10,0
2022-06-22,Hai Phong City,Le Chan District,10,199,177,22,2
2022-06-22,Hai Phong City,Le Chan District,11,351,317,34,8
2022-06-22,Hai Phong City,Le Chan District,12,238,208,30,3
2022-06-22,Hai Phong City,Le Chan District,13,105,87,18,1
2022-06-22,Hai Phong City,Le Chan District,14,163,138,25,4
2022-06-22,Hai Phong City,Le Chan District,15,175,155,20,3
2022-06-22,Hai Phong City,Le Chan District,16,137,127,10,2
2022-06-22,Hai Phong City,Le Chan District,17,161,148,13,1
2022-06-22,Hai Phong City,Le Chan District,18,184,163,21,5
2022-06-22,Hai Phong City,Le Chan District,19,184,155,29,4
2022-06-22,Hai Phong City,Le Chan District,20,147,120,27,0
2022-06-22,Hai Phong City,Le Chan District,21,52,45,7,2
2022-06-22,Hai Phong City,Le Chan District,22,1,0,1,1
2022-06-22,Hai Phong City,Le Chan District,23,1,0,1,0
2022-06-22,Hai Phong City,Ngo Quyen District,0,3,2,1,0
2022-06-22,Hai Phong City,Ngo Quyen District,2,1,0,1,0
2022-06-22,Hai Phong City,Ngo Quyen District,6,1,1,0,0
2022-06-22,Hai Phong City,Ngo Quyen District,7,28,15,13,3
2022-06-22,Hai Phong City,Ngo Quyen District,8,93,81,12,5
2022-06-22,Hai Phong City,Ngo Quyen District,9,90,74,16,0
2022-06-22,Hai Phong City,Ngo Quyen District,10,158,143,15,3
2022-06-22,Hai Phong City,Ngo Quyen District,11,295,261,34,9
2022-06-22,Hai Phong City,Ngo Quyen District,12,179,162,17,4
2022-06-22,Hai Phong City,Ngo Quyen District,13,102,93,9,0
2022-06-22,Hai Phong City,Ngo Quyen District,14,131,121,10,2
2022-06-22,Hai Phong City,Ngo Quyen District,15,158,136,22,7
2022-06-22,Hai Phong City,Ngo Quyen District,16,105,92,13,0
2022-06-22,Hai Phong City,Ngo Quyen District,17,120,109,11,2
2022-06-22,Hai Phong City,Ngo Quyen District,18,154,139,15,2
2022-06-22,Hai Phong City,Ngo Quyen District,19,164,148,16,1
2022-06-22,Hai Phong City,Ngo Quyen District,20,130,117,13,0
2022-06-22,Hai Phong City,Ngo Quyen District,21,72,59,13,3
2022-06-22,Hai Phong City,Thuy Nguyen,9,2,0,2,2
2022-06-22,Hai Phong City,Thuy Nguyen,10,2,0,2,2
2022-06-22,Hai Phong City,Thuy Nguyen,11,1,0,1,1
2022-06-22,Hai Phong City,Thuy Nguyen,12,2,0,2,2
2022-06-22,Hai Phong City,Thuy Nguyen,14,1,0,1,1
2022-06-22,Hai Phong City,Thuy Nguyen,15,3,0,3,3
2022-06-22,Hai Phong City,Thuy Nguyen,16,1,0,1,0
2022-06-22,Hai Phong City,Thuy Nguyen,17,2,0,2,2
2022-06-22,Hai Phong City,Thuy Nguyen,20,1,0,1,1
2022-06-22,Hue City,Hue City,0,7,2,5,0
2022-06-22,Hue City,Hue City,1,1,1,0,0
2022-06-22,Hue City,Hue City,2,2,1,1,0
2022-06-22,Hue City,Hue City,4,2,1,1,1
2022-06-22,Hue City,Hue City,5,6,6,0,0
2022-06-22,Hue City,Hue City,6,88,71,17,6
2022-06-22,Hue City,Hue City,7,195,183,12,0
2022-06-22,Hue City,Hue City,8,324,297,27,1
2022-06-22,Hue City,Hue City,9,255,234,21,1
2022-06-22,Hue City,Hue City,10,460,430,30,0
2022-06-22,Hue City,Hue City,11,915,837,78,9
2022-06-22,Hue City,Hue City,12,607,565,42,2
2022-06-22,Hue City,Hue City,13,347,323,24,0
2022-06-22,Hue City,Hue City,14,391,365,26,2
2022-06-22,Hue City,Hue City,15,406,379,27,2
2022-06-22,Hue City,Hue City,16,331,307,24,2
2022-06-22,Hue City,Hue City,17,444,401,43,1
2022-06-22,Hue City,Hue City,18,508,463,45,3
2022-06-22,Hue City,Hue City,19,521,478,43,2
2022-06-22,Hue City,Hue City,20,397,350,47,5
2022-06-22,Hue City,Hue City,21,303,215,88,38
2022-06-22,Hue City,Hue City,22,2,1,1,0
2022-06-22,Hue City,Huong Thuy,6,1,1,0,0
2022-06-22,Hue City,Huong Thuy,9,2,0,2,1
2022-06-22,Hue City,Huong Thuy,10,2,1,1,1
2022-06-22,Hue City,Huong Thuy,11,7,4,3,0
2022-06-22,Hue City,Huong Thuy,14,1,1,0,0
2022-06-22,Hue City,Huong Thuy,15,3,2,1,0
2022-06-22,Hue City,Huong Thuy,16,1,1,0,0
2022-06-22,Hue City,Huong Thuy,17,3,3,0,0
2022-06-22,Hue City,Huong Thuy,18,2,2,0,0
2022-06-22,Hue City,Huong Thuy,19,1,1,0,0
2022-06-22,Hue City,Huong Thuy,20,3,1,2,1
2022-06-22,Hue City,Huong Tra,8,1,1,0,0
2022-06-22,Hue City,Huong Tra,10,1,1,0,0
2022-06-22,Hue City,Huong Tra,18,1,0,1,0
2022-06-22,Hue City,Huong Tra,19,2,0,2,2
2022-06-22,Hue City,Huong Tra,20,2,2,0,0
2022-06-22,Hue City,Phong Dien,15,1,0,1,0
2022-06-22,Hue City,Phu Vang,6,3,0,3,1
2022-06-22,Hue City,Phu Vang,7,2,0,2,1
2022-06-22,Hue City,Phu Vang,8,4,2,2,1
2022-06-22,Hue City,Phu Vang,10,1,1,0,0
2022-06-22,Hue City,Phu Vang,11,4,4,0,0
2022-06-22,Hue City,Phu Vang,12,4,4,0,0
2022-06-22,Hue City,Phu Vang,13,1,0,1,1
2022-06-22,Hue City,Phu Vang,14,2,1,1,1
2022-06-22,Hue City,Phu Vang,15,1,1,0,0
2022-06-22,Hue City,Phu Vang,16,1,0,1,1
2022-06-22,Hue City,Phu Vang,17,1,0,1,0
2022-06-22,Hue City,Phu Vang,18,1,1,0,0
2022-06-22,Hue City,Phu Vang,19,1,1,0,0
2022-06-22,Hue City,Phu Vang,20,2,1,1,1
2022-06-22,Hue City,Phu Vang,21,1,1,0,0
2022-06-22,Khanh Hoa,Cam Ranh City,19,1,0,1,1
2022-06-22,Khanh Hoa,Dien Khanh,9,2,0,2,2
2022-06-22,Khanh Hoa,Dien Khanh,10,3,0,3,3
2022-06-22,Khanh Hoa,Dien Khanh,14,2,0,2,2
2022-06-22,Khanh Hoa,Dien Khanh,17,1,0,1,1
2022-06-22,Khanh Hoa,Dien Khanh,18,1,0,1,1
2022-06-22,Khanh Hoa,Dien Khanh,19,1,0,1,1
2022-06-22,Khanh Hoa,Nha Trang City,1,2,1,1,0
2022-06-22,Khanh Hoa,Nha Trang City,4,1,0,1,0
2022-06-22,Khanh Hoa,Nha Trang City,5,2,2,0,0
2022-06-22,Khanh Hoa,Nha Trang City,6,47,37,10,3
2022-06-22,Khanh Hoa,Nha Trang City,7,156,148,8,2
2022-06-22,Khanh Hoa,Nha Trang City,8,205,191,14,4
2022-06-22,Khanh Hoa,Nha Trang City,9,198,185,13,4
2022-06-22,Khanh Hoa,Nha Trang City,10,199,191,8,0
2022-06-22,Khanh Hoa,Nha Trang City,11,407,369,38,2
2022-06-22,Khanh Hoa,Nha Trang City,12,321,297,24,1
2022-06-22,Khanh Hoa,Nha Trang City,13,287,271,16,1
2022-06-22,Khanh Hoa,Nha Trang City,14,294,271,23,3
2022-06-22,Khanh Hoa,Nha Trang City,15,214,205,9,1
2022-06-22,Khanh Hoa,Nha Trang City,16,156,140,16,0
2022-06-22,Khanh Hoa,Nha Trang City,17,201,181,20,0
2022-06-22,Khanh Hoa,Nha Trang City,18,233,217,16,0
2022-06-22,Khanh Hoa,Nha Trang City,19,242,226,16,4
2022-06-22,Khanh Hoa,Nha Trang City,20,197,177,20,1
2022-06-22,Khanh Hoa,Nha Trang City,21,105,81,24,2
2022-06-22,Khanh Hoa,Nha Trang City,22,1,0,1,1
2022-06-22,Khanh Hoa,Nha Trang City,23,2,2,0,0
2022-06-22,Lam Dong,Da Lat City,3,1,0,1,1
2022-06-22,Lam Dong,Da Lat City,5,1,1,0,0
2022-06-22,Lam Dong,Da Lat City,6,4,2,2,2
2022-06-22,Lam Dong,Da Lat City,7,45,23,22,20
2022-06-22,Lam Dong,Da Lat City,8,80,63,17,11
2022-06-22,Lam Dong,Da Lat City,9,105,76,29,12
2022-06-22,Lam Dong,Da Lat City,10,77,68,9,2
2022-06-22,Lam Dong,Da Lat City,11,140,99,41,19
2022-06-22,Lam Dong,Da Lat City,12,140,83,57,49
2022-06-22,Lam Dong,Da Lat City,13,114,69,45,30
2022-06-22,Lam Dong,Da Lat City,14,250,102,148,127
2022-06-22,Lam Dong,Da Lat City,15,130,96,34,22
2022-06-22,Lam Dong,Da Lat City,16,95,76,19,14
2022-06-22,Lam Dong,Da Lat City,17,129,90,39,26
2022-06-22,Lam Dong,Da Lat City,18,157,95,62,51
2022-06-22,Lam Dong,Da Lat City,19,183,96,87,64
2022-06-22,Lam Dong,Da Lat City,20,137,68,69,50
2022-06-22,Lam Dong,Da Lat City,21,86,39,47,38
2022-06-22,Lam Dong,Da Lat City,22,1,0,1,0
2022-06-22,Nghe An,Hung Nguyen,14,1,0,1,1
2022-06-22,Nghe An,Hung Nguyen,17,1,0,1,1
2022-06-22,Nghe An,Vinh City,0,2,1,1,0
2022-06-22,Nghe An,Vinh City,5,1,1,0,0
2022-06-22,Nghe An,Vinh City,6,8,6,2,1
2022-06-22,Nghe An,Vinh City,7,179,154,25,8
2022-06-22,Nghe An,Vinh City,8,183,160,23,2
2022-06-22,Nghe An,Vinh City,9,178,151,27,2
2022-06-22,Nghe An,Vinh City,10,251,225,26,10
2022-06-22,Nghe An,Vinh City,11,405,351,54,16
2022-06-22,Nghe An,Vinh City,12,244,215,29,2
2022-06-22,Nghe An,Vinh City,13,144,129,15,0
2022-06-22,Nghe An,Vinh City,14,193,173,20,7
2022-06-22,Nghe An,Vinh City,15,203,176,27,3
2022-06-22,Nghe An,Vinh City,16,130,116,14,0
2022-06-22,Nghe An,Vinh City,17,133,113,20,1
2022-06-22,Nghe An,Vinh City,18,193,163,30,12
2022-06-22,Nghe An,Vinh City,19,197,159,38,11
2022-06-22,Nghe An,Vinh City,20,158,132,26,9
2022-06-22,Nghe An,Vinh City,21,92,61,31,8
2022-06-22,Quang Nam,Hoi An City,6,3,0,3,3
2022-06-22,Quang Nam,Hoi An City,7,13,7,6,3
2022-06-22,Quang Nam,Hoi An City,8,14,11,3,2
2022-06-22,Quang Nam,Hoi An City,9,28,23,5,2
2022-06-22,Quang Nam,Hoi An City,10,23,18,5,2
2022-06-22,Quang Nam,Hoi An City,11,55,44,11,5
2022-06-22,Quang Nam,Hoi An City,12,35,31,4,2
2022-06-22,Quang Nam,Hoi An City,13,31,27,4,0
2022-06-22,Quang Nam,Hoi An City,14,28,25,3,2
2022-06-22,Quang Nam,Hoi An City,15,34,27,7,1
2022-06-22,Quang Nam,Hoi An City,16,32,22,10,7
2022-06-22,Quang Nam,Hoi An City,17,32,24,8,1
2022-06-22,Quang Nam,Hoi An City,18,54,47,7,3
2022-06-22,Quang Nam,Hoi An City,19,67,56,11,7
2022-06-22,Quang Nam,Hoi An City,20,35,27,8,1
2022-06-22,Quang Nam,Hoi An City,21,24,12,12,11
2022-06-22,Quang Nam,Tam Ky City,8,1,0,1,1
2022-06-22,Quang Ninh,Cam Pha City,11,3,0,3,3
2022-06-22,Quang Ninh,Cam Pha City,12,1,0,1,1
2022-06-22,Quang Ninh,Cam Pha City,13,1,0,1,1
2022-06-22,Quang Ninh,Cam Pha City,15,1,0,1,0
2022-06-22,Quang Ninh,Cam Pha City,20,1,0,1,0
2022-06-22,Quang Ninh,Ha Long City,7,26,21,5,2
2022-06-22,Quang Ninh,Ha Long City,8,60,45,15,10
2022-06-22,Quang Ninh,Ha Long City,9,76,61,15,9
2022-06-22,Quang Ninh,Ha Long City,10,89,65,24,9
2022-06-22,Quang Ninh,Ha Long City,11,131,104,27,11
2022-06-22,Quang Ninh,Ha Long City,12,101,82,19,9
2022-06-22,Quang Ninh,Ha Long City,13,72,56,16,9
2022-06-22,Quang Ninh,Ha Long City,14,74,51,23,9
2022-06-22,Quang Ninh,Ha Long City,15,54,33,21,15
2022-06-22,Quang Ninh,Ha Long City,16,60,47,13,5
2022-06-22,Quang Ninh,Ha Long City,17,48,29,19,6
2022-06-22,Quang Ninh,Ha Long City,18,54,43,11,4
2022-06-22,Quang Ninh,Ha Long City,19,66,52,14,3
2022-06-22,Quang Ninh,Ha Long City,20,67,44,23,10
2022-06-22,Quang Ninh,Ha Long City,21,1,0,1,1
2022-06-22,Quang Ninh,Ha Long City,22,1,1,0,0
2022-06-22,Quang Ninh,Uong Bi City,12,1,0,1,1
2022-06-22,Quang Ninh,Uong Bi City,18,1,0,1,1
2022-06-22,Thai Nguyen,Dong Hy,7,1,1,0,0
2022-06-22,Thai Nguyen,Dong Hy,21,1,1,0,0
2022-06-22,Thai Nguyen,Thai Nguyen City,0,5,3,2,0
2022-06-22,Thai Nguyen,Thai Nguyen City,1,1,0,1,0
2022-06-22,Thai Nguyen,Thai Nguyen City,6,2,1,1,0
2022-06-22,Thai Nguyen,Thai Nguyen City,7,96,86,10,5
2022-06-22,Thai Nguyen,Thai Nguyen City,8,142,132,10,1
2022-06-22,Thai Nguyen,Thai Nguyen City,9,145,129,16,3
2022-06-22,Thai Nguyen,Thai Nguyen City,10,199,184,15,0
2022-06-22,Thai Nguyen,Thai Nguyen City,11,373,346,27,2
2022-06-22,Thai Nguyen,Thai Nguyen City,12,331,308,23,3
2022-06-22,Thai Nguyen,Thai Nguyen City,13,142,127,15,1
2022-06-22,Thai Nguyen,Thai Nguyen City,14,216,185,31,4
2022-06-22,Thai Nguyen,Thai Nguyen City,15,172,151,21,3
2022-06-22,Thai Nguyen,Thai Nguyen City,16,156,139,17,1
2022-06-22,Thai Nguyen,Thai Nguyen City,17,165,149,16,1
2022-06-22,Thai Nguyen,Thai Nguyen City,18,190,171,19,0
2022-06-22,Thai Nguyen,Thai Nguyen City,19,244,223,21,2
2022-06-22,Thai Nguyen,Thai Nguyen City,20,175,158,17,1
2022-06-22,Thai Nguyen,Thai Nguyen City,21,122,80,42,27
2022-06-22,Vung Tau,Ba Ria City,7,1,1,0,0
2022-06-22,Vung Tau,Ba Ria City,8,5,2,3,3
2022-06-22,Vung Tau,Ba Ria City,9,11,5,6,3
2022-06-22,Vung Tau,Ba Ria City,10,6,6,0,0
2022-06-22,Vung Tau,Ba Ria City,11,8,3,5,4
2022-06-22,Vung Tau,Ba Ria City,12,9,3,6,5
2022-06-22,Vung Tau,Ba Ria City,13,12,3,9,8
2022-06-22,Vung Tau,Ba Ria City,14,5,4,1,0
2022-06-22,Vung Tau,Ba Ria City,15,4,2,2,2
2022-06-22,Vung Tau,Ba Ria City,16,3,1,2,2
2022-06-22,Vung Tau,Ba Ria City,17,4,2,2,1
2022-06-22,Vung Tau,Ba Ria City,18,4,0,4,1
2022-06-22,Vung Tau,Ba Ria City,19,3,2,1,0
2022-06-22,Vung Tau,Ba Ria City,20,5,0,5,5
2022-06-22,Vung Tau,Ba Ria City,21,1,0,1,1
2022-06-22,Vung Tau,Chau Duc,18,1,0,1,1
2022-06-22,Vung Tau,Vung Tau City,0,1,1,0,0
2022-06-22,Vung Tau,Vung Tau City,3,1,1,0,0
2022-06-22,Vung Tau,Vung Tau City,6,27,24,3,0
2022-06-22,Vung Tau,Vung Tau City,7,101,92,9,2
2022-06-22,Vung Tau,Vung Tau City,8,187,172,15,2
2022-06-22,Vung Tau,Vung Tau City,9,201,195,6,1
2022-06-22,Vung Tau,Vung Tau City,10,242,226,16,0
2022-06-22,Vung Tau,Vung Tau City,11,401,379,22,3
2022-06-22,Vung Tau,Vung Tau City,12,272,256,16,0
2022-06-22,Vung Tau,Vung Tau City,13,221,211,10,0
2022-06-22,Vung Tau,Vung Tau City,14,260,245,15,0
2022-06-22,Vung Tau,Vung Tau City,15,221,210,11,0
2022-06-22,Vung Tau,Vung Tau City,16,224,204,20,2
2022-06-22,Vung Tau,Vung Tau City,17,309,245,64,31
2022-06-22,Vung Tau,Vung Tau City,18,340,304,36,7
2022-06-22,Vung Tau,Vung Tau City,19,354,281,73,38
2022-06-22,Vung Tau,Vung Tau City,20,218,175,43,18
2022-06-22,Vung Tau,Vung Tau City,21,99,83,16,4
2022-06-22,Vung Tau,Vung Tau City,22,3,1,2,0
2022-06-23,Bac Ninh,Bác Ninh City,1,2,2,0,0
2022-06-23,Bac Ninh,Bác Ninh City,6,3,0,3,0
2022-06-23,Bac Ninh,Bác Ninh City,7,64,60,4,2
2022-06-23,Bac Ninh,Bác Ninh City,8,108,100,8,2
2022-06-23,Bac Ninh,Bác Ninh City,9,107,97,10,2
2022-06-23,Bac Ninh,Bác Ninh City,10,148,127,21,2
2022-06-23,Bac Ninh,Bác Ninh City,11,374,317,57,21
2022-06-23,Bac Ninh,Bác Ninh City,12,226,204,22,5
2022-06-23,Bac Ninh,Bác Ninh City,13,185,170,15,0
2022-06-23,Bac Ninh,Bác Ninh City,14,156,139,17,0
2022-06-23,Bac Ninh,Bác Ninh City,15,115,105,10,0
2022-06-23,Bac Ninh,Bác Ninh City,16,97,87,10,1
2022-06-23,Bac Ninh,Bác Ninh City,17,125,111,14,0
2022-06-23,Bac Ninh,Bác Ninh City,18,170,156,14,0
2022-06-23,Bac Ninh,Bác Ninh City,19,187,154,33,14
2022-06-23,Bac Ninh,Bác Ninh City,20,166,133,33,16
2022-06-23,Bac Ninh,Bác Ninh City,21,98,73,25,14
2022-06-23,Bac Ninh,Bác Ninh City,22,1,0,1,0
2022-06-23,Bac Ninh,Que Vo,11,1,1,0,0
2022-06-23,Bac Ninh,Que Vo,13,1,0,1,1
2022-06-23,Bac Ninh,Que Vo,14,1,0,1,1
2022-06-23,Bac Ninh,Que Vo,15,1,1,0,0
2022-06-23,Bac Ninh,Que Vo,18,2,0,2,1
2022-06-23,Bac Ninh,Que Vo,19,1,0,1,1
2022-06-23,Bac Ninh,Tien Du,11,1,0,1,1
2022-06-23,Bac Ninh,Tien Du,13,1,0,1,1
2022-06-23,Bac Ninh,Tien Du,18,1,0,1,1
2022-06-23,Bac Ninh,Tien Du,19,1,0,1,1
2022-06-23,Bac Ninh,Tien Du,21,1,0,1,1
2022-06-23,Bac Ninh,Tu Son,10,1,0,1,1
2022-06-23,Bac Ninh,Tu Son,13,1,0,1,1
2022-06-23,Bac Ninh,Tu Son,15,1,0,1,0
2022-06-23,Bac Ninh,Tu Son,16,1,0,1,1
2022-06-23,Bac Ninh,Tu Son,17,3,0,3,3
2022-06-23,Bac Ninh,Tu Son,18,1,0,1,1
2022-06-23,Binh Duong,Ben Cat,11,3,0,3,3
2022-06-23,Binh Duong,Ben Cat,12,3,0,3,2
2022-06-23,Binh Duong,Ben Cat,13,3,0,3,3
2022-06-23,Binh Duong,Ben Cat,14,3,0,3,3
2022-06-23,Binh Duong,Ben Cat,15,4,0,4,3
2022-06-23,Binh Duong,Ben Cat,16,1,0,1,1
2022-06-23,Binh Duong,Ben Cat,18,1,0,1,1
2022-06-23,Binh Duong,Ben Cat,19,2,0,2,2
2022-06-23,Binh Duong,Ben Cat,20,1,0,1,1
2022-06-23,Binh Duong,Di An,7,6,1,5,5
2022-06-23,Binh Duong,Di An,8,9,5,4,4
2022-06-23,Binh Duong,Di An,9,25,18,7,4
2022-06-23,Binh Duong,Di An,10,33,27,6,2
2022-06-23,Binh Duong,Di An,11,34,23,11,7
2022-06-23,Binh Duong,Di An,12,33,27,6,2
2022-06-23,Binh Duong,Di An,13,31,17,14,5
2022-06-23,Binh Duong,Di An,14,25,18,7,1
2022-06-23,Binh Duong,Di An,15,27,22,5,4
2022-06-23,Binh Duong,Di An,16,25,21,4,2
2022-06-23,Binh Duong,Di An,17,33,22,11,5
2022-06-23,Binh Duong,Di An,18,31,20,11,8
2022-06-23,Binh Duong,Di An,19,45,21,24,14
2022-06-23,Binh Duong,Di An,20,28,16,12,5
2022-06-23,Binh Duong,Di An,21,16,4,12,9
2022-06-23,Binh Duong,Di An,22,2,0,2,0
2022-06-23,Binh Duong,Tan Uyen,8,4,0,4,3
2022-06-23,Binh Duong,Tan Uyen,10,2,1,1,0
2022-06-23,Binh Duong,Tan Uyen,11,3,2,1,0
2022-06-23,Binh Duong,Tan Uyen,12,6,4,2,2
2022-06-23,Binh Duong,Tan Uyen,13,1,1,0,0
2022-06-23,Binh Duong,Tan Uyen,14,4,4,0,0
2022-06-23,Binh Duong,Tan Uyen,15,2,1,1,1
2022-06-23,Binh Duong,Tan Uyen,16,4,1,3,3
2022-06-23,Binh Duong,Tan Uyen,17,1,0,1,1
2022-06-23,Binh Duong,Tan Uyen,18,5,2,3,3
2022-06-23,Binh Duong,Tan Uyen,19,4,2,2,2
2022-06-23,Binh Duong,Tan Uyen,20,2,0,2,2
2022-06-23,Binh Duong,Thu Dau Mot Town,2,2,2,0,0
2022-06-23,Binh Duong,Thu Dau Mot Town,3,1,0,1,0
2022-06-23,Binh Duong,Thu Dau Mot Town,4,1,0,1,0
2022-06-23,Binh Duong,Thu Dau Mot Town,6,42,36,6,3
2022-06-23,Binh Duong,Thu Dau Mot Town,7,121,113,8,0
2022-06-23,Binh Duong,Thu Dau Mot Town,8,242,225,17,3
2022-06-23,Binh Duong,Thu Dau Mot Town,9,240,225,15,0
2022-06-23,Binh Duong,Thu Dau Mot Town,10,441,397,44,5
2022-06-23,Binh Duong,Thu Dau Mot Town,11,734,685,49,13
2022-06-23,Binh Duong,Thu Dau Mot Town,12,493,458,35,5
2022-06-23,Binh Duong,Thu Dau Mot Town,13,480,456,24,3
2022-06-23,Binh Duong,Thu Dau Mot Town,14,362,336,26,3
2022-06-23,Binh Duong,Thu Dau Mot Town,15,264,244,20,3
2022-06-23,Binh Duong,Thu Dau Mot Town,16,300,272,28,10
2022-06-23,Binh Duong,Thu Dau Mot Town,17,408,377,31,6
2022-06-23,Binh Duong,Thu Dau Mot Town,18,422,386,36,13
2022-06-23,Binh Duong,Thu Dau Mot Town,19,427,382,45,11
2022-06-23,Binh Duong,Thu Dau Mot Town,20,269,232,37,14
2022-06-23,Binh Duong,Thu Dau Mot Town,21,116,101,15,2
2022-06-23,Binh Duong,Thu Dau Mot Town,22,3,1,2,0
2022-06-23,Binh Duong,Thuan An,6,2,0,2,2
2022-06-23,Binh Duong,Thuan An,7,7,4,3,3
2022-06-23,Binh Duong,Thuan An,8,20,17,3,3
2022-06-23,Binh Duong,Thuan An,9,39,33,6,1
2022-06-23,Binh Duong,Thuan An,10,58,53,5,1
2022-06-23,Binh Duong,Thuan An,11,118,102,16,1
2022-06-23,Binh Duong,Thuan An,12,71,64,7,0
2022-06-23,Binh Duong,Thuan An,13,83,70,13,5
2022-06-23,Binh Duong,Thuan An,14,51,42,9,5
2022-06-23,Binh Duong,Thuan An,15,55,42,13,9
2022-06-23,Binh Duong,Thuan An,16,46,36,10,3
2022-06-23,Binh Duong,Thuan An,17,31,25,6,2
2022-06-23,Binh Duong,Thuan An,18,51,40,11,4
2022-06-23,Binh Duong,Thuan An,19,68,38,30,19
2022-06-23,Binh Duong,Thuan An,20,44,26,18,8
2022-06-23,Binh Duong,Thuan An,21,42,15,27,21
2022-06-23,Binh Duong,Thuan An,23,1,0,1,0
2022-06-23,Can Tho City,Binh Thuy District,6,3,2,1,0
2022-06-23,Can Tho City,Binh Thuy District,7,2,2,0,0
2022-06-23,Can Tho City,Binh Thuy District,8,1,1,0,0
2022-06-23,Can Tho City,Binh Thuy District,9,4,4,0,0
2022-06-23,Can Tho City,Binh Thuy District,10,14,11,3,0
2022-06-23,Can Tho City,Binh Thuy District,11,9,9,0,0
2022-06-23,Can Tho City,Binh Thuy District,12,15,14,1,1
2022-06-23,Can Tho City,Binh Thuy District,13,8,7,1,0
2022-06-23,Can Tho City,Binh Thuy District,14,8,5,3,2
2022-06-23,Can Tho City,Binh Thuy District,15,9,9,0,0
2022-06-23,Can Tho City,Binh Thuy District,16,12,11,1,0
2022-06-23,Can Tho City,Binh Thuy District,17,10,8,2,1
2022-06-23,Can Tho City,Binh Thuy District,18,22,20,2,0
2022-06-23,Can Tho City,Binh Thuy District,19,11,11,0,0
2022-06-23,Can Tho City,Binh Thuy District,20,11,10,1,0
2022-06-23,Can Tho City,Binh Thuy District,21,2,1,1,0
2022-06-23,Can Tho City,Cai Rang District,0,2,1,1,0
2022-06-23,Can Tho City,Cai Rang District,6,1,0,1,1
2022-06-23,Can Tho City,Cai Rang District,7,3,1,2,2
2022-06-23,Can Tho City,Cai Rang District,8,11,7,4,4
2022-06-23,Can Tho City,Cai Rang District,9,3,3,0,0
2022-06-23,Can Tho City,Cai Rang District,10,13,11,2,1
2022-06-23,Can Tho City,Cai Rang District,11,14,14,0,0
2022-06-23,Can Tho City,Cai Rang District,12,9,8,1,0
2022-06-23,Can Tho City,Cai Rang District,13,13,12,1,1
2022-06-23,Can Tho City,Cai Rang District,14,7,7,0,0
2022-06-23,Can Tho City,Cai Rang District,15,3,3,0,0
2022-06-23,Can Tho City,Cai Rang District,16,12,12,0,0
2022-06-23,Can Tho City,Cai Rang District,17,11,11,0,0
2022-06-23,Can Tho City,Cai Rang District,18,12,11,1,0
2022-06-23,Can Tho City,Cai Rang District,19,27,25,2,0
2022-06-23,Can Tho City,Cai Rang District,20,9,9,0,0
2022-06-23,Can Tho City,Cai Rang District,21,3,3,0,0
2022-06-23,Can Tho City,Ninh Kieu District,0,2,2,0,0
2022-06-23,Can Tho City,Ninh Kieu District,2,2,2,0,0
2022-06-23,Can Tho City,Ninh Kieu District,4,1,0,1,0
2022-06-23,Can Tho City,Ninh Kieu District,5,2,2,0,0
2022-06-23,Can Tho City,Ninh Kieu District,6,55,53,2,0
2022-06-23,Can Tho City,Ninh Kieu District,7,139,128,11,0
2022-06-23,Can Tho City,Ninh Kieu District,8,221,205,16,0
2022-06-23,Can Tho City,Ninh Kieu District,9,300,283,17,0
2022-06-23,Can Tho City,Ninh Kieu District,10,504,490,14,0
2022-06-23,Can Tho City,Ninh Kieu District,11,860,820,40,7
2022-06-23,Can Tho City,Ninh Kieu District,12,608,596,12,0
2022-06-23,Can Tho City,Ninh Kieu District,13,464,444,20,0
2022-06-23,Can Tho City,Ninh Kieu District,14,301,286,15,0
2022-06-23,Can Tho City,Ninh Kieu District,15,391,376,15,0
2022-06-23,Can Tho City,Ninh Kieu District,16,506,486,20,0
2022-06-23,Can Tho City,Ninh Kieu District,17,603,577,26,1
2022-06-23,Can Tho City,Ninh Kieu District,18,645,603,42,0
2022-06-23,Can Tho City,Ninh Kieu District,19,621,589,32,2
2022-06-23,Can Tho City,Ninh Kieu District,20,418,387,31,0
2022-06-23,Can Tho City,Ninh Kieu District,21,242,215,27,2
2022-06-23,Can Tho City,Ninh Kieu District,22,3,1,2,0
2022-06-23,Can Tho City,Ninh Kieu District,23,1,1,0,0
2022-06-23,Dong Nai,Bien Hoa City,0,4,4,0,0
2022-06-23,Dong Nai,Bien Hoa City,1,1,0,1,0
2022-06-23,Dong Nai,Bien Hoa City,2,2,1,1,0
2022-06-23,Dong Nai,Bien Hoa City,3,1,1,0,0
2022-06-23,Dong Nai,Bien Hoa City,4,2,0,2,0
2022-06-23,Dong Nai,Bien Hoa City,6,43,35,8,4
2022-06-23,Dong Nai,Bien Hoa City,7,170,138,32,11
2022-06-23,Dong Nai,Bien Hoa City,8,313,282,31,8
2022-06-23,Dong Nai,Bien Hoa City,9,416,375,41,10
2022-06-23,Dong Nai,Bien Hoa City,10,790,736,54,10
2022-06-23,Dong Nai,Bien Hoa City,11,1158,1063,95,21
2022-06-23,Dong Nai,Bien Hoa City,12,928,860,68,11
2022-06-23,Dong Nai,Bien Hoa City,13,874,821,53,5
2022-06-23,Dong Nai,Bien Hoa City,14,645,584,61,6
2022-06-23,Dong Nai,Bien Hoa City,15,536,493,43,5
2022-06-23,Dong Nai,Bien Hoa City,16,510,471,39,4
2022-06-23,Dong Nai,Bien Hoa City,17,608,547,61,10
2022-06-23,Dong Nai,Bien Hoa City,18,767,698,69,14
2022-06-23,Dong Nai,Bien Hoa City,19,870,714,156,60
2022-06-23,Dong Nai,Bien Hoa City,20,603,456,147,62
2022-06-23,Dong Nai,Bien Hoa City,21,293,199,94,27
2022-06-23,Dong Nai,Bien Hoa City,22,9,3,6,0
2022-06-23,Dong Nai,Bien Hoa City,23,2,2,0,0
2022-06-23,Dong Nai,Long Khanh,18,1,0,1,1
2022-06-23,Dong Nai,Long Thanh,9,2,0,2,2
2022-06-23,Dong Nai,Long Thanh,10,2,0,2,2
2022-06-23,Dong Nai,Long Thanh,11,1,0,1,1
2022-06-23,Dong Nai,Long Thanh,12,2,0,2,2
2022-06-23,Dong Nai,Long Thanh,13,2,0,2,2
2022-06-23,Dong Nai,Long Thanh,14,7,0,7,7
2022-06-23,Dong Nai,Long Thanh,15,1,0,1,1
2022-06-23,Dong Nai,Long Thanh,17,2,0,2,1
2022-06-23,Dong Nai,Long Thanh,18,1,0,1,1
2022-06-23,Dong Nai,Nhon trach,8,2,0,2,2
2022-06-23,Dong Nai,Nhon trach,9,1,0,1,0
2022-06-23,Dong Nai,Nhon trach,13,1,0,1,1
2022-06-23,Dong Nai,Nhon trach,14,4,0,4,3
2022-06-23,Dong Nai,Trang Bom,8,1,0,1,1
2022-06-23,Dong Nai,Trang Bom,9,2,1,1,1
2022-06-23,Dong Nai,Trang Bom,11,4,0,4,3
2022-06-23,Dong Nai,Trang Bom,12,2,0,2,2
2022-06-23,Dong Nai,Trang Bom,14,2,0,2,2
2022-06-23,Dong Nai,Trang Bom,15,4,1,3,2
2022-06-23,Dong Nai,Trang Bom,18,2,0,2,2
2022-06-23,Dong Nai,Trang Bom,19,1,0,1,1
2022-06-23,Dong Nai,Trang Bom,20,1,0,1,1
2022-06-23,Dong Nai,Vinh Cuu,21,1,0,1,1
2022-06-23,Hai Phong City,An Duong,7,2,0,2,2
2022-06-23,Hai Phong City,An Duong,8,7,3,4,3
2022-06-23,Hai Phong City,An Duong,9,5,2,3,2
2022-06-23,Hai Phong City,An Duong,10,12,7,5,5
2022-06-23,Hai Phong City,An Duong,11,5,3,2,1
2022-06-23,Hai Phong City,An Duong,12,2,2,0,0
2022-06-23,Hai Phong City,An Duong,13,5,3,2,1
2022-06-23,Hai Phong City,An Duong,14,2,1,1,0
2022-06-23,Hai Phong City,An Duong,15,3,1,2,2
2022-06-23,Hai Phong City,An Duong,16,2,1,1,1
2022-06-23,Hai Phong City,An Duong,17,3,3,0,0
2022-06-23,Hai Phong City,An Duong,18,2,0,2,1
2022-06-23,Hai Phong City,An Duong,20,1,0,1,1
2022-06-23,Hai Phong City,An Duong,21,4,1,3,2
2022-06-23,Hai Phong City,Do Son District,17,1,0,1,1
2022-06-23,Hai Phong City,Duong Kinh District,20,1,0,1,1
2022-06-23,Hai Phong City,Hai An District,7,6,2,4,1
2022-06-23,Hai Phong City,Hai An District,8,24,14,10,7
2022-06-23,Hai Phong City,Hai An District,9,10,6,4,0
2022-06-23,Hai Phong City,Hai An District,10,28,21,7,2
2022-06-23,Hai Phong City,Hai An District,11,60,45,15,5
2022-06-23,Hai Phong City,Hai An District,12,42,36,6,4
2022-06-23,Hai Phong City,Hai An District,13,22,12,10,3
2022-06-23,Hai Phong City,Hai An District,14,21,17,4,4
2022-06-23,Hai Phong City,Hai An District,15,20,17,3,2
2022-06-23,Hai Phong City,Hai An District,16,27,24,3,2
2022-06-23,Hai Phong City,Hai An District,17,15,13,2,0
2022-06-23,Hai Phong City,Hai An District,18,21,17,4,1
2022-06-23,Hai Phong City,Hai An District,19,21,17,4,3
2022-06-23,Hai Phong City,Hai An District,20,17,15,2,1
2022-06-23,Hai Phong City,Hai An District,21,10,7,3,1
2022-06-23,Hai Phong City,Hong Bang District,1,2,1,1,0
2022-06-23,Hai Phong City,Hong Bang District,7,14,11,3,2
2022-06-23,Hai Phong City,Hong Bang District,8,42,36,6,3
2022-06-23,Hai Phong City,Hong Bang District,9,32,30,2,1
2022-06-23,Hai Phong City,Hong Bang District,10,52,43,9,2
2022-06-23,Hai Phong City,Hong Bang District,11,138,113,25,11
2022-06-23,Hai Phong City,Hong Bang District,12,75,61,14,3
2022-06-23,Hai Phong City,Hong Bang District,13,50,44,6,1
2022-06-23,Hai Phong City,Hong Bang District,14,60,38,22,10
2022-06-23,Hai Phong City,Hong Bang District,15,47,38,9,3
2022-06-23,Hai Phong City,Hong Bang District,16,43,36,7,2
2022-06-23,Hai Phong City,Hong Bang District,17,32,28,4,0
2022-06-23,Hai Phong City,Hong Bang District,18,49,46,3,1
2022-06-23,Hai Phong City,Hong Bang District,19,42,37,5,1
2022-06-23,Hai Phong City,Hong Bang District,20,42,38,4,0
2022-06-23,Hai Phong City,Hong Bang District,21,11,8,3,2
2022-06-23,Hai Phong City,Hong Bang District,23,1,1,0,0
2022-06-23,Hai Phong City,Kien An District,7,1,0,1,1
2022-06-23,Hai Phong City,Kien An District,9,8,7,1,1
2022-06-23,Hai Phong City,Kien An District,10,16,10,6,1
2022-06-23,Hai Phong City,Kien An District,11,17,11,6,1
2022-06-23,Hai Phong City,Kien An District,12,3,3,0,0
2022-06-23,Hai Phong City,Kien An District,13,5,4,1,1
2022-06-23,Hai Phong City,Kien An District,14,15,10,5,1
2022-06-23,Hai Phong City,Kien An District,15,5,4,1,0
2022-06-23,Hai Phong City,Kien An District,16,8,7,1,0
2022-06-23,Hai Phong City,Kien An District,17,12,10,2,0
2022-06-23,Hai Phong City,Kien An District,18,4,4,0,0
2022-06-23,Hai Phong City,Kien An District,19,7,2,5,4
2022-06-23,Hai Phong City,Kien An District,20,12,5,7,6
2022-06-23,Hai Phong City,Kien An District,21,8,2,6,3
2022-06-23,Hai Phong City,Le Chan District,0,2,1,1,0
2022-06-23,Hai Phong City,Le Chan District,2,2,1,1,0
2022-06-23,Hai Phong City,Le Chan District,5,1,1,0,0
2022-06-23,Hai Phong City,Le Chan District,6,3,2,1,1
2022-06-23,Hai Phong City,Le Chan District,7,43,34,9,5
2022-06-23,Hai Phong City,Le Chan District,8,82,70,12,4
2022-06-23,Hai Phong City,Le Chan District,9,75,70,5,0
2022-06-23,Hai Phong City,Le Chan District,10,224,202,22,5
2022-06-23,Hai Phong City,Le Chan District,11,354,295,59,23
2022-06-23,Hai Phong City,Le Chan District,12,248,219,29,6
2022-06-23,Hai Phong City,Le Chan District,13,139,118,21,5
2022-06-23,Hai Phong City,Le Chan District,14,178,148,30,9
2022-06-23,Hai Phong City,Le Chan District,15,170,145,25,8
2022-06-23,Hai Phong City,Le Chan District,16,182,162,20,2
2022-06-23,Hai Phong City,Le Chan District,17,174,154,20,0
2022-06-23,Hai Phong City,Le Chan District,18,186,166,20,1
2022-06-23,Hai Phong City,Le Chan District,19,207,171,36,3
2022-06-23,Hai Phong City,Le Chan District,20,103,90,13,2
2022-06-23,Hai Phong City,Le Chan District,21,76,52,24,9
2022-06-23,Hai Phong City,Le Chan District,22,2,2,0,0
2022-06-23,Hai Phong City,Le Chan District,23,1,1,0,0
2022-06-23,Hai Phong City,Ngo Quyen District,5,1,1,0,0
2022-06-23,Hai Phong City,Ngo Quyen District,6,2,1,1,1
2022-06-23,Hai Phong City,Ngo Quyen District,7,30,25,5,3
2022-06-23,Hai Phong City,Ngo Quyen District,8,95,75,20,10
2022-06-23,Hai Phong City,Ngo Quyen District,9,76,65,11,0
2022-06-23,Hai Phong City,Ngo Quyen District,10,153,132,21,2
2022-06-23,Hai Phong City,Ngo Quyen District,11,287,246,41,10
2022-06-23,Hai Phong City,Ngo Quyen District,12,148,135,13,0
2022-06-23,Hai Phong City,Ngo Quyen District,13,120,104,16,2
2022-06-23,Hai Phong City,Ngo Quyen District,14,143,125,18,10
2022-06-23,Hai Phong City,Ngo Quyen District,15,126,111,15,2
2022-06-23,Hai Phong City,Ngo Quyen District,16,137,122,15,1
2022-06-23,Hai Phong City,Ngo Quyen District,17,132,116,16,1
2022-06-23,Hai Phong City,Ngo Quyen District,18,128,109,19,2
2022-06-23,Hai Phong City,Ngo Quyen District,19,121,112,9,2
2022-06-23,Hai Phong City,Ngo Quyen District,20,96,81,15,4
2022-06-23,Hai Phong City,Ngo Quyen District,21,70,52,18,9
2022-06-23,Hai Phong City,Ngo Quyen District,22,2,2,0,0
2022-06-23,Hai Phong City,Ngo Quyen District,23,1,0,1,0
2022-06-23,Hai Phong City,Thuy Nguyen,5,1,0,1,0
2022-06-23,Hai Phong City,Thuy Nguyen,6,1,0,1,0
2022-06-23,Hai Phong City,Thuy Nguyen,10,1,0,1,1
2022-06-23,Hai Phong City,Thuy Nguyen,11,8,0,8,7
2022-06-23,Hai Phong City,Thuy Nguyen,13,1,1,0,0
2022-06-23,Hai Phong City,Thuy Nguyen,14,2,0,2,2
2022-06-23,Hai Phong City,Thuy Nguyen,19,3,1,2,1
2022-06-23,Hue City,Hue City,0,1,1,0,0
2022-06-23,Hue City,Hue City,2,1,1,0,0
2022-06-23,Hue City,Hue City,5,3,2,1,0
2022-06-23,Hue City,Hue City,6,78,72,6,2
2022-06-23,Hue City,Hue City,7,179,171,8,1
2022-06-23,Hue City,Hue City,8,312,292,20,1
2022-06-23,Hue City,Hue City,9,290,267,23,1
2022-06-23,Hue City,Hue City,10,436,404,32,2
2022-06-23,Hue City,Hue City,11,922,844,78,10
2022-06-23,Hue City,Hue City,12,627,599,28,1
2022-06-23,Hue City,Hue City,13,338,313,25,0
2022-06-23,Hue City,Hue City,14,391,358,33,2
2022-06-23,Hue City,Hue City,15,390,362,28,7
2022-06-23,Hue City,Hue City,16,337,303,34,2
2022-06-23,Hue City,Hue City,17,442,407,35,0
2022-06-23,Hue City,Hue City,18,547,504,43,3
2022-06-23,Hue City,Hue City,19,586,522,64,0
2022-06-23,Hue City,Hue City,20,425,375,50,3
2022-06-23,Hue City,Hue City,21,248,205,43,9
2022-06-23,Hue City,Hue City,22,2,1,1,0
2022-06-23,Hue City,Hue City,23,1,0,1,0
2022-06-23,Hue City,Huong Thuy,9,1,1,0,0
2022-06-23,Hue City,Huong Thuy,11,2,2,0,0
2022-06-23,Hue City,Huong Thuy,12,2,2,0,0
2022-06-23,Hue City,Huong Thuy,14,1,1,0,0
2022-06-23,Hue City,Huong Thuy,15,2,2,0,0
2022-06-23,Hue City,Huong Thuy,17,1,1,0,0
2022-06-23,Hue City,Huong Thuy,18,1,0,1,0
2022-06-23,Hue City,Huong Thuy,19,1,1,0,0
2022-06-23,Hue City,Huong Tra,10,1,1,0,0
2022-06-23,Hue City,Huong Tra,12,1,0,1,1
2022-06-23,Hue City,Huong Tra,18,1,0,1,0
2022-06-23,Hue City,Huong Tra,19,1,1,0,0
2022-06-23,Hue City,Huong Tra,20,1,1,0,0
2022-06-23,Hue City,Phu Vang,6,3,1,2,0
2022-06-23,Hue City,Phu Vang,7,1,1,0,0
2022-06-23,Hue City,Phu Vang,8,4,3,1,0
2022-06-23,Hue City,Phu Vang,10,1,0,1,0
2022-06-23,Hue City,Phu Vang,11,3,3,0,0
2022-06-23,Hue City,Phu Vang,12,5,4,1,0
2022-06-23,Hue City,Phu Vang,13,1,0,1,1
2022-06-23,Hue City,Phu Vang,14,4,4,0,0
2022-06-23,Hue City,Phu Vang,15,3,2,1,0
2022-06-23,Hue City,Phu Vang,16,1,1,0,0
2022-06-23,Hue City,Phu Vang,18,2,2,0,0
2022-06-23,Hue City,Phu Vang,19,3,2,1,0
2022-06-23,Khanh Hoa,Dien Khanh,7,1,0,1,1
2022-06-23,Khanh Hoa,Nha Trang City,5,2,2,0,0
2022-06-23,Khanh Hoa,Nha Trang City,6,26,24,2,1
2022-06-23,Khanh Hoa,Nha Trang City,7,133,125,8,0
2022-06-23,Khanh Hoa,Nha Trang City,8,195,183,12,0
2022-06-23,Khanh Hoa,Nha Trang City,9,180,166,14,1
2022-06-23,Khanh Hoa,Nha Trang City,10,201,184,17,2
2022-06-23,Khanh Hoa,Nha Trang City,11,398,370,28,1
2022-06-23,Khanh Hoa,Nha Trang City,12,294,273,21,0
2022-06-23,Khanh Hoa,Nha Trang City,13,246,232,14,1
2022-06-23,Khanh Hoa,Nha Trang City,14,196,181,15,0
2022-06-23,Khanh Hoa,Nha Trang City,15,216,208,8,0
2022-06-23,Khanh Hoa,Nha Trang City,16,165,150,15,0
2022-06-23,Khanh Hoa,Nha Trang City,17,185,173,12,0
2022-06-23,Khanh Hoa,Nha Trang City,18,217,205,12,2
2022-06-23,Khanh Hoa,Nha Trang City,19,289,257,32,5
2022-06-23,Khanh Hoa,Nha Trang City,20,207,178,29,9
2022-06-23,Khanh Hoa,Nha Trang City,21,102,79,23,6
2022-06-23,Khanh Hoa,Nha Trang City,22,2,1,1,0
2022-06-23,Khanh Hoa,Nha Trang City,23,2,0,2,1
2022-06-23,Lam Dong,Da Lat City,2,1,1,0,0
2022-06-23,Lam Dong,Da Lat City,5,1,0,1,1
2022-06-23,Lam Dong,Da Lat City,7,54,29,25,20
2022-06-23,Lam Dong,Da Lat City,8,101,67,34,22
2022-06-23,Lam Dong,Da Lat City,9,81,74,7,5
2022-06-23,Lam Dong,Da Lat City,10,85,74,11,0
2022-06-23,Lam Dong,Da Lat City,11,130,110,20,6
2022-06-23,Lam Dong,Da Lat City,12,158,125,33,23
2022-06-23,Lam Dong,Da Lat City,13,135,75,60,45
2022-06-23,Lam Dong,Da Lat City,14,129,86,43,27
2022-06-23,Lam Dong,Da Lat City,15,133,91,42,31
2022-06-23,Lam Dong,Da Lat City,16,134,93,41,27
2022-06-23,Lam Dong,Da Lat City,17,142,94,48,26
2022-06-23,Lam Dong,Da Lat City,18,193,102,91,66
2022-06-23,Lam Dong,Da Lat City,19,189,107,82,64
2022-06-23,Lam Dong,Da Lat City,20,132,69,63,33
2022-06-23,Lam Dong,Da Lat City,21,61,41,20,13
2022-06-23,Nghe An,Vinh City,6,5,4,1,0
2022-06-23,Nghe An,Vinh City,7,173,147,26,11
2022-06-23,Nghe An,Vinh City,8,217,184,33,12
2022-06-23,Nghe An,Vinh City,9,168,151,17,2
2022-06-23,Nghe An,Vinh City,10,230,187,43,13
2022-06-23,Nghe An,Vinh City,11,502,402,100,52
2022-06-23,Nghe An,Vinh City,12,246,221,25,5
2022-06-23,Nghe An,Vinh City,13,154,136,18,2
2022-06-23,Nghe An,Vinh City,14,217,157,60,26
2022-06-23,Nghe An,Vinh City,15,205,157,48,18
2022-06-23,Nghe An,Vinh City,16,118,99,19,2
2022-06-23,Nghe An,Vinh City,17,129,110,19,3
2022-06-23,Nghe An,Vinh City,18,184,148,36,6
2022-06-23,Nghe An,Vinh City,19,177,154,23,8
2022-06-23,Nghe An,Vinh City,20,136,115,21,5
2022-06-23,Nghe An,Vinh City,21,81,54,27,11
2022-06-23,Nghe An,Vinh City,23,2,2,0,0
2022-06-23,Quang Nam,Hoi An City,6,2,1,1,1
2022-06-23,Quang Nam,Hoi An City,7,8,6,2,1
2022-06-23,Quang Nam,Hoi An City,8,23,19,4,0
2022-06-23,Quang Nam,Hoi An City,9,23,18,5,1
2022-06-23,Quang Nam,Hoi An City,10,31,25,6,0
2022-06-23,Quang Nam,Hoi An City,11,42,32,10,4
2022-06-23,Quang Nam,Hoi An City,12,53,40,13,7
2022-06-23,Quang Nam,Hoi An City,13,33,26,7,4
2022-06-23,Quang Nam,Hoi An City,14,53,43,10,4
2022-06-23,Quang Nam,Hoi An City,15,50,44,6,2
2022-06-23,Quang Nam,Hoi An City,16,27,25,2,0
2022-06-23,Quang Nam,Hoi An City,17,43,37,6,1
2022-06-23,Quang Nam,Hoi An City,18,46,40,6,1
2022-06-23,Quang Nam,Hoi An City,19,56,45,11,6
2022-06-23,Quang Nam,Hoi An City,20,46,35,11,3
2022-06-23,Quang Nam,Hoi An City,21,27,19,8,7
2022-06-23,Quang Ninh,Cam Pha City,11,1,0,1,1
2022-06-23,Quang Ninh,Cam Pha City,12,1,0,1,1
2022-06-23,Quang Ninh,Cam Pha City,13,2,0,2,2
2022-06-23,Quang Ninh,Cam Pha City,14,2,0,2,2
2022-06-23,Quang Ninh,Cam Pha City,15,2,0,2,2
2022-06-23,Quang Ninh,Cam Pha City,16,1,0,1,1
2022-06-23,Quang Ninh,Ha Long City,2,1,0,1,1
2022-06-23,Quang Ninh,Ha Long City,7,24,19,5,2
2022-06-23,Quang Ninh,Ha Long City,8,64,43,21,9
2022-06-23,Quang Ninh,Ha Long City,9,50,35,15,6
2022-06-23,Quang Ninh,Ha Long City,10,94,70,24,10
2022-06-23,Quang Ninh,Ha Long City,11,172,114,58,31
2022-06-23,Quang Ninh,Ha Long City,12,132,88,44,23
2022-06-23,Quang Ninh,Ha Long City,13,80,51,29,17
2022-06-23,Quang Ninh,Ha Long City,14,83,56,27,14
2022-06-23,Quang Ninh,Ha Long City,15,71,51,20,11
2022-06-23,Quang Ninh,Ha Long City,16,44,37,7,3
2022-06-23,Quang Ninh,Ha Long City,17,43,36,7,3
2022-06-23,Quang Ninh,Ha Long City,18,76,58,18,5
2022-06-23,Quang Ninh,Ha Long City,19,60,39,21,9
2022-06-23,Quang Ninh,Ha Long City,20,57,35,22,11
2022-06-23,Quang Ninh,Ha Long City,21,1,0,1,0
2022-06-23,Quang Ninh,Ha Long City,22,1,1,0,0
2022-06-23,Thai Nguyen,Dong Hy,13,3,0,3,0
2022-06-23,Thai Nguyen,Dong Hy,17,1,1,0,0
2022-06-23,Thai Nguyen,Thai Nguyen City,0,5,5,0,0
2022-06-23,Thai Nguyen,Thai Nguyen City,1,1,1,0,0
2022-06-23,Thai Nguyen,Thai Nguyen City,2,1,1,0,0
2022-06-23,Thai Nguyen,Thai Nguyen City,6,3,2,1,1
2022-06-23,Thai Nguyen,Thai Nguyen City,7,92,81,11,3
2022-06-23,Thai Nguyen,Thai Nguyen City,8,156,133,23,7
2022-06-23,Thai Nguyen,Thai Nguyen City,9,158,140,18,2
2022-06-23,Thai Nguyen,Thai Nguyen City,10,192,177,15,0
2022-06-23,Thai Nguyen,Thai Nguyen City,11,407,371,36,1
2022-06-23,Thai Nguyen,Thai Nguyen City,12,261,245,16,0
2022-06-23,Thai Nguyen,Thai Nguyen City,13,178,160,18,1
2022-06-23,Thai Nguyen,Thai Nguyen City,14,188,158,30,5
2022-06-23,Thai Nguyen,Thai Nguyen City,15,167,151,16,3
2022-06-23,Thai Nguyen,Thai Nguyen City,16,110,99,11,1
2022-06-23,Thai Nguyen,Thai Nguyen City,17,162,145,17,6
2022-06-23,Thai Nguyen,Thai Nguyen City,18,236,223,13,0
2022-06-23,Thai Nguyen,Thai Nguyen City,19,235,211,24,0
2022-06-23,Thai Nguyen,Thai Nguyen City,20,180,154,26,2
2022-06-23,Thai Nguyen,Thai Nguyen City,21,115,99,16,4
2022-06-23,Thai Nguyen,Thai Nguyen City,22,1,1,0,0
2022-06-23,Vung Tau,Ba Ria City,7,2,1,1,1
2022-06-23,Vung Tau,Ba Ria City,8,13,4,9,6
2022-06-23,Vung Tau,Ba Ria City,9,3,1,2,2
2022-06-23,Vung Tau,Ba Ria City,10,11,7,4,4
2022-06-23,Vung Tau,Ba Ria City,11,5,3,2,0
2022-06-23,Vung Tau,Ba Ria City,12,6,4,2,1
2022-06-23,Vung Tau,Ba Ria City,13,4,4,0,0
2022-06-23,Vung Tau,Ba Ria City,14,5,3,2,2
2022-06-23,Vung Tau,Ba Ria City,15,3,1,2,1
2022-06-23,Vung Tau,Ba Ria City,16,7,3,4,3
2022-06-23,Vung Tau,Ba Ria City,17,11,4,7,4
2022-06-23,Vung Tau,Ba Ria City,18,3,0,3,2
2022-06-23,Vung Tau,Ba Ria City,19,3,1,2,1
2022-06-23,Vung Tau,Ba Ria City,20,4,0,4,3
2022-06-23,Vung Tau,Chau Duc,18,1,0,1,1
2022-06-23,Vung Tau,Vung Tau City,1,1,1,0,0
2022-06-23,Vung Tau,Vung Tau City,3,1,1,0,0
2022-06-23,Vung Tau,Vung Tau City,5,1,0,1,0
2022-06-23,Vung Tau,Vung Tau City,6,39,29,10,2
2022-06-23,Vung Tau,Vung Tau City,7,127,119,8,0
2022-06-23,Vung Tau,Vung Tau City,8,207,197,10,0
2022-06-23,Vung Tau,Vung Tau City,9,168,158,10,0
2022-06-23,Vung Tau,Vung Tau City,10,259,249,10,1
2022-06-23,Vung Tau,Vung Tau City,11,394,361,33,1
2022-06-23,Vung Tau,Vung Tau City,12,308,291,17,1
2022-06-23,Vung Tau,Vung Tau City,13,253,236,17,2
2022-06-23,Vung Tau,Vung Tau City,14,250,233,17,2
2022-06-23,Vung Tau,Vung Tau City,15,209,189,20,4
2022-06-23,Vung Tau,Vung Tau City,16,203,190,13,0
2022-06-23,Vung Tau,Vung Tau City,17,243,227,16,2
2022-06-23,Vung Tau,Vung Tau City,18,338,308,30,8
2022-06-23,Vung Tau,Vung Tau City,19,290,264,26,1
2022-06-23,Vung Tau,Vung Tau City,20,184,166,18,4
2022-06-23,Vung Tau,Vung Tau City,21,89,70,19,6
2022-06-23,Vung Tau,Vung Tau City,22,1,0,1,0
2022-06-23,Vung Tau,Vung Tau City,23,2,1,1,0
2022-06-24,Bac Ninh,Bác Ninh City,6,4,4,0,0
2022-06-24,Bac Ninh,Bác Ninh City,7,67,55,12,4
2022-06-24,Bac Ninh,Bác Ninh City,8,117,109,8,1
2022-06-24,Bac Ninh,Bác Ninh City,9,123,106,17,1
2022-06-24,Bac Ninh,Bác Ninh City,10,196,173,23,3
2022-06-24,Bac Ninh,Bác Ninh City,11,416,340,76,31
2022-06-24,Bac Ninh,Bác Ninh City,12,232,198,34,1
2022-06-24,Bac Ninh,Bác Ninh City,13,174,167,7,0
2022-06-24,Bac Ninh,Bác Ninh City,14,177,159,18,2
2022-06-24,Bac Ninh,Bác Ninh City,15,129,116,13,2
2022-06-24,Bac Ninh,Bác Ninh City,16,108,100,8,1
2022-06-24,Bac Ninh,Bác Ninh City,17,122,114,8,0
2022-06-24,Bac Ninh,Bác Ninh City,18,150,136,14,2
2022-06-24,Bac Ninh,Bác Ninh City,19,178,165,13,2
2022-06-24,Bac Ninh,Bác Ninh City,20,123,110,13,2
2022-06-24,Bac Ninh,Bác Ninh City,21,92,75,17,7
2022-06-24,Bac Ninh,Bác Ninh City,22,1,0,1,0
2022-06-24,Bac Ninh,Que Vo,7,2,0,2,2
2022-06-24,Bac Ninh,Que Vo,9,1,1,0,0
2022-06-24,Bac Ninh,Que Vo,12,1,1,0,0
2022-06-24,Bac Ninh,Que Vo,14,2,0,2,2
2022-06-24,Bac Ninh,Que Vo,15,1,0,1,0
2022-06-24,Bac Ninh,Que Vo,16,3,0,3,2
2022-06-24,Bac Ninh,Que Vo,20,1,0,1,1
2022-06-24,Bac Ninh,Tien Du,10,2,0,2,0
2022-06-24,Bac Ninh,Tien Du,11,1,0,1,0
2022-06-24,Bac Ninh,Tien Du,12,1,0,1,1
2022-06-24,Bac Ninh,Tien Du,13,1,0,1,1
2022-06-24,Bac Ninh,Tien Du,15,1,0,1,1
2022-06-24,Bac Ninh,Tien Du,16,1,0,1,1
2022-06-24,Bac Ninh,Tien Du,18,1,0,1,1
2022-06-24,Bac Ninh,Tien Du,19,1,0,1,1
2022-06-24,Bac Ninh,Tien Du,20,1,0,1,1
2022-06-24,Bac Ninh,Tien Du,21,2,0,2,2
2022-06-24,Bac Ninh,Tu Son,10,1,0,1,1
2022-06-24,Bac Ninh,Tu Son,11,2,0,2,2
2022-06-24,Bac Ninh,Tu Son,15,1,0,1,1
2022-06-24,Bac Ninh,Tu Son,16,2,0,2,2
2022-06-24,Bac Ninh,Tu Son,18,1,0,1,1
2022-06-24,Bac Ninh,Tu Son,20,1,0,1,0
2022-06-24,Binh Duong,Ben Cat,9,1,0,1,1
2022-06-24,Binh Duong,Ben Cat,11,1,0,1,1
2022-06-24,Binh Duong,Ben Cat,13,2,0,2,1
2022-06-24,Binh Duong,Ben Cat,14,4,0,4,1
2022-06-24,Binh Duong,Ben Cat,15,1,0,1,1
2022-06-24,Binh Duong,Ben Cat,16,1,0,1,1
2022-06-24,Binh Duong,Ben Cat,18,1,0,1,1
2022-06-24,Binh Duong,Ben Cat,20,1,0,1,1
2022-06-24,Binh Duong,Di An,6,3,0,3,0
2022-06-24,Binh Duong,Di An,7,4,2,2,0
2022-06-24,Binh Duong,Di An,8,18,11,7,6
2022-06-24,Binh Duong,Di An,9,17,11,6,4
2022-06-24,Binh Duong,Di An,10,27,16,11,10
2022-06-24,Binh Duong,Di An,11,41,28,13,5
2022-06-24,Binh Duong,Di An,12,46,34,12,6
2022-06-24,Binh Duong,Di An,13,32,23,9,8
2022-06-24,Binh Duong,Di An,14,28,16,12,10
2022-06-24,Binh Duong,Di An,15,24,16,8,5
2022-06-24,Binh Duong,Di An,16,28,21,7,3
2022-06-24,Binh Duong,Di An,17,26,20,6,2
2022-06-24,Binh Duong,Di An,18,19,13,6,2
2022-06-24,Binh Duong,Di An,19,37,25,12,6
2022-06-24,Binh Duong,Di An,20,21,13,8,5
2022-06-24,Binh Duong,Di An,21,8,5,3,2
2022-06-24,Binh Duong,Tan Uyen,9,1,0,1,1
2022-06-24,Binh Duong,Tan Uyen,10,2,1,1,1
2022-06-24,Binh Duong,Tan Uyen,11,4,3,1,1
2022-06-24,Binh Duong,Tan Uyen,13,5,2,3,3
2022-06-24,Binh Duong,Tan Uyen,14,4,3,1,1
2022-06-24,Binh Duong,Tan Uyen,15,1,1,0,0
2022-06-24,Binh Duong,Tan Uyen,16,1,1,0,0
2022-06-24,Binh Duong,Tan Uyen,18,7,2,5,4
2022-06-24,Binh Duong,Tan Uyen,19,5,1,4,2
2022-06-24,Binh Duong,Tan Uyen,20,4,3,1,1
2022-06-24,Binh Duong,Tan Uyen,22,1,0,1,1
2022-06-24,Binh Duong,Thu Dau Mot Town,0,1,0,1,0
2022-06-24,Binh Duong,Thu Dau Mot Town,1,2,2,0,0
2022-06-24,Binh Duong,Thu Dau Mot Town,4,3,1,2,0
2022-06-24,Binh Duong,Thu Dau Mot Town,6,39,33,6,1
2022-06-24,Binh Duong,Thu Dau Mot Town,7,125,114,11,2
2022-06-24,Binh Duong,Thu Dau Mot Town,8,243,225,18,1
2022-06-24,Binh Duong,Thu Dau Mot Town,9,299,262,37,1
2022-06-24,Binh Duong,Thu Dau Mot Town,10,455,401,54,4
2022-06-24,Binh Duong,Thu Dau Mot Town,11,678,607,71,17
2022-06-24,Binh Duong,Thu Dau Mot Town,12,532,484,48,7
2022-06-24,Binh Duong,Thu Dau Mot Town,13,470,435,35,6
2022-06-24,Binh Duong,Thu Dau Mot Town,14,407,381,26,2
2022-06-24,Binh Duong,Thu Dau Mot Town,15,290,257,33,4
2022-06-24,Binh Duong,Thu Dau Mot Town,16,323,303,20,4
2022-06-24,Binh Duong,Thu Dau Mot Town,17,373,346,27,5
2022-06-24,Binh Duong,Thu Dau Mot Town,18,384,357,27,3
2022-06-24,Binh Duong,Thu Dau Mot Town,19,380,337,43,1
2022-06-24,Binh Duong,Thu Dau Mot Town,20,298,262,36,4
2022-06-24,Binh Duong,Thu Dau Mot Town,21,118,105,13,3
2022-06-24,Binh Duong,Thu Dau Mot Town,22,2,0,2,1
2022-06-24,Binh Duong,Thu Dau Mot Town,23,2,2,0,0
2022-06-24,Binh Duong,Thuan An,6,4,1,3,3
2022-06-24,Binh Duong,Thuan An,7,10,8,2,2
2022-06-24,Binh Duong,Thuan An,8,28,20,8,5
2022-06-24,Binh Duong,Thuan An,9,46,32,14,5
2022-06-24,Binh Duong,Thuan An,10,56,48,8,2
2022-06-24,Binh Duong,Thuan An,11,107,81,26,9
2022-06-24,Binh Duong,Thuan An,12,78,54,24,5
2022-06-24,Binh Duong,Thuan An,13,89,68,21,9
2022-06-24,Binh Duong,Thuan An,14,67,34,33,16
2022-06-24,Binh Duong,Thuan An,15,50,34,16,10
2022-06-24,Binh Duong,Thuan An,16,56,40,16,9
2022-06-24,Binh Duong,Thuan An,17,41,33,8,4
2022-06-24,Binh Duong,Thuan An,18,44,37,7,1
2022-06-24,Binh Duong,Thuan An,19,65,58,7,2
2022-06-24,Binh Duong,Thuan An,20,45,34,11,4
2022-06-24,Binh Duong,Thuan An,21,23,9,14,10
2022-06-24,Can Tho City,Binh Thuy District,1,1,0,1,1
2022-06-24,Can Tho City,Binh Thuy District,6,1,0,1,1
2022-06-24,Can Tho City,Binh Thuy District,7,3,3,0,0
2022-06-24,Can Tho City,Binh Thuy District,8,8,7,1,1
2022-06-24,Can Tho City,Binh Thuy District,9,3,3,0,0
2022-06-24,Can Tho City,Binh Thuy District,10,8,8,0,0
2022-06-24,Can Tho City,Binh Thuy District,11,11,11,0,0
2022-06-24,Can Tho City,Binh Thuy District,12,12,11,1,0
2022-06-24,Can Tho City,Binh Thuy District,13,12,12,0,0
2022-06-24,Can Tho City,Binh Thuy District,14,15,15,0,0
2022-06-24,Can Tho City,Binh Thuy District,15,5,5,0,0
2022-06-24,Can Tho City,Binh Thuy District,16,15,14,1,0
2022-06-24,Can Tho City,Binh Thuy District,17,9,9,0,0
2022-06-24,Can Tho City,Binh Thuy District,18,11,9,2,2
2022-06-24,Can Tho City,Binh Thuy District,19,8,8,0,0
2022-06-24,Can Tho City,Binh Thuy District,20,9,9,0,0
2022-06-24,Can Tho City,Binh Thuy District,21,3,2,1,0
2022-06-24,Can Tho City,Cai Rang District,7,4,2,2,2
2022-06-24,Can Tho City,Cai Rang District,8,5,4,1,1
2022-06-24,Can Tho City,Cai Rang District,9,7,7,0,0
2022-06-24,Can Tho City,Cai Rang District,10,7,6,1,0
2022-06-24,Can Tho City,Cai Rang District,11,11,10,1,0
2022-06-24,Can Tho City,Cai Rang District,12,14,11,3,1
2022-06-24,Can Tho City,Cai Rang District,13,16,11,5,1
2022-06-24,Can Tho City,Cai Rang District,14,14,13,1,0
2022-06-24,Can Tho City,Cai Rang District,15,15,9,6,4
2022-06-24,Can Tho City,Cai Rang District,16,9,5,4,0
2022-06-24,Can Tho City,Cai Rang District,17,12,11,1,1
2022-06-24,Can Tho City,Cai Rang District,18,18,15,3,1
2022-06-24,Can Tho City,Cai Rang District,19,18,13,5,0
2022-06-24,Can Tho City,Cai Rang District,20,12,10,2,0
2022-06-24,Can Tho City,Cai Rang District,21,8,8,0,0
2022-06-24,Can Tho City,Ninh Kieu District,0,6,4,2,0
2022-06-24,Can Tho City,Ninh Kieu District,1,1,0,1,0
2022-06-24,Can Tho City,Ninh Kieu District,5,3,2,1,1
2022-06-24,Can Tho City,Ninh Kieu District,6,51,47,4,0
2022-06-24,Can Tho City,Ninh Kieu District,7,137,128,9,0
2022-06-24,Can Tho City,Ninh Kieu District,8,241,224,17,0
2022-06-24,Can Tho City,Ninh Kieu District,9,301,286,15,0
2022-06-24,Can Tho City,Ninh Kieu District,10,540,510,30,0
2022-06-24,Can Tho City,Ninh Kieu District,11,879,824,55,5
2022-06-24,Can Tho City,Ninh Kieu District,12,627,595,32,0
2022-06-24,Can Tho City,Ninh Kieu District,13,491,472,19,0
2022-06-24,Can Tho City,Ninh Kieu District,14,423,406,17,0
2022-06-24,Can Tho City,Ninh Kieu District,15,354,337,17,0
2022-06-24,Can Tho City,Ninh Kieu District,16,402,390,12,0
2022-06-24,Can Tho City,Ninh Kieu District,17,551,516,35,0
2022-06-24,Can Tho City,Ninh Kieu District,18,542,499,43,0
2022-06-24,Can Tho City,Ninh Kieu District,19,489,469,20,0
2022-06-24,Can Tho City,Ninh Kieu District,20,367,342,25,0
2022-06-24,Can Tho City,Ninh Kieu District,21,198,183,15,0
2022-06-24,Can Tho City,Ninh Kieu District,22,3,2,1,0
2022-06-24,Can Tho City,Ninh Kieu District,23,1,1,0,0
2022-06-24,Can Tho City,Thoi Lai,16,1,0,1,1
2022-06-24,Dong Nai,Bien Hoa City,0,2,2,0,0
2022-06-24,Dong Nai,Bien Hoa City,1,1,1,0,0
2022-06-24,Dong Nai,Bien Hoa City,2,5,1,4,1
2022-06-24,Dong Nai,Bien Hoa City,5,2,1,1,1
2022-06-24,Dong Nai,Bien Hoa City,6,49,37,12,3
2022-06-24,Dong Nai,Bien Hoa City,7,174,151,23,9
2022-06-24,Dong Nai,Bien Hoa City,8,311,283,28,0
2022-06-24,Dong Nai,Bien Hoa City,9,475,419,56,6
2022-06-24,Dong Nai,Bien Hoa City,10,821,736,85,6
2022-06-24,Dong Nai,Bien Hoa City,11,1099,1010,89,20
2022-06-24,Dong Nai,Bien Hoa City,12,921,857,64,4
2022-06-24,Dong Nai,Bien Hoa City,13,942,865,77,10
2022-06-24,Dong Nai,Bien Hoa City,14,668,611,57,8
2022-06-24,Dong Nai,Bien Hoa City,15,476,437,39,9
2022-06-24,Dong Nai,Bien Hoa City,16,538,499,39,10
2022-06-24,Dong Nai,Bien Hoa City,17,632,595,37,6
2022-06-24,Dong Nai,Bien Hoa City,18,647,602,45,7
2022-06-24,Dong Nai,Bien Hoa City,19,634,578,56,8
2022-06-24,Dong Nai,Bien Hoa City,20,575,483,92,23
2022-06-24,Dong Nai,Bien Hoa City,21,259,197,62,11
2022-06-24,Dong Nai,Bien Hoa City,22,2,0,2,1
2022-06-24,Dong Nai,Bien Hoa City,23,1,1,0,0
2022-06-24,Dong Nai,Cam My,19,1,0,1,1
2022-06-24,Dong Nai,Long Khanh,18,1,0,1,0
2022-06-24,Dong Nai,Long Khanh,19,1,0,1,1
2022-06-24,Dong Nai,Long Thanh,9,2,0,2,2
2022-06-24,Dong Nai,Long Thanh,10,3,0,3,3
2022-06-24,Dong Nai,Long Thanh,11,2,0,2,2
2022-06-24,Dong Nai,Long Thanh,12,3,0,3,3
2022-06-24,Dong Nai,Long Thanh,13,1,0,1,1
2022-06-24,Dong Nai,Long Thanh,14,2,0,2,2
2022-06-24,Dong Nai,Long Thanh,17,2,0,2,1
2022-06-24,Dong Nai,Long Thanh,20,1,0,1,1
2022-06-24,Dong Nai,Nhon trach,9,6,0,6,2
2022-06-24,Dong Nai,Nhon trach,10,2,0,2,2
2022-06-24,Dong Nai,Nhon trach,13,1,0,1,1
2022-06-24,Dong Nai,Nhon trach,14,2,0,2,2
2022-06-24,Dong Nai,Nhon trach,15,1,0,1,1
2022-06-24,Dong Nai,Trang Bom,9,1,0,1,0
2022-06-24,Dong Nai,Trang Bom,10,1,1,0,0
2022-06-24,Dong Nai,Trang Bom,17,1,0,1,1
2022-06-24,Dong Nai,Trang Bom,19,1,0,1,1
2022-06-24,Dong Nai,Trang Bom,20,1,0,1,0
2022-06-24,Dong Nai,Trang Bom,21,2,0,2,2
2022-06-24,Dong Nai,Vinh Cuu,11,1,1,0,0
2022-06-24,Hai Phong City,An Duong,8,5,1,4,1
2022-06-24,Hai Phong City,An Duong,9,3,2,1,1
2022-06-24,Hai Phong City,An Duong,10,9,2,7,5
2022-06-24,Hai Phong City,An Duong,11,12,6,6,6
2022-06-24,Hai Phong City,An Duong,12,4,1,3,2
2022-06-24,Hai Phong City,An Duong,13,2,1,1,1
2022-06-24,Hai Phong City,An Duong,14,7,1,6,6
2022-06-24,Hai Phong City,An Duong,15,5,3,2,1
2022-06-24,Hai Phong City,An Duong,17,3,2,1,0
2022-06-24,Hai Phong City,An Duong,18,4,0,4,2
2022-06-24,Hai Phong City,An Duong,19,1,1,0,0
2022-06-24,Hai Phong City,An Duong,20,3,0,3,3
2022-06-24,Hai Phong City,An Duong,21,1,0,1,0
2022-06-24,Hai Phong City,Duong Kinh District,17,1,0,1,1
2022-06-24,Hai Phong City,Hai An District,6,1,0,1,0
2022-06-24,Hai Phong City,Hai An District,7,6,3,3,0
2022-06-24,Hai Phong City,Hai An District,8,25,17,8,2
2022-06-24,Hai Phong City,Hai An District,9,9,6,3,0
2022-06-24,Hai Phong City,Hai An District,10,33,28,5,2
2022-06-24,Hai Phong City,Hai An District,11,64,49,15,7
2022-06-24,Hai Phong City,Hai An District,12,25,21,4,1
2022-06-24,Hai Phong City,Hai An District,13,19,15,4,0
2022-06-24,Hai Phong City,Hai An District,14,23,16,7,3
2022-06-24,Hai Phong City,Hai An District,15,24,19,5,0
2022-06-24,Hai Phong City,Hai An District,16,17,11,6,2
2022-06-24,Hai Phong City,Hai An District,17,24,22,2,2
2022-06-24,Hai Phong City,Hai An District,18,28,24,4,2
2022-06-24,Hai Phong City,Hai An District,19,27,17,10,1
2022-06-24,Hai Phong City,Hai An District,20,12,10,2,0
2022-06-24,Hai Phong City,Hai An District,21,6,4,2,0
2022-06-24,Hai Phong City,Hong Bang District,6,1,0,1,1
2022-06-24,Hai Phong City,Hong Bang District,7,9,7,2,2
2022-06-24,Hai Phong City,Hong Bang District,8,34,32,2,0
2022-06-24,Hai Phong City,Hong Bang District,9,29,24,5,0
2022-06-24,Hai Phong City,Hong Bang District,10,55,42,13,3
2022-06-24,Hai Phong City,Hong Bang District,11,108,92,16,7
2022-06-24,Hai Phong City,Hong Bang District,12,63,54,9,4
2022-06-24,Hai Phong City,Hong Bang District,13,43,36,7,2
2022-06-24,Hai Phong City,Hong Bang District,14,46,37,9,3
2022-06-24,Hai Phong City,Hong Bang District,15,54,49,5,1
2022-06-24,Hai Phong City,Hong Bang District,16,38,34,4,1
2022-06-24,Hai Phong City,Hong Bang District,17,48,44,4,1
2022-06-24,Hai Phong City,Hong Bang District,18,52,40,12,1
2022-06-24,Hai Phong City,Hong Bang District,19,67,59,8,1
2022-06-24,Hai Phong City,Hong Bang District,20,40,29,11,3
2022-06-24,Hai Phong City,Hong Bang District,21,14,14,0,0
2022-06-24,Hai Phong City,Hong Bang District,23,1,1,0,0
2022-06-24,Hai Phong City,Kien An District,6,1,0,1,1
2022-06-24,Hai Phong City,Kien An District,7,2,1,1,1
2022-06-24,Hai Phong City,Kien An District,8,3,2,1,1
2022-06-24,Hai Phong City,Kien An District,9,2,2,0,0
2022-06-24,Hai Phong City,Kien An District,10,6,6,0,0
2022-06-24,Hai Phong City,Kien An District,11,19,19,0,0
2022-06-24,Hai Phong City,Kien An District,12,11,10,1,0
2022-06-24,Hai Phong City,Kien An District,13,10,4,6,3
2022-06-24,Hai Phong City,Kien An District,14,11,8,3,2
2022-06-24,Hai Phong City,Kien An District,15,19,14,5,3
2022-06-24,Hai Phong City,Kien An District,16,9,7,2,0
2022-06-24,Hai Phong City,Kien An District,17,3,3,0,0
2022-06-24,Hai Phong City,Kien An District,18,10,5,5,1
2022-06-24,Hai Phong City,Kien An District,19,24,13,11,2
2022-06-24,Hai Phong City,Kien An District,20,11,10,1,1
2022-06-24,Hai Phong City,Kien An District,21,1,1,0,0
2022-06-24,Hai Phong City,Le Chan District,5,1,0,1,0
2022-06-24,Hai Phong City,Le Chan District,6,2,0,2,0
2022-06-24,Hai Phong City,Le Chan District,7,35,26,9,5
2022-06-24,Hai Phong City,Le Chan District,8,81,69,12,2
2022-06-24,Hai Phong City,Le Chan District,9,101,86,15,2
2022-06-24,Hai Phong City,Le Chan District,10,220,190,30,4
2022-06-24,Hai Phong City,Le Chan District,11,374,315,59,21
2022-06-24,Hai Phong City,Le Chan District,12,252,223,29,1
2022-06-24,Hai Phong City,Le Chan District,13,147,129,18,3
2022-06-24,Hai Phong City,Le Chan District,14,161,139,22,5
2022-06-24,Hai Phong City,Le Chan District,15,183,158,25,4
2022-06-24,Hai Phong City,Le Chan District,16,160,144,16,2
2022-06-24,Hai Phong City,Le Chan District,17,189,168,21,3
2022-06-24,Hai Phong City,Le Chan District,18,238,211,27,7
2022-06-24,Hai Phong City,Le Chan District,19,177,155,22,3
2022-06-24,Hai Phong City,Le Chan District,20,147,117,30,5
2022-06-24,Hai Phong City,Le Chan District,21,63,55,8,1
2022-06-24,Hai Phong City,Ngo Quyen District,3,1,0,1,1
2022-06-24,Hai Phong City,Ngo Quyen District,6,1,1,0,0
2022-06-24,Hai Phong City,Ngo Quyen District,7,18,16,2,1
2022-06-24,Hai Phong City,Ngo Quyen District,8,74,68,6,1
2022-06-24,Hai Phong City,Ngo Quyen District,9,95,85,10,2
2022-06-24,Hai Phong City,Ngo Quyen District,10,165,145,20,7
2022-06-24,Hai Phong City,Ngo Quyen District,11,266,232,34,7
2022-06-24,Hai Phong City,Ngo Quyen District,12,175,159,16,1
2022-06-24,Hai Phong City,Ngo Quyen District,13,104,91,13,2
2022-06-24,Hai Phong City,Ngo Quyen District,14,150,130,20,8
2022-06-24,Hai Phong City,Ngo Quyen District,15,154,130,24,4
2022-06-24,Hai Phong City,Ngo Quyen District,16,122,108,14,3
2022-06-24,Hai Phong City,Ngo Quyen District,17,123,106,17,1
2022-06-24,Hai Phong City,Ngo Quyen District,18,152,131,21,3
2022-06-24,Hai Phong City,Ngo Quyen District,19,131,115,16,3
2022-06-24,Hai Phong City,Ngo Quyen District,20,122,107,15,1
2022-06-24,Hai Phong City,Ngo Quyen District,21,47,40,7,1
2022-06-24,Hai Phong City,Ngo Quyen District,22,1,0,1,0
2022-06-24,Hai Phong City,Thuy Nguyen,8,1,0,1,1
2022-06-24,Hai Phong City,Thuy Nguyen,9,1,0,1,0
2022-06-24,Hai Phong City,Thuy Nguyen,11,2,0,2,2
2022-06-24,Hai Phong City,Thuy Nguyen,13,2,1,1,0
2022-06-24,Hai Phong City,Thuy Nguyen,14,1,0,1,1
2022-06-24,Hai Phong City,Thuy Nguyen,16,2,1,1,0
2022-06-24,Hai Phong City,Thuy Nguyen,17,1,0,1,1
2022-06-24,Hai Phong City,Thuy Nguyen,18,1,0,1,1
2022-06-24,Hai Phong City,Thuy Nguyen,19,1,0,1,1
2022-06-24,Hue City,Hue City,1,2,1,1,0
2022-06-24,Hue City,Hue City,4,1,1,0,0
2022-06-24,Hue City,Hue City,5,3,1,2,1
2022-06-24,Hue City,Hue City,6,80,70,10,2
2022-06-24,Hue City,Hue City,7,185,173,12,1
2022-06-24,Hue City,Hue City,8,301,284,17,0
2022-06-24,Hue City,Hue City,9,276,246,30,1
2022-06-24,Hue City,Hue City,10,431,391,40,1
2022-06-24,Hue City,Hue City,11,939,857,82,9
2022-06-24,Hue City,Hue City,12,567,522,45,0
2022-06-24,Hue City,Hue City,13,369,335,34,2
2022-06-24,Hue City,Hue City,14,397,367,30,0
2022-06-24,Hue City,Hue City,15,382,350,32,2
2022-06-24,Hue City,Hue City,16,351,333,18,1
2022-06-24,Hue City,Hue City,17,457,427,30,1
2022-06-24,Hue City,Hue City,18,545,478,67,2
2022-06-24,Hue City,Hue City,19,569,500,69,3
2022-06-24,Hue City,Hue City,20,398,322,76,7
2022-06-24,Hue City,Hue City,21,320,239,81,17
2022-06-24,Hue City,Hue City,22,1,0,1,1
2022-06-24,Hue City,Hue City,23,4,1,3,0
2022-06-24,Hue City,Huong Thuy,6,2,0,2,0
2022-06-24,Hue City,Huong Thuy,8,2,2,0,0
2022-06-24,Hue City,Huong Thuy,9,3,3,0,0
2022-06-24,Hue City,Huong Thuy,10,1,0,1,0
2022-06-24,Hue City,Huong Thuy,11,5,3,2,1
2022-06-24,Hue City,Huong Thuy,12,1,0,1,1
2022-06-24,Hue City,Huong Thuy,13,2,1,1,1
2022-06-24,Hue City,Huong Thuy,14,1,1,0,0
2022-06-24,Hue City,Huong Thuy,15,1,1,0,0
2022-06-24,Hue City,Huong Thuy,16,2,1,1,0
2022-06-24,Hue City,Huong Thuy,18,1,1,0,0
2022-06-24,Hue City,Huong Thuy,19,2,2,0,0
2022-06-24,Hue City,Huong Thuy,20,1,1,0,0
2022-06-24,Hue City,Huong Thuy,21,3,1,2,1
2022-06-24,Hue City,Phu Vang,9,1,1,0,0
2022-06-24,Hue City,Phu Vang,10,1,1,0,0
2022-06-24,Hue City,Phu Vang,11,3,1,2,0
2022-06-24,Hue City,Phu Vang,12,4,3,1,0
2022-06-24,Hue City,Phu Vang,14,2,1,1,1
2022-06-24,Hue City,Phu Vang,16,1,1,0,0
2022-06-24,Hue City,Phu Vang,17,3,1,2,2
2022-06-24,Hue City,Phu Vang,18,1,1,0,0
2022-06-24,Hue City,Phu Vang,19,2,1,1,0
2022-06-24,Hue City,Phu Vang,20,1,0,1,1
2022-06-24,Hue City,Phu Vang,21,2,0,2,2
2022-06-24,Khanh Hoa,Cam Ranh City,15,1,0,1,0
2022-06-24,Khanh Hoa,Dien Khanh,6,1,0,1,1
2022-06-24,Khanh Hoa,Dien Khanh,15,1,0,1,1
2022-06-24,Khanh Hoa,Dien Khanh,16,1,0,1,1
2022-06-24,Khanh Hoa,Nha Trang City,0,1,1,0,0
2022-06-24,Khanh Hoa,Nha Trang City,3,1,1,0,0
2022-06-24,Khanh Hoa,Nha Trang City,4,1,1,0,0
2022-06-24,Khanh Hoa,Nha Trang City,5,2,1,1,1
2022-06-24,Khanh Hoa,Nha Trang City,6,43,37,6,1
2022-06-24,Khanh Hoa,Nha Trang City,7,134,119,15,0
2022-06-24,Khanh Hoa,Nha Trang City,8,228,210,18,1
2022-06-24,Khanh Hoa,Nha Trang City,9,193,174,19,1
2022-06-24,Khanh Hoa,Nha Trang City,10,264,226,38,1
2022-06-24,Khanh Hoa,Nha Trang City,11,444,412,32,0
2022-06-24,Khanh Hoa,Nha Trang City,12,293,271,22,0
2022-06-24,Khanh Hoa,Nha Trang City,13,299,282,17,1
2022-06-24,Khanh Hoa,Nha Trang City,14,275,261,14,0
2022-06-24,Khanh Hoa,Nha Trang City,15,167,161,6,0
2022-06-24,Khanh Hoa,Nha Trang City,16,167,157,10,1
2022-06-24,Khanh Hoa,Nha Trang City,17,217,201,16,1
2022-06-24,Khanh Hoa,Nha Trang City,18,235,203,32,1
2022-06-24,Khanh Hoa,Nha Trang City,19,272,231,41,0
2022-06-24,Khanh Hoa,Nha Trang City,20,169,148,21,0
2022-06-24,Khanh Hoa,Nha Trang City,21,121,83,38,10
2022-06-24,Khanh Hoa,Nha Trang City,23,1,1,0,0
2022-06-24,Lam Dong,Da Lat City,0,2,1,1,0
2022-06-24,Lam Dong,Da Lat City,6,1,1,0,0
2022-06-24,Lam Dong,Da Lat City,7,52,25,27,20
2022-06-24,Lam Dong,Da Lat City,8,93,65,28,21
2022-06-24,Lam Dong,Da Lat City,9,96,81,15,6
2022-06-24,Lam Dong,Da Lat City,10,109,89,20,2
2022-06-24,Lam Dong,Da Lat City,11,141,120,21,11
2022-06-24,Lam Dong,Da Lat City,12,149,98,51,30
2022-06-24,Lam Dong,Da Lat City,13,164,84,80,51
2022-06-24,Lam Dong,Da Lat City,14,129,79,50,29
2022-06-24,Lam Dong,Da Lat City,15,111,75,36,20
2022-06-24,Lam Dong,Da Lat City,16,102,66,36,23
2022-06-24,Lam Dong,Da Lat City,17,176,110,66,48
2022-06-24,Lam Dong,Da Lat City,18,284,111,173,113
2022-06-24,Lam Dong,Da Lat City,19,352,119,233,182
2022-06-24,Lam Dong,Da Lat City,20,358,98,260,207
2022-06-24,Lam Dong,Da Lat City,21,229,58,171,136
2022-06-24,Lam Dong,Da Lat City,22,4,1,3,0
2022-06-24,Nghe An,Do luong,13,1,0,1,1
2022-06-24,Nghe An,Do luong,14,2,0,2,2
2022-06-24,Nghe An,Do luong,15,2,0,2,2
2022-06-24,Nghe An,Vinh City,0,3,3,0,0
2022-06-24,Nghe An,Vinh City,1,1,1,0,0
2022-06-24,Nghe An,Vinh City,2,1,1,0,0
2022-06-24,Nghe An,Vinh City,6,12,7,5,1
2022-06-24,Nghe An,Vinh City,7,141,122,19,3
2022-06-24,Nghe An,Vinh City,8,179,162,17,0
2022-06-24,Nghe An,Vinh City,9,161,137,24,0
2022-06-24,Nghe An,Vinh City,10,233,191,42,14
2022-06-24,Nghe An,Vinh City,11,481,383,98,33
2022-06-24,Nghe An,Vinh City,12,265,231,34,6
2022-06-24,Nghe An,Vinh City,13,156,139,17,1
2022-06-24,Nghe An,Vinh City,14,185,162,23,2
2022-06-24,Nghe An,Vinh City,15,166,145,21,5
2022-06-24,Nghe An,Vinh City,16,133,114,19,1
2022-06-24,Nghe An,Vinh City,17,151,126,25,7
2022-06-24,Nghe An,Vinh City,18,218,155,63,39
2022-06-24,Nghe An,Vinh City,19,167,139,28,7
2022-06-24,Nghe An,Vinh City,20,144,113,31,3
2022-06-24,Nghe An,Vinh City,21,77,54,23,12
2022-06-24,Nghe An,Vinh City,22,1,0,1,0
2022-06-24,Quang Nam,Dien Ban,11,1,0,1,1
2022-06-24,Quang Nam,Hoi An City,7,9,6,3,1
2022-06-24,Quang Nam,Hoi An City,8,22,18,4,3
2022-06-24,Quang Nam,Hoi An City,9,33,28,5,0
2022-06-24,Quang Nam,Hoi An City,10,34,28,6,0
2022-06-24,Quang Nam,Hoi An City,11,58,41,17,7
2022-06-24,Quang Nam,Hoi An City,12,49,38,11,3
2022-06-24,Quang Nam,Hoi An City,13,36,28,8,3
2022-06-24,Quang Nam,Hoi An City,14,39,30,9,3
2022-06-24,Quang Nam,Hoi An City,15,30,26,4,0
2022-06-24,Quang Nam,Hoi An City,16,22,19,3,0
2022-06-24,Quang Nam,Hoi An City,17,27,25,2,0
2022-06-24,Quang Nam,Hoi An City,18,35,29,6,2
2022-06-24,Quang Nam,Hoi An City,19,53,43,10,2
2022-06-24,Quang Nam,Hoi An City,20,42,28,14,6
2022-06-24,Quang Nam,Hoi An City,21,31,18,13,6
2022-06-24,Quang Nam,Tam Ky City,8,2,0,2,1
2022-06-24,Quang Nam,Tam Ky City,13,2,0,2,1
2022-06-24,Quang Ninh,Cam Pha City,9,1,0,1,0
2022-06-24,Quang Ninh,Cam Pha City,10,2,0,2,2
2022-06-24,Quang Ninh,Cam Pha City,11,1,0,1,1
2022-06-24,Quang Ninh,Cam Pha City,14,2,0,2,2
2022-06-24,Quang Ninh,Cam Pha City,18,1,0,1,0
2022-06-24,Quang Ninh,Ha Long City,1,1,0,1,0
2022-06-24,Quang Ninh,Ha Long City,5,1,0,1,1
2022-06-24,Quang Ninh,Ha Long City,6,6,1,5,2
2022-06-24,Quang Ninh,Ha Long City,7,37,24,13,9
2022-06-24,Quang Ninh,Ha Long City,8,55,34,21,11
2022-06-24,Quang Ninh,Ha Long City,9,76,46,30,12
2022-06-24,Quang Ninh,Ha Long City,10,98,71,27,6
2022-06-24,Quang Ninh,Ha Long City,11,143,117,26,8
2022-06-24,Quang Ninh,Ha Long City,12,96,72,24,8
2022-06-24,Quang Ninh,Ha Long City,13,60,42,18,7
2022-06-24,Quang Ninh,Ha Long City,14,84,42,42,25
2022-06-24,Quang Ninh,Ha Long City,15,79,48,31,17
2022-06-24,Quang Ninh,Ha Long City,16,60,35,25,11
2022-06-24,Quang Ninh,Ha Long City,17,53,40,13,3
2022-06-24,Quang Ninh,Ha Long City,18,56,41,15,2
2022-06-24,Quang Ninh,Ha Long City,19,67,49,18,8
2022-06-24,Quang Ninh,Ha Long City,20,66,49,17,7
2022-06-24,Quang Ninh,Ha Long City,21,1,0,1,0
2022-06-24,Quang Ninh,Ha Long City,23,1,0,1,0
2022-06-24,Quang Ninh,Uong Bi City,11,1,0,1,1
2022-06-24,Quang Ninh,Uong Bi City,17,1,0,1,0
2022-06-24,Thai Nguyen,Dong Hy,7,1,0,1,1
2022-06-24,Thai Nguyen,Dong Hy,8,1,1,0,0
2022-06-24,Thai Nguyen,Dong Hy,10,1,1,0,0
2022-06-24,Thai Nguyen,Dong Hy,11,1,1,0,0
2022-06-24,Thai Nguyen,Dong Hy,15,1,1,0,0
2022-06-24,Thai Nguyen,Thai Nguyen City,0,1,1,0,0
2022-06-24,Thai Nguyen,Thai Nguyen City,1,1,1,0,0
2022-06-24,Thai Nguyen,Thai Nguyen City,5,2,1,1,0
2022-06-24,Thai Nguyen,Thai Nguyen City,6,6,4,2,0
2022-06-24,Thai Nguyen,Thai Nguyen City,7,84,78,6,2
2022-06-24,Thai Nguyen,Thai Nguyen City,8,157,150,7,1
2022-06-24,Thai Nguyen,Thai Nguyen City,9,130,117,13,2
2022-06-24,Thai Nguyen,Thai Nguyen City,10,207,188,19,1
2022-06-24,Thai Nguyen,Thai Nguyen City,11,475,429,46,11
2022-06-24,Thai Nguyen,Thai Nguyen City,12,283,260,23,1
2022-06-24,Thai Nguyen,Thai Nguyen City,13,172,153,19,0
2022-06-24,Thai Nguyen,Thai Nguyen City,14,175,154,21,4
2022-06-24,Thai Nguyen,Thai Nguyen City,15,150,127,23,2
2022-06-24,Thai Nguyen,Thai Nguyen City,16,143,132,11,1
2022-06-24,Thai Nguyen,Thai Nguyen City,17,144,135,9,2
2022-06-24,Thai Nguyen,Thai Nguyen City,18,198,182,16,2
2022-06-24,Thai Nguyen,Thai Nguyen City,19,211,191,20,0
2022-06-24,Thai Nguyen,Thai Nguyen City,20,170,150,20,3
2022-06-24,Thai Nguyen,Thai Nguyen City,21,137,113,24,11
2022-06-24,Thai Nguyen,Thai Nguyen City,22,3,1,2,0
2022-06-24,Thai Nguyen,Thai Nguyen City,23,1,1,0,0
2022-06-24,Vung Tau,Ba Ria City,7,1,1,0,0
2022-06-24,Vung Tau,Ba Ria City,9,3,2,1,1
2022-06-24,Vung Tau,Ba Ria City,10,4,3,1,0
2022-06-24,Vung Tau,Ba Ria City,11,5,3,2,2
2022-06-24,Vung Tau,Ba Ria City,12,5,3,2,2
2022-06-24,Vung Tau,Ba Ria City,13,4,3,1,1
2022-06-24,Vung Tau,Ba Ria City,14,2,1,1,1
2022-06-24,Vung Tau,Ba Ria City,15,3,3,0,0
2022-06-24,Vung Tau,Ba Ria City,16,8,6,2,0
2022-06-24,Vung Tau,Ba Ria City,17,9,6,3,1
2022-06-24,Vung Tau,Ba Ria City,18,5,3,2,1
2022-06-24,Vung Tau,Ba Ria City,19,9,1,8,5
2022-06-24,Vung Tau,Ba Ria City,20,2,0,2,2
2022-06-24,Vung Tau,Ba Ria City,21,2,0,2,2
2022-06-24,Vung Tau,Vung Tau City,1,3,2,1,0
2022-06-24,Vung Tau,Vung Tau City,2,1,1,0,0
2022-06-24,Vung Tau,Vung Tau City,4,3,1,2,0
2022-06-24,Vung Tau,Vung Tau City,5,1,1,0,0
2022-06-24,Vung Tau,Vung Tau City,6,41,33,8,2
2022-06-24,Vung Tau,Vung Tau City,7,134,124,10,1
2022-06-24,Vung Tau,Vung Tau City,8,184,167,17,2
2022-06-24,Vung Tau,Vung Tau City,9,210,199,11,4
2022-06-24,Vung Tau,Vung Tau City,10,225,202,23,1
2022-06-24,Vung Tau,Vung Tau City,11,408,377,31,4
2022-06-24,Vung Tau,Vung Tau City,12,309,284,25,1
2022-06-24,Vung Tau,Vung Tau City,13,223,213,10,1
2022-06-24,Vung Tau,Vung Tau City,14,318,298,20,0
2022-06-24,Vung Tau,Vung Tau City,15,224,209,15,2
2022-06-24,Vung Tau,Vung Tau City,16,237,217,20,2
2022-06-24,Vung Tau,Vung Tau City,17,250,226,24,1
2022-06-24,Vung Tau,Vung Tau City,18,342,314,28,2
2022-06-24,Vung Tau,Vung Tau City,19,313,281,32,3
2022-06-24,Vung Tau,Vung Tau City,20,193,169,24,4
2022-06-24,Vung Tau,Vung Tau City,21,132,111,21,2
2022-06-24,Vung Tau,Vung Tau City,22,1,0,1,0
2022-06-25,Bac Ninh,Bác Ninh City,0,1,1,0,0
2022-06-25,Bac Ninh,Bác Ninh City,1,3,2,1,0
2022-06-25,Bac Ninh,Bác Ninh City,5,1,0,1,1
2022-06-25,Bac Ninh,Bác Ninh City,6,4,4,0,0
2022-06-25,Bac Ninh,Bác Ninh City,7,56,49,7,0
2022-06-25,Bac Ninh,Bác Ninh City,8,111,104,7,1
2022-06-25,Bac Ninh,Bác Ninh City,9,132,114,18,1
2022-06-25,Bac Ninh,Bác Ninh City,10,198,179,19,1
2022-06-25,Bac Ninh,Bác Ninh City,11,369,332,37,5
2022-06-25,Bac Ninh,Bác Ninh City,12,262,237,25,5
2022-06-25,Bac Ninh,Bác Ninh City,13,177,145,32,10
2022-06-25,Bac Ninh,Bác Ninh City,14,151,137,14,1
2022-06-25,Bac Ninh,Bác Ninh City,15,134,124,10,0
2022-06-25,Bac Ninh,Bác Ninh City,16,139,126,13,0
2022-06-25,Bac Ninh,Bác Ninh City,17,119,114,5,0
2022-06-25,Bac Ninh,Bác Ninh City,18,188,172,16,1
2022-06-25,Bac Ninh,Bác Ninh City,19,224,192,32,14
2022-06-25,Bac Ninh,Bác Ninh City,20,174,141,33,16
2022-06-25,Bac Ninh,Bác Ninh City,21,115,86,29,8
2022-06-25,Bac Ninh,Bác Ninh City,22,3,1,2,0
2022-06-25,Bac Ninh,Bác Ninh City,23,1,0,1,0
2022-06-25,Bac Ninh,Que Vo,8,1,1,0,0
2022-06-25,Bac Ninh,Que Vo,9,1,0,1,1
2022-06-25,Bac Ninh,Que Vo,10,2,1,1,0
2022-06-25,Bac Ninh,Que Vo,12,2,1,1,1
2022-06-25,Bac Ninh,Que Vo,13,4,0,4,3
2022-06-25,Bac Ninh,Que Vo,14,1,0,1,0
2022-06-25,Bac Ninh,Que Vo,18,1,0,1,0
2022-06-25,Bac Ninh,Que Vo,19,1,0,1,0
2022-06-25,Bac Ninh,Que Vo,20,2,0,2,2
2022-06-25,Bac Ninh,Tien Du,8,1,0,1,1
2022-06-25,Bac Ninh,Tien Du,9,2,0,2,2
2022-06-25,Bac Ninh,Tien Du,10,1,0,1,1
2022-06-25,Bac Ninh,Tien Du,11,1,0,1,1
2022-06-25,Bac Ninh,Tien Du,12,5,0,5,4
2022-06-25,Bac Ninh,Tien Du,13,2,0,2,2
2022-06-25,Bac Ninh,Tien Du,15,1,0,1,1
2022-06-25,Bac Ninh,Tien Du,17,1,0,1,1
2022-06-25,Bac Ninh,Tien Du,19,2,0,2,0
2022-06-25,Bac Ninh,Tien Du,20,2,0,2,1
2022-06-25,Bac Ninh,Tu Son,10,2,0,2,2
2022-06-25,Bac Ninh,Tu Son,11,2,0,2,2
2022-06-25,Bac Ninh,Tu Son,12,1,0,1,1
2022-06-25,Bac Ninh,Tu Son,13,1,0,1,1
2022-06-25,Bac Ninh,Tu Son,14,1,0,1,1
2022-06-25,Bac Ninh,Tu Son,19,3,0,3,2
2022-06-25,Bac Ninh,Yen Phong,12,1,0,1,1
2022-06-25,Binh Duong,Ben Cat,8,1,0,1,1
2022-06-25,Binh Duong,Ben Cat,9,4,0,4,4
2022-06-25,Binh Duong,Ben Cat,10,2,0,2,2
2022-06-25,Binh Duong,Ben Cat,11,2,0,2,2
2022-06-25,Binh Duong,Ben Cat,12,3,0,3,2
2022-06-25,Binh Duong,Ben Cat,13,4,0,4,2
2022-06-25,Binh Duong,Ben Cat,14,1,0,1,1
2022-06-25,Binh Duong,Ben Cat,15,3,0,3,3
2022-06-25,Binh Duong,Ben Cat,17,3,0,3,3
2022-06-25,Binh Duong,Ben Cat,19,2,0,2,2
2022-06-25,Binh Duong,Ben Cat,21,2,0,2,0
2022-06-25,Binh Duong,Di An,6,1,0,1,1
2022-06-25,Binh Duong,Di An,7,6,1,5,4
2022-06-25,Binh Duong,Di An,8,16,10,6,0
2022-06-25,Binh Duong,Di An,9,14,8,6,4
2022-06-25,Binh Duong,Di An,10,26,22,4,1
2022-06-25,Binh Duong,Di An,11,56,43,13,6
2022-06-25,Binh Duong,Di An,12,43,38,5,1
2022-06-25,Binh Duong,Di An,13,37,31,6,1
2022-06-25,Binh Duong,Di An,14,34,28,6,0
2022-06-25,Binh Duong,Di An,15,25,18,7,2
2022-06-25,Binh Duong,Di An,16,28,21,7,2
2022-06-25,Binh Duong,Di An,17,22,20,2,0
2022-06-25,Binh Duong,Di An,18,34,25,9,4
2022-06-25,Binh Duong,Di An,19,40,29,11,3
2022-06-25,Binh Duong,Di An,20,25,17,8,4
2022-06-25,Binh Duong,Di An,21,11,7,4,1
2022-06-25,Binh Duong,Tan Uyen,7,1,0,1,1
2022-06-25,Binh Duong,Tan Uyen,8,2,0,2,1
2022-06-25,Binh Duong,Tan Uyen,9,6,2,4,4
2022-06-25,Binh Duong,Tan Uyen,10,8,3,5,4
2022-06-25,Binh Duong,Tan Uyen,11,5,1,4,2
2022-06-25,Binh Duong,Tan Uyen,12,7,5,2,1
2022-06-25,Binh Duong,Tan Uyen,13,5,3,2,1
2022-06-25,Binh Duong,Tan Uyen,14,7,3,4,3
2022-06-25,Binh Duong,Tan Uyen,15,3,1,2,0
2022-06-25,Binh Duong,Tan Uyen,17,4,1,3,1
2022-06-25,Binh Duong,Tan Uyen,18,4,1,3,2
2022-06-25,Binh Duong,Tan Uyen,19,2,1,1,1
2022-06-25,Binh Duong,Tan Uyen,20,1,0,1,1
2022-06-25,Binh Duong,Thu Dau Mot Town,0,1,1,0,0
2022-06-25,Binh Duong,Thu Dau Mot Town,1,1,1,0,0
2022-06-25,Binh Duong,Thu Dau Mot Town,6,37,34,3,1
2022-06-25,Binh Duong,Thu Dau Mot Town,7,126,115,11,1
2022-06-25,Binh Duong,Thu Dau Mot Town,8,233,212,21,1
2022-06-25,Binh Duong,Thu Dau Mot Town,9,296,273,23,4
2022-06-25,Binh Duong,Thu Dau Mot Town,10,406,384,22,1
2022-06-25,Binh Duong,Thu Dau Mot Town,11,601,553,48,7
2022-06-25,Binh Duong,Thu Dau Mot Town,12,550,511,39,6
2022-06-25,Binh Duong,Thu Dau Mot Town,13,458,424,34,8
2022-06-25,Binh Duong,Thu Dau Mot Town,14,345,316,29,4
2022-06-25,Binh Duong,Thu Dau Mot Town,15,315,303,12,2
2022-06-25,Binh Duong,Thu Dau Mot Town,16,332,316,16,2
2022-06-25,Binh Duong,Thu Dau Mot Town,17,424,398,26,3
2022-06-25,Binh Duong,Thu Dau Mot Town,18,403,372,31,10
2022-06-25,Binh Duong,Thu Dau Mot Town,19,403,373,30,7
2022-06-25,Binh Duong,Thu Dau Mot Town,20,294,269,25,5
2022-06-25,Binh Duong,Thu Dau Mot Town,21,164,137,27,6
2022-06-25,Binh Duong,Thu Dau Mot Town,22,3,2,1,0
2022-06-25,Binh Duong,Thuan An,2,1,0,1,0
2022-06-25,Binh Duong,Thuan An,6,2,0,2,2
2022-06-25,Binh Duong,Thuan An,7,5,4,1,1
2022-06-25,Binh Duong,Thuan An,8,18,13,5,2
2022-06-25,Binh Duong,Thuan An,9,49,41,8,2
2022-06-25,Binh Duong,Thuan An,10,79,63,16,4
2022-06-25,Binh Duong,Thuan An,11,82,68,14,6
2022-06-25,Binh Duong,Thuan An,12,78,66,12,4
2022-06-25,Binh Duong,Thuan An,13,65,56,9,5
2022-06-25,Binh Duong,Thuan An,14,59,52,7,4
2022-06-25,Binh Duong,Thuan An,15,43,37,6,1
2022-06-25,Binh Duong,Thuan An,16,37,34,3,0
2022-06-25,Binh Duong,Thuan An,17,47,45,2,0
2022-06-25,Binh Duong,Thuan An,18,52,46,6,1
2022-06-25,Binh Duong,Thuan An,19,46,32,14,5
2022-06-25,Binh Duong,Thuan An,20,54,37,17,10
2022-06-25,Binh Duong,Thuan An,21,10,7,3,1
2022-06-25,Binh Duong,Thuan An,22,2,0,2,0
2022-06-25,Can Tho City,Binh Thuy District,6,1,1,0,0
2022-06-25,Can Tho City,Binh Thuy District,7,2,2,0,0
2022-06-25,Can Tho City,Binh Thuy District,8,1,1,0,0
2022-06-25,Can Tho City,Binh Thuy District,9,5,5,0,0
2022-06-25,Can Tho City,Binh Thuy District,10,11,10,1,0
2022-06-25,Can Tho City,Binh Thuy District,11,12,12,0,0
2022-06-25,Can Tho City,Binh Thuy District,12,9,9,0,0
2022-06-25,Can Tho City,Binh Thuy District,13,19,15,4,1
2022-06-25,Can Tho City,Binh Thuy District,14,9,9,0,0
2022-06-25,Can Tho City,Binh Thuy District,15,7,6,1,0
2022-06-25,Can Tho City,Binh Thuy District,16,12,10,2,0
2022-06-25,Can Tho City,Binh Thuy District,17,14,12,2,0
2022-06-25,Can Tho City,Binh Thuy District,18,15,15,0,0
2022-06-25,Can Tho City,Binh Thuy District,19,16,15,1,0
2022-06-25,Can Tho City,Binh Thuy District,20,4,3,1,0
2022-06-25,Can Tho City,Binh Thuy District,21,3,1,2,0
2022-06-25,Can Tho City,Cai Rang District,6,3,2,1,1
2022-06-25,Can Tho City,Cai Rang District,7,9,7,2,0
2022-06-25,Can Tho City,Cai Rang District,8,6,6,0,0
2022-06-25,Can Tho City,Cai Rang District,9,13,9,4,0
2022-06-25,Can Tho City,Cai Rang District,10,11,10,1,0
2022-06-25,Can Tho City,Cai Rang District,11,10,7,3,2
2022-06-25,Can Tho City,Cai Rang District,12,18,15,3,1
2022-06-25,Can Tho City,Cai Rang District,13,17,16,1,1
2022-06-25,Can Tho City,Cai Rang District,14,13,11,2,1
2022-06-25,Can Tho City,Cai Rang District,15,17,16,1,1
2022-06-25,Can Tho City,Cai Rang District,16,6,5,1,0
2022-06-25,Can Tho City,Cai Rang District,17,8,8,0,0
2022-06-25,Can Tho City,Cai Rang District,18,14,14,0,0
2022-06-25,Can Tho City,Cai Rang District,19,18,17,1,0
2022-06-25,Can Tho City,Cai Rang District,20,6,6,0,0
2022-06-25,Can Tho City,Cai Rang District,21,4,2,2,0
2022-06-25,Can Tho City,Ninh Kieu District,0,7,3,4,0
2022-06-25,Can Tho City,Ninh Kieu District,1,1,1,0,0
2022-06-25,Can Tho City,Ninh Kieu District,5,2,2,0,0
2022-06-25,Can Tho City,Ninh Kieu District,6,64,61,3,0
2022-06-25,Can Tho City,Ninh Kieu District,7,122,116,6,0
2022-06-25,Can Tho City,Ninh Kieu District,8,263,248,15,0
2022-06-25,Can Tho City,Ninh Kieu District,9,302,281,21,0
2022-06-25,Can Tho City,Ninh Kieu District,10,466,450,16,0
2022-06-25,Can Tho City,Ninh Kieu District,11,774,748,26,4
2022-06-25,Can Tho City,Ninh Kieu District,12,654,625,29,1
2022-06-25,Can Tho City,Ninh Kieu District,13,481,459,22,0
2022-06-25,Can Tho City,Ninh Kieu District,14,440,413,27,0
2022-06-25,Can Tho City,Ninh Kieu District,15,359,336,23,0
2022-06-25,Can Tho City,Ninh Kieu District,16,412,395,17,0
2022-06-25,Can Tho City,Ninh Kieu District,17,487,474,13,0
2022-06-25,Can Tho City,Ninh Kieu District,18,525,503,22,0
2022-06-25,Can Tho City,Ninh Kieu District,19,505,484,21,0
2022-06-25,Can Tho City,Ninh Kieu District,20,402,376,26,0
2022-06-25,Can Tho City,Ninh Kieu District,21,200,186,14,0
2022-06-25,Can Tho City,Ninh Kieu District,22,3,0,3,0
2022-06-25,Can Tho City,Ninh Kieu District,23,2,1,1,0
2022-06-25,Dong Nai,Bien Hoa City,0,5,3,2,0
2022-06-25,Dong Nai,Bien Hoa City,1,7,6,1,0
2022-06-25,Dong Nai,Bien Hoa City,3,1,1,0,0
2022-06-25,Dong Nai,Bien Hoa City,4,1,1,0,0
2022-06-25,Dong Nai,Bien Hoa City,6,52,38,14,5
2022-06-25,Dong Nai,Bien Hoa City,7,172,140,32,15
2022-06-25,Dong Nai,Bien Hoa City,8,333,296,37,6
2022-06-25,Dong Nai,Bien Hoa City,9,463,418,45,2
2022-06-25,Dong Nai,Bien Hoa City,10,822,751,71,7
2022-06-25,Dong Nai,Bien Hoa City,11,1150,1051,99,10
2022-06-25,Dong Nai,Bien Hoa City,12,1027,940,87,9
2022-06-25,Dong Nai,Bien Hoa City,13,860,812,48,11
2022-06-25,Dong Nai,Bien Hoa City,14,667,627,40,3
2022-06-25,Dong Nai,Bien Hoa City,15,617,574,43,7
2022-06-25,Dong Nai,Bien Hoa City,16,582,539,43,9
2022-06-25,Dong Nai,Bien Hoa City,17,690,637,53,13
2022-06-25,Dong Nai,Bien Hoa City,18,705,648,57,10
2022-06-25,Dong Nai,Bien Hoa City,19,772,681,91,35
2022-06-25,Dong Nai,Bien Hoa City,20,596,488,108,27
2022-06-25,Dong Nai,Bien Hoa City,21,294,223,71,21
2022-06-25,Dong Nai,Bien Hoa City,22,2,1,1,0
2022-06-25,Dong Nai,Bien Hoa City,23,1,0,1,1
2022-06-25,Dong Nai,Cam My,15,1,0,1,0
2022-06-25,Dong Nai,Long Khanh,18,1,0,1,1
2022-06-25,Dong Nai,Long Khanh,19,1,0,1,1
2022-06-25,Dong Nai,Long Thanh,10,1,1,0,0
2022-06-25,Dong Nai,Long Thanh,12,1,0,1,1
2022-06-25,Dong Nai,Long Thanh,13,1,0,1,1
2022-06-25,Dong Nai,Long Thanh,20,3,0,3,3
2022-06-25,Dong Nai,Nhon trach,12,2,0,2,2
2022-06-25,Dong Nai,Nhon trach,13,2,0,2,1
2022-06-25,Dong Nai,Nhon trach,18,1,0,1,1
2022-06-25,Dong Nai,Nhon trach,19,1,0,1,1
2022-06-25,Dong Nai,Nhon trach,22,1,0,1,1
2022-06-25,Dong Nai,Trang Bom,10,2,0,2,1
2022-06-25,Dong Nai,Trang Bom,11,1,0,1,1
2022-06-25,Dong Nai,Trang Bom,13,1,0,1,0
2022-06-25,Dong Nai,Trang Bom,15,2,0,2,2
2022-06-25,Dong Nai,Trang Bom,16,1,0,1,0
2022-06-25,Dong Nai,Trang Bom,20,1,0,1,0
2022-06-25,Dong Nai,Vinh Cuu,8,1,1,0,0
2022-06-25,Dong Nai,Vinh Cuu,11,1,1,0,0
2022-06-25,Hai Phong City,An Duong,7,2,1,1,1
2022-06-25,Hai Phong City,An Duong,8,1,1,0,0
2022-06-25,Hai Phong City,An Duong,9,1,0,1,1
2022-06-25,Hai Phong City,An Duong,10,5,3,2,1
2022-06-25,Hai Phong City,An Duong,11,10,2,8,5
2022-06-25,Hai Phong City,An Duong,12,6,1,5,4
2022-06-25,Hai Phong City,An Duong,13,6,1,5,4
2022-06-25,Hai Phong City,An Duong,14,2,0,2,2
2022-06-25,Hai Phong City,An Duong,15,6,0,6,2
2022-06-25,Hai Phong City,An Duong,16,5,3,2,1
2022-06-25,Hai Phong City,An Duong,17,4,0,4,2
2022-06-25,Hai Phong City,An Duong,18,1,0,1,0
2022-06-25,Hai Phong City,An Duong,19,2,0,2,0
2022-06-25,Hai Phong City,An Duong,21,3,0,3,3
2022-06-25,Hai Phong City,Do Son District,12,2,0,2,2
2022-06-25,Hai Phong City,Do Son District,18,1,0,1,1
2022-06-25,Hai Phong City,Do Son District,21,1,0,1,0
2022-06-25,Hai Phong City,Hai An District,7,8,7,1,1
2022-06-25,Hai Phong City,Hai An District,8,13,12,1,1
2022-06-25,Hai Phong City,Hai An District,9,7,6,1,0
2022-06-25,Hai Phong City,Hai An District,10,36,34,2,1
2022-06-25,Hai Phong City,Hai An District,11,54,47,7,3
2022-06-25,Hai Phong City,Hai An District,12,30,29,1,0
2022-06-25,Hai Phong City,Hai An District,13,12,8,4,3
2022-06-25,Hai Phong City,Hai An District,14,17,9,8,4
2022-06-25,Hai Phong City,Hai An District,15,15,12,3,1
2022-06-25,Hai Phong City,Hai An District,16,24,22,2,0
2022-06-25,Hai Phong City,Hai An District,17,25,21,4,1
2022-06-25,Hai Phong City,Hai An District,18,16,16,0,0
2022-06-25,Hai Phong City,Hai An District,19,13,10,3,1
2022-06-25,Hai Phong City,Hai An District,20,14,6,8,4
2022-06-25,Hai Phong City,Hai An District,21,13,6,7,5
2022-06-25,Hai Phong City,Hong Bang District,0,1,0,1,1
2022-06-25,Hai Phong City,Hong Bang District,6,2,2,0,0
2022-06-25,Hai Phong City,Hong Bang District,7,10,7,3,0
2022-06-25,Hai Phong City,Hong Bang District,8,24,21,3,1
2022-06-25,Hai Phong City,Hong Bang District,9,41,35,6,1
2022-06-25,Hai Phong City,Hong Bang District,10,57,49,8,0
2022-06-25,Hai Phong City,Hong Bang District,11,101,85,16,2
2022-06-25,Hai Phong City,Hong Bang District,12,70,58,12,4
2022-06-25,Hai Phong City,Hong Bang District,13,44,33,11,1
2022-06-25,Hai Phong City,Hong Bang District,14,36,32,4,1
2022-06-25,Hai Phong City,Hong Bang District,15,61,53,8,3
2022-06-25,Hai Phong City,Hong Bang District,16,57,51,6,0
2022-06-25,Hai Phong City,Hong Bang District,17,42,38,4,1
2022-06-25,Hai Phong City,Hong Bang District,18,49,42,7,0
2022-06-25,Hai Phong City,Hong Bang District,19,33,27,6,2
2022-06-25,Hai Phong City,Hong Bang District,20,30,22,8,1
2022-06-25,Hai Phong City,Hong Bang District,21,19,14,5,1
2022-06-25,Hai Phong City,Kien An District,7,2,1,1,1
2022-06-25,Hai Phong City,Kien An District,8,3,2,1,0
2022-06-25,Hai Phong City,Kien An District,9,5,5,0,0
2022-06-25,Hai Phong City,Kien An District,10,16,15,1,0
2022-06-25,Hai Phong City,Kien An District,11,18,15,3,2
2022-06-25,Hai Phong City,Kien An District,12,13,10,3,1
2022-06-25,Hai Phong City,Kien An District,13,9,7,2,1
2022-06-25,Hai Phong City,Kien An District,14,15,5,10,5
2022-06-25,Hai Phong City,Kien An District,15,11,8,3,1
2022-06-25,Hai Phong City,Kien An District,16,11,10,1,1
2022-06-25,Hai Phong City,Kien An District,17,11,4,7,5
2022-06-25,Hai Phong City,Kien An District,18,12,10,2,1
2022-06-25,Hai Phong City,Kien An District,19,15,12,3,2
2022-06-25,Hai Phong City,Kien An District,20,7,5,2,0
2022-06-25,Hai Phong City,Kien An District,21,3,0,3,3
2022-06-25,Hai Phong City,Le Chan District,0,1,1,0,0
2022-06-25,Hai Phong City,Le Chan District,1,1,0,1,0
2022-06-25,Hai Phong City,Le Chan District,3,1,1,0,0
2022-06-25,Hai Phong City,Le Chan District,5,1,1,0,0
2022-06-25,Hai Phong City,Le Chan District,6,5,1,4,1
2022-06-25,Hai Phong City,Le Chan District,7,48,36,12,6
2022-06-25,Hai Phong City,Le Chan District,8,92,81,11,2
2022-06-25,Hai Phong City,Le Chan District,9,142,113,29,2
2022-06-25,Hai Phong City,Le Chan District,10,219,193,26,1
2022-06-25,Hai Phong City,Le Chan District,11,364,325,39,9
2022-06-25,Hai Phong City,Le Chan District,12,274,247,27,3
2022-06-25,Hai Phong City,Le Chan District,13,200,169,31,6
2022-06-25,Hai Phong City,Le Chan District,14,184,153,31,8
2022-06-25,Hai Phong City,Le Chan District,15,216,171,45,11
2022-06-25,Hai Phong City,Le Chan District,16,200,178,22,3
2022-06-25,Hai Phong City,Le Chan District,17,181,163,18,4
2022-06-25,Hai Phong City,Le Chan District,18,229,185,44,6
2022-06-25,Hai Phong City,Le Chan District,19,216,188,28,9
2022-06-25,Hai Phong City,Le Chan District,20,169,133,36,8
2022-06-25,Hai Phong City,Le Chan District,21,78,55,23,9
2022-06-25,Hai Phong City,Le Chan District,22,1,0,1,0
2022-06-25,Hai Phong City,Ngo Quyen District,0,1,0,1,0
2022-06-25,Hai Phong City,Ngo Quyen District,7,23,21,2,1
2022-06-25,Hai Phong City,Ngo Quyen District,8,71,59,12,2
2022-06-25,Hai Phong City,Ngo Quyen District,9,77,69,8,0
2022-06-25,Hai Phong City,Ngo Quyen District,10,151,140,11,1
2022-06-25,Hai Phong City,Ngo Quyen District,11,257,238,19,2
2022-06-25,Hai Phong City,Ngo Quyen District,12,208,188,20,4
2022-06-25,Hai Phong City,Ngo Quyen District,13,137,122,15,2
2022-06-25,Hai Phong City,Ngo Quyen District,14,97,88,9,2
2022-06-25,Hai Phong City,Ngo Quyen District,15,149,125,24,3
2022-06-25,Hai Phong City,Ngo Quyen District,16,130,115,15,3
2022-06-25,Hai Phong City,Ngo Quyen District,17,137,122,15,1
2022-06-25,Hai Phong City,Ngo Quyen District,18,157,137,20,6
2022-06-25,Hai Phong City,Ngo Quyen District,19,140,117,23,4
2022-06-25,Hai Phong City,Ngo Quyen District,20,149,110,39,12
2022-06-25,Hai Phong City,Ngo Quyen District,21,70,50,20,8
2022-06-25,Hai Phong City,Ngo Quyen District,23,1,1,0,0
2022-06-25,Hai Phong City,Thuy Nguyen,10,1,0,1,1
2022-06-25,Hai Phong City,Thuy Nguyen,12,1,1,0,0
2022-06-25,Hai Phong City,Thuy Nguyen,13,1,0,1,1
2022-06-25,Hai Phong City,Thuy Nguyen,14,2,0,2,2
2022-06-25,Hai Phong City,Thuy Nguyen,16,2,0,2,2
2022-06-25,Hai Phong City,Thuy Nguyen,17,4,0,4,4
2022-06-25,Hai Phong City,Thuy Nguyen,18,2,0,2,1
2022-06-25,Hai Phong City,Thuy Nguyen,21,1,0,1,1
2022-06-25,Hue City,Hue City,0,3,1,2,0
2022-06-25,Hue City,Hue City,1,3,2,1,0
2022-06-25,Hue City,Hue City,2,1,1,0,0
2022-06-25,Hue City,Hue City,5,3,1,2,1
2022-06-25,Hue City,Hue City,6,65,58,7,3
2022-06-25,Hue City,Hue City,7,193,183,10,1
2022-06-25,Hue City,Hue City,8,333,313,20,1
2022-06-25,Hue City,Hue City,9,300,272,28,0
2022-06-25,Hue City,Hue City,10,457,427,30,1
2022-06-25,Hue City,Hue City,11,878,810,68,2
2022-06-25,Hue City,Hue City,12,683,624,59,0
2022-06-25,Hue City,Hue City,13,376,343,33,0
2022-06-25,Hue City,Hue City,14,371,335,36,2
2022-06-25,Hue City,Hue City,15,419,380,39,5
2022-06-25,Hue City,Hue City,16,431,384,47,1
2022-06-25,Hue City,Hue City,17,456,412,44,1
2022-06-25,Hue City,Hue City,18,553,485,68,8
2022-06-25,Hue City,Hue City,19,519,412,107,35
2022-06-25,Hue City,Hue City,20,488,313,175,104
2022-06-25,Hue City,Hue City,21,331,169,162,96
2022-06-25,Hue City,Hue City,22,2,0,2,0
2022-06-25,Hue City,Hue City,23,1,0,1,0
2022-06-25,Hue City,Huong Thuy,9,2,1,1,1
2022-06-25,Hue City,Huong Thuy,10,3,3,0,0
2022-06-25,Hue City,Huong Thuy,11,2,1,1,0
2022-06-25,Hue City,Huong Thuy,14,1,1,0,0
2022-06-25,Hue City,Huong Thuy,16,1,1,0,0
2022-06-25,Hue City,Huong Thuy,17,1,1,0,0
2022-06-25,Hue City,Huong Thuy,19,3,1,2,1
2022-06-25,Hue City,Huong Tra,19,2,2,0,0
2022-06-25,Hue City,Huong Tra,21,1,0,1,1
2022-06-25,Hue City,Phu Vang,8,4,2,2,1
2022-06-25,Hue City,Phu Vang,10,2,0,2,1
2022-06-25,Hue City,Phu Vang,11,7,5,2,1
2022-06-25,Hue City,Phu Vang,12,4,4,0,0
2022-06-25,Hue City,Phu Vang,13,5,3,2,1
2022-06-25,Hue City,Phu Vang,14,1,1,0,0
2022-06-25,Hue City,Phu Vang,16,1,1,0,0
2022-06-25,Hue City,Phu Vang,17,2,2,0,0
2022-06-25,Hue City,Phu Vang,18,5,4,1,0
2022-06-25,Hue City,Phu Vang,19,2,1,1,1
2022-06-25,Hue City,Phu Vang,20,2,1,1,1
2022-06-25,Hue City,Phu Vang,21,2,1,1,0
2022-06-25,Khanh Hoa,Dien Khanh,6,1,0,1,1
2022-06-25,Khanh Hoa,Dien Khanh,14,1,0,1,0
2022-06-25,Khanh Hoa,Dien Khanh,17,1,0,1,1
2022-06-25,Khanh Hoa,Nha Trang City,0,2,2,0,0
2022-06-25,Khanh Hoa,Nha Trang City,2,1,1,0,0
2022-06-25,Khanh Hoa,Nha Trang City,5,1,1,0,0
2022-06-25,Khanh Hoa,Nha Trang City,6,33,28,5,1
2022-06-25,Khanh Hoa,Nha Trang City,7,138,128,10,0
2022-06-25,Khanh Hoa,Nha Trang City,8,180,165,15,0
2022-06-25,Khanh Hoa,Nha Trang City,9,185,178,7,0
2022-06-25,Khanh Hoa,Nha Trang City,10,174,161,13,0
2022-06-25,Khanh Hoa,Nha Trang City,11,319,301,18,0
2022-06-25,Khanh Hoa,Nha Trang City,12,316,297,19,0
2022-06-25,Khanh Hoa,Nha Trang City,13,274,261,13,1
2022-06-25,Khanh Hoa,Nha Trang City,14,211,200,11,0
2022-06-25,Khanh Hoa,Nha Trang City,15,212,196,16,1
2022-06-25,Khanh Hoa,Nha Trang City,16,193,182,11,0
2022-06-25,Khanh Hoa,Nha Trang City,17,232,208,24,0
2022-06-25,Khanh Hoa,Nha Trang City,18,316,289,27,5
2022-06-25,Khanh Hoa,Nha Trang City,19,284,233,51,9
2022-06-25,Khanh Hoa,Nha Trang City,20,219,184,35,6
2022-06-25,Khanh Hoa,Nha Trang City,21,115,75,40,10
2022-06-25,Khanh Hoa,Nha Trang City,22,4,1,3,0
2022-06-25,Khanh Hoa,Nha Trang City,23,4,3,1,0
2022-06-25,Lam Dong,Da Lat City,0,2,2,0,0
2022-06-25,Lam Dong,Da Lat City,5,1,1,0,0
2022-06-25,Lam Dong,Da Lat City,6,6,1,5,4
2022-06-25,Lam Dong,Da Lat City,7,44,32,12,10
2022-06-25,Lam Dong,Da Lat City,8,81,52,29,11
2022-06-25,Lam Dong,Da Lat City,9,71,64,7,1
2022-06-25,Lam Dong,Da Lat City,10,122,111,11,2
2022-06-25,Lam Dong,Da Lat City,11,159,126,33,18
2022-06-25,Lam Dong,Da Lat City,12,161,124,37,15
2022-06-25,Lam Dong,Da Lat City,13,175,88,87,63
2022-06-25,Lam Dong,Da Lat City,14,144,103,41,30
2022-06-25,Lam Dong,Da Lat City,15,131,76,55,35
2022-06-25,Lam Dong,Da Lat City,16,154,81,73,46
2022-06-25,Lam Dong,Da Lat City,17,158,101,57,36
2022-06-25,Lam Dong,Da Lat City,18,167,90,77,54
2022-06-25,Lam Dong,Da Lat City,19,202,72,130,94
2022-06-25,Lam Dong,Da Lat City,20,206,76,130,107
2022-06-25,Lam Dong,Da Lat City,21,124,38,86,68
2022-06-25,Lam Dong,Da Lat City,22,2,0,2,1
2022-06-25,Lam Dong,Da Lat City,23,2,0,2,1
2022-06-25,Nghe An,Vinh City,0,3,2,1,1
2022-06-25,Nghe An,Vinh City,4,1,1,0,0
2022-06-25,Nghe An,Vinh City,6,6,4,2,1
2022-06-25,Nghe An,Vinh City,7,110,94,16,3
2022-06-25,Nghe An,Vinh City,8,189,162,27,0
2022-06-25,Nghe An,Vinh City,9,161,144,17,0
2022-06-25,Nghe An,Vinh City,10,250,222,28,2
2022-06-25,Nghe An,Vinh City,11,439,367,72,23
2022-06-25,Nghe An,Vinh City,12,286,238,48,16
2022-06-25,Nghe An,Vinh City,13,171,150,21,1
2022-06-25,Nghe An,Vinh City,14,182,167,15,5
2022-06-25,Nghe An,Vinh City,15,239,187,52,18
2022-06-25,Nghe An,Vinh City,16,148,127,21,4
2022-06-25,Nghe An,Vinh City,17,163,138,25,9
2022-06-25,Nghe An,Vinh City,18,217,179,38,18
2022-06-25,Nghe An,Vinh City,19,189,157,32,5
2022-06-25,Nghe An,Vinh City,20,143,112,31,6
2022-06-25,Nghe An,Vinh City,21,86,63,23,11
2022-06-25,Quang Nam,Dien Ban,12,2,0,2,2
2022-06-25,Quang Nam,Dien Ban,13,2,0,2,2
2022-06-25,Quang Nam,Dien Ban,14,1,0,1,1
2022-06-25,Quang Nam,Hoi An City,0,2,2,0,0
2022-06-25,Quang Nam,Hoi An City,6,1,0,1,0
2022-06-25,Quang Nam,Hoi An City,7,14,9,5,3
2022-06-25,Quang Nam,Hoi An City,8,16,15,1,1
2022-06-25,Quang Nam,Hoi An City,9,27,27,0,0
2022-06-25,Quang Nam,Hoi An City,10,27,23,4,0
2022-06-25,Quang Nam,Hoi An City,11,62,48,14,4
2022-06-25,Quang Nam,Hoi An City,12,43,31,12,1
2022-06-25,Quang Nam,Hoi An City,13,33,26,7,0
2022-06-25,Quang Nam,Hoi An City,14,43,35,8,1
2022-06-25,Quang Nam,Hoi An City,15,57,49,8,0
2022-06-25,Quang Nam,Hoi An City,16,48,41,7,1
2022-06-25,Quang Nam,Hoi An City,17,62,47,15,7
2022-06-25,Quang Nam,Hoi An City,18,51,40,11,3
2022-06-25,Quang Nam,Hoi An City,19,74,50,24,12
2022-06-25,Quang Nam,Hoi An City,20,84,41,43,23
2022-06-25,Quang Nam,Hoi An City,21,59,19,40,28
2022-06-25,Quang Nam,Tam Ky City,10,1,0,1,1
2022-06-25,Quang Nam,Tam Ky City,11,2,0,2,2
2022-06-25,Quang Nam,Tam Ky City,18,1,0,1,0
2022-06-25,Quang Nam,Tam Ky City,22,1,0,1,1
2022-06-25,Quang Ninh,Cam Pha City,13,1,0,1,1
2022-06-25,Quang Ninh,Cam Pha City,16,1,0,1,1
2022-06-25,Quang Ninh,Cam Pha City,18,2,0,2,1
2022-06-25,Quang Ninh,Cam Pha City,20,3,0,3,1
2022-06-25,Quang Ninh,Ha Long City,1,2,1,1,0
2022-06-25,Quang Ninh,Ha Long City,6,1,1,0,0
2022-06-25,Quang Ninh,Ha Long City,7,29,17,12,6
2022-06-25,Quang Ninh,Ha Long City,8,58,38,20,9
2022-06-25,Quang Ninh,Ha Long City,9,70,35,35,11
2022-06-25,Quang Ninh,Ha Long City,10,108,73,35,18
2022-06-25,Quang Ninh,Ha Long City,11,191,138,53,23
2022-06-25,Quang Ninh,Ha Long City,12,143,90,53,28
2022-06-25,Quang Ninh,Ha Long City,13,109,58,51,25
2022-06-25,Quang Ninh,Ha Long City,14,83,57,26,17
2022-06-25,Quang Ninh,Ha Long City,15,93,60,33,18
2022-06-25,Quang Ninh,Ha Long City,16,81,52,29,16
2022-06-25,Quang Ninh,Ha Long City,17,76,48,28,17
2022-06-25,Quang Ninh,Ha Long City,18,70,47,23,13
2022-06-25,Quang Ninh,Ha Long City,19,79,53,26,14
2022-06-25,Quang Ninh,Ha Long City,20,80,41,39,24
2022-06-25,Quang Ninh,Ha Long City,21,1,0,1,0
2022-06-25,Quang Ninh,Ha Long City,22,1,1,0,0
2022-06-25,Quang Ninh,Uong Bi City,20,2,0,2,1
2022-06-25,Thai Nguyen,Dong Hy,12,2,2,0,0
2022-06-25,Thai Nguyen,Dong Hy,13,1,1,0,0
2022-06-25,Thai Nguyen,Dong Hy,19,2,1,1,1
2022-06-25,Thai Nguyen,Dong Hy,20,5,0,5,3
2022-06-25,Thai Nguyen,Dong Hy,21,1,1,0,0
2022-06-25,Thai Nguyen,Thai Nguyen City,0,4,4,0,0
2022-06-25,Thai Nguyen,Thai Nguyen City,1,1,0,1,0
2022-06-25,Thai Nguyen,Thai Nguyen City,2,1,1,0,0
2022-06-25,Thai Nguyen,Thai Nguyen City,5,1,1,0,0
2022-06-25,Thai Nguyen,Thai Nguyen City,6,7,5,2,0
2022-06-25,Thai Nguyen,Thai Nguyen City,7,88,72,16,6
2022-06-25,Thai Nguyen,Thai Nguyen City,8,159,146,13,0
2022-06-25,Thai Nguyen,Thai Nguyen City,9,156,139,17,1
2022-06-25,Thai Nguyen,Thai Nguyen City,10,237,219,18,0
2022-06-25,Thai Nguyen,Thai Nguyen City,11,393,358,35,2
2022-06-25,Thai Nguyen,Thai Nguyen City,12,283,256,27,1
2022-06-25,Thai Nguyen,Thai Nguyen City,13,167,154,13,0
2022-06-25,Thai Nguyen,Thai Nguyen City,14,189,171,18,0
2022-06-25,Thai Nguyen,Thai Nguyen City,15,182,165,17,0
2022-06-25,Thai Nguyen,Thai Nguyen City,16,160,145,15,0
2022-06-25,Thai Nguyen,Thai Nguyen City,17,126,113,13,1
2022-06-25,Thai Nguyen,Thai Nguyen City,18,207,180,27,1
2022-06-25,Thai Nguyen,Thai Nguyen City,19,279,248,31,5
2022-06-25,Thai Nguyen,Thai Nguyen City,20,192,170,22,2
2022-06-25,Thai Nguyen,Thai Nguyen City,21,156,130,26,7
2022-06-25,Thai Nguyen,Thai Nguyen City,22,2,0,2,0
2022-06-25,Thai Nguyen,Thai Nguyen City,23,2,2,0,0
2022-06-25,Vung Tau,Ba Ria City,6,1,0,1,0
2022-06-25,Vung Tau,Ba Ria City,7,7,1,6,6
2022-06-25,Vung Tau,Ba Ria City,8,11,1,10,8
2022-06-25,Vung Tau,Ba Ria City,9,10,4,6,6
2022-06-25,Vung Tau,Ba Ria City,10,11,5,6,2
2022-06-25,Vung Tau,Ba Ria City,11,13,6,7,5
2022-06-25,Vung Tau,Ba Ria City,12,3,2,1,1
2022-06-25,Vung Tau,Ba Ria City,13,4,3,1,0
2022-06-25,Vung Tau,Ba Ria City,14,4,3,1,1
2022-06-25,Vung Tau,Ba Ria City,15,2,2,0,0
2022-06-25,Vung Tau,Ba Ria City,16,5,3,2,0
2022-06-25,Vung Tau,Ba Ria City,17,7,4,3,0
2022-06-25,Vung Tau,Ba Ria City,18,3,3,0,0
2022-06-25,Vung Tau,Ba Ria City,19,4,2,2,1
2022-06-25,Vung Tau,Ba Ria City,20,2,0,2,1
2022-06-25,Vung Tau,Ba Ria City,21,5,0,5,3
2022-06-25,Vung Tau,Vung Tau City,1,1,1,0,0
2022-06-25,Vung Tau,Vung Tau City,6,60,36,24,15
2022-06-25,Vung Tau,Vung Tau City,7,119,104,15,5
2022-06-25,Vung Tau,Vung Tau City,8,181,167,14,4
2022-06-25,Vung Tau,Vung Tau City,9,254,241,13,2
2022-06-25,Vung Tau,Vung Tau City,10,216,196,20,3
2022-06-25,Vung Tau,Vung Tau City,11,408,385,23,2
2022-06-25,Vung Tau,Vung Tau City,12,361,338,23,0
2022-06-25,Vung Tau,Vung Tau City,13,258,241,17,0
2022-06-25,Vung Tau,Vung Tau City,14,316,293,23,1
2022-06-25,Vung Tau,Vung Tau City,15,259,241,18,0
2022-06-25,Vung Tau,Vung Tau City,16,257,233,24,5
2022-06-25,Vung Tau,Vung Tau City,17,309,284,25,5
2022-06-25,Vung Tau,Vung Tau City,18,342,309,33,5
2022-06-25,Vung Tau,Vung Tau City,19,358,298,60,7
2022-06-25,Vung Tau,Vung Tau City,20,227,192,35,3
2022-06-25,Vung Tau,Vung Tau City,21,135,109,26,4
2022-06-25,Vung Tau,Vung Tau City,22,5,2,3,0
2022-06-25,Vung Tau,Vung Tau City,23,2,1,1,0
2022-06-26,Bac Ninh,Bác Ninh City,6,6,4,2,0
2022-06-26,Bac Ninh,Bác Ninh City,7,56,44,12,0
2022-06-26,Bac Ninh,Bác Ninh City,8,96,87,9,0
2022-06-26,Bac Ninh,Bác Ninh City,9,132,119,13,0
2022-06-26,Bac Ninh,Bác Ninh City,10,217,183,34,3
2022-06-26,Bac Ninh,Bác Ninh City,11,383,308,75,30
2022-06-26,Bac Ninh,Bác Ninh City,12,278,254,24,7
2022-06-26,Bac Ninh,Bác Ninh City,13,158,141,17,3
2022-06-26,Bac Ninh,Bác Ninh City,14,173,152,21,1
2022-06-26,Bac Ninh,Bác Ninh City,15,174,148,26,6
2022-06-26,Bac Ninh,Bác Ninh City,16,121,100,21,5
2022-06-26,Bac Ninh,Bác Ninh City,17,126,116,10,2
2022-06-26,Bac Ninh,Bác Ninh City,18,169,148,21,2
2022-06-26,Bac Ninh,Bác Ninh City,19,219,178,41,18
2022-06-26,Bac Ninh,Bác Ninh City,20,172,135,37,9
2022-06-26,Bac Ninh,Bác Ninh City,21,97,78,19,5
2022-06-26,Bac Ninh,Bác Ninh City,22,2,0,2,0
2022-06-26,Bac Ninh,Que Vo,9,2,1,1,1
2022-06-26,Bac Ninh,Que Vo,12,1,0,1,0
2022-06-26,Bac Ninh,Que Vo,13,1,1,0,0
2022-06-26,Bac Ninh,Que Vo,15,1,1,0,0
2022-06-26,Bac Ninh,Que Vo,19,1,0,1,1
2022-06-26,Bac Ninh,Tien Du,10,2,0,2,2
2022-06-26,Bac Ninh,Tien Du,11,2,0,2,2
2022-06-26,Bac Ninh,Tien Du,12,1,0,1,1
2022-06-26,Bac Ninh,Tien Du,14,2,0,2,1
2022-06-26,Bac Ninh,Tien Du,15,7,0,7,6
2022-06-26,Bac Ninh,Tien Du,16,2,0,2,2
2022-06-26,Bac Ninh,Tien Du,17,5,0,5,5
2022-06-26,Bac Ninh,Tien Du,18,2,0,2,2
2022-06-26,Bac Ninh,Tien Du,19,2,0,2,1
2022-06-26,Bac Ninh,Tien Du,21,3,0,3,3
2022-06-26,Bac Ninh,Tu Son,9,1,0,1,1
2022-06-26,Bac Ninh,Tu Son,10,4,0,4,4
2022-06-26,Bac Ninh,Tu Son,12,5,0,5,5
2022-06-26,Bac Ninh,Tu Son,14,1,0,1,1
2022-06-26,Bac Ninh,Tu Son,16,1,0,1,1
2022-06-26,Bac Ninh,Tu Son,19,1,0,1,1
2022-06-26,Binh Duong,Ben Cat,10,4,0,4,3
2022-06-26,Binh Duong,Ben Cat,11,4,0,4,4
2022-06-26,Binh Duong,Ben Cat,12,2,0,2,1
2022-06-26,Binh Duong,Ben Cat,13,4,0,4,3
2022-06-26,Binh Duong,Ben Cat,15,1,0,1,1
2022-06-26,Binh Duong,Ben Cat,16,5,0,5,1
2022-06-26,Binh Duong,Ben Cat,17,2,0,2,2
2022-06-26,Binh Duong,Ben Cat,19,3,0,3,3
2022-06-26,Binh Duong,Di An,6,1,0,1,0
2022-06-26,Binh Duong,Di An,7,4,3,1,1
2022-06-26,Binh Duong,Di An,8,8,7,1,1
2022-06-26,Binh Duong,Di An,9,19,12,7,4
2022-06-26,Binh Duong,Di An,10,41,26,15,4
2022-06-26,Binh Duong,Di An,11,47,37,10,2
2022-06-26,Binh Duong,Di An,12,63,45,18,7
2022-06-26,Binh Duong,Di An,13,45,30,15,6
2022-06-26,Binh Duong,Di An,14,40,29,11,6
2022-06-26,Binh Duong,Di An,15,29,21,8,3
2022-06-26,Binh Duong,Di An,16,30,21,9,5
2022-06-26,Binh Duong,Di An,17,38,26,12,7
2022-06-26,Binh Duong,Di An,18,38,27,11,3
2022-06-26,Binh Duong,Di An,19,48,28,20,9
2022-06-26,Binh Duong,Di An,20,22,18,4,3
2022-06-26,Binh Duong,Di An,21,15,6,9,6
2022-06-26,Binh Duong,Di An,23,1,0,1,0
2022-06-26,Binh Duong,Tan Uyen,10,2,1,1,0
2022-06-26,Binh Duong,Tan Uyen,11,6,4,2,0
2022-06-26,Binh Duong,Tan Uyen,12,1,1,0,0
2022-06-26,Binh Duong,Tan Uyen,13,3,2,1,1
2022-06-26,Binh Duong,Tan Uyen,14,5,3,2,2
2022-06-26,Binh Duong,Tan Uyen,15,3,1,2,1
2022-06-26,Binh Duong,Tan Uyen,16,1,0,1,1
2022-06-26,Binh Duong,Tan Uyen,17,6,1,5,0
2022-06-26,Binh Duong,Tan Uyen,18,3,2,1,1
2022-06-26,Binh Duong,Tan Uyen,19,6,2,4,4
2022-06-26,Binh Duong,Tan Uyen,20,2,1,1,1
2022-06-26,Binh Duong,Tan Uyen,21,1,0,1,1
2022-06-26,Binh Duong,Thu Dau Mot Town,2,2,2,0,0
2022-06-26,Binh Duong,Thu Dau Mot Town,3,1,0,1,0
2022-06-26,Binh Duong,Thu Dau Mot Town,5,2,1,1,0
2022-06-26,Binh Duong,Thu Dau Mot Town,6,33,30,3,1
2022-06-26,Binh Duong,Thu Dau Mot Town,7,122,112,10,2
2022-06-26,Binh Duong,Thu Dau Mot Town,8,228,211,17,1
2022-06-26,Binh Duong,Thu Dau Mot Town,9,297,285,12,1
2022-06-26,Binh Duong,Thu Dau Mot Town,10,402,374,28,3
2022-06-26,Binh Duong,Thu Dau Mot Town,11,637,612,25,2
2022-06-26,Binh Duong,Thu Dau Mot Town,12,594,525,69,4
2022-06-26,Binh Duong,Thu Dau Mot Town,13,450,415,35,5
2022-06-26,Binh Duong,Thu Dau Mot Town,14,362,338,24,2
2022-06-26,Binh Duong,Thu Dau Mot Town,15,370,346,24,0
2022-06-26,Binh Duong,Thu Dau Mot Town,16,346,323,23,4
2022-06-26,Binh Duong,Thu Dau Mot Town,17,416,381,35,5
2022-06-26,Binh Duong,Thu Dau Mot Town,18,487,428,59,10
2022-06-26,Binh Duong,Thu Dau Mot Town,19,429,397,32,5
2022-06-26,Binh Duong,Thu Dau Mot Town,20,299,266,33,3
2022-06-26,Binh Duong,Thu Dau Mot Town,21,102,81,21,1
2022-06-26,Binh Duong,Thu Dau Mot Town,22,1,0,1,0
2022-06-26,Binh Duong,Thuan An,1,1,0,1,0
2022-06-26,Binh Duong,Thuan An,6,3,2,1,0
2022-06-26,Binh Duong,Thuan An,7,6,5,1,1
2022-06-26,Binh Duong,Thuan An,8,29,17,12,7
2022-06-26,Binh Duong,Thuan An,9,48,32,16,10
2022-06-26,Binh Duong,Thuan An,10,56,43,13,3
2022-06-26,Binh Duong,Thuan An,11,68,60,8,0
2022-06-26,Binh Duong,Thuan An,12,91,76,15,4
2022-06-26,Binh Duong,Thuan An,13,79,62,17,6
2022-06-26,Binh Duong,Thuan An,14,61,44,17,6
2022-06-26,Binh Duong,Thuan An,15,58,52,6,0
2022-06-26,Binh Duong,Thuan An,16,40,30,10,5
2022-06-26,Binh Duong,Thuan An,17,63,50,13,5
2022-06-26,Binh Duong,Thuan An,18,44,38,6,3
2022-06-26,Binh Duong,Thuan An,19,59,45,14,3
2022-06-26,Binh Duong,Thuan An,20,58,34,24,7
2022-06-26,Binh Duong,Thuan An,21,20,11,9,3
2022-06-26,Binh Duong,Thuan An,23,1,0,1,0
2022-06-26,Can Tho City,Binh Thuy District,7,1,1,0,0
2022-06-26,Can Tho City,Binh Thuy District,8,6,6,0,0
2022-06-26,Can Tho City,Binh Thuy District,9,10,9,1,1
2022-06-26,Can Tho City,Binh Thuy District,10,12,12,0,0
2022-06-26,Can Tho City,Binh Thuy District,11,15,14,1,0
2022-06-26,Can Tho City,Binh Thuy District,12,16,16,0,0
2022-06-26,Can Tho City,Binh Thuy District,13,12,11,1,0
2022-06-26,Can Tho City,Binh Thuy District,14,12,9,3,0
2022-06-26,Can Tho City,Binh Thuy District,15,12,9,3,0
2022-06-26,Can Tho City,Binh Thuy District,16,14,13,1,1
2022-06-26,Can Tho City,Binh Thuy District,17,19,19,0,0
2022-06-26,Can Tho City,Binh Thuy District,18,15,15,0,0
2022-06-26,Can Tho City,Binh Thuy District,19,16,16,0,0
2022-06-26,Can Tho City,Binh Thuy District,20,8,7,1,0
2022-06-26,Can Tho City,Cai Rang District,7,10,8,2,0
2022-06-26,Can Tho City,Cai Rang District,8,7,6,1,0
2022-06-26,Can Tho City,Cai Rang District,9,8,6,2,0
2022-06-26,Can Tho City,Cai Rang District,10,20,17,3,0
2022-06-26,Can Tho City,Cai Rang District,11,18,17,1,0
2022-06-26,Can Tho City,Cai Rang District,12,11,10,1,0
2022-06-26,Can Tho City,Cai Rang District,13,8,6,2,1
2022-06-26,Can Tho City,Cai Rang District,14,10,8,2,0
2022-06-26,Can Tho City,Cai Rang District,15,17,17,0,0
2022-06-26,Can Tho City,Cai Rang District,16,14,13,1,0
2022-06-26,Can Tho City,Cai Rang District,17,13,12,1,1
2022-06-26,Can Tho City,Cai Rang District,18,12,10,2,0
2022-06-26,Can Tho City,Cai Rang District,19,20,17,3,0
2022-06-26,Can Tho City,Cai Rang District,20,8,6,2,0
2022-06-26,Can Tho City,Cai Rang District,21,7,5,2,0
2022-06-26,Can Tho City,Ninh Kieu District,0,6,4,2,0
2022-06-26,Can Tho City,Ninh Kieu District,1,2,2,0,0
2022-06-26,Can Tho City,Ninh Kieu District,3,1,1,0,0
2022-06-26,Can Tho City,Ninh Kieu District,4,3,1,2,0
2022-06-26,Can Tho City,Ninh Kieu District,5,1,1,0,0
2022-06-26,Can Tho City,Ninh Kieu District,6,43,40,3,0
2022-06-26,Can Tho City,Ninh Kieu District,7,126,117,9,0
2022-06-26,Can Tho City,Ninh Kieu District,8,231,212,19,0
2022-06-26,Can Tho City,Ninh Kieu District,9,330,306,24,0
2022-06-26,Can Tho City,Ninh Kieu District,10,501,488,13,0
2022-06-26,Can Tho City,Ninh Kieu District,11,749,713,36,4
2022-06-26,Can Tho City,Ninh Kieu District,12,583,571,12,0
2022-06-26,Can Tho City,Ninh Kieu District,13,365,343,22,1
2022-06-26,Can Tho City,Ninh Kieu District,14,439,413,26,0
2022-06-26,Can Tho City,Ninh Kieu District,15,464,438,26,0
2022-06-26,Can Tho City,Ninh Kieu District,16,465,441,24,0
2022-06-26,Can Tho City,Ninh Kieu District,17,556,525,31,0
2022-06-26,Can Tho City,Ninh Kieu District,18,546,519,27,0
2022-06-26,Can Tho City,Ninh Kieu District,19,508,483,25,0
2022-06-26,Can Tho City,Ninh Kieu District,20,392,365,27,0
2022-06-26,Can Tho City,Ninh Kieu District,21,206,186,20,0
2022-06-26,Can Tho City,O Mon District,20,2,0,2,0
2022-06-26,Dong Nai,Bien Hoa City,0,8,3,5,1
2022-06-26,Dong Nai,Bien Hoa City,2,1,1,0,0
2022-06-26,Dong Nai,Bien Hoa City,4,1,1,0,0
2022-06-26,Dong Nai,Bien Hoa City,5,3,3,0,0
2022-06-26,Dong Nai,Bien Hoa City,6,46,34,12,6
2022-06-26,Dong Nai,Bien Hoa City,7,187,149,38,10
2022-06-26,Dong Nai,Bien Hoa City,8,317,282,35,6
2022-06-26,Dong Nai,Bien Hoa City,9,522,458,64,7
2022-06-26,Dong Nai,Bien Hoa City,10,904,832,72,11
2022-06-26,Dong Nai,Bien Hoa City,11,1263,1134,129,15
2022-06-26,Dong Nai,Bien Hoa City,12,1208,1103,105,13
2022-06-26,Dong Nai,Bien Hoa City,13,862,814,48,5
2022-06-26,Dong Nai,Bien Hoa City,14,705,643,62,11
2022-06-26,Dong Nai,Bien Hoa City,15,694,623,71,6
2022-06-26,Dong Nai,Bien Hoa City,16,639,576,63,5
2022-06-26,Dong Nai,Bien Hoa City,17,752,666,86,9
2022-06-26,Dong Nai,Bien Hoa City,18,857,744,113,18
2022-06-26,Dong Nai,Bien Hoa City,19,715,605,110,20
2022-06-26,Dong Nai,Bien Hoa City,20,541,444,97,27
2022-06-26,Dong Nai,Bien Hoa City,21,223,170,53,15
2022-06-26,Dong Nai,Bien Hoa City,22,1,0,1,0
2022-06-26,Dong Nai,Long Khanh,18,1,0,1,0
2022-06-26,Dong Nai,Long Thanh,9,2,0,2,2
2022-06-26,Dong Nai,Long Thanh,10,3,0,3,3
2022-06-26,Dong Nai,Long Thanh,11,5,0,5,4
2022-06-26,Dong Nai,Long Thanh,12,2,0,2,2
2022-06-26,Dong Nai,Long Thanh,13,1,0,1,1
2022-06-26,Dong Nai,Long Thanh,14,2,0,2,1
2022-06-26,Dong Nai,Long Thanh,15,1,0,1,1
2022-06-26,Dong Nai,Long Thanh,16,2,0,2,2
2022-06-26,Dong Nai,Long Thanh,18,1,0,1,1
2022-06-26,Dong Nai,Long Thanh,19,2,0,2,1
2022-06-26,Dong Nai,Long Thanh,20,3,1,2,2
2022-06-26,Dong Nai,Nhon trach,10,1,0,1,1
2022-06-26,Dong Nai,Nhon trach,12,2,0,2,2
2022-06-26,Dong Nai,Nhon trach,14,1,0,1,1
2022-06-26,Dong Nai,Nhon trach,16,1,0,1,1
2022-06-26,Dong Nai,Nhon trach,17,1,0,1,1
2022-06-26,Dong Nai,Nhon trach,19,1,0,1,1
2022-06-26,Dong Nai,Trang Bom,13,1,0,1,1
2022-06-26,Dong Nai,Trang Bom,20,1,0,1,0
2022-06-26,Dong Nai,Trang Bom,21,1,0,1,1
2022-06-26,Hai Phong City,An Duong,7,1,0,1,1
2022-06-26,Hai Phong City,An Duong,9,2,2,0,0
2022-06-26,Hai Phong City,An Duong,10,1,0,1,1
2022-06-26,Hai Phong City,An Duong,11,10,1,9,6
2022-06-26,Hai Phong City,An Duong,12,5,5,0,0
2022-06-26,Hai Phong City,An Duong,13,9,6,3,0
2022-06-26,Hai Phong City,An Duong,14,7,1,6,4
2022-06-26,Hai Phong City,An Duong,15,7,3,4,4
2022-06-26,Hai Phong City,An Duong,16,6,4,2,1
2022-06-26,Hai Phong City,An Duong,17,8,4,4,2
2022-06-26,Hai Phong City,An Duong,18,1,1,0,0
2022-06-26,Hai Phong City,An Duong,19,2,1,1,0
2022-06-26,Hai Phong City,An Duong,20,5,0,5,3
2022-06-26,Hai Phong City,An Duong,21,3,0,3,3
2022-06-26,Hai Phong City,Do Son District,18,1,0,1,1
2022-06-26,Hai Phong City,Do Son District,20,2,0,2,2
2022-06-26,Hai Phong City,Duong Kinh District,15,1,0,1,1
2022-06-26,Hai Phong City,Hai An District,7,12,2,10,6
2022-06-26,Hai Phong City,Hai An District,8,15,13,2,0
2022-06-26,Hai Phong City,Hai An District,9,20,17,3,0
2022-06-26,Hai Phong City,Hai An District,10,26,24,2,1
2022-06-26,Hai Phong City,Hai An District,11,34,26,8,2
2022-06-26,Hai Phong City,Hai An District,12,40,34,6,0
2022-06-26,Hai Phong City,Hai An District,13,19,17,2,0
2022-06-26,Hai Phong City,Hai An District,14,18,12,6,1
2022-06-26,Hai Phong City,Hai An District,15,23,21,2,2
2022-06-26,Hai Phong City,Hai An District,16,16,14,2,0
2022-06-26,Hai Phong City,Hai An District,17,21,14,7,2
2022-06-26,Hai Phong City,Hai An District,18,21,17,4,0
2022-06-26,Hai Phong City,Hai An District,19,23,15,8,1
2022-06-26,Hai Phong City,Hai An District,20,19,13,6,0
2022-06-26,Hai Phong City,Hai An District,21,10,4,6,3
2022-06-26,Hai Phong City,Hong Bang District,6,1,0,1,1
2022-06-26,Hai Phong City,Hong Bang District,7,11,5,6,3
2022-06-26,Hai Phong City,Hong Bang District,8,25,21,4,2
2022-06-26,Hai Phong City,Hong Bang District,9,32,29,3,0
2022-06-26,Hai Phong City,Hong Bang District,10,66,57,9,2
2022-06-26,Hai Phong City,Hong Bang District,11,107,92,15,4
2022-06-26,Hai Phong City,Hong Bang District,12,60,55,5,1
2022-06-26,Hai Phong City,Hong Bang District,13,44,38,6,2
2022-06-26,Hai Phong City,Hong Bang District,14,37,32,5,2
2022-06-26,Hai Phong City,Hong Bang District,15,46,39,7,3
2022-06-26,Hai Phong City,Hong Bang District,16,38,31,7,3
2022-06-26,Hai Phong City,Hong Bang District,17,54,48,6,2
2022-06-26,Hai Phong City,Hong Bang District,18,61,52,9,3
2022-06-26,Hai Phong City,Hong Bang District,19,73,60,13,4
2022-06-26,Hai Phong City,Hong Bang District,20,44,31,13,4
2022-06-26,Hai Phong City,Hong Bang District,21,16,8,8,2
2022-06-26,Hai Phong City,Kien An District,6,1,0,1,1
2022-06-26,Hai Phong City,Kien An District,7,1,0,1,1
2022-06-26,Hai Phong City,Kien An District,8,4,3,1,1
2022-06-26,Hai Phong City,Kien An District,9,11,9,2,1
2022-06-26,Hai Phong City,Kien An District,10,19,17,2,0
2022-06-26,Hai Phong City,Kien An District,11,14,12,2,0
2022-06-26,Hai Phong City,Kien An District,12,12,9,3,0
2022-06-26,Hai Phong City,Kien An District,13,10,8,2,0
2022-06-26,Hai Phong City,Kien An District,14,8,6,2,1
2022-06-26,Hai Phong City,Kien An District,15,22,11,11,8
2022-06-26,Hai Phong City,Kien An District,16,13,11,2,1
2022-06-26,Hai Phong City,Kien An District,17,15,13,2,0
2022-06-26,Hai Phong City,Kien An District,18,11,8,3,1
2022-06-26,Hai Phong City,Kien An District,19,14,6,8,3
2022-06-26,Hai Phong City,Kien An District,20,6,1,5,4
2022-06-26,Hai Phong City,Kien An District,21,6,3,3,2
2022-06-26,Hai Phong City,Le Chan District,0,2,1,1,0
2022-06-26,Hai Phong City,Le Chan District,2,1,0,1,1
2022-06-26,Hai Phong City,Le Chan District,4,1,1,0,0
2022-06-26,Hai Phong City,Le Chan District,5,1,0,1,0
2022-06-26,Hai Phong City,Le Chan District,6,4,1,3,1
2022-06-26,Hai Phong City,Le Chan District,7,50,32,18,4
2022-06-26,Hai Phong City,Le Chan District,8,90,76,14,5
2022-06-26,Hai Phong City,Le Chan District,9,115,98,17,3
2022-06-26,Hai Phong City,Le Chan District,10,226,183,43,3
2022-06-26,Hai Phong City,Le Chan District,11,376,320,56,12
2022-06-26,Hai Phong City,Le Chan District,12,234,209,25,3
2022-06-26,Hai Phong City,Le Chan District,13,145,127,18,1
2022-06-26,Hai Phong City,Le Chan District,14,165,139,26,3
2022-06-26,Hai Phong City,Le Chan District,15,209,176,33,9
2022-06-26,Hai Phong City,Le Chan District,16,181,148,33,9
2022-06-26,Hai Phong City,Le Chan District,17,235,179,56,21
2022-06-26,Hai Phong City,Le Chan District,18,238,196,42,17
2022-06-26,Hai Phong City,Le Chan District,19,226,182,44,17
2022-06-26,Hai Phong City,Le Chan District,20,179,129,50,13
2022-06-26,Hai Phong City,Le Chan District,21,63,46,17,3
2022-06-26,Hai Phong City,Ngo Quyen District,0,1,0,1,1
2022-06-26,Hai Phong City,Ngo Quyen District,6,4,2,2,0
2022-06-26,Hai Phong City,Ngo Quyen District,7,19,16,3,3
2022-06-26,Hai Phong City,Ngo Quyen District,8,65,52,13,1
2022-06-26,Hai Phong City,Ngo Quyen District,9,95,73,22,6
2022-06-26,Hai Phong City,Ngo Quyen District,10,168,159,9,1
2022-06-26,Hai Phong City,Ngo Quyen District,11,286,230,56,7
2022-06-26,Hai Phong City,Ngo Quyen District,12,205,178,27,5
2022-06-26,Hai Phong City,Ngo Quyen District,13,129,109,20,1
2022-06-26,Hai Phong City,Ngo Quyen District,14,103,80,23,2
2022-06-26,Hai Phong City,Ngo Quyen District,15,140,119,21,0
2022-06-26,Hai Phong City,Ngo Quyen District,16,122,105,17,0
2022-06-26,Hai Phong City,Ngo Quyen District,17,165,146,19,6
2022-06-26,Hai Phong City,Ngo Quyen District,18,163,139,24,4
2022-06-26,Hai Phong City,Ngo Quyen District,19,165,137,28,6
2022-06-26,Hai Phong City,Ngo Quyen District,20,150,110,40,10
2022-06-26,Hai Phong City,Ngo Quyen District,21,70,47,23,7
2022-06-26,Hai Phong City,Thuy Nguyen,9,1,0,1,1
2022-06-26,Hai Phong City,Thuy Nguyen,10,2,1,1,1
2022-06-26,Hai Phong City,Thuy Nguyen,11,1,1,0,0
2022-06-26,Hai Phong City,Thuy Nguyen,12,1,1,0,0
2022-06-26,Hai Phong City,Thuy Nguyen,13,1,1,0,0
2022-06-26,Hai Phong City,Thuy Nguyen,20,1,0,1,1
2022-06-26,Hai Phong City,Thuy Nguyen,21,2,0,2,0
2022-06-26,Hue City,Hue City,0,3,3,0,0
2022-06-26,Hue City,Hue City,1,2,2,0,0
2022-06-26,Hue City,Hue City,2,2,1,1,0
2022-06-26,Hue City,Hue City,6,63,54,9,2
2022-06-26,Hue City,Hue City,7,203,191,12,2
2022-06-26,Hue City,Hue City,8,313,284,29,1
2022-06-26,Hue City,Hue City,9,332,292,40,0
2022-06-26,Hue City,Hue City,10,521,487,34,1
2022-06-26,Hue City,Hue City,11,898,824,74,5
2022-06-26,Hue City,Hue City,12,666,608,58,2
2022-06-26,Hue City,Hue City,13,467,407,60,0
2022-06-26,Hue City,Hue City,14,393,359,34,1
2022-06-26,Hue City,Hue City,15,457,415,42,5
2022-06-26,Hue City,Hue City,16,440,398,42,4
2022-06-26,Hue City,Hue City,17,521,439,82,10
2022-06-26,Hue City,Hue City,18,581,410,171,73
2022-06-26,Hue City,Hue City,19,725,389,336,192
2022-06-26,Hue City,Hue City,20,540,261,279,165
2022-06-26,Hue City,Hue City,21,261,161,100,37
2022-06-26,Hue City,Hue City,22,2,0,2,0
2022-06-26,Hue City,Huong Thuy,7,1,0,1,0
2022-06-26,Hue City,Huong Thuy,8,2,1,1,1
2022-06-26,Hue City,Huong Thuy,9,3,2,1,0
2022-06-26,Hue City,Huong Thuy,10,2,2,0,0
2022-06-26,Hue City,Huong Thuy,12,2,2,0,0
2022-06-26,Hue City,Huong Thuy,13,3,0,3,0
2022-06-26,Hue City,Huong Thuy,14,3,0,3,3
2022-06-26,Hue City,Huong Thuy,15,1,0,1,1
2022-06-26,Hue City,Huong Thuy,16,2,2,0,0
2022-06-26,Hue City,Huong Thuy,18,1,1,0,0
2022-06-26,Hue City,Huong Thuy,19,1,0,1,1
2022-06-26,Hue City,Huong Thuy,20,1,0,1,1
2022-06-26,Hue City,Huong Thuy,21,5,0,5,0
2022-06-26,Hue City,Huong Tra,12,3,0,3,3
2022-06-26,Hue City,Huong Tra,21,2,0,2,0
2022-06-26,Hue City,Phu Vang,6,1,1,0,0
2022-06-26,Hue City,Phu Vang,7,5,4,1,1
2022-06-26,Hue City,Phu Vang,8,1,1,0,0
2022-06-26,Hue City,Phu Vang,9,1,1,0,0
2022-06-26,Hue City,Phu Vang,10,1,1,0,0
2022-06-26,Hue City,Phu Vang,11,3,3,0,0
2022-06-26,Hue City,Phu Vang,12,2,1,1,1
2022-06-26,Hue City,Phu Vang,14,1,1,0,0
2022-06-26,Hue City,Phu Vang,15,2,2,0,0
2022-06-26,Hue City,Phu Vang,16,2,2,0,0
2022-06-26,Hue City,Phu Vang,17,2,2,0,0
2022-06-26,Hue City,Phu Vang,18,2,1,1,0
2022-06-26,Hue City,Phu Vang,19,2,1,1,1
2022-06-26,Hue City,Phu Vang,20,1,0,1,1
2022-06-26,Khanh Hoa,Cam Ranh City,17,2,0,2,2
2022-06-26,Khanh Hoa,Nha Trang City,1,1,0,1,0
2022-06-26,Khanh Hoa,Nha Trang City,2,1,0,1,0
2022-06-26,Khanh Hoa,Nha Trang City,5,3,1,2,0
2022-06-26,Khanh Hoa,Nha Trang City,6,37,29,8,1
2022-06-26,Khanh Hoa,Nha Trang City,7,141,127,14,2
2022-06-26,Khanh Hoa,Nha Trang City,8,179,169,10,1
2022-06-26,Khanh Hoa,Nha Trang City,9,208,187,21,0
2022-06-26,Khanh Hoa,Nha Trang City,10,244,233,11,0
2022-06-26,Khanh Hoa,Nha Trang City,11,408,373,35,0
2022-06-26,Khanh Hoa,Nha Trang City,12,303,281,22,1
2022-06-26,Khanh Hoa,Nha Trang City,13,232,212,20,1
2022-06-26,Khanh Hoa,Nha Trang City,14,229,215,14,1
2022-06-26,Khanh Hoa,Nha Trang City,15,238,223,15,1
2022-06-26,Khanh Hoa,Nha Trang City,16,230,202,28,3
2022-06-26,Khanh Hoa,Nha Trang City,17,252,235,17,1
2022-06-26,Khanh Hoa,Nha Trang City,18,337,270,67,26
2022-06-26,Khanh Hoa,Nha Trang City,19,290,223,67,23
2022-06-26,Khanh Hoa,Nha Trang City,20,257,168,89,45
2022-06-26,Khanh Hoa,Nha Trang City,21,114,86,28,7
2022-06-26,Khanh Hoa,Nha Trang City,22,1,0,1,0
2022-06-26,Lam Dong,Da Lat City,0,2,0,2,1
2022-06-26,Lam Dong,Da Lat City,1,5,0,5,2
2022-06-26,Lam Dong,Da Lat City,5,2,0,2,0
2022-06-26,Lam Dong,Da Lat City,6,9,1,8,5
2022-06-26,Lam Dong,Da Lat City,7,90,38,52,39
2022-06-26,Lam Dong,Da Lat City,8,110,66,44,27
2022-06-26,Lam Dong,Da Lat City,9,109,87,22,4
2022-06-26,Lam Dong,Da Lat City,10,116,95,21,3
2022-06-26,Lam Dong,Da Lat City,11,182,127,55,33
2022-06-26,Lam Dong,Da Lat City,12,213,137,76,41
2022-06-26,Lam Dong,Da Lat City,13,164,106,58,28
2022-06-26,Lam Dong,Da Lat City,14,148,66,82,51
2022-06-26,Lam Dong,Da Lat City,15,138,96,42,25
2022-06-26,Lam Dong,Da Lat City,16,138,90,48,29
2022-06-26,Lam Dong,Da Lat City,17,156,108,48,24
2022-06-26,Lam Dong,Da Lat City,18,175,98,77,49
2022-06-26,Lam Dong,Da Lat City,19,145,85,60,22
2022-06-26,Lam Dong,Da Lat City,20,131,61,70,35
2022-06-26,Lam Dong,Da Lat City,21,98,28,70,43
2022-06-26,Nghe An,Vinh City,0,1,1,0,0
2022-06-26,Nghe An,Vinh City,1,1,0,1,1
2022-06-26,Nghe An,Vinh City,3,1,1,0,0
2022-06-26,Nghe An,Vinh City,6,6,4,2,0
2022-06-26,Nghe An,Vinh City,7,106,95,11,1
2022-06-26,Nghe An,Vinh City,8,161,137,24,0
2022-06-26,Nghe An,Vinh City,9,170,150,20,0
2022-06-26,Nghe An,Vinh City,10,263,222,41,15
2022-06-26,Nghe An,Vinh City,11,442,364,78,38
2022-06-26,Nghe An,Vinh City,12,239,216,23,5
2022-06-26,Nghe An,Vinh City,13,189,160,29,5
2022-06-26,Nghe An,Vinh City,14,203,160,43,13
2022-06-26,Nghe An,Vinh City,15,253,176,77,37
2022-06-26,Nghe An,Vinh City,16,182,135,47,16
2022-06-26,Nghe An,Vinh City,17,179,144,35,13
2022-06-26,Nghe An,Vinh City,18,200,161,39,10
2022-06-26,Nghe An,Vinh City,19,217,169,48,14
2022-06-26,Nghe An,Vinh City,20,157,115,42,10
2022-06-26,Nghe An,Vinh City,21,76,60,16,0
2022-06-26,Quang Nam,Hoi An City,2,1,0,1,0
2022-06-26,Quang Nam,Hoi An City,6,3,0,3,2
2022-06-26,Quang Nam,Hoi An City,7,35,14,21,18
2022-06-26,Quang Nam,Hoi An City,8,61,35,26,14
2022-06-26,Quang Nam,Hoi An City,9,46,38,8,0
2022-06-26,Quang Nam,Hoi An City,10,64,43,21,6
2022-06-26,Quang Nam,Hoi An City,11,68,44,24,7
2022-06-26,Quang Nam,Hoi An City,12,55,38,17,10
2022-06-26,Quang Nam,Hoi An City,13,35,27,8,4
2022-06-26,Quang Nam,Hoi An City,14,38,32,6,1
2022-06-26,Quang Nam,Hoi An City,15,35,32,3,0
2022-06-26,Quang Nam,Hoi An City,16,51,44,7,1
2022-06-26,Quang Nam,Hoi An City,17,58,52,6,3
2022-06-26,Quang Nam,Hoi An City,18,49,42,7,3
2022-06-26,Quang Nam,Hoi An City,19,47,38,9,2
2022-06-26,Quang Nam,Hoi An City,20,35,19,16,4
2022-06-26,Quang Nam,Hoi An City,21,40,14,26,17
2022-06-26,Quang Nam,Tam Ky City,9,1,0,1,1
2022-06-26,Quang Nam,Tam Ky City,15,2,0,2,2
2022-06-26,Quang Ninh,Cam Pha City,9,1,0,1,1
2022-06-26,Quang Ninh,Cam Pha City,12,1,0,1,1
2022-06-26,Quang Ninh,Cam Pha City,14,2,0,2,1
2022-06-26,Quang Ninh,Ha Long City,6,2,2,0,0
2022-06-26,Quang Ninh,Ha Long City,7,11,5,6,1
2022-06-26,Quang Ninh,Ha Long City,8,46,27,19,7
2022-06-26,Quang Ninh,Ha Long City,9,61,35,26,16
2022-06-26,Quang Ninh,Ha Long City,10,104,73,31,16
2022-06-26,Quang Ninh,Ha Long City,11,142,111,31,10
2022-06-26,Quang Ninh,Ha Long City,12,135,94,41,14
2022-06-26,Quang Ninh,Ha Long City,13,90,60,30,12
2022-06-26,Quang Ninh,Ha Long City,14,70,35,35,17
2022-06-26,Quang Ninh,Ha Long City,15,81,54,27,10
2022-06-26,Quang Ninh,Ha Long City,16,53,37,16,7
2022-06-26,Quang Ninh,Ha Long City,17,50,35,15,4
2022-06-26,Quang Ninh,Ha Long City,18,70,51,19,9
2022-06-26,Quang Ninh,Ha Long City,19,70,39,31,11
2022-06-26,Quang Ninh,Ha Long City,20,53,38,15,7
2022-06-26,Quang Ninh,Ha Long City,21,1,0,1,0
2022-06-26,Thai Nguyen,Dong Hy,18,3,0,3,2
2022-06-26,Thai Nguyen,Dong Hy,20,1,0,1,0
2022-06-26,Thai Nguyen,Thai Nguyen City,0,3,3,0,0
2022-06-26,Thai Nguyen,Thai Nguyen City,1,1,1,0,0
2022-06-26,Thai Nguyen,Thai Nguyen City,6,2,2,0,0
2022-06-26,Thai Nguyen,Thai Nguyen City,7,94,80,14,5
2022-06-26,Thai Nguyen,Thai Nguyen City,8,137,128,9,0
2022-06-26,Thai Nguyen,Thai Nguyen City,9,154,147,7,0
2022-06-26,Thai Nguyen,Thai Nguyen City,10,209,188,21,2
2022-06-26,Thai Nguyen,Thai Nguyen City,11,426,384,42,6
2022-06-26,Thai Nguyen,Thai Nguyen City,12,292,268,24,3
2022-06-26,Thai Nguyen,Thai Nguyen City,13,155,135,20,0
2022-06-26,Thai Nguyen,Thai Nguyen City,14,203,177,26,4
2022-06-26,Thai Nguyen,Thai Nguyen City,15,150,140,10,3
2022-06-26,Thai Nguyen,Thai Nguyen City,16,153,141,12,1
2022-06-26,Thai Nguyen,Thai Nguyen City,17,152,147,5,0
2022-06-26,Thai Nguyen,Thai Nguyen City,18,214,197,17,1
2022-06-26,Thai Nguyen,Thai Nguyen City,19,271,215,56,16
2022-06-26,Thai Nguyen,Thai Nguyen City,20,260,151,109,56
2022-06-26,Thai Nguyen,Thai Nguyen City,21,169,123,46,20
2022-06-26,Thai Nguyen,Thai Nguyen City,22,2,0,2,0
2022-06-26,Vung Tau,Ba Ria City,7,1,0,1,0
2022-06-26,Vung Tau,Ba Ria City,8,3,2,1,1
2022-06-26,Vung Tau,Ba Ria City,9,6,5,1,1
2022-06-26,Vung Tau,Ba Ria City,10,6,3,3,0
2022-06-26,Vung Tau,Ba Ria City,11,10,7,3,3
2022-06-26,Vung Tau,Ba Ria City,12,12,5,7,3
2022-06-26,Vung Tau,Ba Ria City,13,11,4,7,5
2022-06-26,Vung Tau,Ba Ria City,14,8,3,5,2
2022-06-26,Vung Tau,Ba Ria City,15,13,0,13,6
2022-06-26,Vung Tau,Ba Ria City,16,11,3,8,7
2022-06-26,Vung Tau,Ba Ria City,17,4,2,2,2
2022-06-26,Vung Tau,Ba Ria City,18,6,1,5,4
2022-06-26,Vung Tau,Ba Ria City,19,12,0,12,8
2022-06-26,Vung Tau,Ba Ria City,20,10,0,10,6
2022-06-26,Vung Tau,Ba Ria City,21,1,0,1,1
2022-06-26,Vung Tau,Chau Duc,15,1,0,1,1
2022-06-26,Vung Tau,Vung Tau City,0,1,1,0,0
2022-06-26,Vung Tau,Vung Tau City,2,1,0,1,0
2022-06-26,Vung Tau,Vung Tau City,5,2,1,1,0
2022-06-26,Vung Tau,Vung Tau City,6,42,38,4,0
2022-06-26,Vung Tau,Vung Tau City,7,150,128,22,5
2022-06-26,Vung Tau,Vung Tau City,8,208,193,15,0
2022-06-26,Vung Tau,Vung Tau City,9,293,269,24,1
2022-06-26,Vung Tau,Vung Tau City,10,319,289,30,0
2022-06-26,Vung Tau,Vung Tau City,11,425,398,27,1
2022-06-26,Vung Tau,Vung Tau City,12,440,405,35,0
2022-06-26,Vung Tau,Vung Tau City,13,283,265,18,2
2022-06-26,Vung Tau,Vung Tau City,14,279,250,29,3
2022-06-26,Vung Tau,Vung Tau City,15,275,247,28,1
2022-06-26,Vung Tau,Vung Tau City,16,233,217,16,1
2022-06-26,Vung Tau,Vung Tau City,17,284,258,26,4
2022-06-26,Vung Tau,Vung Tau City,18,295,270,25,3
2022-06-26,Vung Tau,Vung Tau City,19,318,271,47,9
2022-06-26,Vung Tau,Vung Tau City,20,204,175,29,6
2022-06-26,Vung Tau,Vung Tau City,21,123,96,27,5
2022-06-26,Vung Tau,Vung Tau City,22,5,0,5,1
2022-06-27,Bac Ninh,Bác Ninh City,5,2,1,1,0
2022-06-27,Bac Ninh,Bác Ninh City,6,3,3,0,0
2022-06-27,Bac Ninh,Bác Ninh City,7,82,64,18,5
2022-06-27,Bac Ninh,Bác Ninh City,8,118,113,5,1
2022-06-27,Bac Ninh,Bác Ninh City,9,135,116,19,2
2022-06-27,Bac Ninh,Bác Ninh City,10,192,170,22,4
2022-06-27,Bac Ninh,Bác Ninh City,11,376,330,46,14
2022-06-27,Bac Ninh,Bác Ninh City,12,228,208,20,0
2022-06-27,Bac Ninh,Bác Ninh City,13,159,140,19,3
2022-06-27,Bac Ninh,Bác Ninh City,14,176,153,23,2
2022-06-27,Bac Ninh,Bác Ninh City,15,121,114,7,0
2022-06-27,Bac Ninh,Bác Ninh City,16,127,107,20,3
2022-06-27,Bac Ninh,Bác Ninh City,17,113,110,3,0
2022-06-27,Bac Ninh,Bác Ninh City,18,162,156,6,0
2022-06-27,Bac Ninh,Bác Ninh City,19,181,163,18,1
2022-06-27,Bac Ninh,Bác Ninh City,20,165,136,29,4
2022-06-27,Bac Ninh,Bác Ninh City,21,89,66,23,10
2022-06-27,Bac Ninh,Que Vo,7,1,0,1,1
2022-06-27,Bac Ninh,Que Vo,8,1,0,1,1
2022-06-27,Bac Ninh,Que Vo,9,1,1,0,0
2022-06-27,Bac Ninh,Que Vo,10,3,1,2,2
2022-06-27,Bac Ninh,Que Vo,14,3,1,2,2
2022-06-27,Bac Ninh,Que Vo,15,1,1,0,0
2022-06-27,Bac Ninh,Que Vo,18,2,0,2,2
2022-06-27,Bac Ninh,Que Vo,19,2,1,1,0
2022-06-27,Bac Ninh,Tien Du,9,1,0,1,0
2022-06-27,Bac Ninh,Tien Du,12,1,0,1,1
2022-06-27,Bac Ninh,Tien Du,13,1,0,1,1
2022-06-27,Bac Ninh,Tien Du,16,1,0,1,1
2022-06-27,Bac Ninh,Tien Du,18,2,0,2,2
2022-06-27,Bac Ninh,Tien Du,19,1,0,1,1
2022-06-27,Bac Ninh,Tu Son,13,3,0,3,2
2022-06-27,Bac Ninh,Tu Son,14,1,0,1,0
2022-06-27,Bac Ninh,Tu Son,15,1,0,1,1
2022-06-27,Bac Ninh,Tu Son,17,1,0,1,0
2022-06-27,Bac Ninh,Tu Son,18,1,0,1,1
2022-06-27,Bac Ninh,Tu Son,19,1,0,1,1
2022-06-27,Bac Ninh,Yen Phong,15,2,0,2,2
2022-06-27,Binh Duong,Ben Cat,8,2,0,2,0
2022-06-27,Binh Duong,Ben Cat,10,2,0,2,2
2022-06-27,Binh Duong,Ben Cat,11,1,0,1,1
2022-06-27,Binh Duong,Ben Cat,12,4,0,4,2
2022-06-27,Binh Duong,Ben Cat,14,2,0,2,2
2022-06-27,Binh Duong,Ben Cat,16,1,0,1,1
2022-06-27,Binh Duong,Ben Cat,17,1,0,1,0
2022-06-27,Binh Duong,Ben Cat,18,1,0,1,1
2022-06-27,Binh Duong,Ben Cat,19,2,0,2,2
2022-06-27,Binh Duong,Ben Cat,20,1,0,1,0
2022-06-27,Binh Duong,Ben Cat,21,1,0,1,0
2022-06-27,Binh Duong,Di An,7,2,1,1,1
2022-06-27,Binh Duong,Di An,8,15,7,8,5
2022-06-27,Binh Duong,Di An,9,31,21,10,7
2022-06-27,Binh Duong,Di An,10,29,20,9,3
2022-06-27,Binh Duong,Di An,11,42,31,11,2
2022-06-27,Binh Duong,Di An,12,48,36,12,3
2022-06-27,Binh Duong,Di An,13,50,30,20,7
2022-06-27,Binh Duong,Di An,14,29,18,11,2
2022-06-27,Binh Duong,Di An,15,29,19,10,4
2022-06-27,Binh Duong,Di An,16,40,20,20,5
2022-06-27,Binh Duong,Di An,17,21,16,5,2
2022-06-27,Binh Duong,Di An,18,26,22,4,0
2022-06-27,Binh Duong,Di An,19,35,30,5,2
2022-06-27,Binh Duong,Di An,20,14,10,4,2
2022-06-27,Binh Duong,Di An,21,7,3,4,1
2022-06-27,Binh Duong,Tan Uyen,9,2,0,2,0
2022-06-27,Binh Duong,Tan Uyen,10,1,0,1,0
2022-06-27,Binh Duong,Tan Uyen,11,2,0,2,2
2022-06-27,Binh Duong,Tan Uyen,12,1,0,1,0
2022-06-27,Binh Duong,Tan Uyen,13,6,1,5,1
2022-06-27,Binh Duong,Tan Uyen,14,1,1,0,0
2022-06-27,Binh Duong,Tan Uyen,15,3,1,2,1
2022-06-27,Binh Duong,Tan Uyen,17,1,0,1,1
2022-06-27,Binh Duong,Tan Uyen,18,2,2,0,0
2022-06-27,Binh Duong,Tan Uyen,19,3,2,1,0
2022-06-27,Binh Duong,Tan Uyen,21,1,0,1,1
2022-06-27,Binh Duong,Thu Dau Mot Town,4,3,1,2,0
2022-06-27,Binh Duong,Thu Dau Mot Town,6,38,28,10,2
2022-06-27,Binh Duong,Thu Dau Mot Town,7,128,119,9,0
2022-06-27,Binh Duong,Thu Dau Mot Town,8,227,209,18,2
2022-06-27,Binh Duong,Thu Dau Mot Town,9,261,240,21,2
2022-06-27,Binh Duong,Thu Dau Mot Town,10,375,349,26,1
2022-06-27,Binh Duong,Thu Dau Mot Town,11,713,628,85,6
2022-06-27,Binh Duong,Thu Dau Mot Town,12,512,470,42,4
2022-06-27,Binh Duong,Thu Dau Mot Town,13,461,436,25,3
2022-06-27,Binh Duong,Thu Dau Mot Town,14,351,325,26,2
2022-06-27,Binh Duong,Thu Dau Mot Town,15,272,252,20,3
2022-06-27,Binh Duong,Thu Dau Mot Town,16,318,298,20,1
2022-06-27,Binh Duong,Thu Dau Mot Town,17,392,354,38,4
2022-06-27,Binh Duong,Thu Dau Mot Town,18,401,366,35,4
2022-06-27,Binh Duong,Thu Dau Mot Town,19,340,308,32,2
2022-06-27,Binh Duong,Thu Dau Mot Town,20,261,239,22,0
2022-06-27,Binh Duong,Thu Dau Mot Town,21,133,116,17,0
2022-06-27,Binh Duong,Thu Dau Mot Town,22,1,0,1,0
2022-06-27,Binh Duong,Thuan An,6,1,0,1,1
2022-06-27,Binh Duong,Thuan An,7,8,2,6,3
2022-06-27,Binh Duong,Thuan An,8,23,20,3,0
2022-06-27,Binh Duong,Thuan An,9,53,38,15,5
2022-06-27,Binh Duong,Thuan An,10,63,50,13,5
2022-06-27,Binh Duong,Thuan An,11,76,65,11,3
2022-06-27,Binh Duong,Thuan An,12,52,44,8,2
2022-06-27,Binh Duong,Thuan An,13,89,66,23,12
2022-06-27,Binh Duong,Thuan An,14,61,47,14,6
2022-06-27,Binh Duong,Thuan An,15,27,26,1,0
2022-06-27,Binh Duong,Thuan An,16,39,30,9,6
2022-06-27,Binh Duong,Thuan An,17,43,37,6,1
2022-06-27,Binh Duong,Thuan An,18,56,48,8,4
2022-06-27,Binh Duong,Thuan An,19,45,36,9,2
2022-06-27,Binh Duong,Thuan An,20,35,26,9,3
2022-06-27,Binh Duong,Thuan An,21,14,7,7,4
2022-06-27,Can Tho City,Binh Thuy District,6,1,1,0,0
2022-06-27,Can Tho City,Binh Thuy District,8,3,3,0,0
2022-06-27,Can Tho City,Binh Thuy District,9,5,3,2,1
2022-06-27,Can Tho City,Binh Thuy District,10,4,3,1,0
2022-06-27,Can Tho City,Binh Thuy District,11,8,8,0,0
2022-06-27,Can Tho City,Binh Thuy District,12,9,9,0,0
2022-06-27,Can Tho City,Binh Thuy District,13,15,12,3,1
2022-06-27,Can Tho City,Binh Thuy District,14,22,18,4,0
2022-06-27,Can Tho City,Binh Thuy District,15,21,19,2,1
2022-06-27,Can Tho City,Binh Thuy District,16,9,8,1,0
2022-06-27,Can Tho City,Binh Thuy District,17,10,8,2,0
2022-06-27,Can Tho City,Binh Thuy District,18,5,3,2,0
2022-06-27,Can Tho City,Binh Thuy District,19,7,6,1,1
2022-06-27,Can Tho City,Binh Thuy District,20,8,6,2,1
2022-06-27,Can Tho City,Binh Thuy District,21,4,3,1,1
2022-06-27,Can Tho City,Cai Rang District,7,3,2,1,1
2022-06-27,Can Tho City,Cai Rang District,8,5,4,1,1
2022-06-27,Can Tho City,Cai Rang District,9,8,7,1,0
2022-06-27,Can Tho City,Cai Rang District,10,13,11,2,0
2022-06-27,Can Tho City,Cai Rang District,11,10,9,1,0
2022-06-27,Can Tho City,Cai Rang District,12,10,10,0,0
2022-06-27,Can Tho City,Cai Rang District,13,4,4,0,0
2022-06-27,Can Tho City,Cai Rang District,14,12,10,2,0
2022-06-27,Can Tho City,Cai Rang District,15,8,7,1,0
2022-06-27,Can Tho City,Cai Rang District,16,5,5,0,0
2022-06-27,Can Tho City,Cai Rang District,17,6,6,0,0
2022-06-27,Can Tho City,Cai Rang District,18,14,13,1,0
2022-06-27,Can Tho City,Cai Rang District,19,9,8,1,0
2022-06-27,Can Tho City,Cai Rang District,20,5,5,0,0
2022-06-27,Can Tho City,Cai Rang District,21,3,2,1,0
2022-06-27,Can Tho City,Ninh Kieu District,0,1,1,0,0
2022-06-27,Can Tho City,Ninh Kieu District,1,4,1,3,0
2022-06-27,Can Tho City,Ninh Kieu District,2,2,2,0,0
2022-06-27,Can Tho City,Ninh Kieu District,3,1,1,0,0
2022-06-27,Can Tho City,Ninh Kieu District,4,3,2,1,0
2022-06-27,Can Tho City,Ninh Kieu District,5,4,3,1,0
2022-06-27,Can Tho City,Ninh Kieu District,6,66,59,7,0
2022-06-27,Can Tho City,Ninh Kieu District,7,141,131,10,0
2022-06-27,Can Tho City,Ninh Kieu District,8,235,223,12,0
2022-06-27,Can Tho City,Ninh Kieu District,9,274,261,13,0
2022-06-27,Can Tho City,Ninh Kieu District,10,512,498,14,0
2022-06-27,Can Tho City,Ninh Kieu District,11,809,766,43,1
2022-06-27,Can Tho City,Ninh Kieu District,12,623,607,16,0
2022-06-27,Can Tho City,Ninh Kieu District,13,454,441,13,0
2022-06-27,Can Tho City,Ninh Kieu District,14,436,408,28,0
2022-06-27,Can Tho City,Ninh Kieu District,15,367,353,14,0
2022-06-27,Can Tho City,Ninh Kieu District,16,400,376,24,0
2022-06-27,Can Tho City,Ninh Kieu District,17,453,439,14,1
2022-06-27,Can Tho City,Ninh Kieu District,18,528,506,22,0
2022-06-27,Can Tho City,Ninh Kieu District,19,454,431,23,0
2022-06-27,Can Tho City,Ninh Kieu District,20,367,340,27,0
2022-06-27,Can Tho City,Ninh Kieu District,21,208,189,19,0
2022-06-27,Can Tho City,Ninh Kieu District,22,1,0,1,0
2022-06-27,Dong Nai,Bien Hoa City,0,3,2,1,0
2022-06-27,Dong Nai,Bien Hoa City,5,3,2,1,0
2022-06-27,Dong Nai,Bien Hoa City,6,41,31,10,2
2022-06-27,Dong Nai,Bien Hoa City,7,166,144,22,4
2022-06-27,Dong Nai,Bien Hoa City,8,310,273,37,2
2022-06-27,Dong Nai,Bien Hoa City,9,413,371,42,11
2022-06-27,Dong Nai,Bien Hoa City,10,701,641,60,5
2022-06-27,Dong Nai,Bien Hoa City,11,1175,1084,91,7
2022-06-27,Dong Nai,Bien Hoa City,12,965,880,85,12
2022-06-27,Dong Nai,Bien Hoa City,13,889,801,88,11
2022-06-27,Dong Nai,Bien Hoa City,14,684,618,66,5
2022-06-27,Dong Nai,Bien Hoa City,15,473,426,47,5
2022-06-27,Dong Nai,Bien Hoa City,16,530,481,49,1
2022-06-27,Dong Nai,Bien Hoa City,17,625,568,57,7
2022-06-27,Dong Nai,Bien Hoa City,18,640,594,46,4
2022-06-27,Dong Nai,Bien Hoa City,19,738,669,69,6
2022-06-27,Dong Nai,Bien Hoa City,20,512,436,76,5
2022-06-27,Dong Nai,Bien Hoa City,21,219,165,54,16
2022-06-27,Dong Nai,Bien Hoa City,22,3,0,3,1
2022-06-27,Dong Nai,Long Khanh,16,1,0,1,1
2022-06-27,Dong Nai,Long Thanh,10,4,0,4,1
2022-06-27,Dong Nai,Long Thanh,13,2,0,2,2
2022-06-27,Dong Nai,Long Thanh,14,1,0,1,1
2022-06-27,Dong Nai,Long Thanh,16,1,0,1,0
2022-06-27,Dong Nai,Long Thanh,17,2,0,2,2
2022-06-27,Dong Nai,Long Thanh,19,4,0,4,3
2022-06-27,Dong Nai,Long Thanh,20,2,0,2,2
2022-06-27,Dong Nai,Long Thanh,21,2,0,2,2
2022-06-27,Dong Nai,Nhon trach,10,1,0,1,1
2022-06-27,Dong Nai,Nhon trach,11,1,0,1,1
2022-06-27,Dong Nai,Nhon trach,12,1,0,1,1
2022-06-27,Dong Nai,Nhon trach,17,1,0,1,1
2022-06-27,Dong Nai,Nhon trach,20,1,0,1,1
2022-06-27,Dong Nai,Nhon trach,21,1,0,1,0
2022-06-27,Dong Nai,Trang Bom,9,2,0,2,2
2022-06-27,Dong Nai,Trang Bom,10,2,0,2,2
2022-06-27,Dong Nai,Trang Bom,15,1,0,1,0
2022-06-27,Dong Nai,Trang Bom,19,1,1,0,0
2022-06-27,Dong Nai,Trang Bom,21,1,0,1,1
2022-06-27,Dong Nai,Vinh Cuu,12,1,1,0,0
2022-06-27,Dong Nai,Vinh Cuu,13,1,0,1,0
2022-06-27,Hai Phong City,An Duong,8,1,1,0,0
2022-06-27,Hai Phong City,An Duong,9,2,2,0,0
2022-06-27,Hai Phong City,An Duong,10,8,6,2,2
2022-06-27,Hai Phong City,An Duong,11,8,5,3,2
2022-06-27,Hai Phong City,An Duong,12,6,3,3,3
2022-06-27,Hai Phong City,An Duong,13,6,3,3,3
2022-06-27,Hai Phong City,An Duong,14,7,1,6,4
2022-06-27,Hai Phong City,An Duong,15,3,3,0,0
2022-06-27,Hai Phong City,An Duong,16,5,4,1,1
2022-06-27,Hai Phong City,An Duong,17,4,2,2,1
2022-06-27,Hai Phong City,An Duong,18,3,2,1,0
2022-06-27,Hai Phong City,An Duong,19,1,0,1,0
2022-06-27,Hai Phong City,An Duong,20,1,0,1,1
2022-06-27,Hai Phong City,Do Son District,17,1,0,1,1
2022-06-27,Hai Phong City,Duong Kinh District,18,1,0,1,1
2022-06-27,Hai Phong City,Hai An District,7,3,2,1,0
2022-06-27,Hai Phong City,Hai An District,8,18,18,0,0
2022-06-27,Hai Phong City,Hai An District,9,13,9,4,1
2022-06-27,Hai Phong City,Hai An District,10,31,28,3,1
2022-06-27,Hai Phong City,Hai An District,11,66,53,13,2
2022-06-27,Hai Phong City,Hai An District,12,34,26,8,3
2022-06-27,Hai Phong City,Hai An District,13,10,7,3,1
2022-06-27,Hai Phong City,Hai An District,14,15,12,3,2
2022-06-27,Hai Phong City,Hai An District,15,17,12,5,2
2022-06-27,Hai Phong City,Hai An District,16,27,18,9,3
2022-06-27,Hai Phong City,Hai An District,17,13,10,3,0
2022-06-27,Hai Phong City,Hai An District,18,17,14,3,0
2022-06-27,Hai Phong City,Hai An District,19,25,18,7,0
2022-06-27,Hai Phong City,Hai An District,20,20,14,6,0
2022-06-27,Hai Phong City,Hai An District,21,5,4,1,0
2022-06-27,Hai Phong City,Hong Bang District,6,3,2,1,0
2022-06-27,Hai Phong City,Hong Bang District,7,10,7,3,1
2022-06-27,Hai Phong City,Hong Bang District,8,39,29,10,2
2022-06-27,Hai Phong City,Hong Bang District,9,35,29,6,1
2022-06-27,Hai Phong City,Hong Bang District,10,73,64,9,2
2022-06-27,Hai Phong City,Hong Bang District,11,117,99,18,3
2022-06-27,Hai Phong City,Hong Bang District,12,66,56,10,0
2022-06-27,Hai Phong City,Hong Bang District,13,60,45,15,3
2022-06-27,Hai Phong City,Hong Bang District,14,51,41,10,3
2022-06-27,Hai Phong City,Hong Bang District,15,40,34,6,1
2022-06-27,Hai Phong City,Hong Bang District,16,41,36,5,1
2022-06-27,Hai Phong City,Hong Bang District,17,44,41,3,0
2022-06-27,Hai Phong City,Hong Bang District,18,61,47,14,4
2022-06-27,Hai Phong City,Hong Bang District,19,74,54,20,6
2022-06-27,Hai Phong City,Hong Bang District,20,34,26,8,1
2022-06-27,Hai Phong City,Hong Bang District,21,14,10,4,1
2022-06-27,Hai Phong City,Hong Bang District,22,2,0,2,0
2022-06-27,Hai Phong City,Kien An District,8,4,2,2,1
2022-06-27,Hai Phong City,Kien An District,9,8,4,4,2
2022-06-27,Hai Phong City,Kien An District,10,17,12,5,5
2022-06-27,Hai Phong City,Kien An District,11,17,13,4,1
2022-06-27,Hai Phong City,Kien An District,12,10,6,4,1
2022-06-27,Hai Phong City,Kien An District,13,7,4,3,2
2022-06-27,Hai Phong City,Kien An District,14,7,3,4,2
2022-06-27,Hai Phong City,Kien An District,15,14,8,6,2
2022-06-27,Hai Phong City,Kien An District,16,10,7,3,0
2022-06-27,Hai Phong City,Kien An District,17,8,8,0,0
2022-06-27,Hai Phong City,Kien An District,18,9,6,3,1
2022-06-27,Hai Phong City,Kien An District,19,12,7,5,2
2022-06-27,Hai Phong City,Kien An District,20,19,5,14,6
2022-06-27,Hai Phong City,Kien An District,21,4,1,3,3
2022-06-27,Hai Phong City,Le Chan District,1,1,0,1,1
2022-06-27,Hai Phong City,Le Chan District,4,1,0,1,0
2022-06-27,Hai Phong City,Le Chan District,7,35,23,12,4
2022-06-27,Hai Phong City,Le Chan District,8,81,65,16,5
2022-06-27,Hai Phong City,Le Chan District,9,97,81,16,0
2022-06-27,Hai Phong City,Le Chan District,10,169,152,17,0
2022-06-27,Hai Phong City,Le Chan District,11,334,295,39,11
2022-06-27,Hai Phong City,Le Chan District,12,218,202,16,2
2022-06-27,Hai Phong City,Le Chan District,13,121,107,14,1
2022-06-27,Hai Phong City,Le Chan District,14,158,129,29,8
2022-06-27,Hai Phong City,Le Chan District,15,153,137,16,2
2022-06-27,Hai Phong City,Le Chan District,16,140,115,25,1
2022-06-27,Hai Phong City,Le Chan District,17,157,137,20,1
2022-06-27,Hai Phong City,Le Chan District,18,197,178,19,1
2022-06-27,Hai Phong City,Le Chan District,19,190,163,27,5
2022-06-27,Hai Phong City,Le Chan District,20,136,110,26,3
2022-06-27,Hai Phong City,Le Chan District,21,93,61,32,10
2022-06-27,Hai Phong City,Le Chan District,22,1,0,1,0
2022-06-27,Hai Phong City,Le Chan District,23,1,0,1,0
2022-06-27,Hai Phong City,Ngo Quyen District,5,1,0,1,0
2022-06-27,Hai Phong City,Ngo Quyen District,6,2,0,2,2
2022-06-27,Hai Phong City,Ngo Quyen District,7,34,25,9,3
2022-06-27,Hai Phong City,Ngo Quyen District,8,75,53,22,1
2022-06-27,Hai Phong City,Ngo Quyen District,9,78,72,6,0
2022-06-27,Hai Phong City,Ngo Quyen District,10,125,110,15,0
2022-06-27,Hai Phong City,Ngo Quyen District,11,251,224,27,8
2022-06-27,Hai Phong City,Ngo Quyen District,12,156,135,21,2
2022-06-27,Hai Phong City,Ngo Quyen District,13,129,116,13,0
2022-06-27,Hai Phong City,Ngo Quyen District,14,166,144,22,5
2022-06-27,Hai Phong City,Ngo Quyen District,15,144,123,21,1
2022-06-27,Hai Phong City,Ngo Quyen District,16,129,122,7,1
2022-06-27,Hai Phong City,Ngo Quyen District,17,120,113,7,1
2022-06-27,Hai Phong City,Ngo Quyen District,18,161,146,15,1
2022-06-27,Hai Phong City,Ngo Quyen District,19,145,127,18,3
2022-06-27,Hai Phong City,Ngo Quyen District,20,130,104,26,8
2022-06-27,Hai Phong City,Ngo Quyen District,21,68,50,18,5
2022-06-27,Hai Phong City,Thuy Nguyen,10,2,0,2,1
2022-06-27,Hai Phong City,Thuy Nguyen,11,2,0,2,2
2022-06-27,Hai Phong City,Thuy Nguyen,12,1,0,1,0
2022-06-27,Hai Phong City,Thuy Nguyen,14,1,0,1,1
2022-06-27,Hai Phong City,Thuy Nguyen,16,1,0,1,0
2022-06-27,Hai Phong City,Thuy Nguyen,18,1,0,1,1
2022-06-27,Hai Phong City,Thuy Nguyen,20,1,0,1,1
2022-06-27,Hue City,Hue City,0,4,2,2,0
2022-06-27,Hue City,Hue City,1,1,1,0,0
2022-06-27,Hue City,Hue City,5,5,3,2,1
2022-06-27,Hue City,Hue City,6,74,66,8,1
2022-06-27,Hue City,Hue City,7,177,158,19,2
2022-06-27,Hue City,Hue City,8,348,317,31,0
2022-06-27,Hue City,Hue City,9,275,260,15,2
2022-06-27,Hue City,Hue City,10,469,426,43,1
2022-06-27,Hue City,Hue City,11,902,843,59,3
2022-06-27,Hue City,Hue City,12,663,619,44,0
2022-06-27,Hue City,Hue City,13,373,347,26,0
2022-06-27,Hue City,Hue City,14,390,354,36,1
2022-06-27,Hue City,Hue City,15,415,369,46,0
2022-06-27,Hue City,Hue City,16,416,373,43,4
2022-06-27,Hue City,Hue City,17,433,413,20,2
2022-06-27,Hue City,Hue City,18,491,448,43,2
2022-06-27,Hue City,Hue City,19,567,503,64,8
2022-06-27,Hue City,Hue City,20,484,376,108,38
2022-06-27,Hue City,Hue City,21,272,212,60,12
2022-06-27,Hue City,Hue City,23,1,0,1,0
2022-06-27,Hue City,Huong Thuy,7,1,1,0,0
2022-06-27,Hue City,Huong Thuy,8,2,0,2,1
2022-06-27,Hue City,Huong Thuy,9,3,0,3,2
2022-06-27,Hue City,Huong Thuy,10,1,0,1,1
2022-06-27,Hue City,Huong Thuy,11,2,1,1,0
2022-06-27,Hue City,Huong Thuy,12,2,2,0,0
2022-06-27,Hue City,Huong Thuy,14,2,0,2,2
2022-06-27,Hue City,Huong Thuy,15,1,1,0,0
2022-06-27,Hue City,Huong Thuy,17,1,1,0,0
2022-06-27,Hue City,Huong Thuy,18,1,1,0,0
2022-06-27,Hue City,Huong Thuy,19,2,2,0,0
2022-06-27,Hue City,Huong Thuy,21,1,0,1,0
2022-06-27,Hue City,Huong Tra,9,1,1,0,0
2022-06-27,Hue City,Huong Tra,10,1,1,0,0
2022-06-27,Hue City,Huong Tra,12,1,1,0,0
2022-06-27,Hue City,Huong Tra,15,2,1,1,0
2022-06-27,Hue City,Huong Tra,18,1,1,0,0
2022-06-27,Hue City,Phu Vang,7,3,2,1,1
2022-06-27,Hue City,Phu Vang,8,4,4,0,0
2022-06-27,Hue City,Phu Vang,9,1,1,0,0
2022-06-27,Hue City,Phu Vang,10,3,3,0,0
2022-06-27,Hue City,Phu Vang,11,2,2,0,0
2022-06-27,Hue City,Phu Vang,12,1,1,0,0
2022-06-27,Hue City,Phu Vang,14,2,1,1,0
2022-06-27,Hue City,Phu Vang,16,1,1,0,0
2022-06-27,Hue City,Phu Vang,17,1,0,1,1
2022-06-27,Hue City,Phu Vang,18,2,2,0,0
2022-06-27,Hue City,Phu Vang,19,1,1,0,0
2022-06-27,Hue City,Phu Vang,20,1,0,1,1
2022-06-27,Hue City,Phu Vang,21,1,0,1,1
2022-06-27,Khanh Hoa,Cam Ranh City,10,1,0,1,1
2022-06-27,Khanh Hoa,Cam Ranh City,13,3,0,3,2
2022-06-27,Khanh Hoa,Dien Khanh,12,1,0,1,0
2022-06-27,Khanh Hoa,Nha Trang City,0,3,2,1,1
2022-06-27,Khanh Hoa,Nha Trang City,1,2,0,2,0
2022-06-27,Khanh Hoa,Nha Trang City,3,3,1,2,0
2022-06-27,Khanh Hoa,Nha Trang City,5,2,1,1,0
2022-06-27,Khanh Hoa,Nha Trang City,6,39,31,8,0
2022-06-27,Khanh Hoa,Nha Trang City,7,138,129,9,0
2022-06-27,Khanh Hoa,Nha Trang City,8,204,194,10,0
2022-06-27,Khanh Hoa,Nha Trang City,9,210,187,23,3
2022-06-27,Khanh Hoa,Nha Trang City,10,258,241,17,2
2022-06-27,Khanh Hoa,Nha Trang City,11,403,369,34,0
2022-06-27,Khanh Hoa,Nha Trang City,12,383,343,40,4
2022-06-27,Khanh Hoa,Nha Trang City,13,270,245,25,0
2022-06-27,Khanh Hoa,Nha Trang City,14,267,250,17,0
2022-06-27,Khanh Hoa,Nha Trang City,15,197,178,19,1
2022-06-27,Khanh Hoa,Nha Trang City,16,181,165,16,0
2022-06-27,Khanh Hoa,Nha Trang City,17,224,212,12,0
2022-06-27,Khanh Hoa,Nha Trang City,18,288,258,30,0
2022-06-27,Khanh Hoa,Nha Trang City,19,264,241,23,2
2022-06-27,Khanh Hoa,Nha Trang City,20,192,173,19,1
2022-06-27,Khanh Hoa,Nha Trang City,21,110,67,43,7
2022-06-27,Khanh Hoa,Nha Trang City,22,2,1,1,1
2022-06-27,Lam Dong,Da Lat City,6,1,1,0,0
2022-06-27,Lam Dong,Da Lat City,7,79,32,47,34
2022-06-27,Lam Dong,Da Lat City,8,111,75,36,20
2022-06-27,Lam Dong,Da Lat City,9,120,88,32,13
2022-06-27,Lam Dong,Da Lat City,10,114,88,26,1
2022-06-27,Lam Dong,Da Lat City,11,164,126,38,18
2022-06-27,Lam Dong,Da Lat City,12,147,88,59,41
2022-06-27,Lam Dong,Da Lat City,13,121,71,50,29
2022-06-27,Lam Dong,Da Lat City,14,160,107,53,29
2022-06-27,Lam Dong,Da Lat City,15,113,86,27,14
2022-06-27,Lam Dong,Da Lat City,16,107,97,10,3
2022-06-27,Lam Dong,Da Lat City,17,124,93,31,10
2022-06-27,Lam Dong,Da Lat City,18,117,86,31,7
2022-06-27,Lam Dong,Da Lat City,19,130,88,42,19
2022-06-27,Lam Dong,Da Lat City,20,141,73,68,35
2022-06-27,Lam Dong,Da Lat City,21,87,41,46,20
2022-06-27,Lam Dong,Da Lat City,22,1,0,1,0
2022-06-27,Nghe An,Vinh City,0,1,0,1,0
2022-06-27,Nghe An,Vinh City,1,2,1,1,0
2022-06-27,Nghe An,Vinh City,2,2,0,2,0
2022-06-27,Nghe An,Vinh City,5,1,0,1,0
2022-06-27,Nghe An,Vinh City,6,5,4,1,0
2022-06-27,Nghe An,Vinh City,7,144,130,14,2
2022-06-27,Nghe An,Vinh City,8,174,150,24,0
2022-06-27,Nghe An,Vinh City,9,150,133,17,0
2022-06-27,Nghe An,Vinh City,10,242,204,38,3
2022-06-27,Nghe An,Vinh City,11,404,323,81,29
2022-06-27,Nghe An,Vinh City,12,247,209,38,6
2022-06-27,Nghe An,Vinh City,13,156,142,14,2
2022-06-27,Nghe An,Vinh City,14,195,159,36,7
2022-06-27,Nghe An,Vinh City,15,201,169,32,5
2022-06-27,Nghe An,Vinh City,16,123,111,12,0
2022-06-27,Nghe An,Vinh City,17,128,107,21,2
2022-06-27,Nghe An,Vinh City,18,193,165,28,5
2022-06-27,Nghe An,Vinh City,19,189,163,26,4
2022-06-27,Nghe An,Vinh City,20,140,114,26,6
2022-06-27,Nghe An,Vinh City,21,86,65,21,6
2022-06-27,Quang Nam,Dien Ban,11,3,0,3,2
2022-06-27,Quang Nam,Hoi An City,5,1,1,0,0
2022-06-27,Quang Nam,Hoi An City,7,17,13,4,0
2022-06-27,Quang Nam,Hoi An City,8,25,19,6,2
2022-06-27,Quang Nam,Hoi An City,9,44,35,9,2
2022-06-27,Quang Nam,Hoi An City,10,37,34,3,1
2022-06-27,Quang Nam,Hoi An City,11,58,43,15,3
2022-06-27,Quang Nam,Hoi An City,12,64,51,13,2
2022-06-27,Quang Nam,Hoi An City,13,38,25,13,4
2022-06-27,Quang Nam,Hoi An City,14,33,30,3,0
2022-06-27,Quang Nam,Hoi An City,15,52,45,7,1
2022-06-27,Quang Nam,Hoi An City,16,42,35,7,2
2022-06-27,Quang Nam,Hoi An City,17,44,40,4,1
2022-06-27,Quang Nam,Hoi An City,18,42,39,3,1
2022-06-27,Quang Nam,Hoi An City,19,47,37,10,5
2022-06-27,Quang Nam,Hoi An City,20,42,29,13,5
2022-06-27,Quang Nam,Hoi An City,21,22,11,11,6
2022-06-27,Quang Ninh,Cam Pha City,9,1,0,1,1
2022-06-27,Quang Ninh,Cam Pha City,10,3,0,3,3
2022-06-27,Quang Ninh,Cam Pha City,12,1,0,1,1
2022-06-27,Quang Ninh,Cam Pha City,14,1,0,1,1
2022-06-27,Quang Ninh,Cam Pha City,16,1,0,1,1
2022-06-27,Quang Ninh,Cam Pha City,17,1,0,1,1
2022-06-27,Quang Ninh,Cam Pha City,18,1,0,1,0
2022-06-27,Quang Ninh,Ha Long City,7,22,16,6,1
2022-06-27,Quang Ninh,Ha Long City,8,59,44,15,4
2022-06-27,Quang Ninh,Ha Long City,9,51,38,13,5
2022-06-27,Quang Ninh,Ha Long City,10,87,61,26,9
2022-06-27,Quang Ninh,Ha Long City,11,165,118,47,15
2022-06-27,Quang Ninh,Ha Long City,12,117,79,38,12
2022-06-27,Quang Ninh,Ha Long City,13,65,44,21,9
2022-06-27,Quang Ninh,Ha Long City,14,85,57,28,10
2022-06-27,Quang Ninh,Ha Long City,15,69,43,26,11
2022-06-27,Quang Ninh,Ha Long City,16,53,36,17,3
2022-06-27,Quang Ninh,Ha Long City,17,59,43,16,7
2022-06-27,Quang Ninh,Ha Long City,18,56,39,17,9
2022-06-27,Quang Ninh,Ha Long City,19,74,52,22,9
2022-06-27,Quang Ninh,Ha Long City,20,58,35,23,6
2022-06-27,Quang Ninh,Ha Long City,21,2,1,1,1
2022-06-27,Quang Ninh,Uong Bi City,13,1,0,1,1
2022-06-27,Quang Ninh,Uong Bi City,14,1,0,1,1
2022-06-27,Thai Nguyen,Dong Hy,9,1,0,1,1
2022-06-27,Thai Nguyen,Dong Hy,13,1,0,1,0
2022-06-27,Thai Nguyen,Thai Nguyen City,0,6,5,1,0
2022-06-27,Thai Nguyen,Thai Nguyen City,1,1,1,0,0
2022-06-27,Thai Nguyen,Thai Nguyen City,2,1,1,0,0
2022-06-27,Thai Nguyen,Thai Nguyen City,6,8,6,2,1
2022-06-27,Thai Nguyen,Thai Nguyen City,7,106,96,10,1
2022-06-27,Thai Nguyen,Thai Nguyen City,8,144,137,7,0
2022-06-27,Thai Nguyen,Thai Nguyen City,9,130,125,5,1
2022-06-27,Thai Nguyen,Thai Nguyen City,10,192,174,18,1
2022-06-27,Thai Nguyen,Thai Nguyen City,11,407,371,36,3
2022-06-27,Thai Nguyen,Thai Nguyen City,12,261,241,20,2
2022-06-27,Thai Nguyen,Thai Nguyen City,13,169,157,12,1
2022-06-27,Thai Nguyen,Thai Nguyen City,14,180,158,22,6
2022-06-27,Thai Nguyen,Thai Nguyen City,15,189,161,28,4
2022-06-27,Thai Nguyen,Thai Nguyen City,16,146,136,10,0
2022-06-27,Thai Nguyen,Thai Nguyen City,17,131,114,17,1
2022-06-27,Thai Nguyen,Thai Nguyen City,18,185,170,15,0
2022-06-27,Thai Nguyen,Thai Nguyen City,19,216,194,22,2
2022-06-27,Thai Nguyen,Thai Nguyen City,20,214,191,23,1
2022-06-27,Thai Nguyen,Thai Nguyen City,21,128,114,14,1
2022-06-27,Thai Nguyen,Thai Nguyen City,22,1,0,1,0
2022-06-27,Vung Tau,Ba Ria City,7,1,1,0,0
2022-06-27,Vung Tau,Ba Ria City,8,2,2,0,0
2022-06-27,Vung Tau,Ba Ria City,9,3,3,0,0
2022-06-27,Vung Tau,Ba Ria City,10,5,2,3,2
2022-06-27,Vung Tau,Ba Ria City,11,11,4,7,6
2022-06-27,Vung Tau,Ba Ria City,12,12,7,5,4
2022-06-27,Vung Tau,Ba Ria City,13,9,3,6,3
2022-06-27,Vung Tau,Ba Ria City,14,10,5,5,4
2022-06-27,Vung Tau,Ba Ria City,15,6,3,3,1
2022-06-27,Vung Tau,Ba Ria City,16,3,0,3,2
2022-06-27,Vung Tau,Ba Ria City,17,6,0,6,6
2022-06-27,Vung Tau,Ba Ria City,18,3,0,3,3
2022-06-27,Vung Tau,Ba Ria City,19,2,0,2,2
2022-06-27,Vung Tau,Ba Ria City,20,3,0,3,2
2022-06-27,Vung Tau,Ba Ria City,21,5,0,5,0
2022-06-27,Vung Tau,Chau Duc,9,2,0,2,2
2022-06-27,Vung Tau,Vung Tau City,0,1,1,0,0
2022-06-27,Vung Tau,Vung Tau City,1,1,1,0,0
2022-06-27,Vung Tau,Vung Tau City,6,32,17,15,1
2022-06-27,Vung Tau,Vung Tau City,7,144,112,32,12
2022-06-27,Vung Tau,Vung Tau City,8,211,186,25,3
2022-06-27,Vung Tau,Vung Tau City,9,170,161,9,0
2022-06-27,Vung Tau,Vung Tau City,10,261,245,16,1
2022-06-27,Vung Tau,Vung Tau City,11,408,370,38,3
2022-06-27,Vung Tau,Vung Tau City,12,336,311,25,2
2022-06-27,Vung Tau,Vung Tau City,13,266,239,27,0
2022-06-27,Vung Tau,Vung Tau City,14,273,240,33,5
2022-06-27,Vung Tau,Vung Tau City,15,236,216,20,2
2022-06-27,Vung Tau,Vung Tau City,16,214,196,18,0
2022-06-27,Vung Tau,Vung Tau City,17,244,214,30,5
2022-06-27,Vung Tau,Vung Tau City,18,284,253,31,0
2022-06-27,Vung Tau,Vung Tau City,19,279,258,21,4
2022-06-27,Vung Tau,Vung Tau City,20,182,160,22,1
2022-06-27,Vung Tau,Vung Tau City,21,124,104,20,6
2022-06-27,Vung Tau,Vung Tau City,23,3,0,3,1
2022-06-28,Bac Ninh,Bác Ninh City,2,1,1,0,0
2022-06-28,Bac Ninh,Bác Ninh City,6,3,2,1,0
2022-06-28,Bac Ninh,Bác Ninh City,7,82,73,9,2
2022-06-28,Bac Ninh,Bác Ninh City,8,140,134,6,0
2022-06-28,Bac Ninh,Bác Ninh City,9,125,114,11,0
2022-06-28,Bac Ninh,Bác Ninh City,10,205,185,20,3
2022-06-28,Bac Ninh,Bác Ninh City,11,410,343,67,29
2022-06-28,Bac Ninh,Bác Ninh City,12,252,230,22,8
2022-06-28,Bac Ninh,Bác Ninh City,13,148,138,10,0
2022-06-28,Bac Ninh,Bác Ninh City,14,136,125,11,3
2022-06-28,Bac Ninh,Bác Ninh City,15,136,126,10,2
2022-06-28,Bac Ninh,Bác Ninh City,16,98,92,6,1
2022-06-28,Bac Ninh,Bác Ninh City,17,125,115,10,1
2022-06-28,Bac Ninh,Bác Ninh City,18,178,170,8,1
2022-06-28,Bac Ninh,Bác Ninh City,19,199,179,20,3
2022-06-28,Bac Ninh,Bác Ninh City,20,89,77,12,1
2022-06-28,Bac Ninh,Bác Ninh City,21,93,77,16,5
2022-06-28,Bac Ninh,Bác Ninh City,22,3,1,2,0
2022-06-28,Bac Ninh,Que Vo,8,1,0,1,1
2022-06-28,Bac Ninh,Que Vo,10,2,1,1,0
2022-06-28,Bac Ninh,Que Vo,11,2,0,2,1
2022-06-28,Bac Ninh,Que Vo,12,2,0,2,2
2022-06-28,Bac Ninh,Que Vo,13,4,3,1,1
2022-06-28,Bac Ninh,Que Vo,14,3,0,3,1
2022-06-28,Bac Ninh,Que Vo,16,1,0,1,0
2022-06-28,Bac Ninh,Que Vo,18,1,0,1,1
2022-06-28,Bac Ninh,Tien Du,8,1,0,1,1
2022-06-28,Bac Ninh,Tien Du,11,1,0,1,1
2022-06-28,Bac Ninh,Tien Du,13,2,0,2,2
2022-06-28,Bac Ninh,Tien Du,20,1,0,1,1
2022-06-28,Bac Ninh,Tu Son,10,1,0,1,1
2022-06-28,Bac Ninh,Tu Son,15,1,0,1,0
2022-06-28,Bac Ninh,Tu Son,18,2,0,2,2
2022-06-28,Bac Ninh,Tu Son,19,3,0,3,3
2022-06-28,Binh Duong,Ben Cat,7,1,0,1,1
2022-06-28,Binh Duong,Ben Cat,8,4,0,4,3
2022-06-28,Binh Duong,Ben Cat,9,2,0,2,2
2022-06-28,Binh Duong,Ben Cat,10,2,0,2,1
2022-06-28,Binh Duong,Ben Cat,13,2,0,2,1
2022-06-28,Binh Duong,Ben Cat,15,3,0,3,2
2022-06-28,Binh Duong,Ben Cat,16,1,0,1,1
2022-06-28,Binh Duong,Ben Cat,17,2,0,2,2
2022-06-28,Binh Duong,Ben Cat,18,1,0,1,1
2022-06-28,Binh Duong,Ben Cat,21,2,0,2,1
2022-06-28,Binh Duong,Di An,7,8,1,7,5
2022-06-28,Binh Duong,Di An,8,26,8,18,6
2022-06-28,Binh Duong,Di An,9,26,13,13,4
2022-06-28,Binh Duong,Di An,10,29,23,6,1
2022-06-28,Binh Duong,Di An,11,49,45,4,3
2022-06-28,Binh Duong,Di An,12,36,30,6,1
2022-06-28,Binh Duong,Di An,13,39,25,14,5
2022-06-28,Binh Duong,Di An,14,36,23,13,7
2022-06-28,Binh Duong,Di An,15,38,28,10,4
2022-06-28,Binh Duong,Di An,16,26,20,6,3
2022-06-28,Binh Duong,Di An,17,23,17,6,5
2022-06-28,Binh Duong,Di An,18,27,19,8,3
2022-06-28,Binh Duong,Di An,19,24,19,5,0
2022-06-28,Binh Duong,Di An,20,14,11,3,0
2022-06-28,Binh Duong,Di An,21,13,10,3,1
2022-06-28,Binh Duong,Di An,22,1,0,1,0
2022-06-28,Binh Duong,Tan Uyen,0,1,0,1,0
2022-06-28,Binh Duong,Tan Uyen,7,1,0,1,1
2022-06-28,Binh Duong,Tan Uyen,8,1,0,1,1
2022-06-28,Binh Duong,Tan Uyen,9,2,2,0,0
2022-06-28,Binh Duong,Tan Uyen,10,1,0,1,1
2022-06-28,Binh Duong,Tan Uyen,11,3,1,2,0
2022-06-28,Binh Duong,Tan Uyen,13,4,3,1,1
2022-06-28,Binh Duong,Tan Uyen,14,2,1,1,0
2022-06-28,Binh Duong,Tan Uyen,15,2,2,0,0
2022-06-28,Binh Duong,Tan Uyen,17,2,2,0,0
2022-06-28,Binh Duong,Tan Uyen,18,2,1,1,0
2022-06-28,Binh Duong,Tan Uyen,19,4,1,3,2
2022-06-28,Binh Duong,Tan Uyen,20,5,2,3,1
2022-06-28,Binh Duong,Tan Uyen,21,3,0,3,2
2022-06-28,Binh Duong,Thu Dau Mot Town,0,2,1,1,0
2022-06-28,Binh Duong,Thu Dau Mot Town,4,2,1,1,0
2022-06-28,Binh Duong,Thu Dau Mot Town,5,2,0,2,2
2022-06-28,Binh Duong,Thu Dau Mot Town,6,28,17,11,6
2022-06-28,Binh Duong,Thu Dau Mot Town,7,144,83,61,17
2022-06-28,Binh Duong,Thu Dau Mot Town,8,298,230,68,17
2022-06-28,Binh Duong,Thu Dau Mot Town,9,271,240,31,2
2022-06-28,Binh Duong,Thu Dau Mot Town,10,409,379,30,4
2022-06-28,Binh Duong,Thu Dau Mot Town,11,665,623,42,7
2022-06-28,Binh Duong,Thu Dau Mot Town,12,485,464,21,3
2022-06-28,Binh Duong,Thu Dau Mot Town,13,488,443,45,3
2022-06-28,Binh Duong,Thu Dau Mot Town,14,377,360,17,4
2022-06-28,Binh Duong,Thu Dau Mot Town,15,377,349,28,4
2022-06-28,Binh Duong,Thu Dau Mot Town,16,287,267,20,0
2022-06-28,Binh Duong,Thu Dau Mot Town,17,403,367,36,5
2022-06-28,Binh Duong,Thu Dau Mot Town,18,370,343,27,3
2022-06-28,Binh Duong,Thu Dau Mot Town,19,402,356,46,7
2022-06-28,Binh Duong,Thu Dau Mot Town,20,188,170,18,1
2022-06-28,Binh Duong,Thu Dau Mot Town,21,143,124,19,2
2022-06-28,Binh Duong,Thu Dau Mot Town,22,1,0,1,0
2022-06-28,Binh Duong,Thuan An,6,5,1,4,1
2022-06-28,Binh Duong,Thuan An,7,7,3,4,3
2022-06-28,Binh Duong,Thuan An,8,29,22,7,3
2022-06-28,Binh Duong,Thuan An,9,40,35,5,3
2022-06-28,Binh Duong,Thuan An,10,59,48,11,5
2022-06-28,Binh Duong,Thuan An,11,86,71,15,2
2022-06-28,Binh Duong,Thuan An,12,100,88,12,4
2022-06-28,Binh Duong,Thuan An,13,78,64,14,3
2022-06-28,Binh Duong,Thuan An,14,68,58,10,2
2022-06-28,Binh Duong,Thuan An,15,57,42,15,2
2022-06-28,Binh Duong,Thuan An,16,38,29,9,5
2022-06-28,Binh Duong,Thuan An,17,38,30,8,2
2022-06-28,Binh Duong,Thuan An,18,39,37,2,0
2022-06-28,Binh Duong,Thuan An,19,53,47,6,1
2022-06-28,Binh Duong,Thuan An,20,22,16,6,2
2022-06-28,Binh Duong,Thuan An,21,26,6,20,13
2022-06-28,Can Tho City,Binh Thuy District,7,1,1,0,0
2022-06-28,Can Tho City,Binh Thuy District,8,2,1,1,0
2022-06-28,Can Tho City,Binh Thuy District,9,6,6,0,0
2022-06-28,Can Tho City,Binh Thuy District,10,13,9,4,0
2022-06-28,Can Tho City,Binh Thuy District,11,12,11,1,0
2022-06-28,Can Tho City,Binh Thuy District,12,13,12,1,0
2022-06-28,Can Tho City,Binh Thuy District,13,15,13,2,1
2022-06-28,Can Tho City,Binh Thuy District,14,8,8,0,0
2022-06-28,Can Tho City,Binh Thuy District,15,20,19,1,0
2022-06-28,Can Tho City,Binh Thuy District,16,8,8,0,0
2022-06-28,Can Tho City,Binh Thuy District,17,18,18,0,0
2022-06-28,Can Tho City,Binh Thuy District,18,13,13,0,0
2022-06-28,Can Tho City,Binh Thuy District,19,16,16,0,0
2022-06-28,Can Tho City,Binh Thuy District,20,8,6,2,0
2022-06-28,Can Tho City,Binh Thuy District,21,4,3,1,0
2022-06-28,Can Tho City,Cai Rang District,6,3,1,2,2
2022-06-28,Can Tho City,Cai Rang District,7,6,4,2,1
2022-06-28,Can Tho City,Cai Rang District,8,11,8,3,0
2022-06-28,Can Tho City,Cai Rang District,9,5,4,1,1
2022-06-28,Can Tho City,Cai Rang District,10,10,10,0,0
2022-06-28,Can Tho City,Cai Rang District,11,15,12,3,0
2022-06-28,Can Tho City,Cai Rang District,12,14,14,0,0
2022-06-28,Can Tho City,Cai Rang District,13,11,11,0,0
2022-06-28,Can Tho City,Cai Rang District,14,8,7,1,0
2022-06-28,Can Tho City,Cai Rang District,15,7,7,0,0
2022-06-28,Can Tho City,Cai Rang District,16,22,18,4,2
2022-06-28,Can Tho City,Cai Rang District,17,10,9,1,1
2022-06-28,Can Tho City,Cai Rang District,18,14,12,2,0
2022-06-28,Can Tho City,Cai Rang District,19,12,9,3,2
2022-06-28,Can Tho City,Cai Rang District,20,6,6,0,0
2022-06-28,Can Tho City,Cai Rang District,21,4,4,0,0
2022-06-28,Can Tho City,Ninh Kieu District,0,3,3,0,0
2022-06-28,Can Tho City,Ninh Kieu District,1,1,0,1,0
2022-06-28,Can Tho City,Ninh Kieu District,3,1,1,0,0
2022-06-28,Can Tho City,Ninh Kieu District,5,3,2,1,0
2022-06-28,Can Tho City,Ninh Kieu District,6,31,27,4,0
2022-06-28,Can Tho City,Ninh Kieu District,7,126,124,2,0
2022-06-28,Can Tho City,Ninh Kieu District,8,217,205,12,0
2022-06-28,Can Tho City,Ninh Kieu District,9,287,273,14,0
2022-06-28,Can Tho City,Ninh Kieu District,10,520,501,19,0
2022-06-28,Can Tho City,Ninh Kieu District,11,826,777,49,1
2022-06-28,Can Tho City,Ninh Kieu District,12,591,572,19,0
2022-06-28,Can Tho City,Ninh Kieu District,13,506,488,18,0
2022-06-28,Can Tho City,Ninh Kieu District,14,391,378,13,0
2022-06-28,Can Tho City,Ninh Kieu District,15,392,370,22,0
2022-06-28,Can Tho City,Ninh Kieu District,16,406,395,11,1
2022-06-28,Can Tho City,Ninh Kieu District,17,507,482,25,0
2022-06-28,Can Tho City,Ninh Kieu District,18,558,533,25,0
2022-06-28,Can Tho City,Ninh Kieu District,19,437,414,23,0
2022-06-28,Can Tho City,Ninh Kieu District,20,250,242,8,0
2022-06-28,Can Tho City,Ninh Kieu District,21,224,207,17,0
2022-06-28,Can Tho City,Ninh Kieu District,22,1,0,1,0
2022-06-28,Dong Nai,Bien Hoa City,0,4,2,2,0
2022-06-28,Dong Nai,Bien Hoa City,1,1,0,1,0
2022-06-28,Dong Nai,Bien Hoa City,5,1,0,1,1
2022-06-28,Dong Nai,Bien Hoa City,6,36,17,19,11
2022-06-28,Dong Nai,Bien Hoa City,7,213,155,58,25
2022-06-28,Dong Nai,Bien Hoa City,8,336,302,34,5
2022-06-28,Dong Nai,Bien Hoa City,9,428,392,36,0
2022-06-28,Dong Nai,Bien Hoa City,10,702,650,52,7
2022-06-28,Dong Nai,Bien Hoa City,11,1088,1003,85,8
2022-06-28,Dong Nai,Bien Hoa City,12,906,836,70,2
2022-06-28,Dong Nai,Bien Hoa City,13,988,917,71,3
2022-06-28,Dong Nai,Bien Hoa City,14,764,694,70,8
2022-06-28,Dong Nai,Bien Hoa City,15,611,554,57,6
2022-06-28,Dong Nai,Bien Hoa City,16,553,512,41,2
2022-06-28,Dong Nai,Bien Hoa City,17,642,597,45,0
2022-06-28,Dong Nai,Bien Hoa City,18,695,650,45,2
2022-06-28,Dong Nai,Bien Hoa City,19,749,679,70,4
2022-06-28,Dong Nai,Bien Hoa City,20,372,310,62,7
2022-06-28,Dong Nai,Bien Hoa City,21,251,196,55,7
2022-06-28,Dong Nai,Long Khanh,13,1,0,1,1
2022-06-28,Dong Nai,Long Khanh,18,1,0,1,1
2022-06-28,Dong Nai,Long Thanh,9,1,0,1,1
2022-06-28,Dong Nai,Long Thanh,10,4,0,4,2
2022-06-28,Dong Nai,Long Thanh,11,2,0,2,2
2022-06-28,Dong Nai,Long Thanh,12,4,0,4,4
2022-06-28,Dong Nai,Long Thanh,13,3,0,3,2
2022-06-28,Dong Nai,Long Thanh,14,1,0,1,1
2022-06-28,Dong Nai,Nhon trach,12,1,0,1,1
2022-06-28,Dong Nai,Nhon trach,13,1,0,1,1
2022-06-28,Dong Nai,Nhon trach,14,1,0,1,1
2022-06-28,Dong Nai,Nhon trach,20,1,0,1,1
2022-06-28,Dong Nai,Trang Bom,8,1,0,1,1
2022-06-28,Dong Nai,Trang Bom,9,1,0,1,1
2022-06-28,Dong Nai,Trang Bom,10,3,0,3,3
2022-06-28,Dong Nai,Trang Bom,11,1,1,0,0
2022-06-28,Dong Nai,Trang Bom,12,1,1,0,0
2022-06-28,Dong Nai,Trang Bom,17,1,0,1,0
2022-06-28,Dong Nai,Trang Bom,19,3,0,3,1
2022-06-28,Dong Nai,Trang Bom,20,2,1,1,1
2022-06-28,Dong Nai,Vinh Cuu,18,1,0,1,0
2022-06-28,Hai Phong City,An Duong,8,1,1,0,0
2022-06-28,Hai Phong City,An Duong,9,5,1,4,1
2022-06-28,Hai Phong City,An Duong,10,5,1,4,2
2022-06-28,Hai Phong City,An Duong,11,6,3,3,0
2022-06-28,Hai Phong City,An Duong,12,4,3,1,1
2022-06-28,Hai Phong City,An Duong,13,7,2,5,3
2022-06-28,Hai Phong City,An Duong,14,1,1,0,0
2022-06-28,Hai Phong City,An Duong,15,3,1,2,1
2022-06-28,Hai Phong City,An Duong,16,4,2,2,1
2022-06-28,Hai Phong City,An Duong,17,1,1,0,0
2022-06-28,Hai Phong City,An Duong,18,1,1,0,0
2022-06-28,Hai Phong City,An Duong,19,2,1,1,1
2022-06-28,Hai Phong City,An Duong,20,3,2,1,0
2022-06-28,Hai Phong City,Do Son District,10,1,0,1,1
2022-06-28,Hai Phong City,Do Son District,11,1,0,1,1
2022-06-28,Hai Phong City,Hai An District,6,1,1,0,0
2022-06-28,Hai Phong City,Hai An District,7,6,4,2,1
2022-06-28,Hai Phong City,Hai An District,8,15,11,4,3
2022-06-28,Hai Phong City,Hai An District,9,12,10,2,1
2022-06-28,Hai Phong City,Hai An District,10,27,23,4,0
2022-06-28,Hai Phong City,Hai An District,11,61,52,9,2
2022-06-28,Hai Phong City,Hai An District,12,24,23,1,0
2022-06-28,Hai Phong City,Hai An District,13,20,18,2,1
2022-06-28,Hai Phong City,Hai An District,14,16,12,4,0
2022-06-28,Hai Phong City,Hai An District,15,21,19,2,1
2022-06-28,Hai Phong City,Hai An District,16,23,19,4,0
2022-06-28,Hai Phong City,Hai An District,17,29,23,6,1
2022-06-28,Hai Phong City,Hai An District,18,20,16,4,0
2022-06-28,Hai Phong City,Hai An District,19,15,12,3,0
2022-06-28,Hai Phong City,Hai An District,20,8,8,0,0
2022-06-28,Hai Phong City,Hai An District,21,16,11,5,0
2022-06-28,Hai Phong City,Hong Bang District,2,1,0,1,1
2022-06-28,Hai Phong City,Hong Bang District,5,1,1,0,0
2022-06-28,Hai Phong City,Hong Bang District,7,19,11,8,2
2022-06-28,Hai Phong City,Hong Bang District,8,47,39,8,1
2022-06-28,Hai Phong City,Hong Bang District,9,38,34,4,0
2022-06-28,Hai Phong City,Hong Bang District,10,60,53,7,0
2022-06-28,Hai Phong City,Hong Bang District,11,104,89,15,2
2022-06-28,Hai Phong City,Hong Bang District,12,61,52,9,0
2022-06-28,Hai Phong City,Hong Bang District,13,36,34,2,1
2022-06-28,Hai Phong City,Hong Bang District,14,54,46,8,3
2022-06-28,Hai Phong City,Hong Bang District,15,46,38,8,1
2022-06-28,Hai Phong City,Hong Bang District,16,39,35,4,0
2022-06-28,Hai Phong City,Hong Bang District,17,42,34,8,0
2022-06-28,Hai Phong City,Hong Bang District,18,68,58,10,1
2022-06-28,Hai Phong City,Hong Bang District,19,44,37,7,0
2022-06-28,Hai Phong City,Hong Bang District,20,19,15,4,0
2022-06-28,Hai Phong City,Hong Bang District,21,16,6,10,2
2022-06-28,Hai Phong City,Hong Bang District,23,1,0,1,0
2022-06-28,Hai Phong City,Kien An District,4,1,0,1,0
2022-06-28,Hai Phong City,Kien An District,7,3,1,2,1
2022-06-28,Hai Phong City,Kien An District,8,5,3,2,2
2022-06-28,Hai Phong City,Kien An District,9,10,5,5,4
2022-06-28,Hai Phong City,Kien An District,10,8,4,4,2
2022-06-28,Hai Phong City,Kien An District,11,13,10,3,0
2022-06-28,Hai Phong City,Kien An District,12,11,8,3,0
2022-06-28,Hai Phong City,Kien An District,13,13,4,9,5
2022-06-28,Hai Phong City,Kien An District,14,15,5,10,7
2022-06-28,Hai Phong City,Kien An District,15,14,7,7,2
2022-06-28,Hai Phong City,Kien An District,16,5,5,0,0
2022-06-28,Hai Phong City,Kien An District,17,12,7,5,0
2022-06-28,Hai Phong City,Kien An District,18,15,12,3,1
2022-06-28,Hai Phong City,Kien An District,19,8,7,1,0
2022-06-28,Hai Phong City,Kien An District,20,6,4,2,2
2022-06-28,Hai Phong City,Kien An District,21,6,1,5,1
2022-06-28,Hai Phong City,Le Chan District,1,5,3,2,0
2022-06-28,Hai Phong City,Le Chan District,6,4,2,2,0
2022-06-28,Hai Phong City,Le Chan District,7,38,36,2,1
2022-06-28,Hai Phong City,Le Chan District,8,70,63,7,0
2022-06-28,Hai Phong City,Le Chan District,9,87,74,13,0
2022-06-28,Hai Phong City,Le Chan District,10,204,174,30,2
2022-06-28,Hai Phong City,Le Chan District,11,320,284,36,4
2022-06-28,Hai Phong City,Le Chan District,12,191,173,18,0
2022-06-28,Hai Phong City,Le Chan District,13,165,142,23,2
2022-06-28,Hai Phong City,Le Chan District,14,152,125,27,3
2022-06-28,Hai Phong City,Le Chan District,15,170,147,23,0
2022-06-28,Hai Phong City,Le Chan District,16,143,121,22,2
2022-06-28,Hai Phong City,Le Chan District,17,159,139,20,0
2022-06-28,Hai Phong City,Le Chan District,18,200,182,18,2
2022-06-28,Hai Phong City,Le Chan District,19,204,184,20,2
2022-06-28,Hai Phong City,Le Chan District,20,100,88,12,1
2022-06-28,Hai Phong City,Le Chan District,21,78,53,25,4
2022-06-28,Hai Phong City,Ngo Quyen District,2,1,0,1,0
2022-06-28,Hai Phong City,Ngo Quyen District,6,2,2,0,0
2022-06-28,Hai Phong City,Ngo Quyen District,7,37,25,12,2
2022-06-28,Hai Phong City,Ngo Quyen District,8,65,56,9,1
2022-06-28,Hai Phong City,Ngo Quyen District,9,77,71,6,0
2022-06-28,Hai Phong City,Ngo Quyen District,10,133,120,13,0
2022-06-28,Hai Phong City,Ngo Quyen District,11,250,221,29,1
2022-06-28,Hai Phong City,Ngo Quyen District,12,169,155,14,2
2022-06-28,Hai Phong City,Ngo Quyen District,13,145,121,24,6
2022-06-28,Hai Phong City,Ngo Quyen District,14,137,110,27,4
2022-06-28,Hai Phong City,Ngo Quyen District,15,139,127,12,2
2022-06-28,Hai Phong City,Ngo Quyen District,16,146,130,16,0
2022-06-28,Hai Phong City,Ngo Quyen District,17,95,84,11,1
2022-06-28,Hai Phong City,Ngo Quyen District,18,179,165,14,2
2022-06-28,Hai Phong City,Ngo Quyen District,19,180,154,26,2
2022-06-28,Hai Phong City,Ngo Quyen District,20,87,67,20,1
2022-06-28,Hai Phong City,Ngo Quyen District,21,80,57,23,5
2022-06-28,Hai Phong City,Thuy Nguyen,9,3,0,3,2
2022-06-28,Hai Phong City,Thuy Nguyen,10,2,0,2,2
2022-06-28,Hai Phong City,Thuy Nguyen,11,2,0,2,2
2022-06-28,Hai Phong City,Thuy Nguyen,12,2,0,2,1
2022-06-28,Hai Phong City,Thuy Nguyen,13,1,0,1,1
2022-06-28,Hai Phong City,Thuy Nguyen,14,1,1,0,0
2022-06-28,Hai Phong City,Thuy Nguyen,16,1,1,0,0
2022-06-28,Hai Phong City,Thuy Nguyen,17,3,0,3,2
2022-06-28,Hai Phong City,Thuy Nguyen,18,1,0,1,1
2022-06-28,Hai Phong City,Thuy Nguyen,19,1,0,1,1
2022-06-28,Hue City,Hue City,0,1,1,0,0
2022-06-28,Hue City,Hue City,1,2,2,0,0
2022-06-28,Hue City,Hue City,2,1,0,1,0
2022-06-28,Hue City,Hue City,3,1,1,0,0
2022-06-28,Hue City,Hue City,4,1,1,0,0
2022-06-28,Hue City,Hue City,5,4,3,1,0
2022-06-28,Hue City,Hue City,6,65,56,9,1
2022-06-28,Hue City,Hue City,7,209,189,20,0
2022-06-28,Hue City,Hue City,8,345,314,31,3
2022-06-28,Hue City,Hue City,9,283,259,24,0
2022-06-28,Hue City,Hue City,10,446,419,27,1
2022-06-28,Hue City,Hue City,11,992,919,73,6
2022-06-28,Hue City,Hue City,12,601,557,44,0
2022-06-28,Hue City,Hue City,13,423,396,27,0
2022-06-28,Hue City,Hue City,14,411,373,38,0
2022-06-28,Hue City,Hue City,15,400,372,28,1
2022-06-28,Hue City,Hue City,16,391,364,27,1
2022-06-28,Hue City,Hue City,17,406,381,25,0
2022-06-28,Hue City,Hue City,18,522,470,52,1
2022-06-28,Hue City,Hue City,19,567,508,59,1
2022-06-28,Hue City,Hue City,20,315,280,35,2
2022-06-28,Hue City,Hue City,21,274,208,66,16
2022-06-28,Hue City,Hue City,22,1,0,1,0
2022-06-28,Hue City,Huong Thuy,8,1,1,0,0
2022-06-28,Hue City,Huong Thuy,9,2,2,0,0
2022-06-28,Hue City,Huong Thuy,10,2,2,0,0
2022-06-28,Hue City,Huong Thuy,11,2,0,2,0
2022-06-28,Hue City,Huong Thuy,12,3,3,0,0
2022-06-28,Hue City,Huong Thuy,14,4,3,1,0
2022-06-28,Hue City,Huong Thuy,15,4,3,1,0
2022-06-28,Hue City,Huong Thuy,17,1,0,1,0
2022-06-28,Hue City,Huong Thuy,19,1,1,0,0
2022-06-28,Hue City,Huong Thuy,21,3,2,1,1
2022-06-28,Hue City,Huong Tra,13,1,1,0,0
2022-06-28,Hue City,Huong Tra,15,1,1,0,0
2022-06-28,Hue City,Huong Tra,17,1,1,0,0
2022-06-28,Hue City,Phu Vang,9,1,1,0,0
2022-06-28,Hue City,Phu Vang,10,2,1,1,0
2022-06-28,Hue City,Phu Vang,11,1,1,0,0
2022-06-28,Hue City,Phu Vang,12,1,1,0,0
2022-06-28,Hue City,Phu Vang,13,3,2,1,1
2022-06-28,Hue City,Phu Vang,14,2,0,2,0
2022-06-28,Hue City,Phu Vang,15,2,2,0,0
2022-06-28,Hue City,Phu Vang,17,2,1,1,1
2022-06-28,Hue City,Phu Vang,18,1,1,0,0
2022-06-28,Hue City,Phu Vang,21,1,0,1,1
2022-06-28,Khanh Hoa,Cam Ranh City,9,1,0,1,1
2022-06-28,Khanh Hoa,Cam Ranh City,10,3,0,3,3
2022-06-28,Khanh Hoa,Dien Khanh,12,1,0,1,1
2022-06-28,Khanh Hoa,Dien Khanh,20,1,0,1,1
2022-06-28,Khanh Hoa,Dien Khanh,21,1,0,1,1
2022-06-28,Khanh Hoa,Nha Trang City,1,1,0,1,0
2022-06-28,Khanh Hoa,Nha Trang City,4,2,1,1,0
2022-06-28,Khanh Hoa,Nha Trang City,6,58,45,13,1
2022-06-28,Khanh Hoa,Nha Trang City,7,130,120,10,0
2022-06-28,Khanh Hoa,Nha Trang City,8,197,175,22,0
2022-06-28,Khanh Hoa,Nha Trang City,9,198,179,19,2
2022-06-28,Khanh Hoa,Nha Trang City,10,225,211,14,0
2022-06-28,Khanh Hoa,Nha Trang City,11,368,347,21,2
2022-06-28,Khanh Hoa,Nha Trang City,12,290,275,15,1
2022-06-28,Khanh Hoa,Nha Trang City,13,281,264,17,1
2022-06-28,Khanh Hoa,Nha Trang City,14,232,223,9,0
2022-06-28,Khanh Hoa,Nha Trang City,15,199,179,20,0
2022-06-28,Khanh Hoa,Nha Trang City,16,191,175,16,0
2022-06-28,Khanh Hoa,Nha Trang City,17,214,199,15,0
2022-06-28,Khanh Hoa,Nha Trang City,18,267,242,25,0
2022-06-28,Khanh Hoa,Nha Trang City,19,260,234,26,1
2022-06-28,Khanh Hoa,Nha Trang City,20,126,113,13,0
2022-06-28,Khanh Hoa,Nha Trang City,21,107,85,22,3
2022-06-28,Khanh Hoa,Nha Trang City,22,2,0,2,0
2022-06-28,Lam Dong,Da Lat City,6,4,4,0,0
2022-06-28,Lam Dong,Da Lat City,7,51,31,20,9
2022-06-28,Lam Dong,Da Lat City,8,72,61,11,2
2022-06-28,Lam Dong,Da Lat City,9,84,77,7,2
2022-06-28,Lam Dong,Da Lat City,10,93,82,11,1
2022-06-28,Lam Dong,Da Lat City,11,148,117,31,4
2022-06-28,Lam Dong,Da Lat City,12,144,129,15,2
2022-06-28,Lam Dong,Da Lat City,13,134,109,25,7
2022-06-28,Lam Dong,Da Lat City,14,121,98,23,12
2022-06-28,Lam Dong,Da Lat City,15,119,79,40,28
2022-06-28,Lam Dong,Da Lat City,16,112,82,30,15
2022-06-28,Lam Dong,Da Lat City,17,101,84,17,3
2022-06-28,Lam Dong,Da Lat City,18,134,91,43,21
2022-06-28,Lam Dong,Da Lat City,19,129,80,49,21
2022-06-28,Lam Dong,Da Lat City,20,66,43,23,11
2022-06-28,Lam Dong,Da Lat City,21,60,28,32,11
2022-06-28,Nghe An,Vinh City,2,1,1,0,0
2022-06-28,Nghe An,Vinh City,6,5,3,2,0
2022-06-28,Nghe An,Vinh City,7,152,134,18,0
2022-06-28,Nghe An,Vinh City,8,214,187,27,0
2022-06-28,Nghe An,Vinh City,9,202,176,26,1
2022-06-28,Nghe An,Vinh City,10,252,225,27,4
2022-06-28,Nghe An,Vinh City,11,442,373,69,23
2022-06-28,Nghe An,Vinh City,12,234,211,23,5
2022-06-28,Nghe An,Vinh City,13,124,102,22,1
2022-06-28,Nghe An,Vinh City,14,175,149,26,2
2022-06-28,Nghe An,Vinh City,15,187,159,28,3
2022-06-28,Nghe An,Vinh City,16,144,122,22,2
2022-06-28,Nghe An,Vinh City,17,159,133,26,5
2022-06-28,Nghe An,Vinh City,18,196,162,34,6
2022-06-28,Nghe An,Vinh City,19,197,161,36,8
2022-06-28,Nghe An,Vinh City,20,122,94,28,8
2022-06-28,Nghe An,Vinh City,21,106,52,54,33
2022-06-28,Nghe An,Vinh City,22,1,0,1,0
2022-06-28,Quang Nam,Dien Ban,8,2,0,2,1
2022-06-28,Quang Nam,Hoi An City,6,2,0,2,2
2022-06-28,Quang Nam,Hoi An City,7,16,8,8,3
2022-06-28,Quang Nam,Hoi An City,8,27,17,10,4
2022-06-28,Quang Nam,Hoi An City,9,20,15,5,0
2022-06-28,Quang Nam,Hoi An City,10,31,29,2,0
2022-06-28,Quang Nam,Hoi An City,11,44,38,6,1
2022-06-28,Quang Nam,Hoi An City,12,34,31,3,0
2022-06-28,Quang Nam,Hoi An City,13,45,38,7,1
2022-06-28,Quang Nam,Hoi An City,14,33,27,6,1
2022-06-28,Quang Nam,Hoi An City,15,36,32,4,2
2022-06-28,Quang Nam,Hoi An City,16,33,28,5,0
2022-06-28,Quang Nam,Hoi An City,17,34,31,3,0
2022-06-28,Quang Nam,Hoi An City,18,49,43,6,1
2022-06-28,Quang Nam,Hoi An City,19,42,36,6,0
2022-06-28,Quang Nam,Hoi An City,20,24,17,7,2
2022-06-28,Quang Nam,Hoi An City,21,23,8,15,8
2022-06-28,Quang Nam,Tam Ky City,15,1,0,1,1
2022-06-28,Quang Ninh,Cam Pha City,9,2,0,2,2
2022-06-28,Quang Ninh,Cam Pha City,12,2,0,2,2
2022-06-28,Quang Ninh,Cam Pha City,15,1,0,1,0
2022-06-28,Quang Ninh,Cam Pha City,17,1,0,1,1
2022-06-28,Quang Ninh,Cam Pha City,19,1,0,1,1
2022-06-28,Quang Ninh,Ha Long City,1,1,1,0,0
2022-06-28,Quang Ninh,Ha Long City,6,1,1,0,0
2022-06-28,Quang Ninh,Ha Long City,7,28,19,9,4
2022-06-28,Quang Ninh,Ha Long City,8,58,41,17,8
2022-06-28,Quang Ninh,Ha Long City,9,63,44,19,9
2022-06-28,Quang Ninh,Ha Long City,10,70,49,21,7
2022-06-28,Quang Ninh,Ha Long City,11,162,132,30,10
2022-06-28,Quang Ninh,Ha Long City,12,125,91,34,16
2022-06-28,Quang Ninh,Ha Long City,13,76,53,23,14
2022-06-28,Quang Ninh,Ha Long City,14,80,54,26,12
2022-06-28,Quang Ninh,Ha Long City,15,59,44,15,4
2022-06-28,Quang Ninh,Ha Long City,16,47,34,13,6
2022-06-28,Quang Ninh,Ha Long City,17,56,37,19,7
2022-06-28,Quang Ninh,Ha Long City,18,66,52,14,4
2022-06-28,Quang Ninh,Ha Long City,19,54,41,13,6
2022-06-28,Quang Ninh,Ha Long City,20,27,11,16,7
2022-06-28,Quang Ninh,Uong Bi City,13,2,0,2,2
2022-06-28,Thai Nguyen,Dong Hy,7,1,0,1,0
2022-06-28,Thai Nguyen,Dong Hy,12,1,0,1,0
2022-06-28,Thai Nguyen,Dong Hy,19,1,0,1,0
2022-06-28,Thai Nguyen,Thai Nguyen City,0,7,6,1,0
2022-06-28,Thai Nguyen,Thai Nguyen City,1,1,0,1,1
2022-06-28,Thai Nguyen,Thai Nguyen City,3,2,1,1,0
2022-06-28,Thai Nguyen,Thai Nguyen City,4,1,1,0,0
2022-06-28,Thai Nguyen,Thai Nguyen City,6,5,5,0,0
2022-06-28,Thai Nguyen,Thai Nguyen City,7,86,83,3,0
2022-06-28,Thai Nguyen,Thai Nguyen City,8,154,139,15,1
2022-06-28,Thai Nguyen,Thai Nguyen City,9,166,147,19,0
2022-06-28,Thai Nguyen,Thai Nguyen City,10,200,184,16,1
2022-06-28,Thai Nguyen,Thai Nguyen City,11,414,377,37,5
2022-06-28,Thai Nguyen,Thai Nguyen City,12,246,227,19,2
2022-06-28,Thai Nguyen,Thai Nguyen City,13,154,144,10,3
2022-06-28,Thai Nguyen,Thai Nguyen City,14,178,150,28,3
2022-06-28,Thai Nguyen,Thai Nguyen City,15,165,147,18,2
2022-06-28,Thai Nguyen,Thai Nguyen City,16,128,116,12,0
2022-06-28,Thai Nguyen,Thai Nguyen City,17,168,146,22,3
2022-06-28,Thai Nguyen,Thai Nguyen City,18,221,212,9,0
2022-06-28,Thai Nguyen,Thai Nguyen City,19,238,222,16,1
2022-06-28,Thai Nguyen,Thai Nguyen City,20,148,135,13,1
2022-06-28,Thai Nguyen,Thai Nguyen City,21,133,109,24,2
2022-06-28,Thai Nguyen,Thai Nguyen City,22,1,0,1,0
2022-06-28,Thai Nguyen,Thai Nguyen City,23,1,0,1,0
2022-06-28,Vung Tau,Ba Ria City,7,1,0,1,1
2022-06-28,Vung Tau,Ba Ria City,8,4,0,4,4
2022-06-28,Vung Tau,Ba Ria City,9,8,0,8,6
2022-06-28,Vung Tau,Ba Ria City,10,14,6,8,3
2022-06-28,Vung Tau,Ba Ria City,11,8,5,3,0
2022-06-28,Vung Tau,Ba Ria City,12,11,8,3,1
2022-06-28,Vung Tau,Ba Ria City,13,7,4,3,3
2022-06-28,Vung Tau,Ba Ria City,14,5,5,0,0
2022-06-28,Vung Tau,Ba Ria City,15,9,6,3,2
2022-06-28,Vung Tau,Ba Ria City,16,2,0,2,2
2022-06-28,Vung Tau,Ba Ria City,17,7,0,7,4
2022-06-28,Vung Tau,Ba Ria City,18,3,0,3,2
2022-06-28,Vung Tau,Ba Ria City,19,11,0,11,5
2022-06-28,Vung Tau,Ba Ria City,20,7,0,7,4
2022-06-28,Vung Tau,Ba Ria City,21,6,0,6,2
2022-06-28,Vung Tau,Chau Duc,16,1,0,1,1
2022-06-28,Vung Tau,Tan Thanh,12,1,0,1,1
2022-06-28,Vung Tau,Vung Tau City,3,1,1,0,0
2022-06-28,Vung Tau,Vung Tau City,5,1,1,0,0
2022-06-28,Vung Tau,Vung Tau City,6,29,24,5,0
2022-06-28,Vung Tau,Vung Tau City,7,134,108,26,5
2022-06-28,Vung Tau,Vung Tau City,8,190,177,13,1
2022-06-28,Vung Tau,Vung Tau City,9,189,180,9,1
2022-06-28,Vung Tau,Vung Tau City,10,178,166,12,0
2022-06-28,Vung Tau,Vung Tau City,11,345,313,32,2
2022-06-28,Vung Tau,Vung Tau City,12,274,253,21,0
2022-06-28,Vung Tau,Vung Tau City,13,217,204,13,0
2022-06-28,Vung Tau,Vung Tau City,14,261,242,19,1
2022-06-28,Vung Tau,Vung Tau City,15,218,200,18,2
2022-06-28,Vung Tau,Vung Tau City,16,188,173,15,2
2022-06-28,Vung Tau,Vung Tau City,17,231,214,17,1
2022-06-28,Vung Tau,Vung Tau City,18,277,255,22,1
2022-06-28,Vung Tau,Vung Tau City,19,298,260,38,5
2022-06-28,Vung Tau,Vung Tau City,20,132,104,28,1
2022-06-28,Vung Tau,Vung Tau City,21,140,95,45,12
2022-06-28,Vung Tau,Vung Tau City,22,1,0,1,0
2022-06-28,Vung Tau,Vung Tau City,23,1,0,1,0
2022-06-29,Bac Ninh,Bác Ninh City,1,1,1,0,0
2022-06-29,Bac Ninh,Bác Ninh City,6,6,2,4,3
2022-06-29,Bac Ninh,Bác Ninh City,7,99,51,48,39
2022-06-29,Bac Ninh,Bác Ninh City,8,124,110,14,5
2022-06-29,Bac Ninh,Bác Ninh City,9,103,92,11,2
2022-06-29,Bac Ninh,Bác Ninh City,10,188,169,19,0
2022-06-29,Bac Ninh,Bác Ninh City,11,334,310,24,4
2022-06-29,Bac Ninh,Bác Ninh City,12,211,199,12,1
2022-06-29,Bac Ninh,Bác Ninh City,13,154,144,10,0
2022-06-29,Bac Ninh,Bác Ninh City,14,163,151,12,2
2022-06-29,Bac Ninh,Bác Ninh City,15,132,120,12,3
2022-06-29,Bac Ninh,Bác Ninh City,16,127,116,11,0
2022-06-29,Bac Ninh,Bác Ninh City,17,114,104,10,0
2022-06-29,Bac Ninh,Bác Ninh City,18,158,143,15,0
2022-06-29,Bac Ninh,Bác Ninh City,19,177,159,18,3
2022-06-29,Bac Ninh,Bác Ninh City,20,171,146,25,4
2022-06-29,Bac Ninh,Bác Ninh City,21,87,72,15,1
2022-06-29,Bac Ninh,Que Vo,7,1,0,1,0
2022-06-29,Bac Ninh,Que Vo,8,1,0,1,1
2022-06-29,Bac Ninh,Que Vo,11,2,1,1,0
2022-06-29,Bac Ninh,Que Vo,12,1,1,0,0
2022-06-29,Bac Ninh,Que Vo,13,2,2,0,0
2022-06-29,Bac Ninh,Que Vo,14,1,0,1,0
2022-06-29,Bac Ninh,Que Vo,15,1,1,0,0
2022-06-29,Bac Ninh,Que Vo,17,1,1,0,0
2022-06-29,Bac Ninh,Tien Du,10,1,0,1,1
2022-06-29,Bac Ninh,Tien Du,11,1,0,1,0
2022-06-29,Bac Ninh,Tien Du,14,1,0,1,0
2022-06-29,Bac Ninh,Tien Du,19,1,0,1,1
2022-06-29,Bac Ninh,Tien Du,20,1,0,1,1
2022-06-29,Bac Ninh,Tien Du,21,1,0,1,1
2022-06-29,Bac Ninh,Tu Son,11,1,0,1,1
2022-06-29,Bac Ninh,Tu Son,12,1,0,1,1
2022-06-29,Bac Ninh,Tu Son,14,1,0,1,1
2022-06-29,Bac Ninh,Tu Son,15,1,0,1,0
2022-06-29,Bac Ninh,Tu Son,17,1,0,1,1
2022-06-29,Bac Ninh,Tu Son,19,2,0,2,2
2022-06-29,Binh Duong,Ben Cat,8,3,0,3,3
2022-06-29,Binh Duong,Ben Cat,9,1,0,1,0
2022-06-29,Binh Duong,Ben Cat,12,4,0,4,3
2022-06-29,Binh Duong,Ben Cat,13,2,0,2,2
2022-06-29,Binh Duong,Ben Cat,14,3,0,3,3
2022-06-29,Binh Duong,Ben Cat,15,4,0,4,3
2022-06-29,Binh Duong,Ben Cat,16,1,0,1,1
2022-06-29,Binh Duong,Ben Cat,17,1,0,1,1
2022-06-29,Binh Duong,Ben Cat,19,1,0,1,1
2022-06-29,Binh Duong,Di An,3,1,0,1,0
2022-06-29,Binh Duong,Di An,6,2,0,2,0
2022-06-29,Binh Duong,Di An,7,6,2,4,3
2022-06-29,Binh Duong,Di An,8,10,8,2,0
2022-06-29,Binh Duong,Di An,9,18,12,6,3
2022-06-29,Binh Duong,Di An,10,28,23,5,3
2022-06-29,Binh Duong,Di An,11,42,29,13,3
2022-06-29,Binh Duong,Di An,12,41,34,7,2
2022-06-29,Binh Duong,Di An,13,35,26,9,3
2022-06-29,Binh Duong,Di An,14,43,27,16,6
2022-06-29,Binh Duong,Di An,15,32,22,10,4
2022-06-29,Binh Duong,Di An,16,22,17,5,2
2022-06-29,Binh Duong,Di An,17,26,17,9,1
2022-06-29,Binh Duong,Di An,18,30,23,7,3
2022-06-29,Binh Duong,Di An,19,30,22,8,2
2022-06-29,Binh Duong,Di An,20,17,15,2,0
2022-06-29,Binh Duong,Di An,21,15,8,7,1
2022-06-29,Binh Duong,Di An,22,1,0,1,0
2022-06-29,Binh Duong,Tan Uyen,8,1,1,0,0
2022-06-29,Binh Duong,Tan Uyen,9,4,1,3,2
2022-06-29,Binh Duong,Tan Uyen,10,7,2,5,4
2022-06-29,Binh Duong,Tan Uyen,11,1,0,1,0
2022-06-29,Binh Duong,Tan Uyen,12,4,4,0,0
2022-06-29,Binh Duong,Tan Uyen,13,3,2,1,1
2022-06-29,Binh Duong,Tan Uyen,16,2,2,0,0
2022-06-29,Binh Duong,Tan Uyen,17,4,3,1,0
2022-06-29,Binh Duong,Tan Uyen,18,4,1,3,1
2022-06-29,Binh Duong,Tan Uyen,19,2,0,2,0
2022-06-29,Binh Duong,Tan Uyen,20,1,1,0,0
2022-06-29,Binh Duong,Thu Dau Mot Town,0,4,3,1,0
2022-06-29,Binh Duong,Thu Dau Mot Town,4,2,1,1,0
2022-06-29,Binh Duong,Thu Dau Mot Town,5,2,1,1,0
2022-06-29,Binh Duong,Thu Dau Mot Town,6,35,28,7,1
2022-06-29,Binh Duong,Thu Dau Mot Town,7,110,102,8,0
2022-06-29,Binh Duong,Thu Dau Mot Town,8,240,223,17,6
2022-06-29,Binh Duong,Thu Dau Mot Town,9,325,298,27,6
2022-06-29,Binh Duong,Thu Dau Mot Town,10,481,451,30,0
2022-06-29,Binh Duong,Thu Dau Mot Town,11,703,662,41,5
2022-06-29,Binh Duong,Thu Dau Mot Town,12,526,495,31,1
2022-06-29,Binh Duong,Thu Dau Mot Town,13,510,467,43,3
2022-06-29,Binh Duong,Thu Dau Mot Town,14,427,387,40,1
2022-06-29,Binh Duong,Thu Dau Mot Town,15,312,293,19,1
2022-06-29,Binh Duong,Thu Dau Mot Town,16,313,297,16,3
2022-06-29,Binh Duong,Thu Dau Mot Town,17,348,319,29,3
2022-06-29,Binh Duong,Thu Dau Mot Town,18,405,383,22,0
2022-06-29,Binh Duong,Thu Dau Mot Town,19,371,346,25,2
2022-06-29,Binh Duong,Thu Dau Mot Town,20,295,261,34,2
2022-06-29,Binh Duong,Thu Dau Mot Town,21,144,124,20,1
2022-06-29,Binh Duong,Thu Dau Mot Town,22,3,0,3,0
2022-06-29,Binh Duong,Thu Dau Mot Town,23,3,1,2,0
2022-06-29,Binh Duong,Thuan An,0,2,1,1,0
2022-06-29,Binh Duong,Thuan An,6,2,1,1,0
2022-06-29,Binh Duong,Thuan An,7,9,3,6,1
2022-06-29,Binh Duong,Thuan An,8,18,13,5,2
2022-06-29,Binh Duong,Thuan An,9,30,26,4,1
2022-06-29,Binh Duong,Thuan An,10,69,62,7,1
2022-06-29,Binh Duong,Thuan An,11,86,72,14,6
2022-06-29,Binh Duong,Thuan An,12,75,70,5,2
2022-06-29,Binh Duong,Thuan An,13,72,63,9,1
2022-06-29,Binh Duong,Thuan An,14,63,53,10,4
2022-06-29,Binh Duong,Thuan An,15,43,33,10,2
2022-06-29,Binh Duong,Thuan An,16,45,36,9,3
2022-06-29,Binh Duong,Thuan An,17,39,36,3,0
2022-06-29,Binh Duong,Thuan An,18,39,34,5,0
2022-06-29,Binh Duong,Thuan An,19,50,40,10,2
2022-06-29,Binh Duong,Thuan An,20,45,30,15,4
2022-06-29,Binh Duong,Thuan An,21,30,20,10,0
2022-06-29,Binh Duong,Thuan An,22,1,1,0,0
2022-06-29,Can Tho City,Binh Thuy District,7,2,1,1,1
2022-06-29,Can Tho City,Binh Thuy District,8,1,1,0,0
2022-06-29,Can Tho City,Binh Thuy District,9,3,3,0,0
2022-06-29,Can Tho City,Binh Thuy District,10,11,10,1,0
2022-06-29,Can Tho City,Binh Thuy District,11,17,16,1,0
2022-06-29,Can Tho City,Binh Thuy District,12,5,5,0,0
2022-06-29,Can Tho City,Binh Thuy District,13,14,14,0,0
2022-06-29,Can Tho City,Binh Thuy District,14,5,5,0,0
2022-06-29,Can Tho City,Binh Thuy District,15,6,6,0,0
2022-06-29,Can Tho City,Binh Thuy District,16,11,11,0,0
2022-06-29,Can Tho City,Binh Thuy District,17,11,11,0,0
2022-06-29,Can Tho City,Binh Thuy District,18,13,12,1,0
2022-06-29,Can Tho City,Binh Thuy District,19,18,17,1,0
2022-06-29,Can Tho City,Binh Thuy District,20,10,6,4,0
2022-06-29,Can Tho City,Binh Thuy District,21,5,5,0,0
2022-06-29,Can Tho City,Cai Rang District,6,1,1,0,0
2022-06-29,Can Tho City,Cai Rang District,7,3,2,1,1
2022-06-29,Can Tho City,Cai Rang District,8,6,5,1,1
2022-06-29,Can Tho City,Cai Rang District,9,4,3,1,0
2022-06-29,Can Tho City,Cai Rang District,10,11,9,2,0
2022-06-29,Can Tho City,Cai Rang District,11,18,15,3,0
2022-06-29,Can Tho City,Cai Rang District,12,12,11,1,0
2022-06-29,Can Tho City,Cai Rang District,13,10,6,4,1
2022-06-29,Can Tho City,Cai Rang District,14,6,6,0,0
2022-06-29,Can Tho City,Cai Rang District,15,13,10,3,0
2022-06-29,Can Tho City,Cai Rang District,16,6,4,2,0
2022-06-29,Can Tho City,Cai Rang District,17,9,8,1,0
2022-06-29,Can Tho City,Cai Rang District,18,19,15,4,0
2022-06-29,Can Tho City,Cai Rang District,19,11,11,0,0
2022-06-29,Can Tho City,Cai Rang District,20,7,7,0,0
2022-06-29,Can Tho City,Cai Rang District,21,1,1,0,0
2022-06-29,Can Tho City,Ninh Kieu District,0,1,1,0,0
2022-06-29,Can Tho City,Ninh Kieu District,1,2,1,1,0
2022-06-29,Can Tho City,Ninh Kieu District,2,2,0,2,0
2022-06-29,Can Tho City,Ninh Kieu District,4,5,3,2,1
2022-06-29,Can Tho City,Ninh Kieu District,5,2,1,1,0
2022-06-29,Can Tho City,Ninh Kieu District,6,48,45,3,0
2022-06-29,Can Tho City,Ninh Kieu District,7,125,117,8,0
2022-06-29,Can Tho City,Ninh Kieu District,8,220,209,11,0
2022-06-29,Can Tho City,Ninh Kieu District,9,303,290,13,0
2022-06-29,Can Tho City,Ninh Kieu District,10,605,576,29,0
2022-06-29,Can Tho City,Ninh Kieu District,11,910,869,41,3
2022-06-29,Can Tho City,Ninh Kieu District,12,638,614,24,0
2022-06-29,Can Tho City,Ninh Kieu District,13,586,555,31,0
2022-06-29,Can Tho City,Ninh Kieu District,14,447,419,28,0
2022-06-29,Can Tho City,Ninh Kieu District,15,369,345,24,0
2022-06-29,Can Tho City,Ninh Kieu District,16,451,433,18,0
2022-06-29,Can Tho City,Ninh Kieu District,17,543,525,18,0
2022-06-29,Can Tho City,Ninh Kieu District,18,527,495,32,0
2022-06-29,Can Tho City,Ninh Kieu District,19,452,433,19,0
2022-06-29,Can Tho City,Ninh Kieu District,20,412,395,17,1
2022-06-29,Can Tho City,Ninh Kieu District,21,199,181,18,0
2022-06-29,Can Tho City,Ninh Kieu District,22,7,3,4,0
2022-06-29,Can Tho City,Ninh Kieu District,23,2,2,0,0
2022-06-29,Dong Nai,Bien Hoa City,2,1,0,1,0
2022-06-29,Dong Nai,Bien Hoa City,4,1,1,0,0
2022-06-29,Dong Nai,Bien Hoa City,5,6,6,0,0
2022-06-29,Dong Nai,Bien Hoa City,6,50,36,14,3
2022-06-29,Dong Nai,Bien Hoa City,7,174,154,20,6
2022-06-29,Dong Nai,Bien Hoa City,8,323,298,25,3
2022-06-29,Dong Nai,Bien Hoa City,9,465,417,48,3
2022-06-29,Dong Nai,Bien Hoa City,10,899,807,92,9
2022-06-29,Dong Nai,Bien Hoa City,11,1224,1116,108,18
2022-06-29,Dong Nai,Bien Hoa City,12,900,843,57,5
2022-06-29,Dong Nai,Bien Hoa City,13,919,862,57,5
2022-06-29,Dong Nai,Bien Hoa City,14,751,675,76,6
2022-06-29,Dong Nai,Bien Hoa City,15,560,516,44,3
2022-06-29,Dong Nai,Bien Hoa City,16,509,468,41,5
2022-06-29,Dong Nai,Bien Hoa City,17,614,571,43,1
2022-06-29,Dong Nai,Bien Hoa City,18,708,649,59,9
2022-06-29,Dong Nai,Bien Hoa City,19,705,646,59,5
2022-06-29,Dong Nai,Bien Hoa City,20,501,447,54,5
2022-06-29,Dong Nai,Bien Hoa City,21,239,179,60,7
2022-06-29,Dong Nai,Bien Hoa City,22,3,0,3,0
2022-06-29,Dong Nai,Bien Hoa City,23,3,2,1,0
2022-06-29,Dong Nai,Long Thanh,10,1,0,1,0
2022-06-29,Dong Nai,Long Thanh,12,2,0,2,1
2022-06-29,Dong Nai,Long Thanh,14,1,0,1,0
2022-06-29,Dong Nai,Long Thanh,16,1,0,1,0
2022-06-29,Dong Nai,Long Thanh,21,1,0,1,0
2022-06-29,Dong Nai,Nhon trach,7,1,0,1,1
2022-06-29,Dong Nai,Nhon trach,8,1,0,1,1
2022-06-29,Dong Nai,Nhon trach,11,3,0,3,2
2022-06-29,Dong Nai,Nhon trach,12,1,0,1,1
2022-06-29,Dong Nai,Nhon trach,14,2,0,2,1
2022-06-29,Dong Nai,Trang Bom,10,2,0,2,2
2022-06-29,Dong Nai,Trang Bom,14,1,0,1,1
2022-06-29,Dong Nai,Trang Bom,15,1,0,1,0
2022-06-29,Dong Nai,Trang Bom,16,1,0,1,1
2022-06-29,Dong Nai,Trang Bom,19,1,0,1,1
2022-06-29,Dong Nai,Trang Bom,20,1,0,1,1
2022-06-29,Dong Nai,Trang Bom,21,3,0,3,1
2022-06-29,Dong Nai,Vinh Cuu,14,1,0,1,0
2022-06-29,Hai Phong City,An Duong,7,2,2,0,0
2022-06-29,Hai Phong City,An Duong,9,1,1,0,0
2022-06-29,Hai Phong City,An Duong,10,6,2,4,2
2022-06-29,Hai Phong City,An Duong,11,10,10,0,0
2022-06-29,Hai Phong City,An Duong,12,5,2,3,0
2022-06-29,Hai Phong City,An Duong,13,4,0,4,1
2022-06-29,Hai Phong City,An Duong,14,6,1,5,3
2022-06-29,Hai Phong City,An Duong,15,5,3,2,1
2022-06-29,Hai Phong City,An Duong,16,2,1,1,0
2022-06-29,Hai Phong City,An Duong,17,3,1,2,1
2022-06-29,Hai Phong City,An Duong,18,3,1,2,2
2022-06-29,Hai Phong City,An Duong,19,3,2,1,1
2022-06-29,Hai Phong City,An Duong,20,6,2,4,2
2022-06-29,Hai Phong City,An Duong,21,3,0,3,2
2022-06-29,Hai Phong City,Do Son District,14,1,0,1,1
2022-06-29,Hai Phong City,Duong Kinh District,10,1,1,0,0
2022-06-29,Hai Phong City,Duong Kinh District,13,1,0,1,1
2022-06-29,Hai Phong City,Duong Kinh District,15,1,0,1,1
2022-06-29,Hai Phong City,Hai An District,7,6,2,4,3
2022-06-29,Hai Phong City,Hai An District,8,13,12,1,0
2022-06-29,Hai Phong City,Hai An District,9,14,12,2,0
2022-06-29,Hai Phong City,Hai An District,10,30,25,5,1
2022-06-29,Hai Phong City,Hai An District,11,45,43,2,1
2022-06-29,Hai Phong City,Hai An District,12,22,20,2,0
2022-06-29,Hai Phong City,Hai An District,13,13,6,7,1
2022-06-29,Hai Phong City,Hai An District,14,13,8,5,0
2022-06-29,Hai Phong City,Hai An District,15,15,11,4,1
2022-06-29,Hai Phong City,Hai An District,16,14,11,3,1
2022-06-29,Hai Phong City,Hai An District,17,27,20,7,3
2022-06-29,Hai Phong City,Hai An District,18,29,19,10,2
2022-06-29,Hai Phong City,Hai An District,19,23,15,8,3
2022-06-29,Hai Phong City,Hai An District,20,8,7,1,0
2022-06-29,Hai Phong City,Hai An District,21,13,6,7,3
2022-06-29,Hai Phong City,Hong Bang District,0,1,1,0,0
2022-06-29,Hai Phong City,Hong Bang District,3,1,1,0,0
2022-06-29,Hai Phong City,Hong Bang District,4,3,3,0,0
2022-06-29,Hai Phong City,Hong Bang District,7,17,15,2,1
2022-06-29,Hai Phong City,Hong Bang District,8,41,30,11,4
2022-06-29,Hai Phong City,Hong Bang District,9,32,31,1,0
2022-06-29,Hai Phong City,Hong Bang District,10,56,53,3,0
2022-06-29,Hai Phong City,Hong Bang District,11,130,107,23,7
2022-06-29,Hai Phong City,Hong Bang District,12,59,51,8,0
2022-06-29,Hai Phong City,Hong Bang District,13,42,35,7,4
2022-06-29,Hai Phong City,Hong Bang District,14,44,24,20,9
2022-06-29,Hai Phong City,Hong Bang District,15,44,32,12,4
2022-06-29,Hai Phong City,Hong Bang District,16,46,44,2,0
2022-06-29,Hai Phong City,Hong Bang District,17,51,48,3,0
2022-06-29,Hai Phong City,Hong Bang District,18,54,45,9,0
2022-06-29,Hai Phong City,Hong Bang District,19,40,36,4,0
2022-06-29,Hai Phong City,Hong Bang District,20,26,22,4,2
2022-06-29,Hai Phong City,Hong Bang District,21,21,10,11,2
2022-06-29,Hai Phong City,Hong Bang District,23,1,1,0,0
2022-06-29,Hai Phong City,Kien An District,7,4,2,2,2
2022-06-29,Hai Phong City,Kien An District,8,4,2,2,0
2022-06-29,Hai Phong City,Kien An District,9,3,3,0,0
2022-06-29,Hai Phong City,Kien An District,10,17,9,8,3
2022-06-29,Hai Phong City,Kien An District,11,21,18,3,0
2022-06-29,Hai Phong City,Kien An District,12,6,4,2,0
2022-06-29,Hai Phong City,Kien An District,13,12,6,6,5
2022-06-29,Hai Phong City,Kien An District,14,10,4,6,4
2022-06-29,Hai Phong City,Kien An District,15,14,9,5,4
2022-06-29,Hai Phong City,Kien An District,16,10,7,3,1
2022-06-29,Hai Phong City,Kien An District,17,10,5,5,1
2022-06-29,Hai Phong City,Kien An District,18,13,9,4,1
2022-06-29,Hai Phong City,Kien An District,19,12,9,3,0
2022-06-29,Hai Phong City,Kien An District,20,9,4,5,3
2022-06-29,Hai Phong City,Kien An District,21,2,0,2,2
2022-06-29,Hai Phong City,Le Chan District,0,2,2,0,0
2022-06-29,Hai Phong City,Le Chan District,6,1,0,1,1
2022-06-29,Hai Phong City,Le Chan District,7,33,26,7,6
2022-06-29,Hai Phong City,Le Chan District,8,76,62,14,1
2022-06-29,Hai Phong City,Le Chan District,9,93,82,11,1
2022-06-29,Hai Phong City,Le Chan District,10,173,152,21,0
2022-06-29,Hai Phong City,Le Chan District,11,319,280,39,4
2022-06-29,Hai Phong City,Le Chan District,12,196,172,24,1
2022-06-29,Hai Phong City,Le Chan District,13,108,87,21,7
2022-06-29,Hai Phong City,Le Chan District,14,115,75,40,12
2022-06-29,Hai Phong City,Le Chan District,15,167,143,24,3
2022-06-29,Hai Phong City,Le Chan District,16,140,126,14,2
2022-06-29,Hai Phong City,Le Chan District,17,162,143,19,3
2022-06-29,Hai Phong City,Le Chan District,18,183,164,19,4
2022-06-29,Hai Phong City,Le Chan District,19,205,183,22,1
2022-06-29,Hai Phong City,Le Chan District,20,163,133,30,5
2022-06-29,Hai Phong City,Le Chan District,21,81,56,25,6
2022-06-29,Hai Phong City,Le Chan District,22,1,0,1,0
2022-06-29,Hai Phong City,Ngo Quyen District,3,1,1,0,0
2022-06-29,Hai Phong City,Ngo Quyen District,6,4,2,2,0
2022-06-29,Hai Phong City,Ngo Quyen District,7,27,20,7,1
2022-06-29,Hai Phong City,Ngo Quyen District,8,86,69,17,3
2022-06-29,Hai Phong City,Ngo Quyen District,9,68,62,6,0
2022-06-29,Hai Phong City,Ngo Quyen District,10,162,144,18,3
2022-06-29,Hai Phong City,Ngo Quyen District,11,319,286,33,6
2022-06-29,Hai Phong City,Ngo Quyen District,12,180,157,23,2
2022-06-29,Hai Phong City,Ngo Quyen District,13,113,94,19,6
2022-06-29,Hai Phong City,Ngo Quyen District,14,122,100,22,5
2022-06-29,Hai Phong City,Ngo Quyen District,15,115,103,12,1
2022-06-29,Hai Phong City,Ngo Quyen District,16,127,116,11,2
2022-06-29,Hai Phong City,Ngo Quyen District,17,136,118,18,3
2022-06-29,Hai Phong City,Ngo Quyen District,18,169,148,21,1
2022-06-29,Hai Phong City,Ngo Quyen District,19,142,129,13,1
2022-06-29,Hai Phong City,Ngo Quyen District,20,111,90,21,2
2022-06-29,Hai Phong City,Ngo Quyen District,21,49,37,12,2
2022-06-29,Hai Phong City,Ngo Quyen District,23,2,2,0,0
2022-06-29,Hai Phong City,Thuy Nguyen,10,4,2,2,2
2022-06-29,Hai Phong City,Thuy Nguyen,12,1,0,1,1
2022-06-29,Hai Phong City,Thuy Nguyen,17,2,1,1,1
2022-06-29,Hai Phong City,Thuy Nguyen,19,1,0,1,1
2022-06-29,Hai Phong City,Thuy Nguyen,20,2,0,2,1
2022-06-29,Hue City,Hue City,0,1,1,0,0
2022-06-29,Hue City,Hue City,1,1,1,0,0
2022-06-29,Hue City,Hue City,3,1,0,1,0
2022-06-29,Hue City,Hue City,5,3,3,0,0
2022-06-29,Hue City,Hue City,6,78,68,10,3
2022-06-29,Hue City,Hue City,7,198,183,15,0
2022-06-29,Hue City,Hue City,8,362,331,31,0
2022-06-29,Hue City,Hue City,9,316,279,37,1
2022-06-29,Hue City,Hue City,10,519,470,49,4
2022-06-29,Hue City,Hue City,11,1009,922,87,3
2022-06-29,Hue City,Hue City,12,636,608,28,0
2022-06-29,Hue City,Hue City,13,385,361,24,0
2022-06-29,Hue City,Hue City,14,414,378,36,0
2022-06-29,Hue City,Hue City,15,399,363,36,1
2022-06-29,Hue City,Hue City,16,438,406,32,1
2022-06-29,Hue City,Hue City,17,497,464,33,0
2022-06-29,Hue City,Hue City,18,556,513,43,0
2022-06-29,Hue City,Hue City,19,649,554,95,14
2022-06-29,Hue City,Hue City,20,451,372,79,8
2022-06-29,Hue City,Hue City,21,319,218,101,29
2022-06-29,Hue City,Hue City,22,1,0,1,0
2022-06-29,Hue City,Huong Thuy,6,1,1,0,0
2022-06-29,Hue City,Huong Thuy,7,3,1,2,1
2022-06-29,Hue City,Huong Thuy,8,1,0,1,0
2022-06-29,Hue City,Huong Thuy,9,1,1,0,0
2022-06-29,Hue City,Huong Thuy,10,2,2,0,0
2022-06-29,Hue City,Huong Thuy,11,1,1,0,0
2022-06-29,Hue City,Huong Thuy,12,4,1,3,1
2022-06-29,Hue City,Huong Thuy,13,2,2,0,0
2022-06-29,Hue City,Huong Thuy,14,2,1,1,0
2022-06-29,Hue City,Huong Thuy,15,2,2,0,0
2022-06-29,Hue City,Huong Thuy,17,1,1,0,0
2022-06-29,Hue City,Huong Thuy,18,1,0,1,0
2022-06-29,Hue City,Huong Thuy,19,7,3,4,1
2022-06-29,Hue City,Huong Thuy,20,4,0,4,1
2022-06-29,Hue City,Huong Thuy,21,4,2,2,1
2022-06-29,Hue City,Huong Thuy,22,1,0,1,0
2022-06-29,Hue City,Huong Tra,15,1,1,0,0
2022-06-29,Hue City,Huong Tra,16,1,1,0,0
2022-06-29,Hue City,Huong Tra,17,1,1,0,0
2022-06-29,Hue City,Huong Tra,18,1,1,0,0
2022-06-29,Hue City,Huong Tra,20,3,2,1,0
2022-06-29,Hue City,Phu Vang,8,3,2,1,0
2022-06-29,Hue City,Phu Vang,9,1,1,0,0
2022-06-29,Hue City,Phu Vang,10,2,1,1,1
2022-06-29,Hue City,Phu Vang,11,6,6,0,0
2022-06-29,Hue City,Phu Vang,12,4,4,0,0
2022-06-29,Hue City,Phu Vang,13,1,1,0,0
2022-06-29,Hue City,Phu Vang,14,2,1,1,0
2022-06-29,Hue City,Phu Vang,16,2,1,1,1
2022-06-29,Hue City,Phu Vang,17,1,1,0,0
2022-06-29,Hue City,Phu Vang,19,4,3,1,0
2022-06-29,Hue City,Phu Vang,20,1,1,0,0
2022-06-29,Hue City,Phu Vang,21,3,0,3,2
2022-06-29,Khanh Hoa,Cam Ranh City,11,1,0,1,1
2022-06-29,Khanh Hoa,Dien Khanh,9,1,0,1,0
2022-06-29,Khanh Hoa,Dien Khanh,10,3,0,3,2
2022-06-29,Khanh Hoa,Dien Khanh,11,2,0,2,2
2022-06-29,Khanh Hoa,Dien Khanh,15,1,0,1,1
2022-06-29,Khanh Hoa,Dien Khanh,20,1,0,1,0
2022-06-29,Khanh Hoa,Nha Trang City,0,1,1,0,0
2022-06-29,Khanh Hoa,Nha Trang City,4,1,0,1,0
2022-06-29,Khanh Hoa,Nha Trang City,5,3,1,2,0
2022-06-29,Khanh Hoa,Nha Trang City,6,42,33,9,1
2022-06-29,Khanh Hoa,Nha Trang City,7,146,129,17,0
2022-06-29,Khanh Hoa,Nha Trang City,8,197,181,16,0
2022-06-29,Khanh Hoa,Nha Trang City,9,212,190,22,0
2022-06-29,Khanh Hoa,Nha Trang City,10,241,220,21,1
2022-06-29,Khanh Hoa,Nha Trang City,11,368,338,30,0
2022-06-29,Khanh Hoa,Nha Trang City,12,283,263,20,0
2022-06-29,Khanh Hoa,Nha Trang City,13,261,239,22,1
2022-06-29,Khanh Hoa,Nha Trang City,14,251,233,18,0
2022-06-29,Khanh Hoa,Nha Trang City,15,188,182,6,0
2022-06-29,Khanh Hoa,Nha Trang City,16,180,166,14,1
2022-06-29,Khanh Hoa,Nha Trang City,17,188,176,12,0
2022-06-29,Khanh Hoa,Nha Trang City,18,272,246,26,0
2022-06-29,Khanh Hoa,Nha Trang City,19,251,216,35,1
2022-06-29,Khanh Hoa,Nha Trang City,20,190,167,23,1
2022-06-29,Khanh Hoa,Nha Trang City,21,112,92,20,5
2022-06-29,Khanh Hoa,Nha Trang City,22,2,1,1,0
2022-06-29,Lam Dong,Da Lat City,6,5,2,3,1
2022-06-29,Lam Dong,Da Lat City,7,57,33,24,16
2022-06-29,Lam Dong,Da Lat City,8,73,61,12,5
2022-06-29,Lam Dong,Da Lat City,9,84,73,11,1
2022-06-29,Lam Dong,Da Lat City,10,91,71,20,3
2022-06-29,Lam Dong,Da Lat City,11,143,122,21,8
2022-06-29,Lam Dong,Da Lat City,12,134,109,25,13
2022-06-29,Lam Dong,Da Lat City,13,97,85,12,3
2022-06-29,Lam Dong,Da Lat City,14,118,94,24,10
2022-06-29,Lam Dong,Da Lat City,15,94,83,11,3
2022-06-29,Lam Dong,Da Lat City,16,72,65,7,2
2022-06-29,Lam Dong,Da Lat City,17,102,87,15,4
2022-06-29,Lam Dong,Da Lat City,18,116,98,18,5
2022-06-29,Lam Dong,Da Lat City,19,125,82,43,26
2022-06-29,Lam Dong,Da Lat City,20,99,59,40,21
2022-06-29,Lam Dong,Da Lat City,21,51,32,19,8
2022-06-29,Nghe An,Hung Nguyen,17,2,0,2,2
2022-06-29,Nghe An,Hung Nguyen,18,1,0,1,1
2022-06-29,Nghe An,Vinh City,0,3,3,0,0
2022-06-29,Nghe An,Vinh City,4,2,1,1,0
2022-06-29,Nghe An,Vinh City,6,7,4,3,0
2022-06-29,Nghe An,Vinh City,7,163,140,23,5
2022-06-29,Nghe An,Vinh City,8,240,210,30,6
2022-06-29,Nghe An,Vinh City,9,185,159,26,3
2022-06-29,Nghe An,Vinh City,10,303,247,56,12
2022-06-29,Nghe An,Vinh City,11,436,368,68,23
2022-06-29,Nghe An,Vinh City,12,244,213,31,1
2022-06-29,Nghe An,Vinh City,13,149,127,22,2
2022-06-29,Nghe An,Vinh City,14,198,154,44,15
2022-06-29,Nghe An,Vinh City,15,175,152,23,2
2022-06-29,Nghe An,Vinh City,16,137,117,20,3
2022-06-29,Nghe An,Vinh City,17,151,130,21,2
2022-06-29,Nghe An,Vinh City,18,193,145,48,21
2022-06-29,Nghe An,Vinh City,19,268,127,141,87
2022-06-29,Nghe An,Vinh City,20,178,126,52,25
2022-06-29,Nghe An,Vinh City,21,93,61,32,10
2022-06-29,Nghe An,Vinh City,22,1,0,1,0
2022-06-29,Nghe An,Vinh City,23,1,1,0,0
2022-06-29,Quang Nam,Dien Ban,12,1,0,1,1
2022-06-29,Quang Nam,Dien Ban,13,1,0,1,1
2022-06-29,Quang Nam,Dien Ban,15,2,0,2,1
2022-06-29,Quang Nam,Hoi An City,1,1,1,0,0
2022-06-29,Quang Nam,Hoi An City,7,16,12,4,2
2022-06-29,Quang Nam,Hoi An City,8,32,26,6,2
2022-06-29,Quang Nam,Hoi An City,9,30,28,2,0
2022-06-29,Quang Nam,Hoi An City,10,36,27,9,0
2022-06-29,Quang Nam,Hoi An City,11,56,45,11,3
2022-06-29,Quang Nam,Hoi An City,12,47,35,12,1
2022-06-29,Quang Nam,Hoi An City,13,44,36,8,1
2022-06-29,Quang Nam,Hoi An City,14,36,32,4,0
2022-06-29,Quang Nam,Hoi An City,15,32,23,9,0
2022-06-29,Quang Nam,Hoi An City,16,39,33,6,0
2022-06-29,Quang Nam,Hoi An City,17,39,33,6,0
2022-06-29,Quang Nam,Hoi An City,18,48,33,15,3
2022-06-29,Quang Nam,Hoi An City,19,54,43,11,1
2022-06-29,Quang Nam,Hoi An City,20,60,28,32,15
2022-06-29,Quang Nam,Hoi An City,21,23,6,17,8
2022-06-29,Quang Nam,Tam Ky City,10,3,0,3,2
2022-06-29,Quang Nam,Tam Ky City,16,2,0,2,2
2022-06-29,Quang Ninh,Cam Pha City,10,1,0,1,1
2022-06-29,Quang Ninh,Cam Pha City,11,4,0,4,1
2022-06-29,Quang Ninh,Cam Pha City,19,5,0,5,2
2022-06-29,Quang Ninh,Ha Long City,2,1,1,0,0
2022-06-29,Quang Ninh,Ha Long City,7,25,18,7,2
2022-06-29,Quang Ninh,Ha Long City,8,37,25,12,2
2022-06-29,Quang Ninh,Ha Long City,9,50,37,13,4
2022-06-29,Quang Ninh,Ha Long City,10,67,45,22,5
2022-06-29,Quang Ninh,Ha Long City,11,144,117,27,6
2022-06-29,Quang Ninh,Ha Long City,12,101,79,22,9
2022-06-29,Quang Ninh,Ha Long City,13,74,55,19,12
2022-06-29,Quang Ninh,Ha Long City,14,59,40,19,10
2022-06-29,Quang Ninh,Ha Long City,15,56,41,15,4
2022-06-29,Quang Ninh,Ha Long City,16,51,34,17,5
2022-06-29,Quang Ninh,Ha Long City,17,44,25,19,4
2022-06-29,Quang Ninh,Ha Long City,18,80,51,29,6
2022-06-29,Quang Ninh,Ha Long City,19,49,31,18,5
2022-06-29,Quang Ninh,Ha Long City,20,43,30,13,3
2022-06-29,Quang Ninh,Ha Long City,22,2,2,0,0
2022-06-29,Thai Nguyen,Dong Hy,9,1,1,0,0
2022-06-29,Thai Nguyen,Dong Hy,11,3,1,2,1
2022-06-29,Thai Nguyen,Dong Hy,16,1,1,0,0
2022-06-29,Thai Nguyen,Dong Hy,18,1,1,0,0
2022-06-29,Thai Nguyen,Dong Hy,21,1,0,1,0
2022-06-29,Thai Nguyen,Thai Nguyen City,0,7,5,2,0
2022-06-29,Thai Nguyen,Thai Nguyen City,1,2,2,0,0
2022-06-29,Thai Nguyen,Thai Nguyen City,2,1,0,1,0
2022-06-29,Thai Nguyen,Thai Nguyen City,6,7,4,3,0
2022-06-29,Thai Nguyen,Thai Nguyen City,7,82,77,5,1
2022-06-29,Thai Nguyen,Thai Nguyen City,8,128,118,10,0
2022-06-29,Thai Nguyen,Thai Nguyen City,9,114,107,7,0
2022-06-29,Thai Nguyen,Thai Nguyen City,10,171,152,19,0
2022-06-29,Thai Nguyen,Thai Nguyen City,11,382,353,29,2
2022-06-29,Thai Nguyen,Thai Nguyen City,12,276,257,19,0
2022-06-29,Thai Nguyen,Thai Nguyen City,13,193,174,19,0
2022-06-29,Thai Nguyen,Thai Nguyen City,14,162,151,11,1
2022-06-29,Thai Nguyen,Thai Nguyen City,15,158,141,17,2
2022-06-29,Thai Nguyen,Thai Nguyen City,16,118,109,9,0
2022-06-29,Thai Nguyen,Thai Nguyen City,17,129,117,12,2
2022-06-29,Thai Nguyen,Thai Nguyen City,18,184,167,17,2
2022-06-29,Thai Nguyen,Thai Nguyen City,19,211,198,13,0
2022-06-29,Thai Nguyen,Thai Nguyen City,20,187,168,19,0
2022-06-29,Thai Nguyen,Thai Nguyen City,21,161,132,29,4
2022-06-29,Thai Nguyen,Thai Nguyen City,22,2,0,2,0
2022-06-29,Vung Tau,Ba Ria City,0,1,0,1,1
2022-06-29,Vung Tau,Ba Ria City,7,1,0,1,1
2022-06-29,Vung Tau,Ba Ria City,8,2,0,2,2
2022-06-29,Vung Tau,Ba Ria City,9,7,2,5,1
2022-06-29,Vung Tau,Ba Ria City,10,9,6,3,3
2022-06-29,Vung Tau,Ba Ria City,11,7,5,2,1
2022-06-29,Vung Tau,Ba Ria City,12,3,2,1,1
2022-06-29,Vung Tau,Ba Ria City,13,18,6,12,2
2022-06-29,Vung Tau,Ba Ria City,14,7,2,5,3
2022-06-29,Vung Tau,Ba Ria City,15,2,2,0,0
2022-06-29,Vung Tau,Ba Ria City,16,16,7,9,6
2022-06-29,Vung Tau,Ba Ria City,18,3,1,2,1
2022-06-29,Vung Tau,Ba Ria City,19,5,1,4,4
2022-06-29,Vung Tau,Ba Ria City,20,3,0,3,3
2022-06-29,Vung Tau,Ba Ria City,21,7,0,7,5
2022-06-29,Vung Tau,Chau Duc,8,3,0,3,0
2022-06-29,Vung Tau,Chau Duc,14,1,0,1,1
2022-06-29,Vung Tau,Vung Tau City,2,1,1,0,0
2022-06-29,Vung Tau,Vung Tau City,4,1,1,0,0
2022-06-29,Vung Tau,Vung Tau City,5,2,1,1,0
2022-06-29,Vung Tau,Vung Tau City,6,39,34,5,0
2022-06-29,Vung Tau,Vung Tau City,7,133,117,16,0
2022-06-29,Vung Tau,Vung Tau City,8,192,181,11,0
2022-06-29,Vung Tau,Vung Tau City,9,197,183,14,3
2022-06-29,Vung Tau,Vung Tau City,10,243,228,15,2
2022-06-29,Vung Tau,Vung Tau City,11,418,387,31,1
2022-06-29,Vung Tau,Vung Tau City,12,318,292,26,0
2022-06-29,Vung Tau,Vung Tau City,13,251,237,14,0
2022-06-29,Vung Tau,Vung Tau City,14,277,264,13,1
2022-06-29,Vung Tau,Vung Tau City,15,188,181,7,0
2022-06-29,Vung Tau,Vung Tau City,16,214,195,19,1
2022-06-29,Vung Tau,Vung Tau City,17,274,252,22,0
2022-06-29,Vung Tau,Vung Tau City,18,309,290,19,3
2022-06-29,Vung Tau,Vung Tau City,19,306,279,27,3
2022-06-29,Vung Tau,Vung Tau City,20,210,177,33,5
2022-06-29,Vung Tau,Vung Tau City,21,128,103,25,2
2022-06-29,Vung Tau,Vung Tau City,23,2,2,0,0
2022-06-30,Bac Ninh,Bác Ninh City,2,1,0,1,0
2022-06-30,Bac Ninh,Bác Ninh City,3,1,0,1,0
2022-06-30,Bac Ninh,Bác Ninh City,6,2,1,1,0
2022-06-30,Bac Ninh,Bác Ninh City,7,58,54,4,1
2022-06-30,Bac Ninh,Bác Ninh City,8,109,102,7,0
2022-06-30,Bac Ninh,Bác Ninh City,9,119,109,10,1
2022-06-30,Bac Ninh,Bác Ninh City,10,174,164,10,0
2022-06-30,Bac Ninh,Bác Ninh City,11,348,323,25,0
2022-06-30,Bac Ninh,Bác Ninh City,12,224,210,14,1
2022-06-30,Bac Ninh,Bác Ninh City,13,141,127,14,4
2022-06-30,Bac Ninh,Bác Ninh City,14,159,142,17,0
2022-06-30,Bac Ninh,Bác Ninh City,15,133,117,16,2
2022-06-30,Bac Ninh,Bác Ninh City,16,106,95,11,0
2022-06-30,Bac Ninh,Bác Ninh City,17,126,109,17,0
2022-06-30,Bac Ninh,Bác Ninh City,18,155,151,4,0
2022-06-30,Bac Ninh,Bác Ninh City,19,217,191,26,2
2022-06-30,Bac Ninh,Bác Ninh City,20,147,123,24,1
2022-06-30,Bac Ninh,Bác Ninh City,21,87,71,16,0
2022-06-30,Bac Ninh,Bác Ninh City,22,1,0,1,0
2022-06-30,Bac Ninh,Que Vo,11,1,0,1,1
2022-06-30,Bac Ninh,Que Vo,12,1,0,1,0
2022-06-30,Bac Ninh,Que Vo,13,1,0,1,1
2022-06-30,Bac Ninh,Que Vo,14,1,0,1,1
2022-06-30,Bac Ninh,Que Vo,16,2,1,1,1
2022-06-30,Bac Ninh,Que Vo,17,1,1,0,0
2022-06-30,Bac Ninh,Que Vo,19,1,1,0,0
2022-06-30,Bac Ninh,Tien Du,8,2,0,2,2
2022-06-30,Bac Ninh,Tien Du,10,1,1,0,0
2022-06-30,Bac Ninh,Tien Du,13,1,0,1,1
2022-06-30,Bac Ninh,Tien Du,14,2,0,2,2
2022-06-30,Bac Ninh,Tien Du,15,3,0,3,3
2022-06-30,Bac Ninh,Tien Du,16,2,0,2,1
2022-06-30,Bac Ninh,Tien Du,17,1,0,1,1
2022-06-30,Bac Ninh,Tu Son,8,1,0,1,0
2022-06-30,Bac Ninh,Tu Son,10,2,0,2,0
2022-06-30,Bac Ninh,Tu Son,11,3,0,3,3
2022-06-30,Bac Ninh,Tu Son,12,2,0,2,2
2022-06-30,Bac Ninh,Tu Son,17,1,0,1,0
2022-06-30,Bac Ninh,Yen Phong,12,1,0,1,0
2022-06-30,Binh Duong,Ben Cat,8,2,0,2,1
2022-06-30,Binh Duong,Ben Cat,9,1,0,1,1
2022-06-30,Binh Duong,Ben Cat,10,2,0,2,2
2022-06-30,Binh Duong,Ben Cat,11,1,0,1,1
2022-06-30,Binh Duong,Ben Cat,12,2,0,2,2
2022-06-30,Binh Duong,Ben Cat,13,3,0,3,2
2022-06-30,Binh Duong,Ben Cat,14,3,0,3,2
2022-06-30,Binh Duong,Ben Cat,15,2,0,2,2
2022-06-30,Binh Duong,Ben Cat,18,2,0,2,1
2022-06-30,Binh Duong,Ben Cat,20,1,0,1,1
2022-06-30,Binh Duong,Di An,4,1,0,1,0
2022-06-30,Binh Duong,Di An,5,2,0,2,1
2022-06-30,Binh Duong,Di An,6,2,1,1,1
2022-06-30,Binh Duong,Di An,7,9,4,5,2
2022-06-30,Binh Duong,Di An,8,19,13,6,2
2022-06-30,Binh Duong,Di An,9,26,17,9,2
2022-06-30,Binh Duong,Di An,10,43,26,17,5
2022-06-30,Binh Duong,Di An,11,47,36,11,2
2022-06-30,Binh Duong,Di An,12,42,39,3,1
2022-06-30,Binh Duong,Di An,13,34,27,7,1
2022-06-30,Binh Duong,Di An,14,33,27,6,4
2022-06-30,Binh Duong,Di An,15,30,23,7,2
2022-06-30,Binh Duong,Di An,16,36,29,7,3
2022-06-30,Binh Duong,Di An,17,32,19,13,5
2022-06-30,Binh Duong,Di An,18,33,25,8,1
2022-06-30,Binh Duong,Di An,19,48,33,15,4
2022-06-30,Binh Duong,Di An,20,16,9,7,4
2022-06-30,Binh Duong,Di An,21,11,6,5,3
2022-06-30,Binh Duong,Tan Uyen,10,1,0,1,0
2022-06-30,Binh Duong,Tan Uyen,11,2,0,2,0
2022-06-30,Binh Duong,Tan Uyen,12,3,2,1,1
2022-06-30,Binh Duong,Tan Uyen,13,2,2,0,0
2022-06-30,Binh Duong,Tan Uyen,14,1,1,0,0
2022-06-30,Binh Duong,Tan Uyen,15,5,1,4,3
2022-06-30,Binh Duong,Tan Uyen,16,1,1,0,0
2022-06-30,Binh Duong,Tan Uyen,17,2,2,0,0
2022-06-30,Binh Duong,Tan Uyen,18,2,2,0,0
2022-06-30,Binh Duong,Tan Uyen,20,4,0,4,0
2022-06-30,Binh Duong,Tan Uyen,21,3,1,2,1
2022-06-30,Binh Duong,Thu Dau Mot Town,0,5,2,3,0
2022-06-30,Binh Duong,Thu Dau Mot Town,2,1,0,1,0
2022-06-30,Binh Duong,Thu Dau Mot Town,4,2,0,2,0
2022-06-30,Binh Duong,Thu Dau Mot Town,5,2,0,2,1
2022-06-30,Binh Duong,Thu Dau Mot Town,6,41,31,10,3
2022-06-30,Binh Duong,Thu Dau Mot Town,7,109,105,4,0
2022-06-30,Binh Duong,Thu Dau Mot Town,8,255,236,19,2
2022-06-30,Binh Duong,Thu Dau Mot Town,9,294,270,24,1
2022-06-30,Binh Duong,Thu Dau Mot Town,10,435,415,20,1
2022-06-30,Binh Duong,Thu Dau Mot Town,11,703,659,44,3
2022-06-30,Binh Duong,Thu Dau Mot Town,12,489,455,34,3
2022-06-30,Binh Duong,Thu Dau Mot Town,13,470,447,23,3
2022-06-30,Binh Duong,Thu Dau Mot Town,14,421,389,32,5
2022-06-30,Binh Duong,Thu Dau Mot Town,15,328,303,25,2
2022-06-30,Binh Duong,Thu Dau Mot Town,16,354,324,30,2
2022-06-30,Binh Duong,Thu Dau Mot Town,17,398,374,24,2
2022-06-30,Binh Duong,Thu Dau Mot Town,18,389,364,25,1
2022-06-30,Binh Duong,Thu Dau Mot Town,19,390,351,39,6
2022-06-30,Binh Duong,Thu Dau Mot Town,20,257,228,29,6
2022-06-30,Binh Duong,Thu Dau Mot Town,21,136,116,20,4
2022-06-30,Binh Duong,Thu Dau Mot Town,22,1,0,1,0
2022-06-30,Binh Duong,Thuan An,6,4,0,4,0
2022-06-30,Binh Duong,Thuan An,7,16,9,7,0
2022-06-30,Binh Duong,Thuan An,8,19,11,8,1
2022-06-30,Binh Duong,Thuan An,9,32,31,1,0
2022-06-30,Binh Duong,Thuan An,10,71,57,14,3
2022-06-30,Binh Duong,Thuan An,11,89,79,10,2
2022-06-30,Binh Duong,Thuan An,12,82,66,16,3
2022-06-30,Binh Duong,Thuan An,13,99,71,28,9
2022-06-30,Binh Duong,Thuan An,14,85,62,23,4
2022-06-30,Binh Duong,Thuan An,15,59,49,10,2
2022-06-30,Binh Duong,Thuan An,16,44,36,8,1
2022-06-30,Binh Duong,Thuan An,17,55,41,14,0
2022-06-30,Binh Duong,Thuan An,18,48,40,8,0
2022-06-30,Binh Duong,Thuan An,19,53,43,10,1
2022-06-30,Binh Duong,Thuan An,20,41,29,12,5
2022-06-30,Binh Duong,Thuan An,21,20,9,11,4
2022-06-30,Can Tho City,Binh Thuy District,7,3,2,1,0
2022-06-30,Can Tho City,Binh Thuy District,8,6,6,0,0
2022-06-30,Can Tho City,Binh Thuy District,9,9,9,0,0
2022-06-30,Can Tho City,Binh Thuy District,10,12,11,1,1
2022-06-30,Can Tho City,Binh Thuy District,11,14,13,1,0
2022-06-30,Can Tho City,Binh Thuy District,12,16,14,2,1
2022-06-30,Can Tho City,Binh Thuy District,13,6,6,0,0
2022-06-30,Can Tho City,Binh Thuy District,14,5,5,0,0
2022-06-30,Can Tho City,Binh Thuy District,15,17,15,2,0
2022-06-30,Can Tho City,Binh Thuy District,16,15,12,3,0
2022-06-30,Can Tho City,Binh Thuy District,17,16,14,2,0
2022-06-30,Can Tho City,Binh Thuy District,18,14,13,1,0
2022-06-30,Can Tho City,Binh Thuy District,19,11,11,0,0
2022-06-30,Can Tho City,Binh Thuy District,20,10,9,1,0
2022-06-30,Can Tho City,Binh Thuy District,21,4,3,1,0
2022-06-30,Can Tho City,Cai Rang District,7,3,2,1,0
2022-06-30,Can Tho City,Cai Rang District,8,8,8,0,0
2022-06-30,Can Tho City,Cai Rang District,9,10,9,1,0
2022-06-30,Can Tho City,Cai Rang District,10,14,14,0,0
2022-06-30,Can Tho City,Cai Rang District,11,8,8,0,0
2022-06-30,Can Tho City,Cai Rang District,12,13,13,0,0
2022-06-30,Can Tho City,Cai Rang District,13,5,5,0,0
2022-06-30,Can Tho City,Cai Rang District,14,3,3,0,0
2022-06-30,Can Tho City,Cai Rang District,15,12,12,0,0
2022-06-30,Can Tho City,Cai Rang District,16,12,12,0,0
2022-06-30,Can Tho City,Cai Rang District,17,24,23,1,0
2022-06-30,Can Tho City,Cai Rang District,18,15,12,3,0
2022-06-30,Can Tho City,Cai Rang District,19,13,12,1,0
2022-06-30,Can Tho City,Cai Rang District,20,7,7,0,0
2022-06-30,Can Tho City,Cai Rang District,21,4,4,0,0
2022-06-30,Can Tho City,Ninh Kieu District,0,2,2,0,0
2022-06-30,Can Tho City,Ninh Kieu District,1,3,3,0,0
2022-06-30,Can Tho City,Ninh Kieu District,4,2,2,0,0
2022-06-30,Can Tho City,Ninh Kieu District,6,52,48,4,1
2022-06-30,Can Tho City,Ninh Kieu District,7,162,152,10,0
2022-06-30,Can Tho City,Ninh Kieu District,8,235,228,7,0
2022-06-30,Can Tho City,Ninh Kieu District,9,340,319,21,0
2022-06-30,Can Tho City,Ninh Kieu District,10,513,496,17,0
2022-06-30,Can Tho City,Ninh Kieu District,11,854,816,38,1
2022-06-30,Can Tho City,Ninh Kieu District,12,625,600,25,0
2022-06-30,Can Tho City,Ninh Kieu District,13,477,458,19,0
2022-06-30,Can Tho City,Ninh Kieu District,14,386,371,15,0
2022-06-30,Can Tho City,Ninh Kieu District,15,362,333,29,0
2022-06-30,Can Tho City,Ninh Kieu District,16,455,420,35,0
2022-06-30,Can Tho City,Ninh Kieu District,17,700,661,39,0
2022-06-30,Can Tho City,Ninh Kieu District,18,644,610,34,0
2022-06-30,Can Tho City,Ninh Kieu District,19,583,556,27,0
2022-06-30,Can Tho City,Ninh Kieu District,20,411,382,29,0
2022-06-30,Can Tho City,Ninh Kieu District,21,253,228,25,2
2022-06-30,Can Tho City,Ninh Kieu District,22,1,0,1,0
2022-06-30,Can Tho City,Phong Dien,17,2,0,2,2
2022-06-30,Can Tho City,Phong Dien,18,3,0,3,1
2022-06-30,Dong Nai,Bien Hoa City,0,3,0,3,0
2022-06-30,Dong Nai,Bien Hoa City,5,1,0,1,1
2022-06-30,Dong Nai,Bien Hoa City,6,37,29,8,1
2022-06-30,Dong Nai,Bien Hoa City,7,161,136,25,6
2022-06-30,Dong Nai,Bien Hoa City,8,280,251,29,1
2022-06-30,Dong Nai,Bien Hoa City,9,434,405,29,1
2022-06-30,Dong Nai,Bien Hoa City,10,813,749,64,2
2022-06-30,Dong Nai,Bien Hoa City,11,1178,1077,101,18
2022-06-30,Dong Nai,Bien Hoa City,12,925,866,59,3
2022-06-30,Dong Nai,Bien Hoa City,13,915,870,45,2
2022-06-30,Dong Nai,Bien Hoa City,14,730,674,56,2
2022-06-30,Dong Nai,Bien Hoa City,15,574,520,54,3
2022-06-30,Dong Nai,Bien Hoa City,16,500,456,44,2
2022-06-30,Dong Nai,Bien Hoa City,17,615,570,45,2
2022-06-30,Dong Nai,Bien Hoa City,18,691,647,44,0
2022-06-30,Dong Nai,Bien Hoa City,19,754,669,85,3
2022-06-30,Dong Nai,Bien Hoa City,20,499,432,67,10
2022-06-30,Dong Nai,Bien Hoa City,21,265,202,63,25
2022-06-30,Dong Nai,Bien Hoa City,22,3,0,3,0
2022-06-30,Dong Nai,Long Khanh,11,2,0,2,2
2022-06-30,Dong Nai,Long Khanh,14,2,0,2,2
2022-06-30,Dong Nai,Long Khanh,17,1,0,1,0
2022-06-30,Dong Nai,Long Khanh,20,1,0,1,1
2022-06-30,Dong Nai,Long Thanh,9,1,0,1,0
2022-06-30,Dong Nai,Long Thanh,10,4,0,4,1
2022-06-30,Dong Nai,Long Thanh,11,4,0,4,4
2022-06-30,Dong Nai,Long Thanh,12,2,0,2,2
2022-06-30,Dong Nai,Long Thanh,13,1,0,1,1
2022-06-30,Dong Nai,Long Thanh,14,1,0,1,1
2022-06-30,Dong Nai,Long Thanh,17,3,0,3,2
2022-06-30,Dong Nai,Long Thanh,18,1,0,1,0
2022-06-30,Dong Nai,Long Thanh,20,1,0,1,1
2022-06-30,Dong Nai,Nhon trach,15,1,0,1,0
2022-06-30,Dong Nai,Nhon trach,19,2,0,2,1
2022-06-30,Dong Nai,Trang Bom,10,2,0,2,2
2022-06-30,Dong Nai,Trang Bom,11,2,0,2,1
2022-06-30,Dong Nai,Trang Bom,12,3,0,3,2
2022-06-30,Dong Nai,Trang Bom,13,4,1,3,2
2022-06-30,Dong Nai,Trang Bom,19,1,1,0,0
2022-06-30,Dong Nai,Trang Bom,21,1,0,1,1
2022-06-30,Dong Nai,Vinh Cuu,12,1,0,1,0
2022-06-30,Dong Nai,Vinh Cuu,13,1,1,0,0
2022-06-30,Dong Nai,Vinh Cuu,14,1,0,1,0
2022-06-30,Dong Nai,Vinh Cuu,21,1,0,1,1
2022-06-30,Hai Phong City,An Duong,7,1,0,1,0
2022-06-30,Hai Phong City,An Duong,8,2,0,2,0
2022-06-30,Hai Phong City,An Duong,9,5,2,3,2
2022-06-30,Hai Phong City,An Duong,10,5,3,2,2
2022-06-30,Hai Phong City,An Duong,11,2,1,1,1
2022-06-30,Hai Phong City,An Duong,12,5,3,2,2
2022-06-30,Hai Phong City,An Duong,13,6,0,6,4
2022-06-30,Hai Phong City,An Duong,14,5,1,4,2
2022-06-30,Hai Phong City,An Duong,15,3,1,2,1
2022-06-30,Hai Phong City,An Duong,16,6,2,4,1
2022-06-30,Hai Phong City,An Duong,17,4,1,3,0
2022-06-30,Hai Phong City,An Duong,18,1,1,0,0
2022-06-30,Hai Phong City,An Duong,19,1,0,1,0
2022-06-30,Hai Phong City,An Duong,20,4,2,2,0
2022-06-30,Hai Phong City,An Duong,21,2,1,1,1
2022-06-30,Hai Phong City,Do Son District,14,1,0,1,0
2022-06-30,Hai Phong City,Do Son District,19,2,0,2,1
2022-06-30,Hai Phong City,Duong Kinh District,12,1,0,1,1
2022-06-30,Hai Phong City,Duong Kinh District,19,1,0,1,1
2022-06-30,Hai Phong City,Hai An District,0,1,1,0,0
2022-06-30,Hai Phong City,Hai An District,6,3,1,2,1
2022-06-30,Hai Phong City,Hai An District,7,4,1,3,0
2022-06-30,Hai Phong City,Hai An District,8,20,15,5,2
2022-06-30,Hai Phong City,Hai An District,9,12,11,1,1
2022-06-30,Hai Phong City,Hai An District,10,19,16,3,1
2022-06-30,Hai Phong City,Hai An District,11,56,50,6,2
2022-06-30,Hai Phong City,Hai An District,12,23,19,4,0
2022-06-30,Hai Phong City,Hai An District,13,21,16,5,2
2022-06-30,Hai Phong City,Hai An District,14,26,20,6,0
2022-06-30,Hai Phong City,Hai An District,15,20,19,1,0
2022-06-30,Hai Phong City,Hai An District,16,33,28,5,0
2022-06-30,Hai Phong City,Hai An District,17,18,13,5,1
2022-06-30,Hai Phong City,Hai An District,18,19,14,5,0
2022-06-30,Hai Phong City,Hai An District,19,27,21,6,2
2022-06-30,Hai Phong City,Hai An District,20,20,16,4,1
2022-06-30,Hai Phong City,Hai An District,21,8,6,2,0
2022-06-30,Hai Phong City,Hong Bang District,6,2,0,2,1
2022-06-30,Hai Phong City,Hong Bang District,7,19,11,8,3
2022-06-30,Hai Phong City,Hong Bang District,8,27,23,4,1
2022-06-30,Hai Phong City,Hong Bang District,9,43,40,3,0
2022-06-30,Hai Phong City,Hong Bang District,10,63,53,10,1
2022-06-30,Hai Phong City,Hong Bang District,11,97,90,7,0
2022-06-30,Hai Phong City,Hong Bang District,12,62,58,4,0
2022-06-30,Hai Phong City,Hong Bang District,13,63,58,5,1
2022-06-30,Hai Phong City,Hong Bang District,14,56,45,11,0
2022-06-30,Hai Phong City,Hong Bang District,15,38,36,2,0
2022-06-30,Hai Phong City,Hong Bang District,16,31,27,4,0
2022-06-30,Hai Phong City,Hong Bang District,17,32,29,3,0
2022-06-30,Hai Phong City,Hong Bang District,18,45,43,2,0
2022-06-30,Hai Phong City,Hong Bang District,19,65,51,14,1
2022-06-30,Hai Phong City,Hong Bang District,20,50,37,13,6
2022-06-30,Hai Phong City,Hong Bang District,21,27,15,12,7
2022-06-30,Hai Phong City,Kien An District,7,6,2,4,1
2022-06-30,Hai Phong City,Kien An District,8,7,3,4,4
2022-06-30,Hai Phong City,Kien An District,9,11,8,3,1
2022-06-30,Hai Phong City,Kien An District,10,13,13,0,0
2022-06-30,Hai Phong City,Kien An District,11,17,12,5,0
2022-06-30,Hai Phong City,Kien An District,12,6,4,2,0
2022-06-30,Hai Phong City,Kien An District,13,12,7,5,2
2022-06-30,Hai Phong City,Kien An District,14,13,7,6,1
2022-06-30,Hai Phong City,Kien An District,15,13,5,8,1
2022-06-30,Hai Phong City,Kien An District,16,19,12,7,1
2022-06-30,Hai Phong City,Kien An District,17,11,9,2,0
2022-06-30,Hai Phong City,Kien An District,18,9,8,1,1
2022-06-30,Hai Phong City,Kien An District,19,11,6,5,2
2022-06-30,Hai Phong City,Kien An District,20,13,7,6,2
2022-06-30,Hai Phong City,Kien An District,21,4,2,2,2
2022-06-30,Hai Phong City,Le Chan District,1,1,1,0,0
2022-06-30,Hai Phong City,Le Chan District,6,6,5,1,0
2022-06-30,Hai Phong City,Le Chan District,7,36,22,14,4
2022-06-30,Hai Phong City,Le Chan District,8,79,70,9,1
2022-06-30,Hai Phong City,Le Chan District,9,69,62,7,0
2022-06-30,Hai Phong City,Le Chan District,10,174,159,15,2
2022-06-30,Hai Phong City,Le Chan District,11,305,278,27,5
2022-06-30,Hai Phong City,Le Chan District,12,176,163,13,3
2022-06-30,Hai Phong City,Le Chan District,13,141,123,18,3
2022-06-30,Hai Phong City,Le Chan District,14,136,115,21,2
2022-06-30,Hai Phong City,Le Chan District,15,159,141,18,1
2022-06-30,Hai Phong City,Le Chan District,16,162,136,26,0
2022-06-30,Hai Phong City,Le Chan District,17,151,135,16,0
2022-06-30,Hai Phong City,Le Chan District,18,204,176,28,0
2022-06-30,Hai Phong City,Le Chan District,19,218,181,37,8
2022-06-30,Hai Phong City,Le Chan District,20,146,123,23,7
2022-06-30,Hai Phong City,Le Chan District,21,84,69,15,3
2022-06-30,Hai Phong City,Le Chan District,22,1,0,1,0
2022-06-30,Hai Phong City,Ngo Quyen District,7,25,18,7,3
2022-06-30,Hai Phong City,Ngo Quyen District,8,69,61,8,3
2022-06-30,Hai Phong City,Ngo Quyen District,9,90,82,8,0
2022-06-30,Hai Phong City,Ngo Quyen District,10,128,116,12,2
2022-06-30,Hai Phong City,Ngo Quyen District,11,246,235,11,0
2022-06-30,Hai Phong City,Ngo Quyen District,12,179,158,21,2
2022-06-30,Hai Phong City,Ngo Quyen District,13,108,93,15,4
2022-06-30,Hai Phong City,Ngo Quyen District,14,137,119,18,0
2022-06-30,Hai Phong City,Ngo Quyen District,15,175,149,26,1
2022-06-30,Hai Phong City,Ngo Quyen District,16,136,112,24,1
2022-06-30,Hai Phong City,Ngo Quyen District,17,120,110,10,2
2022-06-30,Hai Phong City,Ngo Quyen District,18,160,134,26,2
2022-06-30,Hai Phong City,Ngo Quyen District,19,170,141,29,2
2022-06-30,Hai Phong City,Ngo Quyen District,20,129,108,21,9
2022-06-30,Hai Phong City,Ngo Quyen District,21,68,52,16,7
2022-06-30,Hai Phong City,Thuy Nguyen,10,1,0,1,1
2022-06-30,Hai Phong City,Thuy Nguyen,11,1,1,0,0
2022-06-30,Hai Phong City,Thuy Nguyen,14,1,0,1,1
2022-06-30,Hai Phong City,Thuy Nguyen,15,4,1,3,3
2022-06-30,Hai Phong City,Thuy Nguyen,18,1,0,1,0
2022-06-30,Hue City,Hue City,0,1,1,0,0
2022-06-30,Hue City,Hue City,5,2,2,0,0
2022-06-30,Hue City,Hue City,6,64,59,5,0
2022-06-30,Hue City,Hue City,7,185,164,21,3
2022-06-30,Hue City,Hue City,8,335,306,29,1
2022-06-30,Hue City,Hue City,9,345,302,43,3
2022-06-30,Hue City,Hue City,10,462,418,44,0
2022-06-30,Hue City,Hue City,11,989,906,83,4
2022-06-30,Hue City,Hue City,12,592,543,49,2
2022-06-30,Hue City,Hue City,13,396,361,35,0
2022-06-30,Hue City,Hue City,14,412,382,30,3
2022-06-30,Hue City,Hue City,15,445,405,40,0
2022-06-30,Hue City,Hue City,16,398,357,41,1
2022-06-30,Hue City,Hue City,17,493,455,38,0
2022-06-30,Hue City,Hue City,18,549,497,52,0
2022-06-30,Hue City,Hue City,19,571,470,101,20
2022-06-30,Hue City,Hue City,20,469,351,118,55
2022-06-30,Hue City,Hue City,21,341,200,141,80
2022-06-30,Hue City,Hue City,22,1,0,1,0
2022-06-30,Hue City,Huong Thuy,7,1,0,1,0
2022-06-30,Hue City,Huong Thuy,8,1,1,0,0
2022-06-30,Hue City,Huong Thuy,9,2,1,1,1
2022-06-30,Hue City,Huong Thuy,10,1,1,0,0
2022-06-30,Hue City,Huong Thuy,11,2,1,1,0
2022-06-30,Hue City,Huong Thuy,12,3,1,2,0
2022-06-30,Hue City,Huong Thuy,14,3,0,3,1
2022-06-30,Hue City,Huong Thuy,15,2,2,0,0
2022-06-30,Hue City,Huong Thuy,16,1,0,1,0
2022-06-30,Hue City,Huong Thuy,17,1,1,0,0
2022-06-30,Hue City,Huong Thuy,18,7,5,2,1
2022-06-30,Hue City,Huong Thuy,19,2,1,1,0
2022-06-30,Hue City,Huong Thuy,20,3,2,1,0
2022-06-30,Hue City,Huong Thuy,21,1,1,0,0
2022-06-30,Hue City,Huong Tra,8,1,1,0,0
2022-06-30,Hue City,Huong Tra,9,3,2,1,0
2022-06-30,Hue City,Huong Tra,15,1,0,1,1
2022-06-30,Hue City,Huong Tra,16,1,1,0,0
2022-06-30,Hue City,Huong Tra,18,2,1,1,0
2022-06-30,Hue City,Huong Tra,19,1,1,0,0
2022-06-30,Hue City,Huong Tra,21,1,0,1,1
2022-06-30,Hue City,Phu Vang,7,2,1,1,0
2022-06-30,Hue City,Phu Vang,9,4,1,3,2
2022-06-30,Hue City,Phu Vang,10,5,4,1,0
2022-06-30,Hue City,Phu Vang,11,3,3,0,0
2022-06-30,Hue City,Phu Vang,12,2,2,0,0
2022-06-30,Hue City,Phu Vang,13,2,2,0,0
2022-06-30,Hue City,Phu Vang,14,1,0,1,0
2022-06-30,Hue City,Phu Vang,15,1,0,1,0
2022-06-30,Hue City,Phu Vang,16,2,1,1,1
2022-06-30,Hue City,Phu Vang,17,1,1,0,0
2022-06-30,Hue City,Phu Vang,18,5,3,2,0
2022-06-30,Hue City,Phu Vang,19,4,3,1,0
2022-06-30,Hue City,Phu Vang,20,1,1,0,0
2022-06-30,Khanh Hoa,Cam Ranh City,14,1,0,1,1
2022-06-30,Khanh Hoa,Dien Khanh,14,1,0,1,1
2022-06-30,Khanh Hoa,Dien Khanh,17,1,0,1,1
2022-06-30,Khanh Hoa,Dien Khanh,19,1,0,1,0
2022-06-30,Khanh Hoa,Nha Trang City,0,3,1,2,0
2022-06-30,Khanh Hoa,Nha Trang City,5,1,1,0,0
2022-06-30,Khanh Hoa,Nha Trang City,6,34,27,7,2
2022-06-30,Khanh Hoa,Nha Trang City,7,110,98,12,1
2022-06-30,Khanh Hoa,Nha Trang City,8,231,216,15,0
2022-06-30,Khanh Hoa,Nha Trang City,9,186,163,23,0
2022-06-30,Khanh Hoa,Nha Trang City,10,228,210,18,0
2022-06-30,Khanh Hoa,Nha Trang City,11,381,359,22,0
2022-06-30,Khanh Hoa,Nha Trang City,12,319,283,36,1
2022-06-30,Khanh Hoa,Nha Trang City,13,225,208,17,1
2022-06-30,Khanh Hoa,Nha Trang City,14,240,231,9,0
2022-06-30,Khanh Hoa,Nha Trang City,15,176,156,20,0
2022-06-30,Khanh Hoa,Nha Trang City,16,150,134,16,1
2022-06-30,Khanh Hoa,Nha Trang City,17,207,191,16,2
2022-06-30,Khanh Hoa,Nha Trang City,18,274,254,20,0
2022-06-30,Khanh Hoa,Nha Trang City,19,258,231,27,1
2022-06-30,Khanh Hoa,Nha Trang City,20,174,156,18,0
2022-06-30,Khanh Hoa,Nha Trang City,21,115,92,23,4
2022-06-30,Khanh Hoa,Nha Trang City,22,4,2,2,0
2022-06-30,Khanh Hoa,Nha Trang City,23,1,1,0,0
2022-06-30,Lam Dong,Da Lat City,6,2,2,0,0
2022-06-30,Lam Dong,Da Lat City,7,48,38,10,3
2022-06-30,Lam Dong,Da Lat City,8,89,75,14,3
2022-06-30,Lam Dong,Da Lat City,9,99,86,13,4
2022-06-30,Lam Dong,Da Lat City,10,100,81,19,1
2022-06-30,Lam Dong,Da Lat City,11,133,119,14,3
2022-06-30,Lam Dong,Da Lat City,12,133,111,22,3
2022-06-30,Lam Dong,Da Lat City,13,115,98,17,4
2022-06-30,Lam Dong,Da Lat City,14,109,85,24,8
2022-06-30,Lam Dong,Da Lat City,15,126,83,43,15
2022-06-30,Lam Dong,Da Lat City,16,94,82,12,1
2022-06-30,Lam Dong,Da Lat City,17,123,107,16,4
2022-06-30,Lam Dong,Da Lat City,18,154,107,47,20
2022-06-30,Lam Dong,Da Lat City,19,143,89,54,26
2022-06-30,Lam Dong,Da Lat City,20,99,53,46,35
2022-06-30,Lam Dong,Da Lat City,21,60,33,27,20
2022-06-30,Lam Dong,Lac Duong,8,1,0,1,1
2022-06-30,Nghe An,Vinh City,0,1,1,0,0
2022-06-30,Nghe An,Vinh City,6,7,5,2,1
2022-06-30,Nghe An,Vinh City,7,143,124,19,5
2022-06-30,Nghe An,Vinh City,8,183,163,20,2
2022-06-30,Nghe An,Vinh City,9,162,144,18,1
2022-06-30,Nghe An,Vinh City,10,241,193,48,12
2022-06-30,Nghe An,Vinh City,11,402,338,64,21
2022-06-30,Nghe An,Vinh City,12,235,212,23,6
2022-06-30,Nghe An,Vinh City,13,151,126,25,3
2022-06-30,Nghe An,Vinh City,14,195,162,33,13
2022-06-30,Nghe An,Vinh City,15,179,156,23,4
2022-06-30,Nghe An,Vinh City,16,161,128,33,6
2022-06-30,Nghe An,Vinh City,17,160,136,24,4
2022-06-30,Nghe An,Vinh City,18,198,151,47,4
2022-06-30,Nghe An,Vinh City,19,217,140,77,35
2022-06-30,Nghe An,Vinh City,20,163,96,67,31
2022-06-30,Nghe An,Vinh City,21,98,56,42,27
2022-06-30,Nghe An,Vinh City,22,1,0,1,0
2022-06-30,Quang Nam,Hoi An City,7,22,10,12,8
2022-06-30,Quang Nam,Hoi An City,8,30,23,7,0
2022-06-30,Quang Nam,Hoi An City,9,24,21,3,0
2022-06-30,Quang Nam,Hoi An City,10,35,26,9,1
2022-06-30,Quang Nam,Hoi An City,11,32,26,6,1
2022-06-30,Quang Nam,Hoi An City,12,47,37,10,1
2022-06-30,Quang Nam,Hoi An City,13,35,31,4,0
2022-06-30,Quang Nam,Hoi An City,14,56,44,12,1
2022-06-30,Quang Nam,Hoi An City,15,30,30,0,0
2022-06-30,Quang Nam,Hoi An City,16,34,32,2,0
2022-06-30,Quang Nam,Hoi An City,17,39,31,8,2
2022-06-30,Quang Nam,Hoi An City,18,64,46,18,7
2022-06-30,Quang Nam,Hoi An City,19,70,42,28,17
2022-06-30,Quang Nam,Hoi An City,20,65,24,41,24
2022-06-30,Quang Nam,Hoi An City,21,48,11,37,27
2022-06-30,Quang Nam,Tam Ky City,10,1,0,1,1
2022-06-30,Quang Ninh,Cam Pha City,10,1,0,1,1
2022-06-30,Quang Ninh,Cam Pha City,13,1,0,1,0
2022-06-30,Quang Ninh,Cam Pha City,14,3,0,3,0
2022-06-30,Quang Ninh,Cam Pha City,20,2,0,2,2
2022-06-30,Quang Ninh,Ha Long City,0,2,1,1,0
2022-06-30,Quang Ninh,Ha Long City,6,1,1,0,0
2022-06-30,Quang Ninh,Ha Long City,7,31,18,13,8
2022-06-30,Quang Ninh,Ha Long City,8,55,35,20,4
2022-06-30,Quang Ninh,Ha Long City,9,44,35,9,3
2022-06-30,Quang Ninh,Ha Long City,10,68,48,20,2
2022-06-30,Quang Ninh,Ha Long City,11,153,122,31,9
2022-06-30,Quang Ninh,Ha Long City,12,118,86,32,3
2022-06-30,Quang Ninh,Ha Long City,13,91,57,34,11
2022-06-30,Quang Ninh,Ha Long City,14,68,50,18,3
2022-06-30,Quang Ninh,Ha Long City,15,57,37,20,4
2022-06-30,Quang Ninh,Ha Long City,16,39,23,16,3
2022-06-30,Quang Ninh,Ha Long City,17,51,36,15,5
2022-06-30,Quang Ninh,Ha Long City,18,82,61,21,4
2022-06-30,Quang Ninh,Ha Long City,19,63,46,17,3
2022-06-30,Quang Ninh,Ha Long City,20,64,32,32,12
2022-06-30,Quang Ninh,Ha Long City,21,2,1,1,0
2022-06-30,Quang Ninh,Uong Bi City,12,1,0,1,1
2022-06-30,Quang Ninh,Uong Bi City,14,1,0,1,1
2022-06-30,Quang Ninh,Uong Bi City,15,1,0,1,0
2022-06-30,Quang Ninh,Uong Bi City,17,1,0,1,1
2022-06-30,Quang Ninh,Uong Bi City,20,1,0,1,1
2022-06-30,Thai Nguyen,Dong Hy,8,1,1,0,0
2022-06-30,Thai Nguyen,Dong Hy,13,1,1,0,0
2022-06-30,Thai Nguyen,Dong Hy,19,2,0,2,0
2022-06-30,Thai Nguyen,Pho Yen,20,1,0,1,1
2022-06-30,Thai Nguyen,Thai Nguyen City,0,3,3,0,0
2022-06-30,Thai Nguyen,Thai Nguyen City,1,4,3,1,0
2022-06-30,Thai Nguyen,Thai Nguyen City,2,1,1,0,0
2022-06-30,Thai Nguyen,Thai Nguyen City,6,2,1,1,0
2022-06-30,Thai Nguyen,Thai Nguyen City,7,115,102,13,3
2022-06-30,Thai Nguyen,Thai Nguyen City,8,170,160,10,2
2022-06-30,Thai Nguyen,Thai Nguyen City,9,132,119,13,0
2022-06-30,Thai Nguyen,Thai Nguyen City,10,200,186,14,0
2022-06-30,Thai Nguyen,Thai Nguyen City,11,387,353,34,1
2022-06-30,Thai Nguyen,Thai Nguyen City,12,256,237,19,0
2022-06-30,Thai Nguyen,Thai Nguyen City,13,163,159,4,0
2022-06-30,Thai Nguyen,Thai Nguyen City,14,192,174,18,1
2022-06-30,Thai Nguyen,Thai Nguyen City,15,145,119,26,2
2022-06-30,Thai Nguyen,Thai Nguyen City,16,122,110,12,0
2022-06-30,Thai Nguyen,Thai Nguyen City,17,134,122,12,0
2022-06-30,Thai Nguyen,Thai Nguyen City,18,236,219,17,1
2022-06-30,Thai Nguyen,Thai Nguyen City,19,281,249,32,2
2022-06-30,Thai Nguyen,Thai Nguyen City,20,168,146,22,1
2022-06-30,Thai Nguyen,Thai Nguyen City,21,144,117,27,2
2022-06-30,Thai Nguyen,Thai Nguyen City,22,1,0,1,0
2022-06-30,Vung Tau,Ba Ria City,7,1,0,1,1
2022-06-30,Vung Tau,Ba Ria City,8,4,0,4,4
2022-06-30,Vung Tau,Ba Ria City,9,10,1,9,7
2022-06-30,Vung Tau,Ba Ria City,10,5,5,0,0
2022-06-30,Vung Tau,Ba Ria City,11,12,4,8,2
2022-06-30,Vung Tau,Ba Ria City,12,9,3,6,3
2022-06-30,Vung Tau,Ba Ria City,13,11,3,8,3
2022-06-30,Vung Tau,Ba Ria City,14,13,6,7,2
2022-06-30,Vung Tau,Ba Ria City,15,5,2,3,2
2022-06-30,Vung Tau,Ba Ria City,16,7,3,4,3
2022-06-30,Vung Tau,Ba Ria City,17,6,2,4,0
2022-06-30,Vung Tau,Ba Ria City,18,10,3,7,3
2022-06-30,Vung Tau,Ba Ria City,19,10,0,10,3
2022-06-30,Vung Tau,Ba Ria City,20,6,0,6,3
2022-06-30,Vung Tau,Ba Ria City,21,5,0,5,4
2022-06-30,Vung Tau,Chau Duc,9,1,0,1,1
2022-06-30,Vung Tau,Vung Tau City,1,5,2,3,0
2022-06-30,Vung Tau,Vung Tau City,2,2,1,1,0
2022-06-30,Vung Tau,Vung Tau City,6,50,33,17,6
2022-06-30,Vung Tau,Vung Tau City,7,110,101,9,1
2022-06-30,Vung Tau,Vung Tau City,8,183,175,8,1
2022-06-30,Vung Tau,Vung Tau City,9,189,173,16,3
2022-06-30,Vung Tau,Vung Tau City,10,210,194,16,0
2022-06-30,Vung Tau,Vung Tau City,11,370,341,29,2
2022-06-30,Vung Tau,Vung Tau City,12,305,286,19,0
2022-06-30,Vung Tau,Vung Tau City,13,244,228,16,0
2022-06-30,Vung Tau,Vung Tau City,14,233,213,20,0
2022-06-30,Vung Tau,Vung Tau City,15,272,252,20,1
2022-06-30,Vung Tau,Vung Tau City,16,198,184,14,1
2022-06-30,Vung Tau,Vung Tau City,17,273,255,18,0
2022-06-30,Vung Tau,Vung Tau City,18,328,291,37,5
2022-06-30,Vung Tau,Vung Tau City,19,305,271,34,1
2022-06-30,Vung Tau,Vung Tau City,20,182,160,22,3
2022-06-30,Vung Tau,Vung Tau City,21,105,81,24,5
2022-07-01,Bac Ninh,Bác Ninh City,0,1,1,0,0
2022-07-01,Bac Ninh,Bác Ninh City,1,1,0,1,0
2022-07-01,Bac Ninh,Bác Ninh City,3,1,0,1,0
2022-07-01,Bac Ninh,Bác Ninh City,6,5,3,2,0
2022-07-01,Bac Ninh,Bác Ninh City,7,53,49,4,1
2022-07-01,Bac Ninh,Bác Ninh City,8,115,106,9,0
2022-07-01,Bac Ninh,Bác Ninh City,9,118,107,11,1
2022-07-01,Bac Ninh,Bác Ninh City,10,190,179,11,1
2022-07-01,Bac Ninh,Bác Ninh City,11,334,305,29,2
2022-07-01,Bac Ninh,Bác Ninh City,12,235,215,20,3
2022-07-01,Bac Ninh,Bác Ninh City,13,163,150,13,3
2022-07-01,Bac Ninh,Bác Ninh City,14,144,128,16,3
2022-07-01,Bac Ninh,Bác Ninh City,15,124,118,6,0
2022-07-01,Bac Ninh,Bác Ninh City,16,101,94,7,0
2022-07-01,Bac Ninh,Bác Ninh City,17,143,125,18,4
2022-07-01,Bac Ninh,Bác Ninh City,18,160,144,16,2
2022-07-01,Bac Ninh,Bác Ninh City,19,176,158,18,4
2022-07-01,Bac Ninh,Bác Ninh City,20,123,103,20,6
2022-07-01,Bac Ninh,Bác Ninh City,21,92,77,15,4
2022-07-01,Bac Ninh,Bác Ninh City,22,1,0,1,0
2022-07-01,Bac Ninh,Que Vo,14,1,0,1,1
2022-07-01,Bac Ninh,Que Vo,15,1,0,1,1
2022-07-01,Bac Ninh,Que Vo,19,1,0,1,1
2022-07-01,Bac Ninh,Tien Du,9,1,0,1,0
2022-07-01,Bac Ninh,Tien Du,11,1,0,1,1
2022-07-01,Bac Ninh,Tien Du,12,2,0,2,2
2022-07-01,Bac Ninh,Tien Du,15,4,0,4,4
2022-07-01,Bac Ninh,Tien Du,16,1,0,1,0
2022-07-01,Bac Ninh,Tien Du,17,1,0,1,1
2022-07-01,Bac Ninh,Tien Du,18,5,0,5,5
2022-07-01,Bac Ninh,Tien Du,20,1,0,1,1
2022-07-01,Bac Ninh,Tien Du,21,2,0,2,2
2022-07-01,Bac Ninh,Tu Son,10,3,0,3,3
2022-07-01,Bac Ninh,Tu Son,11,2,0,2,2
2022-07-01,Bac Ninh,Tu Son,12,2,0,2,2
2022-07-01,Bac Ninh,Tu Son,13,3,0,3,3
2022-07-01,Bac Ninh,Tu Son,20,1,0,1,1
2022-07-01,Bac Ninh,Tu Son,21,1,0,1,1
2022-07-01,Binh Duong,Ben Cat,8,1,0,1,1
2022-07-01,Binh Duong,Ben Cat,9,1,1,0,0
2022-07-01,Binh Duong,Ben Cat,10,2,0,2,2
2022-07-01,Binh Duong,Ben Cat,11,2,0,2,2
2022-07-01,Binh Duong,Ben Cat,12,1,0,1,1
2022-07-01,Binh Duong,Ben Cat,14,1,1,0,0
2022-07-01,Binh Duong,Ben Cat,15,2,0,2,2
2022-07-01,Binh Duong,Ben Cat,16,1,0,1,1
2022-07-01,Binh Duong,Ben Cat,17,1,0,1,1
2022-07-01,Binh Duong,Ben Cat,18,2,0,2,2
2022-07-01,Binh Duong,Ben Cat,19,1,0,1,1
2022-07-01,Binh Duong,Ben Cat,23,1,0,1,1
2022-07-01,Binh Duong,Di An,6,1,0,1,1
2022-07-01,Binh Duong,Di An,7,5,1,4,4
2022-07-01,Binh Duong,Di An,8,11,4,7,5
2022-07-01,Binh Duong,Di An,9,25,13,12,8
2022-07-01,Binh Duong,Di An,10,30,22,8,5
2022-07-01,Binh Duong,Di An,11,38,29,9,4
2022-07-01,Binh Duong,Di An,12,31,21,10,6
2022-07-01,Binh Duong,Di An,13,48,36,12,7
2022-07-01,Binh Duong,Di An,14,30,22,8,5
2022-07-01,Binh Duong,Di An,15,29,19,10,6
2022-07-01,Binh Duong,Di An,16,18,13,5,4
2022-07-01,Binh Duong,Di An,17,25,21,4,2
2022-07-01,Binh Duong,Di An,18,25,23,2,0
2022-07-01,Binh Duong,Di An,19,33,27,6,3
2022-07-01,Binh Duong,Di An,20,18,13,5,4
2022-07-01,Binh Duong,Di An,21,15,6,9,8
2022-07-01,Binh Duong,Tan Uyen,8,1,0,1,1
2022-07-01,Binh Duong,Tan Uyen,9,2,1,1,1
2022-07-01,Binh Duong,Tan Uyen,10,7,5,2,2
2022-07-01,Binh Duong,Tan Uyen,11,1,0,1,1
2022-07-01,Binh Duong,Tan Uyen,12,3,0,3,1
2022-07-01,Binh Duong,Tan Uyen,13,5,2,3,2
2022-07-01,Binh Duong,Tan Uyen,14,1,0,1,0
2022-07-01,Binh Duong,Tan Uyen,15,1,0,1,1
2022-07-01,Binh Duong,Tan Uyen,16,1,0,1,0
2022-07-01,Binh Duong,Tan Uyen,17,2,1,1,1
2022-07-01,Binh Duong,Tan Uyen,18,3,2,1,1
2022-07-01,Binh Duong,Tan Uyen,19,2,1,1,1
2022-07-01,Binh Duong,Tan Uyen,20,3,1,2,2
2022-07-01,Binh Duong,Tan Uyen,21,1,0,1,1
2022-07-01,Binh Duong,Thu Dau Mot Town,3,2,1,1,0
2022-07-01,Binh Duong,Thu Dau Mot Town,4,1,1,0,0
2022-07-01,Binh Duong,Thu Dau Mot Town,6,41,33,8,7
2022-07-01,Binh Duong,Thu Dau Mot Town,7,97,92,5,0
2022-07-01,Binh Duong,Thu Dau Mot Town,8,201,188,13,3
2022-07-01,Binh Duong,Thu Dau Mot Town,9,272,252,20,5
2022-07-01,Binh Duong,Thu Dau Mot Town,10,416,385,31,3
2022-07-01,Binh Duong,Thu Dau Mot Town,11,650,610,40,9
2022-07-01,Binh Duong,Thu Dau Mot Town,12,480,440,40,4
2022-07-01,Binh Duong,Thu Dau Mot Town,13,441,409,32,6
2022-07-01,Binh Duong,Thu Dau Mot Town,14,384,352,32,8
2022-07-01,Binh Duong,Thu Dau Mot Town,15,289,268,21,3
2022-07-01,Binh Duong,Thu Dau Mot Town,16,272,250,22,2
2022-07-01,Binh Duong,Thu Dau Mot Town,17,394,365,29,5
2022-07-01,Binh Duong,Thu Dau Mot Town,18,407,386,21,5
2022-07-01,Binh Duong,Thu Dau Mot Town,19,383,356,27,8
2022-07-01,Binh Duong,Thu Dau Mot Town,20,288,250,38,4
2022-07-01,Binh Duong,Thu Dau Mot Town,21,140,113,27,6
2022-07-01,Binh Duong,Thu Dau Mot Town,22,4,1,3,2
2022-07-01,Binh Duong,Thu Dau Mot Town,23,1,0,1,0
2022-07-01,Binh Duong,Thuan An,1,1,0,1,1
2022-07-01,Binh Duong,Thuan An,7,14,7,7,6
2022-07-01,Binh Duong,Thuan An,8,17,11,6,3
2022-07-01,Binh Duong,Thuan An,9,26,23,3,2
2022-07-01,Binh Duong,Thuan An,10,63,56,7,4
2022-07-01,Binh Duong,Thuan An,11,87,74,13,4
2022-07-01,Binh Duong,Thuan An,12,74,56,18,4
2022-07-01,Binh Duong,Thuan An,13,91,73,18,9
2022-07-01,Binh Duong,Thuan An,14,55,47,8,4
2022-07-01,Binh Duong,Thuan An,15,36,24,12,4
2022-07-01,Binh Duong,Thuan An,16,45,38,7,4
2022-07-01,Binh Duong,Thuan An,17,45,37,8,2
2022-07-01,Binh Duong,Thuan An,18,37,35,2,0
2022-07-01,Binh Duong,Thuan An,19,44,40,4,0
2022-07-01,Binh Duong,Thuan An,20,29,24,5,2
2022-07-01,Binh Duong,Thuan An,21,36,10,26,18
2022-07-01,Can Tho City,Binh Thuy District,8,3,3,0,0
2022-07-01,Can Tho City,Binh Thuy District,9,7,6,1,0
2022-07-01,Can Tho City,Binh Thuy District,10,12,10,2,0
2022-07-01,Can Tho City,Binh Thuy District,11,13,13,0,0
2022-07-01,Can Tho City,Binh Thuy District,12,13,13,0,0
2022-07-01,Can Tho City,Binh Thuy District,13,12,11,1,0
2022-07-01,Can Tho City,Binh Thuy District,14,14,11,3,0
2022-07-01,Can Tho City,Binh Thuy District,15,7,7,0,0
2022-07-01,Can Tho City,Binh Thuy District,16,10,9,1,0
2022-07-01,Can Tho City,Binh Thuy District,17,14,14,0,0
2022-07-01,Can Tho City,Binh Thuy District,18,19,18,1,0
2022-07-01,Can Tho City,Binh Thuy District,19,12,9,3,1
2022-07-01,Can Tho City,Binh Thuy District,20,10,9,1,1
2022-07-01,Can Tho City,Binh Thuy District,21,3,2,1,0
2022-07-01,Can Tho City,Cai Rang District,6,1,1,0,0
2022-07-01,Can Tho City,Cai Rang District,7,1,1,0,0
2022-07-01,Can Tho City,Cai Rang District,8,7,6,1,1
2022-07-01,Can Tho City,Cai Rang District,9,10,10,0,0
2022-07-01,Can Tho City,Cai Rang District,10,9,9,0,0
2022-07-01,Can Tho City,Cai Rang District,11,14,12,2,0
2022-07-01,Can Tho City,Cai Rang District,12,15,13,2,0
2022-07-01,Can Tho City,Cai Rang District,13,8,8,0,0
2022-07-01,Can Tho City,Cai Rang District,14,15,13,2,0
2022-07-01,Can Tho City,Cai Rang District,15,9,7,2,2
2022-07-01,Can Tho City,Cai Rang District,16,13,12,1,0
2022-07-01,Can Tho City,Cai Rang District,17,11,11,0,0
2022-07-01,Can Tho City,Cai Rang District,18,11,11,0,0
2022-07-01,Can Tho City,Cai Rang District,19,5,5,0,0
2022-07-01,Can Tho City,Cai Rang District,20,1,1,0,0
2022-07-01,Can Tho City,Cai Rang District,21,6,4,2,1
2022-07-01,Can Tho City,Ninh Kieu District,0,4,4,0,0
2022-07-01,Can Tho City,Ninh Kieu District,1,1,1,0,0
2022-07-01,Can Tho City,Ninh Kieu District,2,2,1,1,0
2022-07-01,Can Tho City,Ninh Kieu District,6,46,45,1,1
2022-07-01,Can Tho City,Ninh Kieu District,7,108,99,9,3
2022-07-01,Can Tho City,Ninh Kieu District,8,270,245,25,2
2022-07-01,Can Tho City,Ninh Kieu District,9,288,269,19,0
2022-07-01,Can Tho City,Ninh Kieu District,10,547,523,24,0
2022-07-01,Can Tho City,Ninh Kieu District,11,841,800,41,2
2022-07-01,Can Tho City,Ninh Kieu District,12,629,597,32,0
2022-07-01,Can Tho City,Ninh Kieu District,13,506,486,20,0
2022-07-01,Can Tho City,Ninh Kieu District,14,452,435,17,0
2022-07-01,Can Tho City,Ninh Kieu District,15,370,355,15,0
2022-07-01,Can Tho City,Ninh Kieu District,16,379,360,19,1
2022-07-01,Can Tho City,Ninh Kieu District,17,498,477,21,0
2022-07-01,Can Tho City,Ninh Kieu District,18,545,525,20,0
2022-07-01,Can Tho City,Ninh Kieu District,19,491,461,30,0
2022-07-01,Can Tho City,Ninh Kieu District,20,373,354,19,0
2022-07-01,Can Tho City,Ninh Kieu District,21,204,189,15,1
2022-07-01,Can Tho City,Ninh Kieu District,22,4,2,2,0
2022-07-01,Dong Nai,Bien Hoa City,0,4,3,1,0
2022-07-01,Dong Nai,Bien Hoa City,1,1,1,0,0
2022-07-01,Dong Nai,Bien Hoa City,4,1,0,1,0
2022-07-01,Dong Nai,Bien Hoa City,5,3,0,3,0
2022-07-01,Dong Nai,Bien Hoa City,6,32,27,5,1
2022-07-01,Dong Nai,Bien Hoa City,7,169,143,26,10
2022-07-01,Dong Nai,Bien Hoa City,8,294,267,27,3
2022-07-01,Dong Nai,Bien Hoa City,9,433,380,53,6
2022-07-01,Dong Nai,Bien Hoa City,10,744,686,58,10
2022-07-01,Dong Nai,Bien Hoa City,11,1152,1070,82,13
2022-07-01,Dong Nai,Bien Hoa City,12,936,856,80,19
2022-07-01,Dong Nai,Bien Hoa City,13,898,837,61,10
2022-07-01,Dong Nai,Bien Hoa City,14,727,670,57,8
2022-07-01,Dong Nai,Bien Hoa City,15,540,500,40,6
2022-07-01,Dong Nai,Bien Hoa City,16,497,463,34,9
2022-07-01,Dong Nai,Bien Hoa City,17,595,560,35,5
2022-07-01,Dong Nai,Bien Hoa City,18,661,622,39,1
2022-07-01,Dong Nai,Bien Hoa City,19,740,668,72,14
2022-07-01,Dong Nai,Bien Hoa City,20,518,449,69,17
2022-07-01,Dong Nai,Bien Hoa City,21,249,187,62,22
2022-07-01,Dong Nai,Bien Hoa City,22,6,3,3,0
2022-07-01,Dong Nai,Bien Hoa City,23,4,3,1,0
2022-07-01,Dong Nai,Long Khanh,16,1,0,1,1
2022-07-01,Dong Nai,Long Thanh,10,2,0,2,2
2022-07-01,Dong Nai,Long Thanh,11,4,0,4,3
2022-07-01,Dong Nai,Long Thanh,12,5,0,5,4
2022-07-01,Dong Nai,Long Thanh,16,1,0,1,1
2022-07-01,Dong Nai,Long Thanh,18,5,0,5,5
2022-07-01,Dong Nai,Long Thanh,20,1,0,1,1
2022-07-01,Dong Nai,Nhon trach,9,1,0,1,1
2022-07-01,Dong Nai,Nhon trach,16,1,0,1,1
2022-07-01,Dong Nai,Nhon trach,17,2,0,2,2
2022-07-01,Dong Nai,Trang Bom,8,1,0,1,1
2022-07-01,Dong Nai,Trang Bom,9,1,0,1,1
2022-07-01,Dong Nai,Trang Bom,10,1,0,1,1
2022-07-01,Dong Nai,Trang Bom,12,1,0,1,1
2022-07-01,Dong Nai,Trang Bom,13,2,0,2,1
2022-07-01,Dong Nai,Trang Bom,15,2,0,2,2
2022-07-01,Dong Nai,Trang Bom,16,1,0,1,1
2022-07-01,Dong Nai,Vinh Cuu,11,1,0,1,1
2022-07-01,Dong Nai,Vinh Cuu,14,1,0,1,1
2022-07-01,Hai Phong City,An Duong,8,1,0,1,1
2022-07-01,Hai Phong City,An Duong,9,6,0,6,4
2022-07-01,Hai Phong City,An Duong,10,9,4,5,2
2022-07-01,Hai Phong City,An Duong,11,5,3,2,1
2022-07-01,Hai Phong City,An Duong,12,6,3,3,3
2022-07-01,Hai Phong City,An Duong,13,3,1,2,2
2022-07-01,Hai Phong City,An Duong,14,6,3,3,1
2022-07-01,Hai Phong City,An Duong,15,2,2,0,0
2022-07-01,Hai Phong City,An Duong,16,3,2,1,1
2022-07-01,Hai Phong City,An Duong,17,1,1,0,0
2022-07-01,Hai Phong City,An Duong,18,4,1,3,2
2022-07-01,Hai Phong City,An Duong,19,3,1,2,2
2022-07-01,Hai Phong City,An Duong,20,4,1,3,3
2022-07-01,Hai Phong City,An Duong,21,3,1,2,1
2022-07-01,Hai Phong City,Do Son District,12,2,0,2,2
2022-07-01,Hai Phong City,Do Son District,16,1,0,1,1
2022-07-01,Hai Phong City,Hai An District,1,2,0,2,2
2022-07-01,Hai Phong City,Hai An District,7,6,3,3,3
2022-07-01,Hai Phong City,Hai An District,8,22,17,5,3
2022-07-01,Hai Phong City,Hai An District,9,19,15,4,1
2022-07-01,Hai Phong City,Hai An District,10,24,21,3,1
2022-07-01,Hai Phong City,Hai An District,11,48,44,4,2
2022-07-01,Hai Phong City,Hai An District,12,29,27,2,1
2022-07-01,Hai Phong City,Hai An District,13,18,11,7,5
2022-07-01,Hai Phong City,Hai An District,14,11,9,2,1
2022-07-01,Hai Phong City,Hai An District,15,12,12,0,0
2022-07-01,Hai Phong City,Hai An District,16,18,17,1,0
2022-07-01,Hai Phong City,Hai An District,17,28,25,3,0
2022-07-01,Hai Phong City,Hai An District,18,23,17,6,4
2022-07-01,Hai Phong City,Hai An District,19,21,14,7,1
2022-07-01,Hai Phong City,Hai An District,20,23,21,2,1
2022-07-01,Hai Phong City,Hai An District,21,4,2,2,2
2022-07-01,Hai Phong City,Hong Bang District,0,1,0,1,1
2022-07-01,Hai Phong City,Hong Bang District,7,11,11,0,0
2022-07-01,Hai Phong City,Hong Bang District,8,32,27,5,2
2022-07-01,Hai Phong City,Hong Bang District,9,23,19,4,0
2022-07-01,Hai Phong City,Hong Bang District,10,56,53,3,0
2022-07-01,Hai Phong City,Hong Bang District,11,125,101,24,6
2022-07-01,Hai Phong City,Hong Bang District,12,51,45,6,1
2022-07-01,Hai Phong City,Hong Bang District,13,40,37,3,0
2022-07-01,Hai Phong City,Hong Bang District,14,37,31,6,4
2022-07-01,Hai Phong City,Hong Bang District,15,52,39,13,8
2022-07-01,Hai Phong City,Hong Bang District,16,45,38,7,0
2022-07-01,Hai Phong City,Hong Bang District,17,64,53,11,2
2022-07-01,Hai Phong City,Hong Bang District,18,62,50,12,4
2022-07-01,Hai Phong City,Hong Bang District,19,59,46,13,5
2022-07-01,Hai Phong City,Hong Bang District,20,45,35,10,4
2022-07-01,Hai Phong City,Hong Bang District,21,13,10,3,1
2022-07-01,Hai Phong City,Kien An District,7,4,1,3,3
2022-07-01,Hai Phong City,Kien An District,8,6,5,1,1
2022-07-01,Hai Phong City,Kien An District,9,5,3,2,0
2022-07-01,Hai Phong City,Kien An District,10,10,6,4,0
2022-07-01,Hai Phong City,Kien An District,11,13,12,1,0
2022-07-01,Hai Phong City,Kien An District,12,12,10,2,0
2022-07-01,Hai Phong City,Kien An District,13,5,4,1,0
2022-07-01,Hai Phong City,Kien An District,14,14,11,3,1
2022-07-01,Hai Phong City,Kien An District,15,16,9,7,5
2022-07-01,Hai Phong City,Kien An District,16,5,5,0,0
2022-07-01,Hai Phong City,Kien An District,17,9,9,0,0
2022-07-01,Hai Phong City,Kien An District,18,13,9,4,2
2022-07-01,Hai Phong City,Kien An District,19,25,18,7,1
2022-07-01,Hai Phong City,Kien An District,20,15,6,9,7
2022-07-01,Hai Phong City,Kien An District,21,11,4,7,6
2022-07-01,Hai Phong City,Le Chan District,1,1,1,0,0
2022-07-01,Hai Phong City,Le Chan District,5,1,1,0,0
2022-07-01,Hai Phong City,Le Chan District,7,38,31,7,6
2022-07-01,Hai Phong City,Le Chan District,8,75,63,12,1
2022-07-01,Hai Phong City,Le Chan District,9,83,76,7,0
2022-07-01,Hai Phong City,Le Chan District,10,202,190,12,1
2022-07-01,Hai Phong City,Le Chan District,11,345,305,40,9
2022-07-01,Hai Phong City,Le Chan District,12,227,210,17,4
2022-07-01,Hai Phong City,Le Chan District,13,118,104,14,4
2022-07-01,Hai Phong City,Le Chan District,14,143,126,17,4
2022-07-01,Hai Phong City,Le Chan District,15,191,156,35,15
2022-07-01,Hai Phong City,Le Chan District,16,150,133,17,2
2022-07-01,Hai Phong City,Le Chan District,17,177,150,27,9
2022-07-01,Hai Phong City,Le Chan District,18,214,176,38,12
2022-07-01,Hai Phong City,Le Chan District,19,203,165,38,11
2022-07-01,Hai Phong City,Le Chan District,20,127,107,20,2
2022-07-01,Hai Phong City,Le Chan District,21,76,51,25,11
2022-07-01,Hai Phong City,Le Chan District,22,1,0,1,0
2022-07-01,Hai Phong City,Ngo Quyen District,0,1,0,1,0
2022-07-01,Hai Phong City,Ngo Quyen District,6,1,1,0,0
2022-07-01,Hai Phong City,Ngo Quyen District,7,14,6,8,4
2022-07-01,Hai Phong City,Ngo Quyen District,8,70,53,17,5
2022-07-01,Hai Phong City,Ngo Quyen District,9,62,54,8,0
2022-07-01,Hai Phong City,Ngo Quyen District,10,119,107,12,2
2022-07-01,Hai Phong City,Ngo Quyen District,11,272,236,36,10
2022-07-01,Hai Phong City,Ngo Quyen District,12,152,136,16,2
2022-07-01,Hai Phong City,Ngo Quyen District,13,102,82,20,5
2022-07-01,Hai Phong City,Ngo Quyen District,14,120,107,13,10
2022-07-01,Hai Phong City,Ngo Quyen District,15,145,116,29,9
2022-07-01,Hai Phong City,Ngo Quyen District,16,118,101,17,2
2022-07-01,Hai Phong City,Ngo Quyen District,17,127,108,19,8
2022-07-01,Hai Phong City,Ngo Quyen District,18,183,163,20,8
2022-07-01,Hai Phong City,Ngo Quyen District,19,190,167,23,8
2022-07-01,Hai Phong City,Ngo Quyen District,20,161,140,21,7
2022-07-01,Hai Phong City,Ngo Quyen District,21,72,58,14,5
2022-07-01,Hai Phong City,Thuy Nguyen,10,1,0,1,1
2022-07-01,Hai Phong City,Thuy Nguyen,11,1,0,1,1
2022-07-01,Hai Phong City,Thuy Nguyen,12,2,0,2,2
2022-07-01,Hai Phong City,Thuy Nguyen,15,1,0,1,1
2022-07-01,Hai Phong City,Thuy Nguyen,17,3,0,3,2
2022-07-01,Hai Phong City,Thuy Nguyen,18,1,0,1,1
2022-07-01,Hai Phong City,Thuy Nguyen,19,3,0,3,3
2022-07-01,Hue City,Hue City,1,5,2,3,0
2022-07-01,Hue City,Hue City,4,1,1,0,0
2022-07-01,Hue City,Hue City,5,6,2,4,0
2022-07-01,Hue City,Hue City,6,77,68,9,2
2022-07-01,Hue City,Hue City,7,192,174,18,2
2022-07-01,Hue City,Hue City,8,343,305,38,2
2022-07-01,Hue City,Hue City,9,251,222,29,0
2022-07-01,Hue City,Hue City,10,338,308,30,3
2022-07-01,Hue City,Hue City,11,754,693,61,5
2022-07-01,Hue City,Hue City,12,572,541,31,0
2022-07-01,Hue City,Hue City,13,367,335,32,0
2022-07-01,Hue City,Hue City,14,374,350,24,0
2022-07-01,Hue City,Hue City,15,360,331,29,1
2022-07-01,Hue City,Hue City,16,376,343,33,4
2022-07-01,Hue City,Hue City,17,480,432,48,5
2022-07-01,Hue City,Hue City,18,555,513,42,3
2022-07-01,Hue City,Hue City,19,586,528,58,15
2022-07-01,Hue City,Hue City,20,464,396,68,11
2022-07-01,Hue City,Hue City,21,315,214,101,45
2022-07-01,Hue City,Hue City,22,7,3,4,0
2022-07-01,Hue City,Hue City,23,4,2,2,1
2022-07-01,Hue City,Huong Thuy,7,1,1,0,0
2022-07-01,Hue City,Huong Thuy,8,3,1,2,2
2022-07-01,Hue City,Huong Thuy,9,2,2,0,0
2022-07-01,Hue City,Huong Thuy,11,2,1,1,0
2022-07-01,Hue City,Huong Thuy,13,1,1,0,0
2022-07-01,Hue City,Huong Thuy,14,1,1,0,0
2022-07-01,Hue City,Huong Thuy,17,3,2,1,0
2022-07-01,Hue City,Huong Thuy,18,2,0,2,0
2022-07-01,Hue City,Huong Thuy,19,1,1,0,0
2022-07-01,Hue City,Huong Thuy,21,2,0,2,0
2022-07-01,Hue City,Huong Tra,14,5,2,3,0
2022-07-01,Hue City,Huong Tra,21,1,0,1,1
2022-07-01,Hue City,Phu Vang,6,1,1,0,0
2022-07-01,Hue City,Phu Vang,7,2,2,0,0
2022-07-01,Hue City,Phu Vang,8,2,2,0,0
2022-07-01,Hue City,Phu Vang,9,4,3,1,0
2022-07-01,Hue City,Phu Vang,10,1,1,0,0
2022-07-01,Hue City,Phu Vang,11,3,3,0,0
2022-07-01,Hue City,Phu Vang,12,2,1,1,1
2022-07-01,Hue City,Phu Vang,13,6,1,5,0
2022-07-01,Hue City,Phu Vang,14,1,1,0,0
2022-07-01,Hue City,Phu Vang,15,2,1,1,0
2022-07-01,Hue City,Phu Vang,16,2,2,0,0
2022-07-01,Hue City,Phu Vang,17,3,2,1,1
2022-07-01,Hue City,Phu Vang,18,6,4,2,0
2022-07-01,Hue City,Phu Vang,19,2,1,1,0
2022-07-01,Khanh Hoa,Cam Ranh City,8,1,0,1,0
2022-07-01,Khanh Hoa,Dien Khanh,8,1,0,1,0
2022-07-01,Khanh Hoa,Dien Khanh,10,4,0,4,3
2022-07-01,Khanh Hoa,Nha Trang City,5,2,2,0,0
2022-07-01,Khanh Hoa,Nha Trang City,6,28,20,8,4
2022-07-01,Khanh Hoa,Nha Trang City,7,129,117,12,5
2022-07-01,Khanh Hoa,Nha Trang City,8,168,158,10,1
2022-07-01,Khanh Hoa,Nha Trang City,9,184,170,14,1
2022-07-01,Khanh Hoa,Nha Trang City,10,214,196,18,1
2022-07-01,Khanh Hoa,Nha Trang City,11,361,333,28,1
2022-07-01,Khanh Hoa,Nha Trang City,12,301,279,22,0
2022-07-01,Khanh Hoa,Nha Trang City,13,269,253,16,0
2022-07-01,Khanh Hoa,Nha Trang City,14,242,224,18,0
2022-07-01,Khanh Hoa,Nha Trang City,15,196,185,11,0
2022-07-01,Khanh Hoa,Nha Trang City,16,212,191,21,1
2022-07-01,Khanh Hoa,Nha Trang City,17,266,248,18,2
2022-07-01,Khanh Hoa,Nha Trang City,18,276,258,18,2
2022-07-01,Khanh Hoa,Nha Trang City,19,263,237,26,0
2022-07-01,Khanh Hoa,Nha Trang City,20,214,192,22,3
2022-07-01,Khanh Hoa,Nha Trang City,21,126,98,28,7
2022-07-01,Khanh Hoa,Nha Trang City,22,1,1,0,0
2022-07-01,Khanh Hoa,Nha Trang City,23,2,1,1,1
2022-07-01,Lam Dong,Da Lat City,2,1,1,0,0
2022-07-01,Lam Dong,Da Lat City,6,2,1,1,1
2022-07-01,Lam Dong,Da Lat City,7,49,30,19,13
2022-07-01,Lam Dong,Da Lat City,8,93,61,32,22
2022-07-01,Lam Dong,Da Lat City,9,72,57,15,6
2022-07-01,Lam Dong,Da Lat City,10,87,77,10,1
2022-07-01,Lam Dong,Da Lat City,11,141,121,20,4
2022-07-01,Lam Dong,Da Lat City,12,136,100,36,17
2022-07-01,Lam Dong,Da Lat City,13,127,111,16,8
2022-07-01,Lam Dong,Da Lat City,14,109,97,12,5
2022-07-01,Lam Dong,Da Lat City,15,137,96,41,21
2022-07-01,Lam Dong,Da Lat City,16,113,93,20,13
2022-07-01,Lam Dong,Da Lat City,17,111,86,25,14
2022-07-01,Lam Dong,Da Lat City,18,142,93,49,33
2022-07-01,Lam Dong,Da Lat City,19,124,81,43,35
2022-07-01,Lam Dong,Da Lat City,20,119,67,52,37
2022-07-01,Lam Dong,Da Lat City,21,73,32,41,29
2022-07-01,Lam Dong,Da Lat City,22,4,0,4,0
2022-07-01,Lam Dong,Da Lat City,23,1,0,1,0
2022-07-01,Nghe An,Cua Lo Town,14,1,0,1,1
2022-07-01,Nghe An,Vinh City,5,1,1,0,0
2022-07-01,Nghe An,Vinh City,6,11,10,1,0
2022-07-01,Nghe An,Vinh City,7,123,98,25,9
2022-07-01,Nghe An,Vinh City,8,192,159,33,7
2022-07-01,Nghe An,Vinh City,9,145,121,24,4
2022-07-01,Nghe An,Vinh City,10,215,181,34,11
2022-07-01,Nghe An,Vinh City,11,439,354,85,37
2022-07-01,Nghe An,Vinh City,12,220,188,32,9
2022-07-01,Nghe An,Vinh City,13,131,117,14,1
2022-07-01,Nghe An,Vinh City,14,174,137,37,6
2022-07-01,Nghe An,Vinh City,15,188,158,30,10
2022-07-01,Nghe An,Vinh City,16,135,114,21,2
2022-07-01,Nghe An,Vinh City,17,135,108,27,3
2022-07-01,Nghe An,Vinh City,18,187,147,40,12
2022-07-01,Nghe An,Vinh City,19,168,127,41,16
2022-07-01,Nghe An,Vinh City,20,162,99,63,37
2022-07-01,Nghe An,Vinh City,21,89,56,33,21
2022-07-01,Nghe An,Vinh City,22,1,0,1,0
2022-07-01,Quang Nam,Hoi An City,7,17,7,10,7
2022-07-01,Quang Nam,Hoi An City,8,20,19,1,1
2022-07-01,Quang Nam,Hoi An City,9,30,19,11,2
2022-07-01,Quang Nam,Hoi An City,10,27,20,7,0
2022-07-01,Quang Nam,Hoi An City,11,33,26,7,2
2022-07-01,Quang Nam,Hoi An City,12,36,26,10,2
2022-07-01,Quang Nam,Hoi An City,13,29,18,11,6
2022-07-01,Quang Nam,Hoi An City,14,40,33,7,3
2022-07-01,Quang Nam,Hoi An City,15,33,29,4,1
2022-07-01,Quang Nam,Hoi An City,16,38,33,5,0
2022-07-01,Quang Nam,Hoi An City,17,50,39,11,5
2022-07-01,Quang Nam,Hoi An City,18,57,42,15,9
2022-07-01,Quang Nam,Hoi An City,19,71,41,30,22
2022-07-01,Quang Nam,Hoi An City,20,72,34,38,33
2022-07-01,Quang Nam,Hoi An City,21,44,21,23,14
2022-07-01,Quang Nam,Hoi An City,22,2,0,2,0
2022-07-01,Quang Nam,Tam Ky City,14,1,0,1,1
2022-07-01,Quang Ninh,Cam Pha City,8,1,0,1,1
2022-07-01,Quang Ninh,Cam Pha City,9,2,0,2,2
2022-07-01,Quang Ninh,Cam Pha City,10,1,0,1,1
2022-07-01,Quang Ninh,Cam Pha City,11,1,0,1,1
2022-07-01,Quang Ninh,Cam Pha City,13,1,0,1,1
2022-07-01,Quang Ninh,Cam Pha City,14,2,0,2,2
2022-07-01,Quang Ninh,Cam Pha City,15,1,0,1,0
2022-07-01,Quang Ninh,Cam Pha City,18,1,0,1,1
2022-07-01,Quang Ninh,Ha Long City,0,1,1,0,0
2022-07-01,Quang Ninh,Ha Long City,1,1,1,0,0
2022-07-01,Quang Ninh,Ha Long City,6,2,0,2,2
2022-07-01,Quang Ninh,Ha Long City,7,24,15,9,4
2022-07-01,Quang Ninh,Ha Long City,8,47,36,11,4
2022-07-01,Quang Ninh,Ha Long City,9,50,37,13,2
2022-07-01,Quang Ninh,Ha Long City,10,82,63,19,9
2022-07-01,Quang Ninh,Ha Long City,11,119,90,29,12
2022-07-01,Quang Ninh,Ha Long City,12,104,78,26,12
2022-07-01,Quang Ninh,Ha Long City,13,64,37,27,20
2022-07-01,Quang Ninh,Ha Long City,14,56,31,25,20
2022-07-01,Quang Ninh,Ha Long City,15,53,37,16,9
2022-07-01,Quang Ninh,Ha Long City,16,47,22,25,10
2022-07-01,Quang Ninh,Ha Long City,17,55,37,18,11
2022-07-01,Quang Ninh,Ha Long City,18,75,48,27,9
2022-07-01,Quang Ninh,Ha Long City,19,65,36,29,11
2022-07-01,Quang Ninh,Ha Long City,20,84,44,40,24
2022-07-01,Quang Ninh,Ha Long City,21,2,0,2,1
2022-07-01,Quang Ninh,Uong Bi City,12,1,0,1,1
2022-07-01,Thai Nguyen,Dong Hy,8,1,1,0,0
2022-07-01,Thai Nguyen,Dong Hy,11,1,1,0,0
2022-07-01,Thai Nguyen,Dong Hy,20,1,1,0,0
2022-07-01,Thai Nguyen,Thai Nguyen City,1,7,6,1,0
2022-07-01,Thai Nguyen,Thai Nguyen City,6,1,0,1,0
2022-07-01,Thai Nguyen,Thai Nguyen City,7,92,86,6,1
2022-07-01,Thai Nguyen,Thai Nguyen City,8,142,129,13,0
2022-07-01,Thai Nguyen,Thai Nguyen City,9,165,146,19,2
2022-07-01,Thai Nguyen,Thai Nguyen City,10,188,171,17,0
2022-07-01,Thai Nguyen,Thai Nguyen City,11,435,407,28,1
2022-07-01,Thai Nguyen,Thai Nguyen City,12,251,239,12,1
2022-07-01,Thai Nguyen,Thai Nguyen City,13,182,161,21,1
2022-07-01,Thai Nguyen,Thai Nguyen City,14,171,154,17,2
2022-07-01,Thai Nguyen,Thai Nguyen City,15,165,147,18,0
2022-07-01,Thai Nguyen,Thai Nguyen City,16,136,128,8,0
2022-07-01,Thai Nguyen,Thai Nguyen City,17,146,133,13,1
2022-07-01,Thai Nguyen,Thai Nguyen City,18,184,174,10,1
2022-07-01,Thai Nguyen,Thai Nguyen City,19,244,213,31,5
2022-07-01,Thai Nguyen,Thai Nguyen City,20,190,169,21,0
2022-07-01,Thai Nguyen,Thai Nguyen City,21,138,118,20,6
2022-07-01,Thai Nguyen,Thai Nguyen City,23,1,0,1,0
2022-07-01,Vung Tau,Ba Ria City,7,1,0,1,1
2022-07-01,Vung Tau,Ba Ria City,8,3,0,3,3
2022-07-01,Vung Tau,Ba Ria City,9,7,5,2,2
2022-07-01,Vung Tau,Ba Ria City,10,4,2,2,1
2022-07-01,Vung Tau,Ba Ria City,11,8,3,5,4
2022-07-01,Vung Tau,Ba Ria City,12,4,3,1,0
2022-07-01,Vung Tau,Ba Ria City,13,6,5,1,0
2022-07-01,Vung Tau,Ba Ria City,14,10,3,7,7
2022-07-01,Vung Tau,Ba Ria City,15,7,2,5,4
2022-07-01,Vung Tau,Ba Ria City,16,5,3,2,2
2022-07-01,Vung Tau,Ba Ria City,17,11,4,7,4
2022-07-01,Vung Tau,Ba Ria City,18,4,1,3,3
2022-07-01,Vung Tau,Ba Ria City,19,9,0,9,8
2022-07-01,Vung Tau,Ba Ria City,20,10,0,10,8
2022-07-01,Vung Tau,Ba Ria City,21,2,0,2,2
2022-07-01,Vung Tau,Chau Duc,14,1,0,1,1
2022-07-01,Vung Tau,Vung Tau City,3,2,1,1,1
2022-07-01,Vung Tau,Vung Tau City,5,1,0,1,1
2022-07-01,Vung Tau,Vung Tau City,6,41,32,9,4
2022-07-01,Vung Tau,Vung Tau City,7,106,94,12,7
2022-07-01,Vung Tau,Vung Tau City,8,203,183,20,2
2022-07-01,Vung Tau,Vung Tau City,9,153,144,9,2
2022-07-01,Vung Tau,Vung Tau City,10,215,194,21,4
2022-07-01,Vung Tau,Vung Tau City,11,364,335,29,7
2022-07-01,Vung Tau,Vung Tau City,12,289,276,13,2
2022-07-01,Vung Tau,Vung Tau City,13,245,229,16,3
2022-07-01,Vung Tau,Vung Tau City,14,243,228,15,0
2022-07-01,Vung Tau,Vung Tau City,15,230,207,23,6
2022-07-01,Vung Tau,Vung Tau City,16,242,211,31,7
2022-07-01,Vung Tau,Vung Tau City,17,285,261,24,3
2022-07-01,Vung Tau,Vung Tau City,18,321,289,32,12
2022-07-01,Vung Tau,Vung Tau City,19,258,234,24,8
2022-07-01,Vung Tau,Vung Tau City,20,182,165,17,5
2022-07-01,Vung Tau,Vung Tau City,21,113,83,30,9
2022-07-01,Vung Tau,Vung Tau City,23,4,3,1,1
2022-07-02,Bac Ninh,Bác Ninh City,1,1,1,0,0
2022-07-02,Bac Ninh,Bác Ninh City,5,1,1,0,0
2022-07-02,Bac Ninh,Bác Ninh City,6,4,3,1,0
2022-07-02,Bac Ninh,Bác Ninh City,7,68,58,10,1
2022-07-02,Bac Ninh,Bác Ninh City,8,128,116,12,2
2022-07-02,Bac Ninh,Bác Ninh City,9,118,113,5,0
2022-07-02,Bac Ninh,Bác Ninh City,10,195,180,15,0
2022-07-02,Bac Ninh,Bác Ninh City,11,377,339,38,14
2022-07-02,Bac Ninh,Bác Ninh City,12,253,228,25,3
2022-07-02,Bac Ninh,Bác Ninh City,13,179,165,14,0
2022-07-02,Bac Ninh,Bác Ninh City,14,159,143,16,2
2022-07-02,Bac Ninh,Bác Ninh City,15,131,113,18,4
2022-07-02,Bac Ninh,Bác Ninh City,16,112,105,7,0
2022-07-02,Bac Ninh,Bác Ninh City,17,141,125,16,1
2022-07-02,Bac Ninh,Bác Ninh City,18,187,173,14,2
2022-07-02,Bac Ninh,Bác Ninh City,19,189,107,82,63
2022-07-02,Bac Ninh,Bác Ninh City,20,242,71,171,141
2022-07-02,Bac Ninh,Bác Ninh City,21,149,44,105,84
2022-07-02,Bac Ninh,Bác Ninh City,22,1,0,1,0
2022-07-02,Bac Ninh,Bác Ninh City,23,1,0,1,0
2022-07-02,Bac Ninh,Que Vo,8,2,1,1,1
2022-07-02,Bac Ninh,Que Vo,11,1,0,1,1
2022-07-02,Bac Ninh,Que Vo,12,2,1,1,1
2022-07-02,Bac Ninh,Que Vo,13,3,1,2,1
2022-07-02,Bac Ninh,Que Vo,15,1,0,1,1
2022-07-02,Bac Ninh,Que Vo,17,1,0,1,1
2022-07-02,Bac Ninh,Que Vo,18,1,0,1,1
2022-07-02,Bac Ninh,Que Vo,19,3,0,3,2
2022-07-02,Bac Ninh,Tien Du,8,2,0,2,2
2022-07-02,Bac Ninh,Tien Du,9,1,0,1,1
2022-07-02,Bac Ninh,Tien Du,10,2,0,2,2
2022-07-02,Bac Ninh,Tien Du,11,1,0,1,0
2022-07-02,Bac Ninh,Tien Du,13,1,0,1,1
2022-07-02,Bac Ninh,Tien Du,14,1,0,1,1
2022-07-02,Bac Ninh,Tien Du,16,3,0,3,3
2022-07-02,Bac Ninh,Tien Du,17,7,0,7,5
2022-07-02,Bac Ninh,Tien Du,18,2,0,2,2
2022-07-02,Bac Ninh,Tien Du,19,4,0,4,3
2022-07-02,Bac Ninh,Tien Du,20,2,0,2,1
2022-07-02,Bac Ninh,Tien Du,21,1,0,1,1
2022-07-02,Bac Ninh,Tu Son,8,1,0,1,1
2022-07-02,Bac Ninh,Tu Son,10,1,0,1,1
2022-07-02,Bac Ninh,Tu Son,11,1,0,1,1
2022-07-02,Bac Ninh,Tu Son,13,2,0,2,1
2022-07-02,Bac Ninh,Tu Son,18,2,0,2,2
2022-07-02,Binh Duong,Ben Cat,8,4,0,4,4
2022-07-02,Binh Duong,Ben Cat,9,3,0,3,3
2022-07-02,Binh Duong,Ben Cat,10,2,0,2,2
2022-07-02,Binh Duong,Ben Cat,11,1,0,1,1
2022-07-02,Binh Duong,Ben Cat,12,2,0,2,2
2022-07-02,Binh Duong,Ben Cat,13,3,0,3,3
2022-07-02,Binh Duong,Ben Cat,16,1,0,1,1
2022-07-02,Binh Duong,Ben Cat,19,1,1,0,0
2022-07-02,Binh Duong,Ben Cat,20,2,0,2,1
2022-07-02,Binh Duong,Di An,7,12,0,12,11
2022-07-02,Binh Duong,Di An,8,33,14,19,16
2022-07-02,Binh Duong,Di An,9,25,16,9,6
2022-07-02,Binh Duong,Di An,10,41,30,11,9
2022-07-02,Binh Duong,Di An,11,48,36,12,8
2022-07-02,Binh Duong,Di An,12,56,35,21,14
2022-07-02,Binh Duong,Di An,13,33,22,11,7
2022-07-02,Binh Duong,Di An,14,29,22,7,6
2022-07-02,Binh Duong,Di An,15,36,27,9,5
2022-07-02,Binh Duong,Di An,16,25,16,9,4
2022-07-02,Binh Duong,Di An,17,41,27,14,7
2022-07-02,Binh Duong,Di An,18,36,28,8,7
2022-07-02,Binh Duong,Di An,19,25,21,4,3
2022-07-02,Binh Duong,Di An,20,24,16,8,4
2022-07-02,Binh Duong,Di An,21,13,5,8,6
2022-07-02,Binh Duong,Tan Uyen,8,2,1,1,1
2022-07-02,Binh Duong,Tan Uyen,9,3,0,3,3
2022-07-02,Binh Duong,Tan Uyen,10,6,1,5,3
2022-07-02,Binh Duong,Tan Uyen,11,2,2,0,0
2022-07-02,Binh Duong,Tan Uyen,12,4,3,1,0
2022-07-02,Binh Duong,Tan Uyen,13,3,1,2,2
2022-07-02,Binh Duong,Tan Uyen,14,2,1,1,0
2022-07-02,Binh Duong,Tan Uyen,15,3,1,2,1
2022-07-02,Binh Duong,Tan Uyen,17,5,3,2,1
2022-07-02,Binh Duong,Tan Uyen,18,3,1,2,1
2022-07-02,Binh Duong,Tan Uyen,19,3,0,3,3
2022-07-02,Binh Duong,Tan Uyen,20,5,1,4,3
2022-07-02,Binh Duong,Tan Uyen,21,1,0,1,1
2022-07-02,Binh Duong,Thu Dau Mot Town,4,1,0,1,1
2022-07-02,Binh Duong,Thu Dau Mot Town,5,1,0,1,1
2022-07-02,Binh Duong,Thu Dau Mot Town,6,54,40,14,10
2022-07-02,Binh Duong,Thu Dau Mot Town,7,122,116,6,4
2022-07-02,Binh Duong,Thu Dau Mot Town,8,246,226,20,5
2022-07-02,Binh Duong,Thu Dau Mot Town,9,249,223,26,9
2022-07-02,Binh Duong,Thu Dau Mot Town,10,400,359,41,9
2022-07-02,Binh Duong,Thu Dau Mot Town,11,545,500,45,12
2022-07-02,Binh Duong,Thu Dau Mot Town,12,507,466,41,16
2022-07-02,Binh Duong,Thu Dau Mot Town,13,422,385,37,12
2022-07-02,Binh Duong,Thu Dau Mot Town,14,346,322,24,4
2022-07-02,Binh Duong,Thu Dau Mot Town,15,348,322,26,8
2022-07-02,Binh Duong,Thu Dau Mot Town,16,282,257,25,12
2022-07-02,Binh Duong,Thu Dau Mot Town,17,404,376,28,10
2022-07-02,Binh Duong,Thu Dau Mot Town,18,431,395,36,13
2022-07-02,Binh Duong,Thu Dau Mot Town,19,368,332,36,8
2022-07-02,Binh Duong,Thu Dau Mot Town,20,313,280,33,10
2022-07-02,Binh Duong,Thu Dau Mot Town,21,152,122,30,7
2022-07-02,Binh Duong,Thu Dau Mot Town,22,2,0,2,0
2022-07-02,Binh Duong,Thu Dau Mot Town,23,2,1,1,0
2022-07-02,Binh Duong,Thuan An,0,1,0,1,1
2022-07-02,Binh Duong,Thuan An,1,1,1,0,0
2022-07-02,Binh Duong,Thuan An,6,1,1,0,0
2022-07-02,Binh Duong,Thuan An,7,13,7,6,5
2022-07-02,Binh Duong,Thuan An,8,23,17,6,3
2022-07-02,Binh Duong,Thuan An,9,41,24,17,5
2022-07-02,Binh Duong,Thuan An,10,55,49,6,5
2022-07-02,Binh Duong,Thuan An,11,80,67,13,4
2022-07-02,Binh Duong,Thuan An,12,52,48,4,1
2022-07-02,Binh Duong,Thuan An,13,65,48,17,7
2022-07-02,Binh Duong,Thuan An,14,53,47,6,1
2022-07-02,Binh Duong,Thuan An,15,35,30,5,2
2022-07-02,Binh Duong,Thuan An,16,41,32,9,7
2022-07-02,Binh Duong,Thuan An,17,44,40,4,1
2022-07-02,Binh Duong,Thuan An,18,43,38,5,1
2022-07-02,Binh Duong,Thuan An,19,55,44,11,3
2022-07-02,Binh Duong,Thuan An,20,57,39,18,11
2022-07-02,Binh Duong,Thuan An,21,14,8,6,3
2022-07-02,Binh Duong,Thuan An,23,2,1,1,0
2022-07-02,Can Tho City,Binh Thuy District,7,4,3,1,0
2022-07-02,Can Tho City,Binh Thuy District,8,7,4,3,0
2022-07-02,Can Tho City,Binh Thuy District,9,9,7,2,0
2022-07-02,Can Tho City,Binh Thuy District,10,9,9,0,0
2022-07-02,Can Tho City,Binh Thuy District,11,18,15,3,2
2022-07-02,Can Tho City,Binh Thuy District,12,12,11,1,0
2022-07-02,Can Tho City,Binh Thuy District,13,11,11,0,0
2022-07-02,Can Tho City,Binh Thuy District,14,13,11,2,0
2022-07-02,Can Tho City,Binh Thuy District,15,4,3,1,0
2022-07-02,Can Tho City,Binh Thuy District,16,13,12,1,1
2022-07-02,Can Tho City,Binh Thuy District,17,8,6,2,0
2022-07-02,Can Tho City,Binh Thuy District,18,22,19,3,0
2022-07-02,Can Tho City,Binh Thuy District,19,10,10,0,0
2022-07-02,Can Tho City,Binh Thuy District,20,12,10,2,2
2022-07-02,Can Tho City,Binh Thuy District,21,2,2,0,0
2022-07-02,Can Tho City,Cai Rang District,6,1,1,0,0
2022-07-02,Can Tho City,Cai Rang District,7,5,3,2,1
2022-07-02,Can Tho City,Cai Rang District,8,10,8,2,1
2022-07-02,Can Tho City,Cai Rang District,9,15,14,1,1
2022-07-02,Can Tho City,Cai Rang District,10,9,8,1,0
2022-07-02,Can Tho City,Cai Rang District,11,21,20,1,0
2022-07-02,Can Tho City,Cai Rang District,12,11,9,2,1
2022-07-02,Can Tho City,Cai Rang District,13,11,10,1,0
2022-07-02,Can Tho City,Cai Rang District,14,4,4,0,0
2022-07-02,Can Tho City,Cai Rang District,15,16,13,3,3
2022-07-02,Can Tho City,Cai Rang District,16,11,9,2,0
2022-07-02,Can Tho City,Cai Rang District,17,12,10,2,0
2022-07-02,Can Tho City,Cai Rang District,18,13,13,0,0
2022-07-02,Can Tho City,Cai Rang District,19,6,6,0,0
2022-07-02,Can Tho City,Cai Rang District,20,13,12,1,0
2022-07-02,Can Tho City,Cai Rang District,21,5,3,2,1
2022-07-02,Can Tho City,Cai Rang District,22,1,0,1,1
2022-07-02,Can Tho City,Ninh Kieu District,0,2,2,0,0
2022-07-02,Can Tho City,Ninh Kieu District,1,2,2,0,0
2022-07-02,Can Tho City,Ninh Kieu District,2,4,3,1,0
2022-07-02,Can Tho City,Ninh Kieu District,5,1,1,0,0
2022-07-02,Can Tho City,Ninh Kieu District,6,51,45,6,2
2022-07-02,Can Tho City,Ninh Kieu District,7,146,129,17,6
2022-07-02,Can Tho City,Ninh Kieu District,8,243,231,12,2
2022-07-02,Can Tho City,Ninh Kieu District,9,323,307,16,0
2022-07-02,Can Tho City,Ninh Kieu District,10,477,458,19,0
2022-07-02,Can Tho City,Ninh Kieu District,11,727,684,43,7
2022-07-02,Can Tho City,Ninh Kieu District,12,636,610,26,0
2022-07-02,Can Tho City,Ninh Kieu District,13,521,499,22,0
2022-07-02,Can Tho City,Ninh Kieu District,14,402,384,18,0
2022-07-02,Can Tho City,Ninh Kieu District,15,414,380,34,0
2022-07-02,Can Tho City,Ninh Kieu District,16,423,408,15,0
2022-07-02,Can Tho City,Ninh Kieu District,17,463,443,20,0
2022-07-02,Can Tho City,Ninh Kieu District,18,539,515,24,0
2022-07-02,Can Tho City,Ninh Kieu District,19,433,413,20,0
2022-07-02,Can Tho City,Ninh Kieu District,20,345,320,25,0
2022-07-02,Can Tho City,Ninh Kieu District,21,212,199,13,1
2022-07-02,Can Tho City,Ninh Kieu District,22,2,2,0,0
2022-07-02,Can Tho City,Ninh Kieu District,23,4,2,2,0
2022-07-02,Dong Nai,Bien Hoa City,0,5,2,3,1
2022-07-02,Dong Nai,Bien Hoa City,1,5,2,3,0
2022-07-02,Dong Nai,Bien Hoa City,2,2,0,2,0
2022-07-02,Dong Nai,Bien Hoa City,4,1,0,1,0
2022-07-02,Dong Nai,Bien Hoa City,6,51,37,14,7
2022-07-02,Dong Nai,Bien Hoa City,7,181,159,22,18
2022-07-02,Dong Nai,Bien Hoa City,8,326,297,29,5
2022-07-02,Dong Nai,Bien Hoa City,9,492,444,48,15
2022-07-02,Dong Nai,Bien Hoa City,10,765,693,72,13
2022-07-02,Dong Nai,Bien Hoa City,11,1064,985,79,8
2022-07-02,Dong Nai,Bien Hoa City,12,911,853,58,12
2022-07-02,Dong Nai,Bien Hoa City,13,786,739,47,7
2022-07-02,Dong Nai,Bien Hoa City,14,573,525,48,17
2022-07-02,Dong Nai,Bien Hoa City,15,587,513,74,21
2022-07-02,Dong Nai,Bien Hoa City,16,561,523,38,8
2022-07-02,Dong Nai,Bien Hoa City,17,710,630,80,18
2022-07-02,Dong Nai,Bien Hoa City,18,777,695,82,18
2022-07-02,Dong Nai,Bien Hoa City,19,773,676,97,30
2022-07-02,Dong Nai,Bien Hoa City,20,589,501,88,31
2022-07-02,Dong Nai,Bien Hoa City,21,285,204,81,31
2022-07-02,Dong Nai,Bien Hoa City,23,2,1,1,0
2022-07-02,Dong Nai,Long Khanh,12,1,0,1,0
2022-07-02,Dong Nai,Long Thanh,9,2,0,2,1
2022-07-02,Dong Nai,Long Thanh,10,1,1,0,0
2022-07-02,Dong Nai,Long Thanh,11,1,0,1,0
2022-07-02,Dong Nai,Long Thanh,16,1,0,1,1
2022-07-02,Dong Nai,Long Thanh,18,3,0,3,3
2022-07-02,Dong Nai,Nhon trach,14,1,0,1,1
2022-07-02,Dong Nai,Trang Bom,13,3,1,2,2
2022-07-02,Dong Nai,Trang Bom,20,2,0,2,2
2022-07-02,Hai Phong City,An Duong,7,1,0,1,1
2022-07-02,Hai Phong City,An Duong,8,2,1,1,1
2022-07-02,Hai Phong City,An Duong,9,2,1,1,1
2022-07-02,Hai Phong City,An Duong,10,3,1,2,2
2022-07-02,Hai Phong City,An Duong,11,9,4,5,5
2022-07-02,Hai Phong City,An Duong,12,8,2,6,6
2022-07-02,Hai Phong City,An Duong,13,1,0,1,1
2022-07-02,Hai Phong City,An Duong,14,4,0,4,2
2022-07-02,Hai Phong City,An Duong,15,1,1,0,0
2022-07-02,Hai Phong City,An Duong,16,2,2,0,0
2022-07-02,Hai Phong City,An Duong,17,6,2,4,2
2022-07-02,Hai Phong City,An Duong,18,2,0,2,1
2022-07-02,Hai Phong City,An Duong,19,2,0,2,2
2022-07-02,Hai Phong City,An Duong,21,3,0,3,2
2022-07-02,Hai Phong City,Do Son District,11,1,0,1,1
2022-07-02,Hai Phong City,Do Son District,12,1,0,1,1
2022-07-02,Hai Phong City,Do Son District,15,1,0,1,1
2022-07-02,Hai Phong City,Do Son District,19,2,0,2,2
2022-07-02,Hai Phong City,Do Son District,20,1,0,1,1
2022-07-02,Hai Phong City,Duong Kinh District,16,1,0,1,1
2022-07-02,Hai Phong City,Duong Kinh District,17,2,0,2,2
2022-07-02,Hai Phong City,Hai An District,7,7,5,2,0
2022-07-02,Hai Phong City,Hai An District,8,13,11,2,0
2022-07-02,Hai Phong City,Hai An District,9,13,10,3,0
2022-07-02,Hai Phong City,Hai An District,10,20,18,2,0
2022-07-02,Hai Phong City,Hai An District,11,33,30,3,0
2022-07-02,Hai Phong City,Hai An District,12,38,36,2,0
2022-07-02,Hai Phong City,Hai An District,13,15,14,1,0
2022-07-02,Hai Phong City,Hai An District,14,12,10,2,2
2022-07-02,Hai Phong City,Hai An District,15,11,8,3,1
2022-07-02,Hai Phong City,Hai An District,16,17,15,2,2
2022-07-02,Hai Phong City,Hai An District,17,22,18,4,0
2022-07-02,Hai Phong City,Hai An District,18,18,10,8,6
2022-07-02,Hai Phong City,Hai An District,19,25,9,16,13
2022-07-02,Hai Phong City,Hai An District,20,21,11,10,4
2022-07-02,Hai Phong City,Hai An District,21,16,8,8,7
2022-07-02,Hai Phong City,Hong Bang District,7,18,14,4,2
2022-07-02,Hai Phong City,Hong Bang District,8,42,34,8,3
2022-07-02,Hai Phong City,Hong Bang District,9,37,30,7,1
2022-07-02,Hai Phong City,Hong Bang District,10,64,60,4,2
2022-07-02,Hai Phong City,Hong Bang District,11,101,90,11,6
2022-07-02,Hai Phong City,Hong Bang District,12,76,63,13,5
2022-07-02,Hai Phong City,Hong Bang District,13,47,39,8,2
2022-07-02,Hai Phong City,Hong Bang District,14,36,32,4,0
2022-07-02,Hai Phong City,Hong Bang District,15,44,30,14,11
2022-07-02,Hai Phong City,Hong Bang District,16,43,33,10,3
2022-07-02,Hai Phong City,Hong Bang District,17,70,56,14,3
2022-07-02,Hai Phong City,Hong Bang District,18,66,32,34,25
2022-07-02,Hai Phong City,Hong Bang District,19,89,29,60,52
2022-07-02,Hai Phong City,Hong Bang District,20,56,23,33,22
2022-07-02,Hai Phong City,Hong Bang District,21,24,13,11,8
2022-07-02,Hai Phong City,Kien An District,7,1,0,1,1
2022-07-02,Hai Phong City,Kien An District,8,3,2,1,1
2022-07-02,Hai Phong City,Kien An District,9,11,8,3,1
2022-07-02,Hai Phong City,Kien An District,10,10,5,5,3
2022-07-02,Hai Phong City,Kien An District,11,14,14,0,0
2022-07-02,Hai Phong City,Kien An District,12,12,12,0,0
2022-07-02,Hai Phong City,Kien An District,13,5,5,0,0
2022-07-02,Hai Phong City,Kien An District,14,11,9,2,0
2022-07-02,Hai Phong City,Kien An District,15,8,6,2,1
2022-07-02,Hai Phong City,Kien An District,16,9,7,2,0
2022-07-02,Hai Phong City,Kien An District,17,5,5,0,0
2022-07-02,Hai Phong City,Kien An District,18,15,9,6,6
2022-07-02,Hai Phong City,Kien An District,19,15,7,8,4
2022-07-02,Hai Phong City,Kien An District,20,11,6,5,3
2022-07-02,Hai Phong City,Kien An District,21,8,0,8,5
2022-07-02,Hai Phong City,Le Chan District,0,1,1,0,0
2022-07-02,Hai Phong City,Le Chan District,2,1,0,1,0
2022-07-02,Hai Phong City,Le Chan District,6,1,0,1,0
2022-07-02,Hai Phong City,Le Chan District,7,25,15,10,8
2022-07-02,Hai Phong City,Le Chan District,8,97,79,18,9
2022-07-02,Hai Phong City,Le Chan District,9,120,101,19,2
2022-07-02,Hai Phong City,Le Chan District,10,205,184,21,5
2022-07-02,Hai Phong City,Le Chan District,11,299,270,29,8
2022-07-02,Hai Phong City,Le Chan District,12,224,194,30,8
2022-07-02,Hai Phong City,Le Chan District,13,124,113,11,3
2022-07-02,Hai Phong City,Le Chan District,14,139,121,18,2
2022-07-02,Hai Phong City,Le Chan District,15,158,108,50,29
2022-07-02,Hai Phong City,Le Chan District,16,172,145,27,9
2022-07-02,Hai Phong City,Le Chan District,17,198,166,32,3
2022-07-02,Hai Phong City,Le Chan District,18,219,140,79,57
2022-07-02,Hai Phong City,Le Chan District,19,250,116,134,112
2022-07-02,Hai Phong City,Le Chan District,20,210,104,106,68
2022-07-02,Hai Phong City,Le Chan District,21,88,53,35,15
2022-07-02,Hai Phong City,Le Chan District,22,1,0,1,0
2022-07-02,Hai Phong City,Le Chan District,23,1,0,1,0
2022-07-02,Hai Phong City,Ngo Quyen District,0,1,0,1,0
2022-07-02,Hai Phong City,Ngo Quyen District,7,36,28,8,4
2022-07-02,Hai Phong City,Ngo Quyen District,8,77,61,16,2
2022-07-02,Hai Phong City,Ngo Quyen District,9,84,67,17,4
2022-07-02,Hai Phong City,Ngo Quyen District,10,137,123,14,1
2022-07-02,Hai Phong City,Ngo Quyen District,11,257,233,24,4
2022-07-02,Hai Phong City,Ngo Quyen District,12,156,142,14,5
2022-07-02,Hai Phong City,Ngo Quyen District,13,107,100,7,0
2022-07-02,Hai Phong City,Ngo Quyen District,14,106,89,17,3
2022-07-02,Hai Phong City,Ngo Quyen District,15,131,93,38,21
2022-07-02,Hai Phong City,Ngo Quyen District,16,129,108,21,7
2022-07-02,Hai Phong City,Ngo Quyen District,17,164,136,28,6
2022-07-02,Hai Phong City,Ngo Quyen District,18,157,94,63,37
2022-07-02,Hai Phong City,Ngo Quyen District,19,224,111,113,91
2022-07-02,Hai Phong City,Ngo Quyen District,20,168,96,72,49
2022-07-02,Hai Phong City,Ngo Quyen District,21,102,68,34,16
2022-07-02,Hai Phong City,Ngo Quyen District,22,3,0,3,0
2022-07-02,Hai Phong City,Thuy Nguyen,11,3,0,3,3
2022-07-02,Hai Phong City,Thuy Nguyen,12,1,0,1,1
2022-07-02,Hai Phong City,Thuy Nguyen,13,1,0,1,1
2022-07-02,Hai Phong City,Thuy Nguyen,14,1,0,1,1
2022-07-02,Hai Phong City,Thuy Nguyen,17,1,0,1,1
2022-07-02,Hai Phong City,Thuy Nguyen,19,1,0,1,1
2022-07-02,Hai Phong City,Thuy Nguyen,20,2,0,2,2
2022-07-02,Hue City,Hue City,1,2,1,1,0
2022-07-02,Hue City,Hue City,5,3,3,0,0
2022-07-02,Hue City,Hue City,6,90,68,22,13
2022-07-02,Hue City,Hue City,7,312,277,35,10
2022-07-02,Hue City,Hue City,8,358,328,30,0
2022-07-02,Hue City,Hue City,9,290,257,33,2
2022-07-02,Hue City,Hue City,10,407,390,17,0
2022-07-02,Hue City,Hue City,11,765,701,64,14
2022-07-02,Hue City,Hue City,12,600,555,45,0
2022-07-02,Hue City,Hue City,13,401,372,29,0
2022-07-02,Hue City,Hue City,14,372,348,24,3
2022-07-02,Hue City,Hue City,15,402,358,44,5
2022-07-02,Hue City,Hue City,16,393,355,38,1
2022-07-02,Hue City,Hue City,17,450,413,37,4
2022-07-02,Hue City,Hue City,18,563,506,57,9
2022-07-02,Hue City,Hue City,19,553,470,83,10
2022-07-02,Hue City,Hue City,20,503,423,80,10
2022-07-02,Hue City,Hue City,21,278,208,70,20
2022-07-02,Hue City,Hue City,22,1,0,1,0
2022-07-02,Hue City,Hue City,23,1,1,0,0
2022-07-02,Hue City,Huong Thuy,7,3,2,1,0
2022-07-02,Hue City,Huong Thuy,9,1,1,0,0
2022-07-02,Hue City,Huong Thuy,10,1,0,1,0
2022-07-02,Hue City,Huong Thuy,11,3,2,1,0
2022-07-02,Hue City,Huong Thuy,14,2,0,2,0
2022-07-02,Hue City,Huong Thuy,16,1,1,0,0
2022-07-02,Hue City,Huong Thuy,17,2,1,1,0
2022-07-02,Hue City,Huong Thuy,18,2,2,0,0
2022-07-02,Hue City,Huong Thuy,19,1,1,0,0
2022-07-02,Hue City,Huong Tra,20,2,1,1,0
2022-07-02,Hue City,Phu Vang,7,4,2,2,1
2022-07-02,Hue City,Phu Vang,9,3,3,0,0
2022-07-02,Hue City,Phu Vang,10,2,1,1,0
2022-07-02,Hue City,Phu Vang,11,3,0,3,1
2022-07-02,Hue City,Phu Vang,12,1,1,0,0
2022-07-02,Hue City,Phu Vang,13,2,2,0,0
2022-07-02,Hue City,Phu Vang,16,1,0,1,1
2022-07-02,Hue City,Phu Vang,17,4,2,2,1
2022-07-02,Hue City,Phu Vang,18,5,2,3,2
2022-07-02,Hue City,Phu Vang,19,3,2,1,0
2022-07-02,Khanh Hoa,Dien Khanh,11,1,0,1,1
2022-07-02,Khanh Hoa,Nha Trang City,2,1,0,1,0
2022-07-02,Khanh Hoa,Nha Trang City,4,1,1,0,0
2022-07-02,Khanh Hoa,Nha Trang City,5,2,1,1,0
2022-07-02,Khanh Hoa,Nha Trang City,6,46,39,7,2
2022-07-02,Khanh Hoa,Nha Trang City,7,115,105,10,0
2022-07-02,Khanh Hoa,Nha Trang City,8,204,190,14,0
2022-07-02,Khanh Hoa,Nha Trang City,9,208,197,11,0
2022-07-02,Khanh Hoa,Nha Trang City,10,212,190,22,1
2022-07-02,Khanh Hoa,Nha Trang City,11,374,341,33,2
2022-07-02,Khanh Hoa,Nha Trang City,12,322,301,21,2
2022-07-02,Khanh Hoa,Nha Trang City,13,296,277,19,2
2022-07-02,Khanh Hoa,Nha Trang City,14,271,243,28,3
2022-07-02,Khanh Hoa,Nha Trang City,15,233,211,22,1
2022-07-02,Khanh Hoa,Nha Trang City,16,246,226,20,0
2022-07-02,Khanh Hoa,Nha Trang City,17,294,271,23,2
2022-07-02,Khanh Hoa,Nha Trang City,18,357,325,32,3
2022-07-02,Khanh Hoa,Nha Trang City,19,331,292,39,4
2022-07-02,Khanh Hoa,Nha Trang City,20,246,212,34,3
2022-07-02,Khanh Hoa,Nha Trang City,21,141,114,27,12
2022-07-02,Khanh Hoa,Nha Trang City,22,2,0,2,0
2022-07-02,Khanh Hoa,Nha Trang City,23,1,0,1,1
2022-07-02,Lam Dong,Da Lat City,6,4,1,3,1
2022-07-02,Lam Dong,Da Lat City,7,57,38,19,15
2022-07-02,Lam Dong,Da Lat City,8,101,82,19,12
2022-07-02,Lam Dong,Da Lat City,9,95,74,21,11
2022-07-02,Lam Dong,Da Lat City,10,108,82,26,18
2022-07-02,Lam Dong,Da Lat City,11,161,85,76,64
2022-07-02,Lam Dong,Da Lat City,12,220,109,111,90
2022-07-02,Lam Dong,Da Lat City,13,179,81,98,84
2022-07-02,Lam Dong,Da Lat City,14,176,80,96,84
2022-07-02,Lam Dong,Da Lat City,15,178,101,77,52
2022-07-02,Lam Dong,Da Lat City,16,201,80,121,102
2022-07-02,Lam Dong,Da Lat City,17,270,103,167,141
2022-07-02,Lam Dong,Da Lat City,18,265,121,144,121
2022-07-02,Lam Dong,Da Lat City,19,231,100,131,110
2022-07-02,Lam Dong,Da Lat City,20,240,93,147,123
2022-07-02,Lam Dong,Da Lat City,21,141,58,83,75
2022-07-02,Lam Dong,Da Lat City,22,3,0,3,0
2022-07-02,Nghe An,Vinh City,0,1,0,1,1
2022-07-02,Nghe An,Vinh City,6,5,2,3,3
2022-07-02,Nghe An,Vinh City,7,122,104,18,4
2022-07-02,Nghe An,Vinh City,8,147,131,16,3
2022-07-02,Nghe An,Vinh City,9,154,127,27,2
2022-07-02,Nghe An,Vinh City,10,245,198,47,20
2022-07-02,Nghe An,Vinh City,11,404,303,101,60
2022-07-02,Nghe An,Vinh City,12,271,229,42,18
2022-07-02,Nghe An,Vinh City,13,146,127,19,4
2022-07-02,Nghe An,Vinh City,14,168,132,36,9
2022-07-02,Nghe An,Vinh City,15,181,151,30,11
2022-07-02,Nghe An,Vinh City,16,159,132,27,12
2022-07-02,Nghe An,Vinh City,17,156,117,39,26
2022-07-02,Nghe An,Vinh City,18,220,163,57,36
2022-07-02,Nghe An,Vinh City,19,196,142,54,33
2022-07-02,Nghe An,Vinh City,20,174,104,70,46
2022-07-02,Nghe An,Vinh City,21,128,57,71,48
2022-07-02,Nghe An,Vinh City,22,1,0,1,0
2022-07-02,Quang Nam,Dien Ban,15,1,0,1,1
2022-07-02,Quang Nam,Dien Ban,16,1,0,1,1
2022-07-02,Quang Nam,Hoi An City,6,1,0,1,1
2022-07-02,Quang Nam,Hoi An City,7,17,10,7,5
2022-07-02,Quang Nam,Hoi An City,8,23,20,3,2
2022-07-02,Quang Nam,Hoi An City,9,24,20,4,0
2022-07-02,Quang Nam,Hoi An City,10,22,17,5,1
2022-07-02,Quang Nam,Hoi An City,11,44,37,7,2
2022-07-02,Quang Nam,Hoi An City,12,52,37,15,11
2022-07-02,Quang Nam,Hoi An City,13,27,22,5,1
2022-07-02,Quang Nam,Hoi An City,14,55,46,9,4
2022-07-02,Quang Nam,Hoi An City,15,38,36,2,1
2022-07-02,Quang Nam,Hoi An City,16,58,48,10,3
2022-07-02,Quang Nam,Hoi An City,17,71,54,17,2
2022-07-02,Quang Nam,Hoi An City,18,63,45,18,11
2022-07-02,Quang Nam,Hoi An City,19,89,54,35,25
2022-07-02,Quang Nam,Hoi An City,20,83,45,38,27
2022-07-02,Quang Nam,Hoi An City,21,42,16,26,21
2022-07-02,Quang Ninh,Cam Pha City,10,1,0,1,1
2022-07-02,Quang Ninh,Cam Pha City,11,1,0,1,1
2022-07-02,Quang Ninh,Cam Pha City,12,2,0,2,1
2022-07-02,Quang Ninh,Cam Pha City,13,1,0,1,1
2022-07-02,Quang Ninh,Cam Pha City,14,3,0,3,2
2022-07-02,Quang Ninh,Cam Pha City,18,3,0,3,1
2022-07-02,Quang Ninh,Ha Long City,1,2,1,1,0
2022-07-02,Quang Ninh,Ha Long City,7,18,12,6,3
2022-07-02,Quang Ninh,Ha Long City,8,40,25,15,2
2022-07-02,Quang Ninh,Ha Long City,9,39,31,8,2
2022-07-02,Quang Ninh,Ha Long City,10,98,68,30,9
2022-07-02,Quang Ninh,Ha Long City,11,153,108,45,34
2022-07-02,Quang Ninh,Ha Long City,12,116,83,33,16
2022-07-02,Quang Ninh,Ha Long City,13,81,59,22,15
2022-07-02,Quang Ninh,Ha Long City,14,80,53,27,17
2022-07-02,Quang Ninh,Ha Long City,15,67,17,50,36
2022-07-02,Quang Ninh,Ha Long City,16,112,42,70,48
2022-07-02,Quang Ninh,Ha Long City,17,91,45,46,30
2022-07-02,Quang Ninh,Ha Long City,18,95,46,49,38
2022-07-02,Quang Ninh,Ha Long City,19,102,39,63,51
2022-07-02,Quang Ninh,Ha Long City,20,103,31,72,59
2022-07-02,Quang Ninh,Ha Long City,21,1,0,1,0
2022-07-02,Thai Nguyen,Dong Hy,11,1,1,0,0
2022-07-02,Thai Nguyen,Dong Hy,21,1,0,1,1
2022-07-02,Thai Nguyen,Pho Yen,10,1,0,1,1
2022-07-02,Thai Nguyen,Thai Nguyen City,0,1,1,0,0
2022-07-02,Thai Nguyen,Thai Nguyen City,2,2,2,0,0
2022-07-02,Thai Nguyen,Thai Nguyen City,6,4,3,1,0
2022-07-02,Thai Nguyen,Thai Nguyen City,7,89,82,7,0
2022-07-02,Thai Nguyen,Thai Nguyen City,8,157,135,22,0
2022-07-02,Thai Nguyen,Thai Nguyen City,9,128,117,11,0
2022-07-02,Thai Nguyen,Thai Nguyen City,10,216,194,22,1
2022-07-02,Thai Nguyen,Thai Nguyen City,11,377,346,31,3
2022-07-02,Thai Nguyen,Thai Nguyen City,12,305,277,28,1
2022-07-02,Thai Nguyen,Thai Nguyen City,13,180,167,13,1
2022-07-02,Thai Nguyen,Thai Nguyen City,14,190,165,25,2
2022-07-02,Thai Nguyen,Thai Nguyen City,15,142,134,8,0
2022-07-02,Thai Nguyen,Thai Nguyen City,16,172,153,19,1
2022-07-02,Thai Nguyen,Thai Nguyen City,17,139,126,13,1
2022-07-02,Thai Nguyen,Thai Nguyen City,18,220,193,27,0
2022-07-02,Thai Nguyen,Thai Nguyen City,19,289,182,107,70
2022-07-02,Thai Nguyen,Thai Nguyen City,20,236,161,75,42
2022-07-02,Thai Nguyen,Thai Nguyen City,21,179,136,43,12
2022-07-02,Thai Nguyen,Thai Nguyen City,22,3,0,3,1
2022-07-02,Vung Tau,Ba Ria City,8,4,0,4,4
2022-07-02,Vung Tau,Ba Ria City,9,13,1,12,12
2022-07-02,Vung Tau,Ba Ria City,10,15,5,10,10
2022-07-02,Vung Tau,Ba Ria City,11,8,5,3,2
2022-07-02,Vung Tau,Ba Ria City,12,8,7,1,0
2022-07-02,Vung Tau,Ba Ria City,13,2,1,1,0
2022-07-02,Vung Tau,Ba Ria City,14,7,2,5,5
2022-07-02,Vung Tau,Ba Ria City,15,4,4,0,0
2022-07-02,Vung Tau,Ba Ria City,16,4,0,4,4
2022-07-02,Vung Tau,Ba Ria City,17,5,3,2,2
2022-07-02,Vung Tau,Ba Ria City,18,10,3,7,5
2022-07-02,Vung Tau,Ba Ria City,19,7,0,7,6
2022-07-02,Vung Tau,Ba Ria City,20,3,0,3,2
2022-07-02,Vung Tau,Chau Duc,8,1,0,1,1
2022-07-02,Vung Tau,Vung Tau City,0,1,0,1,0
2022-07-02,Vung Tau,Vung Tau City,2,1,0,1,0
2022-07-02,Vung Tau,Vung Tau City,5,2,2,0,0
2022-07-02,Vung Tau,Vung Tau City,6,46,33,13,5
2022-07-02,Vung Tau,Vung Tau City,7,120,111,9,2
2022-07-02,Vung Tau,Vung Tau City,8,225,202,23,3
2022-07-02,Vung Tau,Vung Tau City,9,212,198,14,2
2022-07-02,Vung Tau,Vung Tau City,10,271,244,27,6
2022-07-02,Vung Tau,Vung Tau City,11,408,349,59,17
2022-07-02,Vung Tau,Vung Tau City,12,365,338,27,2
2022-07-02,Vung Tau,Vung Tau City,13,239,224,15,4
2022-07-02,Vung Tau,Vung Tau City,14,300,271,29,10
2022-07-02,Vung Tau,Vung Tau City,15,235,220,15,4
2022-07-02,Vung Tau,Vung Tau City,16,254,228,26,2
2022-07-02,Vung Tau,Vung Tau City,17,299,269,30,3
2022-07-02,Vung Tau,Vung Tau City,18,328,299,29,5
2022-07-02,Vung Tau,Vung Tau City,19,287,253,34,11
2022-07-02,Vung Tau,Vung Tau City,20,227,189,38,8
2022-07-02,Vung Tau,Vung Tau City,21,144,107,37,11
2022-07-02,Vung Tau,Vung Tau City,22,1,0,1,0
2022-07-03,Bac Ninh,Bác Ninh City,2,1,1,0,0
2022-07-03,Bac Ninh,Bác Ninh City,6,4,3,1,0
2022-07-03,Bac Ninh,Bác Ninh City,7,57,46,11,2
2022-07-03,Bac Ninh,Bác Ninh City,8,117,108,9,1
2022-07-03,Bac Ninh,Bác Ninh City,9,134,123,11,0
2022-07-03,Bac Ninh,Bác Ninh City,10,214,194,20,1
2022-07-03,Bac Ninh,Bác Ninh City,11,336,288,48,12
2022-07-03,Bac Ninh,Bác Ninh City,12,245,215,30,5
2022-07-03,Bac Ninh,Bác Ninh City,13,182,158,24,2
2022-07-03,Bac Ninh,Bác Ninh City,14,162,145,17,1
2022-07-03,Bac Ninh,Bác Ninh City,15,158,139,19,2
2022-07-03,Bac Ninh,Bác Ninh City,16,127,113,14,2
2022-07-03,Bac Ninh,Bác Ninh City,17,122,112,10,1
2022-07-03,Bac Ninh,Bác Ninh City,18,190,169,21,7
2022-07-03,Bac Ninh,Bác Ninh City,19,201,174,27,8
2022-07-03,Bac Ninh,Bác Ninh City,20,148,132,16,6
2022-07-03,Bac Ninh,Bác Ninh City,21,100,89,11,1
2022-07-03,Bac Ninh,Bác Ninh City,22,2,0,2,0
2022-07-03,Bac Ninh,Que Vo,7,1,0,1,1
2022-07-03,Bac Ninh,Que Vo,8,1,0,1,1
2022-07-03,Bac Ninh,Que Vo,9,2,1,1,1
2022-07-03,Bac Ninh,Que Vo,10,3,1,2,0
2022-07-03,Bac Ninh,Que Vo,11,2,0,2,2
2022-07-03,Bac Ninh,Que Vo,12,4,0,4,4
2022-07-03,Bac Ninh,Que Vo,14,4,0,4,4
2022-07-03,Bac Ninh,Que Vo,16,5,0,5,5
2022-07-03,Bac Ninh,Que Vo,18,1,0,1,1
2022-07-03,Bac Ninh,Que Vo,19,1,0,1,1
2022-07-03,Bac Ninh,Tien Du,1,1,0,1,1
2022-07-03,Bac Ninh,Tien Du,10,8,0,8,3
2022-07-03,Bac Ninh,Tien Du,11,1,0,1,1
2022-07-03,Bac Ninh,Tien Du,12,1,0,1,1
2022-07-03,Bac Ninh,Tien Du,17,2,0,2,1
2022-07-03,Bac Ninh,Tien Du,18,4,0,4,4
2022-07-03,Bac Ninh,Tu Son,10,3,0,3,3
2022-07-03,Bac Ninh,Tu Son,11,3,0,3,2
2022-07-03,Bac Ninh,Tu Son,12,3,0,3,3
2022-07-03,Bac Ninh,Tu Son,13,2,0,2,2
2022-07-03,Bac Ninh,Tu Son,14,3,0,3,3
2022-07-03,Bac Ninh,Tu Son,15,1,0,1,1
2022-07-03,Bac Ninh,Tu Son,17,1,0,1,1
2022-07-03,Bac Ninh,Tu Son,18,1,0,1,1
2022-07-03,Bac Ninh,Tu Son,19,1,0,1,1
2022-07-03,Bac Ninh,Tu Son,20,3,0,3,1
2022-07-03,Bac Ninh,Tu Son,21,2,0,2,2
2022-07-03,Binh Duong,Ben Cat,9,3,0,3,2
2022-07-03,Binh Duong,Ben Cat,12,4,0,4,2
2022-07-03,Binh Duong,Ben Cat,13,2,0,2,1
2022-07-03,Binh Duong,Ben Cat,14,2,0,2,1
2022-07-03,Binh Duong,Di An,7,7,2,5,4
2022-07-03,Binh Duong,Di An,8,17,8,9,3
2022-07-03,Binh Duong,Di An,9,36,21,15,11
2022-07-03,Binh Duong,Di An,10,46,18,28,23
2022-07-03,Binh Duong,Di An,11,38,23,15,9
2022-07-03,Binh Duong,Di An,12,41,32,9,5
2022-07-03,Binh Duong,Di An,13,52,28,24,14
2022-07-03,Binh Duong,Di An,14,42,27,15,7
2022-07-03,Binh Duong,Di An,15,31,22,9,7
2022-07-03,Binh Duong,Di An,16,28,17,11,7
2022-07-03,Binh Duong,Di An,17,42,29,13,6
2022-07-03,Binh Duong,Di An,18,27,18,9,5
2022-07-03,Binh Duong,Di An,19,53,27,26,22
2022-07-03,Binh Duong,Di An,20,20,12,8,4
2022-07-03,Binh Duong,Di An,21,5,4,1,1
2022-07-03,Binh Duong,Tan Uyen,8,2,0,2,1
2022-07-03,Binh Duong,Tan Uyen,9,2,0,2,0
2022-07-03,Binh Duong,Tan Uyen,10,1,0,1,1
2022-07-03,Binh Duong,Tan Uyen,11,2,1,1,1
2022-07-03,Binh Duong,Tan Uyen,12,2,2,0,0
2022-07-03,Binh Duong,Tan Uyen,13,5,2,3,3
2022-07-03,Binh Duong,Tan Uyen,15,3,1,2,2
2022-07-03,Binh Duong,Tan Uyen,17,1,1,0,0
2022-07-03,Binh Duong,Tan Uyen,18,3,2,1,0
2022-07-03,Binh Duong,Tan Uyen,19,10,3,7,5
2022-07-03,Binh Duong,Tan Uyen,20,2,0,2,2
2022-07-03,Binh Duong,Thu Dau Mot Town,2,1,0,1,0
2022-07-03,Binh Duong,Thu Dau Mot Town,5,2,1,1,0
2022-07-03,Binh Duong,Thu Dau Mot Town,6,46,40,6,2
2022-07-03,Binh Duong,Thu Dau Mot Town,7,142,123,19,5
2022-07-03,Binh Duong,Thu Dau Mot Town,8,240,221,19,2
2022-07-03,Binh Duong,Thu Dau Mot Town,9,320,288,32,7
2022-07-03,Binh Duong,Thu Dau Mot Town,10,385,327,58,17
2022-07-03,Binh Duong,Thu Dau Mot Town,11,566,490,76,37
2022-07-03,Binh Duong,Thu Dau Mot Town,12,500,456,44,10
2022-07-03,Binh Duong,Thu Dau Mot Town,13,416,381,35,10
2022-07-03,Binh Duong,Thu Dau Mot Town,14,364,327,37,17
2022-07-03,Binh Duong,Thu Dau Mot Town,15,357,330,27,6
2022-07-03,Binh Duong,Thu Dau Mot Town,16,339,308,31,6
2022-07-03,Binh Duong,Thu Dau Mot Town,17,412,381,31,5
2022-07-03,Binh Duong,Thu Dau Mot Town,18,437,402,35,12
2022-07-03,Binh Duong,Thu Dau Mot Town,19,416,384,32,9
2022-07-03,Binh Duong,Thu Dau Mot Town,20,290,250,40,15
2022-07-03,Binh Duong,Thu Dau Mot Town,21,127,104,23,5
2022-07-03,Binh Duong,Thu Dau Mot Town,22,1,0,1,0
2022-07-03,Binh Duong,Thuan An,0,3,2,1,0
2022-07-03,Binh Duong,Thuan An,5,2,0,2,0
2022-07-03,Binh Duong,Thuan An,6,1,0,1,1
2022-07-03,Binh Duong,Thuan An,7,12,5,7,4
2022-07-03,Binh Duong,Thuan An,8,24,17,7,6
2022-07-03,Binh Duong,Thuan An,9,36,29,7,2
2022-07-03,Binh Duong,Thuan An,10,61,42,19,7
2022-07-03,Binh Duong,Thuan An,11,61,47,14,2
2022-07-03,Binh Duong,Thuan An,12,81,62,19,8
2022-07-03,Binh Duong,Thuan An,13,59,46,13,6
2022-07-03,Binh Duong,Thuan An,14,61,45,16,9
2022-07-03,Binh Duong,Thuan An,15,47,40,7,5
2022-07-03,Binh Duong,Thuan An,16,49,35,14,10
2022-07-03,Binh Duong,Thuan An,17,52,40,12,5
2022-07-03,Binh Duong,Thuan An,18,59,52,7,4
2022-07-03,Binh Duong,Thuan An,19,62,48,14,5
2022-07-03,Binh Duong,Thuan An,20,40,27,13,9
2022-07-03,Binh Duong,Thuan An,21,12,6,6,5
2022-07-03,Can Tho City,Binh Thuy District,6,2,0,2,2
2022-07-03,Can Tho City,Binh Thuy District,7,3,2,1,0
2022-07-03,Can Tho City,Binh Thuy District,8,7,6,1,0
2022-07-03,Can Tho City,Binh Thuy District,9,10,9,1,0
2022-07-03,Can Tho City,Binh Thuy District,10,7,7,0,0
2022-07-03,Can Tho City,Binh Thuy District,11,12,11,1,0
2022-07-03,Can Tho City,Binh Thuy District,12,15,15,0,0
2022-07-03,Can Tho City,Binh Thuy District,13,9,9,0,0
2022-07-03,Can Tho City,Binh Thuy District,14,16,15,1,0
2022-07-03,Can Tho City,Binh Thuy District,15,8,7,1,1
2022-07-03,Can Tho City,Binh Thuy District,16,17,15,2,2
2022-07-03,Can Tho City,Binh Thuy District,17,16,16,0,0
2022-07-03,Can Tho City,Binh Thuy District,18,14,13,1,0
2022-07-03,Can Tho City,Binh Thuy District,19,15,12,3,2
2022-07-03,Can Tho City,Binh Thuy District,20,6,6,0,0
2022-07-03,Can Tho City,Binh Thuy District,21,11,9,2,1
2022-07-03,Can Tho City,Cai Rang District,7,8,4,4,4
2022-07-03,Can Tho City,Cai Rang District,8,5,5,0,0
2022-07-03,Can Tho City,Cai Rang District,9,5,5,0,0
2022-07-03,Can Tho City,Cai Rang District,10,8,8,0,0
2022-07-03,Can Tho City,Cai Rang District,11,13,10,3,1
2022-07-03,Can Tho City,Cai Rang District,12,14,14,0,0
2022-07-03,Can Tho City,Cai Rang District,13,9,8,1,0
2022-07-03,Can Tho City,Cai Rang District,14,9,9,0,0
2022-07-03,Can Tho City,Cai Rang District,15,7,6,1,0
2022-07-03,Can Tho City,Cai Rang District,16,8,8,0,0
2022-07-03,Can Tho City,Cai Rang District,17,13,13,0,0
2022-07-03,Can Tho City,Cai Rang District,18,17,14,3,0
2022-07-03,Can Tho City,Cai Rang District,19,11,11,0,0
2022-07-03,Can Tho City,Cai Rang District,20,2,2,0,0
2022-07-03,Can Tho City,Cai Rang District,21,3,3,0,0
2022-07-03,Can Tho City,Ninh Kieu District,0,2,2,0,0
2022-07-03,Can Tho City,Ninh Kieu District,1,1,1,0,0
2022-07-03,Can Tho City,Ninh Kieu District,2,3,2,1,0
2022-07-03,Can Tho City,Ninh Kieu District,3,1,1,0,0
2022-07-03,Can Tho City,Ninh Kieu District,5,2,2,0,0
2022-07-03,Can Tho City,Ninh Kieu District,6,51,42,9,1
2022-07-03,Can Tho City,Ninh Kieu District,7,117,113,4,0
2022-07-03,Can Tho City,Ninh Kieu District,8,203,188,15,0
2022-07-03,Can Tho City,Ninh Kieu District,9,337,315,22,1
2022-07-03,Can Tho City,Ninh Kieu District,10,433,409,24,2
2022-07-03,Can Tho City,Ninh Kieu District,11,756,699,57,7
2022-07-03,Can Tho City,Ninh Kieu District,12,660,627,33,2
2022-07-03,Can Tho City,Ninh Kieu District,13,521,501,20,1
2022-07-03,Can Tho City,Ninh Kieu District,14,409,387,22,0
2022-07-03,Can Tho City,Ninh Kieu District,15,371,356,15,0
2022-07-03,Can Tho City,Ninh Kieu District,16,423,394,29,1
2022-07-03,Can Tho City,Ninh Kieu District,17,534,509,25,0
2022-07-03,Can Tho City,Ninh Kieu District,18,502,470,32,0
2022-07-03,Can Tho City,Ninh Kieu District,19,447,423,24,0
2022-07-03,Can Tho City,Ninh Kieu District,20,356,334,22,0
2022-07-03,Can Tho City,Ninh Kieu District,21,210,185,25,1
2022-07-03,Can Tho City,Ninh Kieu District,22,3,0,3,0
2022-07-03,Can Tho City,Ninh Kieu District,23,1,0,1,0
2022-07-03,Can Tho City,Phong Dien,14,2,0,2,2
2022-07-03,Dong Nai,Bien Hoa City,1,4,2,2,0
2022-07-03,Dong Nai,Bien Hoa City,2,1,1,0,0
2022-07-03,Dong Nai,Bien Hoa City,3,2,2,0,0
2022-07-03,Dong Nai,Bien Hoa City,5,3,1,2,2
2022-07-03,Dong Nai,Bien Hoa City,6,48,35,13,8
2022-07-03,Dong Nai,Bien Hoa City,7,180,161,19,10
2022-07-03,Dong Nai,Bien Hoa City,8,352,311,41,11
2022-07-03,Dong Nai,Bien Hoa City,9,513,454,59,13
2022-07-03,Dong Nai,Bien Hoa City,10,695,601,94,39
2022-07-03,Dong Nai,Bien Hoa City,11,1086,924,162,71
2022-07-03,Dong Nai,Bien Hoa City,12,917,850,67,23
2022-07-03,Dong Nai,Bien Hoa City,13,771,721,50,6
2022-07-03,Dong Nai,Bien Hoa City,14,658,607,51,3
2022-07-03,Dong Nai,Bien Hoa City,15,521,473,48,3
2022-07-03,Dong Nai,Bien Hoa City,16,572,521,51,5
2022-07-03,Dong Nai,Bien Hoa City,17,692,627,65,19
2022-07-03,Dong Nai,Bien Hoa City,18,835,733,102,30
2022-07-03,Dong Nai,Bien Hoa City,19,764,681,83,32
2022-07-03,Dong Nai,Bien Hoa City,20,630,512,118,39
2022-07-03,Dong Nai,Bien Hoa City,21,266,215,51,14
2022-07-03,Dong Nai,Bien Hoa City,22,1,0,1,0
2022-07-03,Dong Nai,Long Khanh,7,1,0,1,1
2022-07-03,Dong Nai,Long Khanh,10,2,0,2,2
2022-07-03,Dong Nai,Long Khanh,11,1,0,1,1
2022-07-03,Dong Nai,Long Khanh,14,2,0,2,2
2022-07-03,Dong Nai,Long Khanh,19,1,0,1,1
2022-07-03,Dong Nai,Long Khanh,20,1,0,1,1
2022-07-03,Dong Nai,Long Thanh,9,2,0,2,2
2022-07-03,Dong Nai,Long Thanh,10,2,0,2,2
2022-07-03,Dong Nai,Long Thanh,11,3,0,3,3
2022-07-03,Dong Nai,Long Thanh,12,1,0,1,1
2022-07-03,Dong Nai,Long Thanh,13,2,0,2,1
2022-07-03,Dong Nai,Long Thanh,14,3,0,3,3
2022-07-03,Dong Nai,Long Thanh,16,3,0,3,3
2022-07-03,Dong Nai,Long Thanh,17,2,0,2,2
2022-07-03,Dong Nai,Long Thanh,18,1,0,1,1
2022-07-03,Dong Nai,Long Thanh,19,2,0,2,0
2022-07-03,Dong Nai,Long Thanh,21,4,0,4,2
2022-07-03,Dong Nai,Nhon trach,9,1,0,1,1
2022-07-03,Dong Nai,Nhon trach,10,1,0,1,1
2022-07-03,Dong Nai,Nhon trach,11,1,0,1,1
2022-07-03,Dong Nai,Nhon trach,12,1,0,1,1
2022-07-03,Dong Nai,Nhon trach,15,3,0,3,2
2022-07-03,Dong Nai,Nhon trach,17,1,0,1,1
2022-07-03,Dong Nai,Nhon trach,18,1,0,1,0
2022-07-03,Dong Nai,Trang Bom,9,2,0,2,2
2022-07-03,Dong Nai,Trang Bom,10,2,0,2,1
2022-07-03,Dong Nai,Vinh Cuu,19,1,1,0,0
2022-07-03,Hai Phong City,An Duong,8,2,2,0,0
2022-07-03,Hai Phong City,An Duong,9,2,1,1,1
2022-07-03,Hai Phong City,An Duong,10,6,1,5,4
2022-07-03,Hai Phong City,An Duong,11,8,2,6,6
2022-07-03,Hai Phong City,An Duong,12,4,2,2,1
2022-07-03,Hai Phong City,An Duong,13,4,1,3,2
2022-07-03,Hai Phong City,An Duong,14,3,0,3,2
2022-07-03,Hai Phong City,An Duong,15,5,3,2,1
2022-07-03,Hai Phong City,An Duong,16,7,2,5,1
2022-07-03,Hai Phong City,An Duong,17,4,1,3,2
2022-07-03,Hai Phong City,An Duong,19,2,0,2,2
2022-07-03,Hai Phong City,An Duong,20,1,0,1,1
2022-07-03,Hai Phong City,Duong Kinh District,20,1,0,1,1
2022-07-03,Hai Phong City,Hai An District,6,1,0,1,1
2022-07-03,Hai Phong City,Hai An District,7,11,8,3,2
2022-07-03,Hai Phong City,Hai An District,8,15,12,3,1
2022-07-03,Hai Phong City,Hai An District,9,26,18,8,0
2022-07-03,Hai Phong City,Hai An District,10,33,24,9,5
2022-07-03,Hai Phong City,Hai An District,11,45,36,9,5
2022-07-03,Hai Phong City,Hai An District,12,33,26,7,6
2022-07-03,Hai Phong City,Hai An District,13,24,15,9,6
2022-07-03,Hai Phong City,Hai An District,14,16,14,2,0
2022-07-03,Hai Phong City,Hai An District,15,18,13,5,3
2022-07-03,Hai Phong City,Hai An District,16,17,16,1,0
2022-07-03,Hai Phong City,Hai An District,17,18,13,5,3
2022-07-03,Hai Phong City,Hai An District,18,31,22,9,7
2022-07-03,Hai Phong City,Hai An District,19,16,11,5,2
2022-07-03,Hai Phong City,Hai An District,20,24,16,8,3
2022-07-03,Hai Phong City,Hai An District,21,20,15,5,3
2022-07-03,Hai Phong City,Hong Bang District,5,1,0,1,0
2022-07-03,Hai Phong City,Hong Bang District,7,13,11,2,1
2022-07-03,Hai Phong City,Hong Bang District,8,21,20,1,1
2022-07-03,Hai Phong City,Hong Bang District,9,34,29,5,1
2022-07-03,Hai Phong City,Hong Bang District,10,76,56,20,11
2022-07-03,Hai Phong City,Hong Bang District,11,135,99,36,25
2022-07-03,Hai Phong City,Hong Bang District,12,97,76,21,10
2022-07-03,Hai Phong City,Hong Bang District,13,42,37,5,2
2022-07-03,Hai Phong City,Hong Bang District,14,45,35,10,6
2022-07-03,Hai Phong City,Hong Bang District,15,46,36,10,4
2022-07-03,Hai Phong City,Hong Bang District,16,54,49,5,1
2022-07-03,Hai Phong City,Hong Bang District,17,55,39,16,11
2022-07-03,Hai Phong City,Hong Bang District,18,71,51,20,13
2022-07-03,Hai Phong City,Hong Bang District,19,64,46,18,6
2022-07-03,Hai Phong City,Hong Bang District,20,33,25,8,1
2022-07-03,Hai Phong City,Hong Bang District,21,28,18,10,4
2022-07-03,Hai Phong City,Kien An District,2,1,0,1,1
2022-07-03,Hai Phong City,Kien An District,7,3,0,3,1
2022-07-03,Hai Phong City,Kien An District,8,3,1,2,2
2022-07-03,Hai Phong City,Kien An District,9,10,5,5,3
2022-07-03,Hai Phong City,Kien An District,10,12,9,3,2
2022-07-03,Hai Phong City,Kien An District,11,18,14,4,3
2022-07-03,Hai Phong City,Kien An District,12,9,7,2,0
2022-07-03,Hai Phong City,Kien An District,13,7,4,3,0
2022-07-03,Hai Phong City,Kien An District,14,5,4,1,1
2022-07-03,Hai Phong City,Kien An District,15,8,6,2,0
2022-07-03,Hai Phong City,Kien An District,16,12,7,5,1
2022-07-03,Hai Phong City,Kien An District,17,12,8,4,2
2022-07-03,Hai Phong City,Kien An District,18,7,5,2,2
2022-07-03,Hai Phong City,Kien An District,19,8,5,3,2
2022-07-03,Hai Phong City,Kien An District,20,9,4,5,3
2022-07-03,Hai Phong City,Kien An District,21,6,1,5,5
2022-07-03,Hai Phong City,Le Chan District,1,1,1,0,0
2022-07-03,Hai Phong City,Le Chan District,4,1,0,1,0
2022-07-03,Hai Phong City,Le Chan District,6,1,0,1,1
2022-07-03,Hai Phong City,Le Chan District,7,45,31,14,10
2022-07-03,Hai Phong City,Le Chan District,8,91,68,23,6
2022-07-03,Hai Phong City,Le Chan District,9,103,83,20,1
2022-07-03,Hai Phong City,Le Chan District,10,249,189,60,31
2022-07-03,Hai Phong City,Le Chan District,11,403,309,94,55
2022-07-03,Hai Phong City,Le Chan District,12,280,233,47,30
2022-07-03,Hai Phong City,Le Chan District,13,152,124,28,6
2022-07-03,Hai Phong City,Le Chan District,14,146,113,33,13
2022-07-03,Hai Phong City,Le Chan District,15,176,145,31,15
2022-07-03,Hai Phong City,Le Chan District,16,163,132,31,14
2022-07-03,Hai Phong City,Le Chan District,17,214,167,47,22
2022-07-03,Hai Phong City,Le Chan District,18,232,177,55,29
2022-07-03,Hai Phong City,Le Chan District,19,198,146,52,25
2022-07-03,Hai Phong City,Le Chan District,20,131,105,26,11
2022-07-03,Hai Phong City,Le Chan District,21,68,46,22,14
2022-07-03,Hai Phong City,Ngo Quyen District,0,2,0,2,0
2022-07-03,Hai Phong City,Ngo Quyen District,7,31,18,13,9
2022-07-03,Hai Phong City,Ngo Quyen District,8,46,37,9,4
2022-07-03,Hai Phong City,Ngo Quyen District,9,96,79,17,5
2022-07-03,Hai Phong City,Ngo Quyen District,10,200,161,39,22
2022-07-03,Hai Phong City,Ngo Quyen District,11,259,202,57,32
2022-07-03,Hai Phong City,Ngo Quyen District,12,225,185,40,24
2022-07-03,Hai Phong City,Ngo Quyen District,13,126,103,23,11
2022-07-03,Hai Phong City,Ngo Quyen District,14,127,103,24,8
2022-07-03,Hai Phong City,Ngo Quyen District,15,148,124,24,4
2022-07-03,Hai Phong City,Ngo Quyen District,16,134,115,19,4
2022-07-03,Hai Phong City,Ngo Quyen District,17,183,124,59,34
2022-07-03,Hai Phong City,Ngo Quyen District,18,184,135,49,29
2022-07-03,Hai Phong City,Ngo Quyen District,19,180,143,37,18
2022-07-03,Hai Phong City,Ngo Quyen District,20,146,117,29,7
2022-07-03,Hai Phong City,Ngo Quyen District,21,78,58,20,11
2022-07-03,Hai Phong City,Ngo Quyen District,22,2,0,2,0
2022-07-03,Hai Phong City,Thuy Nguyen,9,1,0,1,1
2022-07-03,Hai Phong City,Thuy Nguyen,10,1,0,1,1
2022-07-03,Hai Phong City,Thuy Nguyen,14,1,0,1,1
2022-07-03,Hai Phong City,Thuy Nguyen,17,2,0,2,1
2022-07-03,Hai Phong City,Thuy Nguyen,18,1,0,1,1
2022-07-03,Hai Phong City,Thuy Nguyen,19,2,0,2,2
2022-07-03,Hue City,Hue City,0,6,4,2,0
2022-07-03,Hue City,Hue City,1,2,1,1,0
2022-07-03,Hue City,Hue City,3,1,0,1,0
2022-07-03,Hue City,Hue City,5,3,3,0,0
2022-07-03,Hue City,Hue City,6,62,58,4,2
2022-07-03,Hue City,Hue City,7,220,199,21,2
2022-07-03,Hue City,Hue City,8,312,288,24,0
2022-07-03,Hue City,Hue City,9,274,244,30,1
2022-07-03,Hue City,Hue City,10,416,379,37,0
2022-07-03,Hue City,Hue City,11,758,690,68,4
2022-07-03,Hue City,Hue City,12,646,595,51,0
2022-07-03,Hue City,Hue City,13,376,345,31,3
2022-07-03,Hue City,Hue City,14,397,366,31,1
2022-07-03,Hue City,Hue City,15,416,389,27,1
2022-07-03,Hue City,Hue City,16,384,353,31,0
2022-07-03,Hue City,Hue City,17,472,425,47,4
2022-07-03,Hue City,Hue City,18,584,510,74,12
2022-07-03,Hue City,Hue City,19,663,528,135,61
2022-07-03,Hue City,Hue City,20,572,414,158,86
2022-07-03,Hue City,Hue City,21,324,213,111,63
2022-07-03,Hue City,Hue City,22,1,1,0,0
2022-07-03,Hue City,Huong Thuy,8,2,1,1,0
2022-07-03,Hue City,Huong Thuy,9,3,2,1,1
2022-07-03,Hue City,Huong Thuy,10,3,1,2,1
2022-07-03,Hue City,Huong Thuy,11,2,0,2,0
2022-07-03,Hue City,Huong Thuy,13,1,1,0,0
2022-07-03,Hue City,Huong Thuy,15,1,1,0,0
2022-07-03,Hue City,Huong Thuy,16,2,1,1,0
2022-07-03,Hue City,Huong Thuy,18,1,1,0,0
2022-07-03,Hue City,Huong Thuy,19,2,1,1,0
2022-07-03,Hue City,Huong Thuy,20,1,0,1,1
2022-07-03,Hue City,Huong Thuy,21,4,0,4,1
2022-07-03,Hue City,Huong Tra,11,1,1,0,0
2022-07-03,Hue City,Huong Tra,14,1,1,0,0
2022-07-03,Hue City,Huong Tra,17,1,0,1,0
2022-07-03,Hue City,Phu Vang,7,4,2,2,1
2022-07-03,Hue City,Phu Vang,8,2,1,1,0
2022-07-03,Hue City,Phu Vang,10,4,4,0,0
2022-07-03,Hue City,Phu Vang,11,4,2,2,1
2022-07-03,Hue City,Phu Vang,12,4,3,1,1
2022-07-03,Hue City,Phu Vang,13,5,3,2,2
2022-07-03,Hue City,Phu Vang,14,3,1,2,2
2022-07-03,Hue City,Phu Vang,15,3,2,1,1
2022-07-03,Hue City,Phu Vang,16,1,1,0,0
2022-07-03,Hue City,Phu Vang,17,1,1,0,0
2022-07-03,Hue City,Phu Vang,18,2,2,0,0
2022-07-03,Hue City,Phu Vang,19,3,1,2,0
2022-07-03,Hue City,Phu Vang,20,2,0,2,1
2022-07-03,Hue City,Phu Vang,21,2,0,2,0
2022-07-03,Khanh Hoa,Nha Trang City,0,1,1,0,0
2022-07-03,Khanh Hoa,Nha Trang City,5,2,1,1,0
2022-07-03,Khanh Hoa,Nha Trang City,6,40,36,4,3
2022-07-03,Khanh Hoa,Nha Trang City,7,118,106,12,0
2022-07-03,Khanh Hoa,Nha Trang City,8,196,178,18,1
2022-07-03,Khanh Hoa,Nha Trang City,9,204,190,14,0
2022-07-03,Khanh Hoa,Nha Trang City,10,242,217,25,0
2022-07-03,Khanh Hoa,Nha Trang City,11,409,367,42,10
2022-07-03,Khanh Hoa,Nha Trang City,12,364,322,42,19
2022-07-03,Khanh Hoa,Nha Trang City,13,263,238,25,4
2022-07-03,Khanh Hoa,Nha Trang City,14,246,225,21,4
2022-07-03,Khanh Hoa,Nha Trang City,15,257,231,26,12
2022-07-03,Khanh Hoa,Nha Trang City,16,234,214,20,5
2022-07-03,Khanh Hoa,Nha Trang City,17,320,290,30,6
2022-07-03,Khanh Hoa,Nha Trang City,18,344,301,43,18
2022-07-03,Khanh Hoa,Nha Trang City,19,316,268,48,17
2022-07-03,Khanh Hoa,Nha Trang City,20,241,190,51,23
2022-07-03,Khanh Hoa,Nha Trang City,21,144,94,50,20
2022-07-03,Khanh Hoa,Nha Trang City,22,1,0,1,0
2022-07-03,Khanh Hoa,Nha Trang City,23,1,1,0,0
2022-07-03,Lam Dong,Da Lat City,3,1,0,1,1
2022-07-03,Lam Dong,Da Lat City,5,1,1,0,0
2022-07-03,Lam Dong,Da Lat City,6,5,2,3,3
2022-07-03,Lam Dong,Da Lat City,7,76,32,44,34
2022-07-03,Lam Dong,Da Lat City,8,86,56,30,21
2022-07-03,Lam Dong,Da Lat City,9,107,75,32,25
2022-07-03,Lam Dong,Da Lat City,10,114,74,40,23
2022-07-03,Lam Dong,Da Lat City,11,184,113,71,51
2022-07-03,Lam Dong,Da Lat City,12,175,113,62,48
2022-07-03,Lam Dong,Da Lat City,13,161,100,61,42
2022-07-03,Lam Dong,Da Lat City,14,121,84,37,25
2022-07-03,Lam Dong,Da Lat City,15,133,87,46,31
2022-07-03,Lam Dong,Da Lat City,16,128,93,35,24
2022-07-03,Lam Dong,Da Lat City,17,152,107,45,31
2022-07-03,Lam Dong,Da Lat City,18,153,92,61,46
2022-07-03,Lam Dong,Da Lat City,19,181,82,99,83
2022-07-03,Lam Dong,Da Lat City,20,233,49,184,166
2022-07-03,Lam Dong,Da Lat City,21,129,17,112,98
2022-07-03,Lam Dong,Da Lat City,22,6,0,6,2
2022-07-03,Nghe An,Vinh City,1,1,1,0,0
2022-07-03,Nghe An,Vinh City,4,1,0,1,0
2022-07-03,Nghe An,Vinh City,6,4,3,1,0
2022-07-03,Nghe An,Vinh City,7,106,89,17,3
2022-07-03,Nghe An,Vinh City,8,173,151,22,7
2022-07-03,Nghe An,Vinh City,9,179,156,23,4
2022-07-03,Nghe An,Vinh City,10,262,195,67,44
2022-07-03,Nghe An,Vinh City,11,356,267,89,43
2022-07-03,Nghe An,Vinh City,12,243,208,35,15
2022-07-03,Nghe An,Vinh City,13,129,105,24,14
2022-07-03,Nghe An,Vinh City,14,170,130,40,11
2022-07-03,Nghe An,Vinh City,15,219,154,65,36
2022-07-03,Nghe An,Vinh City,16,191,147,44,17
2022-07-03,Nghe An,Vinh City,17,160,118,42,27
2022-07-03,Nghe An,Vinh City,18,243,143,100,66
2022-07-03,Nghe An,Vinh City,19,333,174,159,114
2022-07-03,Nghe An,Vinh City,20,160,108,52,30
2022-07-03,Nghe An,Vinh City,21,105,57,48,35
2022-07-03,Nghe An,Vinh City,22,1,1,0,0
2022-07-03,Quang Nam,Dien Ban,17,1,0,1,1
2022-07-03,Quang Nam,Hoi An City,6,2,0,2,2
2022-07-03,Quang Nam,Hoi An City,7,31,9,22,19
2022-07-03,Quang Nam,Hoi An City,8,42,25,17,12
2022-07-03,Quang Nam,Hoi An City,9,47,30,17,7
2022-07-03,Quang Nam,Hoi An City,10,52,40,12,5
2022-07-03,Quang Nam,Hoi An City,11,68,49,19,13
2022-07-03,Quang Nam,Hoi An City,12,79,37,42,33
2022-07-03,Quang Nam,Hoi An City,13,45,36,9,7
2022-07-03,Quang Nam,Hoi An City,14,46,35,11,6
2022-07-03,Quang Nam,Hoi An City,15,45,39,6,3
2022-07-03,Quang Nam,Hoi An City,16,42,27,15,9
2022-07-03,Quang Nam,Hoi An City,17,78,55,23,13
2022-07-03,Quang Nam,Hoi An City,18,61,45,16,12
2022-07-03,Quang Nam,Hoi An City,19,78,44,34,22
2022-07-03,Quang Nam,Hoi An City,20,79,21,58,47
2022-07-03,Quang Nam,Hoi An City,21,47,11,36,28
2022-07-03,Quang Nam,Hoi An City,22,1,0,1,0
2022-07-03,Quang Nam,Tam Ky City,12,1,0,1,1
2022-07-03,Quang Nam,Tam Ky City,13,1,0,1,1
2022-07-03,Quang Nam,Tam Ky City,14,3,0,3,3
2022-07-03,Quang Ninh,Cam Pha City,10,1,0,1,1
2022-07-03,Quang Ninh,Cam Pha City,11,4,0,4,3
2022-07-03,Quang Ninh,Cam Pha City,12,1,0,1,1
2022-07-03,Quang Ninh,Cam Pha City,13,1,0,1,1
2022-07-03,Quang Ninh,Cam Pha City,15,2,0,2,1
2022-07-03,Quang Ninh,Cam Pha City,20,1,0,1,1
2022-07-03,Quang Ninh,Ha Long City,0,1,0,1,0
2022-07-03,Quang Ninh,Ha Long City,5,1,0,1,0
2022-07-03,Quang Ninh,Ha Long City,6,1,0,1,1
2022-07-03,Quang Ninh,Ha Long City,7,23,9,14,7
2022-07-03,Quang Ninh,Ha Long City,8,53,24,29,22
2022-07-03,Quang Ninh,Ha Long City,9,62,32,30,17
2022-07-03,Quang Ninh,Ha Long City,10,99,70,29,14
2022-07-03,Quang Ninh,Ha Long City,11,185,107,78,58
2022-07-03,Quang Ninh,Ha Long City,12,142,86,56,42
2022-07-03,Quang Ninh,Ha Long City,13,96,61,35,19
2022-07-03,Quang Ninh,Ha Long City,14,79,48,31,16
2022-07-03,Quang Ninh,Ha Long City,15,94,49,45,33
2022-07-03,Quang Ninh,Ha Long City,16,68,42,26,19
2022-07-03,Quang Ninh,Ha Long City,17,56,41,15,11
2022-07-03,Quang Ninh,Ha Long City,18,60,36,24,9
2022-07-03,Quang Ninh,Ha Long City,19,73,53,20,16
2022-07-03,Quang Ninh,Ha Long City,20,74,42,32,19
2022-07-03,Thai Nguyen,Dong Hy,8,1,1,0,0
2022-07-03,Thai Nguyen,Dong Hy,19,2,0,2,1
2022-07-03,Thai Nguyen,Dong Hy,21,2,0,2,1
2022-07-03,Thai Nguyen,Pho Yen,10,1,0,1,1
2022-07-03,Thai Nguyen,Thai Nguyen City,0,8,6,2,0
2022-07-03,Thai Nguyen,Thai Nguyen City,1,1,1,0,0
2022-07-03,Thai Nguyen,Thai Nguyen City,2,2,0,2,0
2022-07-03,Thai Nguyen,Thai Nguyen City,3,1,0,1,0
2022-07-03,Thai Nguyen,Thai Nguyen City,5,1,1,0,0
2022-07-03,Thai Nguyen,Thai Nguyen City,6,6,5,1,0
2022-07-03,Thai Nguyen,Thai Nguyen City,7,65,55,10,1
2022-07-03,Thai Nguyen,Thai Nguyen City,8,159,144,15,0
2022-07-03,Thai Nguyen,Thai Nguyen City,9,136,121,15,0
2022-07-03,Thai Nguyen,Thai Nguyen City,10,237,217,20,3
2022-07-03,Thai Nguyen,Thai Nguyen City,11,459,407,52,15
2022-07-03,Thai Nguyen,Thai Nguyen City,12,303,272,31,1
2022-07-03,Thai Nguyen,Thai Nguyen City,13,169,153,16,1
2022-07-03,Thai Nguyen,Thai Nguyen City,14,191,171,20,4
2022-07-03,Thai Nguyen,Thai Nguyen City,15,202,175,27,8
2022-07-03,Thai Nguyen,Thai Nguyen City,16,152,140,12,2
2022-07-03,Thai Nguyen,Thai Nguyen City,17,166,152,14,0
2022-07-03,Thai Nguyen,Thai Nguyen City,18,192,177,15,0
2022-07-03,Thai Nguyen,Thai Nguyen City,19,320,277,43,4
2022-07-03,Thai Nguyen,Thai Nguyen City,20,184,164,20,2
2022-07-03,Thai Nguyen,Thai Nguyen City,21,154,128,26,3
2022-07-03,Thai Nguyen,Thai Nguyen City,22,1,0,1,1
2022-07-03,Thai Nguyen,Thai Nguyen City,23,1,1,0,0
2022-07-03,Vung Tau,Ba Ria City,7,1,0,1,1
2022-07-03,Vung Tau,Ba Ria City,8,4,0,4,2
2022-07-03,Vung Tau,Ba Ria City,9,4,0,4,3
2022-07-03,Vung Tau,Ba Ria City,10,7,2,5,3
2022-07-03,Vung Tau,Ba Ria City,11,8,2,6,6
2022-07-03,Vung Tau,Ba Ria City,12,8,4,4,3
2022-07-03,Vung Tau,Ba Ria City,13,12,6,6,3
2022-07-03,Vung Tau,Ba Ria City,14,8,2,6,5
2022-07-03,Vung Tau,Ba Ria City,15,4,2,2,2
2022-07-03,Vung Tau,Ba Ria City,16,3,1,2,2
2022-07-03,Vung Tau,Ba Ria City,17,8,4,4,4
2022-07-03,Vung Tau,Ba Ria City,18,9,2,7,6
2022-07-03,Vung Tau,Ba Ria City,19,6,0,6,5
2022-07-03,Vung Tau,Ba Ria City,20,4,0,4,4
2022-07-03,Vung Tau,Ba Ria City,21,2,0,2,2
2022-07-03,Vung Tau,Chau Duc,14,1,0,1,1
2022-07-03,Vung Tau,Vung Tau City,1,2,2,0,0
2022-07-03,Vung Tau,Vung Tau City,3,3,1,2,1
2022-07-03,Vung Tau,Vung Tau City,4,1,1,0,0
2022-07-03,Vung Tau,Vung Tau City,5,1,1,0,0
2022-07-03,Vung Tau,Vung Tau City,6,36,29,7,0
2022-07-03,Vung Tau,Vung Tau City,7,142,122,20,7
2022-07-03,Vung Tau,Vung Tau City,8,245,215,30,11
2022-07-03,Vung Tau,Vung Tau City,9,237,220,17,8
2022-07-03,Vung Tau,Vung Tau City,10,361,318,43,4
2022-07-03,Vung Tau,Vung Tau City,11,450,394,56,16
2022-07-03,Vung Tau,Vung Tau City,12,378,297,81,35
2022-07-03,Vung Tau,Vung Tau City,13,258,237,21,4
2022-07-03,Vung Tau,Vung Tau City,14,239,219,20,4
2022-07-03,Vung Tau,Vung Tau City,15,250,232,18,2
2022-07-03,Vung Tau,Vung Tau City,16,239,221,18,2
2022-07-03,Vung Tau,Vung Tau City,17,316,284,32,14
2022-07-03,Vung Tau,Vung Tau City,18,339,296,43,8
2022-07-03,Vung Tau,Vung Tau City,19,300,258,42,11
2022-07-03,Vung Tau,Vung Tau City,20,228,185,43,11
2022-07-03,Vung Tau,Vung Tau City,21,112,91,21,3
2022-07-04,Bac Ninh,Bác Ninh City,5,1,1,0,0
2022-07-04,Bac Ninh,Bác Ninh City,6,5,5,0,0
2022-07-04,Bac Ninh,Bác Ninh City,7,72,63,9,2
2022-07-04,Bac Ninh,Bác Ninh City,8,114,104,10,1
2022-07-04,Bac Ninh,Bác Ninh City,9,118,107,11,1
2022-07-04,Bac Ninh,Bác Ninh City,10,165,153,12,0
2022-07-04,Bac Ninh,Bác Ninh City,11,396,345,51,16
2022-07-04,Bac Ninh,Bác Ninh City,12,231,216,15,1
2022-07-04,Bac Ninh,Bác Ninh City,13,163,148,15,0
2022-07-04,Bac Ninh,Bác Ninh City,14,170,156,14,2
2022-07-04,Bac Ninh,Bác Ninh City,15,161,138,23,2
2022-07-04,Bac Ninh,Bác Ninh City,16,145,125,20,4
2022-07-04,Bac Ninh,Bác Ninh City,17,139,123,16,3
2022-07-04,Bac Ninh,Bác Ninh City,18,156,142,14,1
2022-07-04,Bac Ninh,Bác Ninh City,19,168,156,12,0
2022-07-04,Bac Ninh,Bác Ninh City,20,157,135,22,9
2022-07-04,Bac Ninh,Bác Ninh City,21,90,73,17,7
2022-07-04,Bac Ninh,Bác Ninh City,23,2,1,1,0
2022-07-04,Bac Ninh,Que Vo,9,1,0,1,1
2022-07-04,Bac Ninh,Que Vo,10,2,0,2,0
2022-07-04,Bac Ninh,Que Vo,11,4,0,4,1
2022-07-04,Bac Ninh,Que Vo,12,1,0,1,0
2022-07-04,Bac Ninh,Que Vo,13,4,1,3,2
2022-07-04,Bac Ninh,Que Vo,15,1,0,1,1
2022-07-04,Bac Ninh,Que Vo,16,4,0,4,4
2022-07-04,Bac Ninh,Que Vo,19,1,0,1,0
2022-07-04,Bac Ninh,Que Vo,20,2,0,2,2
2022-07-04,Bac Ninh,Que Vo,21,1,0,1,1
2022-07-04,Bac Ninh,Tien Du,9,1,0,1,1
2022-07-04,Bac Ninh,Tien Du,10,1,0,1,1
2022-07-04,Bac Ninh,Tien Du,11,2,0,2,2
2022-07-04,Bac Ninh,Tien Du,12,2,0,2,2
2022-07-04,Bac Ninh,Tien Du,13,1,0,1,1
2022-07-04,Bac Ninh,Tien Du,14,1,0,1,1
2022-07-04,Bac Ninh,Tien Du,17,1,0,1,1
2022-07-04,Bac Ninh,Tien Du,18,2,0,2,2
2022-07-04,Bac Ninh,Tien Du,19,3,0,3,3
2022-07-04,Bac Ninh,Tien Du,20,1,0,1,1
2022-07-04,Bac Ninh,Tien Du,21,2,0,2,2
2022-07-04,Bac Ninh,Tu Son,9,1,0,1,1
2022-07-04,Bac Ninh,Tu Son,10,2,0,2,2
2022-07-04,Bac Ninh,Tu Son,11,1,0,1,1
2022-07-04,Bac Ninh,Tu Son,12,2,0,2,2
2022-07-04,Bac Ninh,Tu Son,14,5,0,5,5
2022-07-04,Bac Ninh,Tu Son,15,3,0,3,3
2022-07-04,Bac Ninh,Tu Son,16,1,0,1,1
2022-07-04,Bac Ninh,Tu Son,18,1,0,1,1
2022-07-04,Bac Ninh,Tu Son,21,1,0,1,1
2022-07-04,Binh Duong,Ben Cat,10,1,0,1,1
2022-07-04,Binh Duong,Ben Cat,11,1,0,1,1
2022-07-04,Binh Duong,Ben Cat,12,3,0,3,3
2022-07-04,Binh Duong,Ben Cat,14,2,0,2,2
2022-07-04,Binh Duong,Ben Cat,18,1,0,1,1
2022-07-04,Binh Duong,Di An,6,4,0,4,4
2022-07-04,Binh Duong,Di An,7,8,1,7,6
2022-07-04,Binh Duong,Di An,8,15,8,7,4
2022-07-04,Binh Duong,Di An,9,26,17,9,7
2022-07-04,Binh Duong,Di An,10,38,27,11,9
2022-07-04,Binh Duong,Di An,11,39,31,8,4
2022-07-04,Binh Duong,Di An,12,37,24,13,7
2022-07-04,Binh Duong,Di An,13,48,30,18,14
2022-07-04,Binh Duong,Di An,14,27,21,6,3
2022-07-04,Binh Duong,Di An,15,34,25,9,4
2022-07-04,Binh Duong,Di An,16,25,20,5,4
2022-07-04,Binh Duong,Di An,17,19,15,4,1
2022-07-04,Binh Duong,Di An,18,31,27,4,3
2022-07-04,Binh Duong,Di An,19,26,19,7,5
2022-07-04,Binh Duong,Di An,20,20,15,5,4
2022-07-04,Binh Duong,Di An,21,12,6,6,4
2022-07-04,Binh Duong,Tan Uyen,7,2,0,2,2
2022-07-04,Binh Duong,Tan Uyen,8,3,1,2,2
2022-07-04,Binh Duong,Tan Uyen,9,3,0,3,2
2022-07-04,Binh Duong,Tan Uyen,10,3,0,3,2
2022-07-04,Binh Duong,Tan Uyen,11,2,1,1,1
2022-07-04,Binh Duong,Tan Uyen,13,6,2,4,3
2022-07-04,Binh Duong,Tan Uyen,14,4,2,2,2
2022-07-04,Binh Duong,Tan Uyen,15,5,3,2,2
2022-07-04,Binh Duong,Tan Uyen,17,4,1,3,3
2022-07-04,Binh Duong,Tan Uyen,18,11,1,10,7
2022-07-04,Binh Duong,Tan Uyen,19,2,2,0,0
2022-07-04,Binh Duong,Tan Uyen,20,2,0,2,2
2022-07-04,Binh Duong,Thu Dau Mot Town,2,1,1,0,0
2022-07-04,Binh Duong,Thu Dau Mot Town,4,1,0,1,0
2022-07-04,Binh Duong,Thu Dau Mot Town,6,29,23,6,2
2022-07-04,Binh Duong,Thu Dau Mot Town,7,114,105,9,1
2022-07-04,Binh Duong,Thu Dau Mot Town,8,218,192,26,7
2022-07-04,Binh Duong,Thu Dau Mot Town,9,300,260,40,7
2022-07-04,Binh Duong,Thu Dau Mot Town,10,376,345,31,10
2022-07-04,Binh Duong,Thu Dau Mot Town,11,631,586,45,12
2022-07-04,Binh Duong,Thu Dau Mot Town,12,476,439,37,12
2022-07-04,Binh Duong,Thu Dau Mot Town,13,486,438,48,15
2022-07-04,Binh Duong,Thu Dau Mot Town,14,318,293,25,9
2022-07-04,Binh Duong,Thu Dau Mot Town,15,326,302,24,6
2022-07-04,Binh Duong,Thu Dau Mot Town,16,262,248,14,3
2022-07-04,Binh Duong,Thu Dau Mot Town,17,342,307,35,6
2022-07-04,Binh Duong,Thu Dau Mot Town,18,410,373,37,7
2022-07-04,Binh Duong,Thu Dau Mot Town,19,377,350,27,8
2022-07-04,Binh Duong,Thu Dau Mot Town,20,297,261,36,7
2022-07-04,Binh Duong,Thu Dau Mot Town,21,130,110,20,5
2022-07-04,Binh Duong,Thu Dau Mot Town,22,1,0,1,0
2022-07-04,Binh Duong,Thuan An,6,1,0,1,1
2022-07-04,Binh Duong,Thuan An,7,14,7,7,4
2022-07-04,Binh Duong,Thuan An,8,16,9,7,4
2022-07-04,Binh Duong,Thuan An,9,57,42,15,7
2022-07-04,Binh Duong,Thuan An,10,57,41,16,8
2022-07-04,Binh Duong,Thuan An,11,90,74,16,3
2022-07-04,Binh Duong,Thuan An,12,65,56,9,2
2022-07-04,Binh Duong,Thuan An,13,92,76,16,10
2022-07-04,Binh Duong,Thuan An,14,86,62,24,16
2022-07-04,Binh Duong,Thuan An,15,40,33,7,3
2022-07-04,Binh Duong,Thuan An,16,50,38,12,3
2022-07-04,Binh Duong,Thuan An,17,39,35,4,1
2022-07-04,Binh Duong,Thuan An,18,51,45,6,2
2022-07-04,Binh Duong,Thuan An,19,44,37,7,1
2022-07-04,Binh Duong,Thuan An,20,40,28,12,7
2022-07-04,Binh Duong,Thuan An,21,18,10,8,6
2022-07-04,Can Tho City,Binh Thuy District,7,1,1,0,0
2022-07-04,Can Tho City,Binh Thuy District,8,4,4,0,0
2022-07-04,Can Tho City,Binh Thuy District,9,8,8,0,0
2022-07-04,Can Tho City,Binh Thuy District,10,5,4,1,0
2022-07-04,Can Tho City,Binh Thuy District,11,7,7,0,0
2022-07-04,Can Tho City,Binh Thuy District,12,12,10,2,0
2022-07-04,Can Tho City,Binh Thuy District,13,13,13,0,0
2022-07-04,Can Tho City,Binh Thuy District,14,12,11,1,0
2022-07-04,Can Tho City,Binh Thuy District,15,5,5,0,0
2022-07-04,Can Tho City,Binh Thuy District,16,13,12,1,1
2022-07-04,Can Tho City,Binh Thuy District,17,16,15,1,0
2022-07-04,Can Tho City,Binh Thuy District,18,12,12,0,0
2022-07-04,Can Tho City,Binh Thuy District,19,23,21,2,0
2022-07-04,Can Tho City,Binh Thuy District,20,11,11,0,0
2022-07-04,Can Tho City,Binh Thuy District,21,4,4,0,0
2022-07-04,Can Tho City,Cai Rang District,6,3,1,2,2
2022-07-04,Can Tho City,Cai Rang District,7,5,5,0,0
2022-07-04,Can Tho City,Cai Rang District,8,9,6,3,2
2022-07-04,Can Tho City,Cai Rang District,9,10,8,2,1
2022-07-04,Can Tho City,Cai Rang District,10,14,10,4,4
2022-07-04,Can Tho City,Cai Rang District,11,26,23,3,1
2022-07-04,Can Tho City,Cai Rang District,12,8,7,1,0
2022-07-04,Can Tho City,Cai Rang District,13,12,9,3,0
2022-07-04,Can Tho City,Cai Rang District,14,13,12,1,0
2022-07-04,Can Tho City,Cai Rang District,15,13,11,2,2
2022-07-04,Can Tho City,Cai Rang District,16,9,9,0,0
2022-07-04,Can Tho City,Cai Rang District,17,9,7,2,2
2022-07-04,Can Tho City,Cai Rang District,18,9,8,1,0
2022-07-04,Can Tho City,Cai Rang District,19,12,11,1,0
2022-07-04,Can Tho City,Cai Rang District,20,8,7,1,1
2022-07-04,Can Tho City,Cai Rang District,21,4,4,0,0
2022-07-04,Can Tho City,Ninh Kieu District,0,1,0,1,0
2022-07-04,Can Tho City,Ninh Kieu District,2,2,1,1,1
2022-07-04,Can Tho City,Ninh Kieu District,5,4,1,3,0
2022-07-04,Can Tho City,Ninh Kieu District,6,34,31,3,0
2022-07-04,Can Tho City,Ninh Kieu District,7,129,121,8,2
2022-07-04,Can Tho City,Ninh Kieu District,8,230,215,15,0
2022-07-04,Can Tho City,Ninh Kieu District,9,251,232,19,0
2022-07-04,Can Tho City,Ninh Kieu District,10,443,424,19,1
2022-07-04,Can Tho City,Ninh Kieu District,11,848,795,53,8
2022-07-04,Can Tho City,Ninh Kieu District,12,574,554,20,0
2022-07-04,Can Tho City,Ninh Kieu District,13,503,486,17,0
2022-07-04,Can Tho City,Ninh Kieu District,14,441,427,14,0
2022-07-04,Can Tho City,Ninh Kieu District,15,371,353,18,1
2022-07-04,Can Tho City,Ninh Kieu District,16,371,351,20,0
2022-07-04,Can Tho City,Ninh Kieu District,17,449,430,19,0
2022-07-04,Can Tho City,Ninh Kieu District,18,466,441,25,0
2022-07-04,Can Tho City,Ninh Kieu District,19,430,408,22,0
2022-07-04,Can Tho City,Ninh Kieu District,20,351,335,16,0
2022-07-04,Can Tho City,Ninh Kieu District,21,206,188,18,0
2022-07-04,Can Tho City,Ninh Kieu District,22,4,0,4,0
2022-07-04,Dong Nai,Bien Hoa City,0,2,0,2,0
2022-07-04,Dong Nai,Bien Hoa City,1,2,2,0,0
2022-07-04,Dong Nai,Bien Hoa City,4,3,1,2,0
2022-07-04,Dong Nai,Bien Hoa City,6,47,30,17,5
2022-07-04,Dong Nai,Bien Hoa City,7,182,163,19,1
2022-07-04,Dong Nai,Bien Hoa City,8,329,284,45,7
2022-07-04,Dong Nai,Bien Hoa City,9,398,359,39,1
2022-07-04,Dong Nai,Bien Hoa City,10,748,695,53,6
2022-07-04,Dong Nai,Bien Hoa City,11,1072,972,100,21
2022-07-04,Dong Nai,Bien Hoa City,12,933,869,64,11
2022-07-04,Dong Nai,Bien Hoa City,13,855,790,65,8
2022-07-04,Dong Nai,Bien Hoa City,14,748,693,55,9
2022-07-04,Dong Nai,Bien Hoa City,15,594,550,44,4
2022-07-04,Dong Nai,Bien Hoa City,16,517,482,35,8
2022-07-04,Dong Nai,Bien Hoa City,17,581,539,42,7
2022-07-04,Dong Nai,Bien Hoa City,18,656,603,53,7
2022-07-04,Dong Nai,Bien Hoa City,19,642,575,67,9
2022-07-04,Dong Nai,Bien Hoa City,20,556,470,86,27
2022-07-04,Dong Nai,Bien Hoa City,21,262,204,58,15
2022-07-04,Dong Nai,Long Khanh,10,1,0,1,1
2022-07-04,Dong Nai,Long Khanh,16,1,0,1,1
2022-07-04,Dong Nai,Long Khanh,17,1,0,1,1
2022-07-04,Dong Nai,Long Thanh,8,1,0,1,1
2022-07-04,Dong Nai,Long Thanh,11,1,0,1,0
2022-07-04,Dong Nai,Long Thanh,12,4,0,4,4
2022-07-04,Dong Nai,Long Thanh,13,2,0,2,2
2022-07-04,Dong Nai,Long Thanh,14,2,0,2,2
2022-07-04,Dong Nai,Long Thanh,15,2,0,2,2
2022-07-04,Dong Nai,Long Thanh,18,1,0,1,1
2022-07-04,Dong Nai,Long Thanh,22,1,0,1,0
2022-07-04,Dong Nai,Trang Bom,9,1,0,1,1
2022-07-04,Dong Nai,Trang Bom,10,2,1,1,1
2022-07-04,Dong Nai,Trang Bom,12,1,0,1,1
2022-07-04,Dong Nai,Trang Bom,13,1,0,1,1
2022-07-04,Dong Nai,Trang Bom,21,1,0,1,1
2022-07-04,Hai Phong City,An Duong,8,1,1,0,0
2022-07-04,Hai Phong City,An Duong,9,4,2,2,2
2022-07-04,Hai Phong City,An Duong,10,7,5,2,1
2022-07-04,Hai Phong City,An Duong,11,4,3,1,1
2022-07-04,Hai Phong City,An Duong,12,1,0,1,1
2022-07-04,Hai Phong City,An Duong,13,5,2,3,2
2022-07-04,Hai Phong City,An Duong,14,5,2,3,3
2022-07-04,Hai Phong City,An Duong,15,3,2,1,1
2022-07-04,Hai Phong City,An Duong,16,3,3,0,0
2022-07-04,Hai Phong City,An Duong,17,3,2,1,0
2022-07-04,Hai Phong City,An Duong,18,2,0,2,1
2022-07-04,Hai Phong City,An Duong,19,3,1,2,2
2022-07-04,Hai Phong City,An Duong,20,4,0,4,4
2022-07-04,Hai Phong City,An Duong,21,4,1,3,3
2022-07-04,Hai Phong City,Do Son District,16,2,0,2,2
2022-07-04,Hai Phong City,Do Son District,17,1,0,1,1
2022-07-04,Hai Phong City,Hai An District,7,4,4,0,0
2022-07-04,Hai Phong City,Hai An District,8,11,10,1,1
2022-07-04,Hai Phong City,Hai An District,9,11,10,1,0
2022-07-04,Hai Phong City,Hai An District,10,31,29,2,0
2022-07-04,Hai Phong City,Hai An District,11,63,54,9,2
2022-07-04,Hai Phong City,Hai An District,12,43,37,6,2
2022-07-04,Hai Phong City,Hai An District,13,15,14,1,0
2022-07-04,Hai Phong City,Hai An District,14,27,22,5,0
2022-07-04,Hai Phong City,Hai An District,15,17,17,0,0
2022-07-04,Hai Phong City,Hai An District,16,18,13,5,0
2022-07-04,Hai Phong City,Hai An District,17,24,21,3,1
2022-07-04,Hai Phong City,Hai An District,18,22,19,3,1
2022-07-04,Hai Phong City,Hai An District,19,17,12,5,0
2022-07-04,Hai Phong City,Hai An District,20,8,8,0,0
2022-07-04,Hai Phong City,Hai An District,21,7,6,1,1
2022-07-04,Hai Phong City,Hong Bang District,0,1,0,1,1
2022-07-04,Hai Phong City,Hong Bang District,6,2,1,1,0
2022-07-04,Hai Phong City,Hong Bang District,7,22,17,5,2
2022-07-04,Hai Phong City,Hong Bang District,8,44,41,3,1
2022-07-04,Hai Phong City,Hong Bang District,9,35,31,4,1
2022-07-04,Hai Phong City,Hong Bang District,10,87,78,9,4
2022-07-04,Hai Phong City,Hong Bang District,11,131,103,28,16
2022-07-04,Hai Phong City,Hong Bang District,12,74,64,10,5
2022-07-04,Hai Phong City,Hong Bang District,13,45,33,12,11
2022-07-04,Hai Phong City,Hong Bang District,14,65,50,15,9
2022-07-04,Hai Phong City,Hong Bang District,15,50,40,10,5
2022-07-04,Hai Phong City,Hong Bang District,16,35,32,3,2
2022-07-04,Hai Phong City,Hong Bang District,17,58,52,6,0
2022-07-04,Hai Phong City,Hong Bang District,18,61,54,7,2
2022-07-04,Hai Phong City,Hong Bang District,19,46,37,9,7
2022-07-04,Hai Phong City,Hong Bang District,20,37,31,6,1
2022-07-04,Hai Phong City,Hong Bang District,21,9,6,3,2
2022-07-04,Hai Phong City,Hong Bang District,22,1,0,1,0
2022-07-04,Hai Phong City,Kien An District,7,2,0,2,1
2022-07-04,Hai Phong City,Kien An District,8,3,3,0,0
2022-07-04,Hai Phong City,Kien An District,9,12,6,6,4
2022-07-04,Hai Phong City,Kien An District,10,9,5,4,4
2022-07-04,Hai Phong City,Kien An District,11,14,10,4,3
2022-07-04,Hai Phong City,Kien An District,12,11,8,3,2
2022-07-04,Hai Phong City,Kien An District,13,7,5,2,2
2022-07-04,Hai Phong City,Kien An District,14,9,5,4,2
2022-07-04,Hai Phong City,Kien An District,15,13,8,5,2
2022-07-04,Hai Phong City,Kien An District,16,11,10,1,1
2022-07-04,Hai Phong City,Kien An District,17,9,7,2,0
2022-07-04,Hai Phong City,Kien An District,18,4,3,1,0
2022-07-04,Hai Phong City,Kien An District,19,14,10,4,0
2022-07-04,Hai Phong City,Kien An District,20,8,8,0,0
2022-07-04,Hai Phong City,Kien An District,21,4,4,0,0
2022-07-04,Hai Phong City,Le Chan District,0,2,1,1,0
2022-07-04,Hai Phong City,Le Chan District,1,2,2,0,0
2022-07-04,Hai Phong City,Le Chan District,3,1,0,1,0
2022-07-04,Hai Phong City,Le Chan District,6,1,1,0,0
2022-07-04,Hai Phong City,Le Chan District,7,34,30,4,3
2022-07-04,Hai Phong City,Le Chan District,8,96,81,15,8
2022-07-04,Hai Phong City,Le Chan District,9,91,81,10,0
2022-07-04,Hai Phong City,Le Chan District,10,205,180,25,4
2022-07-04,Hai Phong City,Le Chan District,11,344,310,34,14
2022-07-04,Hai Phong City,Le Chan District,12,225,196,29,9
2022-07-04,Hai Phong City,Le Chan District,13,145,123,22,6
2022-07-04,Hai Phong City,Le Chan District,14,188,152,36,26
2022-07-04,Hai Phong City,Le Chan District,15,189,145,44,24
2022-07-04,Hai Phong City,Le Chan District,16,189,161,28,11
2022-07-04,Hai Phong City,Le Chan District,17,178,160,18,5
2022-07-04,Hai Phong City,Le Chan District,18,199,174,25,4
2022-07-04,Hai Phong City,Le Chan District,19,180,158,22,1
2022-07-04,Hai Phong City,Le Chan District,20,132,108,24,3
2022-07-04,Hai Phong City,Le Chan District,21,93,60,33,17
2022-07-04,Hai Phong City,Ngo Quyen District,1,2,0,2,0
2022-07-04,Hai Phong City,Ngo Quyen District,4,2,1,1,0
2022-07-04,Hai Phong City,Ngo Quyen District,6,2,1,1,1
2022-07-04,Hai Phong City,Ngo Quyen District,7,21,17,4,1
2022-07-04,Hai Phong City,Ngo Quyen District,8,88,76,12,4
2022-07-04,Hai Phong City,Ngo Quyen District,9,109,95,14,2
2022-07-04,Hai Phong City,Ngo Quyen District,10,141,126,15,8
2022-07-04,Hai Phong City,Ngo Quyen District,11,273,236,37,13
2022-07-04,Hai Phong City,Ngo Quyen District,12,175,152,23,9
2022-07-04,Hai Phong City,Ngo Quyen District,13,129,110,19,3
2022-07-04,Hai Phong City,Ngo Quyen District,14,176,145,31,19
2022-07-04,Hai Phong City,Ngo Quyen District,15,163,145,18,9
2022-07-04,Hai Phong City,Ngo Quyen District,16,118,99,19,4
2022-07-04,Hai Phong City,Ngo Quyen District,17,136,124,12,1
2022-07-04,Hai Phong City,Ngo Quyen District,18,126,108,18,1
2022-07-04,Hai Phong City,Ngo Quyen District,19,157,145,12,2
2022-07-04,Hai Phong City,Ngo Quyen District,20,132,103,29,2
2022-07-04,Hai Phong City,Ngo Quyen District,21,70,56,14,10
2022-07-04,Hai Phong City,Ngo Quyen District,22,1,0,1,0
2022-07-04,Hai Phong City,Thuy Nguyen,10,3,0,3,3
2022-07-04,Hai Phong City,Thuy Nguyen,11,2,1,1,1
2022-07-04,Hai Phong City,Thuy Nguyen,12,1,0,1,1
2022-07-04,Hai Phong City,Thuy Nguyen,13,2,0,2,2
2022-07-04,Hai Phong City,Thuy Nguyen,17,1,0,1,1
2022-07-04,Hue City,Hue City,0,3,3,0,0
2022-07-04,Hue City,Hue City,1,1,1,0,0
2022-07-04,Hue City,Hue City,2,1,1,0,0
2022-07-04,Hue City,Hue City,3,1,1,0,0
2022-07-04,Hue City,Hue City,5,1,1,0,0
2022-07-04,Hue City,Hue City,6,73,69,4,0
2022-07-04,Hue City,Hue City,7,212,192,20,1
2022-07-04,Hue City,Hue City,8,305,289,16,2
2022-07-04,Hue City,Hue City,9,303,272,31,0
2022-07-04,Hue City,Hue City,10,385,354,31,0
2022-07-04,Hue City,Hue City,11,908,851,57,9
2022-07-04,Hue City,Hue City,12,641,584,57,1
2022-07-04,Hue City,Hue City,13,431,401,30,0
2022-07-04,Hue City,Hue City,14,428,396,32,1
2022-07-04,Hue City,Hue City,15,470,446,24,3
2022-07-04,Hue City,Hue City,16,395,365,30,2
2022-07-04,Hue City,Hue City,17,468,441,27,2
2022-07-04,Hue City,Hue City,18,546,501,45,0
2022-07-04,Hue City,Hue City,19,620,573,47,2
2022-07-04,Hue City,Hue City,20,447,399,48,7
2022-07-04,Hue City,Hue City,21,268,218,50,15
2022-07-04,Hue City,Hue City,22,2,1,1,1
2022-07-04,Hue City,Hue City,23,1,0,1,0
2022-07-04,Hue City,Huong Thuy,9,2,2,0,0
2022-07-04,Hue City,Huong Thuy,11,2,1,1,0
2022-07-04,Hue City,Huong Thuy,12,4,4,0,0
2022-07-04,Hue City,Huong Thuy,13,2,2,0,0
2022-07-04,Hue City,Huong Thuy,18,1,1,0,0
2022-07-04,Hue City,Huong Thuy,19,2,2,0,0
2022-07-04,Hue City,Huong Tra,10,1,1,0,0
2022-07-04,Hue City,Huong Tra,12,2,1,1,1
2022-07-04,Hue City,Phu Vang,7,2,1,1,0
2022-07-04,Hue City,Phu Vang,8,3,2,1,0
2022-07-04,Hue City,Phu Vang,11,2,2,0,0
2022-07-04,Hue City,Phu Vang,12,4,3,1,0
2022-07-04,Hue City,Phu Vang,14,2,2,0,0
2022-07-04,Hue City,Phu Vang,15,3,2,1,0
2022-07-04,Hue City,Phu Vang,16,4,2,2,1
2022-07-04,Hue City,Phu Vang,17,3,3,0,0
2022-07-04,Hue City,Phu Vang,18,3,3,0,0
2022-07-04,Hue City,Phu Vang,19,2,1,1,0
2022-07-04,Hue City,Phu Vang,21,1,1,0,0
2022-07-04,Khanh Hoa,Dien Khanh,9,1,1,0,0
2022-07-04,Khanh Hoa,Nha Trang City,0,1,1,0,0
2022-07-04,Khanh Hoa,Nha Trang City,2,3,0,3,0
2022-07-04,Khanh Hoa,Nha Trang City,5,3,2,1,0
2022-07-04,Khanh Hoa,Nha Trang City,6,29,25,4,0
2022-07-04,Khanh Hoa,Nha Trang City,7,123,114,9,1
2022-07-04,Khanh Hoa,Nha Trang City,8,229,204,25,1
2022-07-04,Khanh Hoa,Nha Trang City,9,235,213,22,0
2022-07-04,Khanh Hoa,Nha Trang City,10,209,192,17,0
2022-07-04,Khanh Hoa,Nha Trang City,11,368,347,21,2
2022-07-04,Khanh Hoa,Nha Trang City,12,309,291,18,0
2022-07-04,Khanh Hoa,Nha Trang City,13,301,285,16,2
2022-07-04,Khanh Hoa,Nha Trang City,14,311,291,20,3
2022-07-04,Khanh Hoa,Nha Trang City,15,222,206,16,1
2022-07-04,Khanh Hoa,Nha Trang City,16,234,223,11,0
2022-07-04,Khanh Hoa,Nha Trang City,17,233,215,18,0
2022-07-04,Khanh Hoa,Nha Trang City,18,258,232,26,2
2022-07-04,Khanh Hoa,Nha Trang City,19,318,279,39,7
2022-07-04,Khanh Hoa,Nha Trang City,20,199,185,14,1
2022-07-04,Khanh Hoa,Nha Trang City,21,135,97,38,10
2022-07-04,Khanh Hoa,Nha Trang City,22,2,0,2,1
2022-07-04,Lam Dong,Da Lat City,6,2,1,1,1
2022-07-04,Lam Dong,Da Lat City,7,67,25,42,39
2022-07-04,Lam Dong,Da Lat City,8,94,57,37,31
2022-07-04,Lam Dong,Da Lat City,9,85,58,27,13
2022-07-04,Lam Dong,Da Lat City,10,77,57,20,12
2022-07-04,Lam Dong,Da Lat City,11,140,97,43,34
2022-07-04,Lam Dong,Da Lat City,12,142,91,51,39
2022-07-04,Lam Dong,Da Lat City,13,147,85,62,51
2022-07-04,Lam Dong,Da Lat City,14,120,68,52,44
2022-07-04,Lam Dong,Da Lat City,15,105,83,22,12
2022-07-04,Lam Dong,Da Lat City,16,110,74,36,32
2022-07-04,Lam Dong,Da Lat City,17,135,90,45,35
2022-07-04,Lam Dong,Da Lat City,18,113,85,28,21
2022-07-04,Lam Dong,Da Lat City,19,122,90,32,25
2022-07-04,Lam Dong,Da Lat City,20,106,53,53,37
2022-07-04,Lam Dong,Da Lat City,21,47,13,34,26
2022-07-04,Lam Dong,Lam ha,16,2,0,2,2
2022-07-04,Nghe An,Cua Lo Town,9,2,0,2,2
2022-07-04,Nghe An,Cua Lo Town,13,1,0,1,1
2022-07-04,Nghe An,Vinh City,5,1,0,1,0
2022-07-04,Nghe An,Vinh City,6,7,2,5,0
2022-07-04,Nghe An,Vinh City,7,136,117,19,6
2022-07-04,Nghe An,Vinh City,8,185,163,22,1
2022-07-04,Nghe An,Vinh City,9,147,134,13,1
2022-07-04,Nghe An,Vinh City,10,248,198,50,23
2022-07-04,Nghe An,Vinh City,11,422,332,90,52
2022-07-04,Nghe An,Vinh City,12,224,192,32,6
2022-07-04,Nghe An,Vinh City,13,144,126,18,3
2022-07-04,Nghe An,Vinh City,14,226,186,40,7
2022-07-04,Nghe An,Vinh City,15,201,176,25,5
2022-07-04,Nghe An,Vinh City,16,145,120,25,9
2022-07-04,Nghe An,Vinh City,17,130,107,23,8
2022-07-04,Nghe An,Vinh City,18,198,154,44,17
2022-07-04,Nghe An,Vinh City,19,191,138,53,31
2022-07-04,Nghe An,Vinh City,20,138,105,33,17
2022-07-04,Nghe An,Vinh City,21,98,55,43,32
2022-07-04,Nghe An,Vinh City,22,1,0,1,0
2022-07-04,Quang Nam,Dien Ban,12,1,0,1,1
2022-07-04,Quang Nam,Hoi An City,7,14,12,2,1
2022-07-04,Quang Nam,Hoi An City,8,34,25,9,3
2022-07-04,Quang Nam,Hoi An City,9,22,22,0,0
2022-07-04,Quang Nam,Hoi An City,10,33,26,7,2
2022-07-04,Quang Nam,Hoi An City,11,64,44,20,13
2022-07-04,Quang Nam,Hoi An City,12,66,47,19,7
2022-07-04,Quang Nam,Hoi An City,13,38,34,4,0
2022-07-04,Quang Nam,Hoi An City,14,51,38,13,3
2022-07-04,Quang Nam,Hoi An City,15,43,35,8,2
2022-07-04,Quang Nam,Hoi An City,16,33,27,6,0
2022-07-04,Quang Nam,Hoi An City,17,32,31,1,0
2022-07-04,Quang Nam,Hoi An City,18,59,42,17,7
2022-07-04,Quang Nam,Hoi An City,19,51,38,13,8
2022-07-04,Quang Nam,Hoi An City,20,51,33,18,12
2022-07-04,Quang Nam,Hoi An City,21,21,7,14,10
2022-07-04,Quang Nam,Hoi An City,22,2,0,2,0
2022-07-04,Quang Nam,Tam Ky City,11,1,0,1,1
2022-07-04,Quang Ninh,Cam Pha City,8,1,0,1,1
2022-07-04,Quang Ninh,Cam Pha City,10,2,0,2,2
2022-07-04,Quang Ninh,Cam Pha City,11,1,0,1,1
2022-07-04,Quang Ninh,Cam Pha City,12,3,0,3,3
2022-07-04,Quang Ninh,Cam Pha City,13,1,0,1,1
2022-07-04,Quang Ninh,Cam Pha City,17,1,0,1,1
2022-07-04,Quang Ninh,Ha Long City,1,1,0,1,1
2022-07-04,Quang Ninh,Ha Long City,2,1,0,1,0
2022-07-04,Quang Ninh,Ha Long City,7,20,12,8,6
2022-07-04,Quang Ninh,Ha Long City,8,55,32,23,10
2022-07-04,Quang Ninh,Ha Long City,9,56,35,21,12
2022-07-04,Quang Ninh,Ha Long City,10,93,62,31,16
2022-07-04,Quang Ninh,Ha Long City,11,158,109,49,30
2022-07-04,Quang Ninh,Ha Long City,12,127,80,47,31
2022-07-04,Quang Ninh,Ha Long City,13,90,52,38,18
2022-07-04,Quang Ninh,Ha Long City,14,74,48,26,15
2022-07-04,Quang Ninh,Ha Long City,15,61,38,23,8
2022-07-04,Quang Ninh,Ha Long City,16,73,46,27,12
2022-07-04,Quang Ninh,Ha Long City,17,66,43,23,10
2022-07-04,Quang Ninh,Ha Long City,18,68,42,26,12
2022-07-04,Quang Ninh,Ha Long City,19,62,42,20,12
2022-07-04,Quang Ninh,Ha Long City,20,44,34,10,5
2022-07-04,Quang Ninh,Ha Long City,21,1,0,1,0
2022-07-04,Quang Ninh,Hoanh Bo,8,1,0,1,1
2022-07-04,Quang Ninh,Hoanh Bo,10,1,0,1,1
2022-07-04,Thai Nguyen,Dong Hy,7,1,0,1,0
2022-07-04,Thai Nguyen,Dong Hy,12,2,1,1,0
2022-07-04,Thai Nguyen,Dong Hy,13,1,1,0,0
2022-07-04,Thai Nguyen,Thai Nguyen City,0,5,5,0,0
2022-07-04,Thai Nguyen,Thai Nguyen City,2,1,0,1,0
2022-07-04,Thai Nguyen,Thai Nguyen City,6,5,2,3,0
2022-07-04,Thai Nguyen,Thai Nguyen City,7,96,87,9,1
2022-07-04,Thai Nguyen,Thai Nguyen City,8,143,135,8,1
2022-07-04,Thai Nguyen,Thai Nguyen City,9,127,117,10,0
2022-07-04,Thai Nguyen,Thai Nguyen City,10,159,149,10,0
2022-07-04,Thai Nguyen,Thai Nguyen City,11,398,369,29,4
2022-07-04,Thai Nguyen,Thai Nguyen City,12,301,278,23,2
2022-07-04,Thai Nguyen,Thai Nguyen City,13,161,150,11,0
2022-07-04,Thai Nguyen,Thai Nguyen City,14,175,156,19,3
2022-07-04,Thai Nguyen,Thai Nguyen City,15,163,147,16,3
2022-07-04,Thai Nguyen,Thai Nguyen City,16,140,130,10,0
2022-07-04,Thai Nguyen,Thai Nguyen City,17,149,140,9,1
2022-07-04,Thai Nguyen,Thai Nguyen City,18,209,194,15,0
2022-07-04,Thai Nguyen,Thai Nguyen City,19,200,186,14,0
2022-07-04,Thai Nguyen,Thai Nguyen City,20,204,187,17,0
2022-07-04,Thai Nguyen,Thai Nguyen City,21,133,116,17,1
2022-07-04,Thai Nguyen,Thai Nguyen City,23,1,1,0,0
2022-07-04,Vung Tau,Ba Ria City,7,1,0,1,0
2022-07-04,Vung Tau,Ba Ria City,8,3,0,3,3
2022-07-04,Vung Tau,Ba Ria City,9,4,1,3,3
2022-07-04,Vung Tau,Ba Ria City,10,10,5,5,5
2022-07-04,Vung Tau,Ba Ria City,11,7,4,3,3
2022-07-04,Vung Tau,Ba Ria City,12,6,4,2,0
2022-07-04,Vung Tau,Ba Ria City,13,5,5,0,0
2022-07-04,Vung Tau,Ba Ria City,14,2,2,0,0
2022-07-04,Vung Tau,Ba Ria City,15,4,3,1,1
2022-07-04,Vung Tau,Ba Ria City,16,8,6,2,2
2022-07-04,Vung Tau,Ba Ria City,17,2,1,1,1
2022-07-04,Vung Tau,Ba Ria City,18,4,3,1,0
2022-07-04,Vung Tau,Ba Ria City,19,1,0,1,1
2022-07-04,Vung Tau,Ba Ria City,20,1,0,1,1
2022-07-04,Vung Tau,Ba Ria City,21,2,0,2,2
2022-07-04,Vung Tau,Vung Tau City,3,1,1,0,0
2022-07-04,Vung Tau,Vung Tau City,5,2,2,0,0
2022-07-04,Vung Tau,Vung Tau City,6,39,31,8,4
2022-07-04,Vung Tau,Vung Tau City,7,141,119,22,10
2022-07-04,Vung Tau,Vung Tau City,8,197,175,22,3
2022-07-04,Vung Tau,Vung Tau City,9,180,166,14,3
2022-07-04,Vung Tau,Vung Tau City,10,246,227,19,9
2022-07-04,Vung Tau,Vung Tau City,11,404,353,51,12
2022-07-04,Vung Tau,Vung Tau City,12,310,283,27,1
2022-07-04,Vung Tau,Vung Tau City,13,242,223,19,3
2022-07-04,Vung Tau,Vung Tau City,14,196,170,26,5
2022-07-04,Vung Tau,Vung Tau City,15,263,237,26,8
2022-07-04,Vung Tau,Vung Tau City,16,237,221,16,3
2022-07-04,Vung Tau,Vung Tau City,17,239,207,32,10
2022-07-04,Vung Tau,Vung Tau City,18,275,245,30,9
2022-07-04,Vung Tau,Vung Tau City,19,273,239,34,12
2022-07-04,Vung Tau,Vung Tau City,20,196,172,24,7
2022-07-04,Vung Tau,Vung Tau City,21,89,76,13,3
2022-07-04,Vung Tau,Vung Tau City,22,2,0,2,0
2022-07-05,Bac Ninh,Bác Ninh City,6,3,2,1,0
2022-07-05,Bac Ninh,Bác Ninh City,7,76,69,7,0
2022-07-05,Bac Ninh,Bác Ninh City,8,123,113,10,0
2022-07-05,Bac Ninh,Bác Ninh City,9,103,91,12,0
2022-07-05,Bac Ninh,Bác Ninh City,10,212,189,23,6
2022-07-05,Bac Ninh,Bác Ninh City,11,363,283,80,47
2022-07-05,Bac Ninh,Bác Ninh City,12,241,218,23,4
2022-07-05,Bac Ninh,Bác Ninh City,13,118,102,16,3
2022-07-05,Bac Ninh,Bác Ninh City,14,165,153,12,2
2022-07-05,Bac Ninh,Bác Ninh City,15,159,144,15,1
2022-07-05,Bac Ninh,Bác Ninh City,16,122,114,8,3
2022-07-05,Bac Ninh,Bác Ninh City,17,136,128,8,2
2022-07-05,Bac Ninh,Bác Ninh City,18,183,58,125,106
2022-07-05,Bac Ninh,Bác Ninh City,19,256,39,217,194
2022-07-05,Bac Ninh,Bác Ninh City,20,285,88,197,151
2022-07-05,Bac Ninh,Bác Ninh City,21,152,68,84,68
2022-07-05,Bac Ninh,Que Vo,8,1,0,1,1
2022-07-05,Bac Ninh,Que Vo,9,1,1,0,0
2022-07-05,Bac Ninh,Que Vo,10,1,0,1,1
2022-07-05,Bac Ninh,Que Vo,12,1,0,1,1
2022-07-05,Bac Ninh,Que Vo,13,2,1,1,1
2022-07-05,Bac Ninh,Que Vo,14,1,0,1,1
2022-07-05,Bac Ninh,Que Vo,17,1,1,0,0
2022-07-05,Bac Ninh,Que Vo,21,1,0,1,1
2022-07-05,Bac Ninh,Tien Du,10,1,0,1,1
2022-07-05,Bac Ninh,Tien Du,11,2,0,2,1
2022-07-05,Bac Ninh,Tien Du,12,2,0,2,2
2022-07-05,Bac Ninh,Tien Du,13,2,0,2,2
2022-07-05,Bac Ninh,Tien Du,15,1,0,1,1
2022-07-05,Bac Ninh,Tien Du,19,1,0,1,1
2022-07-05,Bac Ninh,Tu Son,10,2,0,2,2
2022-07-05,Bac Ninh,Tu Son,11,3,0,3,3
2022-07-05,Bac Ninh,Tu Son,12,2,0,2,1
2022-07-05,Bac Ninh,Tu Son,15,1,0,1,1
2022-07-05,Bac Ninh,Tu Son,18,1,0,1,1
2022-07-05,Bac Ninh,Tu Son,19,3,0,3,3
2022-07-05,Binh Duong,Ben Cat,8,2,0,2,1
2022-07-05,Binh Duong,Ben Cat,9,1,0,1,1
2022-07-05,Binh Duong,Ben Cat,10,3,0,3,3
2022-07-05,Binh Duong,Ben Cat,11,1,0,1,1
2022-07-05,Binh Duong,Ben Cat,12,1,0,1,1
2022-07-05,Binh Duong,Ben Cat,14,3,0,3,3
2022-07-05,Binh Duong,Ben Cat,15,3,0,3,3
2022-07-05,Binh Duong,Ben Cat,16,2,0,2,1
2022-07-05,Binh Duong,Ben Cat,18,1,0,1,1
2022-07-05,Binh Duong,Di An,6,2,1,1,0
2022-07-05,Binh Duong,Di An,7,7,1,6,4
2022-07-05,Binh Duong,Di An,8,22,14,8,6
2022-07-05,Binh Duong,Di An,9,24,17,7,2
2022-07-05,Binh Duong,Di An,10,29,22,7,6
2022-07-05,Binh Duong,Di An,11,39,29,10,4
2022-07-05,Binh Duong,Di An,12,36,30,6,3
2022-07-05,Binh Duong,Di An,13,42,34,8,3
2022-07-05,Binh Duong,Di An,14,48,32,16,11
2022-07-05,Binh Duong,Di An,15,44,32,12,5
2022-07-05,Binh Duong,Di An,16,22,17,5,2
2022-07-05,Binh Duong,Di An,17,24,18,6,4
2022-07-05,Binh Duong,Di An,18,38,31,7,3
2022-07-05,Binh Duong,Di An,19,45,31,14,8
2022-07-05,Binh Duong,Di An,20,19,15,4,1
2022-07-05,Binh Duong,Di An,21,17,7,10,10
2022-07-05,Binh Duong,Di An,22,1,0,1,0
2022-07-05,Binh Duong,Tan Uyen,7,1,0,1,1
2022-07-05,Binh Duong,Tan Uyen,8,3,1,2,1
2022-07-05,Binh Duong,Tan Uyen,9,4,1,3,3
2022-07-05,Binh Duong,Tan Uyen,10,2,0,2,2
2022-07-05,Binh Duong,Tan Uyen,11,8,4,4,1
2022-07-05,Binh Duong,Tan Uyen,12,5,2,3,3
2022-07-05,Binh Duong,Tan Uyen,13,3,2,1,1
2022-07-05,Binh Duong,Tan Uyen,14,4,2,2,1
2022-07-05,Binh Duong,Tan Uyen,15,2,1,1,1
2022-07-05,Binh Duong,Tan Uyen,16,3,1,2,1
2022-07-05,Binh Duong,Tan Uyen,17,3,0,3,3
2022-07-05,Binh Duong,Tan Uyen,18,6,3,3,3
2022-07-05,Binh Duong,Tan Uyen,19,1,1,0,0
2022-07-05,Binh Duong,Tan Uyen,20,2,1,1,1
2022-07-05,Binh Duong,Tan Uyen,21,1,0,1,1
2022-07-05,Binh Duong,Thu Dau Mot Town,2,2,0,2,0
2022-07-05,Binh Duong,Thu Dau Mot Town,6,47,35,12,7
2022-07-05,Binh Duong,Thu Dau Mot Town,7,121,111,10,2
2022-07-05,Binh Duong,Thu Dau Mot Town,8,216,198,18,0
2022-07-05,Binh Duong,Thu Dau Mot Town,9,279,254,25,5
2022-07-05,Binh Duong,Thu Dau Mot Town,10,418,389,29,10
2022-07-05,Binh Duong,Thu Dau Mot Town,11,695,616,79,31
2022-07-05,Binh Duong,Thu Dau Mot Town,12,512,475,37,6
2022-07-05,Binh Duong,Thu Dau Mot Town,13,442,402,40,9
2022-07-05,Binh Duong,Thu Dau Mot Town,14,419,388,31,6
2022-07-05,Binh Duong,Thu Dau Mot Town,15,325,307,18,3
2022-07-05,Binh Duong,Thu Dau Mot Town,16,311,286,25,4
2022-07-05,Binh Duong,Thu Dau Mot Town,17,372,343,29,10
2022-07-05,Binh Duong,Thu Dau Mot Town,18,419,394,25,4
2022-07-05,Binh Duong,Thu Dau Mot Town,19,396,355,41,12
2022-07-05,Binh Duong,Thu Dau Mot Town,20,278,239,39,12
2022-07-05,Binh Duong,Thu Dau Mot Town,21,131,105,26,11
2022-07-05,Binh Duong,Thu Dau Mot Town,22,2,0,2,0
2022-07-05,Binh Duong,Thuan An,6,1,0,1,0
2022-07-05,Binh Duong,Thuan An,7,5,1,4,3
2022-07-05,Binh Duong,Thuan An,8,31,14,17,14
2022-07-05,Binh Duong,Thuan An,9,44,34,10,6
2022-07-05,Binh Duong,Thuan An,10,77,62,15,7
2022-07-05,Binh Duong,Thuan An,11,84,73,11,3
2022-07-05,Binh Duong,Thuan An,12,72,57,15,8
2022-07-05,Binh Duong,Thuan An,13,84,61,23,11
2022-07-05,Binh Duong,Thuan An,14,71,54,17,15
2022-07-05,Binh Duong,Thuan An,15,57,47,10,3
2022-07-05,Binh Duong,Thuan An,16,41,35,6,3
2022-07-05,Binh Duong,Thuan An,17,46,40,6,2
2022-07-05,Binh Duong,Thuan An,18,67,52,15,4
2022-07-05,Binh Duong,Thuan An,19,46,39,7,4
2022-07-05,Binh Duong,Thuan An,20,28,20,8,4
2022-07-05,Binh Duong,Thuan An,21,20,4,16,14
2022-07-05,Can Tho City,Binh Thuy District,7,1,0,1,0
2022-07-05,Can Tho City,Binh Thuy District,8,3,3,0,0
2022-07-05,Can Tho City,Binh Thuy District,9,8,7,1,0
2022-07-05,Can Tho City,Binh Thuy District,10,7,7,0,0
2022-07-05,Can Tho City,Binh Thuy District,11,18,13,5,1
2022-07-05,Can Tho City,Binh Thuy District,12,9,8,1,0
2022-07-05,Can Tho City,Binh Thuy District,13,11,8,3,0
2022-07-05,Can Tho City,Binh Thuy District,14,8,8,0,0
2022-07-05,Can Tho City,Binh Thuy District,15,14,12,2,2
2022-07-05,Can Tho City,Binh Thuy District,16,12,11,1,0
2022-07-05,Can Tho City,Binh Thuy District,17,12,10,2,0
2022-07-05,Can Tho City,Binh Thuy District,18,9,6,3,0
2022-07-05,Can Tho City,Binh Thuy District,19,12,11,1,0
2022-07-05,Can Tho City,Binh Thuy District,20,12,9,3,1
2022-07-05,Can Tho City,Binh Thuy District,21,2,2,0,0
2022-07-05,Can Tho City,Cai Rang District,6,6,3,3,2
2022-07-05,Can Tho City,Cai Rang District,7,3,2,1,1
2022-07-05,Can Tho City,Cai Rang District,8,7,6,1,0
2022-07-05,Can Tho City,Cai Rang District,9,7,6,1,0
2022-07-05,Can Tho City,Cai Rang District,10,11,10,1,0
2022-07-05,Can Tho City,Cai Rang District,11,19,18,1,0
2022-07-05,Can Tho City,Cai Rang District,12,12,9,3,0
2022-07-05,Can Tho City,Cai Rang District,13,9,9,0,0
2022-07-05,Can Tho City,Cai Rang District,14,11,10,1,0
2022-07-05,Can Tho City,Cai Rang District,15,7,6,1,0
2022-07-05,Can Tho City,Cai Rang District,16,8,7,1,1
2022-07-05,Can Tho City,Cai Rang District,17,6,6,0,0
2022-07-05,Can Tho City,Cai Rang District,18,12,12,0,0
2022-07-05,Can Tho City,Cai Rang District,19,10,10,0,0
2022-07-05,Can Tho City,Cai Rang District,20,6,6,0,0
2022-07-05,Can Tho City,Cai Rang District,21,5,3,2,0
2022-07-05,Can Tho City,Ninh Kieu District,1,1,1,0,0
2022-07-05,Can Tho City,Ninh Kieu District,3,1,1,0,0
2022-07-05,Can Tho City,Ninh Kieu District,4,2,0,2,2
2022-07-05,Can Tho City,Ninh Kieu District,5,1,1,0,0
2022-07-05,Can Tho City,Ninh Kieu District,6,42,38,4,2
2022-07-05,Can Tho City,Ninh Kieu District,7,149,137,12,0
2022-07-05,Can Tho City,Ninh Kieu District,8,226,204,22,0
2022-07-05,Can Tho City,Ninh Kieu District,9,269,261,8,0
2022-07-05,Can Tho City,Ninh Kieu District,10,508,493,15,0
2022-07-05,Can Tho City,Ninh Kieu District,11,822,776,46,7
2022-07-05,Can Tho City,Ninh Kieu District,12,539,511,28,0
2022-07-05,Can Tho City,Ninh Kieu District,13,484,459,25,0
2022-07-05,Can Tho City,Ninh Kieu District,14,461,440,21,0
2022-07-05,Can Tho City,Ninh Kieu District,15,363,336,27,0
2022-07-05,Can Tho City,Ninh Kieu District,16,433,416,17,0
2022-07-05,Can Tho City,Ninh Kieu District,17,436,421,15,0
2022-07-05,Can Tho City,Ninh Kieu District,18,514,499,15,0
2022-07-05,Can Tho City,Ninh Kieu District,19,458,430,28,0
2022-07-05,Can Tho City,Ninh Kieu District,20,352,321,31,0
2022-07-05,Can Tho City,Ninh Kieu District,21,229,206,23,0
2022-07-05,Can Tho City,Ninh Kieu District,22,1,0,1,0
2022-07-05,Dong Nai,Bien Hoa City,0,4,2,2,1
2022-07-05,Dong Nai,Bien Hoa City,1,2,0,2,0
2022-07-05,Dong Nai,Bien Hoa City,2,1,1,0,0
2022-07-05,Dong Nai,Bien Hoa City,3,1,0,1,0
2022-07-05,Dong Nai,Bien Hoa City,4,1,1,0,0
2022-07-05,Dong Nai,Bien Hoa City,5,3,2,1,1
2022-07-05,Dong Nai,Bien Hoa City,6,39,32,7,6
2022-07-05,Dong Nai,Bien Hoa City,7,176,153,23,9
2022-07-05,Dong Nai,Bien Hoa City,8,311,287,24,4
2022-07-05,Dong Nai,Bien Hoa City,9,416,383,33,2
2022-07-05,Dong Nai,Bien Hoa City,10,730,661,69,13
2022-07-05,Dong Nai,Bien Hoa City,11,1148,1074,74,19
2022-07-05,Dong Nai,Bien Hoa City,12,822,748,74,14
2022-07-05,Dong Nai,Bien Hoa City,13,903,835,68,18
2022-07-05,Dong Nai,Bien Hoa City,14,707,663,44,9
2022-07-05,Dong Nai,Bien Hoa City,15,542,500,42,4
2022-07-05,Dong Nai,Bien Hoa City,16,512,474,38,6
2022-07-05,Dong Nai,Bien Hoa City,17,609,558,51,4
2022-07-05,Dong Nai,Bien Hoa City,18,675,628,47,4
2022-07-05,Dong Nai,Bien Hoa City,19,693,623,70,12
2022-07-05,Dong Nai,Bien Hoa City,20,600,515,85,18
2022-07-05,Dong Nai,Bien Hoa City,21,241,176,65,20
2022-07-05,Dong Nai,Bien Hoa City,22,3,0,3,0
2022-07-05,Dong Nai,Long Khanh,9,1,0,1,1
2022-07-05,Dong Nai,Long Khanh,12,1,0,1,1
2022-07-05,Dong Nai,Long Khanh,13,1,0,1,1
2022-07-05,Dong Nai,Long Thanh,10,3,0,3,3
2022-07-05,Dong Nai,Long Thanh,11,3,0,3,2
2022-07-05,Dong Nai,Long Thanh,12,3,0,3,3
2022-07-05,Dong Nai,Long Thanh,13,3,0,3,3
2022-07-05,Dong Nai,Long Thanh,15,2,0,2,2
2022-07-05,Dong Nai,Long Thanh,16,1,0,1,1
2022-07-05,Dong Nai,Long Thanh,19,1,0,1,1
2022-07-05,Dong Nai,Long Thanh,20,4,0,4,4
2022-07-05,Dong Nai,Long Thanh,21,2,0,2,1
2022-07-05,Dong Nai,Long Thanh,22,1,0,1,0
2022-07-05,Dong Nai,Nhon trach,12,2,0,2,2
2022-07-05,Dong Nai,Nhon trach,16,3,0,3,2
2022-07-05,Dong Nai,Trang Bom,9,1,0,1,1
2022-07-05,Dong Nai,Trang Bom,10,1,1,0,0
2022-07-05,Dong Nai,Trang Bom,11,2,0,2,2
2022-07-05,Dong Nai,Trang Bom,16,2,0,2,2
2022-07-05,Dong Nai,Trang Bom,18,1,0,1,1
2022-07-05,Dong Nai,Trang Bom,19,1,1,0,0
2022-07-05,Dong Nai,Trang Bom,20,1,1,0,0
2022-07-05,Hai Phong City,An Duong,8,4,2,2,2
2022-07-05,Hai Phong City,An Duong,9,1,0,1,0
2022-07-05,Hai Phong City,An Duong,10,8,4,4,3
2022-07-05,Hai Phong City,An Duong,11,11,3,8,7
2022-07-05,Hai Phong City,An Duong,12,3,2,1,0
2022-07-05,Hai Phong City,An Duong,13,3,2,1,1
2022-07-05,Hai Phong City,An Duong,14,2,2,0,0
2022-07-05,Hai Phong City,An Duong,15,1,0,1,1
2022-07-05,Hai Phong City,An Duong,16,3,3,0,0
2022-07-05,Hai Phong City,An Duong,17,6,5,1,0
2022-07-05,Hai Phong City,An Duong,19,1,0,1,1
2022-07-05,Hai Phong City,An Duong,20,1,0,1,1
2022-07-05,Hai Phong City,An Duong,21,6,0,6,4
2022-07-05,Hai Phong City,Do Son District,18,2,0,2,2
2022-07-05,Hai Phong City,Do Son District,19,2,0,2,2
2022-07-05,Hai Phong City,Do Son District,20,1,0,1,1
2022-07-05,Hai Phong City,Duong Kinh District,10,1,0,1,1
2022-07-05,Hai Phong City,Hai An District,6,1,0,1,0
2022-07-05,Hai Phong City,Hai An District,7,15,11,4,1
2022-07-05,Hai Phong City,Hai An District,8,15,12,3,1
2022-07-05,Hai Phong City,Hai An District,9,18,18,0,0
2022-07-05,Hai Phong City,Hai An District,10,24,19,5,2
2022-07-05,Hai Phong City,Hai An District,11,56,48,8,3
2022-07-05,Hai Phong City,Hai An District,12,32,27,5,1
2022-07-05,Hai Phong City,Hai An District,13,28,25,3,1
2022-07-05,Hai Phong City,Hai An District,14,14,11,3,1
2022-07-05,Hai Phong City,Hai An District,15,15,10,5,2
2022-07-05,Hai Phong City,Hai An District,16,16,13,3,2
2022-07-05,Hai Phong City,Hai An District,17,14,11,3,2
2022-07-05,Hai Phong City,Hai An District,18,18,6,12,11
2022-07-05,Hai Phong City,Hai An District,19,25,9,16,10
2022-07-05,Hai Phong City,Hai An District,20,21,3,18,12
2022-07-05,Hai Phong City,Hai An District,21,15,2,13,5
2022-07-05,Hai Phong City,Hong Bang District,0,2,2,0,0
2022-07-05,Hai Phong City,Hong Bang District,1,1,0,1,0
2022-07-05,Hai Phong City,Hong Bang District,7,13,11,2,0
2022-07-05,Hai Phong City,Hong Bang District,8,52,45,7,1
2022-07-05,Hai Phong City,Hong Bang District,9,47,40,7,2
2022-07-05,Hai Phong City,Hong Bang District,10,64,57,7,2
2022-07-05,Hai Phong City,Hong Bang District,11,132,112,20,9
2022-07-05,Hai Phong City,Hong Bang District,12,85,74,11,5
2022-07-05,Hai Phong City,Hong Bang District,13,65,52,13,7
2022-07-05,Hai Phong City,Hong Bang District,14,52,46,6,1
2022-07-05,Hai Phong City,Hong Bang District,15,49,45,4,1
2022-07-05,Hai Phong City,Hong Bang District,16,54,47,7,1
2022-07-05,Hai Phong City,Hong Bang District,17,63,48,15,7
2022-07-05,Hai Phong City,Hong Bang District,18,60,23,37,32
2022-07-05,Hai Phong City,Hong Bang District,19,76,20,56,44
2022-07-05,Hai Phong City,Hong Bang District,20,57,15,42,31
2022-07-05,Hai Phong City,Hong Bang District,21,21,6,15,13
2022-07-05,Hai Phong City,Kien An District,7,4,1,3,3
2022-07-05,Hai Phong City,Kien An District,8,9,6,3,3
2022-07-05,Hai Phong City,Kien An District,9,10,5,5,0
2022-07-05,Hai Phong City,Kien An District,10,9,7,2,1
2022-07-05,Hai Phong City,Kien An District,11,15,13,2,1
2022-07-05,Hai Phong City,Kien An District,12,10,8,2,2
2022-07-05,Hai Phong City,Kien An District,13,5,3,2,1
2022-07-05,Hai Phong City,Kien An District,14,14,9,5,4
2022-07-05,Hai Phong City,Kien An District,15,13,9,4,4
2022-07-05,Hai Phong City,Kien An District,16,6,6,0,0
2022-07-05,Hai Phong City,Kien An District,17,7,4,3,2
2022-07-05,Hai Phong City,Kien An District,18,8,2,6,6
2022-07-05,Hai Phong City,Kien An District,19,14,3,11,9
2022-07-05,Hai Phong City,Kien An District,20,16,4,12,12
2022-07-05,Hai Phong City,Kien An District,21,5,2,3,1
2022-07-05,Hai Phong City,Le Chan District,2,1,0,1,0
2022-07-05,Hai Phong City,Le Chan District,5,1,1,0,0
2022-07-05,Hai Phong City,Le Chan District,7,39,30,9,5
2022-07-05,Hai Phong City,Le Chan District,8,105,78,27,10
2022-07-05,Hai Phong City,Le Chan District,9,98,80,18,1
2022-07-05,Hai Phong City,Le Chan District,10,216,195,21,4
2022-07-05,Hai Phong City,Le Chan District,11,333,294,39,13
2022-07-05,Hai Phong City,Le Chan District,12,280,231,49,12
2022-07-05,Hai Phong City,Le Chan District,13,151,126,25,8
2022-07-05,Hai Phong City,Le Chan District,14,147,129,18,4
2022-07-05,Hai Phong City,Le Chan District,15,205,175,30,13
2022-07-05,Hai Phong City,Le Chan District,16,147,133,14,5
2022-07-05,Hai Phong City,Le Chan District,17,222,184,38,14
2022-07-05,Hai Phong City,Le Chan District,18,182,105,77,62
2022-07-05,Hai Phong City,Le Chan District,19,203,65,138,110
2022-07-05,Hai Phong City,Le Chan District,20,223,80,143,107
2022-07-05,Hai Phong City,Le Chan District,21,162,45,117,77
2022-07-05,Hai Phong City,Le Chan District,22,1,0,1,0
2022-07-05,Hai Phong City,Ngo Quyen District,0,2,1,1,0
2022-07-05,Hai Phong City,Ngo Quyen District,2,1,1,0,0
2022-07-05,Hai Phong City,Ngo Quyen District,6,1,0,1,0
2022-07-05,Hai Phong City,Ngo Quyen District,7,33,21,12,7
2022-07-05,Hai Phong City,Ngo Quyen District,8,83,72,11,2
2022-07-05,Hai Phong City,Ngo Quyen District,9,99,85,14,1
2022-07-05,Hai Phong City,Ngo Quyen District,10,179,163,16,5
2022-07-05,Hai Phong City,Ngo Quyen District,11,269,239,30,8
2022-07-05,Hai Phong City,Ngo Quyen District,12,179,162,17,3
2022-07-05,Hai Phong City,Ngo Quyen District,13,122,104,18,7
2022-07-05,Hai Phong City,Ngo Quyen District,14,162,143,19,4
2022-07-05,Hai Phong City,Ngo Quyen District,15,150,137,13,5
2022-07-05,Hai Phong City,Ngo Quyen District,16,140,119,21,2
2022-07-05,Hai Phong City,Ngo Quyen District,17,134,113,21,6
2022-07-05,Hai Phong City,Ngo Quyen District,18,155,82,73,46
2022-07-05,Hai Phong City,Ngo Quyen District,19,154,56,98,84
2022-07-05,Hai Phong City,Ngo Quyen District,20,171,55,116,86
2022-07-05,Hai Phong City,Ngo Quyen District,21,128,50,78,58
2022-07-05,Hai Phong City,Thuy Nguyen,11,5,0,5,5
2022-07-05,Hai Phong City,Thuy Nguyen,12,1,0,1,1
2022-07-05,Hai Phong City,Thuy Nguyen,13,2,0,2,2
2022-07-05,Hai Phong City,Thuy Nguyen,14,1,0,1,1
2022-07-05,Hai Phong City,Thuy Nguyen,17,1,0,1,1
2022-07-05,Hai Phong City,Thuy Nguyen,18,1,0,1,1
2022-07-05,Hai Phong City,Thuy Nguyen,20,2,0,2,2
2022-07-05,Hue City,Hue City,2,1,1,0,0
2022-07-05,Hue City,Hue City,5,1,1,0,0
2022-07-05,Hue City,Hue City,6,85,77,8,6
2022-07-05,Hue City,Hue City,7,196,179,17,1
2022-07-05,Hue City,Hue City,8,340,309,31,1
2022-07-05,Hue City,Hue City,9,303,265,38,2
2022-07-05,Hue City,Hue City,10,429,401,28,0
2022-07-05,Hue City,Hue City,11,910,823,87,13
2022-07-05,Hue City,Hue City,12,579,540,39,0
2022-07-05,Hue City,Hue City,13,370,345,25,0
2022-07-05,Hue City,Hue City,14,460,426,34,3
2022-07-05,Hue City,Hue City,15,412,381,31,0
2022-07-05,Hue City,Hue City,16,419,391,28,3
2022-07-05,Hue City,Hue City,17,437,404,33,1
2022-07-05,Hue City,Hue City,18,560,506,54,3
2022-07-05,Hue City,Hue City,19,561,521,40,1
2022-07-05,Hue City,Hue City,20,469,410,59,10
2022-07-05,Hue City,Hue City,21,318,263,55,5
2022-07-05,Hue City,Hue City,22,4,0,4,0
2022-07-05,Hue City,Hue City,23,1,0,1,1
2022-07-05,Hue City,Huong Thuy,6,2,1,1,1
2022-07-05,Hue City,Huong Thuy,7,2,2,0,0
2022-07-05,Hue City,Huong Thuy,9,1,1,0,0
2022-07-05,Hue City,Huong Thuy,10,1,0,1,0
2022-07-05,Hue City,Huong Thuy,11,5,3,2,0
2022-07-05,Hue City,Huong Thuy,12,2,2,0,0
2022-07-05,Hue City,Huong Thuy,13,3,1,2,1
2022-07-05,Hue City,Huong Thuy,20,1,1,0,0
2022-07-05,Hue City,Huong Thuy,21,1,0,1,0
2022-07-05,Hue City,Huong Tra,11,1,1,0,0
2022-07-05,Hue City,Huong Tra,12,2,1,1,0
2022-07-05,Hue City,Huong Tra,15,1,1,0,0
2022-07-05,Hue City,Phu Vang,7,1,0,1,0
2022-07-05,Hue City,Phu Vang,9,1,0,1,0
2022-07-05,Hue City,Phu Vang,10,1,1,0,0
2022-07-05,Hue City,Phu Vang,11,8,6,2,1
2022-07-05,Hue City,Phu Vang,12,7,4,3,3
2022-07-05,Hue City,Phu Vang,13,2,1,1,1
2022-07-05,Hue City,Phu Vang,14,4,3,1,1
2022-07-05,Hue City,Phu Vang,16,1,1,0,0
2022-07-05,Hue City,Phu Vang,17,1,1,0,0
2022-07-05,Hue City,Phu Vang,18,2,2,0,0
2022-07-05,Hue City,Phu Vang,19,3,3,0,0
2022-07-05,Khanh Hoa,Cam Ranh City,12,1,0,1,1
2022-07-05,Khanh Hoa,Dien Khanh,11,2,1,1,1
2022-07-05,Khanh Hoa,Nha Trang City,3,1,0,1,0
2022-07-05,Khanh Hoa,Nha Trang City,6,42,36,6,3
2022-07-05,Khanh Hoa,Nha Trang City,7,152,134,18,3
2022-07-05,Khanh Hoa,Nha Trang City,8,199,179,20,0
2022-07-05,Khanh Hoa,Nha Trang City,9,214,200,14,0
2022-07-05,Khanh Hoa,Nha Trang City,10,242,223,19,3
2022-07-05,Khanh Hoa,Nha Trang City,11,424,386,38,0
2022-07-05,Khanh Hoa,Nha Trang City,12,298,279,19,2
2022-07-05,Khanh Hoa,Nha Trang City,13,323,304,19,0
2022-07-05,Khanh Hoa,Nha Trang City,14,246,230,16,1
2022-07-05,Khanh Hoa,Nha Trang City,15,270,244,26,1
2022-07-05,Khanh Hoa,Nha Trang City,16,259,242,17,0
2022-07-05,Khanh Hoa,Nha Trang City,17,208,185,23,0
2022-07-05,Khanh Hoa,Nha Trang City,18,256,238,18,0
2022-07-05,Khanh Hoa,Nha Trang City,19,284,254,30,4
2022-07-05,Khanh Hoa,Nha Trang City,20,229,198,31,4
2022-07-05,Khanh Hoa,Nha Trang City,21,131,98,33,14
2022-07-05,Khanh Hoa,Nha Trang City,22,3,2,1,0
2022-07-05,Khanh Hoa,Nha Trang City,23,1,1,0,0
2022-07-05,Lam Dong,Da Lat City,6,3,0,3,3
2022-07-05,Lam Dong,Da Lat City,7,91,22,69,58
2022-07-05,Lam Dong,Da Lat City,8,85,56,29,21
2022-07-05,Lam Dong,Da Lat City,9,91,64,27,14
2022-07-05,Lam Dong,Da Lat City,10,103,76,27,13
2022-07-05,Lam Dong,Da Lat City,11,137,99,38,27
2022-07-05,Lam Dong,Da Lat City,12,131,107,24,19
2022-07-05,Lam Dong,Da Lat City,13,147,95,52,34
2022-07-05,Lam Dong,Da Lat City,14,127,78,49,33
2022-07-05,Lam Dong,Da Lat City,15,101,77,24,16
2022-07-05,Lam Dong,Da Lat City,16,90,72,18,13
2022-07-05,Lam Dong,Da Lat City,17,108,82,26,18
2022-07-05,Lam Dong,Da Lat City,18,135,92,43,31
2022-07-05,Lam Dong,Da Lat City,19,124,85,39,27
2022-07-05,Lam Dong,Da Lat City,20,86,61,25,12
2022-07-05,Lam Dong,Da Lat City,21,76,35,41,28
2022-07-05,Nghe An,Vinh City,1,1,1,0,0
2022-07-05,Nghe An,Vinh City,6,7,4,3,1
2022-07-05,Nghe An,Vinh City,7,145,126,19,9
2022-07-05,Nghe An,Vinh City,8,203,177,26,6
2022-07-05,Nghe An,Vinh City,9,156,131,25,6
2022-07-05,Nghe An,Vinh City,10,233,192,41,18
2022-07-05,Nghe An,Vinh City,11,460,366,94,63
2022-07-05,Nghe An,Vinh City,12,228,204,24,7
2022-07-05,Nghe An,Vinh City,13,187,162,25,9
2022-07-05,Nghe An,Vinh City,14,189,145,44,21
2022-07-05,Nghe An,Vinh City,15,175,152,23,7
2022-07-05,Nghe An,Vinh City,16,171,142,29,11
2022-07-05,Nghe An,Vinh City,17,169,137,32,10
2022-07-05,Nghe An,Vinh City,18,174,135,39,16
2022-07-05,Nghe An,Vinh City,19,221,151,70,36
2022-07-05,Nghe An,Vinh City,20,158,111,47,22
2022-07-05,Nghe An,Vinh City,21,83,53,30,14
2022-07-05,Quang Nam,Hoi An City,7,8,6,2,2
2022-07-05,Quang Nam,Hoi An City,8,22,21,1,0
2022-07-05,Quang Nam,Hoi An City,9,31,25,6,1
2022-07-05,Quang Nam,Hoi An City,10,35,25,10,3
2022-07-05,Quang Nam,Hoi An City,11,53,45,8,4
2022-07-05,Quang Nam,Hoi An City,12,68,44,24,14
2022-07-05,Quang Nam,Hoi An City,13,39,29,10,6
2022-07-05,Quang Nam,Hoi An City,14,43,32,11,7
2022-07-05,Quang Nam,Hoi An City,15,44,34,10,1
2022-07-05,Quang Nam,Hoi An City,16,41,32,9,4
2022-07-05,Quang Nam,Hoi An City,17,39,36,3,0
2022-07-05,Quang Nam,Hoi An City,18,41,33,8,2
2022-07-05,Quang Nam,Hoi An City,19,50,34,16,6
2022-07-05,Quang Nam,Hoi An City,20,47,31,16,7
2022-07-05,Quang Nam,Hoi An City,21,27,14,13,10
2022-07-05,Quang Nam,Hoi An City,22,1,0,1,0
2022-07-05,Quang Nam,Tam Ky City,14,1,0,1,1
2022-07-05,Quang Ninh,Cam Pha City,11,1,0,1,1
2022-07-05,Quang Ninh,Cam Pha City,14,1,0,1,1
2022-07-05,Quang Ninh,Cam Pha City,18,1,0,1,1
2022-07-05,Quang Ninh,Cam Pha City,19,2,0,2,2
2022-07-05,Quang Ninh,Cam Pha City,20,1,0,1,1
2022-07-05,Quang Ninh,Ha Long City,6,1,0,1,1
2022-07-05,Quang Ninh,Ha Long City,7,32,13,19,12
2022-07-05,Quang Ninh,Ha Long City,8,60,43,17,9
2022-07-05,Quang Ninh,Ha Long City,9,57,45,12,3
2022-07-05,Quang Ninh,Ha Long City,10,87,68,19,8
2022-07-05,Quang Ninh,Ha Long City,11,192,125,67,30
2022-07-05,Quang Ninh,Ha Long City,12,125,87,38,26
2022-07-05,Quang Ninh,Ha Long City,13,70,44,26,19
2022-07-05,Quang Ninh,Ha Long City,14,59,40,19,12
2022-07-05,Quang Ninh,Ha Long City,15,69,47,22,10
2022-07-05,Quang Ninh,Ha Long City,16,56,43,13,4
2022-07-05,Quang Ninh,Ha Long City,17,57,35,22,9
2022-07-05,Quang Ninh,Ha Long City,18,70,44,26,14
2022-07-05,Quang Ninh,Ha Long City,19,61,28,33,20
2022-07-05,Quang Ninh,Ha Long City,20,84,18,66,56
2022-07-05,Quang Ninh,Ha Long City,21,1,0,1,0
2022-07-05,Quang Ninh,Uong Bi City,15,1,0,1,1
2022-07-05,Quang Ninh,Uong Bi City,21,1,0,1,1
2022-07-05,Thai Nguyen,Dong Hy,17,1,0,1,1
2022-07-05,Thai Nguyen,Dong Hy,19,1,0,1,1
2022-07-05,Thai Nguyen,Pho Yen,12,1,0,1,1
2022-07-05,Thai Nguyen,Pho Yen,13,1,0,1,1
2022-07-05,Thai Nguyen,Thai Nguyen City,0,3,1,2,0
2022-07-05,Thai Nguyen,Thai Nguyen City,6,7,4,3,0
2022-07-05,Thai Nguyen,Thai Nguyen City,7,92,81,11,0
2022-07-05,Thai Nguyen,Thai Nguyen City,8,173,162,11,1
2022-07-05,Thai Nguyen,Thai Nguyen City,9,133,120,13,0
2022-07-05,Thai Nguyen,Thai Nguyen City,10,206,187,19,2
2022-07-05,Thai Nguyen,Thai Nguyen City,11,408,376,32,3
2022-07-05,Thai Nguyen,Thai Nguyen City,12,266,238,28,3
2022-07-05,Thai Nguyen,Thai Nguyen City,13,178,163,15,2
2022-07-05,Thai Nguyen,Thai Nguyen City,14,157,143,14,0
2022-07-05,Thai Nguyen,Thai Nguyen City,15,168,155,13,0
2022-07-05,Thai Nguyen,Thai Nguyen City,16,133,119,14,0
2022-07-05,Thai Nguyen,Thai Nguyen City,17,136,130,6,1
2022-07-05,Thai Nguyen,Thai Nguyen City,18,213,201,12,3
2022-07-05,Thai Nguyen,Thai Nguyen City,19,234,216,18,2
2022-07-05,Thai Nguyen,Thai Nguyen City,20,205,163,42,12
2022-07-05,Thai Nguyen,Thai Nguyen City,21,143,87,56,34
2022-07-05,Thai Nguyen,Thai Nguyen City,22,3,0,3,0
2022-07-05,Vung Tau,Ba Ria City,8,6,3,3,1
2022-07-05,Vung Tau,Ba Ria City,9,13,8,5,5
2022-07-05,Vung Tau,Ba Ria City,10,3,2,1,1
2022-07-05,Vung Tau,Ba Ria City,11,5,5,0,0
2022-07-05,Vung Tau,Ba Ria City,12,4,4,0,0
2022-07-05,Vung Tau,Ba Ria City,13,3,3,0,0
2022-07-05,Vung Tau,Ba Ria City,14,12,7,5,2
2022-07-05,Vung Tau,Ba Ria City,15,8,4,4,1
2022-07-05,Vung Tau,Ba Ria City,17,4,3,1,0
2022-07-05,Vung Tau,Ba Ria City,18,5,3,2,0
2022-07-05,Vung Tau,Ba Ria City,19,8,2,6,5
2022-07-05,Vung Tau,Ba Ria City,20,3,0,3,3
2022-07-05,Vung Tau,Ba Ria City,21,2,0,2,1
2022-07-05,Vung Tau,Chau Duc,9,3,0,3,3
2022-07-05,Vung Tau,Chau Duc,18,1,0,1,0
2022-07-05,Vung Tau,Vung Tau City,0,2,0,2,0
2022-07-05,Vung Tau,Vung Tau City,1,3,2,1,0
2022-07-05,Vung Tau,Vung Tau City,2,1,0,1,0
2022-07-05,Vung Tau,Vung Tau City,3,1,1,0,0
2022-07-05,Vung Tau,Vung Tau City,5,1,1,0,0
2022-07-05,Vung Tau,Vung Tau City,6,39,34,5,3
2022-07-05,Vung Tau,Vung Tau City,7,121,110,11,3
2022-07-05,Vung Tau,Vung Tau City,8,190,170,20,4
2022-07-05,Vung Tau,Vung Tau City,9,212,195,17,0
2022-07-05,Vung Tau,Vung Tau City,10,255,240,15,4
2022-07-05,Vung Tau,Vung Tau City,11,391,357,34,6
2022-07-05,Vung Tau,Vung Tau City,12,305,283,22,4
2022-07-05,Vung Tau,Vung Tau City,13,219,196,23,7
2022-07-05,Vung Tau,Vung Tau City,14,228,206,22,1
2022-07-05,Vung Tau,Vung Tau City,15,243,227,16,2
2022-07-05,Vung Tau,Vung Tau City,16,195,177,18,2
2022-07-05,Vung Tau,Vung Tau City,17,260,248,12,2
2022-07-05,Vung Tau,Vung Tau City,18,290,270,20,8
2022-07-05,Vung Tau,Vung Tau City,19,286,253,33,9
2022-07-05,Vung Tau,Vung Tau City,20,194,168,26,8
2022-07-05,Vung Tau,Vung Tau City,21,106,82,24,4
2022-07-06,Bac Ninh,Bác Ninh City,2,1,0,1,0
2022-07-06,Bac Ninh,Bác Ninh City,3,1,1,0,0
2022-07-06,Bac Ninh,Bác Ninh City,6,4,3,1,0
2022-07-06,Bac Ninh,Bác Ninh City,7,84,71,13,7
2022-07-06,Bac Ninh,Bác Ninh City,8,128,118,10,0
2022-07-06,Bac Ninh,Bác Ninh City,9,112,102,10,0
2022-07-06,Bac Ninh,Bác Ninh City,10,177,160,17,0
2022-07-06,Bac Ninh,Bác Ninh City,11,345,310,35,1
2022-07-06,Bac Ninh,Bác Ninh City,12,244,228,16,1
2022-07-06,Bac Ninh,Bác Ninh City,13,149,130,19,2
2022-07-06,Bac Ninh,Bác Ninh City,14,149,129,20,4
2022-07-06,Bac Ninh,Bác Ninh City,15,142,128,14,0
2022-07-06,Bac Ninh,Bác Ninh City,16,97,91,6,0
2022-07-06,Bac Ninh,Bác Ninh City,17,125,109,16,2
2022-07-06,Bac Ninh,Bác Ninh City,18,181,161,20,3
2022-07-06,Bac Ninh,Bác Ninh City,19,179,164,15,2
2022-07-06,Bac Ninh,Bác Ninh City,20,158,127,31,6
2022-07-06,Bac Ninh,Bác Ninh City,21,80,64,16,4
2022-07-06,Bac Ninh,Bác Ninh City,22,3,0,3,0
2022-07-06,Bac Ninh,Que Vo,15,1,0,1,1
2022-07-06,Bac Ninh,Que Vo,16,1,0,1,1
2022-07-06,Bac Ninh,Que Vo,20,2,0,2,2
2022-07-06,Bac Ninh,Tien Du,9,1,0,1,1
2022-07-06,Bac Ninh,Tien Du,10,1,0,1,1
2022-07-06,Bac Ninh,Tien Du,12,1,0,1,1
2022-07-06,Bac Ninh,Tien Du,13,1,0,1,1
2022-07-06,Bac Ninh,Tien Du,17,2,0,2,2
2022-07-06,Bac Ninh,Tien Du,19,5,0,5,4
2022-07-06,Bac Ninh,Tien Du,21,1,0,1,1
2022-07-06,Bac Ninh,Tu Son,10,1,0,1,1
2022-07-06,Bac Ninh,Tu Son,11,3,0,3,2
2022-07-06,Bac Ninh,Tu Son,12,2,0,2,2
2022-07-06,Bac Ninh,Tu Son,13,3,0,3,3
2022-07-06,Bac Ninh,Tu Son,14,1,0,1,1
2022-07-06,Bac Ninh,Tu Son,15,4,0,4,4
2022-07-06,Bac Ninh,Tu Son,16,1,0,1,0
2022-07-06,Bac Ninh,Tu Son,17,2,0,2,2
2022-07-06,Bac Ninh,Tu Son,18,4,0,4,4
2022-07-06,Bac Ninh,Tu Son,19,2,0,2,2
2022-07-06,Bac Ninh,Tu Son,20,1,0,1,1
2022-07-06,Binh Duong,Ben Cat,7,1,0,1,1
2022-07-06,Binh Duong,Ben Cat,9,2,0,2,2
2022-07-06,Binh Duong,Ben Cat,10,3,0,3,3
2022-07-06,Binh Duong,Ben Cat,12,1,0,1,1
2022-07-06,Binh Duong,Ben Cat,13,1,0,1,1
2022-07-06,Binh Duong,Ben Cat,14,3,0,3,2
2022-07-06,Binh Duong,Ben Cat,15,1,0,1,1
2022-07-06,Binh Duong,Ben Cat,16,2,0,2,2
2022-07-06,Binh Duong,Ben Cat,17,1,0,1,1
2022-07-06,Binh Duong,Ben Cat,18,1,0,1,1
2022-07-06,Binh Duong,Di An,0,1,1,0,0
2022-07-06,Binh Duong,Di An,6,1,0,1,1
2022-07-06,Binh Duong,Di An,7,7,3,4,2
2022-07-06,Binh Duong,Di An,8,20,16,4,2
2022-07-06,Binh Duong,Di An,9,22,16,6,4
2022-07-06,Binh Duong,Di An,10,31,21,10,6
2022-07-06,Binh Duong,Di An,11,37,32,5,3
2022-07-06,Binh Duong,Di An,12,33,26,7,1
2022-07-06,Binh Duong,Di An,13,39,32,7,6
2022-07-06,Binh Duong,Di An,14,20,15,5,3
2022-07-06,Binh Duong,Di An,15,24,16,8,7
2022-07-06,Binh Duong,Di An,16,27,19,8,5
2022-07-06,Binh Duong,Di An,17,29,21,8,2
2022-07-06,Binh Duong,Di An,18,33,29,4,1
2022-07-06,Binh Duong,Di An,19,23,18,5,0
2022-07-06,Binh Duong,Di An,20,18,17,1,0
2022-07-06,Binh Duong,Di An,21,12,2,10,8
2022-07-06,Binh Duong,Phu Giao,14,1,0,1,1
2022-07-06,Binh Duong,Tan Uyen,8,2,0,2,1
2022-07-06,Binh Duong,Tan Uyen,9,1,1,0,0
2022-07-06,Binh Duong,Tan Uyen,10,2,1,1,1
2022-07-06,Binh Duong,Tan Uyen,11,4,1,3,3
2022-07-06,Binh Duong,Tan Uyen,12,4,3,1,0
2022-07-06,Binh Duong,Tan Uyen,14,3,1,2,1
2022-07-06,Binh Duong,Tan Uyen,15,2,0,2,2
2022-07-06,Binh Duong,Tan Uyen,17,2,1,1,0
2022-07-06,Binh Duong,Tan Uyen,18,3,2,1,1
2022-07-06,Binh Duong,Tan Uyen,19,1,1,0,0
2022-07-06,Binh Duong,Tan Uyen,20,1,0,1,0
2022-07-06,Binh Duong,Thu Dau Mot Town,0,4,4,0,0
2022-07-06,Binh Duong,Thu Dau Mot Town,1,1,0,1,0
2022-07-06,Binh Duong,Thu Dau Mot Town,2,1,1,0,0
2022-07-06,Binh Duong,Thu Dau Mot Town,4,2,1,1,0
2022-07-06,Binh Duong,Thu Dau Mot Town,6,44,34,10,2
2022-07-06,Binh Duong,Thu Dau Mot Town,7,132,122,10,2
2022-07-06,Binh Duong,Thu Dau Mot Town,8,239,224,15,0
2022-07-06,Binh Duong,Thu Dau Mot Town,9,264,242,22,5
2022-07-06,Binh Duong,Thu Dau Mot Town,10,419,393,26,3
2022-07-06,Binh Duong,Thu Dau Mot Town,11,708,646,62,14
2022-07-06,Binh Duong,Thu Dau Mot Town,12,510,465,45,14
2022-07-06,Binh Duong,Thu Dau Mot Town,13,467,428,39,14
2022-07-06,Binh Duong,Thu Dau Mot Town,14,406,383,23,2
2022-07-06,Binh Duong,Thu Dau Mot Town,15,309,278,31,10
2022-07-06,Binh Duong,Thu Dau Mot Town,16,326,304,22,6
2022-07-06,Binh Duong,Thu Dau Mot Town,17,370,339,31,4
2022-07-06,Binh Duong,Thu Dau Mot Town,18,421,388,33,10
2022-07-06,Binh Duong,Thu Dau Mot Town,19,390,362,28,7
2022-07-06,Binh Duong,Thu Dau Mot Town,20,281,257,24,4
2022-07-06,Binh Duong,Thu Dau Mot Town,21,139,118,21,5
2022-07-06,Binh Duong,Thu Dau Mot Town,22,1,0,1,0
2022-07-06,Binh Duong,Thuan An,3,1,0,1,0
2022-07-06,Binh Duong,Thuan An,7,5,3,2,1
2022-07-06,Binh Duong,Thuan An,8,27,22,5,3
2022-07-06,Binh Duong,Thuan An,9,40,31,9,4
2022-07-06,Binh Duong,Thuan An,10,71,56,15,4
2022-07-06,Binh Duong,Thuan An,11,80,75,5,2
2022-07-06,Binh Duong,Thuan An,12,68,59,9,5
2022-07-06,Binh Duong,Thuan An,13,86,72,14,4
2022-07-06,Binh Duong,Thuan An,14,73,51,22,21
2022-07-06,Binh Duong,Thuan An,15,45,34,11,6
2022-07-06,Binh Duong,Thuan An,16,62,45,17,11
2022-07-06,Binh Duong,Thuan An,17,46,36,10,6
2022-07-06,Binh Duong,Thuan An,18,47,39,8,3
2022-07-06,Binh Duong,Thuan An,19,46,39,7,2
2022-07-06,Binh Duong,Thuan An,20,40,21,19,12
2022-07-06,Binh Duong,Thuan An,21,14,7,7,5
2022-07-06,Can Tho City,Binh Thuy District,5,1,1,0,0
2022-07-06,Can Tho City,Binh Thuy District,7,2,2,0,0
2022-07-06,Can Tho City,Binh Thuy District,8,3,3,0,0
2022-07-06,Can Tho City,Binh Thuy District,9,4,4,0,0
2022-07-06,Can Tho City,Binh Thuy District,10,11,11,0,0
2022-07-06,Can Tho City,Binh Thuy District,11,14,12,2,0
2022-07-06,Can Tho City,Binh Thuy District,12,13,13,0,0
2022-07-06,Can Tho City,Binh Thuy District,13,8,7,1,0
2022-07-06,Can Tho City,Binh Thuy District,14,15,13,2,2
2022-07-06,Can Tho City,Binh Thuy District,15,15,14,1,1
2022-07-06,Can Tho City,Binh Thuy District,16,7,5,2,1
2022-07-06,Can Tho City,Binh Thuy District,17,8,8,0,0
2022-07-06,Can Tho City,Binh Thuy District,18,14,14,0,0
2022-07-06,Can Tho City,Binh Thuy District,19,13,12,1,0
2022-07-06,Can Tho City,Binh Thuy District,20,12,8,4,1
2022-07-06,Can Tho City,Binh Thuy District,21,7,3,4,0
2022-07-06,Can Tho City,Cai Rang District,6,3,2,1,0
2022-07-06,Can Tho City,Cai Rang District,8,10,8,2,2
2022-07-06,Can Tho City,Cai Rang District,9,7,7,0,0
2022-07-06,Can Tho City,Cai Rang District,10,16,15,1,0
2022-07-06,Can Tho City,Cai Rang District,11,16,14,2,2
2022-07-06,Can Tho City,Cai Rang District,12,15,15,0,0
2022-07-06,Can Tho City,Cai Rang District,13,6,6,0,0
2022-07-06,Can Tho City,Cai Rang District,14,9,6,3,1
2022-07-06,Can Tho City,Cai Rang District,15,16,15,1,0
2022-07-06,Can Tho City,Cai Rang District,16,6,6,0,0
2022-07-06,Can Tho City,Cai Rang District,17,8,7,1,0
2022-07-06,Can Tho City,Cai Rang District,18,14,11,3,0
2022-07-06,Can Tho City,Cai Rang District,19,10,9,1,0
2022-07-06,Can Tho City,Cai Rang District,20,14,12,2,1
2022-07-06,Can Tho City,Cai Rang District,21,8,5,3,2
2022-07-06,Can Tho City,Ninh Kieu District,0,1,1,0,0
2022-07-06,Can Tho City,Ninh Kieu District,1,1,1,0,0
2022-07-06,Can Tho City,Ninh Kieu District,3,2,2,0,0
2022-07-06,Can Tho City,Ninh Kieu District,4,1,1,0,0
2022-07-06,Can Tho City,Ninh Kieu District,5,3,2,1,0
2022-07-06,Can Tho City,Ninh Kieu District,6,47,45,2,0
2022-07-06,Can Tho City,Ninh Kieu District,7,113,108,5,0
2022-07-06,Can Tho City,Ninh Kieu District,8,232,218,14,0
2022-07-06,Can Tho City,Ninh Kieu District,9,263,240,23,0
2022-07-06,Can Tho City,Ninh Kieu District,10,480,462,18,0
2022-07-06,Can Tho City,Ninh Kieu District,11,800,761,39,1
2022-07-06,Can Tho City,Ninh Kieu District,12,573,553,20,0
2022-07-06,Can Tho City,Ninh Kieu District,13,509,495,14,0
2022-07-06,Can Tho City,Ninh Kieu District,14,447,427,20,0
2022-07-06,Can Tho City,Ninh Kieu District,15,344,321,23,0
2022-07-06,Can Tho City,Ninh Kieu District,16,380,361,19,0
2022-07-06,Can Tho City,Ninh Kieu District,17,487,463,24,0
2022-07-06,Can Tho City,Ninh Kieu District,18,501,471,30,0
2022-07-06,Can Tho City,Ninh Kieu District,19,436,409,27,0
2022-07-06,Can Tho City,Ninh Kieu District,20,349,327,22,0
2022-07-06,Can Tho City,Ninh Kieu District,21,196,181,15,1
2022-07-06,Can Tho City,O Mon District,17,3,0,3,2
2022-07-06,Can Tho City,Phong Dien,16,1,0,1,1
2022-07-06,Dong Nai,Bien Hoa City,0,4,2,2,0
2022-07-06,Dong Nai,Bien Hoa City,1,1,1,0,0
2022-07-06,Dong Nai,Bien Hoa City,2,1,1,0,0
2022-07-06,Dong Nai,Bien Hoa City,5,4,2,2,0
2022-07-06,Dong Nai,Bien Hoa City,6,52,42,10,5
2022-07-06,Dong Nai,Bien Hoa City,7,191,164,27,10
2022-07-06,Dong Nai,Bien Hoa City,8,329,301,28,3
2022-07-06,Dong Nai,Bien Hoa City,9,463,421,42,3
2022-07-06,Dong Nai,Bien Hoa City,10,817,753,64,8
2022-07-06,Dong Nai,Bien Hoa City,11,1157,1055,102,27
2022-07-06,Dong Nai,Bien Hoa City,12,895,837,58,6
2022-07-06,Dong Nai,Bien Hoa City,13,851,798,53,8
2022-07-06,Dong Nai,Bien Hoa City,14,599,533,66,19
2022-07-06,Dong Nai,Bien Hoa City,15,528,484,44,10
2022-07-06,Dong Nai,Bien Hoa City,16,595,549,46,6
2022-07-06,Dong Nai,Bien Hoa City,17,637,595,42,8
2022-07-06,Dong Nai,Bien Hoa City,18,700,654,46,3
2022-07-06,Dong Nai,Bien Hoa City,19,723,653,70,8
2022-07-06,Dong Nai,Bien Hoa City,20,568,492,76,14
2022-07-06,Dong Nai,Bien Hoa City,21,222,174,48,16
2022-07-06,Dong Nai,Bien Hoa City,22,5,0,5,0
2022-07-06,Dong Nai,Long Khanh,9,3,0,3,3
2022-07-06,Dong Nai,Long Khanh,10,3,0,3,2
2022-07-06,Dong Nai,Long Khanh,11,4,0,4,3
2022-07-06,Dong Nai,Long Khanh,13,1,0,1,1
2022-07-06,Dong Nai,Long Khanh,14,2,0,2,2
2022-07-06,Dong Nai,Long Khanh,17,1,0,1,1
2022-07-06,Dong Nai,Long Khanh,19,3,0,3,3
2022-07-06,Dong Nai,Long Khanh,20,2,0,2,2
2022-07-06,Dong Nai,Long Thanh,10,4,0,4,4
2022-07-06,Dong Nai,Long Thanh,11,1,0,1,1
2022-07-06,Dong Nai,Long Thanh,12,3,0,3,3
2022-07-06,Dong Nai,Long Thanh,13,1,0,1,1
2022-07-06,Dong Nai,Long Thanh,14,1,0,1,1
2022-07-06,Dong Nai,Long Thanh,17,5,0,5,4
2022-07-06,Dong Nai,Long Thanh,18,1,0,1,1
2022-07-06,Dong Nai,Long Thanh,19,3,0,3,3
2022-07-06,Dong Nai,Long Thanh,20,1,0,1,1
2022-07-06,Dong Nai,Long Thanh,21,2,0,2,2
2022-07-06,Dong Nai,Nhon trach,14,1,0,1,0
2022-07-06,Dong Nai,Nhon trach,15,1,0,1,1
2022-07-06,Dong Nai,Nhon trach,16,1,0,1,1
2022-07-06,Dong Nai,Trang Bom,7,2,0,2,2
2022-07-06,Dong Nai,Trang Bom,11,1,0,1,0
2022-07-06,Dong Nai,Trang Bom,12,2,0,2,2
2022-07-06,Dong Nai,Trang Bom,15,1,0,1,1
2022-07-06,Dong Nai,Trang Bom,18,1,0,1,1
2022-07-06,Dong Nai,Vinh Cuu,11,1,0,1,1
2022-07-06,Dong Nai,Vinh Cuu,17,1,0,1,0
2022-07-06,Dong Nai,Vinh Cuu,18,1,1,0,0
2022-07-06,Hai Phong City,An Duong,7,1,1,0,0
2022-07-06,Hai Phong City,An Duong,8,2,0,2,2
2022-07-06,Hai Phong City,An Duong,9,6,4,2,1
2022-07-06,Hai Phong City,An Duong,10,7,5,2,2
2022-07-06,Hai Phong City,An Duong,11,3,3,0,0
2022-07-06,Hai Phong City,An Duong,12,5,3,2,1
2022-07-06,Hai Phong City,An Duong,13,3,1,2,2
2022-07-06,Hai Phong City,An Duong,14,1,0,1,1
2022-07-06,Hai Phong City,An Duong,15,4,1,3,1
2022-07-06,Hai Phong City,An Duong,16,1,0,1,1
2022-07-06,Hai Phong City,An Duong,17,4,1,3,2
2022-07-06,Hai Phong City,An Duong,18,7,3,4,2
2022-07-06,Hai Phong City,An Duong,19,6,3,3,2
2022-07-06,Hai Phong City,An Duong,20,4,2,2,1
2022-07-06,Hai Phong City,An Duong,21,9,3,6,6
2022-07-06,Hai Phong City,Do Son District,12,1,0,1,1
2022-07-06,Hai Phong City,Do Son District,20,1,0,1,1
2022-07-06,Hai Phong City,Hai An District,7,11,10,1,0
2022-07-06,Hai Phong City,Hai An District,8,14,13,1,0
2022-07-06,Hai Phong City,Hai An District,9,11,7,4,0
2022-07-06,Hai Phong City,Hai An District,10,35,26,9,2
2022-07-06,Hai Phong City,Hai An District,11,54,44,10,1
2022-07-06,Hai Phong City,Hai An District,12,24,22,2,0
2022-07-06,Hai Phong City,Hai An District,13,14,12,2,0
2022-07-06,Hai Phong City,Hai An District,14,20,12,8,3
2022-07-06,Hai Phong City,Hai An District,15,21,19,2,0
2022-07-06,Hai Phong City,Hai An District,16,19,15,4,0
2022-07-06,Hai Phong City,Hai An District,17,18,16,2,0
2022-07-06,Hai Phong City,Hai An District,18,30,22,8,3
2022-07-06,Hai Phong City,Hai An District,19,23,19,4,3
2022-07-06,Hai Phong City,Hai An District,20,15,12,3,2
2022-07-06,Hai Phong City,Hai An District,21,8,4,4,2
2022-07-06,Hai Phong City,Hong Bang District,6,1,1,0,0
2022-07-06,Hai Phong City,Hong Bang District,7,11,7,4,0
2022-07-06,Hai Phong City,Hong Bang District,8,44,40,4,1
2022-07-06,Hai Phong City,Hong Bang District,9,30,28,2,0
2022-07-06,Hai Phong City,Hong Bang District,10,59,50,9,4
2022-07-06,Hai Phong City,Hong Bang District,11,104,89,15,3
2022-07-06,Hai Phong City,Hong Bang District,12,67,62,5,2
2022-07-06,Hai Phong City,Hong Bang District,13,40,32,8,3
2022-07-06,Hai Phong City,Hong Bang District,14,41,32,9,0
2022-07-06,Hai Phong City,Hong Bang District,15,38,33,5,1
2022-07-06,Hai Phong City,Hong Bang District,16,40,31,9,1
2022-07-06,Hai Phong City,Hong Bang District,17,61,50,11,3
2022-07-06,Hai Phong City,Hong Bang District,18,51,45,6,0
2022-07-06,Hai Phong City,Hong Bang District,19,56,50,6,3
2022-07-06,Hai Phong City,Hong Bang District,20,48,38,10,3
2022-07-06,Hai Phong City,Hong Bang District,21,11,9,2,0
2022-07-06,Hai Phong City,Hong Bang District,22,3,1,2,0
2022-07-06,Hai Phong City,Hong Bang District,23,1,0,1,0
2022-07-06,Hai Phong City,Kien An District,5,1,0,1,0
2022-07-06,Hai Phong City,Kien An District,7,4,2,2,0
2022-07-06,Hai Phong City,Kien An District,8,2,0,2,2
2022-07-06,Hai Phong City,Kien An District,9,6,3,3,3
2022-07-06,Hai Phong City,Kien An District,10,8,2,6,6
2022-07-06,Hai Phong City,Kien An District,11,25,16,9,3
2022-07-06,Hai Phong City,Kien An District,12,4,3,1,0
2022-07-06,Hai Phong City,Kien An District,13,4,2,2,2
2022-07-06,Hai Phong City,Kien An District,14,12,4,8,4
2022-07-06,Hai Phong City,Kien An District,15,12,10,2,1
2022-07-06,Hai Phong City,Kien An District,16,8,8,0,0
2022-07-06,Hai Phong City,Kien An District,17,7,6,1,1
2022-07-06,Hai Phong City,Kien An District,18,8,7,1,1
2022-07-06,Hai Phong City,Kien An District,19,15,13,2,2
2022-07-06,Hai Phong City,Kien An District,20,4,3,1,1
2022-07-06,Hai Phong City,Kien An District,21,6,2,4,1
2022-07-06,Hai Phong City,Le Chan District,0,3,1,2,0
2022-07-06,Hai Phong City,Le Chan District,1,1,0,1,0
2022-07-06,Hai Phong City,Le Chan District,4,2,0,2,0
2022-07-06,Hai Phong City,Le Chan District,5,2,0,2,0
2022-07-06,Hai Phong City,Le Chan District,6,2,2,0,0
2022-07-06,Hai Phong City,Le Chan District,7,48,38,10,2
2022-07-06,Hai Phong City,Le Chan District,8,90,79,11,4
2022-07-06,Hai Phong City,Le Chan District,9,103,93,10,0
2022-07-06,Hai Phong City,Le Chan District,10,189,170,19,7
2022-07-06,Hai Phong City,Le Chan District,11,347,307,40,17
2022-07-06,Hai Phong City,Le Chan District,12,228,206,22,6
2022-07-06,Hai Phong City,Le Chan District,13,146,126,20,3
2022-07-06,Hai Phong City,Le Chan District,14,140,123,17,6
2022-07-06,Hai Phong City,Le Chan District,15,190,165,25,5
2022-07-06,Hai Phong City,Le Chan District,16,166,144,22,1
2022-07-06,Hai Phong City,Le Chan District,17,182,156,26,4
2022-07-06,Hai Phong City,Le Chan District,18,234,203,31,3
2022-07-06,Hai Phong City,Le Chan District,19,220,186,34,10
2022-07-06,Hai Phong City,Le Chan District,20,121,105,16,6
2022-07-06,Hai Phong City,Le Chan District,21,66,51,15,6
2022-07-06,Hai Phong City,Le Chan District,22,2,0,2,0
2022-07-06,Hai Phong City,Ngo Quyen District,1,2,1,1,0
2022-07-06,Hai Phong City,Ngo Quyen District,7,27,22,5,2
2022-07-06,Hai Phong City,Ngo Quyen District,8,109,85,24,4
2022-07-06,Hai Phong City,Ngo Quyen District,9,71,62,9,1
2022-07-06,Hai Phong City,Ngo Quyen District,10,164,144,20,1
2022-07-06,Hai Phong City,Ngo Quyen District,11,234,219,15,8
2022-07-06,Hai Phong City,Ngo Quyen District,12,176,155,21,3
2022-07-06,Hai Phong City,Ngo Quyen District,13,125,113,12,2
2022-07-06,Hai Phong City,Ngo Quyen District,14,125,106,19,4
2022-07-06,Hai Phong City,Ngo Quyen District,15,140,118,22,6
2022-07-06,Hai Phong City,Ngo Quyen District,16,109,99,10,4
2022-07-06,Hai Phong City,Ngo Quyen District,17,128,119,9,2
2022-07-06,Hai Phong City,Ngo Quyen District,18,170,145,25,9
2022-07-06,Hai Phong City,Ngo Quyen District,19,173,150,23,10
2022-07-06,Hai Phong City,Ngo Quyen District,20,133,109,24,8
2022-07-06,Hai Phong City,Ngo Quyen District,21,67,53,14,5
2022-07-06,Hai Phong City,Ngo Quyen District,23,1,0,1,0
2022-07-06,Hai Phong City,Thuy Nguyen,8,1,0,1,0
2022-07-06,Hai Phong City,Thuy Nguyen,9,1,1,0,0
2022-07-06,Hai Phong City,Thuy Nguyen,10,1,0,1,1
2022-07-06,Hai Phong City,Thuy Nguyen,11,2,0,2,2
2022-07-06,Hai Phong City,Thuy Nguyen,12,2,0,2,2
2022-07-06,Hai Phong City,Thuy Nguyen,13,1,0,1,1
2022-07-06,Hai Phong City,Thuy Nguyen,15,1,0,1,1
2022-07-06,Hai Phong City,Thuy Nguyen,16,2,1,1,1
2022-07-06,Hai Phong City,Thuy Nguyen,17,1,0,1,0
2022-07-06,Hai Phong City,Thuy Nguyen,18,2,0,2,2
2022-07-06,Hai Phong City,Thuy Nguyen,20,1,0,1,1
2022-07-06,Hue City,Hue City,0,3,1,2,0
2022-07-06,Hue City,Hue City,1,2,1,1,0
2022-07-06,Hue City,Hue City,3,1,1,0,0
2022-07-06,Hue City,Hue City,5,2,1,1,1
2022-07-06,Hue City,Hue City,6,68,60,8,3
2022-07-06,Hue City,Hue City,7,203,189,14,0
2022-07-06,Hue City,Hue City,8,349,315,34,1
2022-07-06,Hue City,Hue City,9,301,273,28,2
2022-07-06,Hue City,Hue City,10,442,410,32,0
2022-07-06,Hue City,Hue City,11,922,853,69,5
2022-07-06,Hue City,Hue City,12,590,548,42,1
2022-07-06,Hue City,Hue City,13,409,380,29,0
2022-07-06,Hue City,Hue City,14,406,377,29,0
2022-07-06,Hue City,Hue City,15,462,419,43,4
2022-07-06,Hue City,Hue City,16,432,397,35,0
2022-07-06,Hue City,Hue City,17,559,516,43,1
2022-07-06,Hue City,Hue City,18,582,515,67,1
2022-07-06,Hue City,Hue City,19,580,529,51,1
2022-07-06,Hue City,Hue City,20,475,405,70,14
2022-07-06,Hue City,Hue City,21,306,220,86,47
2022-07-06,Hue City,Hue City,22,7,1,6,0
2022-07-06,Hue City,Hue City,23,1,0,1,0
2022-07-06,Hue City,Huong Thuy,8,2,2,0,0
2022-07-06,Hue City,Huong Thuy,9,2,1,1,0
2022-07-06,Hue City,Huong Thuy,10,3,2,1,1
2022-07-06,Hue City,Huong Thuy,11,1,0,1,0
2022-07-06,Hue City,Huong Thuy,14,4,3,1,0
2022-07-06,Hue City,Huong Thuy,15,3,2,1,1
2022-07-06,Hue City,Huong Thuy,16,2,2,0,0
2022-07-06,Hue City,Huong Thuy,17,2,2,0,0
2022-07-06,Hue City,Huong Thuy,18,2,0,2,0
2022-07-06,Hue City,Huong Tra,20,1,1,0,0
2022-07-06,Hue City,Phu Vang,6,1,0,1,1
2022-07-06,Hue City,Phu Vang,8,3,2,1,0
2022-07-06,Hue City,Phu Vang,9,2,2,0,0
2022-07-06,Hue City,Phu Vang,10,1,1,0,0
2022-07-06,Hue City,Phu Vang,11,4,2,2,1
2022-07-06,Hue City,Phu Vang,12,2,2,0,0
2022-07-06,Hue City,Phu Vang,13,2,1,1,0
2022-07-06,Hue City,Phu Vang,14,9,3,6,6
2022-07-06,Hue City,Phu Vang,16,2,1,1,1
2022-07-06,Hue City,Phu Vang,18,3,3,0,0
2022-07-06,Hue City,Phu Vang,19,4,4,0,0
2022-07-06,Hue City,Phu Vang,20,4,3,1,1
2022-07-06,Hue City,Phu Vang,21,4,2,2,2
2022-07-06,Khanh Hoa,Cam Ranh City,10,1,0,1,1
2022-07-06,Khanh Hoa,Dien Khanh,7,1,0,1,1
2022-07-06,Khanh Hoa,Dien Khanh,12,2,0,2,1
2022-07-06,Khanh Hoa,Dien Khanh,15,1,0,1,1
2022-07-06,Khanh Hoa,Dien Khanh,16,1,0,1,1
2022-07-06,Khanh Hoa,Nha Trang City,1,1,0,1,0
2022-07-06,Khanh Hoa,Nha Trang City,6,63,47,16,8
2022-07-06,Khanh Hoa,Nha Trang City,7,146,134,12,2
2022-07-06,Khanh Hoa,Nha Trang City,8,225,210,15,0
2022-07-06,Khanh Hoa,Nha Trang City,9,189,175,14,0
2022-07-06,Khanh Hoa,Nha Trang City,10,239,220,19,1
2022-07-06,Khanh Hoa,Nha Trang City,11,457,431,26,0
2022-07-06,Khanh Hoa,Nha Trang City,12,317,292,25,0
2022-07-06,Khanh Hoa,Nha Trang City,13,305,284,21,3
2022-07-06,Khanh Hoa,Nha Trang City,14,274,259,15,0
2022-07-06,Khanh Hoa,Nha Trang City,15,260,230,30,4
2022-07-06,Khanh Hoa,Nha Trang City,16,284,245,39,12
2022-07-06,Khanh Hoa,Nha Trang City,17,293,269,24,2
2022-07-06,Khanh Hoa,Nha Trang City,18,351,319,32,1
2022-07-06,Khanh Hoa,Nha Trang City,19,285,256,29,2
2022-07-06,Khanh Hoa,Nha Trang City,20,196,165,31,2
2022-07-06,Khanh Hoa,Nha Trang City,21,94,72,22,6
2022-07-06,Khanh Hoa,Nha Trang City,22,3,1,2,0
2022-07-06,Khanh Hoa,Nha Trang City,23,1,1,0,0
2022-07-06,Lam Dong,Da Lat City,5,1,0,1,0
2022-07-06,Lam Dong,Da Lat City,6,5,3,2,1
2022-07-06,Lam Dong,Da Lat City,7,55,33,22,12
2022-07-06,Lam Dong,Da Lat City,8,84,67,17,5
2022-07-06,Lam Dong,Da Lat City,9,92,67,25,12
2022-07-06,Lam Dong,Da Lat City,10,108,89,19,6
2022-07-06,Lam Dong,Da Lat City,11,143,113,30,10
2022-07-06,Lam Dong,Da Lat City,12,173,101,72,55
2022-07-06,Lam Dong,Da Lat City,13,152,101,51,40
2022-07-06,Lam Dong,Da Lat City,14,103,73,30,18
2022-07-06,Lam Dong,Da Lat City,15,129,82,47,37
2022-07-06,Lam Dong,Da Lat City,16,113,76,37,26
2022-07-06,Lam Dong,Da Lat City,17,166,101,65,37
2022-07-06,Lam Dong,Da Lat City,18,149,104,45,26
2022-07-06,Lam Dong,Da Lat City,19,124,85,39,21
2022-07-06,Lam Dong,Da Lat City,20,119,67,52,37
2022-07-06,Lam Dong,Da Lat City,21,84,40,44,37
2022-07-06,Lam Dong,Da Lat City,22,2,0,2,0
2022-07-06,Lam Dong,Da Lat City,23,3,1,2,0
2022-07-06,Nghe An,Vinh City,0,1,1,0,0
2022-07-06,Nghe An,Vinh City,5,1,0,1,0
2022-07-06,Nghe An,Vinh City,6,3,3,0,0
2022-07-06,Nghe An,Vinh City,7,138,113,25,7
2022-07-06,Nghe An,Vinh City,8,217,183,34,8
2022-07-06,Nghe An,Vinh City,9,183,162,21,4
2022-07-06,Nghe An,Vinh City,10,264,215,49,15
2022-07-06,Nghe An,Vinh City,11,425,351,74,39
2022-07-06,Nghe An,Vinh City,12,237,214,23,3
2022-07-06,Nghe An,Vinh City,13,128,103,25,8
2022-07-06,Nghe An,Vinh City,14,209,153,56,21
2022-07-06,Nghe An,Vinh City,15,254,200,54,20
2022-07-06,Nghe An,Vinh City,16,159,126,33,1
2022-07-06,Nghe An,Vinh City,17,175,134,41,10
2022-07-06,Nghe An,Vinh City,18,246,187,59,22
2022-07-06,Nghe An,Vinh City,19,254,149,105,78
2022-07-06,Nghe An,Vinh City,20,175,126,49,26
2022-07-06,Nghe An,Vinh City,21,64,53,11,6
2022-07-06,Nghe An,Vinh City,23,1,0,1,0
2022-07-06,Quang Nam,Hoi An City,7,7,7,0,0
2022-07-06,Quang Nam,Hoi An City,8,32,22,10,7
2022-07-06,Quang Nam,Hoi An City,9,39,32,7,0
2022-07-06,Quang Nam,Hoi An City,10,46,35,11,1
2022-07-06,Quang Nam,Hoi An City,11,56,44,12,4
2022-07-06,Quang Nam,Hoi An City,12,48,37,11,6
2022-07-06,Quang Nam,Hoi An City,13,37,35,2,0
2022-07-06,Quang Nam,Hoi An City,14,49,38,11,2
2022-07-06,Quang Nam,Hoi An City,15,37,28,9,1
2022-07-06,Quang Nam,Hoi An City,16,41,35,6,1
2022-07-06,Quang Nam,Hoi An City,17,51,47,4,1
2022-07-06,Quang Nam,Hoi An City,18,39,37,2,1
2022-07-06,Quang Nam,Hoi An City,19,55,39,16,6
2022-07-06,Quang Nam,Hoi An City,20,52,29,23,14
2022-07-06,Quang Nam,Hoi An City,21,32,6,26,22
2022-07-06,Quang Nam,Tam Ky City,10,1,0,1,1
2022-07-06,Quang Nam,Tam Ky City,14,2,0,2,1
2022-07-06,Quang Nam,Tam Ky City,18,1,0,1,1
2022-07-06,Quang Nam,Tam Ky City,19,1,0,1,1
2022-07-06,Quang Ninh,Cam Pha City,11,3,0,3,1
2022-07-06,Quang Ninh,Cam Pha City,13,1,0,1,1
2022-07-06,Quang Ninh,Cam Pha City,14,1,0,1,1
2022-07-06,Quang Ninh,Cam Pha City,15,1,0,1,1
2022-07-06,Quang Ninh,Cam Pha City,19,2,0,2,2
2022-07-06,Quang Ninh,Ha Long City,1,2,2,0,0
2022-07-06,Quang Ninh,Ha Long City,7,27,22,5,4
2022-07-06,Quang Ninh,Ha Long City,8,68,36,32,14
2022-07-06,Quang Ninh,Ha Long City,9,49,39,10,5
2022-07-06,Quang Ninh,Ha Long City,10,67,55,12,1
2022-07-06,Quang Ninh,Ha Long City,11,146,119,27,10
2022-07-06,Quang Ninh,Ha Long City,12,112,78,34,17
2022-07-06,Quang Ninh,Ha Long City,13,64,49,15,5
2022-07-06,Quang Ninh,Ha Long City,14,77,58,19,5
2022-07-06,Quang Ninh,Ha Long City,15,60,45,15,5
2022-07-06,Quang Ninh,Ha Long City,16,47,39,8,6
2022-07-06,Quang Ninh,Ha Long City,17,57,44,13,6
2022-07-06,Quang Ninh,Ha Long City,18,56,41,15,7
2022-07-06,Quang Ninh,Ha Long City,19,68,48,20,9
2022-07-06,Quang Ninh,Ha Long City,20,37,23,14,10
2022-07-06,Quang Ninh,Ha Long City,21,1,0,1,0
2022-07-06,Thai Nguyen,Dong Hy,7,1,1,0,0
2022-07-06,Thai Nguyen,Dong Hy,8,1,1,0,0
2022-07-06,Thai Nguyen,Dong Hy,18,1,0,1,1
2022-07-06,Thai Nguyen,Thai Nguyen City,0,1,1,0,0
2022-07-06,Thai Nguyen,Thai Nguyen City,1,2,1,1,0
2022-07-06,Thai Nguyen,Thai Nguyen City,2,3,1,2,0
2022-07-06,Thai Nguyen,Thai Nguyen City,4,2,0,2,0
2022-07-06,Thai Nguyen,Thai Nguyen City,5,3,2,1,0
2022-07-06,Thai Nguyen,Thai Nguyen City,6,3,2,1,0
2022-07-06,Thai Nguyen,Thai Nguyen City,7,93,84,9,0
2022-07-06,Thai Nguyen,Thai Nguyen City,8,147,134,13,1
2022-07-06,Thai Nguyen,Thai Nguyen City,9,134,120,14,0
2022-07-06,Thai Nguyen,Thai Nguyen City,10,159,149,10,1
2022-07-06,Thai Nguyen,Thai Nguyen City,11,340,318,22,1
2022-07-06,Thai Nguyen,Thai Nguyen City,12,233,211,22,0
2022-07-06,Thai Nguyen,Thai Nguyen City,13,140,123,17,2
2022-07-06,Thai Nguyen,Thai Nguyen City,14,162,142,20,1
2022-07-06,Thai Nguyen,Thai Nguyen City,15,164,140,24,1
2022-07-06,Thai Nguyen,Thai Nguyen City,16,115,106,9,3
2022-07-06,Thai Nguyen,Thai Nguyen City,17,138,126,12,0
2022-07-06,Thai Nguyen,Thai Nguyen City,18,191,181,10,1
2022-07-06,Thai Nguyen,Thai Nguyen City,19,245,228,17,0
2022-07-06,Thai Nguyen,Thai Nguyen City,20,181,161,20,6
2022-07-06,Thai Nguyen,Thai Nguyen City,21,155,124,31,12
2022-07-06,Thai Nguyen,Thai Nguyen City,23,1,0,1,0
2022-07-06,Vung Tau,Ba Ria City,8,2,2,0,0
2022-07-06,Vung Tau,Ba Ria City,9,2,2,0,0
2022-07-06,Vung Tau,Ba Ria City,10,8,2,6,5
2022-07-06,Vung Tau,Ba Ria City,11,8,1,7,7
2022-07-06,Vung Tau,Ba Ria City,12,8,2,6,6
2022-07-06,Vung Tau,Ba Ria City,13,12,3,9,9
2022-07-06,Vung Tau,Ba Ria City,14,7,3,4,4
2022-07-06,Vung Tau,Ba Ria City,15,5,2,3,3
2022-07-06,Vung Tau,Ba Ria City,16,7,3,4,3
2022-07-06,Vung Tau,Ba Ria City,17,4,0,4,4
2022-07-06,Vung Tau,Ba Ria City,18,1,0,1,1
2022-07-06,Vung Tau,Ba Ria City,19,6,0,6,5
2022-07-06,Vung Tau,Ba Ria City,20,2,0,2,2
2022-07-06,Vung Tau,Ba Ria City,21,4,0,4,1
2022-07-06,Vung Tau,Ba Ria City,23,1,0,1,0
2022-07-06,Vung Tau,Chau Duc,16,1,0,1,1
2022-07-06,Vung Tau,Vung Tau City,2,3,2,1,0
2022-07-06,Vung Tau,Vung Tau City,6,28,26,2,0
2022-07-06,Vung Tau,Vung Tau City,7,114,104,10,2
2022-07-06,Vung Tau,Vung Tau City,8,191,178,13,2
2022-07-06,Vung Tau,Vung Tau City,9,195,181,14,3
2022-07-06,Vung Tau,Vung Tau City,10,240,218,22,1
2022-07-06,Vung Tau,Vung Tau City,11,391,361,30,5
2022-07-06,Vung Tau,Vung Tau City,12,295,276,19,0
2022-07-06,Vung Tau,Vung Tau City,13,258,235,23,5
2022-07-06,Vung Tau,Vung Tau City,14,302,277,25,7
2022-07-06,Vung Tau,Vung Tau City,15,224,211,13,1
2022-07-06,Vung Tau,Vung Tau City,16,202,189,13,2
2022-07-06,Vung Tau,Vung Tau City,17,288,270,18,1
2022-07-06,Vung Tau,Vung Tau City,18,296,272,24,5
2022-07-06,Vung Tau,Vung Tau City,19,282,250,32,7
2022-07-06,Vung Tau,Vung Tau City,20,175,153,22,6
2022-07-06,Vung Tau,Vung Tau City,21,104,79,25,5
2022-07-06,Vung Tau,Vung Tau City,22,1,0,1,0
2022-07-07,Bac Ninh,Bác Ninh City,0,1,1,0,0
2022-07-07,Bac Ninh,Bác Ninh City,1,2,0,2,0
2022-07-07,Bac Ninh,Bác Ninh City,2,1,1,0,0
2022-07-07,Bac Ninh,Bác Ninh City,5,5,2,3,1
2022-07-07,Bac Ninh,Bác Ninh City,6,2,2,0,0
2022-07-07,Bac Ninh,Bác Ninh City,7,73,61,12,4
2022-07-07,Bac Ninh,Bác Ninh City,8,122,116,6,0
2022-07-07,Bac Ninh,Bác Ninh City,9,95,89,6,0
2022-07-07,Bac Ninh,Bác Ninh City,10,197,179,18,1
2022-07-07,Bac Ninh,Bác Ninh City,11,392,266,126,95
2022-07-07,Bac Ninh,Bác Ninh City,12,259,205,54,27
2022-07-07,Bac Ninh,Bác Ninh City,13,133,126,7,0
2022-07-07,Bac Ninh,Bác Ninh City,14,151,126,25,2
2022-07-07,Bac Ninh,Bác Ninh City,15,148,117,31,10
2022-07-07,Bac Ninh,Bác Ninh City,16,153,139,14,4
2022-07-07,Bac Ninh,Bác Ninh City,17,179,164,15,3
2022-07-07,Bac Ninh,Bác Ninh City,18,223,207,16,4
2022-07-07,Bac Ninh,Bác Ninh City,19,191,161,30,13
2022-07-07,Bac Ninh,Bác Ninh City,20,198,123,75,38
2022-07-07,Bac Ninh,Bác Ninh City,21,129,66,63,49
2022-07-07,Bac Ninh,Bác Ninh City,22,3,1,2,1
2022-07-07,Bac Ninh,Que Vo,9,1,0,1,1
2022-07-07,Bac Ninh,Que Vo,12,1,0,1,1
2022-07-07,Bac Ninh,Que Vo,13,4,1,3,3
2022-07-07,Bac Ninh,Que Vo,14,2,0,2,1
2022-07-07,Bac Ninh,Que Vo,15,2,0,2,2
2022-07-07,Bac Ninh,Que Vo,17,4,1,3,0
2022-07-07,Bac Ninh,Que Vo,18,2,0,2,1
2022-07-07,Bac Ninh,Tien Du,6,1,0,1,0
2022-07-07,Bac Ninh,Tien Du,8,1,0,1,1
2022-07-07,Bac Ninh,Tien Du,10,1,0,1,1
2022-07-07,Bac Ninh,Tien Du,11,1,0,1,1
2022-07-07,Bac Ninh,Tien Du,12,2,0,2,2
2022-07-07,Bac Ninh,Tien Du,14,1,0,1,1
2022-07-07,Bac Ninh,Tien Du,15,4,0,4,3
2022-07-07,Bac Ninh,Tien Du,17,2,0,2,2
2022-07-07,Bac Ninh,Tien Du,19,2,0,2,2
2022-07-07,Bac Ninh,Tien Du,20,2,0,2,2
2022-07-07,Bac Ninh,Tien Du,21,3,0,3,3
2022-07-07,Bac Ninh,Tu Son,11,3,0,3,2
2022-07-07,Bac Ninh,Tu Son,12,1,0,1,1
2022-07-07,Bac Ninh,Tu Son,13,2,0,2,1
2022-07-07,Bac Ninh,Tu Son,15,1,0,1,1
2022-07-07,Bac Ninh,Tu Son,17,2,0,2,2
2022-07-07,Bac Ninh,Tu Son,18,1,0,1,1
2022-07-07,Bac Ninh,Tu Son,19,1,0,1,1
2022-07-07,Binh Duong,Ben Cat,9,2,0,2,2
2022-07-07,Binh Duong,Ben Cat,10,2,0,2,2
2022-07-07,Binh Duong,Ben Cat,11,4,0,4,4
2022-07-07,Binh Duong,Ben Cat,12,4,0,4,3
2022-07-07,Binh Duong,Ben Cat,13,7,0,7,6
2022-07-07,Binh Duong,Ben Cat,14,1,0,1,0
2022-07-07,Binh Duong,Ben Cat,16,1,0,1,1
2022-07-07,Binh Duong,Ben Cat,18,1,1,0,0
2022-07-07,Binh Duong,Ben Cat,20,2,0,2,1
2022-07-07,Binh Duong,Ben Cat,22,1,0,1,0
2022-07-07,Binh Duong,Di An,7,12,2,10,5
2022-07-07,Binh Duong,Di An,8,28,15,13,12
2022-07-07,Binh Duong,Di An,9,32,24,8,7
2022-07-07,Binh Duong,Di An,10,41,30,11,5
2022-07-07,Binh Duong,Di An,11,56,33,23,14
2022-07-07,Binh Duong,Di An,12,34,26,8,6
2022-07-07,Binh Duong,Di An,13,72,58,14,7
2022-07-07,Binh Duong,Di An,14,50,38,12,7
2022-07-07,Binh Duong,Di An,15,51,38,13,4
2022-07-07,Binh Duong,Di An,16,43,37,6,0
2022-07-07,Binh Duong,Di An,17,56,46,10,3
2022-07-07,Binh Duong,Di An,18,50,41,9,2
2022-07-07,Binh Duong,Di An,19,38,35,3,1
2022-07-07,Binh Duong,Di An,20,33,24,9,6
2022-07-07,Binh Duong,Di An,21,11,1,10,9
2022-07-07,Binh Duong,Di An,22,1,0,1,0
2022-07-07,Binh Duong,Tan Uyen,7,1,0,1,1
2022-07-07,Binh Duong,Tan Uyen,8,3,0,3,2
2022-07-07,Binh Duong,Tan Uyen,9,3,0,3,3
2022-07-07,Binh Duong,Tan Uyen,10,1,0,1,1
2022-07-07,Binh Duong,Tan Uyen,11,4,1,3,2
2022-07-07,Binh Duong,Tan Uyen,12,10,4,6,3
2022-07-07,Binh Duong,Tan Uyen,13,6,5,1,1
2022-07-07,Binh Duong,Tan Uyen,14,2,1,1,1
2022-07-07,Binh Duong,Tan Uyen,15,1,1,0,0
2022-07-07,Binh Duong,Tan Uyen,16,3,1,2,2
2022-07-07,Binh Duong,Tan Uyen,19,3,3,0,0
2022-07-07,Binh Duong,Tan Uyen,20,3,0,3,3
2022-07-07,Binh Duong,Tan Uyen,21,3,1,2,2
2022-07-07,Binh Duong,Thu Dau Mot Town,0,3,1,2,0
2022-07-07,Binh Duong,Thu Dau Mot Town,2,2,0,2,0
2022-07-07,Binh Duong,Thu Dau Mot Town,3,1,1,0,0
2022-07-07,Binh Duong,Thu Dau Mot Town,5,1,0,1,0
2022-07-07,Binh Duong,Thu Dau Mot Town,6,34,30,4,0
2022-07-07,Binh Duong,Thu Dau Mot Town,7,141,125,16,2
2022-07-07,Binh Duong,Thu Dau Mot Town,8,260,242,18,3
2022-07-07,Binh Duong,Thu Dau Mot Town,9,326,295,31,12
2022-07-07,Binh Duong,Thu Dau Mot Town,10,478,432,46,11
2022-07-07,Binh Duong,Thu Dau Mot Town,11,794,527,267,201
2022-07-07,Binh Duong,Thu Dau Mot Town,12,615,475,140,90
2022-07-07,Binh Duong,Thu Dau Mot Town,13,547,509,38,8
2022-07-07,Binh Duong,Thu Dau Mot Town,14,515,457,58,26
2022-07-07,Binh Duong,Thu Dau Mot Town,15,443,392,51,21
2022-07-07,Binh Duong,Thu Dau Mot Town,16,384,336,48,9
2022-07-07,Binh Duong,Thu Dau Mot Town,17,468,430,38,7
2022-07-07,Binh Duong,Thu Dau Mot Town,18,510,470,40,7
2022-07-07,Binh Duong,Thu Dau Mot Town,19,462,424,38,8
2022-07-07,Binh Duong,Thu Dau Mot Town,20,316,291,25,4
2022-07-07,Binh Duong,Thu Dau Mot Town,21,164,140,24,6
2022-07-07,Binh Duong,Thu Dau Mot Town,22,1,0,1,0
2022-07-07,Binh Duong,Thuan An,1,1,0,1,0
2022-07-07,Binh Duong,Thuan An,3,1,0,1,0
2022-07-07,Binh Duong,Thuan An,6,2,1,1,1
2022-07-07,Binh Duong,Thuan An,7,13,9,4,3
2022-07-07,Binh Duong,Thuan An,8,26,17,9,5
2022-07-07,Binh Duong,Thuan An,9,44,31,13,2
2022-07-07,Binh Duong,Thuan An,10,95,78,17,7
2022-07-07,Binh Duong,Thuan An,11,117,84,33,31
2022-07-07,Binh Duong,Thuan An,12,107,82,25,13
2022-07-07,Binh Duong,Thuan An,13,96,83,13,3
2022-07-07,Binh Duong,Thuan An,14,77,60,17,8
2022-07-07,Binh Duong,Thuan An,15,61,48,13,7
2022-07-07,Binh Duong,Thuan An,16,56,44,12,6
2022-07-07,Binh Duong,Thuan An,17,58,46,12,6
2022-07-07,Binh Duong,Thuan An,18,50,45,5,2
2022-07-07,Binh Duong,Thuan An,19,52,45,7,5
2022-07-07,Binh Duong,Thuan An,20,38,28,10,5
2022-07-07,Binh Duong,Thuan An,21,25,11,14,11
2022-07-07,Binh Duong,Thuan An,22,2,0,2,0
2022-07-07,Can Tho City,Binh Thuy District,6,1,1,0,0
2022-07-07,Can Tho City,Binh Thuy District,8,7,3,4,2
2022-07-07,Can Tho City,Binh Thuy District,9,4,2,2,1
2022-07-07,Can Tho City,Binh Thuy District,10,7,7,0,0
2022-07-07,Can Tho City,Binh Thuy District,11,25,17,8,6
2022-07-07,Can Tho City,Binh Thuy District,12,8,7,1,0
2022-07-07,Can Tho City,Binh Thuy District,13,11,9,2,0
2022-07-07,Can Tho City,Binh Thuy District,14,12,12,0,0
2022-07-07,Can Tho City,Binh Thuy District,15,9,9,0,0
2022-07-07,Can Tho City,Binh Thuy District,16,15,12,3,0
2022-07-07,Can Tho City,Binh Thuy District,17,14,12,2,1
2022-07-07,Can Tho City,Binh Thuy District,18,20,19,1,0
2022-07-07,Can Tho City,Binh Thuy District,19,13,11,2,0
2022-07-07,Can Tho City,Binh Thuy District,20,7,6,1,0
2022-07-07,Can Tho City,Binh Thuy District,21,1,0,1,0
2022-07-07,Can Tho City,Cai Rang District,0,1,1,0,0
2022-07-07,Can Tho City,Cai Rang District,6,5,4,1,1
2022-07-07,Can Tho City,Cai Rang District,7,6,5,1,1
2022-07-07,Can Tho City,Cai Rang District,8,4,4,0,0
2022-07-07,Can Tho City,Cai Rang District,9,7,5,2,0
2022-07-07,Can Tho City,Cai Rang District,10,16,14,2,0
2022-07-07,Can Tho City,Cai Rang District,11,17,7,10,7
2022-07-07,Can Tho City,Cai Rang District,12,28,24,4,2
2022-07-07,Can Tho City,Cai Rang District,13,14,13,1,0
2022-07-07,Can Tho City,Cai Rang District,14,10,9,1,0
2022-07-07,Can Tho City,Cai Rang District,15,12,11,1,0
2022-07-07,Can Tho City,Cai Rang District,16,14,14,0,0
2022-07-07,Can Tho City,Cai Rang District,17,14,13,1,0
2022-07-07,Can Tho City,Cai Rang District,18,15,13,2,0
2022-07-07,Can Tho City,Cai Rang District,19,16,16,0,0
2022-07-07,Can Tho City,Cai Rang District,20,14,10,4,1
2022-07-07,Can Tho City,Cai Rang District,21,4,4,0,0
2022-07-07,Can Tho City,Ninh Kieu District,0,5,5,0,0
2022-07-07,Can Tho City,Ninh Kieu District,1,4,4,0,0
2022-07-07,Can Tho City,Ninh Kieu District,3,2,1,1,0
2022-07-07,Can Tho City,Ninh Kieu District,5,3,3,0,0
2022-07-07,Can Tho City,Ninh Kieu District,6,49,43,6,1
2022-07-07,Can Tho City,Ninh Kieu District,7,142,134,8,0
2022-07-07,Can Tho City,Ninh Kieu District,8,261,245,16,0
2022-07-07,Can Tho City,Ninh Kieu District,9,309,290,19,0
2022-07-07,Can Tho City,Ninh Kieu District,10,612,575,37,0
2022-07-07,Can Tho City,Ninh Kieu District,11,1094,663,431,349
2022-07-07,Can Tho City,Ninh Kieu District,12,685,658,27,10
2022-07-07,Can Tho City,Ninh Kieu District,13,572,553,19,0
2022-07-07,Can Tho City,Ninh Kieu District,14,508,487,21,0
2022-07-07,Can Tho City,Ninh Kieu District,15,444,422,22,0
2022-07-07,Can Tho City,Ninh Kieu District,16,458,443,15,0
2022-07-07,Can Tho City,Ninh Kieu District,17,574,548,26,0
2022-07-07,Can Tho City,Ninh Kieu District,18,642,616,26,0
2022-07-07,Can Tho City,Ninh Kieu District,19,584,560,24,0
2022-07-07,Can Tho City,Ninh Kieu District,20,426,408,18,0
2022-07-07,Can Tho City,Ninh Kieu District,21,226,206,20,0
2022-07-07,Can Tho City,Ninh Kieu District,22,4,0,4,0
2022-07-07,Can Tho City,Ninh Kieu District,23,1,0,1,0
2022-07-07,Can Tho City,O Mon District,12,1,0,1,1
2022-07-07,Can Tho City,Thoi Lai,12,1,0,1,1
2022-07-07,Dong Nai,Bien Hoa City,0,2,1,1,0
2022-07-07,Dong Nai,Bien Hoa City,1,2,2,0,0
2022-07-07,Dong Nai,Bien Hoa City,2,4,0,4,0
2022-07-07,Dong Nai,Bien Hoa City,4,1,0,1,1
2022-07-07,Dong Nai,Bien Hoa City,5,4,3,1,0
2022-07-07,Dong Nai,Bien Hoa City,6,39,32,7,5
2022-07-07,Dong Nai,Bien Hoa City,7,170,145,25,17
2022-07-07,Dong Nai,Bien Hoa City,8,340,305,35,4
2022-07-07,Dong Nai,Bien Hoa City,9,425,398,27,0
2022-07-07,Dong Nai,Bien Hoa City,10,861,796,65,10
2022-07-07,Dong Nai,Bien Hoa City,11,1409,1052,357,231
2022-07-07,Dong Nai,Bien Hoa City,12,1216,989,227,134
2022-07-07,Dong Nai,Bien Hoa City,13,1048,967,81,12
2022-07-07,Dong Nai,Bien Hoa City,14,882,827,55,12
2022-07-07,Dong Nai,Bien Hoa City,15,635,580,55,6
2022-07-07,Dong Nai,Bien Hoa City,16,656,610,46,10
2022-07-07,Dong Nai,Bien Hoa City,17,758,722,36,1
2022-07-07,Dong Nai,Bien Hoa City,18,784,740,44,2
2022-07-07,Dong Nai,Bien Hoa City,19,799,723,76,18
2022-07-07,Dong Nai,Bien Hoa City,20,616,532,84,19
2022-07-07,Dong Nai,Bien Hoa City,21,284,213,71,19
2022-07-07,Dong Nai,Bien Hoa City,22,1,0,1,0
2022-07-07,Dong Nai,Cam My,20,1,0,1,0
2022-07-07,Dong Nai,Long Khanh,0,1,0,1,0
2022-07-07,Dong Nai,Long Khanh,9,1,0,1,1
2022-07-07,Dong Nai,Long Khanh,10,3,0,3,3
2022-07-07,Dong Nai,Long Khanh,11,3,0,3,3
2022-07-07,Dong Nai,Long Khanh,13,1,0,1,1
2022-07-07,Dong Nai,Long Khanh,20,1,0,1,1
2022-07-07,Dong Nai,Long Khanh,21,2,0,2,2
2022-07-07,Dong Nai,Long Thanh,0,1,0,1,1
2022-07-07,Dong Nai,Long Thanh,9,1,0,1,1
2022-07-07,Dong Nai,Long Thanh,10,2,0,2,2
2022-07-07,Dong Nai,Long Thanh,11,7,0,7,7
2022-07-07,Dong Nai,Long Thanh,13,3,1,2,2
2022-07-07,Dong Nai,Long Thanh,14,1,0,1,1
2022-07-07,Dong Nai,Long Thanh,17,1,0,1,1
2022-07-07,Dong Nai,Long Thanh,20,1,0,1,1
2022-07-07,Dong Nai,Nhon trach,13,1,0,1,1
2022-07-07,Dong Nai,Nhon trach,15,1,0,1,1
2022-07-07,Dong Nai,Nhon trach,19,1,0,1,1
2022-07-07,Dong Nai,Nhon trach,20,4,0,4,2
2022-07-07,Dong Nai,Trang Bom,10,1,0,1,1
2022-07-07,Dong Nai,Trang Bom,12,1,0,1,1
2022-07-07,Dong Nai,Trang Bom,14,2,0,2,2
2022-07-07,Dong Nai,Trang Bom,15,1,0,1,1
2022-07-07,Dong Nai,Trang Bom,16,1,0,1,1
2022-07-07,Dong Nai,Trang Bom,17,2,0,2,2
2022-07-07,Dong Nai,Trang Bom,19,4,0,4,4
2022-07-07,Dong Nai,Trang Bom,20,2,0,2,0
2022-07-07,Dong Nai,Vinh Cuu,11,1,0,1,1
2022-07-07,Dong Nai,Vinh Cuu,12,1,1,0,0
2022-07-07,Dong Nai,Vinh Cuu,18,1,1,0,0
2022-07-07,Dong Nai,Vinh Cuu,20,1,0,1,0
2022-07-07,Hai Phong City,An Duong,5,1,0,1,0
2022-07-07,Hai Phong City,An Duong,7,3,1,2,1
2022-07-07,Hai Phong City,An Duong,8,1,0,1,1
2022-07-07,Hai Phong City,An Duong,9,4,2,2,2
2022-07-07,Hai Phong City,An Duong,10,9,3,6,5
2022-07-07,Hai Phong City,An Duong,11,4,0,4,3
2022-07-07,Hai Phong City,An Duong,12,3,1,2,1
2022-07-07,Hai Phong City,An Duong,14,2,1,1,1
2022-07-07,Hai Phong City,An Duong,15,5,0,5,4
2022-07-07,Hai Phong City,An Duong,16,4,2,2,1
2022-07-07,Hai Phong City,An Duong,17,6,2,4,3
2022-07-07,Hai Phong City,An Duong,18,7,3,4,0
2022-07-07,Hai Phong City,An Duong,19,2,1,1,1
2022-07-07,Hai Phong City,An Duong,20,4,0,4,4
2022-07-07,Hai Phong City,An Duong,21,2,1,1,1
2022-07-07,Hai Phong City,Do Son District,19,1,0,1,1
2022-07-07,Hai Phong City,Do Son District,20,1,0,1,1
2022-07-07,Hai Phong City,Do Son District,21,1,0,1,1
2022-07-07,Hai Phong City,Duong Kinh District,7,1,0,1,0
2022-07-07,Hai Phong City,Duong Kinh District,8,1,0,1,1
2022-07-07,Hai Phong City,Duong Kinh District,15,1,0,1,1
2022-07-07,Hai Phong City,Duong Kinh District,16,1,0,1,1
2022-07-07,Hai Phong City,Duong Kinh District,17,2,0,2,2
2022-07-07,Hai Phong City,Duong Kinh District,21,1,0,1,1
2022-07-07,Hai Phong City,Hai An District,1,1,1,0,0
2022-07-07,Hai Phong City,Hai An District,5,1,0,1,0
2022-07-07,Hai Phong City,Hai An District,6,1,1,0,0
2022-07-07,Hai Phong City,Hai An District,7,10,3,7,2
2022-07-07,Hai Phong City,Hai An District,8,16,10,6,3
2022-07-07,Hai Phong City,Hai An District,9,11,6,5,2
2022-07-07,Hai Phong City,Hai An District,10,32,13,19,12
2022-07-07,Hai Phong City,Hai An District,11,73,36,37,31
2022-07-07,Hai Phong City,Hai An District,12,31,20,11,7
2022-07-07,Hai Phong City,Hai An District,13,17,13,4,1
2022-07-07,Hai Phong City,Hai An District,14,23,19,4,2
2022-07-07,Hai Phong City,Hai An District,15,32,22,10,3
2022-07-07,Hai Phong City,Hai An District,16,19,16,3,1
2022-07-07,Hai Phong City,Hai An District,17,17,11,6,5
2022-07-07,Hai Phong City,Hai An District,18,22,17,5,3
2022-07-07,Hai Phong City,Hai An District,19,25,21,4,2
2022-07-07,Hai Phong City,Hai An District,20,11,7,4,0
2022-07-07,Hai Phong City,Hai An District,21,8,6,2,0
2022-07-07,Hai Phong City,Hai An District,23,2,0,2,0
2022-07-07,Hai Phong City,Hong Bang District,6,3,0,3,2
2022-07-07,Hai Phong City,Hong Bang District,7,15,11,4,2
2022-07-07,Hai Phong City,Hong Bang District,8,37,32,5,0
2022-07-07,Hai Phong City,Hong Bang District,9,29,20,9,6
2022-07-07,Hai Phong City,Hong Bang District,10,81,61,20,12
2022-07-07,Hai Phong City,Hong Bang District,11,129,73,56,40
2022-07-07,Hai Phong City,Hong Bang District,12,78,57,21,10
2022-07-07,Hai Phong City,Hong Bang District,13,53,45,8,2
2022-07-07,Hai Phong City,Hong Bang District,14,58,44,14,9
2022-07-07,Hai Phong City,Hong Bang District,15,65,55,10,6
2022-07-07,Hai Phong City,Hong Bang District,16,48,40,8,2
2022-07-07,Hai Phong City,Hong Bang District,17,58,45,13,4
2022-07-07,Hai Phong City,Hong Bang District,18,76,62,14,5
2022-07-07,Hai Phong City,Hong Bang District,19,60,48,12,6
2022-07-07,Hai Phong City,Hong Bang District,20,56,46,10,3
2022-07-07,Hai Phong City,Hong Bang District,21,20,18,2,1
2022-07-07,Hai Phong City,Kien An District,7,1,1,0,0
2022-07-07,Hai Phong City,Kien An District,8,5,5,0,0
2022-07-07,Hai Phong City,Kien An District,9,15,8,7,2
2022-07-07,Hai Phong City,Kien An District,10,11,8,3,1
2022-07-07,Hai Phong City,Kien An District,11,23,11,12,7
2022-07-07,Hai Phong City,Kien An District,12,10,8,2,2
2022-07-07,Hai Phong City,Kien An District,13,18,16,2,0
2022-07-07,Hai Phong City,Kien An District,14,9,7,2,1
2022-07-07,Hai Phong City,Kien An District,15,11,9,2,2
2022-07-07,Hai Phong City,Kien An District,16,18,15,3,1
2022-07-07,Hai Phong City,Kien An District,17,17,12,5,3
2022-07-07,Hai Phong City,Kien An District,18,20,13,7,3
2022-07-07,Hai Phong City,Kien An District,19,21,10,11,5
2022-07-07,Hai Phong City,Kien An District,20,18,5,13,11
2022-07-07,Hai Phong City,Kien An District,21,9,1,8,8
2022-07-07,Hai Phong City,Le Chan District,0,1,1,0,0
2022-07-07,Hai Phong City,Le Chan District,1,2,0,2,1
2022-07-07,Hai Phong City,Le Chan District,3,1,0,1,0
2022-07-07,Hai Phong City,Le Chan District,5,1,0,1,1
2022-07-07,Hai Phong City,Le Chan District,6,3,2,1,0
2022-07-07,Hai Phong City,Le Chan District,7,46,39,7,3
2022-07-07,Hai Phong City,Le Chan District,8,91,78,13,2
2022-07-07,Hai Phong City,Le Chan District,9,97,79,18,3
2022-07-07,Hai Phong City,Le Chan District,10,201,142,59,32
2022-07-07,Hai Phong City,Le Chan District,11,381,217,164,119
2022-07-07,Hai Phong City,Le Chan District,12,234,164,70,39
2022-07-07,Hai Phong City,Le Chan District,13,154,135,19,1
2022-07-07,Hai Phong City,Le Chan District,14,186,147,39,20
2022-07-07,Hai Phong City,Le Chan District,15,225,163,62,32
2022-07-07,Hai Phong City,Le Chan District,16,169,150,19,5
2022-07-07,Hai Phong City,Le Chan District,17,237,197,40,11
2022-07-07,Hai Phong City,Le Chan District,18,264,228,36,13
2022-07-07,Hai Phong City,Le Chan District,19,262,209,53,20
2022-07-07,Hai Phong City,Le Chan District,20,174,137,37,9
2022-07-07,Hai Phong City,Le Chan District,21,88,64,24,6
2022-07-07,Hai Phong City,Le Chan District,22,2,1,1,0
2022-07-07,Hai Phong City,Ngo Quyen District,0,1,0,1,0
2022-07-07,Hai Phong City,Ngo Quyen District,6,3,1,2,0
2022-07-07,Hai Phong City,Ngo Quyen District,7,22,18,4,2
2022-07-07,Hai Phong City,Ngo Quyen District,8,92,83,9,3
2022-07-07,Hai Phong City,Ngo Quyen District,9,91,74,17,2
2022-07-07,Hai Phong City,Ngo Quyen District,10,188,131,57,38
2022-07-07,Hai Phong City,Ngo Quyen District,11,321,190,131,85
2022-07-07,Hai Phong City,Ngo Quyen District,12,191,144,47,26
2022-07-07,Hai Phong City,Ngo Quyen District,13,129,118,11,3
2022-07-07,Hai Phong City,Ngo Quyen District,14,184,163,21,9
2022-07-07,Hai Phong City,Ngo Quyen District,15,192,163,29,11
2022-07-07,Hai Phong City,Ngo Quyen District,16,182,164,18,3
2022-07-07,Hai Phong City,Ngo Quyen District,17,191,155,36,12
2022-07-07,Hai Phong City,Ngo Quyen District,18,185,163,22,9
2022-07-07,Hai Phong City,Ngo Quyen District,19,194,174,20,5
2022-07-07,Hai Phong City,Ngo Quyen District,20,153,126,27,6
2022-07-07,Hai Phong City,Ngo Quyen District,21,82,63,19,4
2022-07-07,Hai Phong City,Thuy Nguyen,12,2,0,2,2
2022-07-07,Hai Phong City,Thuy Nguyen,13,2,0,2,2
2022-07-07,Hai Phong City,Thuy Nguyen,15,1,0,1,1
2022-07-07,Hai Phong City,Thuy Nguyen,16,1,0,1,1
2022-07-07,Hai Phong City,Thuy Nguyen,17,2,0,2,2
2022-07-07,Hai Phong City,Thuy Nguyen,18,2,1,1,1
2022-07-07,Hai Phong City,Thuy Nguyen,20,3,0,3,2
2022-07-07,Hai Phong City,Thuy Nguyen,21,1,0,1,1
2022-07-07,Hue City,Hue City,0,11,8,3,0
2022-07-07,Hue City,Hue City,1,1,0,1,0
2022-07-07,Hue City,Hue City,2,2,2,0,0
2022-07-07,Hue City,Hue City,3,3,3,0,0
2022-07-07,Hue City,Hue City,5,6,3,3,1
2022-07-07,Hue City,Hue City,6,71,68,3,1
2022-07-07,Hue City,Hue City,7,201,178,23,0
2022-07-07,Hue City,Hue City,8,330,303,27,0
2022-07-07,Hue City,Hue City,9,297,267,30,0
2022-07-07,Hue City,Hue City,10,460,431,29,0
2022-07-07,Hue City,Hue City,11,1135,596,539,425
2022-07-07,Hue City,Hue City,12,647,598,49,5
2022-07-07,Hue City,Hue City,13,566,517,49,0
2022-07-07,Hue City,Hue City,14,590,534,56,0
2022-07-07,Hue City,Hue City,15,492,452,40,0
2022-07-07,Hue City,Hue City,16,605,538,67,2
2022-07-07,Hue City,Hue City,17,660,603,57,2
2022-07-07,Hue City,Hue City,18,693,640,53,0
2022-07-07,Hue City,Hue City,19,779,731,48,1
2022-07-07,Hue City,Hue City,20,580,507,73,9
2022-07-07,Hue City,Hue City,21,317,264,53,6
2022-07-07,Hue City,Hue City,22,9,0,9,0
2022-07-07,Hue City,Hue City,23,4,0,4,0
2022-07-07,Hue City,Huong Thuy,8,1,1,0,0
2022-07-07,Hue City,Huong Thuy,11,2,1,1,1
2022-07-07,Hue City,Huong Thuy,12,4,2,2,1
2022-07-07,Hue City,Huong Thuy,13,1,1,0,0
2022-07-07,Hue City,Huong Thuy,15,1,1,0,0
2022-07-07,Hue City,Huong Thuy,16,4,4,0,0
2022-07-07,Hue City,Huong Thuy,17,4,3,1,0
2022-07-07,Hue City,Huong Thuy,18,3,2,1,1
2022-07-07,Hue City,Huong Thuy,19,1,1,0,0
2022-07-07,Hue City,Huong Thuy,20,1,1,0,0
2022-07-07,Hue City,Huong Tra,11,1,1,0,0
2022-07-07,Hue City,Phu Vang,7,2,1,1,0
2022-07-07,Hue City,Phu Vang,8,5,5,0,0
2022-07-07,Hue City,Phu Vang,11,1,1,0,0
2022-07-07,Hue City,Phu Vang,12,1,1,0,0
2022-07-07,Hue City,Phu Vang,13,1,1,0,0
2022-07-07,Hue City,Phu Vang,14,3,3,0,0
2022-07-07,Hue City,Phu Vang,15,5,1,4,3
2022-07-07,Hue City,Phu Vang,16,1,1,0,0
2022-07-07,Hue City,Phu Vang,17,2,2,0,0
2022-07-07,Hue City,Phu Vang,18,1,1,0,0
2022-07-07,Hue City,Phu Vang,19,2,1,1,1
2022-07-07,Hue City,Phu Vang,20,1,0,1,0
2022-07-07,Hue City,Phu Vang,21,4,3,1,1
2022-07-07,Khanh Hoa,Cam Ranh City,17,1,0,1,1
2022-07-07,Khanh Hoa,Dien Khanh,6,3,0,3,2
2022-07-07,Khanh Hoa,Dien Khanh,10,2,0,2,2
2022-07-07,Khanh Hoa,Dien Khanh,19,1,0,1,1
2022-07-07,Khanh Hoa,Nha Trang City,0,2,2,0,0
2022-07-07,Khanh Hoa,Nha Trang City,4,1,1,0,0
2022-07-07,Khanh Hoa,Nha Trang City,5,2,2,0,0
2022-07-07,Khanh Hoa,Nha Trang City,6,43,35,8,7
2022-07-07,Khanh Hoa,Nha Trang City,7,170,155,15,2
2022-07-07,Khanh Hoa,Nha Trang City,8,234,214,20,2
2022-07-07,Khanh Hoa,Nha Trang City,9,198,177,21,1
2022-07-07,Khanh Hoa,Nha Trang City,10,254,232,22,0
2022-07-07,Khanh Hoa,Nha Trang City,11,467,371,96,67
2022-07-07,Khanh Hoa,Nha Trang City,12,360,309,51,23
2022-07-07,Khanh Hoa,Nha Trang City,13,369,338,31,0
2022-07-07,Khanh Hoa,Nha Trang City,14,294,278,16,1
2022-07-07,Khanh Hoa,Nha Trang City,15,275,253,22,0
2022-07-07,Khanh Hoa,Nha Trang City,16,337,313,24,2
2022-07-07,Khanh Hoa,Nha Trang City,17,258,240,18,1
2022-07-07,Khanh Hoa,Nha Trang City,18,314,291,23,0
2022-07-07,Khanh Hoa,Nha Trang City,19,329,302,27,1
2022-07-07,Khanh Hoa,Nha Trang City,20,229,201,28,1
2022-07-07,Khanh Hoa,Nha Trang City,21,119,93,26,6
2022-07-07,Khanh Hoa,Nha Trang City,22,2,0,2,0
2022-07-07,Khanh Hoa,Nha Trang City,23,1,0,1,0
2022-07-07,Lam Dong,Da Lat City,2,1,0,1,0
2022-07-07,Lam Dong,Da Lat City,5,1,1,0,0
2022-07-07,Lam Dong,Da Lat City,6,1,1,0,0
2022-07-07,Lam Dong,Da Lat City,7,41,34,7,2
2022-07-07,Lam Dong,Da Lat City,8,93,78,15,5
2022-07-07,Lam Dong,Da Lat City,9,84,74,10,0
2022-07-07,Lam Dong,Da Lat City,10,128,107,21,10
2022-07-07,Lam Dong,Da Lat City,11,208,123,85,62
2022-07-07,Lam Dong,Da Lat City,12,178,115,63,43
2022-07-07,Lam Dong,Da Lat City,13,134,98,36,16
2022-07-07,Lam Dong,Da Lat City,14,120,92,28,10
2022-07-07,Lam Dong,Da Lat City,15,107,91,16,8
2022-07-07,Lam Dong,Da Lat City,16,138,107,31,11
2022-07-07,Lam Dong,Da Lat City,17,176,127,49,26
2022-07-07,Lam Dong,Da Lat City,18,164,126,38,12
2022-07-07,Lam Dong,Da Lat City,19,121,106,15,6
2022-07-07,Lam Dong,Da Lat City,20,118,86,32,16
2022-07-07,Lam Dong,Da Lat City,21,75,44,31,19
2022-07-07,Lam Dong,Da Lat City,22,3,1,2,0
2022-07-07,Nghe An,Vinh City,0,4,3,1,0
2022-07-07,Nghe An,Vinh City,1,2,1,1,0
2022-07-07,Nghe An,Vinh City,4,1,1,0,0
2022-07-07,Nghe An,Vinh City,5,2,2,0,0
2022-07-07,Nghe An,Vinh City,6,5,2,3,0
2022-07-07,Nghe An,Vinh City,7,145,112,33,3
2022-07-07,Nghe An,Vinh City,8,211,185,26,6
2022-07-07,Nghe An,Vinh City,9,177,144,33,1
2022-07-07,Nghe An,Vinh City,10,280,225,55,18
2022-07-07,Nghe An,Vinh City,11,529,272,257,188
2022-07-07,Nghe An,Vinh City,12,323,223,100,58
2022-07-07,Nghe An,Vinh City,13,159,100,59,28
2022-07-07,Nghe An,Vinh City,14,165,127,38,16
2022-07-07,Nghe An,Vinh City,15,238,176,62,29
2022-07-07,Nghe An,Vinh City,16,196,150,46,22
2022-07-07,Nghe An,Vinh City,17,208,154,54,26
2022-07-07,Nghe An,Vinh City,18,209,177,32,7
2022-07-07,Nghe An,Vinh City,19,197,169,28,7
2022-07-07,Nghe An,Vinh City,20,156,135,21,3
2022-07-07,Nghe An,Vinh City,21,86,67,19,5
2022-07-07,Nghe An,Vinh City,22,4,1,3,0
2022-07-07,Quang Nam,Dien Ban,11,1,0,1,1
2022-07-07,Quang Nam,Hoi An City,0,1,0,1,0
2022-07-07,Quang Nam,Hoi An City,7,8,7,1,0
2022-07-07,Quang Nam,Hoi An City,8,33,27,6,3
2022-07-07,Quang Nam,Hoi An City,9,34,30,4,0
2022-07-07,Quang Nam,Hoi An City,10,41,38,3,0
2022-07-07,Quang Nam,Hoi An City,11,65,45,20,5
2022-07-07,Quang Nam,Hoi An City,12,42,36,6,1
2022-07-07,Quang Nam,Hoi An City,13,39,34,5,0
2022-07-07,Quang Nam,Hoi An City,14,40,35,5,0
2022-07-07,Quang Nam,Hoi An City,15,39,31,8,2
2022-07-07,Quang Nam,Hoi An City,16,51,44,7,0
2022-07-07,Quang Nam,Hoi An City,17,65,48,17,7
2022-07-07,Quang Nam,Hoi An City,18,110,40,70,65
2022-07-07,Quang Nam,Hoi An City,19,121,41,80,62
2022-07-07,Quang Nam,Hoi An City,20,80,33,47,41
2022-07-07,Quang Nam,Hoi An City,21,42,13,29,21
2022-07-07,Quang Nam,Tam Ky City,6,1,0,1,0
2022-07-07,Quang Nam,Tam Ky City,12,1,0,1,1
2022-07-07,Quang Nam,Tam Ky City,13,2,0,2,2
2022-07-07,Quang Nam,Tam Ky City,14,2,0,2,2
2022-07-07,Quang Nam,Tam Ky City,16,1,0,1,1
2022-07-07,Quang Nam,Thang Binh,8,1,0,1,1
2022-07-07,Quang Ninh,Cam Pha City,7,3,0,3,3
2022-07-07,Quang Ninh,Cam Pha City,8,1,0,1,1
2022-07-07,Quang Ninh,Cam Pha City,9,2,0,2,2
2022-07-07,Quang Ninh,Cam Pha City,10,1,0,1,1
2022-07-07,Quang Ninh,Cam Pha City,11,7,0,7,6
2022-07-07,Quang Ninh,Cam Pha City,12,2,0,2,2
2022-07-07,Quang Ninh,Cam Pha City,13,1,0,1,1
2022-07-07,Quang Ninh,Cam Pha City,14,1,0,1,0
2022-07-07,Quang Ninh,Cam Pha City,15,4,0,4,3
2022-07-07,Quang Ninh,Cam Pha City,16,4,0,4,3
2022-07-07,Quang Ninh,Cam Pha City,17,3,0,3,2
2022-07-07,Quang Ninh,Cam Pha City,18,1,0,1,1
2022-07-07,Quang Ninh,Cam Pha City,19,3,0,3,2
2022-07-07,Quang Ninh,Cam Pha City,20,3,0,3,3
2022-07-07,Quang Ninh,Ha Long City,0,4,1,3,1
2022-07-07,Quang Ninh,Ha Long City,2,2,1,1,0
2022-07-07,Quang Ninh,Ha Long City,5,1,0,1,0
2022-07-07,Quang Ninh,Ha Long City,7,25,15,10,4
2022-07-07,Quang Ninh,Ha Long City,8,41,27,14,7
2022-07-07,Quang Ninh,Ha Long City,9,65,35,30,20
2022-07-07,Quang Ninh,Ha Long City,10,87,24,63,49
2022-07-07,Quang Ninh,Ha Long City,11,172,19,153,131
2022-07-07,Quang Ninh,Ha Long City,12,152,31,121,104
2022-07-07,Quang Ninh,Ha Long City,13,110,52,58,44
2022-07-07,Quang Ninh,Ha Long City,14,101,52,49,24
2022-07-07,Quang Ninh,Ha Long City,15,74,50,24,11
2022-07-07,Quang Ninh,Ha Long City,16,61,50,11,2
2022-07-07,Quang Ninh,Ha Long City,17,70,54,16,5
2022-07-07,Quang Ninh,Ha Long City,18,73,57,16,3
2022-07-07,Quang Ninh,Ha Long City,19,64,39,25,14
2022-07-07,Quang Ninh,Ha Long City,20,80,47,33,19
2022-07-07,Quang Ninh,Ha Long City,21,3,0,3,2
2022-07-07,Quang Ninh,Uong Bi City,10,1,0,1,1
2022-07-07,Thai Nguyen,Dong Hy,10,1,1,0,0
2022-07-07,Thai Nguyen,Dong Hy,11,2,0,2,2
2022-07-07,Thai Nguyen,Dong Hy,12,2,0,2,2
2022-07-07,Thai Nguyen,Dong Hy,13,2,1,1,1
2022-07-07,Thai Nguyen,Thai Nguyen City,0,5,5,0,0
2022-07-07,Thai Nguyen,Thai Nguyen City,1,1,0,1,0
2022-07-07,Thai Nguyen,Thai Nguyen City,6,3,1,2,0
2022-07-07,Thai Nguyen,Thai Nguyen City,7,92,82,10,3
2022-07-07,Thai Nguyen,Thai Nguyen City,8,148,137,11,0
2022-07-07,Thai Nguyen,Thai Nguyen City,9,129,113,16,2
2022-07-07,Thai Nguyen,Thai Nguyen City,10,201,178,23,1
2022-07-07,Thai Nguyen,Thai Nguyen City,11,520,380,140,86
2022-07-07,Thai Nguyen,Thai Nguyen City,12,364,292,72,39
2022-07-07,Thai Nguyen,Thai Nguyen City,13,169,153,16,0
2022-07-07,Thai Nguyen,Thai Nguyen City,14,170,164,6,2
2022-07-07,Thai Nguyen,Thai Nguyen City,15,136,124,12,1
2022-07-07,Thai Nguyen,Thai Nguyen City,16,150,137,13,1
2022-07-07,Thai Nguyen,Thai Nguyen City,17,201,180,21,3
2022-07-07,Thai Nguyen,Thai Nguyen City,18,237,220,17,1
2022-07-07,Thai Nguyen,Thai Nguyen City,19,262,237,25,4
2022-07-07,Thai Nguyen,Thai Nguyen City,20,186,164,22,1
2022-07-07,Thai Nguyen,Thai Nguyen City,21,147,130,17,1
2022-07-07,Thai Nguyen,Thai Nguyen City,22,1,0,1,0
2022-07-07,Thai Nguyen,Thai Nguyen City,23,3,3,0,0
2022-07-07,Vung Tau,Ba Ria City,7,1,1,0,0
2022-07-07,Vung Tau,Ba Ria City,8,1,1,0,0
2022-07-07,Vung Tau,Ba Ria City,9,10,6,4,4
2022-07-07,Vung Tau,Ba Ria City,10,6,2,4,3
2022-07-07,Vung Tau,Ba Ria City,11,6,2,4,3
2022-07-07,Vung Tau,Ba Ria City,12,15,6,9,6
2022-07-07,Vung Tau,Ba Ria City,13,14,5,9,7
2022-07-07,Vung Tau,Ba Ria City,14,7,2,5,4
2022-07-07,Vung Tau,Ba Ria City,15,6,2,4,4
2022-07-07,Vung Tau,Ba Ria City,16,8,2,6,6
2022-07-07,Vung Tau,Ba Ria City,17,11,5,6,4
2022-07-07,Vung Tau,Ba Ria City,18,14,3,11,10
2022-07-07,Vung Tau,Ba Ria City,19,5,2,3,2
2022-07-07,Vung Tau,Ba Ria City,20,9,0,9,9
2022-07-07,Vung Tau,Ba Ria City,21,1,0,1,1
2022-07-07,Vung Tau,Chau Duc,15,1,0,1,1
2022-07-07,Vung Tau,Vung Tau City,0,4,3,1,0
2022-07-07,Vung Tau,Vung Tau City,1,1,1,0,0
2022-07-07,Vung Tau,Vung Tau City,2,1,1,0,0
2022-07-07,Vung Tau,Vung Tau City,3,1,1,0,0
2022-07-07,Vung Tau,Vung Tau City,5,4,1,3,1
2022-07-07,Vung Tau,Vung Tau City,6,38,31,7,1
2022-07-07,Vung Tau,Vung Tau City,7,116,105,11,3
2022-07-07,Vung Tau,Vung Tau City,8,181,172,9,0
2022-07-07,Vung Tau,Vung Tau City,9,200,186,14,1
2022-07-07,Vung Tau,Vung Tau City,10,265,239,26,3
2022-07-07,Vung Tau,Vung Tau City,11,480,338,142,98
2022-07-07,Vung Tau,Vung Tau City,12,351,333,18,5
2022-07-07,Vung Tau,Vung Tau City,13,276,254,22,0
2022-07-07,Vung Tau,Vung Tau City,14,276,255,21,6
2022-07-07,Vung Tau,Vung Tau City,15,230,212,18,3
2022-07-07,Vung Tau,Vung Tau City,16,283,259,24,3
2022-07-07,Vung Tau,Vung Tau City,17,411,357,54,17
2022-07-07,Vung Tau,Vung Tau City,18,418,366,52,17
2022-07-07,Vung Tau,Vung Tau City,19,298,264,34,12
2022-07-07,Vung Tau,Vung Tau City,20,236,197,39,8
2022-07-07,Vung Tau,Vung Tau City,21,92,77,15,4
2022-07-07,Vung Tau,Vung Tau City,22,1,0,1,0
2022-07-08,Bac Ninh,Bác Ninh City,2,2,0,2,0
2022-07-08,Bac Ninh,Bác Ninh City,4,1,1,0,0
2022-07-08,Bac Ninh,Bác Ninh City,6,4,3,1,0
2022-07-08,Bac Ninh,Bác Ninh City,7,99,57,42,33
2022-07-08,Bac Ninh,Bác Ninh City,8,125,117,8,1
2022-07-08,Bac Ninh,Bác Ninh City,9,115,105,10,1
2022-07-08,Bac Ninh,Bác Ninh City,10,146,133,13,4
2022-07-08,Bac Ninh,Bác Ninh City,11,399,321,78,44
2022-07-08,Bac Ninh,Bác Ninh City,12,201,190,11,1
2022-07-08,Bac Ninh,Bác Ninh City,13,144,136,8,0
2022-07-08,Bac Ninh,Bác Ninh City,14,138,121,17,1
2022-07-08,Bac Ninh,Bác Ninh City,15,138,129,9,1
2022-07-08,Bac Ninh,Bác Ninh City,16,134,114,20,2
2022-07-08,Bac Ninh,Bác Ninh City,17,128,119,9,0
2022-07-08,Bac Ninh,Bác Ninh City,18,174,164,10,1
2022-07-08,Bac Ninh,Bác Ninh City,19,181,154,27,1
2022-07-08,Bac Ninh,Bác Ninh City,20,176,150,26,8
2022-07-08,Bac Ninh,Bác Ninh City,21,100,77,23,10
2022-07-08,Bac Ninh,Bác Ninh City,22,2,0,2,0
2022-07-08,Bac Ninh,Que Vo,8,1,1,0,0
2022-07-08,Bac Ninh,Que Vo,10,1,1,0,0
2022-07-08,Bac Ninh,Que Vo,14,2,2,0,0
2022-07-08,Bac Ninh,Que Vo,16,1,1,0,0
2022-07-08,Bac Ninh,Que Vo,18,3,1,2,1
2022-07-08,Bac Ninh,Que Vo,20,1,1,0,0
2022-07-08,Bac Ninh,Que Vo,21,1,1,0,0
2022-07-08,Bac Ninh,Tien Du,11,2,0,2,1
2022-07-08,Bac Ninh,Tien Du,12,2,0,2,0
2022-07-08,Bac Ninh,Tien Du,13,4,0,4,2
2022-07-08,Bac Ninh,Tien Du,15,5,0,5,4
2022-07-08,Bac Ninh,Tien Du,16,1,0,1,1
2022-07-08,Bac Ninh,Tien Du,17,6,0,6,6
2022-07-08,Bac Ninh,Tien Du,18,2,0,2,2
2022-07-08,Bac Ninh,Tien Du,19,2,0,2,1
2022-07-08,Bac Ninh,Tien Du,20,1,0,1,1
2022-07-08,Bac Ninh,Tien Du,21,1,0,1,1
2022-07-08,Bac Ninh,Tu Son,8,1,0,1,1
2022-07-08,Bac Ninh,Tu Son,10,3,0,3,3
2022-07-08,Bac Ninh,Tu Son,11,5,0,5,3
2022-07-08,Bac Ninh,Tu Son,12,1,0,1,1
2022-07-08,Bac Ninh,Tu Son,14,2,1,1,0
2022-07-08,Bac Ninh,Tu Son,16,1,0,1,1
2022-07-08,Bac Ninh,Tu Son,17,1,0,1,1
2022-07-08,Bac Ninh,Tu Son,18,3,0,3,3
2022-07-08,Bac Ninh,Tu Son,19,1,0,1,0
2022-07-08,Bac Ninh,Yen Phong,18,1,0,1,1
2022-07-08,Binh Duong,Ben Cat,7,2,0,2,2
2022-07-08,Binh Duong,Ben Cat,8,3,0,3,3
2022-07-08,Binh Duong,Ben Cat,9,1,0,1,1
2022-07-08,Binh Duong,Ben Cat,10,6,0,6,6
2022-07-08,Binh Duong,Ben Cat,11,3,0,3,3
2022-07-08,Binh Duong,Ben Cat,12,1,0,1,1
2022-07-08,Binh Duong,Ben Cat,15,1,0,1,0
2022-07-08,Binh Duong,Ben Cat,16,2,0,2,1
2022-07-08,Binh Duong,Ben Cat,17,1,1,0,0
2022-07-08,Binh Duong,Ben Cat,19,2,1,1,1
2022-07-08,Binh Duong,Ben Cat,20,1,0,1,1
2022-07-08,Binh Duong,Di An,6,1,0,1,1
2022-07-08,Binh Duong,Di An,7,5,1,4,4
2022-07-08,Binh Duong,Di An,8,17,7,10,8
2022-07-08,Binh Duong,Di An,9,29,17,12,10
2022-07-08,Binh Duong,Di An,10,34,21,13,7
2022-07-08,Binh Duong,Di An,11,47,38,9,3
2022-07-08,Binh Duong,Di An,12,41,29,12,3
2022-07-08,Binh Duong,Di An,13,37,31,6,2
2022-07-08,Binh Duong,Di An,14,28,21,7,5
2022-07-08,Binh Duong,Di An,15,38,23,15,9
2022-07-08,Binh Duong,Di An,16,35,28,7,5
2022-07-08,Binh Duong,Di An,17,36,26,10,6
2022-07-08,Binh Duong,Di An,18,24,17,7,2
2022-07-08,Binh Duong,Di An,19,35,21,14,6
2022-07-08,Binh Duong,Di An,20,36,17,19,16
2022-07-08,Binh Duong,Di An,21,26,7,19,15
2022-07-08,Binh Duong,Di An,22,3,0,3,0
2022-07-08,Binh Duong,Tan Uyen,8,2,1,1,1
2022-07-08,Binh Duong,Tan Uyen,9,2,2,0,0
2022-07-08,Binh Duong,Tan Uyen,10,3,1,2,2
2022-07-08,Binh Duong,Tan Uyen,11,2,0,2,1
2022-07-08,Binh Duong,Tan Uyen,12,2,2,0,0
2022-07-08,Binh Duong,Tan Uyen,13,5,3,2,2
2022-07-08,Binh Duong,Tan Uyen,14,2,1,1,1
2022-07-08,Binh Duong,Tan Uyen,16,3,1,2,1
2022-07-08,Binh Duong,Tan Uyen,18,4,1,3,1
2022-07-08,Binh Duong,Tan Uyen,19,7,3,4,4
2022-07-08,Binh Duong,Tan Uyen,20,3,1,2,2
2022-07-08,Binh Duong,Thu Dau Mot Town,0,2,1,1,0
2022-07-08,Binh Duong,Thu Dau Mot Town,1,1,1,0,0
2022-07-08,Binh Duong,Thu Dau Mot Town,2,3,2,1,0
2022-07-08,Binh Duong,Thu Dau Mot Town,3,1,1,0,0
2022-07-08,Binh Duong,Thu Dau Mot Town,6,36,30,6,5
2022-07-08,Binh Duong,Thu Dau Mot Town,7,101,97,4,0
2022-07-08,Binh Duong,Thu Dau Mot Town,8,211,198,13,2
2022-07-08,Binh Duong,Thu Dau Mot Town,9,270,247,23,3
2022-07-08,Binh Duong,Thu Dau Mot Town,10,446,416,30,10
2022-07-08,Binh Duong,Thu Dau Mot Town,11,688,610,78,27
2022-07-08,Binh Duong,Thu Dau Mot Town,12,501,466,35,9
2022-07-08,Binh Duong,Thu Dau Mot Town,13,494,450,44,10
2022-07-08,Binh Duong,Thu Dau Mot Town,14,364,338,26,5
2022-07-08,Binh Duong,Thu Dau Mot Town,15,297,270,27,6
2022-07-08,Binh Duong,Thu Dau Mot Town,16,315,298,17,2
2022-07-08,Binh Duong,Thu Dau Mot Town,17,319,294,25,8
2022-07-08,Binh Duong,Thu Dau Mot Town,18,386,356,30,4
2022-07-08,Binh Duong,Thu Dau Mot Town,19,497,403,94,45
2022-07-08,Binh Duong,Thu Dau Mot Town,20,332,281,51,14
2022-07-08,Binh Duong,Thu Dau Mot Town,21,210,160,50,9
2022-07-08,Binh Duong,Thu Dau Mot Town,22,3,0,3,0
2022-07-08,Binh Duong,Thu Dau Mot Town,23,2,0,2,0
2022-07-08,Binh Duong,Thuan An,4,1,0,1,0
2022-07-08,Binh Duong,Thuan An,5,2,0,2,1
2022-07-08,Binh Duong,Thuan An,6,3,0,3,3
2022-07-08,Binh Duong,Thuan An,7,14,8,6,3
2022-07-08,Binh Duong,Thuan An,8,38,22,16,12
2022-07-08,Binh Duong,Thuan An,9,36,30,6,3
2022-07-08,Binh Duong,Thuan An,10,63,49,14,9
2022-07-08,Binh Duong,Thuan An,11,101,81,20,7
2022-07-08,Binh Duong,Thuan An,12,100,83,17,8
2022-07-08,Binh Duong,Thuan An,13,79,67,12,6
2022-07-08,Binh Duong,Thuan An,14,77,64,13,5
2022-07-08,Binh Duong,Thuan An,15,59,48,11,8
2022-07-08,Binh Duong,Thuan An,16,51,43,8,4
2022-07-08,Binh Duong,Thuan An,17,45,41,4,1
2022-07-08,Binh Duong,Thuan An,18,40,34,6,1
2022-07-08,Binh Duong,Thuan An,19,66,49,17,9
2022-07-08,Binh Duong,Thuan An,20,54,33,21,15
2022-07-08,Binh Duong,Thuan An,21,31,13,18,9
2022-07-08,Binh Duong,Thuan An,22,4,0,4,1
2022-07-08,Binh Duong,Thuan An,23,1,1,0,0
2022-07-08,Can Tho City,Binh Thuy District,7,1,0,1,0
2022-07-08,Can Tho City,Binh Thuy District,8,7,6,1,0
2022-07-08,Can Tho City,Binh Thuy District,9,3,3,0,0
2022-07-08,Can Tho City,Binh Thuy District,10,6,5,1,0
2022-07-08,Can Tho City,Binh Thuy District,11,11,11,0,0
2022-07-08,Can Tho City,Binh Thuy District,12,12,10,2,1
2022-07-08,Can Tho City,Binh Thuy District,13,14,11,3,0
2022-07-08,Can Tho City,Binh Thuy District,14,14,14,0,0
2022-07-08,Can Tho City,Binh Thuy District,15,8,8,0,0
2022-07-08,Can Tho City,Binh Thuy District,16,9,8,1,0
2022-07-08,Can Tho City,Binh Thuy District,17,11,9,2,0
2022-07-08,Can Tho City,Binh Thuy District,18,10,8,2,1
2022-07-08,Can Tho City,Binh Thuy District,19,13,6,7,0
2022-07-08,Can Tho City,Binh Thuy District,20,10,10,0,0
2022-07-08,Can Tho City,Binh Thuy District,21,7,1,6,4
2022-07-08,Can Tho City,Cai Rang District,2,1,0,1,0
2022-07-08,Can Tho City,Cai Rang District,6,3,3,0,0
2022-07-08,Can Tho City,Cai Rang District,7,9,3,6,1
2022-07-08,Can Tho City,Cai Rang District,8,6,4,2,0
2022-07-08,Can Tho City,Cai Rang District,9,8,4,4,0
2022-07-08,Can Tho City,Cai Rang District,10,8,8,0,0
2022-07-08,Can Tho City,Cai Rang District,11,17,16,1,0
2022-07-08,Can Tho City,Cai Rang District,12,13,12,1,1
2022-07-08,Can Tho City,Cai Rang District,13,8,7,1,0
2022-07-08,Can Tho City,Cai Rang District,14,7,7,0,0
2022-07-08,Can Tho City,Cai Rang District,15,11,11,0,0
2022-07-08,Can Tho City,Cai Rang District,16,10,10,0,0
2022-07-08,Can Tho City,Cai Rang District,17,12,10,2,1
2022-07-08,Can Tho City,Cai Rang District,18,14,10,4,0
2022-07-08,Can Tho City,Cai Rang District,19,19,18,1,0
2022-07-08,Can Tho City,Cai Rang District,20,5,3,2,0
2022-07-08,Can Tho City,Cai Rang District,21,2,1,1,0
2022-07-08,Can Tho City,Cai Rang District,22,1,1,0,0
2022-07-08,Can Tho City,Ninh Kieu District,0,2,1,1,0
2022-07-08,Can Tho City,Ninh Kieu District,3,2,2,0,0
2022-07-08,Can Tho City,Ninh Kieu District,5,4,2,2,1
2022-07-08,Can Tho City,Ninh Kieu District,6,48,44,4,2
2022-07-08,Can Tho City,Ninh Kieu District,7,125,114,11,0
2022-07-08,Can Tho City,Ninh Kieu District,8,198,189,9,0
2022-07-08,Can Tho City,Ninh Kieu District,9,270,245,25,0
2022-07-08,Can Tho City,Ninh Kieu District,10,455,433,22,0
2022-07-08,Can Tho City,Ninh Kieu District,11,828,758,70,20
2022-07-08,Can Tho City,Ninh Kieu District,12,610,574,36,2
2022-07-08,Can Tho City,Ninh Kieu District,13,470,453,17,0
2022-07-08,Can Tho City,Ninh Kieu District,14,398,379,19,0
2022-07-08,Can Tho City,Ninh Kieu District,15,333,327,6,0
2022-07-08,Can Tho City,Ninh Kieu District,16,417,396,21,0
2022-07-08,Can Tho City,Ninh Kieu District,17,475,451,24,0
2022-07-08,Can Tho City,Ninh Kieu District,18,479,456,23,0
2022-07-08,Can Tho City,Ninh Kieu District,19,470,438,32,0
2022-07-08,Can Tho City,Ninh Kieu District,20,358,335,23,0
2022-07-08,Can Tho City,Ninh Kieu District,21,205,191,14,0
2022-07-08,Can Tho City,Ninh Kieu District,22,3,2,1,0
2022-07-08,Can Tho City,Ninh Kieu District,23,2,2,0,0
2022-07-08,Dong Nai,Bien Hoa City,0,1,1,0,0
2022-07-08,Dong Nai,Bien Hoa City,1,2,1,1,0
2022-07-08,Dong Nai,Bien Hoa City,2,2,0,2,0
2022-07-08,Dong Nai,Bien Hoa City,5,1,1,0,0
2022-07-08,Dong Nai,Bien Hoa City,6,37,29,8,5
2022-07-08,Dong Nai,Bien Hoa City,7,135,117,18,4
2022-07-08,Dong Nai,Bien Hoa City,8,339,303,36,7
2022-07-08,Dong Nai,Bien Hoa City,9,456,419,37,9
2022-07-08,Dong Nai,Bien Hoa City,10,789,711,78,13
2022-07-08,Dong Nai,Bien Hoa City,11,1283,1164,119,38
2022-07-08,Dong Nai,Bien Hoa City,12,936,877,59,9
2022-07-08,Dong Nai,Bien Hoa City,13,905,846,59,10
2022-07-08,Dong Nai,Bien Hoa City,14,680,632,48,9
2022-07-08,Dong Nai,Bien Hoa City,15,539,489,50,3
2022-07-08,Dong Nai,Bien Hoa City,16,569,528,41,7
2022-07-08,Dong Nai,Bien Hoa City,17,606,565,41,6
2022-07-08,Dong Nai,Bien Hoa City,18,755,709,46,3
2022-07-08,Dong Nai,Bien Hoa City,19,749,661,88,22
2022-07-08,Dong Nai,Bien Hoa City,20,603,466,137,68
2022-07-08,Dong Nai,Bien Hoa City,21,342,209,133,78
2022-07-08,Dong Nai,Bien Hoa City,22,12,5,7,0
2022-07-08,Dong Nai,Long Khanh,7,2,0,2,1
2022-07-08,Dong Nai,Long Khanh,10,1,0,1,1
2022-07-08,Dong Nai,Long Khanh,13,2,0,2,2
2022-07-08,Dong Nai,Long Khanh,15,1,0,1,1
2022-07-08,Dong Nai,Long Khanh,16,1,0,1,0
2022-07-08,Dong Nai,Long Khanh,17,1,0,1,1
2022-07-08,Dong Nai,Long Khanh,20,2,0,2,2
2022-07-08,Dong Nai,Long Khanh,23,1,0,1,1
2022-07-08,Dong Nai,Long Thanh,11,3,0,3,2
2022-07-08,Dong Nai,Long Thanh,12,1,0,1,0
2022-07-08,Dong Nai,Long Thanh,13,4,1,3,3
2022-07-08,Dong Nai,Long Thanh,14,2,1,1,1
2022-07-08,Dong Nai,Long Thanh,16,1,0,1,1
2022-07-08,Dong Nai,Long Thanh,19,1,0,1,1
2022-07-08,Dong Nai,Nhon trach,17,2,0,2,2
2022-07-08,Dong Nai,Nhon trach,20,1,0,1,1
2022-07-08,Dong Nai,Trang Bom,11,2,0,2,2
2022-07-08,Dong Nai,Trang Bom,16,1,1,0,0
2022-07-08,Dong Nai,Trang Bom,19,1,0,1,1
2022-07-08,Hai Phong City,An Duong,8,2,0,2,2
2022-07-08,Hai Phong City,An Duong,9,5,1,4,4
2022-07-08,Hai Phong City,An Duong,10,3,1,2,2
2022-07-08,Hai Phong City,An Duong,11,3,2,1,1
2022-07-08,Hai Phong City,An Duong,12,1,1,0,0
2022-07-08,Hai Phong City,An Duong,13,1,0,1,1
2022-07-08,Hai Phong City,An Duong,14,3,0,3,3
2022-07-08,Hai Phong City,An Duong,16,5,3,2,2
2022-07-08,Hai Phong City,An Duong,17,2,0,2,2
2022-07-08,Hai Phong City,An Duong,18,6,4,2,0
2022-07-08,Hai Phong City,An Duong,19,1,1,0,0
2022-07-08,Hai Phong City,An Duong,20,8,2,6,5
2022-07-08,Hai Phong City,An Duong,21,3,0,3,2
2022-07-08,Hai Phong City,Do Son District,9,2,0,2,2
2022-07-08,Hai Phong City,Do Son District,16,2,0,2,2
2022-07-08,Hai Phong City,Duong Kinh District,12,1,0,1,1
2022-07-08,Hai Phong City,Hai An District,7,8,5,3,3
2022-07-08,Hai Phong City,Hai An District,8,10,7,3,2
2022-07-08,Hai Phong City,Hai An District,9,9,7,2,0
2022-07-08,Hai Phong City,Hai An District,10,30,27,3,0
2022-07-08,Hai Phong City,Hai An District,11,52,41,11,7
2022-07-08,Hai Phong City,Hai An District,12,25,23,2,0
2022-07-08,Hai Phong City,Hai An District,13,16,14,2,1
2022-07-08,Hai Phong City,Hai An District,14,13,9,4,1
2022-07-08,Hai Phong City,Hai An District,15,19,13,6,0
2022-07-08,Hai Phong City,Hai An District,16,21,17,4,1
2022-07-08,Hai Phong City,Hai An District,17,18,14,4,0
2022-07-08,Hai Phong City,Hai An District,18,25,21,4,1
2022-07-08,Hai Phong City,Hai An District,19,18,12,6,4
2022-07-08,Hai Phong City,Hai An District,20,12,10,2,1
2022-07-08,Hai Phong City,Hai An District,21,7,5,2,1
2022-07-08,Hai Phong City,Hai An District,22,1,0,1,0
2022-07-08,Hai Phong City,Hong Bang District,6,1,0,1,1
2022-07-08,Hai Phong City,Hong Bang District,7,14,6,8,4
2022-07-08,Hai Phong City,Hong Bang District,8,24,22,2,1
2022-07-08,Hai Phong City,Hong Bang District,9,36,29,7,2
2022-07-08,Hai Phong City,Hong Bang District,10,59,52,7,3
2022-07-08,Hai Phong City,Hong Bang District,11,120,101,19,11
2022-07-08,Hai Phong City,Hong Bang District,12,54,45,9,1
2022-07-08,Hai Phong City,Hong Bang District,13,44,42,2,0
2022-07-08,Hai Phong City,Hong Bang District,14,33,28,5,2
2022-07-08,Hai Phong City,Hong Bang District,15,58,50,8,3
2022-07-08,Hai Phong City,Hong Bang District,16,36,35,1,1
2022-07-08,Hai Phong City,Hong Bang District,17,48,40,8,2
2022-07-08,Hai Phong City,Hong Bang District,18,66,48,18,9
2022-07-08,Hai Phong City,Hong Bang District,19,73,63,10,2
2022-07-08,Hai Phong City,Hong Bang District,20,45,35,10,2
2022-07-08,Hai Phong City,Hong Bang District,21,13,4,9,6
2022-07-08,Hai Phong City,Kien An District,4,1,1,0,0
2022-07-08,Hai Phong City,Kien An District,7,1,0,1,1
2022-07-08,Hai Phong City,Kien An District,8,2,2,0,0
2022-07-08,Hai Phong City,Kien An District,9,13,4,9,2
2022-07-08,Hai Phong City,Kien An District,10,7,5,2,1
2022-07-08,Hai Phong City,Kien An District,11,8,7,1,1
2022-07-08,Hai Phong City,Kien An District,12,8,5,3,1
2022-07-08,Hai Phong City,Kien An District,13,10,5,5,1
2022-07-08,Hai Phong City,Kien An District,14,10,5,5,2
2022-07-08,Hai Phong City,Kien An District,15,11,8,3,3
2022-07-08,Hai Phong City,Kien An District,16,8,7,1,0
2022-07-08,Hai Phong City,Kien An District,17,10,7,3,2
2022-07-08,Hai Phong City,Kien An District,18,10,8,2,0
2022-07-08,Hai Phong City,Kien An District,19,8,4,4,4
2022-07-08,Hai Phong City,Kien An District,20,16,7,9,7
2022-07-08,Hai Phong City,Kien An District,21,8,0,8,6
2022-07-08,Hai Phong City,Le Chan District,1,1,1,0,0
2022-07-08,Hai Phong City,Le Chan District,3,1,0,1,1
2022-07-08,Hai Phong City,Le Chan District,6,2,0,2,1
2022-07-08,Hai Phong City,Le Chan District,7,40,20,20,17
2022-07-08,Hai Phong City,Le Chan District,8,70,63,7,4
2022-07-08,Hai Phong City,Le Chan District,9,73,63,10,1
2022-07-08,Hai Phong City,Le Chan District,10,181,157,24,5
2022-07-08,Hai Phong City,Le Chan District,11,358,308,50,23
2022-07-08,Hai Phong City,Le Chan District,12,225,208,17,5
2022-07-08,Hai Phong City,Le Chan District,13,139,111,28,4
2022-07-08,Hai Phong City,Le Chan District,14,146,130,16,2
2022-07-08,Hai Phong City,Le Chan District,15,170,151,19,4
2022-07-08,Hai Phong City,Le Chan District,16,158,141,17,3
2022-07-08,Hai Phong City,Le Chan District,17,199,178,21,4
2022-07-08,Hai Phong City,Le Chan District,18,239,210,29,8
2022-07-08,Hai Phong City,Le Chan District,19,205,178,27,11
2022-07-08,Hai Phong City,Le Chan District,20,145,110,35,13
2022-07-08,Hai Phong City,Le Chan District,21,73,57,16,3
2022-07-08,Hai Phong City,Le Chan District,23,2,0,2,1
2022-07-08,Hai Phong City,Ngo Quyen District,0,1,1,0,0
2022-07-08,Hai Phong City,Ngo Quyen District,1,1,1,0,0
2022-07-08,Hai Phong City,Ngo Quyen District,5,1,1,0,0
2022-07-08,Hai Phong City,Ngo Quyen District,6,3,0,3,2
2022-07-08,Hai Phong City,Ngo Quyen District,7,26,14,12,9
2022-07-08,Hai Phong City,Ngo Quyen District,8,62,54,8,2
2022-07-08,Hai Phong City,Ngo Quyen District,9,81,74,7,2
2022-07-08,Hai Phong City,Ngo Quyen District,10,148,128,20,2
2022-07-08,Hai Phong City,Ngo Quyen District,11,275,229,46,14
2022-07-08,Hai Phong City,Ngo Quyen District,12,166,146,20,4
2022-07-08,Hai Phong City,Ngo Quyen District,13,101,91,10,2
2022-07-08,Hai Phong City,Ngo Quyen District,14,141,125,16,3
2022-07-08,Hai Phong City,Ngo Quyen District,15,153,139,14,2
2022-07-08,Hai Phong City,Ngo Quyen District,16,137,116,21,3
2022-07-08,Hai Phong City,Ngo Quyen District,17,122,102,20,3
2022-07-08,Hai Phong City,Ngo Quyen District,18,190,161,29,5
2022-07-08,Hai Phong City,Ngo Quyen District,19,189,143,46,18
2022-07-08,Hai Phong City,Ngo Quyen District,20,120,98,22,8
2022-07-08,Hai Phong City,Ngo Quyen District,21,80,63,17,5
2022-07-08,Hai Phong City,Ngo Quyen District,23,3,1,2,1
2022-07-08,Hai Phong City,Thuy Nguyen,9,4,0,4,4
2022-07-08,Hai Phong City,Thuy Nguyen,10,1,0,1,1
2022-07-08,Hai Phong City,Thuy Nguyen,11,2,0,2,2
2022-07-08,Hai Phong City,Thuy Nguyen,12,1,0,1,1
2022-07-08,Hai Phong City,Thuy Nguyen,14,1,0,1,1
2022-07-08,Hai Phong City,Thuy Nguyen,15,1,0,1,1
2022-07-08,Hai Phong City,Thuy Nguyen,17,2,0,2,2
2022-07-08,Hai Phong City,Thuy Nguyen,18,2,0,2,1
2022-07-08,Hai Phong City,Thuy Nguyen,21,1,0,1,0
2022-07-08,Hue City,Hue City,0,3,1,2,0
2022-07-08,Hue City,Hue City,2,1,1,0,0
2022-07-08,Hue City,Hue City,5,2,2,0,0
2022-07-08,Hue City,Hue City,6,75,69,6,2
2022-07-08,Hue City,Hue City,7,231,213,18,1
2022-07-08,Hue City,Hue City,8,316,292,24,0
2022-07-08,Hue City,Hue City,9,271,258,13,1
2022-07-08,Hue City,Hue City,10,460,433,27,0
2022-07-08,Hue City,Hue City,11,1041,908,133,30
2022-07-08,Hue City,Hue City,12,618,574,44,0
2022-07-08,Hue City,Hue City,13,385,351,34,0
2022-07-08,Hue City,Hue City,14,381,354,27,1
2022-07-08,Hue City,Hue City,15,432,401,31,0
2022-07-08,Hue City,Hue City,16,408,377,31,1
2022-07-08,Hue City,Hue City,17,512,467,45,0
2022-07-08,Hue City,Hue City,18,613,555,58,2
2022-07-08,Hue City,Hue City,19,590,543,47,2
2022-07-08,Hue City,Hue City,20,491,424,67,10
2022-07-08,Hue City,Hue City,21,263,215,48,10
2022-07-08,Hue City,Hue City,22,6,2,4,1
2022-07-08,Hue City,Hue City,23,4,1,3,0
2022-07-08,Hue City,Huong Thuy,7,1,1,0,0
2022-07-08,Hue City,Huong Thuy,9,2,2,0,0
2022-07-08,Hue City,Huong Thuy,10,5,4,1,0
2022-07-08,Hue City,Huong Thuy,11,1,1,0,0
2022-07-08,Hue City,Huong Thuy,14,4,2,2,1
2022-07-08,Hue City,Huong Thuy,15,1,1,0,0
2022-07-08,Hue City,Huong Thuy,16,1,1,0,0
2022-07-08,Hue City,Huong Thuy,17,2,1,1,0
2022-07-08,Hue City,Huong Thuy,18,3,3,0,0
2022-07-08,Hue City,Huong Thuy,19,4,3,1,0
2022-07-08,Hue City,Huong Thuy,20,1,0,1,0
2022-07-08,Hue City,Huong Thuy,21,2,0,2,2
2022-07-08,Hue City,Huong Tra,12,1,1,0,0
2022-07-08,Hue City,Phu Vang,7,1,1,0,0
2022-07-08,Hue City,Phu Vang,8,1,1,0,0
2022-07-08,Hue City,Phu Vang,9,3,2,1,1
2022-07-08,Hue City,Phu Vang,10,3,2,1,1
2022-07-08,Hue City,Phu Vang,11,2,2,0,0
2022-07-08,Hue City,Phu Vang,12,2,1,1,0
2022-07-08,Hue City,Phu Vang,13,1,1,0,0
2022-07-08,Hue City,Phu Vang,15,4,3,1,0
2022-07-08,Hue City,Phu Vang,16,1,1,0,0
2022-07-08,Hue City,Phu Vang,17,5,2,3,2
2022-07-08,Hue City,Phu Vang,18,5,3,2,1
2022-07-08,Hue City,Phu Vang,19,2,0,2,2
2022-07-08,Khanh Hoa,Cam Ranh City,11,1,0,1,1
2022-07-08,Khanh Hoa,Dien Khanh,6,1,0,1,1
2022-07-08,Khanh Hoa,Dien Khanh,12,1,0,1,0
2022-07-08,Khanh Hoa,Dien Khanh,14,1,0,1,1
2022-07-08,Khanh Hoa,Nha Trang City,0,2,2,0,0
2022-07-08,Khanh Hoa,Nha Trang City,1,1,0,1,0
2022-07-08,Khanh Hoa,Nha Trang City,3,2,1,1,0
2022-07-08,Khanh Hoa,Nha Trang City,5,1,1,0,0
2022-07-08,Khanh Hoa,Nha Trang City,6,34,33,1,0
2022-07-08,Khanh Hoa,Nha Trang City,7,135,128,7,0
2022-07-08,Khanh Hoa,Nha Trang City,8,248,231,17,2
2022-07-08,Khanh Hoa,Nha Trang City,9,201,184,17,0
2022-07-08,Khanh Hoa,Nha Trang City,10,301,283,18,1
2022-07-08,Khanh Hoa,Nha Trang City,11,354,327,27,2
2022-07-08,Khanh Hoa,Nha Trang City,12,292,274,18,0
2022-07-08,Khanh Hoa,Nha Trang City,13,269,256,13,0
2022-07-08,Khanh Hoa,Nha Trang City,14,257,237,20,1
2022-07-08,Khanh Hoa,Nha Trang City,15,217,204,13,2
2022-07-08,Khanh Hoa,Nha Trang City,16,256,243,13,2
2022-07-08,Khanh Hoa,Nha Trang City,17,267,256,11,0
2022-07-08,Khanh Hoa,Nha Trang City,18,315,292,23,0
2022-07-08,Khanh Hoa,Nha Trang City,19,251,230,21,2
2022-07-08,Khanh Hoa,Nha Trang City,20,218,185,33,2
2022-07-08,Khanh Hoa,Nha Trang City,21,148,114,34,7
2022-07-08,Khanh Hoa,Nha Trang City,22,5,0,5,0
2022-07-08,Khanh Hoa,Nha Trang City,23,1,1,0,0
2022-07-08,Lam Dong,Da Lat City,0,2,2,0,0
2022-07-08,Lam Dong,Da Lat City,5,1,0,1,0
2022-07-08,Lam Dong,Da Lat City,6,3,2,1,0
2022-07-08,Lam Dong,Da Lat City,7,56,36,20,11
2022-07-08,Lam Dong,Da Lat City,8,92,66,26,19
2022-07-08,Lam Dong,Da Lat City,9,84,75,9,5
2022-07-08,Lam Dong,Da Lat City,10,107,94,13,4
2022-07-08,Lam Dong,Da Lat City,11,167,134,33,25
2022-07-08,Lam Dong,Da Lat City,12,125,112,13,8
2022-07-08,Lam Dong,Da Lat City,13,125,99,26,7
2022-07-08,Lam Dong,Da Lat City,14,128,105,23,16
2022-07-08,Lam Dong,Da Lat City,15,126,94,32,11
2022-07-08,Lam Dong,Da Lat City,16,103,80,23,13
2022-07-08,Lam Dong,Da Lat City,17,128,93,35,22
2022-07-08,Lam Dong,Da Lat City,18,165,127,38,23
2022-07-08,Lam Dong,Da Lat City,19,140,89,51,33
2022-07-08,Lam Dong,Da Lat City,20,131,78,53,35
2022-07-08,Lam Dong,Da Lat City,21,91,52,39,32
2022-07-08,Lam Dong,Da Lat City,22,4,1,3,1
2022-07-08,Nghe An,Vinh City,0,1,0,1,0
2022-07-08,Nghe An,Vinh City,6,8,5,3,2
2022-07-08,Nghe An,Vinh City,7,114,96,18,8
2022-07-08,Nghe An,Vinh City,8,154,135,19,4
2022-07-08,Nghe An,Vinh City,9,138,114,24,3
2022-07-08,Nghe An,Vinh City,10,215,175,40,20
2022-07-08,Nghe An,Vinh City,11,380,314,66,36
2022-07-08,Nghe An,Vinh City,12,219,180,39,13
2022-07-08,Nghe An,Vinh City,13,149,121,28,5
2022-07-08,Nghe An,Vinh City,14,175,141,34,16
2022-07-08,Nghe An,Vinh City,15,217,162,55,16
2022-07-08,Nghe An,Vinh City,16,160,125,35,10
2022-07-08,Nghe An,Vinh City,17,197,148,49,21
2022-07-08,Nghe An,Vinh City,18,206,169,37,14
2022-07-08,Nghe An,Vinh City,19,196,148,48,13
2022-07-08,Nghe An,Vinh City,20,152,114,38,11
2022-07-08,Nghe An,Vinh City,21,87,63,24,12
2022-07-08,Nghe An,Vinh City,22,3,0,3,0
2022-07-08,Nghe An,Vinh City,23,2,1,1,0
2022-07-08,Quang Nam,Hoi An City,6,1,0,1,0
2022-07-08,Quang Nam,Hoi An City,7,11,8,3,1
2022-07-08,Quang Nam,Hoi An City,8,20,16,4,1
2022-07-08,Quang Nam,Hoi An City,9,21,19,2,0
2022-07-08,Quang Nam,Hoi An City,10,44,31,13,1
2022-07-08,Quang Nam,Hoi An City,11,57,45,12,8
2022-07-08,Quang Nam,Hoi An City,12,41,32,9,5
2022-07-08,Quang Nam,Hoi An City,13,32,28,4,2
2022-07-08,Quang Nam,Hoi An City,14,23,19,4,1
2022-07-08,Quang Nam,Hoi An City,15,34,24,10,2
2022-07-08,Quang Nam,Hoi An City,16,52,44,8,2
2022-07-08,Quang Nam,Hoi An City,17,33,29,4,0
2022-07-08,Quang Nam,Hoi An City,18,48,38,10,2
2022-07-08,Quang Nam,Hoi An City,19,69,49,20,11
2022-07-08,Quang Nam,Hoi An City,20,59,28,31,25
2022-07-08,Quang Nam,Hoi An City,21,38,13,25,18
2022-07-08,Quang Nam,Hoi An City,23,1,0,1,0
2022-07-08,Quang Nam,Tam Ky City,12,1,0,1,1
2022-07-08,Quang Ninh,Cam Pha City,8,1,0,1,0
2022-07-08,Quang Ninh,Cam Pha City,10,3,0,3,3
2022-07-08,Quang Ninh,Cam Pha City,11,3,0,3,2
2022-07-08,Quang Ninh,Cam Pha City,12,2,0,2,1
2022-07-08,Quang Ninh,Cam Pha City,13,2,0,2,2
2022-07-08,Quang Ninh,Cam Pha City,16,1,0,1,1
2022-07-08,Quang Ninh,Cam Pha City,19,2,0,2,2
2022-07-08,Quang Ninh,Cam Pha City,21,1,0,1,1
2022-07-08,Quang Ninh,Ha Long City,0,1,1,0,0
2022-07-08,Quang Ninh,Ha Long City,1,2,0,2,1
2022-07-08,Quang Ninh,Ha Long City,2,2,0,2,0
2022-07-08,Quang Ninh,Ha Long City,7,19,8,11,10
2022-07-08,Quang Ninh,Ha Long City,8,43,32,11,8
2022-07-08,Quang Ninh,Ha Long City,9,41,27,14,8
2022-07-08,Quang Ninh,Ha Long City,10,63,46,17,6
2022-07-08,Quang Ninh,Ha Long City,11,144,104,40,22
2022-07-08,Quang Ninh,Ha Long City,12,99,64,35,19
2022-07-08,Quang Ninh,Ha Long City,13,48,35,13,7
2022-07-08,Quang Ninh,Ha Long City,14,65,49,16,6
2022-07-08,Quang Ninh,Ha Long City,15,55,39,16,8
2022-07-08,Quang Ninh,Ha Long City,16,55,41,14,5
2022-07-08,Quang Ninh,Ha Long City,17,77,55,22,8
2022-07-08,Quang Ninh,Ha Long City,18,64,52,12,2
2022-07-08,Quang Ninh,Ha Long City,19,74,47,27,9
2022-07-08,Quang Ninh,Ha Long City,20,64,40,24,13
2022-07-08,Quang Ninh,Ha Long City,21,1,0,1,0
2022-07-08,Quang Ninh,Uong Bi City,18,1,0,1,1
2022-07-08,Thai Nguyen,Dong Hy,11,1,0,1,1
2022-07-08,Thai Nguyen,Dong Hy,15,1,0,1,0
2022-07-08,Thai Nguyen,Dong Hy,16,1,1,0,0
2022-07-08,Thai Nguyen,Thai Nguyen City,0,6,4,2,0
2022-07-08,Thai Nguyen,Thai Nguyen City,6,4,3,1,0
2022-07-08,Thai Nguyen,Thai Nguyen City,7,106,92,14,1
2022-07-08,Thai Nguyen,Thai Nguyen City,8,149,140,9,0
2022-07-08,Thai Nguyen,Thai Nguyen City,9,146,126,20,1
2022-07-08,Thai Nguyen,Thai Nguyen City,10,184,168,16,0
2022-07-08,Thai Nguyen,Thai Nguyen City,11,396,367,29,1
2022-07-08,Thai Nguyen,Thai Nguyen City,12,250,232,18,2
2022-07-08,Thai Nguyen,Thai Nguyen City,13,146,137,9,1
2022-07-08,Thai Nguyen,Thai Nguyen City,14,148,135,13,0
2022-07-08,Thai Nguyen,Thai Nguyen City,15,130,118,12,1
2022-07-08,Thai Nguyen,Thai Nguyen City,16,130,121,9,1
2022-07-08,Thai Nguyen,Thai Nguyen City,17,139,123,16,0
2022-07-08,Thai Nguyen,Thai Nguyen City,18,220,206,14,0
2022-07-08,Thai Nguyen,Thai Nguyen City,19,252,235,17,0
2022-07-08,Thai Nguyen,Thai Nguyen City,20,211,186,25,1
2022-07-08,Thai Nguyen,Thai Nguyen City,21,131,112,19,1
2022-07-08,Thai Nguyen,Thai Nguyen City,22,2,0,2,0
2022-07-08,Thai Nguyen,Thai Nguyen City,23,2,1,1,0
2022-07-08,Vung Tau,Ba Ria City,7,1,0,1,1
2022-07-08,Vung Tau,Ba Ria City,8,6,2,4,3
2022-07-08,Vung Tau,Ba Ria City,9,16,6,10,9
2022-07-08,Vung Tau,Ba Ria City,10,9,5,4,4
2022-07-08,Vung Tau,Ba Ria City,11,10,5,5,5
2022-07-08,Vung Tau,Ba Ria City,12,10,5,5,4
2022-07-08,Vung Tau,Ba Ria City,13,6,5,1,1
2022-07-08,Vung Tau,Ba Ria City,14,2,0,2,2
2022-07-08,Vung Tau,Ba Ria City,15,6,2,4,3
2022-07-08,Vung Tau,Ba Ria City,16,7,0,7,7
2022-07-08,Vung Tau,Ba Ria City,17,17,0,17,10
2022-07-08,Vung Tau,Ba Ria City,18,7,3,4,3
2022-07-08,Vung Tau,Ba Ria City,19,9,0,9,7
2022-07-08,Vung Tau,Ba Ria City,20,7,0,7,7
2022-07-08,Vung Tau,Ba Ria City,21,2,0,2,2
2022-07-08,Vung Tau,Chau Duc,20,1,0,1,1
2022-07-08,Vung Tau,Vung Tau City,4,1,1,0,0
2022-07-08,Vung Tau,Vung Tau City,5,2,2,0,0
2022-07-08,Vung Tau,Vung Tau City,6,43,32,11,6
2022-07-08,Vung Tau,Vung Tau City,7,118,102,16,7
2022-07-08,Vung Tau,Vung Tau City,8,203,188,15,0
2022-07-08,Vung Tau,Vung Tau City,9,201,194,7,0
2022-07-08,Vung Tau,Vung Tau City,10,256,248,8,0
2022-07-08,Vung Tau,Vung Tau City,11,418,382,36,13
2022-07-08,Vung Tau,Vung Tau City,12,308,292,16,1
2022-07-08,Vung Tau,Vung Tau City,13,227,208,19,1
2022-07-08,Vung Tau,Vung Tau City,14,206,196,10,1
2022-07-08,Vung Tau,Vung Tau City,15,221,208,13,0
2022-07-08,Vung Tau,Vung Tau City,16,306,266,40,13
2022-07-08,Vung Tau,Vung Tau City,17,385,321,64,30
2022-07-08,Vung Tau,Vung Tau City,18,374,323,51,21
2022-07-08,Vung Tau,Vung Tau City,19,359,292,67,24
2022-07-08,Vung Tau,Vung Tau City,20,213,188,25,6
2022-07-08,Vung Tau,Vung Tau City,21,122,90,32,9
2022-07-08,Vung Tau,Vung Tau City,22,2,1,1,0
2022-07-09,Bac Ninh,Bác Ninh City,3,1,1,0,0
2022-07-09,Bac Ninh,Bác Ninh City,6,4,2,2,1
2022-07-09,Bac Ninh,Bác Ninh City,7,60,52,8,6
2022-07-09,Bac Ninh,Bác Ninh City,8,114,103,11,1
2022-07-09,Bac Ninh,Bác Ninh City,9,129,115,14,3
2022-07-09,Bac Ninh,Bác Ninh City,10,232,196,36,11
2022-07-09,Bac Ninh,Bác Ninh City,11,320,286,34,9
2022-07-09,Bac Ninh,Bác Ninh City,12,240,213,27,4
2022-07-09,Bac Ninh,Bác Ninh City,13,139,130,9,1
2022-07-09,Bac Ninh,Bác Ninh City,14,125,119,6,0
2022-07-09,Bac Ninh,Bác Ninh City,15,104,91,13,2
2022-07-09,Bac Ninh,Bác Ninh City,16,100,92,8,1
2022-07-09,Bac Ninh,Bác Ninh City,17,130,117,13,0
2022-07-09,Bac Ninh,Bác Ninh City,18,185,165,20,3
2022-07-09,Bac Ninh,Bác Ninh City,19,175,159,16,2
2022-07-09,Bac Ninh,Bác Ninh City,20,153,128,25,8
2022-07-09,Bac Ninh,Bác Ninh City,21,87,65,22,11
2022-07-09,Bac Ninh,Bác Ninh City,22,3,1,2,1
2022-07-09,Bac Ninh,Bác Ninh City,23,1,1,0,0
2022-07-09,Bac Ninh,Que Vo,8,5,0,5,4
2022-07-09,Bac Ninh,Que Vo,9,2,0,2,1
2022-07-09,Bac Ninh,Que Vo,10,1,1,0,0
2022-07-09,Bac Ninh,Que Vo,13,5,2,3,3
2022-07-09,Bac Ninh,Que Vo,14,5,2,3,2
2022-07-09,Bac Ninh,Que Vo,15,1,1,0,0
2022-07-09,Bac Ninh,Que Vo,21,1,0,1,1
2022-07-09,Bac Ninh,Tien Du,10,1,0,1,1
2022-07-09,Bac Ninh,Tien Du,13,2,0,2,1
2022-07-09,Bac Ninh,Tien Du,14,4,0,4,4
2022-07-09,Bac Ninh,Tien Du,15,2,0,2,2
2022-07-09,Bac Ninh,Tien Du,18,4,0,4,4
2022-07-09,Bac Ninh,Tien Du,19,1,0,1,1
2022-07-09,Bac Ninh,Tu Son,9,1,0,1,0
2022-07-09,Bac Ninh,Tu Son,10,1,0,1,1
2022-07-09,Bac Ninh,Tu Son,11,2,0,2,2
2022-07-09,Bac Ninh,Tu Son,12,1,0,1,1
2022-07-09,Bac Ninh,Tu Son,14,2,0,2,1
2022-07-09,Bac Ninh,Tu Son,15,1,0,1,1
2022-07-09,Bac Ninh,Tu Son,17,2,0,2,2
2022-07-09,Bac Ninh,Tu Son,18,3,0,3,2
2022-07-09,Bac Ninh,Tu Son,19,1,0,1,1
2022-07-09,Bac Ninh,Tu Son,20,2,0,2,1
2022-07-09,Binh Duong,Ben Cat,7,1,0,1,1
2022-07-09,Binh Duong,Ben Cat,9,3,0,3,3
2022-07-09,Binh Duong,Ben Cat,10,2,0,2,2
2022-07-09,Binh Duong,Ben Cat,11,2,0,2,2
2022-07-09,Binh Duong,Ben Cat,13,1,0,1,0
2022-07-09,Binh Duong,Ben Cat,15,1,0,1,1
2022-07-09,Binh Duong,Ben Cat,17,1,0,1,0
2022-07-09,Binh Duong,Ben Cat,18,1,0,1,1
2022-07-09,Binh Duong,Ben Cat,19,2,0,2,2
2022-07-09,Binh Duong,Ben Cat,20,4,0,4,4
2022-07-09,Binh Duong,Di An,0,1,1,0,0
2022-07-09,Binh Duong,Di An,6,3,0,3,1
2022-07-09,Binh Duong,Di An,7,4,0,4,3
2022-07-09,Binh Duong,Di An,8,17,8,9,8
2022-07-09,Binh Duong,Di An,9,20,13,7,4
2022-07-09,Binh Duong,Di An,10,42,26,16,9
2022-07-09,Binh Duong,Di An,11,51,38,13,10
2022-07-09,Binh Duong,Di An,12,37,31,6,1
2022-07-09,Binh Duong,Di An,13,38,33,5,1
2022-07-09,Binh Duong,Di An,14,30,28,2,1
2022-07-09,Binh Duong,Di An,15,33,22,11,7
2022-07-09,Binh Duong,Di An,16,40,26,14,7
2022-07-09,Binh Duong,Di An,17,39,28,11,7
2022-07-09,Binh Duong,Di An,18,45,33,12,11
2022-07-09,Binh Duong,Di An,19,59,31,28,19
2022-07-09,Binh Duong,Di An,20,53,24,29,23
2022-07-09,Binh Duong,Di An,21,34,15,19,15
2022-07-09,Binh Duong,Tan Uyen,7,1,0,1,1
2022-07-09,Binh Duong,Tan Uyen,9,4,1,3,2
2022-07-09,Binh Duong,Tan Uyen,10,3,2,1,0
2022-07-09,Binh Duong,Tan Uyen,11,4,4,0,0
2022-07-09,Binh Duong,Tan Uyen,12,1,0,1,0
2022-07-09,Binh Duong,Tan Uyen,13,6,3,3,1
2022-07-09,Binh Duong,Tan Uyen,14,1,1,0,0
2022-07-09,Binh Duong,Tan Uyen,15,3,3,0,0
2022-07-09,Binh Duong,Tan Uyen,17,2,2,0,0
2022-07-09,Binh Duong,Tan Uyen,18,2,1,1,1
2022-07-09,Binh Duong,Tan Uyen,20,6,2,4,3
2022-07-09,Binh Duong,Tan Uyen,21,1,0,1,1
2022-07-09,Binh Duong,Thu Dau Mot Town,0,2,0,2,0
2022-07-09,Binh Duong,Thu Dau Mot Town,1,2,2,0,0
2022-07-09,Binh Duong,Thu Dau Mot Town,2,1,1,0,0
2022-07-09,Binh Duong,Thu Dau Mot Town,3,2,0,2,0
2022-07-09,Binh Duong,Thu Dau Mot Town,5,2,2,0,0
2022-07-09,Binh Duong,Thu Dau Mot Town,6,38,26,12,7
2022-07-09,Binh Duong,Thu Dau Mot Town,7,116,106,10,1
2022-07-09,Binh Duong,Thu Dau Mot Town,8,234,216,18,2
2022-07-09,Binh Duong,Thu Dau Mot Town,9,307,284,23,3
2022-07-09,Binh Duong,Thu Dau Mot Town,10,416,388,28,7
2022-07-09,Binh Duong,Thu Dau Mot Town,11,620,576,44,14
2022-07-09,Binh Duong,Thu Dau Mot Town,12,558,522,36,9
2022-07-09,Binh Duong,Thu Dau Mot Town,13,430,390,40,10
2022-07-09,Binh Duong,Thu Dau Mot Town,14,393,362,31,11
2022-07-09,Binh Duong,Thu Dau Mot Town,15,325,311,14,3
2022-07-09,Binh Duong,Thu Dau Mot Town,16,335,312,23,4
2022-07-09,Binh Duong,Thu Dau Mot Town,17,423,390,33,3
2022-07-09,Binh Duong,Thu Dau Mot Town,18,442,403,39,12
2022-07-09,Binh Duong,Thu Dau Mot Town,19,401,358,43,11
2022-07-09,Binh Duong,Thu Dau Mot Town,20,289,249,40,16
2022-07-09,Binh Duong,Thu Dau Mot Town,21,156,125,31,11
2022-07-09,Binh Duong,Thu Dau Mot Town,22,5,3,2,0
2022-07-09,Binh Duong,Thu Dau Mot Town,23,1,1,0,0
2022-07-09,Binh Duong,Thuan An,2,1,0,1,1
2022-07-09,Binh Duong,Thuan An,6,1,0,1,1
2022-07-09,Binh Duong,Thuan An,7,4,3,1,1
2022-07-09,Binh Duong,Thuan An,8,20,14,6,2
2022-07-09,Binh Duong,Thuan An,9,39,33,6,4
2022-07-09,Binh Duong,Thuan An,10,61,54,7,3
2022-07-09,Binh Duong,Thuan An,11,94,85,9,1
2022-07-09,Binh Duong,Thuan An,12,78,69,9,3
2022-07-09,Binh Duong,Thuan An,13,80,64,16,6
2022-07-09,Binh Duong,Thuan An,14,58,44,14,10
2022-07-09,Binh Duong,Thuan An,15,48,38,10,5
2022-07-09,Binh Duong,Thuan An,16,48,41,7,4
2022-07-09,Binh Duong,Thuan An,17,50,43,7,4
2022-07-09,Binh Duong,Thuan An,18,57,46,11,1
2022-07-09,Binh Duong,Thuan An,19,67,44,23,15
2022-07-09,Binh Duong,Thuan An,20,63,38,25,17
2022-07-09,Binh Duong,Thuan An,21,34,16,18,12
2022-07-09,Can Tho City,Binh Thuy District,8,4,3,1,0
2022-07-09,Can Tho City,Binh Thuy District,9,3,2,1,0
2022-07-09,Can Tho City,Binh Thuy District,10,6,5,1,0
2022-07-09,Can Tho City,Binh Thuy District,11,13,11,2,0
2022-07-09,Can Tho City,Binh Thuy District,12,16,16,0,0
2022-07-09,Can Tho City,Binh Thuy District,13,13,10,3,0
2022-07-09,Can Tho City,Binh Thuy District,14,10,9,1,0
2022-07-09,Can Tho City,Binh Thuy District,15,13,13,0,0
2022-07-09,Can Tho City,Binh Thuy District,16,6,5,1,0
2022-07-09,Can Tho City,Binh Thuy District,17,12,9,3,1
2022-07-09,Can Tho City,Binh Thuy District,18,14,11,3,1
2022-07-09,Can Tho City,Binh Thuy District,19,10,10,0,0
2022-07-09,Can Tho City,Binh Thuy District,20,10,8,2,1
2022-07-09,Can Tho City,Binh Thuy District,21,5,1,4,1
2022-07-09,Can Tho City,Cai Rang District,6,3,2,1,1
2022-07-09,Can Tho City,Cai Rang District,7,4,2,2,2
2022-07-09,Can Tho City,Cai Rang District,8,11,10,1,1
2022-07-09,Can Tho City,Cai Rang District,9,4,3,1,1
2022-07-09,Can Tho City,Cai Rang District,10,18,17,1,0
2022-07-09,Can Tho City,Cai Rang District,11,25,23,2,0
2022-07-09,Can Tho City,Cai Rang District,12,11,11,0,0
2022-07-09,Can Tho City,Cai Rang District,13,19,18,1,0
2022-07-09,Can Tho City,Cai Rang District,14,10,8,2,0
2022-07-09,Can Tho City,Cai Rang District,15,16,15,1,0
2022-07-09,Can Tho City,Cai Rang District,16,3,3,0,0
2022-07-09,Can Tho City,Cai Rang District,17,16,16,0,0
2022-07-09,Can Tho City,Cai Rang District,18,21,19,2,2
2022-07-09,Can Tho City,Cai Rang District,19,10,9,1,0
2022-07-09,Can Tho City,Cai Rang District,20,8,6,2,0
2022-07-09,Can Tho City,Cai Rang District,21,1,1,0,0
2022-07-09,Can Tho City,Ninh Kieu District,0,1,1,0,0
2022-07-09,Can Tho City,Ninh Kieu District,2,1,1,0,0
2022-07-09,Can Tho City,Ninh Kieu District,4,2,0,2,0
2022-07-09,Can Tho City,Ninh Kieu District,6,42,36,6,0
2022-07-09,Can Tho City,Ninh Kieu District,7,141,129,12,0
2022-07-09,Can Tho City,Ninh Kieu District,8,210,202,8,0
2022-07-09,Can Tho City,Ninh Kieu District,9,283,266,17,0
2022-07-09,Can Tho City,Ninh Kieu District,10,431,421,10,0
2022-07-09,Can Tho City,Ninh Kieu District,11,714,677,37,10
2022-07-09,Can Tho City,Ninh Kieu District,12,636,620,16,0
2022-07-09,Can Tho City,Ninh Kieu District,13,485,456,29,0
2022-07-09,Can Tho City,Ninh Kieu District,14,430,408,22,0
2022-07-09,Can Tho City,Ninh Kieu District,15,351,332,19,0
2022-07-09,Can Tho City,Ninh Kieu District,16,418,398,20,0
2022-07-09,Can Tho City,Ninh Kieu District,17,476,450,26,0
2022-07-09,Can Tho City,Ninh Kieu District,18,505,474,31,0
2022-07-09,Can Tho City,Ninh Kieu District,19,501,472,29,0
2022-07-09,Can Tho City,Ninh Kieu District,20,342,323,19,2
2022-07-09,Can Tho City,Ninh Kieu District,21,191,157,34,15
2022-07-09,Can Tho City,Ninh Kieu District,22,12,0,12,0
2022-07-09,Can Tho City,Phong Dien,19,1,0,1,1
2022-07-09,Dong Nai,Bien Hoa City,1,3,1,2,1
2022-07-09,Dong Nai,Bien Hoa City,2,2,0,2,0
2022-07-09,Dong Nai,Bien Hoa City,3,2,2,0,0
2022-07-09,Dong Nai,Bien Hoa City,4,2,1,1,0
2022-07-09,Dong Nai,Bien Hoa City,5,8,3,5,0
2022-07-09,Dong Nai,Bien Hoa City,6,53,42,11,9
2022-07-09,Dong Nai,Bien Hoa City,7,166,145,21,10
2022-07-09,Dong Nai,Bien Hoa City,8,296,272,24,6
2022-07-09,Dong Nai,Bien Hoa City,9,508,469,39,3
2022-07-09,Dong Nai,Bien Hoa City,10,806,733,73,7
2022-07-09,Dong Nai,Bien Hoa City,11,1226,1125,101,15
2022-07-09,Dong Nai,Bien Hoa City,12,1044,964,80,13
2022-07-09,Dong Nai,Bien Hoa City,13,828,776,52,3
2022-07-09,Dong Nai,Bien Hoa City,14,687,649,38,7
2022-07-09,Dong Nai,Bien Hoa City,15,626,568,58,7
2022-07-09,Dong Nai,Bien Hoa City,16,567,532,35,8
2022-07-09,Dong Nai,Bien Hoa City,17,699,638,61,14
2022-07-09,Dong Nai,Bien Hoa City,18,838,728,110,37
2022-07-09,Dong Nai,Bien Hoa City,19,858,717,141,46
2022-07-09,Dong Nai,Bien Hoa City,20,715,578,137,57
2022-07-09,Dong Nai,Bien Hoa City,21,290,211,79,23
2022-07-09,Dong Nai,Bien Hoa City,22,2,1,1,0
2022-07-09,Dong Nai,Bien Hoa City,23,2,1,1,0
2022-07-09,Dong Nai,Long Khanh,9,1,0,1,0
2022-07-09,Dong Nai,Long Khanh,10,2,0,2,0
2022-07-09,Dong Nai,Long Khanh,12,1,0,1,1
2022-07-09,Dong Nai,Long Khanh,17,1,0,1,1
2022-07-09,Dong Nai,Long Khanh,20,1,0,1,1
2022-07-09,Dong Nai,Long Khanh,23,1,0,1,1
2022-07-09,Dong Nai,Long Thanh,13,2,0,2,2
2022-07-09,Dong Nai,Long Thanh,14,1,0,1,1
2022-07-09,Dong Nai,Long Thanh,16,1,0,1,1
2022-07-09,Dong Nai,Long Thanh,17,3,0,3,3
2022-07-09,Dong Nai,Long Thanh,18,2,0,2,2
2022-07-09,Dong Nai,Long Thanh,20,1,0,1,1
2022-07-09,Dong Nai,Long Thanh,21,1,0,1,0
2022-07-09,Dong Nai,Nhon trach,11,1,0,1,1
2022-07-09,Dong Nai,Nhon trach,12,1,0,1,1
2022-07-09,Dong Nai,Nhon trach,13,2,0,2,2
2022-07-09,Dong Nai,Nhon trach,14,1,0,1,0
2022-07-09,Dong Nai,Nhon trach,18,1,0,1,0
2022-07-09,Dong Nai,Trang Bom,7,1,0,1,1
2022-07-09,Dong Nai,Trang Bom,9,4,0,4,2
2022-07-09,Dong Nai,Trang Bom,12,2,0,2,2
2022-07-09,Dong Nai,Trang Bom,14,2,0,2,2
2022-07-09,Dong Nai,Trang Bom,20,2,0,2,2
2022-07-09,Dong Nai,Trang Bom,21,1,0,1,1
2022-07-09,Dong Nai,Vinh Cuu,10,1,0,1,1
2022-07-09,Hai Phong City,An Duong,8,1,0,1,0
2022-07-09,Hai Phong City,An Duong,9,8,2,6,3
2022-07-09,Hai Phong City,An Duong,10,4,2,2,1
2022-07-09,Hai Phong City,An Duong,11,7,4,3,2
2022-07-09,Hai Phong City,An Duong,12,6,4,2,1
2022-07-09,Hai Phong City,An Duong,13,6,2,4,1
2022-07-09,Hai Phong City,An Duong,14,4,1,3,1
2022-07-09,Hai Phong City,An Duong,15,1,0,1,0
2022-07-09,Hai Phong City,An Duong,16,4,2,2,2
2022-07-09,Hai Phong City,An Duong,17,7,5,2,1
2022-07-09,Hai Phong City,An Duong,18,2,2,0,0
2022-07-09,Hai Phong City,An Duong,19,3,0,3,1
2022-07-09,Hai Phong City,Duong Kinh District,16,1,0,1,0
2022-07-09,Hai Phong City,Hai An District,0,2,0,2,0
2022-07-09,Hai Phong City,Hai An District,1,1,0,1,0
2022-07-09,Hai Phong City,Hai An District,7,6,4,2,1
2022-07-09,Hai Phong City,Hai An District,8,15,10,5,2
2022-07-09,Hai Phong City,Hai An District,9,16,11,5,2
2022-07-09,Hai Phong City,Hai An District,10,39,28,11,2
2022-07-09,Hai Phong City,Hai An District,11,32,27,5,1
2022-07-09,Hai Phong City,Hai An District,12,33,32,1,0
2022-07-09,Hai Phong City,Hai An District,13,14,10,4,1
2022-07-09,Hai Phong City,Hai An District,14,16,9,7,3
2022-07-09,Hai Phong City,Hai An District,15,25,16,9,3
2022-07-09,Hai Phong City,Hai An District,16,23,17,6,3
2022-07-09,Hai Phong City,Hai An District,17,21,16,5,3
2022-07-09,Hai Phong City,Hai An District,18,32,26,6,3
2022-07-09,Hai Phong City,Hai An District,19,29,18,11,8
2022-07-09,Hai Phong City,Hai An District,20,19,16,3,0
2022-07-09,Hai Phong City,Hai An District,21,23,12,11,8
2022-07-09,Hai Phong City,Hong Bang District,6,1,1,0,0
2022-07-09,Hai Phong City,Hong Bang District,7,11,5,6,3
2022-07-09,Hai Phong City,Hong Bang District,8,24,15,9,4
2022-07-09,Hai Phong City,Hong Bang District,9,32,25,7,5
2022-07-09,Hai Phong City,Hong Bang District,10,68,54,14,5
2022-07-09,Hai Phong City,Hong Bang District,11,97,81,16,6
2022-07-09,Hai Phong City,Hong Bang District,12,71,60,11,1
2022-07-09,Hai Phong City,Hong Bang District,13,41,37,4,1
2022-07-09,Hai Phong City,Hong Bang District,14,40,34,6,1
2022-07-09,Hai Phong City,Hong Bang District,15,44,42,2,1
2022-07-09,Hai Phong City,Hong Bang District,16,39,36,3,1
2022-07-09,Hai Phong City,Hong Bang District,17,42,28,14,6
2022-07-09,Hai Phong City,Hong Bang District,18,60,47,13,5
2022-07-09,Hai Phong City,Hong Bang District,19,54,37,17,10
2022-07-09,Hai Phong City,Hong Bang District,20,37,25,12,4
2022-07-09,Hai Phong City,Hong Bang District,21,20,9,11,6
2022-07-09,Hai Phong City,Hong Bang District,22,1,1,0,0
2022-07-09,Hai Phong City,Hong Bang District,23,1,1,0,0
2022-07-09,Hai Phong City,Kien An District,7,3,0,3,3
2022-07-09,Hai Phong City,Kien An District,8,4,3,1,1
2022-07-09,Hai Phong City,Kien An District,9,6,2,4,3
2022-07-09,Hai Phong City,Kien An District,10,11,9,2,1
2022-07-09,Hai Phong City,Kien An District,11,13,11,2,1
2022-07-09,Hai Phong City,Kien An District,12,10,10,0,0
2022-07-09,Hai Phong City,Kien An District,13,9,6,3,3
2022-07-09,Hai Phong City,Kien An District,14,9,3,6,4
2022-07-09,Hai Phong City,Kien An District,15,9,6,3,1
2022-07-09,Hai Phong City,Kien An District,16,8,8,0,0
2022-07-09,Hai Phong City,Kien An District,17,10,8,2,1
2022-07-09,Hai Phong City,Kien An District,18,13,7,6,3
2022-07-09,Hai Phong City,Kien An District,19,12,7,5,3
2022-07-09,Hai Phong City,Kien An District,20,6,6,0,0
2022-07-09,Hai Phong City,Kien An District,21,1,1,0,0
2022-07-09,Hai Phong City,Kien An District,22,1,0,1,0
2022-07-09,Hai Phong City,Le Chan District,0,4,0,4,1
2022-07-09,Hai Phong City,Le Chan District,1,1,0,1,0
2022-07-09,Hai Phong City,Le Chan District,2,1,0,1,0
2022-07-09,Hai Phong City,Le Chan District,3,1,1,0,0
2022-07-09,Hai Phong City,Le Chan District,6,4,2,2,1
2022-07-09,Hai Phong City,Le Chan District,7,46,27,19,13
2022-07-09,Hai Phong City,Le Chan District,8,74,53,21,9
2022-07-09,Hai Phong City,Le Chan District,9,92,76,16,3
2022-07-09,Hai Phong City,Le Chan District,10,228,188,40,12
2022-07-09,Hai Phong City,Le Chan District,11,314,272,42,19
2022-07-09,Hai Phong City,Le Chan District,12,238,214,24,6
2022-07-09,Hai Phong City,Le Chan District,13,167,149,18,9
2022-07-09,Hai Phong City,Le Chan District,14,147,124,23,6
2022-07-09,Hai Phong City,Le Chan District,15,172,140,32,7
2022-07-09,Hai Phong City,Le Chan District,16,196,166,30,7
2022-07-09,Hai Phong City,Le Chan District,17,196,171,25,5
2022-07-09,Hai Phong City,Le Chan District,18,250,198,52,19
2022-07-09,Hai Phong City,Le Chan District,19,232,175,57,26
2022-07-09,Hai Phong City,Le Chan District,20,160,123,37,13
2022-07-09,Hai Phong City,Le Chan District,21,107,62,45,27
2022-07-09,Hai Phong City,Le Chan District,22,4,2,2,0
2022-07-09,Hai Phong City,Le Chan District,23,1,1,0,0
2022-07-09,Hai Phong City,Ngo Quyen District,0,2,0,2,2
2022-07-09,Hai Phong City,Ngo Quyen District,6,1,1,0,0
2022-07-09,Hai Phong City,Ngo Quyen District,7,24,10,14,12
2022-07-09,Hai Phong City,Ngo Quyen District,8,80,64,16,9
2022-07-09,Hai Phong City,Ngo Quyen District,9,92,74,18,5
2022-07-09,Hai Phong City,Ngo Quyen District,10,169,145,24,8
2022-07-09,Hai Phong City,Ngo Quyen District,11,204,178,26,7
2022-07-09,Hai Phong City,Ngo Quyen District,12,190,170,20,6
2022-07-09,Hai Phong City,Ngo Quyen District,13,117,106,11,2
2022-07-09,Hai Phong City,Ngo Quyen District,14,120,111,9,1
2022-07-09,Hai Phong City,Ngo Quyen District,15,139,122,17,7
2022-07-09,Hai Phong City,Ngo Quyen District,16,152,132,20,2
2022-07-09,Hai Phong City,Ngo Quyen District,17,143,117,26,9
2022-07-09,Hai Phong City,Ngo Quyen District,18,166,135,31,8
2022-07-09,Hai Phong City,Ngo Quyen District,19,180,141,39,16
2022-07-09,Hai Phong City,Ngo Quyen District,20,153,125,28,18
2022-07-09,Hai Phong City,Ngo Quyen District,21,104,64,40,27
2022-07-09,Hai Phong City,Ngo Quyen District,22,2,0,2,0
2022-07-09,Hai Phong City,Ngo Quyen District,23,2,0,2,0
2022-07-09,Hai Phong City,Thuy Nguyen,8,1,0,1,1
2022-07-09,Hai Phong City,Thuy Nguyen,10,1,0,1,1
2022-07-09,Hai Phong City,Thuy Nguyen,11,1,0,1,1
2022-07-09,Hai Phong City,Thuy Nguyen,12,1,0,1,0
2022-07-09,Hai Phong City,Thuy Nguyen,13,1,0,1,1
2022-07-09,Hai Phong City,Thuy Nguyen,16,3,1,2,2
2022-07-09,Hai Phong City,Thuy Nguyen,19,1,0,1,1
2022-07-09,Hai Phong City,Thuy Nguyen,20,1,0,1,1
2022-07-09,Hue City,Hue City,0,5,1,4,0
2022-07-09,Hue City,Hue City,1,2,1,1,0
2022-07-09,Hue City,Hue City,5,2,2,0,0
2022-07-09,Hue City,Hue City,6,62,58,4,1
2022-07-09,Hue City,Hue City,7,216,194,22,0
2022-07-09,Hue City,Hue City,8,347,315,32,0
2022-07-09,Hue City,Hue City,9,304,284,20,1
2022-07-09,Hue City,Hue City,10,487,444,43,0
2022-07-09,Hue City,Hue City,11,919,825,94,12
2022-07-09,Hue City,Hue City,12,621,579,42,1
2022-07-09,Hue City,Hue City,13,404,377,27,0
2022-07-09,Hue City,Hue City,14,391,358,33,0
2022-07-09,Hue City,Hue City,15,373,349,24,2
2022-07-09,Hue City,Hue City,16,414,380,34,1
2022-07-09,Hue City,Hue City,17,509,472,37,5
2022-07-09,Hue City,Hue City,18,551,490,61,6
2022-07-09,Hue City,Hue City,19,609,530,79,18
2022-07-09,Hue City,Hue City,20,483,404,79,13
2022-07-09,Hue City,Hue City,21,275,215,60,23
2022-07-09,Hue City,Hue City,22,9,5,4,1
2022-07-09,Hue City,Hue City,23,1,0,1,0
2022-07-09,Hue City,Huong Thuy,7,1,1,0,0
2022-07-09,Hue City,Huong Thuy,8,2,1,1,1
2022-07-09,Hue City,Huong Thuy,9,1,1,0,0
2022-07-09,Hue City,Huong Thuy,12,3,3,0,0
2022-07-09,Hue City,Huong Thuy,13,3,2,1,0
2022-07-09,Hue City,Huong Thuy,15,2,0,2,2
2022-07-09,Hue City,Huong Thuy,16,2,2,0,0
2022-07-09,Hue City,Huong Thuy,18,1,1,0,0
2022-07-09,Hue City,Huong Thuy,19,1,1,0,0
2022-07-09,Hue City,Huong Thuy,21,3,0,3,3
2022-07-09,Hue City,Huong Tra,18,1,1,0,0
2022-07-09,Hue City,Huong Tra,20,1,1,0,0
2022-07-09,Hue City,Huong Tra,21,1,0,1,1
2022-07-09,Hue City,Phu Vang,8,6,2,4,1
2022-07-09,Hue City,Phu Vang,9,1,1,0,0
2022-07-09,Hue City,Phu Vang,10,4,4,0,0
2022-07-09,Hue City,Phu Vang,11,3,3,0,0
2022-07-09,Hue City,Phu Vang,12,2,1,1,1
2022-07-09,Hue City,Phu Vang,13,2,1,1,1
2022-07-09,Hue City,Phu Vang,15,6,4,2,2
2022-07-09,Hue City,Phu Vang,16,3,1,2,0
2022-07-09,Hue City,Phu Vang,17,3,2,1,1
2022-07-09,Hue City,Phu Vang,18,2,1,1,0
2022-07-09,Hue City,Phu Vang,19,2,2,0,0
2022-07-09,Hue City,Phu Vang,20,1,1,0,0
2022-07-09,Hue City,Phu Vang,21,1,0,1,0
2022-07-09,Khanh Hoa,Cam Ranh City,15,1,0,1,1
2022-07-09,Khanh Hoa,Cam Ranh City,16,1,0,1,1
2022-07-09,Khanh Hoa,Cam Ranh City,20,1,0,1,0
2022-07-09,Khanh Hoa,Dien Khanh,14,1,0,1,1
2022-07-09,Khanh Hoa,Nha Trang City,1,1,0,1,0
2022-07-09,Khanh Hoa,Nha Trang City,2,1,0,1,0
2022-07-09,Khanh Hoa,Nha Trang City,3,2,0,2,1
2022-07-09,Khanh Hoa,Nha Trang City,5,2,2,0,0
2022-07-09,Khanh Hoa,Nha Trang City,6,34,28,6,3
2022-07-09,Khanh Hoa,Nha Trang City,7,127,118,9,0
2022-07-09,Khanh Hoa,Nha Trang City,8,232,209,23,0
2022-07-09,Khanh Hoa,Nha Trang City,9,196,185,11,0
2022-07-09,Khanh Hoa,Nha Trang City,10,252,231,21,4
2022-07-09,Khanh Hoa,Nha Trang City,11,343,319,24,1
2022-07-09,Khanh Hoa,Nha Trang City,12,349,314,35,1
2022-07-09,Khanh Hoa,Nha Trang City,13,246,232,14,1
2022-07-09,Khanh Hoa,Nha Trang City,14,234,216,18,2
2022-07-09,Khanh Hoa,Nha Trang City,15,206,196,10,0
2022-07-09,Khanh Hoa,Nha Trang City,16,227,211,16,0
2022-07-09,Khanh Hoa,Nha Trang City,17,292,274,18,0
2022-07-09,Khanh Hoa,Nha Trang City,18,319,294,25,3
2022-07-09,Khanh Hoa,Nha Trang City,19,326,279,47,4
2022-07-09,Khanh Hoa,Nha Trang City,20,247,218,29,5
2022-07-09,Khanh Hoa,Nha Trang City,21,165,119,46,24
2022-07-09,Khanh Hoa,Nha Trang City,22,7,1,6,0
2022-07-09,Khanh Hoa,Nha Trang City,23,5,1,4,0
2022-07-09,Lam Dong,Da Lat City,0,1,0,1,0
2022-07-09,Lam Dong,Da Lat City,5,2,1,1,0
2022-07-09,Lam Dong,Da Lat City,6,1,0,1,0
2022-07-09,Lam Dong,Da Lat City,7,66,37,29,17
2022-07-09,Lam Dong,Da Lat City,8,97,66,31,24
2022-07-09,Lam Dong,Da Lat City,9,106,79,27,14
2022-07-09,Lam Dong,Da Lat City,10,127,92,35,19
2022-07-09,Lam Dong,Da Lat City,11,162,119,43,31
2022-07-09,Lam Dong,Da Lat City,12,185,116,69,50
2022-07-09,Lam Dong,Da Lat City,13,160,113,47,29
2022-07-09,Lam Dong,Da Lat City,14,121,90,31,19
2022-07-09,Lam Dong,Da Lat City,15,111,85,26,14
2022-07-09,Lam Dong,Da Lat City,16,122,84,38,29
2022-07-09,Lam Dong,Da Lat City,17,124,91,33,20
2022-07-09,Lam Dong,Da Lat City,18,175,105,70,57
2022-07-09,Lam Dong,Da Lat City,19,210,108,102,86
2022-07-09,Lam Dong,Da Lat City,20,188,59,129,113
2022-07-09,Lam Dong,Da Lat City,21,169,29,140,121
2022-07-09,Lam Dong,Da Lat City,22,6,0,6,0
2022-07-09,Lam Dong,Da Lat City,23,2,0,2,0
2022-07-09,Nghe An,Vinh City,2,1,1,0,0
2022-07-09,Nghe An,Vinh City,4,1,0,1,0
2022-07-09,Nghe An,Vinh City,6,5,3,2,0
2022-07-09,Nghe An,Vinh City,7,110,88,22,10
2022-07-09,Nghe An,Vinh City,8,176,139,37,12
2022-07-09,Nghe An,Vinh City,9,154,130,24,12
2022-07-09,Nghe An,Vinh City,10,224,190,34,10
2022-07-09,Nghe An,Vinh City,11,367,307,60,40
2022-07-09,Nghe An,Vinh City,12,272,215,57,27
2022-07-09,Nghe An,Vinh City,13,175,143,32,8
2022-07-09,Nghe An,Vinh City,14,147,120,27,7
2022-07-09,Nghe An,Vinh City,15,170,140,30,7
2022-07-09,Nghe An,Vinh City,16,167,142,25,2
2022-07-09,Nghe An,Vinh City,17,169,136,33,14
2022-07-09,Nghe An,Vinh City,18,214,152,62,25
2022-07-09,Nghe An,Vinh City,19,204,146,58,26
2022-07-09,Nghe An,Vinh City,20,184,126,58,22
2022-07-09,Nghe An,Vinh City,21,116,67,49,27
2022-07-09,Nghe An,Vinh City,22,4,1,3,0
2022-07-09,Quang Nam,Dien Ban,16,1,0,1,1
2022-07-09,Quang Nam,Hoi An City,0,1,1,0,0
2022-07-09,Quang Nam,Hoi An City,7,8,8,0,0
2022-07-09,Quang Nam,Hoi An City,8,27,24,3,0
2022-07-09,Quang Nam,Hoi An City,9,27,25,2,1
2022-07-09,Quang Nam,Hoi An City,10,30,29,1,0
2022-07-09,Quang Nam,Hoi An City,11,69,52,17,6
2022-07-09,Quang Nam,Hoi An City,12,63,52,11,2
2022-07-09,Quang Nam,Hoi An City,13,33,28,5,2
2022-07-09,Quang Nam,Hoi An City,14,48,38,10,4
2022-07-09,Quang Nam,Hoi An City,15,60,52,8,4
2022-07-09,Quang Nam,Hoi An City,16,60,43,17,6
2022-07-09,Quang Nam,Hoi An City,17,52,42,10,5
2022-07-09,Quang Nam,Hoi An City,18,64,40,24,15
2022-07-09,Quang Nam,Hoi An City,19,68,38,30,21
2022-07-09,Quang Nam,Hoi An City,20,80,37,43,30
2022-07-09,Quang Nam,Hoi An City,21,55,16,39,33
2022-07-09,Quang Nam,Tam Ky City,16,1,0,1,1
2022-07-09,Quang Nam,Tam Ky City,20,2,0,2,2
2022-07-09,Quang Ninh,Cam Pha City,9,2,0,2,1
2022-07-09,Quang Ninh,Cam Pha City,11,3,0,3,2
2022-07-09,Quang Ninh,Cam Pha City,12,1,0,1,1
2022-07-09,Quang Ninh,Cam Pha City,17,2,0,2,2
2022-07-09,Quang Ninh,Cam Pha City,18,2,0,2,1
2022-07-09,Quang Ninh,Cam Pha City,20,3,0,3,3
2022-07-09,Quang Ninh,Ha Long City,0,1,0,1,1
2022-07-09,Quang Ninh,Ha Long City,5,1,1,0,0
2022-07-09,Quang Ninh,Ha Long City,6,1,0,1,1
2022-07-09,Quang Ninh,Ha Long City,7,16,10,6,6
2022-07-09,Quang Ninh,Ha Long City,8,56,35,21,9
2022-07-09,Quang Ninh,Ha Long City,9,50,33,17,10
2022-07-09,Quang Ninh,Ha Long City,10,98,43,55,42
2022-07-09,Quang Ninh,Ha Long City,11,189,79,110,86
2022-07-09,Quang Ninh,Ha Long City,12,135,81,54,36
2022-07-09,Quang Ninh,Ha Long City,13,58,43,15,7
2022-07-09,Quang Ninh,Ha Long City,14,51,37,14,8
2022-07-09,Quang Ninh,Ha Long City,15,50,43,7,3
2022-07-09,Quang Ninh,Ha Long City,16,50,46,4,1
2022-07-09,Quang Ninh,Ha Long City,17,46,41,5,0
2022-07-09,Quang Ninh,Ha Long City,18,59,50,9,3
2022-07-09,Quang Ninh,Ha Long City,19,79,52,27,10
2022-07-09,Quang Ninh,Ha Long City,20,77,44,33,20
2022-07-09,Quang Ninh,Ha Long City,21,2,1,1,0
2022-07-09,Quang Ninh,Ha Long City,22,2,1,1,0
2022-07-09,Quang Ninh,Uong Bi City,14,1,0,1,1
2022-07-09,Thai Nguyen,Dong Hy,8,2,0,2,0
2022-07-09,Thai Nguyen,Dong Hy,9,1,1,0,0
2022-07-09,Thai Nguyen,Dong Hy,19,1,0,1,1
2022-07-09,Thai Nguyen,Thai Nguyen City,0,4,3,1,0
2022-07-09,Thai Nguyen,Thai Nguyen City,4,2,1,1,0
2022-07-09,Thai Nguyen,Thai Nguyen City,5,2,0,2,0
2022-07-09,Thai Nguyen,Thai Nguyen City,6,7,6,1,0
2022-07-09,Thai Nguyen,Thai Nguyen City,7,81,76,5,0
2022-07-09,Thai Nguyen,Thai Nguyen City,8,155,138,17,1
2022-07-09,Thai Nguyen,Thai Nguyen City,9,124,109,15,0
2022-07-09,Thai Nguyen,Thai Nguyen City,10,196,172,24,2
2022-07-09,Thai Nguyen,Thai Nguyen City,11,374,339,35,5
2022-07-09,Thai Nguyen,Thai Nguyen City,12,298,263,35,1
2022-07-09,Thai Nguyen,Thai Nguyen City,13,173,162,11,1
2022-07-09,Thai Nguyen,Thai Nguyen City,14,154,137,17,2
2022-07-09,Thai Nguyen,Thai Nguyen City,15,128,115,13,0
2022-07-09,Thai Nguyen,Thai Nguyen City,16,136,120,16,0
2022-07-09,Thai Nguyen,Thai Nguyen City,17,161,145,16,5
2022-07-09,Thai Nguyen,Thai Nguyen City,18,201,186,15,1
2022-07-09,Thai Nguyen,Thai Nguyen City,19,226,205,21,3
2022-07-09,Thai Nguyen,Thai Nguyen City,20,179,160,19,0
2022-07-09,Thai Nguyen,Thai Nguyen City,21,120,103,17,0
2022-07-09,Thai Nguyen,Thai Nguyen City,22,2,0,2,0
2022-07-09,Vung Tau,Ba Ria City,7,2,0,2,2
2022-07-09,Vung Tau,Ba Ria City,8,2,0,2,2
2022-07-09,Vung Tau,Ba Ria City,9,9,5,4,3
2022-07-09,Vung Tau,Ba Ria City,10,4,3,1,0
2022-07-09,Vung Tau,Ba Ria City,11,15,6,9,8
2022-07-09,Vung Tau,Ba Ria City,12,10,9,1,1
2022-07-09,Vung Tau,Ba Ria City,13,6,4,2,2
2022-07-09,Vung Tau,Ba Ria City,14,3,1,2,2
2022-07-09,Vung Tau,Ba Ria City,15,10,6,4,3
2022-07-09,Vung Tau,Ba Ria City,16,5,3,2,2
2022-07-09,Vung Tau,Ba Ria City,17,13,6,7,6
2022-07-09,Vung Tau,Ba Ria City,18,10,0,10,9
2022-07-09,Vung Tau,Ba Ria City,19,7,0,7,6
2022-07-09,Vung Tau,Ba Ria City,20,6,0,6,5
2022-07-09,Vung Tau,Ba Ria City,21,2,0,2,2
2022-07-09,Vung Tau,Chau Duc,8,1,0,1,1
2022-07-09,Vung Tau,Chau Duc,10,1,0,1,1
2022-07-09,Vung Tau,Tan Thanh,12,1,0,1,0
2022-07-09,Vung Tau,Vung Tau City,6,33,29,4,1
2022-07-09,Vung Tau,Vung Tau City,7,111,102,9,5
2022-07-09,Vung Tau,Vung Tau City,8,197,186,11,0
2022-07-09,Vung Tau,Vung Tau City,9,224,198,26,3
2022-07-09,Vung Tau,Vung Tau City,10,276,254,22,3
2022-07-09,Vung Tau,Vung Tau City,11,420,390,30,5
2022-07-09,Vung Tau,Vung Tau City,12,394,371,23,0
2022-07-09,Vung Tau,Vung Tau City,13,290,272,18,1
2022-07-09,Vung Tau,Vung Tau City,14,266,244,22,2
2022-07-09,Vung Tau,Vung Tau City,15,319,295,24,5
2022-07-09,Vung Tau,Vung Tau City,16,257,239,18,5
2022-07-09,Vung Tau,Vung Tau City,17,454,238,216,174
2022-07-09,Vung Tau,Vung Tau City,18,682,240,442,370
2022-07-09,Vung Tau,Vung Tau City,19,739,195,544,466
2022-07-09,Vung Tau,Vung Tau City,20,429,109,320,277
2022-07-09,Vung Tau,Vung Tau City,21,366,65,301,251
2022-07-09,Vung Tau,Vung Tau City,22,16,1,15,1
2022-07-09,Vung Tau,Vung Tau City,23,3,1,2,0
2022-07-10,Bac Ninh,Bác Ninh City,1,1,1,0,0
2022-07-10,Bac Ninh,Bác Ninh City,6,6,4,2,0
2022-07-10,Bac Ninh,Bác Ninh City,7,61,54,7,0
2022-07-10,Bac Ninh,Bác Ninh City,8,104,89,15,3
2022-07-10,Bac Ninh,Bác Ninh City,9,133,124,9,1
2022-07-10,Bac Ninh,Bác Ninh City,10,207,189,18,0
2022-07-10,Bac Ninh,Bác Ninh City,11,334,305,29,3
2022-07-10,Bac Ninh,Bác Ninh City,12,238,219,19,1
2022-07-10,Bac Ninh,Bác Ninh City,13,149,142,7,1
2022-07-10,Bac Ninh,Bác Ninh City,14,152,144,8,4
2022-07-10,Bac Ninh,Bác Ninh City,15,168,151,17,0
2022-07-10,Bac Ninh,Bác Ninh City,16,122,109,13,0
2022-07-10,Bac Ninh,Bác Ninh City,17,120,111,9,2
2022-07-10,Bac Ninh,Bác Ninh City,18,198,175,23,3
2022-07-10,Bac Ninh,Bác Ninh City,19,197,172,25,6
2022-07-10,Bac Ninh,Bác Ninh City,20,143,127,16,3
2022-07-10,Bac Ninh,Bác Ninh City,21,89,79,10,3
2022-07-10,Bac Ninh,Bác Ninh City,22,28,21,7,2
2022-07-10,Bac Ninh,Bác Ninh City,23,7,4,3,3
2022-07-10,Bac Ninh,Que Vo,10,1,1,0,0
2022-07-10,Bac Ninh,Que Vo,11,1,0,1,1
2022-07-10,Bac Ninh,Que Vo,12,1,1,0,0
2022-07-10,Bac Ninh,Que Vo,14,1,0,1,1
2022-07-10,Bac Ninh,Que Vo,16,1,0,1,1
2022-07-10,Bac Ninh,Que Vo,20,2,1,1,1
2022-07-10,Bac Ninh,Tien Du,8,1,0,1,1
2022-07-10,Bac Ninh,Tien Du,9,1,0,1,1
2022-07-10,Bac Ninh,Tien Du,10,1,0,1,0
2022-07-10,Bac Ninh,Tien Du,11,1,0,1,1
2022-07-10,Bac Ninh,Tien Du,12,3,0,3,2
2022-07-10,Bac Ninh,Tien Du,14,1,0,1,1
2022-07-10,Bac Ninh,Tien Du,15,1,0,1,1
2022-07-10,Bac Ninh,Tien Du,16,1,0,1,1
2022-07-10,Bac Ninh,Tien Du,17,4,0,4,3
2022-07-10,Bac Ninh,Tien Du,18,3,0,3,2
2022-07-10,Bac Ninh,Tien Du,19,1,0,1,1
2022-07-10,Bac Ninh,Tu Son,9,1,0,1,1
2022-07-10,Bac Ninh,Tu Son,11,1,0,1,1
2022-07-10,Bac Ninh,Tu Son,12,1,0,1,0
2022-07-10,Bac Ninh,Tu Son,15,2,0,2,2
2022-07-10,Bac Ninh,Tu Son,16,3,0,3,3
2022-07-10,Bac Ninh,Tu Son,17,2,0,2,2
2022-07-10,Bac Ninh,Tu Son,18,1,0,1,1
2022-07-10,Bac Ninh,Tu Son,20,10,0,10,5
2022-07-10,Bac Ninh,Tu Son,21,1,0,1,1
2022-07-10,Binh Duong,Ben Cat,8,1,0,1,1
2022-07-10,Binh Duong,Ben Cat,9,1,0,1,1
2022-07-10,Binh Duong,Ben Cat,10,4,0,4,4
2022-07-10,Binh Duong,Ben Cat,11,6,0,6,6
2022-07-10,Binh Duong,Ben Cat,12,1,0,1,1
2022-07-10,Binh Duong,Ben Cat,13,1,0,1,1
2022-07-10,Binh Duong,Ben Cat,14,2,0,2,2
2022-07-10,Binh Duong,Ben Cat,17,1,0,1,1
2022-07-10,Binh Duong,Ben Cat,18,4,0,4,2
2022-07-10,Binh Duong,Ben Cat,19,4,0,4,4
2022-07-10,Binh Duong,Ben Cat,20,1,0,1,0
2022-07-10,Binh Duong,Di An,3,1,0,1,1
2022-07-10,Binh Duong,Di An,8,15,12,3,3
2022-07-10,Binh Duong,Di An,9,24,19,5,2
2022-07-10,Binh Duong,Di An,10,33,25,8,2
2022-07-10,Binh Duong,Di An,11,66,57,9,4
2022-07-10,Binh Duong,Di An,12,66,55,11,6
2022-07-10,Binh Duong,Di An,13,45,42,3,1
2022-07-10,Binh Duong,Di An,14,38,30,8,2
2022-07-10,Binh Duong,Di An,15,31,24,7,3
2022-07-10,Binh Duong,Di An,16,34,21,13,5
2022-07-10,Binh Duong,Di An,17,37,27,10,7
2022-07-10,Binh Duong,Di An,18,58,37,21,9
2022-07-10,Binh Duong,Di An,19,47,29,18,10
2022-07-10,Binh Duong,Di An,20,28,19,9,8
2022-07-10,Binh Duong,Di An,21,5,3,2,1
2022-07-10,Binh Duong,Di An,22,1,1,0,0
2022-07-10,Binh Duong,Phu Giao,13,1,0,1,1
2022-07-10,Binh Duong,Tan Uyen,6,1,0,1,1
2022-07-10,Binh Duong,Tan Uyen,7,1,0,1,1
2022-07-10,Binh Duong,Tan Uyen,8,3,0,3,2
2022-07-10,Binh Duong,Tan Uyen,9,1,1,0,0
2022-07-10,Binh Duong,Tan Uyen,10,6,3,3,3
2022-07-10,Binh Duong,Tan Uyen,11,2,1,1,1
2022-07-10,Binh Duong,Tan Uyen,12,6,4,2,2
2022-07-10,Binh Duong,Tan Uyen,13,3,2,1,1
2022-07-10,Binh Duong,Tan Uyen,14,4,2,2,2
2022-07-10,Binh Duong,Tan Uyen,15,4,3,1,0
2022-07-10,Binh Duong,Tan Uyen,16,5,3,2,0
2022-07-10,Binh Duong,Tan Uyen,17,2,0,2,2
2022-07-10,Binh Duong,Tan Uyen,18,7,4,3,3
2022-07-10,Binh Duong,Tan Uyen,19,1,0,1,0
2022-07-10,Binh Duong,Tan Uyen,20,2,0,2,1
2022-07-10,Binh Duong,Thu Dau Mot Town,0,1,0,1,0
2022-07-10,Binh Duong,Thu Dau Mot Town,1,1,1,0,0
2022-07-10,Binh Duong,Thu Dau Mot Town,2,1,1,0,0
2022-07-10,Binh Duong,Thu Dau Mot Town,3,1,0,1,0
2022-07-10,Binh Duong,Thu Dau Mot Town,4,1,0,1,0
2022-07-10,Binh Duong,Thu Dau Mot Town,5,1,0,1,1
2022-07-10,Binh Duong,Thu Dau Mot Town,6,31,27,4,3
2022-07-10,Binh Duong,Thu Dau Mot Town,7,137,115,22,4
2022-07-10,Binh Duong,Thu Dau Mot Town,8,215,200,15,1
2022-07-10,Binh Duong,Thu Dau Mot Town,9,278,255,23,2
2022-07-10,Binh Duong,Thu Dau Mot Town,10,417,393,24,4
2022-07-10,Binh Duong,Thu Dau Mot Town,11,622,591,31,6
2022-07-10,Binh Duong,Thu Dau Mot Town,12,570,528,42,12
2022-07-10,Binh Duong,Thu Dau Mot Town,13,452,402,50,5
2022-07-10,Binh Duong,Thu Dau Mot Town,14,393,352,41,9
2022-07-10,Binh Duong,Thu Dau Mot Town,15,298,268,30,8
2022-07-10,Binh Duong,Thu Dau Mot Town,16,315,295,20,4
2022-07-10,Binh Duong,Thu Dau Mot Town,17,424,376,48,11
2022-07-10,Binh Duong,Thu Dau Mot Town,18,514,459,55,19
2022-07-10,Binh Duong,Thu Dau Mot Town,19,481,421,60,12
2022-07-10,Binh Duong,Thu Dau Mot Town,20,352,313,39,16
2022-07-10,Binh Duong,Thu Dau Mot Town,21,137,118,19,8
2022-07-10,Binh Duong,Thu Dau Mot Town,22,21,15,6,1
2022-07-10,Binh Duong,Thu Dau Mot Town,23,8,3,5,2
2022-07-10,Binh Duong,Thuan An,2,1,0,1,1
2022-07-10,Binh Duong,Thuan An,5,1,0,1,1
2022-07-10,Binh Duong,Thuan An,6,1,0,1,1
2022-07-10,Binh Duong,Thuan An,7,4,2,2,2
2022-07-10,Binh Duong,Thuan An,8,13,6,7,3
2022-07-10,Binh Duong,Thuan An,9,31,26,5,2
2022-07-10,Binh Duong,Thuan An,10,59,47,12,6
2022-07-10,Binh Duong,Thuan An,11,116,103,13,7
2022-07-10,Binh Duong,Thuan An,12,81,70,11,5
2022-07-10,Binh Duong,Thuan An,13,59,50,9,3
2022-07-10,Binh Duong,Thuan An,14,59,44,15,10
2022-07-10,Binh Duong,Thuan An,15,45,36,9,4
2022-07-10,Binh Duong,Thuan An,16,48,33,15,9
2022-07-10,Binh Duong,Thuan An,17,66,41,25,18
2022-07-10,Binh Duong,Thuan An,18,70,47,23,13
2022-07-10,Binh Duong,Thuan An,19,73,49,24,11
2022-07-10,Binh Duong,Thuan An,20,68,40,28,17
2022-07-10,Binh Duong,Thuan An,21,35,14,21,14
2022-07-10,Binh Duong,Thuan An,22,6,0,6,6
2022-07-10,Binh Duong,Thuan An,23,5,0,5,5
2022-07-10,Can Tho City,Binh Thuy District,6,3,2,1,1
2022-07-10,Can Tho City,Binh Thuy District,7,1,1,0,0
2022-07-10,Can Tho City,Binh Thuy District,8,8,5,3,0
2022-07-10,Can Tho City,Binh Thuy District,9,8,8,0,0
2022-07-10,Can Tho City,Binh Thuy District,10,13,11,2,1
2022-07-10,Can Tho City,Binh Thuy District,11,12,11,1,0
2022-07-10,Can Tho City,Binh Thuy District,12,14,10,4,2
2022-07-10,Can Tho City,Binh Thuy District,13,11,9,2,0
2022-07-10,Can Tho City,Binh Thuy District,14,12,12,0,0
2022-07-10,Can Tho City,Binh Thuy District,15,15,13,2,0
2022-07-10,Can Tho City,Binh Thuy District,16,20,17,3,0
2022-07-10,Can Tho City,Binh Thuy District,17,16,14,2,0
2022-07-10,Can Tho City,Binh Thuy District,18,13,11,2,0
2022-07-10,Can Tho City,Binh Thuy District,19,11,11,0,0
2022-07-10,Can Tho City,Binh Thuy District,20,8,8,0,0
2022-07-10,Can Tho City,Binh Thuy District,21,3,0,3,0
2022-07-10,Can Tho City,Binh Thuy District,22,1,0,1,0
2022-07-10,Can Tho City,Cai Rang District,5,1,1,0,0
2022-07-10,Can Tho City,Cai Rang District,6,6,4,2,1
2022-07-10,Can Tho City,Cai Rang District,7,6,5,1,1
2022-07-10,Can Tho City,Cai Rang District,8,6,6,0,0
2022-07-10,Can Tho City,Cai Rang District,9,11,10,1,1
2022-07-10,Can Tho City,Cai Rang District,10,12,10,2,1
2022-07-10,Can Tho City,Cai Rang District,11,18,15,3,1
2022-07-10,Can Tho City,Cai Rang District,12,18,14,4,2
2022-07-10,Can Tho City,Cai Rang District,13,9,8,1,1
2022-07-10,Can Tho City,Cai Rang District,14,9,8,1,1
2022-07-10,Can Tho City,Cai Rang District,15,12,10,2,0
2022-07-10,Can Tho City,Cai Rang District,16,11,9,2,1
2022-07-10,Can Tho City,Cai Rang District,17,11,10,1,0
2022-07-10,Can Tho City,Cai Rang District,18,14,12,2,0
2022-07-10,Can Tho City,Cai Rang District,19,12,10,2,0
2022-07-10,Can Tho City,Cai Rang District,20,5,5,0,0
2022-07-10,Can Tho City,Cai Rang District,21,2,1,1,0
2022-07-10,Can Tho City,Cai Rang District,22,2,2,0,0
2022-07-10,Can Tho City,Cai Rang District,23,1,1,0,0
2022-07-10,Can Tho City,Ninh Kieu District,0,2,2,0,0
2022-07-10,Can Tho City,Ninh Kieu District,2,1,1,0,0
2022-07-10,Can Tho City,Ninh Kieu District,3,1,1,0,0
2022-07-10,Can Tho City,Ninh Kieu District,4,3,3,0,0
2022-07-10,Can Tho City,Ninh Kieu District,5,4,2,2,0
2022-07-10,Can Tho City,Ninh Kieu District,6,49,42,7,1
2022-07-10,Can Tho City,Ninh Kieu District,7,121,108,13,1
2022-07-10,Can Tho City,Ninh Kieu District,8,199,185,14,0
2022-07-10,Can Tho City,Ninh Kieu District,9,338,316,22,0
2022-07-10,Can Tho City,Ninh Kieu District,10,491,462,29,0
2022-07-10,Can Tho City,Ninh Kieu District,11,633,592,41,2
2022-07-10,Can Tho City,Ninh Kieu District,12,573,553,20,0
2022-07-10,Can Tho City,Ninh Kieu District,13,451,424,27,0
2022-07-10,Can Tho City,Ninh Kieu District,14,440,420,20,0
2022-07-10,Can Tho City,Ninh Kieu District,15,385,368,17,0
2022-07-10,Can Tho City,Ninh Kieu District,16,473,442,31,0
2022-07-10,Can Tho City,Ninh Kieu District,17,563,541,22,0
2022-07-10,Can Tho City,Ninh Kieu District,18,622,590,32,1
2022-07-10,Can Tho City,Ninh Kieu District,19,512,466,46,4
2022-07-10,Can Tho City,Ninh Kieu District,20,417,388,29,12
2022-07-10,Can Tho City,Ninh Kieu District,21,202,181,21,4
2022-07-10,Can Tho City,Ninh Kieu District,22,43,34,9,0
2022-07-10,Can Tho City,Ninh Kieu District,23,11,8,3,0
2022-07-10,Can Tho City,Phong Dien,16,1,0,1,1
2022-07-10,Can Tho City,Phong Dien,20,2,0,2,2
2022-07-10,Dong Nai,Bien Hoa City,0,3,1,2,1
2022-07-10,Dong Nai,Bien Hoa City,1,2,1,1,0
2022-07-10,Dong Nai,Bien Hoa City,2,1,0,1,0
2022-07-10,Dong Nai,Bien Hoa City,3,1,0,1,0
2022-07-10,Dong Nai,Bien Hoa City,4,1,0,1,0
2022-07-10,Dong Nai,Bien Hoa City,5,2,1,1,0
2022-07-10,Dong Nai,Bien Hoa City,6,47,36,11,9
2022-07-10,Dong Nai,Bien Hoa City,7,139,125,14,6
2022-07-10,Dong Nai,Bien Hoa City,8,307,255,52,16
2022-07-10,Dong Nai,Bien Hoa City,9,491,449,42,8
2022-07-10,Dong Nai,Bien Hoa City,10,823,751,72,17
2022-07-10,Dong Nai,Bien Hoa City,11,1163,1044,119,30
2022-07-10,Dong Nai,Bien Hoa City,12,1153,1041,112,20
2022-07-10,Dong Nai,Bien Hoa City,13,846,780,66,9
2022-07-10,Dong Nai,Bien Hoa City,14,643,581,62,10
2022-07-10,Dong Nai,Bien Hoa City,15,576,519,57,14
2022-07-10,Dong Nai,Bien Hoa City,16,618,532,86,42
2022-07-10,Dong Nai,Bien Hoa City,17,852,711,141,64
2022-07-10,Dong Nai,Bien Hoa City,18,929,715,214,121
2022-07-10,Dong Nai,Bien Hoa City,19,813,644,169,97
2022-07-10,Dong Nai,Bien Hoa City,20,573,454,119,66
2022-07-10,Dong Nai,Bien Hoa City,21,236,189,47,12
2022-07-10,Dong Nai,Bien Hoa City,22,42,25,17,5
2022-07-10,Dong Nai,Bien Hoa City,23,10,5,5,2
2022-07-10,Dong Nai,Long Khanh,6,1,0,1,1
2022-07-10,Dong Nai,Long Khanh,11,4,0,4,4
2022-07-10,Dong Nai,Long Khanh,12,2,0,2,2
2022-07-10,Dong Nai,Long Khanh,13,2,0,2,1
2022-07-10,Dong Nai,Long Khanh,14,2,0,2,2
2022-07-10,Dong Nai,Long Khanh,18,1,0,1,1
2022-07-10,Dong Nai,Long Khanh,19,1,0,1,1
2022-07-10,Dong Nai,Long Thanh,10,2,0,2,2
2022-07-10,Dong Nai,Long Thanh,11,1,0,1,1
2022-07-10,Dong Nai,Long Thanh,13,1,0,1,1
2022-07-10,Dong Nai,Long Thanh,15,2,0,2,2
2022-07-10,Dong Nai,Long Thanh,16,1,0,1,1
2022-07-10,Dong Nai,Long Thanh,17,1,0,1,1
2022-07-10,Dong Nai,Long Thanh,18,3,0,3,3
2022-07-10,Dong Nai,Long Thanh,19,4,0,4,4
2022-07-10,Dong Nai,Long Thanh,20,3,0,3,3
2022-07-10,Dong Nai,Nhon trach,11,2,0,2,1
2022-07-10,Dong Nai,Nhon trach,17,1,0,1,1
2022-07-10,Dong Nai,Nhon trach,19,1,0,1,1
2022-07-10,Dong Nai,Nhon trach,20,1,0,1,1
2022-07-10,Dong Nai,Trang Bom,10,1,1,0,0
2022-07-10,Dong Nai,Trang Bom,11,1,0,1,1
2022-07-10,Dong Nai,Trang Bom,12,1,1,0,0
2022-07-10,Dong Nai,Trang Bom,13,1,0,1,1
2022-07-10,Dong Nai,Trang Bom,14,2,0,2,2
2022-07-10,Dong Nai,Trang Bom,19,3,0,3,2
2022-07-10,Dong Nai,Trang Bom,20,1,1,0,0
2022-07-10,Dong Nai,Trang Bom,21,1,0,1,1
2022-07-10,Hai Phong City,An Duong,9,5,1,4,3
2022-07-10,Hai Phong City,An Duong,10,6,0,6,6
2022-07-10,Hai Phong City,An Duong,11,9,5,4,3
2022-07-10,Hai Phong City,An Duong,12,6,1,5,5
2022-07-10,Hai Phong City,An Duong,13,2,1,1,1
2022-07-10,Hai Phong City,An Duong,14,2,0,2,1
2022-07-10,Hai Phong City,An Duong,15,1,0,1,1
2022-07-10,Hai Phong City,An Duong,16,2,1,1,1
2022-07-10,Hai Phong City,An Duong,17,3,1,2,2
2022-07-10,Hai Phong City,An Duong,20,4,0,4,1
2022-07-10,Hai Phong City,Duong Kinh District,14,1,0,1,1
2022-07-10,Hai Phong City,Hai An District,6,1,0,1,0
2022-07-10,Hai Phong City,Hai An District,7,6,3,3,3
2022-07-10,Hai Phong City,Hai An District,8,13,9,4,2
2022-07-10,Hai Phong City,Hai An District,9,13,10,3,1
2022-07-10,Hai Phong City,Hai An District,10,28,26,2,1
2022-07-10,Hai Phong City,Hai An District,11,39,30,9,3
2022-07-10,Hai Phong City,Hai An District,12,38,28,10,5
2022-07-10,Hai Phong City,Hai An District,13,21,17,4,3
2022-07-10,Hai Phong City,Hai An District,14,11,7,4,2
2022-07-10,Hai Phong City,Hai An District,15,11,9,2,0
2022-07-10,Hai Phong City,Hai An District,16,12,9,3,1
2022-07-10,Hai Phong City,Hai An District,17,13,9,4,3
2022-07-10,Hai Phong City,Hai An District,18,27,22,5,0
2022-07-10,Hai Phong City,Hai An District,19,20,15,5,3
2022-07-10,Hai Phong City,Hai An District,20,22,13,9,5
2022-07-10,Hai Phong City,Hai An District,21,12,6,6,4
2022-07-10,Hai Phong City,Hai An District,22,1,0,1,1
2022-07-10,Hai Phong City,Hai An District,23,1,0,1,1
2022-07-10,Hai Phong City,Hong Bang District,6,2,1,1,0
2022-07-10,Hai Phong City,Hong Bang District,7,12,11,1,1
2022-07-10,Hai Phong City,Hong Bang District,8,19,13,6,1
2022-07-10,Hai Phong City,Hong Bang District,9,39,31,8,1
2022-07-10,Hai Phong City,Hong Bang District,10,84,68,16,13
2022-07-10,Hai Phong City,Hong Bang District,11,130,87,43,34
2022-07-10,Hai Phong City,Hong Bang District,12,97,75,22,15
2022-07-10,Hai Phong City,Hong Bang District,13,44,38,6,1
2022-07-10,Hai Phong City,Hong Bang District,14,46,34,12,3
2022-07-10,Hai Phong City,Hong Bang District,15,30,27,3,1
2022-07-10,Hai Phong City,Hong Bang District,16,28,23,5,3
2022-07-10,Hai Phong City,Hong Bang District,17,37,24,13,9
2022-07-10,Hai Phong City,Hong Bang District,18,59,37,22,10
2022-07-10,Hai Phong City,Hong Bang District,19,74,44,30,21
2022-07-10,Hai Phong City,Hong Bang District,20,36,20,16,14
2022-07-10,Hai Phong City,Hong Bang District,21,17,11,6,1
2022-07-10,Hai Phong City,Hong Bang District,22,2,1,1,1
2022-07-10,Hai Phong City,Kien An District,0,1,0,1,1
2022-07-10,Hai Phong City,Kien An District,8,1,0,1,1
2022-07-10,Hai Phong City,Kien An District,9,7,3,4,2
2022-07-10,Hai Phong City,Kien An District,10,17,12,5,5
2022-07-10,Hai Phong City,Kien An District,11,27,13,14,10
2022-07-10,Hai Phong City,Kien An District,12,12,6,6,5
2022-07-10,Hai Phong City,Kien An District,13,6,3,3,1
2022-07-10,Hai Phong City,Kien An District,14,9,6,3,2
2022-07-10,Hai Phong City,Kien An District,15,7,4,3,3
2022-07-10,Hai Phong City,Kien An District,16,17,11,6,4
2022-07-10,Hai Phong City,Kien An District,17,11,8,3,2
2022-07-10,Hai Phong City,Kien An District,18,10,6,4,2
2022-07-10,Hai Phong City,Kien An District,19,8,6,2,0
2022-07-10,Hai Phong City,Kien An District,20,9,6,3,2
2022-07-10,Hai Phong City,Kien An District,21,10,1,9,5
2022-07-10,Hai Phong City,Kien An District,23,1,0,1,1
2022-07-10,Hai Phong City,Le Chan District,0,3,1,2,0
2022-07-10,Hai Phong City,Le Chan District,6,1,0,1,1
2022-07-10,Hai Phong City,Le Chan District,7,30,21,9,4
2022-07-10,Hai Phong City,Le Chan District,8,81,63,18,8
2022-07-10,Hai Phong City,Le Chan District,9,103,84,19,6
2022-07-10,Hai Phong City,Le Chan District,10,247,192,55,22
2022-07-10,Hai Phong City,Le Chan District,11,416,294,122,85
2022-07-10,Hai Phong City,Le Chan District,12,298,221,77,35
2022-07-10,Hai Phong City,Le Chan District,13,147,124,23,3
2022-07-10,Hai Phong City,Le Chan District,14,148,116,32,11
2022-07-10,Hai Phong City,Le Chan District,15,164,138,26,7
2022-07-10,Hai Phong City,Le Chan District,16,199,146,53,23
2022-07-10,Hai Phong City,Le Chan District,17,200,159,41,17
2022-07-10,Hai Phong City,Le Chan District,18,287,215,72,41
2022-07-10,Hai Phong City,Le Chan District,19,275,171,104,75
2022-07-10,Hai Phong City,Le Chan District,20,179,128,51,32
2022-07-10,Hai Phong City,Le Chan District,21,86,55,31,12
2022-07-10,Hai Phong City,Le Chan District,22,17,5,12,5
2022-07-10,Hai Phong City,Le Chan District,23,8,2,6,4
2022-07-10,Hai Phong City,Ngo Quyen District,0,1,0,1,1
2022-07-10,Hai Phong City,Ngo Quyen District,4,1,0,1,0
2022-07-10,Hai Phong City,Ngo Quyen District,6,2,0,2,2
2022-07-10,Hai Phong City,Ngo Quyen District,7,25,16,9,6
2022-07-10,Hai Phong City,Ngo Quyen District,8,62,46,16,5
2022-07-10,Hai Phong City,Ngo Quyen District,9,82,72,10,2
2022-07-10,Hai Phong City,Ngo Quyen District,10,193,157,36,17
2022-07-10,Hai Phong City,Ngo Quyen District,11,339,248,91,66
2022-07-10,Hai Phong City,Ngo Quyen District,12,219,174,45,17
2022-07-10,Hai Phong City,Ngo Quyen District,13,128,108,20,4
2022-07-10,Hai Phong City,Ngo Quyen District,14,118,102,16,3
2022-07-10,Hai Phong City,Ngo Quyen District,15,115,99,16,2
2022-07-10,Hai Phong City,Ngo Quyen District,16,155,119,36,17
2022-07-10,Hai Phong City,Ngo Quyen District,17,169,134,35,11
2022-07-10,Hai Phong City,Ngo Quyen District,18,196,148,48,17
2022-07-10,Hai Phong City,Ngo Quyen District,19,217,143,74,41
2022-07-10,Hai Phong City,Ngo Quyen District,20,159,113,46,26
2022-07-10,Hai Phong City,Ngo Quyen District,21,86,55,31,14
2022-07-10,Hai Phong City,Ngo Quyen District,22,11,4,7,2
2022-07-10,Hai Phong City,Ngo Quyen District,23,4,1,3,3
2022-07-10,Hai Phong City,Thuy Nguyen,9,1,1,0,0
2022-07-10,Hai Phong City,Thuy Nguyen,10,1,0,1,1
2022-07-10,Hai Phong City,Thuy Nguyen,11,3,0,3,3
2022-07-10,Hai Phong City,Thuy Nguyen,17,2,0,2,1
2022-07-10,Hai Phong City,Thuy Nguyen,19,1,0,1,1
2022-07-10,Hai Phong City,Thuy Nguyen,20,1,0,1,1
2022-07-10,Hai Phong City,Thuy Nguyen,21,1,0,1,0
2022-07-10,Hue City,Hue City,0,3,1,2,0
2022-07-10,Hue City,Hue City,1,2,0,2,1
2022-07-10,Hue City,Hue City,5,6,3,3,0
2022-07-10,Hue City,Hue City,6,72,66,6,1
2022-07-10,Hue City,Hue City,7,214,187,27,2
2022-07-10,Hue City,Hue City,8,330,306,24,1
2022-07-10,Hue City,Hue City,9,316,290,26,0
2022-07-10,Hue City,Hue City,10,448,410,38,1
2022-07-10,Hue City,Hue City,11,880,790,90,6
2022-07-10,Hue City,Hue City,12,633,591,42,0
2022-07-10,Hue City,Hue City,13,482,421,61,10
2022-07-10,Hue City,Hue City,14,469,385,84,24
2022-07-10,Hue City,Hue City,15,550,453,97,28
2022-07-10,Hue City,Hue City,16,501,446,55,7
2022-07-10,Hue City,Hue City,17,512,466,46,2
2022-07-10,Hue City,Hue City,18,629,529,100,9
2022-07-10,Hue City,Hue City,19,632,516,116,20
2022-07-10,Hue City,Hue City,20,495,407,88,22
2022-07-10,Hue City,Hue City,21,325,216,109,45
2022-07-10,Hue City,Hue City,22,58,37,21,3
2022-07-10,Hue City,Hue City,23,20,12,8,0
2022-07-10,Hue City,Huong Thuy,7,1,1,0,0
2022-07-10,Hue City,Huong Thuy,8,1,1,0,0
2022-07-10,Hue City,Huong Thuy,11,8,3,5,0
2022-07-10,Hue City,Huong Thuy,13,1,0,1,1
2022-07-10,Hue City,Huong Thuy,14,5,2,3,2
2022-07-10,Hue City,Huong Thuy,15,1,0,1,0
2022-07-10,Hue City,Huong Thuy,17,4,0,4,4
2022-07-10,Hue City,Huong Thuy,18,6,2,4,1
2022-07-10,Hue City,Huong Thuy,19,5,3,2,0
2022-07-10,Hue City,Huong Thuy,20,1,1,0,0
2022-07-10,Hue City,Huong Tra,11,1,1,0,0
2022-07-10,Hue City,Huong Tra,15,1,1,0,0
2022-07-10,Hue City,Huong Tra,16,1,0,1,0
2022-07-10,Hue City,Huong Tra,19,1,1,0,0
2022-07-10,Hue City,Huong Tra,21,1,1,0,0
2022-07-10,Hue City,Phu Vang,8,3,1,2,1
2022-07-10,Hue City,Phu Vang,9,4,2,2,1
2022-07-10,Hue City,Phu Vang,10,1,1,0,0
2022-07-10,Hue City,Phu Vang,11,5,3,2,0
2022-07-10,Hue City,Phu Vang,13,4,3,1,0
2022-07-10,Hue City,Phu Vang,14,1,1,0,0
2022-07-10,Hue City,Phu Vang,15,2,2,0,0
2022-07-10,Hue City,Phu Vang,16,2,1,1,0
2022-07-10,Hue City,Phu Vang,17,3,2,1,0
2022-07-10,Hue City,Phu Vang,18,2,2,0,0
2022-07-10,Hue City,Phu Vang,19,2,2,0,0
2022-07-10,Hue City,Phu Vang,20,1,1,0,0
2022-07-10,Khanh Hoa,Dien Khanh,7,1,0,1,0
2022-07-10,Khanh Hoa,Dien Khanh,11,1,0,1,0
2022-07-10,Khanh Hoa,Dien Khanh,15,1,0,1,1
2022-07-10,Khanh Hoa,Nha Trang City,0,2,2,0,0
2022-07-10,Khanh Hoa,Nha Trang City,1,1,0,1,0
2022-07-10,Khanh Hoa,Nha Trang City,4,1,1,0,0
2022-07-10,Khanh Hoa,Nha Trang City,5,3,1,2,0
2022-07-10,Khanh Hoa,Nha Trang City,6,36,32,4,4
2022-07-10,Khanh Hoa,Nha Trang City,7,147,133,14,6
2022-07-10,Khanh Hoa,Nha Trang City,8,215,194,21,1
2022-07-10,Khanh Hoa,Nha Trang City,9,208,188,20,0
2022-07-10,Khanh Hoa,Nha Trang City,10,287,260,27,6
2022-07-10,Khanh Hoa,Nha Trang City,11,378,351,27,3
2022-07-10,Khanh Hoa,Nha Trang City,12,302,284,18,1
2022-07-10,Khanh Hoa,Nha Trang City,13,230,208,22,0
2022-07-10,Khanh Hoa,Nha Trang City,14,235,214,21,2
2022-07-10,Khanh Hoa,Nha Trang City,15,230,212,18,1
2022-07-10,Khanh Hoa,Nha Trang City,16,213,194,19,1
2022-07-10,Khanh Hoa,Nha Trang City,17,327,293,34,1
2022-07-10,Khanh Hoa,Nha Trang City,18,350,313,37,7
2022-07-10,Khanh Hoa,Nha Trang City,19,324,262,62,16
2022-07-10,Khanh Hoa,Nha Trang City,20,208,177,31,1
2022-07-10,Khanh Hoa,Nha Trang City,21,128,105,23,4
2022-07-10,Khanh Hoa,Nha Trang City,22,30,17,13,3
2022-07-10,Khanh Hoa,Nha Trang City,23,9,5,4,3
2022-07-10,Lam Dong,Da Lat City,0,1,0,1,0
2022-07-10,Lam Dong,Da Lat City,3,2,0,2,1
2022-07-10,Lam Dong,Da Lat City,5,1,0,1,0
2022-07-10,Lam Dong,Da Lat City,6,10,2,8,8
2022-07-10,Lam Dong,Da Lat City,7,110,9,101,87
2022-07-10,Lam Dong,Da Lat City,8,204,51,153,133
2022-07-10,Lam Dong,Da Lat City,9,146,76,70,52
2022-07-10,Lam Dong,Da Lat City,10,133,95,38,25
2022-07-10,Lam Dong,Da Lat City,11,181,117,64,50
2022-07-10,Lam Dong,Da Lat City,12,161,110,51,34
2022-07-10,Lam Dong,Da Lat City,13,140,102,38,25
2022-07-10,Lam Dong,Da Lat City,14,134,94,40,30
2022-07-10,Lam Dong,Da Lat City,15,120,71,49,40
2022-07-10,Lam Dong,Da Lat City,16,181,86,95,73
2022-07-10,Lam Dong,Da Lat City,17,225,94,131,100
2022-07-10,Lam Dong,Da Lat City,18,438,98,340,298
2022-07-10,Lam Dong,Da Lat City,19,478,94,384,341
2022-07-10,Lam Dong,Da Lat City,20,324,74,250,220
2022-07-10,Lam Dong,Da Lat City,21,147,42,105,93
2022-07-10,Lam Dong,Da Lat City,22,65,17,48,41
2022-07-10,Lam Dong,Da Lat City,23,27,9,18,15
2022-07-10,Nghe An,Vinh City,2,1,1,0,0
2022-07-10,Nghe An,Vinh City,5,1,1,0,0
2022-07-10,Nghe An,Vinh City,6,5,3,2,0
2022-07-10,Nghe An,Vinh City,7,110,74,36,21
2022-07-10,Nghe An,Vinh City,8,189,129,60,32
2022-07-10,Nghe An,Vinh City,9,172,126,46,25
2022-07-10,Nghe An,Vinh City,10,291,154,137,101
2022-07-10,Nghe An,Vinh City,11,479,270,209,160
2022-07-10,Nghe An,Vinh City,12,290,200,90,63
2022-07-10,Nghe An,Vinh City,13,159,124,35,14
2022-07-10,Nghe An,Vinh City,14,185,133,52,26
2022-07-10,Nghe An,Vinh City,15,245,154,91,55
2022-07-10,Nghe An,Vinh City,16,189,133,56,36
2022-07-10,Nghe An,Vinh City,17,192,139,53,35
2022-07-10,Nghe An,Vinh City,18,247,163,84,53
2022-07-10,Nghe An,Vinh City,19,229,143,86,62
2022-07-10,Nghe An,Vinh City,20,183,103,80,59
2022-07-10,Nghe An,Vinh City,21,125,64,61,39
2022-07-10,Nghe An,Vinh City,22,29,4,25,11
2022-07-10,Nghe An,Vinh City,23,10,0,10,7
2022-07-10,Quang Nam,Hoi An City,6,3,0,3,1
2022-07-10,Quang Nam,Hoi An City,7,26,13,13,8
2022-07-10,Quang Nam,Hoi An City,8,52,19,33,26
2022-07-10,Quang Nam,Hoi An City,9,47,26,21,11
2022-07-10,Quang Nam,Hoi An City,10,47,22,25,14
2022-07-10,Quang Nam,Hoi An City,11,104,31,73,64
2022-07-10,Quang Nam,Hoi An City,12,104,27,77,66
2022-07-10,Quang Nam,Hoi An City,13,63,17,46,35
2022-07-10,Quang Nam,Hoi An City,14,62,24,38,35
2022-07-10,Quang Nam,Hoi An City,15,47,27,20,13
2022-07-10,Quang Nam,Hoi An City,16,67,25,42,32
2022-07-10,Quang Nam,Hoi An City,17,67,34,33,25
2022-07-10,Quang Nam,Hoi An City,18,92,32,60,45
2022-07-10,Quang Nam,Hoi An City,19,68,40,28,18
2022-07-10,Quang Nam,Hoi An City,20,61,34,27,15
2022-07-10,Quang Nam,Hoi An City,21,42,9,33,23
2022-07-10,Quang Nam,Hoi An City,22,5,0,5,5
2022-07-10,Quang Nam,Hoi An City,23,3,0,3,3
2022-07-10,Quang Ninh,Cam Pha City,10,2,0,2,1
2022-07-10,Quang Ninh,Cam Pha City,11,2,0,2,2
2022-07-10,Quang Ninh,Cam Pha City,14,1,0,1,1
2022-07-10,Quang Ninh,Cam Pha City,16,1,0,1,1
2022-07-10,Quang Ninh,Cam Pha City,18,2,0,2,0
2022-07-10,Quang Ninh,Ha Long City,0,1,1,0,0
2022-07-10,Quang Ninh,Ha Long City,5,1,0,1,1
2022-07-10,Quang Ninh,Ha Long City,6,2,1,1,0
2022-07-10,Quang Ninh,Ha Long City,7,21,13,8,5
2022-07-10,Quang Ninh,Ha Long City,8,53,26,27,16
2022-07-10,Quang Ninh,Ha Long City,9,48,32,16,11
2022-07-10,Quang Ninh,Ha Long City,10,117,81,36,17
2022-07-10,Quang Ninh,Ha Long City,11,163,107,56,38
2022-07-10,Quang Ninh,Ha Long City,12,112,78,34,19
2022-07-10,Quang Ninh,Ha Long City,13,86,54,32,19
2022-07-10,Quang Ninh,Ha Long City,14,60,38,22,14
2022-07-10,Quang Ninh,Ha Long City,15,82,54,28,20
2022-07-10,Quang Ninh,Ha Long City,16,65,55,10,4
2022-07-10,Quang Ninh,Ha Long City,17,63,46,17,8
2022-07-10,Quang Ninh,Ha Long City,18,79,59,20,14
2022-07-10,Quang Ninh,Ha Long City,19,70,52,18,10
2022-07-10,Quang Ninh,Ha Long City,20,52,28,24,18
2022-07-10,Quang Ninh,Ha Long City,21,43,10,33,26
2022-07-10,Quang Ninh,Ha Long City,22,26,3,23,19
2022-07-10,Quang Ninh,Ha Long City,23,4,2,2,2
2022-07-10,Thai Nguyen,Dong Hy,7,2,0,2,2
2022-07-10,Thai Nguyen,Dong Hy,11,2,1,1,1
2022-07-10,Thai Nguyen,Dong Hy,18,1,1,0,0
2022-07-10,Thai Nguyen,Thai Nguyen City,0,2,2,0,0
2022-07-10,Thai Nguyen,Thai Nguyen City,6,11,7,4,0
2022-07-10,Thai Nguyen,Thai Nguyen City,7,83,75,8,1
2022-07-10,Thai Nguyen,Thai Nguyen City,8,153,134,19,1
2022-07-10,Thai Nguyen,Thai Nguyen City,9,142,134,8,1
2022-07-10,Thai Nguyen,Thai Nguyen City,10,238,215,23,1
2022-07-10,Thai Nguyen,Thai Nguyen City,11,374,347,27,3
2022-07-10,Thai Nguyen,Thai Nguyen City,12,319,291,28,3
2022-07-10,Thai Nguyen,Thai Nguyen City,13,158,144,14,4
2022-07-10,Thai Nguyen,Thai Nguyen City,14,184,168,16,0
2022-07-10,Thai Nguyen,Thai Nguyen City,15,198,183,15,0
2022-07-10,Thai Nguyen,Thai Nguyen City,16,196,179,17,2
2022-07-10,Thai Nguyen,Thai Nguyen City,17,169,163,6,0
2022-07-10,Thai Nguyen,Thai Nguyen City,18,222,206,16,1
2022-07-10,Thai Nguyen,Thai Nguyen City,19,264,237,27,1
2022-07-10,Thai Nguyen,Thai Nguyen City,20,223,195,28,3
2022-07-10,Thai Nguyen,Thai Nguyen City,21,140,119,21,1
2022-07-10,Thai Nguyen,Thai Nguyen City,22,26,22,4,0
2022-07-10,Thai Nguyen,Thai Nguyen City,23,7,3,4,2
2022-07-10,Vung Tau,Ba Ria City,0,1,0,1,0
2022-07-10,Vung Tau,Ba Ria City,7,2,0,2,1
2022-07-10,Vung Tau,Ba Ria City,8,3,2,1,1
2022-07-10,Vung Tau,Ba Ria City,9,6,3,3,1
2022-07-10,Vung Tau,Ba Ria City,10,7,6,1,1
2022-07-10,Vung Tau,Ba Ria City,11,14,9,5,4
2022-07-10,Vung Tau,Ba Ria City,12,11,7,4,2
2022-07-10,Vung Tau,Ba Ria City,13,7,3,4,2
2022-07-10,Vung Tau,Ba Ria City,14,4,3,1,0
2022-07-10,Vung Tau,Ba Ria City,15,3,3,0,0
2022-07-10,Vung Tau,Ba Ria City,16,4,4,0,0
2022-07-10,Vung Tau,Ba Ria City,17,8,4,4,3
2022-07-10,Vung Tau,Ba Ria City,18,12,3,9,8
2022-07-10,Vung Tau,Ba Ria City,19,13,3,10,8
2022-07-10,Vung Tau,Ba Ria City,20,7,0,7,6
2022-07-10,Vung Tau,Ba Ria City,22,2,0,2,2
2022-07-10,Vung Tau,Chau Duc,13,1,0,1,0
2022-07-10,Vung Tau,Vung Tau City,0,2,1,1,0
2022-07-10,Vung Tau,Vung Tau City,1,3,0,3,0
2022-07-10,Vung Tau,Vung Tau City,2,1,1,0,0
2022-07-10,Vung Tau,Vung Tau City,5,1,0,1,1
2022-07-10,Vung Tau,Vung Tau City,6,39,27,12,3
2022-07-10,Vung Tau,Vung Tau City,7,158,110,48,29
2022-07-10,Vung Tau,Vung Tau City,8,263,192,71,44
2022-07-10,Vung Tau,Vung Tau City,9,325,262,63,30
2022-07-10,Vung Tau,Vung Tau City,10,318,275,43,16
2022-07-10,Vung Tau,Vung Tau City,11,420,385,35,5
2022-07-10,Vung Tau,Vung Tau City,12,449,409,40,13
2022-07-10,Vung Tau,Vung Tau City,13,312,278,34,6
2022-07-10,Vung Tau,Vung Tau City,14,274,251,23,3
2022-07-10,Vung Tau,Vung Tau City,15,278,253,25,3
2022-07-10,Vung Tau,Vung Tau City,16,317,266,51,22
2022-07-10,Vung Tau,Vung Tau City,17,391,327,64,31
2022-07-10,Vung Tau,Vung Tau City,18,407,322,85,44
2022-07-10,Vung Tau,Vung Tau City,19,347,283,64,31
2022-07-10,Vung Tau,Vung Tau City,20,270,218,52,21
2022-07-10,Vung Tau,Vung Tau City,21,124,93,31,12
2022-07-10,Vung Tau,Vung Tau City,22,32,20,12,3
2022-07-10,Vung Tau,Vung Tau City,23,10,4,6,3
2022-07-11,Bac Ninh,Bác Ninh City,0,5,0,5,2
2022-07-11,Bac Ninh,Bác Ninh City,1,3,0,3,3
2022-07-11,Bac Ninh,Bác Ninh City,3,2,1,1,1
2022-07-11,Bac Ninh,Bác Ninh City,5,2,0,2,0
2022-07-11,Bac Ninh,Bác Ninh City,6,13,8,5,3
2022-07-11,Bac Ninh,Bác Ninh City,7,79,73,6,1
2022-07-11,Bac Ninh,Bác Ninh City,8,137,129,8,1
2022-07-11,Bac Ninh,Bác Ninh City,9,114,106,8,1
2022-07-11,Bac Ninh,Bác Ninh City,10,158,142,16,2
2022-07-11,Bac Ninh,Bác Ninh City,11,295,277,18,5
2022-07-11,Bac Ninh,Bác Ninh City,12,221,212,9,0
2022-07-11,Bac Ninh,Bác Ninh City,13,165,148,17,3
2022-07-11,Bac Ninh,Bác Ninh City,14,156,145,11,0
2022-07-11,Bac Ninh,Bác Ninh City,15,156,142,14,1
2022-07-11,Bac Ninh,Bác Ninh City,16,100,95,5,0
2022-07-11,Bac Ninh,Bác Ninh City,17,140,128,12,1
2022-07-11,Bac Ninh,Bác Ninh City,18,140,130,10,0
2022-07-11,Bac Ninh,Bác Ninh City,19,164,144,20,2
2022-07-11,Bac Ninh,Bác Ninh City,20,134,118,16,2
2022-07-11,Bac Ninh,Bác Ninh City,21,80,71,9,2
2022-07-11,Bac Ninh,Bác Ninh City,22,16,13,3,2
2022-07-11,Bac Ninh,Bác Ninh City,23,6,3,3,1
2022-07-11,Bac Ninh,Que Vo,10,1,0,1,1
2022-07-11,Bac Ninh,Que Vo,12,1,0,1,1
2022-07-11,Bac Ninh,Que Vo,13,1,0,1,1
2022-07-11,Bac Ninh,Que Vo,15,1,1,0,0
2022-07-11,Bac Ninh,Que Vo,17,1,0,1,1
2022-07-11,Bac Ninh,Que Vo,21,2,0,2,2
2022-07-11,Bac Ninh,Tien Du,3,2,0,2,2
2022-07-11,Bac Ninh,Tien Du,6,1,0,1,1
2022-07-11,Bac Ninh,Tien Du,11,1,0,1,1
2022-07-11,Bac Ninh,Tien Du,13,1,0,1,1
2022-07-11,Bac Ninh,Tien Du,15,1,0,1,0
2022-07-11,Bac Ninh,Tien Du,20,1,0,1,1
2022-07-11,Bac Ninh,Tien Du,21,1,0,1,1
2022-07-11,Bac Ninh,Tien Du,22,2,0,2,1
2022-07-11,Bac Ninh,Tu Son,9,2,0,2,1
2022-07-11,Bac Ninh,Tu Son,10,1,0,1,0
2022-07-11,Bac Ninh,Tu Son,11,1,0,1,1
2022-07-11,Bac Ninh,Tu Son,14,3,0,3,3
2022-07-11,Bac Ninh,Tu Son,15,3,1,2,2
2022-07-11,Bac Ninh,Tu Son,18,2,0,2,1
2022-07-11,Bac Ninh,Tu Son,19,1,0,1,1
2022-07-11,Bac Ninh,Tu Son,20,3,0,3,2
2022-07-11,Binh Duong,Ben Cat,7,1,0,1,1
2022-07-11,Binh Duong,Ben Cat,8,2,0,2,2
2022-07-11,Binh Duong,Ben Cat,9,1,0,1,1
2022-07-11,Binh Duong,Ben Cat,10,2,0,2,1
2022-07-11,Binh Duong,Ben Cat,12,3,0,3,2
2022-07-11,Binh Duong,Ben Cat,15,2,0,2,2
2022-07-11,Binh Duong,Ben Cat,16,1,0,1,1
2022-07-11,Binh Duong,Ben Cat,18,1,0,1,1
2022-07-11,Binh Duong,Ben Cat,19,2,0,2,2
2022-07-11,Binh Duong,Ben Cat,20,1,0,1,1
2022-07-11,Binh Duong,Di An,1,1,0,1,1
2022-07-11,Binh Duong,Di An,3,2,0,2,2
2022-07-11,Binh Duong,Di An,4,1,1,0,0
2022-07-11,Binh Duong,Di An,6,3,0,3,3
2022-07-11,Binh Duong,Di An,7,8,0,8,4
2022-07-11,Binh Duong,Di An,8,17,6,11,10
2022-07-11,Binh Duong,Di An,9,34,20,14,12
2022-07-11,Binh Duong,Di An,10,31,28,3,2
2022-07-11,Binh Duong,Di An,11,36,27,9,3
2022-07-11,Binh Duong,Di An,12,42,38,4,1
2022-07-11,Binh Duong,Di An,13,56,38,18,11
2022-07-11,Binh Duong,Di An,14,39,31,8,5
2022-07-11,Binh Duong,Di An,15,25,19,6,3
2022-07-11,Binh Duong,Di An,16,19,15,4,1
2022-07-11,Binh Duong,Di An,17,33,22,11,4
2022-07-11,Binh Duong,Di An,18,29,23,6,5
2022-07-11,Binh Duong,Di An,19,39,26,13,5
2022-07-11,Binh Duong,Di An,20,26,15,11,10
2022-07-11,Binh Duong,Di An,21,16,8,8,7
2022-07-11,Binh Duong,Di An,22,8,1,7,5
2022-07-11,Binh Duong,Di An,23,1,0,1,1
2022-07-11,Binh Duong,Tan Uyen,10,2,1,1,1
2022-07-11,Binh Duong,Tan Uyen,11,2,0,2,0
2022-07-11,Binh Duong,Tan Uyen,13,3,0,3,1
2022-07-11,Binh Duong,Tan Uyen,14,1,0,1,0
2022-07-11,Binh Duong,Tan Uyen,15,1,0,1,1
2022-07-11,Binh Duong,Tan Uyen,16,2,1,1,1
2022-07-11,Binh Duong,Tan Uyen,18,2,2,0,0
2022-07-11,Binh Duong,Tan Uyen,20,5,2,3,1
2022-07-11,Binh Duong,Thu Dau Mot Town,0,2,1,1,0
2022-07-11,Binh Duong,Thu Dau Mot Town,1,1,1,0,0
2022-07-11,Binh Duong,Thu Dau Mot Town,2,2,0,2,2
2022-07-11,Binh Duong,Thu Dau Mot Town,3,1,0,1,1
2022-07-11,Binh Duong,Thu Dau Mot Town,4,1,1,0,0
2022-07-11,Binh Duong,Thu Dau Mot Town,5,3,0,3,2
2022-07-11,Binh Duong,Thu Dau Mot Town,6,34,22,12,10
2022-07-11,Binh Duong,Thu Dau Mot Town,7,108,102,6,0
2022-07-11,Binh Duong,Thu Dau Mot Town,8,228,214,14,2
2022-07-11,Binh Duong,Thu Dau Mot Town,9,259,243,16,4
2022-07-11,Binh Duong,Thu Dau Mot Town,10,344,323,21,9
2022-07-11,Binh Duong,Thu Dau Mot Town,11,658,603,55,10
2022-07-11,Binh Duong,Thu Dau Mot Town,12,522,470,52,13
2022-07-11,Binh Duong,Thu Dau Mot Town,13,481,445,36,13
2022-07-11,Binh Duong,Thu Dau Mot Town,14,397,362,35,9
2022-07-11,Binh Duong,Thu Dau Mot Town,15,305,280,25,9
2022-07-11,Binh Duong,Thu Dau Mot Town,16,263,244,19,6
2022-07-11,Binh Duong,Thu Dau Mot Town,17,344,319,25,2
2022-07-11,Binh Duong,Thu Dau Mot Town,18,424,405,19,3
2022-07-11,Binh Duong,Thu Dau Mot Town,19,399,366,33,7
2022-07-11,Binh Duong,Thu Dau Mot Town,20,313,275,38,10
2022-07-11,Binh Duong,Thu Dau Mot Town,21,148,125,23,11
2022-07-11,Binh Duong,Thu Dau Mot Town,22,15,12,3,1
2022-07-11,Binh Duong,Thu Dau Mot Town,23,4,1,3,1
2022-07-11,Binh Duong,Thuan An,0,2,0,2,2
2022-07-11,Binh Duong,Thuan An,6,2,0,2,2
2022-07-11,Binh Duong,Thuan An,7,7,3,4,1
2022-07-11,Binh Duong,Thuan An,8,25,21,4,2
2022-07-11,Binh Duong,Thuan An,9,48,40,8,7
2022-07-11,Binh Duong,Thuan An,10,53,48,5,3
2022-07-11,Binh Duong,Thuan An,11,92,81,11,4
2022-07-11,Binh Duong,Thuan An,12,72,64,8,3
2022-07-11,Binh Duong,Thuan An,13,94,74,20,10
2022-07-11,Binh Duong,Thuan An,14,53,44,9,2
2022-07-11,Binh Duong,Thuan An,15,40,30,10,5
2022-07-11,Binh Duong,Thuan An,16,45,37,8,3
2022-07-11,Binh Duong,Thuan An,17,38,27,11,3
2022-07-11,Binh Duong,Thuan An,18,42,36,6,4
2022-07-11,Binh Duong,Thuan An,19,45,38,7,3
2022-07-11,Binh Duong,Thuan An,20,44,30,14,8
2022-07-11,Binh Duong,Thuan An,21,33,12,21,16
2022-07-11,Binh Duong,Thuan An,22,5,1,4,2
2022-07-11,Binh Duong,Thuan An,23,4,0,4,4
2022-07-11,Can Tho City,Binh Thuy District,7,2,2,0,0
2022-07-11,Can Tho City,Binh Thuy District,8,7,5,2,0
2022-07-11,Can Tho City,Binh Thuy District,9,9,8,1,0
2022-07-11,Can Tho City,Binh Thuy District,10,8,7,1,0
2022-07-11,Can Tho City,Binh Thuy District,11,12,10,2,1
2022-07-11,Can Tho City,Binh Thuy District,12,13,12,1,0
2022-07-11,Can Tho City,Binh Thuy District,13,15,15,0,0
2022-07-11,Can Tho City,Binh Thuy District,14,7,6,1,0
2022-07-11,Can Tho City,Binh Thuy District,15,6,4,2,0
2022-07-11,Can Tho City,Binh Thuy District,16,5,5,0,0
2022-07-11,Can Tho City,Binh Thuy District,17,1,1,0,0
2022-07-11,Can Tho City,Binh Thuy District,18,15,9,6,0
2022-07-11,Can Tho City,Binh Thuy District,19,5,4,1,0
2022-07-11,Can Tho City,Binh Thuy District,20,9,8,1,0
2022-07-11,Can Tho City,Binh Thuy District,21,4,3,1,0
2022-07-11,Can Tho City,Binh Thuy District,22,1,1,0,0
2022-07-11,Can Tho City,Cai Rang District,6,4,1,3,3
2022-07-11,Can Tho City,Cai Rang District,7,4,1,3,3
2022-07-11,Can Tho City,Cai Rang District,8,9,9,0,0
2022-07-11,Can Tho City,Cai Rang District,9,9,9,0,0
2022-07-11,Can Tho City,Cai Rang District,10,13,9,4,0
2022-07-11,Can Tho City,Cai Rang District,11,11,11,0,0
2022-07-11,Can Tho City,Cai Rang District,12,12,11,1,0
2022-07-11,Can Tho City,Cai Rang District,13,11,10,1,0
2022-07-11,Can Tho City,Cai Rang District,14,5,5,0,0
2022-07-11,Can Tho City,Cai Rang District,15,11,8,3,2
2022-07-11,Can Tho City,Cai Rang District,16,16,14,2,1
2022-07-11,Can Tho City,Cai Rang District,17,9,8,1,0
2022-07-11,Can Tho City,Cai Rang District,18,13,12,1,0
2022-07-11,Can Tho City,Cai Rang District,19,10,9,1,1
2022-07-11,Can Tho City,Cai Rang District,20,6,5,1,0
2022-07-11,Can Tho City,Cai Rang District,21,3,3,0,0
2022-07-11,Can Tho City,Cai Rang District,22,1,0,1,0
2022-07-11,Can Tho City,Ninh Kieu District,0,5,4,1,0
2022-07-11,Can Tho City,Ninh Kieu District,1,8,3,5,3
2022-07-11,Can Tho City,Ninh Kieu District,5,6,4,2,2
2022-07-11,Can Tho City,Ninh Kieu District,6,44,41,3,0
2022-07-11,Can Tho City,Ninh Kieu District,7,124,115,9,0
2022-07-11,Can Tho City,Ninh Kieu District,8,209,201,8,0
2022-07-11,Can Tho City,Ninh Kieu District,9,264,253,11,1
2022-07-11,Can Tho City,Ninh Kieu District,10,473,454,19,1
2022-07-11,Can Tho City,Ninh Kieu District,11,765,725,40,8
2022-07-11,Can Tho City,Ninh Kieu District,12,553,529,24,0
2022-07-11,Can Tho City,Ninh Kieu District,13,514,497,17,0
2022-07-11,Can Tho City,Ninh Kieu District,14,363,340,23,1
2022-07-11,Can Tho City,Ninh Kieu District,15,391,369,22,0
2022-07-11,Can Tho City,Ninh Kieu District,16,389,362,27,0
2022-07-11,Can Tho City,Ninh Kieu District,17,457,434,23,0
2022-07-11,Can Tho City,Ninh Kieu District,18,496,478,18,0
2022-07-11,Can Tho City,Ninh Kieu District,19,464,444,20,0
2022-07-11,Can Tho City,Ninh Kieu District,20,338,311,27,0
2022-07-11,Can Tho City,Ninh Kieu District,21,208,185,23,0
2022-07-11,Can Tho City,Ninh Kieu District,22,51,39,12,0
2022-07-11,Can Tho City,Ninh Kieu District,23,15,12,3,1
2022-07-11,Can Tho City,O Mon District,20,1,0,1,0
2022-07-11,Dong Nai,Bien Hoa City,0,3,1,2,1
2022-07-11,Dong Nai,Bien Hoa City,1,6,1,5,5
2022-07-11,Dong Nai,Bien Hoa City,3,1,0,1,1
2022-07-11,Dong Nai,Bien Hoa City,4,2,0,2,0
2022-07-11,Dong Nai,Bien Hoa City,5,4,1,3,3
2022-07-11,Dong Nai,Bien Hoa City,6,40,29,11,6
2022-07-11,Dong Nai,Bien Hoa City,7,164,142,22,8
2022-07-11,Dong Nai,Bien Hoa City,8,315,273,42,5
2022-07-11,Dong Nai,Bien Hoa City,9,384,336,48,2
2022-07-11,Dong Nai,Bien Hoa City,10,705,645,60,8
2022-07-11,Dong Nai,Bien Hoa City,11,1091,986,105,24
2022-07-11,Dong Nai,Bien Hoa City,12,967,895,72,12
2022-07-11,Dong Nai,Bien Hoa City,13,861,792,69,15
2022-07-11,Dong Nai,Bien Hoa City,14,690,622,68,29
2022-07-11,Dong Nai,Bien Hoa City,15,542,501,41,1
2022-07-11,Dong Nai,Bien Hoa City,16,506,468,38,4
2022-07-11,Dong Nai,Bien Hoa City,17,598,563,35,5
2022-07-11,Dong Nai,Bien Hoa City,18,684,627,57,6
2022-07-11,Dong Nai,Bien Hoa City,19,647,589,58,10
2022-07-11,Dong Nai,Bien Hoa City,20,534,466,68,18
2022-07-11,Dong Nai,Bien Hoa City,21,255,193,62,26
2022-07-11,Dong Nai,Bien Hoa City,22,37,22,15,4
2022-07-11,Dong Nai,Bien Hoa City,23,8,4,4,1
2022-07-11,Dong Nai,Long Khanh,10,2,0,2,2
2022-07-11,Dong Nai,Long Khanh,11,3,0,3,2
2022-07-11,Dong Nai,Long Khanh,12,1,0,1,1
2022-07-11,Dong Nai,Long Thanh,12,1,0,1,0
2022-07-11,Dong Nai,Long Thanh,16,3,0,3,3
2022-07-11,Dong Nai,Long Thanh,17,2,0,2,2
2022-07-11,Dong Nai,Long Thanh,18,2,0,2,2
2022-07-11,Dong Nai,Long Thanh,20,2,0,2,2
2022-07-11,Dong Nai,Nhon trach,11,2,0,2,2
2022-07-11,Dong Nai,Nhon trach,17,2,0,2,2
2022-07-11,Dong Nai,Nhon trach,18,5,0,5,5
2022-07-11,Dong Nai,Nhon trach,21,1,0,1,1
2022-07-11,Dong Nai,Trang Bom,21,1,0,1,1
2022-07-11,Dong Nai,Vinh Cuu,11,1,1,0,0
2022-07-11,Dong Nai,Vinh Cuu,17,1,0,1,1
2022-07-11,Hai Phong City,An Duong,8,2,1,1,1
2022-07-11,Hai Phong City,An Duong,9,5,1,4,1
2022-07-11,Hai Phong City,An Duong,10,3,2,1,1
2022-07-11,Hai Phong City,An Duong,11,8,3,5,5
2022-07-11,Hai Phong City,An Duong,12,4,2,2,1
2022-07-11,Hai Phong City,An Duong,13,1,1,0,0
2022-07-11,Hai Phong City,An Duong,14,3,0,3,2
2022-07-11,Hai Phong City,An Duong,15,2,2,0,0
2022-07-11,Hai Phong City,An Duong,16,2,1,1,1
2022-07-11,Hai Phong City,An Duong,17,8,5,3,3
2022-07-11,Hai Phong City,An Duong,18,1,1,0,0
2022-07-11,Hai Phong City,An Duong,20,2,0,2,1
2022-07-11,Hai Phong City,An Duong,21,2,0,2,1
2022-07-11,Hai Phong City,An Duong,22,4,1,3,2
2022-07-11,Hai Phong City,Hai An District,5,1,0,1,0
2022-07-11,Hai Phong City,Hai An District,6,3,2,1,1
2022-07-11,Hai Phong City,Hai An District,7,9,6,3,3
2022-07-11,Hai Phong City,Hai An District,8,7,5,2,2
2022-07-11,Hai Phong City,Hai An District,9,19,16,3,1
2022-07-11,Hai Phong City,Hai An District,10,19,16,3,2
2022-07-11,Hai Phong City,Hai An District,11,54,45,9,3
2022-07-11,Hai Phong City,Hai An District,12,31,24,7,3
2022-07-11,Hai Phong City,Hai An District,13,25,18,7,5
2022-07-11,Hai Phong City,Hai An District,14,12,10,2,1
2022-07-11,Hai Phong City,Hai An District,15,17,16,1,0
2022-07-11,Hai Phong City,Hai An District,16,19,14,5,2
2022-07-11,Hai Phong City,Hai An District,17,19,16,3,0
2022-07-11,Hai Phong City,Hai An District,18,26,19,7,1
2022-07-11,Hai Phong City,Hai An District,19,21,18,3,0
2022-07-11,Hai Phong City,Hai An District,20,18,15,3,0
2022-07-11,Hai Phong City,Hai An District,21,13,10,3,1
2022-07-11,Hai Phong City,Hai An District,22,2,1,1,1
2022-07-11,Hai Phong City,Hong Bang District,6,3,0,3,3
2022-07-11,Hai Phong City,Hong Bang District,7,16,9,7,4
2022-07-11,Hai Phong City,Hong Bang District,8,44,36,8,2
2022-07-11,Hai Phong City,Hong Bang District,9,43,31,12,3
2022-07-11,Hai Phong City,Hong Bang District,10,61,47,14,2
2022-07-11,Hai Phong City,Hong Bang District,11,96,79,17,6
2022-07-11,Hai Phong City,Hong Bang District,12,75,64,11,1
2022-07-11,Hai Phong City,Hong Bang District,13,39,35,4,1
2022-07-11,Hai Phong City,Hong Bang District,14,38,33,5,4
2022-07-11,Hai Phong City,Hong Bang District,15,44,37,7,3
2022-07-11,Hai Phong City,Hong Bang District,16,48,43,5,2
2022-07-11,Hai Phong City,Hong Bang District,17,45,38,7,0
2022-07-11,Hai Phong City,Hong Bang District,18,56,43,13,4
2022-07-11,Hai Phong City,Hong Bang District,19,50,43,7,4
2022-07-11,Hai Phong City,Hong Bang District,20,43,39,4,1
2022-07-11,Hai Phong City,Hong Bang District,21,16,12,4,2
2022-07-11,Hai Phong City,Hong Bang District,22,1,1,0,0
2022-07-11,Hai Phong City,Kien An District,0,1,0,1,0
2022-07-11,Hai Phong City,Kien An District,6,2,1,1,0
2022-07-11,Hai Phong City,Kien An District,8,1,0,1,1
2022-07-11,Hai Phong City,Kien An District,9,3,3,0,0
2022-07-11,Hai Phong City,Kien An District,10,11,8,3,1
2022-07-11,Hai Phong City,Kien An District,11,18,15,3,2
2022-07-11,Hai Phong City,Kien An District,12,6,4,2,1
2022-07-11,Hai Phong City,Kien An District,13,6,4,2,2
2022-07-11,Hai Phong City,Kien An District,14,6,4,2,1
2022-07-11,Hai Phong City,Kien An District,15,8,8,0,0
2022-07-11,Hai Phong City,Kien An District,16,5,4,1,0
2022-07-11,Hai Phong City,Kien An District,17,12,10,2,1
2022-07-11,Hai Phong City,Kien An District,18,10,8,2,2
2022-07-11,Hai Phong City,Kien An District,19,12,8,4,2
2022-07-11,Hai Phong City,Kien An District,20,9,6,3,2
2022-07-11,Hai Phong City,Kien An District,21,7,3,4,1
2022-07-11,Hai Phong City,Kien An District,22,1,0,1,1
2022-07-11,Hai Phong City,Le Chan District,2,2,1,1,0
2022-07-11,Hai Phong City,Le Chan District,3,1,1,0,0
2022-07-11,Hai Phong City,Le Chan District,6,10,3,7,5
2022-07-11,Hai Phong City,Le Chan District,7,47,37,10,7
2022-07-11,Hai Phong City,Le Chan District,8,83,67,16,7
2022-07-11,Hai Phong City,Le Chan District,9,107,81,26,4
2022-07-11,Hai Phong City,Le Chan District,10,198,172,26,6
2022-07-11,Hai Phong City,Le Chan District,11,386,329,57,24
2022-07-11,Hai Phong City,Le Chan District,12,249,222,27,9
2022-07-11,Hai Phong City,Le Chan District,13,170,151,19,8
2022-07-11,Hai Phong City,Le Chan District,14,148,130,18,8
2022-07-11,Hai Phong City,Le Chan District,15,188,161,27,13
2022-07-11,Hai Phong City,Le Chan District,16,174,156,18,3
2022-07-11,Hai Phong City,Le Chan District,17,160,130,30,3
2022-07-11,Hai Phong City,Le Chan District,18,218,188,30,9
2022-07-11,Hai Phong City,Le Chan District,19,172,154,18,3
2022-07-11,Hai Phong City,Le Chan District,20,146,119,27,7
2022-07-11,Hai Phong City,Le Chan District,21,80,56,24,7
2022-07-11,Hai Phong City,Le Chan District,22,20,11,9,2
2022-07-11,Hai Phong City,Le Chan District,23,4,1,3,2
2022-07-11,Hai Phong City,Ngo Quyen District,1,4,1,3,2
2022-07-11,Hai Phong City,Ngo Quyen District,2,2,0,2,1
2022-07-11,Hai Phong City,Ngo Quyen District,5,2,0,2,1
2022-07-11,Hai Phong City,Ngo Quyen District,6,3,1,2,0
2022-07-11,Hai Phong City,Ngo Quyen District,7,28,18,10,5
2022-07-11,Hai Phong City,Ngo Quyen District,8,72,59,13,4
2022-07-11,Hai Phong City,Ngo Quyen District,9,111,97,14,2
2022-07-11,Hai Phong City,Ngo Quyen District,10,135,127,8,1
2022-07-11,Hai Phong City,Ngo Quyen District,11,292,254,38,9
2022-07-11,Hai Phong City,Ngo Quyen District,12,147,133,14,4
2022-07-11,Hai Phong City,Ngo Quyen District,13,147,126,21,6
2022-07-11,Hai Phong City,Ngo Quyen District,14,132,119,13,4
2022-07-11,Hai Phong City,Ngo Quyen District,15,170,150,20,9
2022-07-11,Hai Phong City,Ngo Quyen District,16,116,104,12,2
2022-07-11,Hai Phong City,Ngo Quyen District,17,108,99,9,0
2022-07-11,Hai Phong City,Ngo Quyen District,18,156,137,19,5
2022-07-11,Hai Phong City,Ngo Quyen District,19,171,153,18,1
2022-07-11,Hai Phong City,Ngo Quyen District,20,148,130,18,4
2022-07-11,Hai Phong City,Ngo Quyen District,21,76,54,22,6
2022-07-11,Hai Phong City,Ngo Quyen District,22,10,5,5,0
2022-07-11,Hai Phong City,Ngo Quyen District,23,2,0,2,1
2022-07-11,Hai Phong City,Thuy Nguyen,7,1,0,1,1
2022-07-11,Hai Phong City,Thuy Nguyen,8,1,0,1,1
2022-07-11,Hai Phong City,Thuy Nguyen,9,1,0,1,1
2022-07-11,Hai Phong City,Thuy Nguyen,10,2,0,2,2
2022-07-11,Hai Phong City,Thuy Nguyen,11,1,0,1,1
2022-07-11,Hai Phong City,Thuy Nguyen,12,3,0,3,3
2022-07-11,Hai Phong City,Thuy Nguyen,13,2,0,2,2
2022-07-11,Hai Phong City,Thuy Nguyen,14,1,0,1,1
2022-07-11,Hai Phong City,Thuy Nguyen,15,3,1,2,1
2022-07-11,Hai Phong City,Thuy Nguyen,18,1,0,1,1
2022-07-11,Hai Phong City,Thuy Nguyen,19,1,0,1,1
2022-07-11,Hai Phong City,Thuy Nguyen,20,2,0,2,2
2022-07-11,Hue City,Hue City,0,5,2,3,0
2022-07-11,Hue City,Hue City,1,7,3,4,2
2022-07-11,Hue City,Hue City,2,2,1,1,0
2022-07-11,Hue City,Hue City,3,5,0,5,2
2022-07-11,Hue City,Hue City,5,2,1,1,0
2022-07-11,Hue City,Hue City,6,70,55,15,6
2022-07-11,Hue City,Hue City,7,238,221,17,4
2022-07-11,Hue City,Hue City,8,368,340,28,2
2022-07-11,Hue City,Hue City,9,273,244,29,1
2022-07-11,Hue City,Hue City,10,371,350,21,0
2022-07-11,Hue City,Hue City,11,765,706,59,4
2022-07-11,Hue City,Hue City,12,605,568,37,2
2022-07-11,Hue City,Hue City,13,359,334,25,2
2022-07-11,Hue City,Hue City,14,416,379,37,1
2022-07-11,Hue City,Hue City,15,412,382,30,1
2022-07-11,Hue City,Hue City,16,409,370,39,1
2022-07-11,Hue City,Hue City,17,477,437,40,1
2022-07-11,Hue City,Hue City,18,549,505,44,1
2022-07-11,Hue City,Hue City,19,606,544,62,2
2022-07-11,Hue City,Hue City,20,433,390,43,4
2022-07-11,Hue City,Hue City,21,271,222,49,4
2022-07-11,Hue City,Hue City,22,54,31,23,2
2022-07-11,Hue City,Hue City,23,24,13,11,1
2022-07-11,Hue City,Huong Thuy,6,2,2,0,0
2022-07-11,Hue City,Huong Thuy,11,1,0,1,0
2022-07-11,Hue City,Huong Thuy,12,1,0,1,0
2022-07-11,Hue City,Huong Thuy,14,1,0,1,1
2022-07-11,Hue City,Huong Thuy,15,1,1,0,0
2022-07-11,Hue City,Huong Thuy,18,1,1,0,0
2022-07-11,Hue City,Huong Thuy,19,5,4,1,1
2022-07-11,Hue City,Huong Tra,16,1,1,0,0
2022-07-11,Hue City,Huong Tra,18,1,1,0,0
2022-07-11,Hue City,Huong Tra,23,1,0,1,0
2022-07-11,Hue City,Phu Vang,7,2,1,1,0
2022-07-11,Hue City,Phu Vang,8,3,2,1,1
2022-07-11,Hue City,Phu Vang,9,2,1,1,0
2022-07-11,Hue City,Phu Vang,11,3,3,0,0
2022-07-11,Hue City,Phu Vang,12,3,2,1,0
2022-07-11,Hue City,Phu Vang,13,5,3,2,0
2022-07-11,Hue City,Phu Vang,14,1,0,1,0
2022-07-11,Hue City,Phu Vang,15,1,1,0,0
2022-07-11,Hue City,Phu Vang,16,3,2,1,1
2022-07-11,Hue City,Phu Vang,17,3,3,0,0
2022-07-11,Hue City,Phu Vang,18,3,3,0,0
2022-07-11,Hue City,Phu Vang,19,1,0,1,0
2022-07-11,Hue City,Phu Vang,20,4,2,2,2
2022-07-11,Hue City,Phu Vang,21,1,0,1,1
2022-07-11,Khanh Hoa,Dien Khanh,9,1,0,1,1
2022-07-11,Khanh Hoa,Dien Khanh,17,2,0,2,1
2022-07-11,Khanh Hoa,Dien Khanh,19,2,0,2,1
2022-07-11,Khanh Hoa,Dien Khanh,20,1,0,1,1
2022-07-11,Khanh Hoa,Nha Trang City,0,2,1,1,0
2022-07-11,Khanh Hoa,Nha Trang City,1,1,0,1,1
2022-07-11,Khanh Hoa,Nha Trang City,2,2,0,2,2
2022-07-11,Khanh Hoa,Nha Trang City,4,2,2,0,0
2022-07-11,Khanh Hoa,Nha Trang City,5,2,2,0,0
2022-07-11,Khanh Hoa,Nha Trang City,6,43,35,8,2
2022-07-11,Khanh Hoa,Nha Trang City,7,136,125,11,0
2022-07-11,Khanh Hoa,Nha Trang City,8,194,178,16,2
2022-07-11,Khanh Hoa,Nha Trang City,9,199,189,10,0
2022-07-11,Khanh Hoa,Nha Trang City,10,222,201,21,3
2022-07-11,Khanh Hoa,Nha Trang City,11,392,376,16,2
2022-07-11,Khanh Hoa,Nha Trang City,12,305,278,27,6
2022-07-11,Khanh Hoa,Nha Trang City,13,299,275,24,2
2022-07-11,Khanh Hoa,Nha Trang City,14,239,219,20,2
2022-07-11,Khanh Hoa,Nha Trang City,15,197,187,10,1
2022-07-11,Khanh Hoa,Nha Trang City,16,222,202,20,0
2022-07-11,Khanh Hoa,Nha Trang City,17,232,209,23,1
2022-07-11,Khanh Hoa,Nha Trang City,18,297,281,16,1
2022-07-11,Khanh Hoa,Nha Trang City,19,279,255,24,2
2022-07-11,Khanh Hoa,Nha Trang City,20,183,155,28,1
2022-07-11,Khanh Hoa,Nha Trang City,21,105,83,22,5
2022-07-11,Khanh Hoa,Nha Trang City,22,35,22,13,6
2022-07-11,Khanh Hoa,Nha Trang City,23,15,13,2,1
2022-07-11,Lam Dong,Da Lat City,0,2,2,0,0
2022-07-11,Lam Dong,Da Lat City,1,8,0,8,7
2022-07-11,Lam Dong,Da Lat City,2,2,0,2,2
2022-07-11,Lam Dong,Da Lat City,5,2,0,2,1
2022-07-11,Lam Dong,Da Lat City,6,31,0,31,29
2022-07-11,Lam Dong,Da Lat City,7,110,27,83,80
2022-07-11,Lam Dong,Da Lat City,8,132,67,65,51
2022-07-11,Lam Dong,Da Lat City,9,111,81,30,17
2022-07-11,Lam Dong,Da Lat City,10,126,85,41,24
2022-07-11,Lam Dong,Da Lat City,11,147,101,46,27
2022-07-11,Lam Dong,Da Lat City,12,156,99,57,42
2022-07-11,Lam Dong,Da Lat City,13,159,95,64,44
2022-07-11,Lam Dong,Da Lat City,14,123,76,47,34
2022-07-11,Lam Dong,Da Lat City,15,117,68,49,40
2022-07-11,Lam Dong,Da Lat City,16,144,71,73,58
2022-07-11,Lam Dong,Da Lat City,17,192,99,93,74
2022-07-11,Lam Dong,Da Lat City,18,236,133,103,84
2022-07-11,Lam Dong,Da Lat City,19,176,97,79,63
2022-07-11,Lam Dong,Da Lat City,20,158,82,76,64
2022-07-11,Lam Dong,Da Lat City,21,110,38,72,58
2022-07-11,Lam Dong,Da Lat City,22,53,24,29,20
2022-07-11,Lam Dong,Da Lat City,23,29,10,19,14
2022-07-11,Nghe An,Hung Nguyen,19,1,0,1,1
2022-07-11,Nghe An,Vinh City,0,1,0,1,0
2022-07-11,Nghe An,Vinh City,1,4,0,4,2
2022-07-11,Nghe An,Vinh City,6,29,3,26,24
2022-07-11,Nghe An,Vinh City,7,184,100,84,65
2022-07-11,Nghe An,Vinh City,8,259,162,97,63
2022-07-11,Nghe An,Vinh City,9,153,132,21,6
2022-07-11,Nghe An,Vinh City,10,239,124,115,73
2022-07-11,Nghe An,Vinh City,11,431,236,195,158
2022-07-11,Nghe An,Vinh City,12,305,237,68,35
2022-07-11,Nghe An,Vinh City,13,154,127,27,7
2022-07-11,Nghe An,Vinh City,14,163,131,32,13
2022-07-11,Nghe An,Vinh City,15,191,135,56,33
2022-07-11,Nghe An,Vinh City,16,143,113,30,11
2022-07-11,Nghe An,Vinh City,17,176,127,49,33
2022-07-11,Nghe An,Vinh City,18,208,154,54,34
2022-07-11,Nghe An,Vinh City,19,212,136,76,33
2022-07-11,Nghe An,Vinh City,20,147,111,36,14
2022-07-11,Nghe An,Vinh City,21,119,46,73,46
2022-07-11,Nghe An,Vinh City,22,40,8,32,16
2022-07-11,Nghe An,Vinh City,23,13,6,7,5
2022-07-11,Quang Nam,Dien Ban,14,2,0,2,2
2022-07-11,Quang Nam,Hoi An City,6,2,0,2,2
2022-07-11,Quang Nam,Hoi An City,7,14,7,7,7
2022-07-11,Quang Nam,Hoi An City,8,42,18,24,20
2022-07-11,Quang Nam,Hoi An City,9,29,17,12,8
2022-07-11,Quang Nam,Hoi An City,10,27,17,10,6
2022-07-11,Quang Nam,Hoi An City,11,50,34,16,12
2022-07-11,Quang Nam,Hoi An City,12,61,24,37,31
2022-07-11,Quang Nam,Hoi An City,13,44,26,18,12
2022-07-11,Quang Nam,Hoi An City,14,66,39,27,20
2022-07-11,Quang Nam,Hoi An City,15,74,45,29,23
2022-07-11,Quang Nam,Hoi An City,16,47,38,9,4
2022-07-11,Quang Nam,Hoi An City,17,48,38,10,6
2022-07-11,Quang Nam,Hoi An City,18,50,34,16,9
2022-07-11,Quang Nam,Hoi An City,19,64,38,26,17
2022-07-11,Quang Nam,Hoi An City,20,25,19,6,3
2022-07-11,Quang Nam,Hoi An City,21,37,6,31,24
2022-07-11,Quang Nam,Hoi An City,22,15,0,15,14
2022-07-11,Quang Nam,Hoi An City,23,2,0,2,2
2022-07-11,Quang Nam,Tam Ky City,11,2,0,2,1
2022-07-11,Quang Ninh,Cam Pha City,9,1,0,1,1
2022-07-11,Quang Ninh,Cam Pha City,12,2,0,2,2
2022-07-11,Quang Ninh,Cam Pha City,13,1,0,1,1
2022-07-11,Quang Ninh,Cam Pha City,14,2,0,2,2
2022-07-11,Quang Ninh,Cam Pha City,15,2,0,2,1
2022-07-11,Quang Ninh,Cam Pha City,19,1,0,1,1
2022-07-11,Quang Ninh,Cam Pha City,20,2,0,2,2
2022-07-11,Quang Ninh,Cam Pha City,21,2,0,2,1
2022-07-11,Quang Ninh,Ha Long City,0,2,0,2,1
2022-07-11,Quang Ninh,Ha Long City,7,24,17,7,5
2022-07-11,Quang Ninh,Ha Long City,8,48,35,13,10
2022-07-11,Quang Ninh,Ha Long City,9,47,34,13,7
2022-07-11,Quang Ninh,Ha Long City,10,85,56,29,10
2022-07-11,Quang Ninh,Ha Long City,11,136,92,44,14
2022-07-11,Quang Ninh,Ha Long City,12,121,80,41,25
2022-07-11,Quang Ninh,Ha Long City,13,90,63,27,8
2022-07-11,Quang Ninh,Ha Long City,14,77,53,24,15
2022-07-11,Quang Ninh,Ha Long City,15,66,44,22,8
2022-07-11,Quang Ninh,Ha Long City,16,60,44,16,11
2022-07-11,Quang Ninh,Ha Long City,17,52,41,11,8
2022-07-11,Quang Ninh,Ha Long City,18,59,45,14,6
2022-07-11,Quang Ninh,Ha Long City,19,88,51,37,19
2022-07-11,Quang Ninh,Ha Long City,20,62,36,26,15
2022-07-11,Quang Ninh,Ha Long City,21,41,12,29,18
2022-07-11,Quang Ninh,Ha Long City,22,16,2,14,12
2022-07-11,Quang Ninh,Ha Long City,23,12,0,12,8
2022-07-11,Thai Nguyen,Dong Hy,7,1,1,0,0
2022-07-11,Thai Nguyen,Dong Hy,12,1,1,0,0
2022-07-11,Thai Nguyen,Pho Yen,9,1,0,1,1
2022-07-11,Thai Nguyen,Pho Yen,10,1,0,1,1
2022-07-11,Thai Nguyen,Pho Yen,13,1,0,1,0
2022-07-11,Thai Nguyen,Thai Nguyen City,0,3,0,3,0
2022-07-11,Thai Nguyen,Thai Nguyen City,2,1,0,1,0
2022-07-11,Thai Nguyen,Thai Nguyen City,4,2,1,1,0
2022-07-11,Thai Nguyen,Thai Nguyen City,6,19,11,8,5
2022-07-11,Thai Nguyen,Thai Nguyen City,7,96,89,7,0
2022-07-11,Thai Nguyen,Thai Nguyen City,8,148,133,15,1
2022-07-11,Thai Nguyen,Thai Nguyen City,9,143,135,8,1
2022-07-11,Thai Nguyen,Thai Nguyen City,10,173,163,10,3
2022-07-11,Thai Nguyen,Thai Nguyen City,11,351,334,17,2
2022-07-11,Thai Nguyen,Thai Nguyen City,12,264,243,21,3
2022-07-11,Thai Nguyen,Thai Nguyen City,13,198,185,13,4
2022-07-11,Thai Nguyen,Thai Nguyen City,14,188,174,14,1
2022-07-11,Thai Nguyen,Thai Nguyen City,15,166,151,15,1
2022-07-11,Thai Nguyen,Thai Nguyen City,16,120,113,7,1
2022-07-11,Thai Nguyen,Thai Nguyen City,17,162,142,20,0
2022-07-11,Thai Nguyen,Thai Nguyen City,18,215,197,18,1
2022-07-11,Thai Nguyen,Thai Nguyen City,19,243,221,22,4
2022-07-11,Thai Nguyen,Thai Nguyen City,20,181,169,12,2
2022-07-11,Thai Nguyen,Thai Nguyen City,21,132,110,22,1
2022-07-11,Thai Nguyen,Thai Nguyen City,22,19,14,5,0
2022-07-11,Thai Nguyen,Thai Nguyen City,23,2,2,0,0
2022-07-11,Vung Tau,Ba Ria City,7,2,0,2,2
2022-07-11,Vung Tau,Ba Ria City,8,3,2,1,1
2022-07-11,Vung Tau,Ba Ria City,9,5,5,0,0
2022-07-11,Vung Tau,Ba Ria City,10,8,3,5,4
2022-07-11,Vung Tau,Ba Ria City,11,9,5,4,2
2022-07-11,Vung Tau,Ba Ria City,12,7,1,6,4
2022-07-11,Vung Tau,Ba Ria City,13,7,2,5,4
2022-07-11,Vung Tau,Ba Ria City,14,5,3,2,2
2022-07-11,Vung Tau,Ba Ria City,15,9,3,6,4
2022-07-11,Vung Tau,Ba Ria City,16,7,3,4,1
2022-07-11,Vung Tau,Ba Ria City,17,2,1,1,0
2022-07-11,Vung Tau,Ba Ria City,18,1,0,1,1
2022-07-11,Vung Tau,Ba Ria City,19,6,2,4,3
2022-07-11,Vung Tau,Ba Ria City,20,4,0,4,4
2022-07-11,Vung Tau,Ba Ria City,21,1,0,1,1
2022-07-11,Vung Tau,Vung Tau City,0,2,1,1,1
2022-07-11,Vung Tau,Vung Tau City,1,2,0,2,1
2022-07-11,Vung Tau,Vung Tau City,2,4,2,2,1
2022-07-11,Vung Tau,Vung Tau City,3,2,1,1,1
2022-07-11,Vung Tau,Vung Tau City,4,2,1,1,1
2022-07-11,Vung Tau,Vung Tau City,5,4,2,2,2
2022-07-11,Vung Tau,Vung Tau City,6,52,30,22,13
2022-07-11,Vung Tau,Vung Tau City,7,136,92,44,28
2022-07-11,Vung Tau,Vung Tau City,8,160,147,13,1
2022-07-11,Vung Tau,Vung Tau City,9,176,160,16,4
2022-07-11,Vung Tau,Vung Tau City,10,246,227,19,3
2022-07-11,Vung Tau,Vung Tau City,11,388,352,36,8
2022-07-11,Vung Tau,Vung Tau City,12,263,243,20,3
2022-07-11,Vung Tau,Vung Tau City,13,244,229,15,2
2022-07-11,Vung Tau,Vung Tau City,14,218,212,6,0
2022-07-11,Vung Tau,Vung Tau City,15,211,198,13,2
2022-07-11,Vung Tau,Vung Tau City,16,236,221,15,1
2022-07-11,Vung Tau,Vung Tau City,17,248,233,15,4
2022-07-11,Vung Tau,Vung Tau City,18,323,294,29,7
2022-07-11,Vung Tau,Vung Tau City,19,284,253,31,7
2022-07-11,Vung Tau,Vung Tau City,20,205,187,18,4
2022-07-11,Vung Tau,Vung Tau City,21,102,82,20,4
2022-07-11,Vung Tau,Vung Tau City,22,18,15,3,0
2022-07-11,Vung Tau,Vung Tau City,23,10,7,3,3
2022-07-12,Bac Ninh,Bác Ninh City,0,2,2,0,0
2022-07-12,Bac Ninh,Bác Ninh City,5,1,1,0,0
2022-07-12,Bac Ninh,Bác Ninh City,6,15,7,8,4
2022-07-12,Bac Ninh,Bác Ninh City,7,63,58,5,0
2022-07-12,Bac Ninh,Bác Ninh City,8,101,92,9,0
2022-07-12,Bac Ninh,Bác Ninh City,9,120,110,10,1
2022-07-12,Bac Ninh,Bác Ninh City,10,175,160,15,0
2022-07-12,Bac Ninh,Bác Ninh City,11,303,274,29,13
2022-07-12,Bac Ninh,Bác Ninh City,12,215,200,15,0
2022-07-12,Bac Ninh,Bác Ninh City,13,130,117,13,2
2022-07-12,Bac Ninh,Bác Ninh City,14,147,127,20,1
2022-07-12,Bac Ninh,Bác Ninh City,15,121,107,14,1
2022-07-12,Bac Ninh,Bác Ninh City,16,110,100,10,2
2022-07-12,Bac Ninh,Bác Ninh City,17,114,98,16,3
2022-07-12,Bac Ninh,Bác Ninh City,18,157,142,15,0
2022-07-12,Bac Ninh,Bác Ninh City,19,169,157,12,0
2022-07-12,Bac Ninh,Bác Ninh City,20,138,124,14,0
2022-07-12,Bac Ninh,Bác Ninh City,21,73,65,8,0
2022-07-12,Bac Ninh,Bác Ninh City,22,14,10,4,1
2022-07-12,Bac Ninh,Bác Ninh City,23,7,7,0,0
2022-07-12,Bac Ninh,Que Vo,14,1,0,1,0
2022-07-12,Bac Ninh,Que Vo,19,1,0,1,1
2022-07-12,Bac Ninh,Que Vo,21,2,0,2,2
2022-07-12,Bac Ninh,Tien Du,0,1,0,1,1
2022-07-12,Bac Ninh,Tien Du,8,2,0,2,2
2022-07-12,Bac Ninh,Tien Du,9,2,0,2,1
2022-07-12,Bac Ninh,Tien Du,10,3,0,3,3
2022-07-12,Bac Ninh,Tien Du,11,1,0,1,1
2022-07-12,Bac Ninh,Tien Du,12,2,0,2,2
2022-07-12,Bac Ninh,Tien Du,14,2,0,2,1
2022-07-12,Bac Ninh,Tien Du,17,1,0,1,1
2022-07-12,Bac Ninh,Tu Son,10,1,0,1,1
2022-07-12,Bac Ninh,Tu Son,13,1,0,1,0
2022-07-12,Bac Ninh,Tu Son,14,1,0,1,1
2022-07-12,Bac Ninh,Tu Son,18,2,0,2,2
2022-07-12,Bac Ninh,Tu Son,19,2,0,2,2
2022-07-12,Bac Ninh,Tu Son,21,1,0,1,1
2022-07-12,Binh Duong,Ben Cat,6,1,0,1,1
2022-07-12,Binh Duong,Ben Cat,7,2,0,2,2
2022-07-12,Binh Duong,Ben Cat,8,1,0,1,1
2022-07-12,Binh Duong,Ben Cat,9,1,0,1,0
2022-07-12,Binh Duong,Ben Cat,10,2,0,2,2
2022-07-12,Binh Duong,Ben Cat,11,1,0,1,1
2022-07-12,Binh Duong,Ben Cat,12,2,0,2,1
2022-07-12,Binh Duong,Ben Cat,13,3,0,3,1
2022-07-12,Binh Duong,Ben Cat,14,3,0,3,3
2022-07-12,Binh Duong,Ben Cat,16,1,0,1,0
2022-07-12,Binh Duong,Ben Cat,18,1,1,0,0
2022-07-12,Binh Duong,Ben Cat,20,1,0,1,1
2022-07-12,Binh Duong,Di An,1,1,0,1,1
2022-07-12,Binh Duong,Di An,5,1,0,1,1
2022-07-12,Binh Duong,Di An,6,1,0,1,0
2022-07-12,Binh Duong,Di An,7,7,1,6,5
2022-07-12,Binh Duong,Di An,8,18,10,8,7
2022-07-12,Binh Duong,Di An,9,41,22,19,15
2022-07-12,Binh Duong,Di An,10,34,24,10,4
2022-07-12,Binh Duong,Di An,11,38,32,6,2
2022-07-12,Binh Duong,Di An,12,38,33,5,3
2022-07-12,Binh Duong,Di An,13,38,33,5,1
2022-07-12,Binh Duong,Di An,14,35,30,5,3
2022-07-12,Binh Duong,Di An,15,33,18,15,9
2022-07-12,Binh Duong,Di An,16,41,23,18,11
2022-07-12,Binh Duong,Di An,17,49,41,8,3
2022-07-12,Binh Duong,Di An,18,35,31,4,2
2022-07-12,Binh Duong,Di An,19,39,33,6,1
2022-07-12,Binh Duong,Di An,20,26,22,4,1
2022-07-12,Binh Duong,Di An,21,15,10,5,5
2022-07-12,Binh Duong,Phu Giao,18,1,0,1,0
2022-07-12,Binh Duong,Tan Uyen,8,1,0,1,1
2022-07-12,Binh Duong,Tan Uyen,9,1,0,1,1
2022-07-12,Binh Duong,Tan Uyen,10,9,4,5,2
2022-07-12,Binh Duong,Tan Uyen,11,5,2,3,2
2022-07-12,Binh Duong,Tan Uyen,12,3,3,0,0
2022-07-12,Binh Duong,Tan Uyen,13,6,2,4,2
2022-07-12,Binh Duong,Tan Uyen,14,2,1,1,1
2022-07-12,Binh Duong,Tan Uyen,15,2,1,1,1
2022-07-12,Binh Duong,Tan Uyen,16,1,1,0,0
2022-07-12,Binh Duong,Tan Uyen,17,3,3,0,0
2022-07-12,Binh Duong,Tan Uyen,18,3,1,2,2
2022-07-12,Binh Duong,Tan Uyen,19,2,2,0,0
2022-07-12,Binh Duong,Tan Uyen,20,1,1,0,0
2022-07-12,Binh Duong,Thu Dau Mot Town,0,5,0,5,5
2022-07-12,Binh Duong,Thu Dau Mot Town,1,6,0,6,4
2022-07-12,Binh Duong,Thu Dau Mot Town,2,6,2,4,3
2022-07-12,Binh Duong,Thu Dau Mot Town,3,1,1,0,0
2022-07-12,Binh Duong,Thu Dau Mot Town,5,2,1,1,1
2022-07-12,Binh Duong,Thu Dau Mot Town,6,40,35,5,4
2022-07-12,Binh Duong,Thu Dau Mot Town,7,134,124,10,1
2022-07-12,Binh Duong,Thu Dau Mot Town,8,212,201,11,1
2022-07-12,Binh Duong,Thu Dau Mot Town,9,288,260,28,6
2022-07-12,Binh Duong,Thu Dau Mot Town,10,407,384,23,5
2022-07-12,Binh Duong,Thu Dau Mot Town,11,660,603,57,9
2022-07-12,Binh Duong,Thu Dau Mot Town,12,463,432,31,6
2022-07-12,Binh Duong,Thu Dau Mot Town,13,480,451,29,4
2022-07-12,Binh Duong,Thu Dau Mot Town,14,407,387,20,3
2022-07-12,Binh Duong,Thu Dau Mot Town,15,299,277,22,1
2022-07-12,Binh Duong,Thu Dau Mot Town,16,278,260,18,1
2022-07-12,Binh Duong,Thu Dau Mot Town,17,371,344,27,7
2022-07-12,Binh Duong,Thu Dau Mot Town,18,424,384,40,12
2022-07-12,Binh Duong,Thu Dau Mot Town,19,365,334,31,10
2022-07-12,Binh Duong,Thu Dau Mot Town,20,269,251,18,3
2022-07-12,Binh Duong,Thu Dau Mot Town,21,125,106,19,3
2022-07-12,Binh Duong,Thu Dau Mot Town,22,23,17,6,4
2022-07-12,Binh Duong,Thu Dau Mot Town,23,17,7,10,6
2022-07-12,Binh Duong,Thuan An,0,2,0,2,2
2022-07-12,Binh Duong,Thuan An,2,1,1,0,0
2022-07-12,Binh Duong,Thuan An,6,3,1,2,2
2022-07-12,Binh Duong,Thuan An,7,8,4,4,3
2022-07-12,Binh Duong,Thuan An,8,24,17,7,2
2022-07-12,Binh Duong,Thuan An,9,38,33,5,3
2022-07-12,Binh Duong,Thuan An,10,66,61,5,1
2022-07-12,Binh Duong,Thuan An,11,87,75,12,5
2022-07-12,Binh Duong,Thuan An,12,84,63,21,12
2022-07-12,Binh Duong,Thuan An,13,105,74,31,24
2022-07-12,Binh Duong,Thuan An,14,83,51,32,23
2022-07-12,Binh Duong,Thuan An,15,52,44,8,4
2022-07-12,Binh Duong,Thuan An,16,44,39,5,2
2022-07-12,Binh Duong,Thuan An,17,39,31,8,3
2022-07-12,Binh Duong,Thuan An,18,48,43,5,0
2022-07-12,Binh Duong,Thuan An,19,54,43,11,5
2022-07-12,Binh Duong,Thuan An,20,41,24,17,9
2022-07-12,Binh Duong,Thuan An,21,21,14,7,4
2022-07-12,Binh Duong,Thuan An,22,5,1,4,3
2022-07-12,Binh Duong,Thuan An,23,3,1,2,2
2022-07-12,Can Tho City,Binh Thuy District,4,2,1,1,0
2022-07-12,Can Tho City,Binh Thuy District,7,1,1,0,0
2022-07-12,Can Tho City,Binh Thuy District,8,3,3,0,0
2022-07-12,Can Tho City,Binh Thuy District,9,7,6,1,0
2022-07-12,Can Tho City,Binh Thuy District,10,4,4,0,0
2022-07-12,Can Tho City,Binh Thuy District,11,15,13,2,1
2022-07-12,Can Tho City,Binh Thuy District,12,7,7,0,0
2022-07-12,Can Tho City,Binh Thuy District,13,16,14,2,0
2022-07-12,Can Tho City,Binh Thuy District,14,15,13,2,1
2022-07-12,Can Tho City,Binh Thuy District,15,18,14,4,0
2022-07-12,Can Tho City,Binh Thuy District,16,11,9,2,2
2022-07-12,Can Tho City,Binh Thuy District,17,13,12,1,0
2022-07-12,Can Tho City,Binh Thuy District,18,22,20,2,1
2022-07-12,Can Tho City,Binh Thuy District,19,22,19,3,1
2022-07-12,Can Tho City,Binh Thuy District,20,13,8,5,2
2022-07-12,Can Tho City,Binh Thuy District,21,4,2,2,0
2022-07-12,Can Tho City,Binh Thuy District,22,1,1,0,0
2022-07-12,Can Tho City,Cai Rang District,2,1,0,1,1
2022-07-12,Can Tho City,Cai Rang District,5,1,1,0,0
2022-07-12,Can Tho City,Cai Rang District,6,3,3,0,0
2022-07-12,Can Tho City,Cai Rang District,7,3,2,1,1
2022-07-12,Can Tho City,Cai Rang District,8,9,8,1,1
2022-07-12,Can Tho City,Cai Rang District,9,16,13,3,1
2022-07-12,Can Tho City,Cai Rang District,10,9,9,0,0
2022-07-12,Can Tho City,Cai Rang District,11,18,14,4,0
2022-07-12,Can Tho City,Cai Rang District,12,13,10,3,0
2022-07-12,Can Tho City,Cai Rang District,13,14,14,0,0
2022-07-12,Can Tho City,Cai Rang District,14,8,5,3,0
2022-07-12,Can Tho City,Cai Rang District,15,11,11,0,0
2022-07-12,Can Tho City,Cai Rang District,16,9,9,0,0
2022-07-12,Can Tho City,Cai Rang District,17,23,19,4,1
2022-07-12,Can Tho City,Cai Rang District,18,21,19,2,2
2022-07-12,Can Tho City,Cai Rang District,19,29,25,4,1
2022-07-12,Can Tho City,Cai Rang District,20,26,20,6,2
2022-07-12,Can Tho City,Cai Rang District,21,7,5,2,0
2022-07-12,Can Tho City,Cai Rang District,22,2,2,0,0
2022-07-12,Can Tho City,Ninh Kieu District,0,7,6,1,0
2022-07-12,Can Tho City,Ninh Kieu District,1,3,3,0,0
2022-07-12,Can Tho City,Ninh Kieu District,4,4,1,3,1
2022-07-12,Can Tho City,Ninh Kieu District,5,10,2,8,5
2022-07-12,Can Tho City,Ninh Kieu District,6,51,46,5,1
2022-07-12,Can Tho City,Ninh Kieu District,7,152,144,8,1
2022-07-12,Can Tho City,Ninh Kieu District,8,227,216,11,0
2022-07-12,Can Tho City,Ninh Kieu District,9,268,260,8,0
2022-07-12,Can Tho City,Ninh Kieu District,10,494,459,35,1
2022-07-12,Can Tho City,Ninh Kieu District,11,857,798,59,4
2022-07-12,Can Tho City,Ninh Kieu District,12,611,589,22,0
2022-07-12,Can Tho City,Ninh Kieu District,13,501,470,31,0
2022-07-12,Can Tho City,Ninh Kieu District,14,416,399,17,0
2022-07-12,Can Tho City,Ninh Kieu District,15,360,338,22,0
2022-07-12,Can Tho City,Ninh Kieu District,16,462,419,43,4
2022-07-12,Can Tho City,Ninh Kieu District,17,720,649,71,29
2022-07-12,Can Tho City,Ninh Kieu District,18,815,701,114,50
2022-07-12,Can Tho City,Ninh Kieu District,19,727,605,122,60
2022-07-12,Can Tho City,Ninh Kieu District,20,683,515,168,95
2022-07-12,Can Tho City,Ninh Kieu District,21,278,246,32,3
2022-07-12,Can Tho City,Ninh Kieu District,22,50,40,10,0
2022-07-12,Can Tho City,Ninh Kieu District,23,23,19,4,2
2022-07-12,Can Tho City,O Mon District,21,1,0,1,1
2022-07-12,Can Tho City,Phong Dien,17,1,1,0,0
2022-07-12,Dong Nai,Bien Hoa City,0,19,4,15,11
2022-07-12,Dong Nai,Bien Hoa City,1,2,0,2,1
2022-07-12,Dong Nai,Bien Hoa City,2,3,0,3,3
2022-07-12,Dong Nai,Bien Hoa City,3,1,0,1,1
2022-07-12,Dong Nai,Bien Hoa City,4,1,0,1,1
2022-07-12,Dong Nai,Bien Hoa City,5,4,1,3,3
2022-07-12,Dong Nai,Bien Hoa City,6,50,36,14,9
2022-07-12,Dong Nai,Bien Hoa City,7,192,159,33,12
2022-07-12,Dong Nai,Bien Hoa City,8,320,276,44,13
2022-07-12,Dong Nai,Bien Hoa City,9,378,353,25,3
2022-07-12,Dong Nai,Bien Hoa City,10,756,703,53,12
2022-07-12,Dong Nai,Bien Hoa City,11,1057,973,84,9
2022-07-12,Dong Nai,Bien Hoa City,12,897,837,60,7
2022-07-12,Dong Nai,Bien Hoa City,13,880,824,56,3
2022-07-12,Dong Nai,Bien Hoa City,14,724,667,57,10
2022-07-12,Dong Nai,Bien Hoa City,15,545,512,33,8
2022-07-12,Dong Nai,Bien Hoa City,16,551,512,39,4
2022-07-12,Dong Nai,Bien Hoa City,17,612,574,38,1
2022-07-12,Dong Nai,Bien Hoa City,18,732,692,40,10
2022-07-12,Dong Nai,Bien Hoa City,19,659,594,65,5
2022-07-12,Dong Nai,Bien Hoa City,20,522,465,57,12
2022-07-12,Dong Nai,Bien Hoa City,21,232,185,47,8
2022-07-12,Dong Nai,Bien Hoa City,22,50,25,25,9
2022-07-12,Dong Nai,Bien Hoa City,23,17,7,10,3
2022-07-12,Dong Nai,Long Khanh,16,1,0,1,1
2022-07-12,Dong Nai,Long Khanh,19,2,0,2,1
2022-07-12,Dong Nai,Long Thanh,8,2,0,2,2
2022-07-12,Dong Nai,Long Thanh,10,1,0,1,1
2022-07-12,Dong Nai,Long Thanh,11,3,0,3,3
2022-07-12,Dong Nai,Long Thanh,12,6,0,6,6
2022-07-12,Dong Nai,Long Thanh,13,3,0,3,3
2022-07-12,Dong Nai,Long Thanh,14,5,0,5,5
2022-07-12,Dong Nai,Long Thanh,16,2,0,2,0
2022-07-12,Dong Nai,Long Thanh,17,1,0,1,1
2022-07-12,Dong Nai,Long Thanh,18,1,0,1,1
2022-07-12,Dong Nai,Long Thanh,19,1,0,1,1
2022-07-12,Dong Nai,Long Thanh,20,1,0,1,1
2022-07-12,Dong Nai,Nhon trach,8,1,0,1,1
2022-07-12,Dong Nai,Nhon trach,10,1,0,1,1
2022-07-12,Dong Nai,Nhon trach,12,1,0,1,1
2022-07-12,Dong Nai,Nhon trach,13,1,0,1,1
2022-07-12,Dong Nai,Nhon trach,15,2,0,2,2
2022-07-12,Dong Nai,Nhon trach,16,1,0,1,1
2022-07-12,Dong Nai,Nhon trach,17,1,0,1,1
2022-07-12,Dong Nai,Nhon trach,20,2,0,2,1
2022-07-12,Dong Nai,Trang Bom,12,1,0,1,1
2022-07-12,Dong Nai,Trang Bom,15,3,0,3,3
2022-07-12,Dong Nai,Trang Bom,19,3,0,3,3
2022-07-12,Dong Nai,Vinh Cuu,18,2,0,2,2
2022-07-12,Hai Phong City,An Duong,8,2,1,1,0
2022-07-12,Hai Phong City,An Duong,9,3,1,2,0
2022-07-12,Hai Phong City,An Duong,10,5,3,2,1
2022-07-12,Hai Phong City,An Duong,11,8,6,2,1
2022-07-12,Hai Phong City,An Duong,12,5,4,1,1
2022-07-12,Hai Phong City,An Duong,13,5,3,2,2
2022-07-12,Hai Phong City,An Duong,14,8,4,4,4
2022-07-12,Hai Phong City,An Duong,15,6,5,1,1
2022-07-12,Hai Phong City,An Duong,16,8,7,1,1
2022-07-12,Hai Phong City,An Duong,17,3,1,2,2
2022-07-12,Hai Phong City,An Duong,18,3,1,2,2
2022-07-12,Hai Phong City,An Duong,19,3,3,0,0
2022-07-12,Hai Phong City,An Duong,20,3,0,3,3
2022-07-12,Hai Phong City,An Duong,22,1,1,0,0
2022-07-12,Hai Phong City,Hai An District,6,2,0,2,2
2022-07-12,Hai Phong City,Hai An District,7,2,1,1,1
2022-07-12,Hai Phong City,Hai An District,8,18,13,5,4
2022-07-12,Hai Phong City,Hai An District,9,20,17,3,0
2022-07-12,Hai Phong City,Hai An District,10,22,20,2,2
2022-07-12,Hai Phong City,Hai An District,11,55,51,4,1
2022-07-12,Hai Phong City,Hai An District,12,29,20,9,2
2022-07-12,Hai Phong City,Hai An District,13,15,12,3,3
2022-07-12,Hai Phong City,Hai An District,14,28,19,9,2
2022-07-12,Hai Phong City,Hai An District,15,27,18,9,4
2022-07-12,Hai Phong City,Hai An District,16,18,15,3,2
2022-07-12,Hai Phong City,Hai An District,17,21,18,3,1
2022-07-12,Hai Phong City,Hai An District,18,27,26,1,1
2022-07-12,Hai Phong City,Hai An District,19,22,19,3,2
2022-07-12,Hai Phong City,Hai An District,20,16,11,5,1
2022-07-12,Hai Phong City,Hai An District,21,12,10,2,1
2022-07-12,Hai Phong City,Hai An District,22,1,0,1,1
2022-07-12,Hai Phong City,Hai An District,23,7,1,6,4
2022-07-12,Hai Phong City,Hong Bang District,6,2,1,1,1
2022-07-12,Hai Phong City,Hong Bang District,7,21,12,9,5
2022-07-12,Hai Phong City,Hong Bang District,8,39,35,4,2
2022-07-12,Hai Phong City,Hong Bang District,9,31,27,4,1
2022-07-12,Hai Phong City,Hong Bang District,10,70,63,7,2
2022-07-12,Hai Phong City,Hong Bang District,11,100,81,19,6
2022-07-12,Hai Phong City,Hong Bang District,12,84,73,11,4
2022-07-12,Hai Phong City,Hong Bang District,13,51,42,9,6
2022-07-12,Hai Phong City,Hong Bang District,14,48,39,9,6
2022-07-12,Hai Phong City,Hong Bang District,15,42,35,7,4
2022-07-12,Hai Phong City,Hong Bang District,16,49,43,6,1
2022-07-12,Hai Phong City,Hong Bang District,17,30,29,1,0
2022-07-12,Hai Phong City,Hong Bang District,18,57,53,4,2
2022-07-12,Hai Phong City,Hong Bang District,19,63,51,12,5
2022-07-12,Hai Phong City,Hong Bang District,20,34,29,5,1
2022-07-12,Hai Phong City,Hong Bang District,21,19,16,3,0
2022-07-12,Hai Phong City,Hong Bang District,22,3,3,0,0
2022-07-12,Hai Phong City,Kien An District,0,1,0,1,1
2022-07-12,Hai Phong City,Kien An District,1,2,0,2,0
2022-07-12,Hai Phong City,Kien An District,7,3,1,2,2
2022-07-12,Hai Phong City,Kien An District,8,3,1,2,2
2022-07-12,Hai Phong City,Kien An District,9,6,6,0,0
2022-07-12,Hai Phong City,Kien An District,10,6,3,3,0
2022-07-12,Hai Phong City,Kien An District,11,12,10,2,2
2022-07-12,Hai Phong City,Kien An District,12,9,6,3,0
2022-07-12,Hai Phong City,Kien An District,13,8,7,1,0
2022-07-12,Hai Phong City,Kien An District,14,10,7,3,1
2022-07-12,Hai Phong City,Kien An District,15,6,6,0,0
2022-07-12,Hai Phong City,Kien An District,16,8,6,2,2
2022-07-12,Hai Phong City,Kien An District,17,7,7,0,0
2022-07-12,Hai Phong City,Kien An District,18,8,8,0,0
2022-07-12,Hai Phong City,Kien An District,19,6,2,4,2
2022-07-12,Hai Phong City,Kien An District,20,14,7,7,7
2022-07-12,Hai Phong City,Kien An District,21,6,2,4,3
2022-07-12,Hai Phong City,Kien An District,22,1,0,1,0
2022-07-12,Hai Phong City,Le Chan District,0,1,0,1,0
2022-07-12,Hai Phong City,Le Chan District,5,1,1,0,0
2022-07-12,Hai Phong City,Le Chan District,6,1,1,0,0
2022-07-12,Hai Phong City,Le Chan District,7,27,20,7,5
2022-07-12,Hai Phong City,Le Chan District,8,91,67,24,10
2022-07-12,Hai Phong City,Le Chan District,9,100,84,16,3
2022-07-12,Hai Phong City,Le Chan District,10,190,171,19,2
2022-07-12,Hai Phong City,Le Chan District,11,360,320,40,16
2022-07-12,Hai Phong City,Le Chan District,12,263,234,29,9
2022-07-12,Hai Phong City,Le Chan District,13,175,154,21,5
2022-07-12,Hai Phong City,Le Chan District,14,200,161,39,17
2022-07-12,Hai Phong City,Le Chan District,15,212,177,35,12
2022-07-12,Hai Phong City,Le Chan District,16,169,149,20,3
2022-07-12,Hai Phong City,Le Chan District,17,178,152,26,1
2022-07-12,Hai Phong City,Le Chan District,18,223,191,32,6
2022-07-12,Hai Phong City,Le Chan District,19,216,187,29,12
2022-07-12,Hai Phong City,Le Chan District,20,138,112,26,5
2022-07-12,Hai Phong City,Le Chan District,21,65,52,13,2
2022-07-12,Hai Phong City,Le Chan District,22,15,6,9,0
2022-07-12,Hai Phong City,Le Chan District,23,9,3,6,3
2022-07-12,Hai Phong City,Ngo Quyen District,1,1,1,0,0
2022-07-12,Hai Phong City,Ngo Quyen District,3,1,0,1,0
2022-07-12,Hai Phong City,Ngo Quyen District,6,5,3,2,1
2022-07-12,Hai Phong City,Ngo Quyen District,7,37,27,10,8
2022-07-12,Hai Phong City,Ngo Quyen District,8,81,72,9,3
2022-07-12,Hai Phong City,Ngo Quyen District,9,95,85,10,2
2022-07-12,Hai Phong City,Ngo Quyen District,10,140,116,24,1
2022-07-12,Hai Phong City,Ngo Quyen District,11,244,227,17,8
2022-07-12,Hai Phong City,Ngo Quyen District,12,178,152,26,4
2022-07-12,Hai Phong City,Ngo Quyen District,13,133,115,18,4
2022-07-12,Hai Phong City,Ngo Quyen District,14,158,144,14,4
2022-07-12,Hai Phong City,Ngo Quyen District,15,167,153,14,0
2022-07-12,Hai Phong City,Ngo Quyen District,16,155,136,19,4
2022-07-12,Hai Phong City,Ngo Quyen District,17,101,90,11,0
2022-07-12,Hai Phong City,Ngo Quyen District,18,155,140,15,5
2022-07-12,Hai Phong City,Ngo Quyen District,19,186,153,33,6
2022-07-12,Hai Phong City,Ngo Quyen District,20,130,114,16,4
2022-07-12,Hai Phong City,Ngo Quyen District,21,85,63,22,7
2022-07-12,Hai Phong City,Ngo Quyen District,22,20,10,10,4
2022-07-12,Hai Phong City,Ngo Quyen District,23,4,1,3,3
2022-07-12,Hai Phong City,Thuy Nguyen,7,2,0,2,2
2022-07-12,Hai Phong City,Thuy Nguyen,8,1,0,1,1
2022-07-12,Hai Phong City,Thuy Nguyen,10,3,0,3,3
2022-07-12,Hai Phong City,Thuy Nguyen,11,4,0,4,4
2022-07-12,Hai Phong City,Thuy Nguyen,12,2,0,2,2
2022-07-12,Hai Phong City,Thuy Nguyen,13,1,0,1,0
2022-07-12,Hai Phong City,Thuy Nguyen,14,1,0,1,1
2022-07-12,Hai Phong City,Thuy Nguyen,15,1,0,1,1
2022-07-12,Hai Phong City,Thuy Nguyen,17,1,0,1,1
2022-07-12,Hue City,Hue City,0,9,4,5,2
2022-07-12,Hue City,Hue City,1,6,3,3,0
2022-07-12,Hue City,Hue City,3,1,0,1,1
2022-07-12,Hue City,Hue City,5,2,1,1,1
2022-07-12,Hue City,Hue City,6,92,78,14,0
2022-07-12,Hue City,Hue City,7,188,174,14,2
2022-07-12,Hue City,Hue City,8,352,324,28,6
2022-07-12,Hue City,Hue City,9,275,256,19,2
2022-07-12,Hue City,Hue City,10,448,410,38,2
2022-07-12,Hue City,Hue City,11,957,887,70,11
2022-07-12,Hue City,Hue City,12,606,572,34,1
2022-07-12,Hue City,Hue City,13,410,386,24,2
2022-07-12,Hue City,Hue City,14,438,408,30,3
2022-07-12,Hue City,Hue City,15,441,408,33,2
2022-07-12,Hue City,Hue City,16,364,349,15,1
2022-07-12,Hue City,Hue City,17,462,420,42,0
2022-07-12,Hue City,Hue City,18,516,479,37,1
2022-07-12,Hue City,Hue City,19,596,558,38,1
2022-07-12,Hue City,Hue City,20,434,379,55,5
2022-07-12,Hue City,Hue City,21,252,224,28,3
2022-07-12,Hue City,Hue City,22,61,45,16,1
2022-07-12,Hue City,Hue City,23,8,7,1,0
2022-07-12,Hue City,Huong Thuy,7,1,1,0,0
2022-07-12,Hue City,Huong Thuy,8,1,1,0,0
2022-07-12,Hue City,Huong Thuy,9,2,1,1,0
2022-07-12,Hue City,Huong Thuy,10,1,1,0,0
2022-07-12,Hue City,Huong Thuy,11,5,3,2,1
2022-07-12,Hue City,Huong Thuy,12,3,2,1,1
2022-07-12,Hue City,Huong Thuy,13,1,1,0,0
2022-07-12,Hue City,Huong Thuy,14,1,1,0,0
2022-07-12,Hue City,Huong Thuy,15,1,0,1,0
2022-07-12,Hue City,Huong Thuy,17,3,2,1,1
2022-07-12,Hue City,Huong Thuy,19,1,0,1,0
2022-07-12,Hue City,Huong Tra,11,1,1,0,0
2022-07-12,Hue City,Huong Tra,12,1,1,0,0
2022-07-12,Hue City,Huong Tra,19,1,1,0,0
2022-07-12,Hue City,Huong Tra,20,1,1,0,0
2022-07-12,Hue City,Phu Vang,6,2,1,1,1
2022-07-12,Hue City,Phu Vang,8,6,3,3,2
2022-07-12,Hue City,Phu Vang,11,4,4,0,0
2022-07-12,Hue City,Phu Vang,12,3,1,2,2
2022-07-12,Hue City,Phu Vang,13,2,2,0,0
2022-07-12,Hue City,Phu Vang,14,2,1,1,0
2022-07-12,Hue City,Phu Vang,15,1,0,1,0
2022-07-12,Hue City,Phu Vang,16,2,1,1,1
2022-07-12,Hue City,Phu Vang,17,1,0,1,0
2022-07-12,Hue City,Phu Vang,19,3,1,2,0
2022-07-12,Hue City,Phu Vang,22,1,1,0,0
2022-07-12,Khanh Hoa,Cam Ranh City,12,1,0,1,1
2022-07-12,Khanh Hoa,Cam Ranh City,13,2,0,2,2
2022-07-12,Khanh Hoa,Nha Trang City,0,1,1,0,0
2022-07-12,Khanh Hoa,Nha Trang City,1,6,0,6,6
2022-07-12,Khanh Hoa,Nha Trang City,2,3,1,2,2
2022-07-12,Khanh Hoa,Nha Trang City,3,1,0,1,1
2022-07-12,Khanh Hoa,Nha Trang City,5,2,2,0,0
2022-07-12,Khanh Hoa,Nha Trang City,6,35,26,9,5
2022-07-12,Khanh Hoa,Nha Trang City,7,108,99,9,0
2022-07-12,Khanh Hoa,Nha Trang City,8,159,152,7,0
2022-07-12,Khanh Hoa,Nha Trang City,9,183,173,10,0
2022-07-12,Khanh Hoa,Nha Trang City,10,231,214,17,1
2022-07-12,Khanh Hoa,Nha Trang City,11,406,375,31,3
2022-07-12,Khanh Hoa,Nha Trang City,12,300,281,19,1
2022-07-12,Khanh Hoa,Nha Trang City,13,248,233,15,0
2022-07-12,Khanh Hoa,Nha Trang City,14,235,215,20,0
2022-07-12,Khanh Hoa,Nha Trang City,15,211,195,16,2
2022-07-12,Khanh Hoa,Nha Trang City,16,212,193,19,0
2022-07-12,Khanh Hoa,Nha Trang City,17,262,237,25,1
2022-07-12,Khanh Hoa,Nha Trang City,18,272,251,21,1
2022-07-12,Khanh Hoa,Nha Trang City,19,276,255,21,1
2022-07-12,Khanh Hoa,Nha Trang City,20,208,185,23,0
2022-07-12,Khanh Hoa,Nha Trang City,21,123,101,22,6
2022-07-12,Khanh Hoa,Nha Trang City,22,33,19,14,3
2022-07-12,Khanh Hoa,Nha Trang City,23,17,9,8,4
2022-07-12,Lam Dong,Da Lat City,0,13,1,12,9
2022-07-12,Lam Dong,Da Lat City,1,7,0,7,6
2022-07-12,Lam Dong,Da Lat City,2,3,1,2,2
2022-07-12,Lam Dong,Da Lat City,6,9,3,6,5
2022-07-12,Lam Dong,Da Lat City,7,56,34,22,15
2022-07-12,Lam Dong,Da Lat City,8,92,61,31,18
2022-07-12,Lam Dong,Da Lat City,9,91,73,18,3
2022-07-12,Lam Dong,Da Lat City,10,107,90,17,5
2022-07-12,Lam Dong,Da Lat City,11,143,97,46,32
2022-07-12,Lam Dong,Da Lat City,12,143,109,34,27
2022-07-12,Lam Dong,Da Lat City,13,167,109,58,40
2022-07-12,Lam Dong,Da Lat City,14,112,89,23,13
2022-07-12,Lam Dong,Da Lat City,15,121,87,34,25
2022-07-12,Lam Dong,Da Lat City,16,127,86,41,27
2022-07-12,Lam Dong,Da Lat City,17,154,95,59,41
2022-07-12,Lam Dong,Da Lat City,18,208,108,100,74
2022-07-12,Lam Dong,Da Lat City,19,194,110,84,62
2022-07-12,Lam Dong,Da Lat City,20,139,84,55,35
2022-07-12,Lam Dong,Da Lat City,21,118,57,61,45
2022-07-12,Lam Dong,Da Lat City,22,37,26,11,6
2022-07-12,Lam Dong,Da Lat City,23,12,7,5,2
2022-07-12,Nghe An,Vinh City,0,1,1,0,0
2022-07-12,Nghe An,Vinh City,1,2,0,2,2
2022-07-12,Nghe An,Vinh City,2,1,0,1,0
2022-07-12,Nghe An,Vinh City,5,2,0,2,2
2022-07-12,Nghe An,Vinh City,6,34,3,31,26
2022-07-12,Nghe An,Vinh City,7,210,112,98,83
2022-07-12,Nghe An,Vinh City,8,209,172,37,14
2022-07-12,Nghe An,Vinh City,9,162,140,22,3
2022-07-12,Nghe An,Vinh City,10,227,179,48,20
2022-07-12,Nghe An,Vinh City,11,359,294,65,32
2022-07-12,Nghe An,Vinh City,12,216,189,27,4
2022-07-12,Nghe An,Vinh City,13,164,123,41,22
2022-07-12,Nghe An,Vinh City,14,190,137,53,30
2022-07-12,Nghe An,Vinh City,15,209,164,45,17
2022-07-12,Nghe An,Vinh City,16,155,125,30,9
2022-07-12,Nghe An,Vinh City,17,151,125,26,7
2022-07-12,Nghe An,Vinh City,18,198,149,49,21
2022-07-12,Nghe An,Vinh City,19,162,129,33,13
2022-07-12,Nghe An,Vinh City,20,185,79,106,81
2022-07-12,Nghe An,Vinh City,21,92,56,36,14
2022-07-12,Nghe An,Vinh City,22,21,13,8,1
2022-07-12,Nghe An,Vinh City,23,3,2,1,0
2022-07-12,Quang Nam,Hoi An City,7,18,10,8,5
2022-07-12,Quang Nam,Hoi An City,8,34,19,15,4
2022-07-12,Quang Nam,Hoi An City,9,24,19,5,1
2022-07-12,Quang Nam,Hoi An City,10,32,25,7,1
2022-07-12,Quang Nam,Hoi An City,11,41,34,7,2
2022-07-12,Quang Nam,Hoi An City,12,41,38,3,0
2022-07-12,Quang Nam,Hoi An City,13,39,37,2,1
2022-07-12,Quang Nam,Hoi An City,14,41,28,13,7
2022-07-12,Quang Nam,Hoi An City,15,46,33,13,6
2022-07-12,Quang Nam,Hoi An City,16,32,29,3,0
2022-07-12,Quang Nam,Hoi An City,17,36,29,7,1
2022-07-12,Quang Nam,Hoi An City,18,57,35,22,14
2022-07-12,Quang Nam,Hoi An City,19,57,49,8,3
2022-07-12,Quang Nam,Hoi An City,20,48,35,13,4
2022-07-12,Quang Nam,Hoi An City,21,20,11,9,5
2022-07-12,Quang Nam,Hoi An City,22,7,1,6,5
2022-07-12,Quang Nam,Hoi An City,23,1,0,1,1
2022-07-12,Quang Ninh,Cam Pha City,14,1,0,1,1
2022-07-12,Quang Ninh,Cam Pha City,16,1,0,1,1
2022-07-12,Quang Ninh,Cam Pha City,18,1,0,1,1
2022-07-12,Quang Ninh,Cam Pha City,19,1,0,1,1
2022-07-12,Quang Ninh,Cam Pha City,20,1,0,1,1
2022-07-12,Quang Ninh,Cam Pha City,22,1,0,1,1
2022-07-12,Quang Ninh,Ha Long City,5,2,0,2,1
2022-07-12,Quang Ninh,Ha Long City,6,7,1,6,4
2022-07-12,Quang Ninh,Ha Long City,7,27,23,4,1
2022-07-12,Quang Ninh,Ha Long City,8,59,37,22,7
2022-07-12,Quang Ninh,Ha Long City,9,67,51,16,6
2022-07-12,Quang Ninh,Ha Long City,10,91,66,25,11
2022-07-12,Quang Ninh,Ha Long City,11,150,115,35,20
2022-07-12,Quang Ninh,Ha Long City,12,106,75,31,24
2022-07-12,Quang Ninh,Ha Long City,13,96,45,51,36
2022-07-12,Quang Ninh,Ha Long City,14,99,44,55,38
2022-07-12,Quang Ninh,Ha Long City,15,93,50,43,29
2022-07-12,Quang Ninh,Ha Long City,16,54,41,13,5
2022-07-12,Quang Ninh,Ha Long City,17,45,29,16,12
2022-07-12,Quang Ninh,Ha Long City,18,71,53,18,14
2022-07-12,Quang Ninh,Ha Long City,19,84,56,28,16
2022-07-12,Quang Ninh,Ha Long City,20,75,42,33,25
2022-07-12,Quang Ninh,Ha Long City,21,50,17,33,23
2022-07-12,Quang Ninh,Ha Long City,22,19,1,18,17
2022-07-12,Quang Ninh,Ha Long City,23,8,0,8,8
2022-07-12,Quang Ninh,Uong Bi City,14,2,0,2,0
2022-07-12,Thai Nguyen,Dong Hy,7,1,0,1,1
2022-07-12,Thai Nguyen,Dong Hy,8,2,2,0,0
2022-07-12,Thai Nguyen,Dong Hy,9,1,1,0,0
2022-07-12,Thai Nguyen,Dong Hy,11,1,0,1,0
2022-07-12,Thai Nguyen,Dong Hy,19,1,1,0,0
2022-07-12,Thai Nguyen,Pho Yen,14,1,0,1,1
2022-07-12,Thai Nguyen,Thai Nguyen City,0,4,1,3,3
2022-07-12,Thai Nguyen,Thai Nguyen City,1,2,1,1,0
2022-07-12,Thai Nguyen,Thai Nguyen City,5,5,1,4,4
2022-07-12,Thai Nguyen,Thai Nguyen City,6,21,14,7,6
2022-07-12,Thai Nguyen,Thai Nguyen City,7,92,86,6,0
2022-07-12,Thai Nguyen,Thai Nguyen City,8,165,154,11,1
2022-07-12,Thai Nguyen,Thai Nguyen City,9,126,109,17,1
2022-07-12,Thai Nguyen,Thai Nguyen City,10,202,186,16,0
2022-07-12,Thai Nguyen,Thai Nguyen City,11,434,402,32,2
2022-07-12,Thai Nguyen,Thai Nguyen City,12,241,224,17,2
2022-07-12,Thai Nguyen,Thai Nguyen City,13,177,159,18,0
2022-07-12,Thai Nguyen,Thai Nguyen City,14,180,155,25,1
2022-07-12,Thai Nguyen,Thai Nguyen City,15,183,166,17,2
2022-07-12,Thai Nguyen,Thai Nguyen City,16,147,142,5,0
2022-07-12,Thai Nguyen,Thai Nguyen City,17,135,124,11,0
2022-07-12,Thai Nguyen,Thai Nguyen City,18,188,166,22,1
2022-07-12,Thai Nguyen,Thai Nguyen City,19,223,203,20,0
2022-07-12,Thai Nguyen,Thai Nguyen City,20,205,178,27,1
2022-07-12,Thai Nguyen,Thai Nguyen City,21,112,97,15,0
2022-07-12,Thai Nguyen,Thai Nguyen City,22,17,11,6,1
2022-07-12,Thai Nguyen,Thai Nguyen City,23,6,3,3,1
2022-07-12,Vung Tau,Ba Ria City,7,2,0,2,2
2022-07-12,Vung Tau,Ba Ria City,8,8,3,5,2
2022-07-12,Vung Tau,Ba Ria City,9,16,7,9,7
2022-07-12,Vung Tau,Ba Ria City,10,4,4,0,0
2022-07-12,Vung Tau,Ba Ria City,11,4,3,1,1
2022-07-12,Vung Tau,Ba Ria City,12,6,5,1,1
2022-07-12,Vung Tau,Ba Ria City,13,4,3,1,1
2022-07-12,Vung Tau,Ba Ria City,14,6,4,2,1
2022-07-12,Vung Tau,Ba Ria City,15,1,1,0,0
2022-07-12,Vung Tau,Ba Ria City,16,6,2,4,4
2022-07-12,Vung Tau,Ba Ria City,17,5,4,1,1
2022-07-12,Vung Tau,Ba Ria City,18,10,0,10,9
2022-07-12,Vung Tau,Ba Ria City,19,8,0,8,7
2022-07-12,Vung Tau,Ba Ria City,20,8,0,8,7
2022-07-12,Vung Tau,Ba Ria City,21,6,0,6,4
2022-07-12,Vung Tau,Chau Duc,14,1,0,1,1
2022-07-12,Vung Tau,Vung Tau City,0,4,1,3,2
2022-07-12,Vung Tau,Vung Tau City,1,2,0,2,2
2022-07-12,Vung Tau,Vung Tau City,2,1,0,1,1
2022-07-12,Vung Tau,Vung Tau City,3,1,1,0,0
2022-07-12,Vung Tau,Vung Tau City,5,2,2,0,0
2022-07-12,Vung Tau,Vung Tau City,6,26,21,5,3
2022-07-12,Vung Tau,Vung Tau City,7,116,110,6,2
2022-07-12,Vung Tau,Vung Tau City,8,178,167,11,0
2022-07-12,Vung Tau,Vung Tau City,9,185,171,14,0
2022-07-12,Vung Tau,Vung Tau City,10,198,181,17,1
2022-07-12,Vung Tau,Vung Tau City,11,362,333,29,6
2022-07-12,Vung Tau,Vung Tau City,12,279,263,16,1
2022-07-12,Vung Tau,Vung Tau City,13,239,215,24,2
2022-07-12,Vung Tau,Vung Tau City,14,254,230,24,5
2022-07-12,Vung Tau,Vung Tau City,15,244,222,22,2
2022-07-12,Vung Tau,Vung Tau City,16,293,259,34,10
2022-07-12,Vung Tau,Vung Tau City,17,307,280,27,8
2022-07-12,Vung Tau,Vung Tau City,18,331,280,51,15
2022-07-12,Vung Tau,Vung Tau City,19,260,223,37,8
2022-07-12,Vung Tau,Vung Tau City,20,207,170,37,9
2022-07-12,Vung Tau,Vung Tau City,21,151,93,58,18
2022-07-12,Vung Tau,Vung Tau City,22,47,35,12,1
2022-07-12,Vung Tau,Vung Tau City,23,12,10,2,2
2022-07-13,Bac Ninh,Bác Ninh City,0,9,5,4,3
2022-07-13,Bac Ninh,Bác Ninh City,1,2,2,0,0
2022-07-13,Bac Ninh,Bác Ninh City,2,1,1,0,0
2022-07-13,Bac Ninh,Bác Ninh City,5,4,0,4,3
2022-07-13,Bac Ninh,Bác Ninh City,6,19,13,6,4
2022-07-13,Bac Ninh,Bác Ninh City,7,51,45,6,2
2022-07-13,Bac Ninh,Bác Ninh City,8,132,118,14,1
2022-07-13,Bac Ninh,Bác Ninh City,9,101,92,9,1
2022-07-13,Bac Ninh,Bác Ninh City,10,167,144,23,2
2022-07-13,Bac Ninh,Bác Ninh City,11,313,285,28,4
2022-07-13,Bac Ninh,Bác Ninh City,12,214,198,16,2
2022-07-13,Bac Ninh,Bác Ninh City,13,146,141,5,0
2022-07-13,Bac Ninh,Bác Ninh City,14,150,138,12,2
2022-07-13,Bac Ninh,Bác Ninh City,15,125,103,22,9
2022-07-13,Bac Ninh,Bác Ninh City,16,141,112,29,15
2022-07-13,Bac Ninh,Bác Ninh City,17,126,114,12,1
2022-07-13,Bac Ninh,Bác Ninh City,18,138,127,11,1
2022-07-13,Bac Ninh,Bác Ninh City,19,156,142,14,2
2022-07-13,Bac Ninh,Bác Ninh City,20,154,132,22,3
2022-07-13,Bac Ninh,Bác Ninh City,21,101,83,18,1
2022-07-13,Bac Ninh,Bác Ninh City,22,23,18,5,0
2022-07-13,Bac Ninh,Bác Ninh City,23,17,12,5,1
2022-07-13,Bac Ninh,Que Vo,7,1,0,1,1
2022-07-13,Bac Ninh,Que Vo,9,5,1,4,4
2022-07-13,Bac Ninh,Que Vo,13,1,0,1,0
2022-07-13,Bac Ninh,Que Vo,14,6,0,6,6
2022-07-13,Bac Ninh,Que Vo,16,2,0,2,1
2022-07-13,Bac Ninh,Que Vo,19,1,0,1,1
2022-07-13,Bac Ninh,Que Vo,20,1,0,1,0
2022-07-13,Bac Ninh,Tien Du,0,1,0,1,1
2022-07-13,Bac Ninh,Tien Du,9,1,0,1,1
2022-07-13,Bac Ninh,Tien Du,10,2,0,2,2
2022-07-13,Bac Ninh,Tien Du,11,2,0,2,1
2022-07-13,Bac Ninh,Tien Du,12,1,0,1,1
2022-07-13,Bac Ninh,Tien Du,13,1,0,1,1
2022-07-13,Bac Ninh,Tien Du,15,1,0,1,1
2022-07-13,Bac Ninh,Tien Du,17,1,0,1,1
2022-07-13,Bac Ninh,Tien Du,21,1,0,1,1
2022-07-13,Bac Ninh,Tu Son,9,1,0,1,1
2022-07-13,Bac Ninh,Tu Son,10,1,0,1,1
2022-07-13,Bac Ninh,Tu Son,11,2,0,2,2
2022-07-13,Bac Ninh,Tu Son,13,2,0,2,2
2022-07-13,Bac Ninh,Tu Son,14,1,0,1,1
2022-07-13,Bac Ninh,Tu Son,17,1,0,1,1
2022-07-13,Bac Ninh,Tu Son,18,2,0,2,2
2022-07-13,Binh Duong,Ben Cat,8,2,0,2,2
2022-07-13,Binh Duong,Ben Cat,9,3,0,3,3
2022-07-13,Binh Duong,Ben Cat,12,1,0,1,1
2022-07-13,Binh Duong,Ben Cat,13,1,0,1,1
2022-07-13,Binh Duong,Ben Cat,14,2,0,2,2
2022-07-13,Binh Duong,Ben Cat,15,2,0,2,2
2022-07-13,Binh Duong,Ben Cat,16,3,0,3,1
2022-07-13,Binh Duong,Ben Cat,17,3,0,3,2
2022-07-13,Binh Duong,Ben Cat,19,1,0,1,1
2022-07-13,Binh Duong,Ben Cat,20,1,0,1,1
2022-07-13,Binh Duong,Ben Cat,22,1,0,1,1
2022-07-13,Binh Duong,Ben Cat,23,1,0,1,0
2022-07-13,Binh Duong,Di An,1,1,0,1,0
2022-07-13,Binh Duong,Di An,2,1,0,1,1
2022-07-13,Binh Duong,Di An,3,2,0,2,2
2022-07-13,Binh Duong,Di An,6,1,0,1,1
2022-07-13,Binh Duong,Di An,7,8,5,3,3
2022-07-13,Binh Duong,Di An,8,21,13,8,4
2022-07-13,Binh Duong,Di An,9,21,13,8,5
2022-07-13,Binh Duong,Di An,10,41,33,8,8
2022-07-13,Binh Duong,Di An,11,36,33,3,3
2022-07-13,Binh Duong,Di An,12,48,36,12,7
2022-07-13,Binh Duong,Di An,13,42,34,8,2
2022-07-13,Binh Duong,Di An,14,46,33,13,8
2022-07-13,Binh Duong,Di An,15,35,26,9,5
2022-07-13,Binh Duong,Di An,16,35,22,13,11
2022-07-13,Binh Duong,Di An,17,29,23,6,3
2022-07-13,Binh Duong,Di An,18,32,24,8,1
2022-07-13,Binh Duong,Di An,19,33,20,13,5
2022-07-13,Binh Duong,Di An,20,23,18,5,2
2022-07-13,Binh Duong,Di An,21,8,4,4,3
2022-07-13,Binh Duong,Di An,22,2,1,1,1
2022-07-13,Binh Duong,Di An,23,2,0,2,2
2022-07-13,Binh Duong,Tan Uyen,8,1,0,1,0
2022-07-13,Binh Duong,Tan Uyen,9,4,3,1,1
2022-07-13,Binh Duong,Tan Uyen,10,7,1,6,2
2022-07-13,Binh Duong,Tan Uyen,11,1,1,0,0
2022-07-13,Binh Duong,Tan Uyen,12,4,0,4,3
2022-07-13,Binh Duong,Tan Uyen,13,4,4,0,0
2022-07-13,Binh Duong,Tan Uyen,14,2,1,1,0
2022-07-13,Binh Duong,Tan Uyen,15,1,1,0,0
2022-07-13,Binh Duong,Tan Uyen,16,3,0,3,3
2022-07-13,Binh Duong,Tan Uyen,17,2,1,1,1
2022-07-13,Binh Duong,Tan Uyen,18,1,1,0,0
2022-07-13,Binh Duong,Tan Uyen,19,2,0,2,2
2022-07-13,Binh Duong,Tan Uyen,20,2,0,2,1
2022-07-13,Binh Duong,Thu Dau Mot Town,0,7,1,6,5
2022-07-13,Binh Duong,Thu Dau Mot Town,1,3,0,3,2
2022-07-13,Binh Duong,Thu Dau Mot Town,2,3,1,2,1
2022-07-13,Binh Duong,Thu Dau Mot Town,3,3,0,3,2
2022-07-13,Binh Duong,Thu Dau Mot Town,4,1,1,0,0
2022-07-13,Binh Duong,Thu Dau Mot Town,5,4,4,0,0
2022-07-13,Binh Duong,Thu Dau Mot Town,6,36,30,6,3
2022-07-13,Binh Duong,Thu Dau Mot Town,7,122,112,10,2
2022-07-13,Binh Duong,Thu Dau Mot Town,8,221,206,15,1
2022-07-13,Binh Duong,Thu Dau Mot Town,9,262,246,16,4
2022-07-13,Binh Duong,Thu Dau Mot Town,10,434,412,22,3
2022-07-13,Binh Duong,Thu Dau Mot Town,11,659,599,60,8
2022-07-13,Binh Duong,Thu Dau Mot Town,12,483,445,38,10
2022-07-13,Binh Duong,Thu Dau Mot Town,13,459,433,26,3
2022-07-13,Binh Duong,Thu Dau Mot Town,14,377,348,29,6
2022-07-13,Binh Duong,Thu Dau Mot Town,15,317,285,32,11
2022-07-13,Binh Duong,Thu Dau Mot Town,16,294,275,19,6
2022-07-13,Binh Duong,Thu Dau Mot Town,17,350,329,21,3
2022-07-13,Binh Duong,Thu Dau Mot Town,18,409,372,37,7
2022-07-13,Binh Duong,Thu Dau Mot Town,19,385,339,46,16
2022-07-13,Binh Duong,Thu Dau Mot Town,20,284,259,25,8
2022-07-13,Binh Duong,Thu Dau Mot Town,21,110,92,18,5
2022-07-13,Binh Duong,Thu Dau Mot Town,22,34,21,13,1
2022-07-13,Binh Duong,Thu Dau Mot Town,23,10,7,3,1
2022-07-13,Binh Duong,Thuan An,0,2,1,1,0
2022-07-13,Binh Duong,Thuan An,6,2,1,1,1
2022-07-13,Binh Duong,Thuan An,7,12,7,5,4
2022-07-13,Binh Duong,Thuan An,8,32,27,5,1
2022-07-13,Binh Duong,Thuan An,9,48,32,16,10
2022-07-13,Binh Duong,Thuan An,10,80,64,16,5
2022-07-13,Binh Duong,Thuan An,11,101,84,17,2
2022-07-13,Binh Duong,Thuan An,12,76,65,11,2
2022-07-13,Binh Duong,Thuan An,13,113,87,26,16
2022-07-13,Binh Duong,Thuan An,14,61,49,12,7
2022-07-13,Binh Duong,Thuan An,15,48,42,6,3
2022-07-13,Binh Duong,Thuan An,16,48,35,13,9
2022-07-13,Binh Duong,Thuan An,17,55,42,13,11
2022-07-13,Binh Duong,Thuan An,18,51,44,7,3
2022-07-13,Binh Duong,Thuan An,19,49,34,15,7
2022-07-13,Binh Duong,Thuan An,20,53,37,16,10
2022-07-13,Binh Duong,Thuan An,21,26,17,9,6
2022-07-13,Binh Duong,Thuan An,22,4,3,1,1
2022-07-13,Binh Duong,Thuan An,23,5,0,5,5
2022-07-13,Can Tho City,Binh Thuy District,7,3,1,2,1
2022-07-13,Can Tho City,Binh Thuy District,8,10,7,3,0
2022-07-13,Can Tho City,Binh Thuy District,9,7,6,1,0
2022-07-13,Can Tho City,Binh Thuy District,10,13,12,1,1
2022-07-13,Can Tho City,Binh Thuy District,11,21,20,1,0
2022-07-13,Can Tho City,Binh Thuy District,12,14,13,1,0
2022-07-13,Can Tho City,Binh Thuy District,13,11,11,0,0
2022-07-13,Can Tho City,Binh Thuy District,14,19,18,1,0
2022-07-13,Can Tho City,Binh Thuy District,15,9,9,0,0
2022-07-13,Can Tho City,Binh Thuy District,16,10,9,1,0
2022-07-13,Can Tho City,Binh Thuy District,17,11,9,2,0
2022-07-13,Can Tho City,Binh Thuy District,18,10,10,0,0
2022-07-13,Can Tho City,Binh Thuy District,19,9,8,1,1
2022-07-13,Can Tho City,Binh Thuy District,20,7,7,0,0
2022-07-13,Can Tho City,Binh Thuy District,21,4,3,1,0
2022-07-13,Can Tho City,Binh Thuy District,22,3,2,1,0
2022-07-13,Can Tho City,Binh Thuy District,23,1,1,0,0
2022-07-13,Can Tho City,Cai Rang District,0,1,0,1,0
2022-07-13,Can Tho City,Cai Rang District,6,3,0,3,3
2022-07-13,Can Tho City,Cai Rang District,7,15,4,11,7
2022-07-13,Can Tho City,Cai Rang District,8,21,11,10,5
2022-07-13,Can Tho City,Cai Rang District,9,19,17,2,1
2022-07-13,Can Tho City,Cai Rang District,10,13,12,1,0
2022-07-13,Can Tho City,Cai Rang District,11,15,13,2,0
2022-07-13,Can Tho City,Cai Rang District,12,20,15,5,2
2022-07-13,Can Tho City,Cai Rang District,13,14,12,2,0
2022-07-13,Can Tho City,Cai Rang District,14,15,15,0,0
2022-07-13,Can Tho City,Cai Rang District,15,6,5,1,0
2022-07-13,Can Tho City,Cai Rang District,16,9,9,0,0
2022-07-13,Can Tho City,Cai Rang District,17,22,20,2,0
2022-07-13,Can Tho City,Cai Rang District,18,13,9,4,3
2022-07-13,Can Tho City,Cai Rang District,19,5,5,0,0
2022-07-13,Can Tho City,Cai Rang District,20,8,7,1,1
2022-07-13,Can Tho City,Cai Rang District,21,1,1,0,0
2022-07-13,Can Tho City,Cai Rang District,23,2,2,0,0
2022-07-13,Can Tho City,Ninh Kieu District,0,18,5,13,7
2022-07-13,Can Tho City,Ninh Kieu District,1,4,0,4,4
2022-07-13,Can Tho City,Ninh Kieu District,2,5,0,5,2
2022-07-13,Can Tho City,Ninh Kieu District,3,1,1,0,0
2022-07-13,Can Tho City,Ninh Kieu District,5,3,0,3,2
2022-07-13,Can Tho City,Ninh Kieu District,6,71,29,42,32
2022-07-13,Can Tho City,Ninh Kieu District,7,246,118,128,108
2022-07-13,Can Tho City,Ninh Kieu District,8,450,296,154,112
2022-07-13,Can Tho City,Ninh Kieu District,9,410,368,42,6
2022-07-13,Can Tho City,Ninh Kieu District,10,597,567,30,0
2022-07-13,Can Tho City,Ninh Kieu District,11,843,780,63,4
2022-07-13,Can Tho City,Ninh Kieu District,12,636,607,29,0
2022-07-13,Can Tho City,Ninh Kieu District,13,585,553,32,0
2022-07-13,Can Tho City,Ninh Kieu District,14,405,383,22,0
2022-07-13,Can Tho City,Ninh Kieu District,15,367,352,15,0
2022-07-13,Can Tho City,Ninh Kieu District,16,426,403,23,3
2022-07-13,Can Tho City,Ninh Kieu District,17,525,509,16,0
2022-07-13,Can Tho City,Ninh Kieu District,18,515,480,35,1
2022-07-13,Can Tho City,Ninh Kieu District,19,446,423,23,0
2022-07-13,Can Tho City,Ninh Kieu District,20,352,328,24,0
2022-07-13,Can Tho City,Ninh Kieu District,21,242,223,19,0
2022-07-13,Can Tho City,Ninh Kieu District,22,47,36,11,0
2022-07-13,Can Tho City,Ninh Kieu District,23,15,11,4,1
2022-07-13,Can Tho City,Phong Dien,16,1,0,1,1
2022-07-13,Dong Nai,Bien Hoa City,0,6,0,6,4
2022-07-13,Dong Nai,Bien Hoa City,1,2,1,1,1
2022-07-13,Dong Nai,Bien Hoa City,2,3,1,2,1
2022-07-13,Dong Nai,Bien Hoa City,4,2,1,1,1
2022-07-13,Dong Nai,Bien Hoa City,5,4,1,3,2
2022-07-13,Dong Nai,Bien Hoa City,6,51,35,16,12
2022-07-13,Dong Nai,Bien Hoa City,7,172,155,17,6
2022-07-13,Dong Nai,Bien Hoa City,8,318,289,29,2
2022-07-13,Dong Nai,Bien Hoa City,9,423,397,26,1
2022-07-13,Dong Nai,Bien Hoa City,10,735,676,59,10
2022-07-13,Dong Nai,Bien Hoa City,11,1048,962,86,13
2022-07-13,Dong Nai,Bien Hoa City,12,917,850,67,13
2022-07-13,Dong Nai,Bien Hoa City,13,808,763,45,8
2022-07-13,Dong Nai,Bien Hoa City,14,744,693,51,8
2022-07-13,Dong Nai,Bien Hoa City,15,538,519,19,2
2022-07-13,Dong Nai,Bien Hoa City,16,529,508,21,3
2022-07-13,Dong Nai,Bien Hoa City,17,596,564,32,2
2022-07-13,Dong Nai,Bien Hoa City,18,669,619,50,6
2022-07-13,Dong Nai,Bien Hoa City,19,662,598,64,14
2022-07-13,Dong Nai,Bien Hoa City,20,490,438,52,8
2022-07-13,Dong Nai,Bien Hoa City,21,249,203,46,13
2022-07-13,Dong Nai,Bien Hoa City,22,35,13,22,9
2022-07-13,Dong Nai,Bien Hoa City,23,10,5,5,4
2022-07-13,Dong Nai,Long Khanh,19,1,0,1,1
2022-07-13,Dong Nai,Long Thanh,12,3,0,3,2
2022-07-13,Dong Nai,Long Thanh,13,1,0,1,1
2022-07-13,Dong Nai,Long Thanh,14,1,0,1,1
2022-07-13,Dong Nai,Long Thanh,17,2,0,2,2
2022-07-13,Dong Nai,Long Thanh,21,2,0,2,2
2022-07-13,Dong Nai,Nhon trach,10,2,0,2,1
2022-07-13,Dong Nai,Nhon trach,11,1,0,1,1
2022-07-13,Dong Nai,Nhon trach,12,1,0,1,1
2022-07-13,Dong Nai,Nhon trach,13,1,0,1,1
2022-07-13,Dong Nai,Nhon trach,14,2,0,2,2
2022-07-13,Dong Nai,Nhon trach,19,4,0,4,4
2022-07-13,Dong Nai,Trang Bom,13,1,0,1,0
2022-07-13,Dong Nai,Vinh Cuu,8,1,0,1,1
2022-07-13,Dong Nai,Vinh Cuu,9,4,0,4,3
2022-07-13,Dong Nai,Vinh Cuu,10,1,0,1,1
2022-07-13,Dong Nai,Vinh Cuu,13,1,0,1,1
2022-07-13,Dong Nai,Vinh Cuu,15,1,1,0,0
2022-07-13,Hai Phong City,An Duong,8,2,0,2,2
2022-07-13,Hai Phong City,An Duong,9,2,1,1,1
2022-07-13,Hai Phong City,An Duong,10,4,4,0,0
2022-07-13,Hai Phong City,An Duong,11,9,4,5,3
2022-07-13,Hai Phong City,An Duong,12,9,6,3,1
2022-07-13,Hai Phong City,An Duong,13,4,1,3,2
2022-07-13,Hai Phong City,An Duong,14,3,1,2,1
2022-07-13,Hai Phong City,An Duong,15,2,1,1,1
2022-07-13,Hai Phong City,An Duong,16,2,1,1,0
2022-07-13,Hai Phong City,An Duong,17,4,2,2,1
2022-07-13,Hai Phong City,An Duong,18,3,3,0,0
2022-07-13,Hai Phong City,An Duong,19,2,2,0,0
2022-07-13,Hai Phong City,An Duong,20,3,0,3,3
2022-07-13,Hai Phong City,An Duong,21,1,1,0,0
2022-07-13,Hai Phong City,An Duong,22,1,0,1,0
2022-07-13,Hai Phong City,Duong Kinh District,20,1,1,0,0
2022-07-13,Hai Phong City,Hai An District,2,1,0,1,0
2022-07-13,Hai Phong City,Hai An District,5,2,1,1,1
2022-07-13,Hai Phong City,Hai An District,6,1,0,1,1
2022-07-13,Hai Phong City,Hai An District,7,4,3,1,1
2022-07-13,Hai Phong City,Hai An District,8,9,6,3,1
2022-07-13,Hai Phong City,Hai An District,9,22,19,3,0
2022-07-13,Hai Phong City,Hai An District,10,22,21,1,0
2022-07-13,Hai Phong City,Hai An District,11,44,42,2,0
2022-07-13,Hai Phong City,Hai An District,12,29,27,2,1
2022-07-13,Hai Phong City,Hai An District,13,16,11,5,0
2022-07-13,Hai Phong City,Hai An District,14,14,12,2,1
2022-07-13,Hai Phong City,Hai An District,15,30,17,13,4
2022-07-13,Hai Phong City,Hai An District,16,17,13,4,1
2022-07-13,Hai Phong City,Hai An District,17,24,22,2,0
2022-07-13,Hai Phong City,Hai An District,18,35,30,5,0
2022-07-13,Hai Phong City,Hai An District,19,28,23,5,0
2022-07-13,Hai Phong City,Hai An District,20,22,16,6,3
2022-07-13,Hai Phong City,Hai An District,21,9,7,2,0
2022-07-13,Hai Phong City,Hai An District,22,2,1,1,1
2022-07-13,Hai Phong City,Hai An District,23,2,1,1,1
2022-07-13,Hai Phong City,Hong Bang District,6,4,1,3,1
2022-07-13,Hai Phong City,Hong Bang District,7,19,15,4,4
2022-07-13,Hai Phong City,Hong Bang District,8,31,23,8,5
2022-07-13,Hai Phong City,Hong Bang District,9,34,33,1,0
2022-07-13,Hai Phong City,Hong Bang District,10,63,51,12,2
2022-07-13,Hai Phong City,Hong Bang District,11,112,99,13,5
2022-07-13,Hai Phong City,Hong Bang District,12,82,71,11,1
2022-07-13,Hai Phong City,Hong Bang District,13,50,48,2,1
2022-07-13,Hai Phong City,Hong Bang District,14,48,39,9,1
2022-07-13,Hai Phong City,Hong Bang District,15,32,29,3,0
2022-07-13,Hai Phong City,Hong Bang District,16,42,39,3,2
2022-07-13,Hai Phong City,Hong Bang District,17,49,43,6,0
2022-07-13,Hai Phong City,Hong Bang District,18,41,38,3,0
2022-07-13,Hai Phong City,Hong Bang District,19,61,58,3,1
2022-07-13,Hai Phong City,Hong Bang District,20,26,24,2,0
2022-07-13,Hai Phong City,Hong Bang District,21,16,10,6,0
2022-07-13,Hai Phong City,Hong Bang District,22,4,0,4,4
2022-07-13,Hai Phong City,Kien An District,3,1,0,1,1
2022-07-13,Hai Phong City,Kien An District,4,1,0,1,1
2022-07-13,Hai Phong City,Kien An District,7,1,0,1,1
2022-07-13,Hai Phong City,Kien An District,8,1,0,1,1
2022-07-13,Hai Phong City,Kien An District,9,6,4,2,0
2022-07-13,Hai Phong City,Kien An District,10,8,5,3,0
2022-07-13,Hai Phong City,Kien An District,11,7,5,2,2
2022-07-13,Hai Phong City,Kien An District,12,9,6,3,2
2022-07-13,Hai Phong City,Kien An District,13,11,7,4,2
2022-07-13,Hai Phong City,Kien An District,14,1,0,1,0
2022-07-13,Hai Phong City,Kien An District,15,3,3,0,0
2022-07-13,Hai Phong City,Kien An District,16,6,4,2,1
2022-07-13,Hai Phong City,Kien An District,17,6,5,1,1
2022-07-13,Hai Phong City,Kien An District,18,7,5,2,2
2022-07-13,Hai Phong City,Kien An District,19,9,7,2,1
2022-07-13,Hai Phong City,Kien An District,20,14,7,7,6
2022-07-13,Hai Phong City,Kien An District,21,3,1,2,2
2022-07-13,Hai Phong City,Le Chan District,0,1,1,0,0
2022-07-13,Hai Phong City,Le Chan District,1,1,0,1,0
2022-07-13,Hai Phong City,Le Chan District,2,3,1,2,2
2022-07-13,Hai Phong City,Le Chan District,5,1,1,0,0
2022-07-13,Hai Phong City,Le Chan District,6,11,2,9,7
2022-07-13,Hai Phong City,Le Chan District,7,47,24,23,19
2022-07-13,Hai Phong City,Le Chan District,8,85,67,18,11
2022-07-13,Hai Phong City,Le Chan District,9,87,75,12,1
2022-07-13,Hai Phong City,Le Chan District,10,160,147,13,3
2022-07-13,Hai Phong City,Le Chan District,11,333,301,32,11
2022-07-13,Hai Phong City,Le Chan District,12,283,250,33,6
2022-07-13,Hai Phong City,Le Chan District,13,138,119,19,3
2022-07-13,Hai Phong City,Le Chan District,14,149,122,27,5
2022-07-13,Hai Phong City,Le Chan District,15,184,162,22,3
2022-07-13,Hai Phong City,Le Chan District,16,187,165,22,6
2022-07-13,Hai Phong City,Le Chan District,17,155,144,11,1
2022-07-13,Hai Phong City,Le Chan District,18,215,178,37,0
2022-07-13,Hai Phong City,Le Chan District,19,228,194,34,6
2022-07-13,Hai Phong City,Le Chan District,20,140,120,20,2
2022-07-13,Hai Phong City,Le Chan District,21,93,76,17,1
2022-07-13,Hai Phong City,Le Chan District,22,16,11,5,1
2022-07-13,Hai Phong City,Le Chan District,23,9,1,8,7
2022-07-13,Hai Phong City,Ngo Quyen District,0,1,1,0,0
2022-07-13,Hai Phong City,Ngo Quyen District,5,1,0,1,1
2022-07-13,Hai Phong City,Ngo Quyen District,6,9,2,7,2
2022-07-13,Hai Phong City,Ngo Quyen District,7,25,16,9,6
2022-07-13,Hai Phong City,Ngo Quyen District,8,64,47,17,10
2022-07-13,Hai Phong City,Ngo Quyen District,9,85,73,12,1
2022-07-13,Hai Phong City,Ngo Quyen District,10,163,150,13,2
2022-07-13,Hai Phong City,Ngo Quyen District,11,246,224,22,7
2022-07-13,Hai Phong City,Ngo Quyen District,12,201,182,19,3
2022-07-13,Hai Phong City,Ngo Quyen District,13,110,90,20,3
2022-07-13,Hai Phong City,Ngo Quyen District,14,146,128,18,7
2022-07-13,Hai Phong City,Ngo Quyen District,15,145,128,17,1
2022-07-13,Hai Phong City,Ngo Quyen District,16,100,89,11,0
2022-07-13,Hai Phong City,Ngo Quyen District,17,122,110,12,2
2022-07-13,Hai Phong City,Ngo Quyen District,18,152,135,17,1
2022-07-13,Hai Phong City,Ngo Quyen District,19,164,144,20,3
2022-07-13,Hai Phong City,Ngo Quyen District,20,120,102,18,2
2022-07-13,Hai Phong City,Ngo Quyen District,21,94,66,28,4
2022-07-13,Hai Phong City,Ngo Quyen District,22,7,3,4,1
2022-07-13,Hai Phong City,Ngo Quyen District,23,4,0,4,3
2022-07-13,Hai Phong City,Thuy Nguyen,10,3,0,3,3
2022-07-13,Hai Phong City,Thuy Nguyen,12,3,0,3,2
2022-07-13,Hai Phong City,Thuy Nguyen,17,1,0,1,1
2022-07-13,Hue City,Hue City,0,13,5,8,4
2022-07-13,Hue City,Hue City,3,3,1,2,1
2022-07-13,Hue City,Hue City,5,3,3,0,0
2022-07-13,Hue City,Hue City,6,79,67,12,5
2022-07-13,Hue City,Hue City,7,231,204,27,2
2022-07-13,Hue City,Hue City,8,307,288,19,0
2022-07-13,Hue City,Hue City,9,287,258,29,0
2022-07-13,Hue City,Hue City,10,481,455,26,0
2022-07-13,Hue City,Hue City,11,966,886,80,4
2022-07-13,Hue City,Hue City,12,676,626,50,1
2022-07-13,Hue City,Hue City,13,395,377,18,1
2022-07-13,Hue City,Hue City,14,423,385,38,2
2022-07-13,Hue City,Hue City,15,397,363,34,0
2022-07-13,Hue City,Hue City,16,416,386,30,2
2022-07-13,Hue City,Hue City,17,513,473,40,2
2022-07-13,Hue City,Hue City,18,526,493,33,0
2022-07-13,Hue City,Hue City,19,556,524,32,0
2022-07-13,Hue City,Hue City,20,562,463,99,26
2022-07-13,Hue City,Hue City,21,417,311,106,25
2022-07-13,Hue City,Hue City,22,88,59,29,1
2022-07-13,Hue City,Hue City,23,30,22,8,5
2022-07-13,Hue City,Huong Thuy,9,1,1,0,0
2022-07-13,Hue City,Huong Thuy,10,2,2,0,0
2022-07-13,Hue City,Huong Thuy,11,1,1,0,0
2022-07-13,Hue City,Huong Thuy,12,3,2,1,0
2022-07-13,Hue City,Huong Thuy,13,1,1,0,0
2022-07-13,Hue City,Huong Thuy,14,2,1,1,0
2022-07-13,Hue City,Huong Thuy,15,1,0,1,0
2022-07-13,Hue City,Huong Thuy,16,1,1,0,0
2022-07-13,Hue City,Huong Thuy,17,2,2,0,0
2022-07-13,Hue City,Huong Thuy,19,1,1,0,0
2022-07-13,Hue City,Huong Thuy,21,1,1,0,0
2022-07-13,Hue City,Huong Tra,9,1,1,0,0
2022-07-13,Hue City,Huong Tra,11,1,0,1,0
2022-07-13,Hue City,Huong Tra,12,1,1,0,0
2022-07-13,Hue City,Huong Tra,14,1,0,1,0
2022-07-13,Hue City,Phu Vang,6,2,1,1,1
2022-07-13,Hue City,Phu Vang,7,2,2,0,0
2022-07-13,Hue City,Phu Vang,8,2,1,1,0
2022-07-13,Hue City,Phu Vang,11,2,2,0,0
2022-07-13,Hue City,Phu Vang,12,6,5,1,0
2022-07-13,Hue City,Phu Vang,13,1,1,0,0
2022-07-13,Hue City,Phu Vang,14,2,1,1,1
2022-07-13,Hue City,Phu Vang,15,1,0,1,0
2022-07-13,Hue City,Phu Vang,16,3,3,0,0
2022-07-13,Hue City,Phu Vang,17,4,3,1,0
2022-07-13,Hue City,Phu Vang,18,1,1,0,0
2022-07-13,Hue City,Phu Vang,19,2,1,1,1
2022-07-13,Hue City,Phu Vang,20,1,0,1,1
2022-07-13,Hue City,Phu Vang,21,1,1,0,0
2022-07-13,Khanh Hoa,Dien Khanh,11,1,0,1,1
2022-07-13,Khanh Hoa,Dien Khanh,16,1,0,1,1
2022-07-13,Khanh Hoa,Dien Khanh,17,1,0,1,1
2022-07-13,Khanh Hoa,Nha Trang City,0,4,3,1,0
2022-07-13,Khanh Hoa,Nha Trang City,1,2,0,2,0
2022-07-13,Khanh Hoa,Nha Trang City,2,3,0,3,3
2022-07-13,Khanh Hoa,Nha Trang City,3,1,0,1,1
2022-07-13,Khanh Hoa,Nha Trang City,5,1,0,1,0
2022-07-13,Khanh Hoa,Nha Trang City,6,38,31,7,2
2022-07-13,Khanh Hoa,Nha Trang City,7,150,126,24,2
2022-07-13,Khanh Hoa,Nha Trang City,8,202,184,18,4
2022-07-13,Khanh Hoa,Nha Trang City,9,207,188,19,1
2022-07-13,Khanh Hoa,Nha Trang City,10,232,215,17,2
2022-07-13,Khanh Hoa,Nha Trang City,11,367,331,36,2
2022-07-13,Khanh Hoa,Nha Trang City,12,324,301,23,1
2022-07-13,Khanh Hoa,Nha Trang City,13,250,235,15,3
2022-07-13,Khanh Hoa,Nha Trang City,14,220,208,12,1
2022-07-13,Khanh Hoa,Nha Trang City,15,205,152,53,26
2022-07-13,Khanh Hoa,Nha Trang City,16,286,219,67,37
2022-07-13,Khanh Hoa,Nha Trang City,17,348,297,51,23
2022-07-13,Khanh Hoa,Nha Trang City,18,351,299,52,21
2022-07-13,Khanh Hoa,Nha Trang City,19,374,296,78,33
2022-07-13,Khanh Hoa,Nha Trang City,20,203,174,29,5
2022-07-13,Khanh Hoa,Nha Trang City,21,130,93,37,11
2022-07-13,Khanh Hoa,Nha Trang City,22,39,17,22,13
2022-07-13,Khanh Hoa,Nha Trang City,23,8,2,6,4
2022-07-13,Lam Dong,Da Lat City,0,8,0,8,3
2022-07-13,Lam Dong,Da Lat City,1,7,0,7,4
2022-07-13,Lam Dong,Da Lat City,2,3,0,3,2
2022-07-13,Lam Dong,Da Lat City,3,3,0,3,3
2022-07-13,Lam Dong,Da Lat City,6,25,3,22,20
2022-07-13,Lam Dong,Da Lat City,7,62,20,42,36
2022-07-13,Lam Dong,Da Lat City,8,97,61,36,27
2022-07-13,Lam Dong,Da Lat City,9,123,73,50,39
2022-07-13,Lam Dong,Da Lat City,10,109,88,21,12
2022-07-13,Lam Dong,Da Lat City,11,131,101,30,19
2022-07-13,Lam Dong,Da Lat City,12,195,102,93,76
2022-07-13,Lam Dong,Da Lat City,13,142,107,35,18
2022-07-13,Lam Dong,Da Lat City,14,136,106,30,21
2022-07-13,Lam Dong,Da Lat City,15,138,82,56,42
2022-07-13,Lam Dong,Da Lat City,16,117,73,44,35
2022-07-13,Lam Dong,Da Lat City,17,132,95,37,22
2022-07-13,Lam Dong,Da Lat City,18,161,101,60,37
2022-07-13,Lam Dong,Da Lat City,19,160,96,64,48
2022-07-13,Lam Dong,Da Lat City,20,141,85,56,44
2022-07-13,Lam Dong,Da Lat City,21,61,37,24,11
2022-07-13,Lam Dong,Da Lat City,22,30,20,10,4
2022-07-13,Lam Dong,Da Lat City,23,11,4,7,4
2022-07-13,Nghe An,Hung Nguyen,15,1,0,1,0
2022-07-13,Nghe An,Vinh City,0,2,0,2,0
2022-07-13,Nghe An,Vinh City,2,2,0,2,2
2022-07-13,Nghe An,Vinh City,3,2,0,2,1
2022-07-13,Nghe An,Vinh City,5,5,1,4,3
2022-07-13,Nghe An,Vinh City,6,14,4,10,9
2022-07-13,Nghe An,Vinh City,7,141,109,32,16
2022-07-13,Nghe An,Vinh City,8,189,171,18,7
2022-07-13,Nghe An,Vinh City,9,164,138,26,6
2022-07-13,Nghe An,Vinh City,10,179,162,17,4
2022-07-13,Nghe An,Vinh City,11,358,292,66,30
2022-07-13,Nghe An,Vinh City,12,203,185,18,2
2022-07-13,Nghe An,Vinh City,13,126,116,10,0
2022-07-13,Nghe An,Vinh City,14,190,162,28,4
2022-07-13,Nghe An,Vinh City,15,192,159,33,1
2022-07-13,Nghe An,Vinh City,16,121,107,14,1
2022-07-13,Nghe An,Vinh City,17,143,120,23,7
2022-07-13,Nghe An,Vinh City,18,197,160,37,20
2022-07-13,Nghe An,Vinh City,19,231,113,118,88
2022-07-13,Nghe An,Vinh City,20,158,87,71,58
2022-07-13,Nghe An,Vinh City,21,125,38,87,72
2022-07-13,Nghe An,Vinh City,22,33,11,22,15
2022-07-13,Nghe An,Vinh City,23,7,3,4,2
2022-07-13,Quang Nam,Hoi An City,7,12,8,4,3
2022-07-13,Quang Nam,Hoi An City,8,29,20,9,3
2022-07-13,Quang Nam,Hoi An City,9,25,19,6,1
2022-07-13,Quang Nam,Hoi An City,10,43,30,13,1
2022-07-13,Quang Nam,Hoi An City,11,51,38,13,5
2022-07-13,Quang Nam,Hoi An City,12,40,35,5,1
2022-07-13,Quang Nam,Hoi An City,13,38,32,6,4
2022-07-13,Quang Nam,Hoi An City,14,52,40,12,4
2022-07-13,Quang Nam,Hoi An City,15,44,38,6,1
2022-07-13,Quang Nam,Hoi An City,16,40,32,8,7
2022-07-13,Quang Nam,Hoi An City,17,46,37,9,4
2022-07-13,Quang Nam,Hoi An City,18,50,38,12,1
2022-07-13,Quang Nam,Hoi An City,19,53,38,15,7
2022-07-13,Quang Nam,Hoi An City,20,53,20,33,24
2022-07-13,Quang Nam,Hoi An City,21,42,17,25,20
2022-07-13,Quang Nam,Hoi An City,22,16,3,13,5
2022-07-13,Quang Nam,Hoi An City,23,8,0,8,7
2022-07-13,Quang Nam,Tam Ky City,12,1,0,1,1
2022-07-13,Quang Nam,Tam Ky City,14,1,0,1,1
2022-07-13,Quang Ninh,Cam Pha City,8,1,0,1,1
2022-07-13,Quang Ninh,Cam Pha City,10,2,0,2,2
2022-07-13,Quang Ninh,Cam Pha City,15,4,0,4,2
2022-07-13,Quang Ninh,Cam Pha City,18,1,0,1,1
2022-07-13,Quang Ninh,Ha Long City,0,1,0,1,1
2022-07-13,Quang Ninh,Ha Long City,2,1,1,0,0
2022-07-13,Quang Ninh,Ha Long City,3,1,0,1,1
2022-07-13,Quang Ninh,Ha Long City,6,3,1,2,2
2022-07-13,Quang Ninh,Ha Long City,7,28,16,12,7
2022-07-13,Quang Ninh,Ha Long City,8,61,35,26,17
2022-07-13,Quang Ninh,Ha Long City,9,63,32,31,19
2022-07-13,Quang Ninh,Ha Long City,10,77,58,19,6
2022-07-13,Quang Ninh,Ha Long City,11,148,117,31,15
2022-07-13,Quang Ninh,Ha Long City,12,98,70,28,12
2022-07-13,Quang Ninh,Ha Long City,13,84,65,19,9
2022-07-13,Quang Ninh,Ha Long City,14,84,51,33,7
2022-07-13,Quang Ninh,Ha Long City,15,66,45,21,9
2022-07-13,Quang Ninh,Ha Long City,16,68,48,20,5
2022-07-13,Quang Ninh,Ha Long City,17,67,53,14,5
2022-07-13,Quang Ninh,Ha Long City,18,71,58,13,3
2022-07-13,Quang Ninh,Ha Long City,19,70,52,18,10
2022-07-13,Quang Ninh,Ha Long City,20,61,35,26,11
2022-07-13,Quang Ninh,Ha Long City,21,31,16,15,12
2022-07-13,Quang Ninh,Ha Long City,22,16,8,8,2
2022-07-13,Quang Ninh,Ha Long City,23,3,1,2,2
2022-07-13,Thai Nguyen,Dong Hy,10,1,0,1,0
2022-07-13,Thai Nguyen,Dong Hy,11,1,0,1,0
2022-07-13,Thai Nguyen,Dong Hy,22,3,2,1,0
2022-07-13,Thai Nguyen,Thai Nguyen City,1,4,0,4,2
2022-07-13,Thai Nguyen,Thai Nguyen City,2,7,3,4,4
2022-07-13,Thai Nguyen,Thai Nguyen City,3,1,0,1,1
2022-07-13,Thai Nguyen,Thai Nguyen City,5,1,0,1,1
2022-07-13,Thai Nguyen,Thai Nguyen City,6,17,12,5,3
2022-07-13,Thai Nguyen,Thai Nguyen City,7,87,82,5,1
2022-07-13,Thai Nguyen,Thai Nguyen City,8,172,158,14,0
2022-07-13,Thai Nguyen,Thai Nguyen City,9,151,139,12,1
2022-07-13,Thai Nguyen,Thai Nguyen City,10,214,198,16,0
2022-07-13,Thai Nguyen,Thai Nguyen City,11,407,377,30,3
2022-07-13,Thai Nguyen,Thai Nguyen City,12,227,221,6,0
2022-07-13,Thai Nguyen,Thai Nguyen City,13,123,113,10,0
2022-07-13,Thai Nguyen,Thai Nguyen City,14,167,156,11,2
2022-07-13,Thai Nguyen,Thai Nguyen City,15,152,143,9,1
2022-07-13,Thai Nguyen,Thai Nguyen City,16,104,95,9,1
2022-07-13,Thai Nguyen,Thai Nguyen City,17,159,141,18,0
2022-07-13,Thai Nguyen,Thai Nguyen City,18,211,203,8,0
2022-07-13,Thai Nguyen,Thai Nguyen City,19,231,207,24,0
2022-07-13,Thai Nguyen,Thai Nguyen City,20,175,162,13,2
2022-07-13,Thai Nguyen,Thai Nguyen City,21,111,99,12,0
2022-07-13,Thai Nguyen,Thai Nguyen City,22,18,12,6,0
2022-07-13,Thai Nguyen,Thai Nguyen City,23,18,11,7,2
2022-07-13,Vung Tau,Ba Ria City,8,2,2,0,0
2022-07-13,Vung Tau,Ba Ria City,9,5,4,1,1
2022-07-13,Vung Tau,Ba Ria City,10,4,2,2,1
2022-07-13,Vung Tau,Ba Ria City,11,9,6,3,0
2022-07-13,Vung Tau,Ba Ria City,12,4,3,1,1
2022-07-13,Vung Tau,Ba Ria City,13,7,6,1,1
2022-07-13,Vung Tau,Ba Ria City,14,10,6,4,3
2022-07-13,Vung Tau,Ba Ria City,15,1,1,0,0
2022-07-13,Vung Tau,Ba Ria City,16,3,3,0,0
2022-07-13,Vung Tau,Ba Ria City,17,4,3,1,1
2022-07-13,Vung Tau,Ba Ria City,18,9,6,3,3
2022-07-13,Vung Tau,Ba Ria City,19,7,1,6,5
2022-07-13,Vung Tau,Ba Ria City,20,5,0,5,4
2022-07-13,Vung Tau,Ba Ria City,21,1,0,1,0
2022-07-13,Vung Tau,Chau Duc,11,1,0,1,1
2022-07-13,Vung Tau,Tan Thanh,21,1,0,1,1
2022-07-13,Vung Tau,Vung Tau City,0,5,4,1,1
2022-07-13,Vung Tau,Vung Tau City,1,3,1,2,2
2022-07-13,Vung Tau,Vung Tau City,2,1,0,1,1
2022-07-13,Vung Tau,Vung Tau City,3,2,2,0,0
2022-07-13,Vung Tau,Vung Tau City,5,2,0,2,1
2022-07-13,Vung Tau,Vung Tau City,6,37,29,8,2
2022-07-13,Vung Tau,Vung Tau City,7,122,106,16,5
2022-07-13,Vung Tau,Vung Tau City,8,174,159,15,2
2022-07-13,Vung Tau,Vung Tau City,9,210,189,21,0
2022-07-13,Vung Tau,Vung Tau City,10,211,188,23,0
2022-07-13,Vung Tau,Vung Tau City,11,356,329,27,3
2022-07-13,Vung Tau,Vung Tau City,12,277,266,11,1
2022-07-13,Vung Tau,Vung Tau City,13,243,228,15,1
2022-07-13,Vung Tau,Vung Tau City,14,237,221,16,4
2022-07-13,Vung Tau,Vung Tau City,15,208,195,13,0
2022-07-13,Vung Tau,Vung Tau City,16,204,193,11,1
2022-07-13,Vung Tau,Vung Tau City,17,253,242,11,1
2022-07-13,Vung Tau,Vung Tau City,18,301,280,21,8
2022-07-13,Vung Tau,Vung Tau City,19,302,273,29,5
2022-07-13,Vung Tau,Vung Tau City,20,181,153,28,4
2022-07-13,Vung Tau,Vung Tau City,21,96,73,23,5
2022-07-13,Vung Tau,Vung Tau City,22,21,20,1,0
2022-07-13,Vung Tau,Vung Tau City,23,3,2,1,0
2022-07-14,Bac Ninh,Bác Ninh City,0,5,5,0,0
2022-07-14,Bac Ninh,Bác Ninh City,2,1,1,0,0
2022-07-14,Bac Ninh,Bác Ninh City,4,1,0,1,0
2022-07-14,Bac Ninh,Bác Ninh City,6,6,4,2,1
2022-07-14,Bac Ninh,Bác Ninh City,7,83,76,7,1
2022-07-14,Bac Ninh,Bác Ninh City,8,152,133,19,0
2022-07-14,Bac Ninh,Bác Ninh City,9,109,101,8,0
2022-07-14,Bac Ninh,Bác Ninh City,10,191,169,22,2
2022-07-14,Bac Ninh,Bác Ninh City,11,381,345,36,4
2022-07-14,Bac Ninh,Bác Ninh City,12,207,197,10,2
2022-07-14,Bac Ninh,Bác Ninh City,13,154,141,13,0
2022-07-14,Bac Ninh,Bác Ninh City,14,121,107,14,3
2022-07-14,Bac Ninh,Bác Ninh City,15,167,156,11,2
2022-07-14,Bac Ninh,Bác Ninh City,16,145,128,17,2
2022-07-14,Bac Ninh,Bác Ninh City,17,145,139,6,0
2022-07-14,Bac Ninh,Bác Ninh City,18,152,143,9,1
2022-07-14,Bac Ninh,Bác Ninh City,19,184,164,20,6
2022-07-14,Bac Ninh,Bác Ninh City,20,146,133,13,3
2022-07-14,Bac Ninh,Bác Ninh City,21,77,67,10,1
2022-07-14,Bac Ninh,Bác Ninh City,22,13,7,6,0
2022-07-14,Bac Ninh,Bác Ninh City,23,8,6,2,1
2022-07-14,Bac Ninh,Que Vo,8,1,0,1,1
2022-07-14,Bac Ninh,Que Vo,9,2,1,1,1
2022-07-14,Bac Ninh,Que Vo,10,1,1,0,0
2022-07-14,Bac Ninh,Que Vo,13,1,1,0,0
2022-07-14,Bac Ninh,Que Vo,14,2,1,1,1
2022-07-14,Bac Ninh,Que Vo,15,2,0,2,2
2022-07-14,Bac Ninh,Tien Du,14,1,0,1,1
2022-07-14,Bac Ninh,Tien Du,17,1,0,1,1
2022-07-14,Bac Ninh,Tien Du,19,1,0,1,1
2022-07-14,Bac Ninh,Tu Son,12,1,0,1,1
2022-07-14,Bac Ninh,Tu Son,15,3,0,3,3
2022-07-14,Bac Ninh,Tu Son,20,1,0,1,1
2022-07-14,Bac Ninh,Yen Phong,16,1,0,1,1
2022-07-14,Binh Duong,Ben Cat,11,1,0,1,1
2022-07-14,Binh Duong,Ben Cat,13,2,0,2,2
2022-07-14,Binh Duong,Ben Cat,14,1,0,1,1
2022-07-14,Binh Duong,Ben Cat,17,3,0,3,3
2022-07-14,Binh Duong,Ben Cat,18,1,0,1,1
2022-07-14,Binh Duong,Ben Cat,19,2,0,2,2
2022-07-14,Binh Duong,Ben Cat,20,1,0,1,1
2022-07-14,Binh Duong,Ben Cat,21,2,0,2,2
2022-07-14,Binh Duong,Di An,0,3,0,3,2
2022-07-14,Binh Duong,Di An,1,1,0,1,0
2022-07-14,Binh Duong,Di An,3,2,0,2,2
2022-07-14,Binh Duong,Di An,7,6,1,5,3
2022-07-14,Binh Duong,Di An,8,16,9,7,7
2022-07-14,Binh Duong,Di An,9,31,18,13,8
2022-07-14,Binh Duong,Di An,10,51,32,19,11
2022-07-14,Binh Duong,Di An,11,33,31,2,0
2022-07-14,Binh Duong,Di An,12,45,34,11,4
2022-07-14,Binh Duong,Di An,13,53,37,16,7
2022-07-14,Binh Duong,Di An,14,38,28,10,4
2022-07-14,Binh Duong,Di An,15,37,29,8,1
2022-07-14,Binh Duong,Di An,16,28,17,11,6
2022-07-14,Binh Duong,Di An,17,23,20,3,1
2022-07-14,Binh Duong,Di An,18,33,25,8,2
2022-07-14,Binh Duong,Di An,19,36,26,10,6
2022-07-14,Binh Duong,Di An,20,24,18,6,3
2022-07-14,Binh Duong,Di An,21,17,9,8,5
2022-07-14,Binh Duong,Di An,22,2,0,2,1
2022-07-14,Binh Duong,Di An,23,5,1,4,4
2022-07-14,Binh Duong,Tan Uyen,9,2,2,0,0
2022-07-14,Binh Duong,Tan Uyen,10,2,1,1,1
2022-07-14,Binh Duong,Tan Uyen,11,4,2,2,1
2022-07-14,Binh Duong,Tan Uyen,12,3,2,1,0
2022-07-14,Binh Duong,Tan Uyen,13,4,0,4,3
2022-07-14,Binh Duong,Tan Uyen,14,2,1,1,1
2022-07-14,Binh Duong,Tan Uyen,15,1,0,1,1
2022-07-14,Binh Duong,Tan Uyen,16,3,1,2,0
2022-07-14,Binh Duong,Tan Uyen,17,1,0,1,1
2022-07-14,Binh Duong,Tan Uyen,18,5,0,5,2
2022-07-14,Binh Duong,Tan Uyen,19,4,3,1,1
2022-07-14,Binh Duong,Tan Uyen,20,4,2,2,2
2022-07-14,Binh Duong,Tan Uyen,21,3,0,3,3
2022-07-14,Binh Duong,Thu Dau Mot Town,0,3,3,0,0
2022-07-14,Binh Duong,Thu Dau Mot Town,1,1,0,1,1
2022-07-14,Binh Duong,Thu Dau Mot Town,3,2,1,1,1
2022-07-14,Binh Duong,Thu Dau Mot Town,5,1,0,1,1
2022-07-14,Binh Duong,Thu Dau Mot Town,6,42,26,16,11
2022-07-14,Binh Duong,Thu Dau Mot Town,7,125,110,15,8
2022-07-14,Binh Duong,Thu Dau Mot Town,8,230,210,20,6
2022-07-14,Binh Duong,Thu Dau Mot Town,9,286,265,21,5
2022-07-14,Binh Duong,Thu Dau Mot Town,10,391,352,39,9
2022-07-14,Binh Duong,Thu Dau Mot Town,11,731,668,63,11
2022-07-14,Binh Duong,Thu Dau Mot Town,12,484,461,23,7
2022-07-14,Binh Duong,Thu Dau Mot Town,13,422,403,19,3
2022-07-14,Binh Duong,Thu Dau Mot Town,14,407,372,35,6
2022-07-14,Binh Duong,Thu Dau Mot Town,15,333,292,41,9
2022-07-14,Binh Duong,Thu Dau Mot Town,16,286,266,20,3
2022-07-14,Binh Duong,Thu Dau Mot Town,17,357,327,30,6
2022-07-14,Binh Duong,Thu Dau Mot Town,18,407,374,33,10
2022-07-14,Binh Duong,Thu Dau Mot Town,19,407,364,43,14
2022-07-14,Binh Duong,Thu Dau Mot Town,20,329,291,38,11
2022-07-14,Binh Duong,Thu Dau Mot Town,21,123,106,17,5
2022-07-14,Binh Duong,Thu Dau Mot Town,22,26,20,6,2
2022-07-14,Binh Duong,Thu Dau Mot Town,23,20,14,6,0
2022-07-14,Binh Duong,Thuan An,0,1,0,1,0
2022-07-14,Binh Duong,Thuan An,5,1,1,0,0
2022-07-14,Binh Duong,Thuan An,6,1,0,1,1
2022-07-14,Binh Duong,Thuan An,7,10,6,4,1
2022-07-14,Binh Duong,Thuan An,8,28,17,11,7
2022-07-14,Binh Duong,Thuan An,9,33,30,3,0
2022-07-14,Binh Duong,Thuan An,10,73,61,12,7
2022-07-14,Binh Duong,Thuan An,11,113,92,21,8
2022-07-14,Binh Duong,Thuan An,12,82,72,10,5
2022-07-14,Binh Duong,Thuan An,13,63,58,5,1
2022-07-14,Binh Duong,Thuan An,14,66,60,6,2
2022-07-14,Binh Duong,Thuan An,15,64,43,21,12
2022-07-14,Binh Duong,Thuan An,16,38,31,7,4
2022-07-14,Binh Duong,Thuan An,17,47,38,9,5
2022-07-14,Binh Duong,Thuan An,18,47,39,8,5
2022-07-14,Binh Duong,Thuan An,19,47,37,10,2
2022-07-14,Binh Duong,Thuan An,20,37,21,16,11
2022-07-14,Binh Duong,Thuan An,21,37,14,23,16
2022-07-14,Binh Duong,Thuan An,22,7,3,4,1
2022-07-14,Binh Duong,Thuan An,23,3,1,2,1
2022-07-14,Can Tho City,Binh Thuy District,7,3,2,1,0
2022-07-14,Can Tho City,Binh Thuy District,8,2,2,0,0
2022-07-14,Can Tho City,Binh Thuy District,9,4,3,1,0
2022-07-14,Can Tho City,Binh Thuy District,10,17,16,1,0
2022-07-14,Can Tho City,Binh Thuy District,11,13,10,3,0
2022-07-14,Can Tho City,Binh Thuy District,12,14,12,2,0
2022-07-14,Can Tho City,Binh Thuy District,13,10,9,1,0
2022-07-14,Can Tho City,Binh Thuy District,14,20,18,2,0
2022-07-14,Can Tho City,Binh Thuy District,15,16,16,0,0
2022-07-14,Can Tho City,Binh Thuy District,16,13,13,0,0
2022-07-14,Can Tho City,Binh Thuy District,17,13,12,1,0
2022-07-14,Can Tho City,Binh Thuy District,18,12,11,1,1
2022-07-14,Can Tho City,Binh Thuy District,19,15,14,1,0
2022-07-14,Can Tho City,Binh Thuy District,20,8,8,0,0
2022-07-14,Can Tho City,Binh Thuy District,21,4,3,1,0
2022-07-14,Can Tho City,Binh Thuy District,22,1,1,0,0
2022-07-14,Can Tho City,Cai Rang District,6,5,1,4,4
2022-07-14,Can Tho City,Cai Rang District,7,1,1,0,0
2022-07-14,Can Tho City,Cai Rang District,8,11,8,3,1
2022-07-14,Can Tho City,Cai Rang District,9,11,10,1,0
2022-07-14,Can Tho City,Cai Rang District,10,6,6,0,0
2022-07-14,Can Tho City,Cai Rang District,11,16,15,1,0
2022-07-14,Can Tho City,Cai Rang District,12,11,10,1,0
2022-07-14,Can Tho City,Cai Rang District,13,16,14,2,0
2022-07-14,Can Tho City,Cai Rang District,14,9,9,0,0
2022-07-14,Can Tho City,Cai Rang District,15,12,12,0,0
2022-07-14,Can Tho City,Cai Rang District,16,9,8,1,0
2022-07-14,Can Tho City,Cai Rang District,17,10,9,1,0
2022-07-14,Can Tho City,Cai Rang District,18,14,14,0,0
2022-07-14,Can Tho City,Cai Rang District,19,14,11,3,0
2022-07-14,Can Tho City,Cai Rang District,20,8,6,2,0
2022-07-14,Can Tho City,Cai Rang District,21,4,3,1,0
2022-07-14,Can Tho City,Ninh Kieu District,0,2,2,0,0
2022-07-14,Can Tho City,Ninh Kieu District,1,4,0,4,4
2022-07-14,Can Tho City,Ninh Kieu District,2,3,1,2,1
2022-07-14,Can Tho City,Ninh Kieu District,4,1,1,0,0
2022-07-14,Can Tho City,Ninh Kieu District,5,1,0,1,0
2022-07-14,Can Tho City,Ninh Kieu District,6,61,49,12,4
2022-07-14,Can Tho City,Ninh Kieu District,7,133,121,12,3
2022-07-14,Can Tho City,Ninh Kieu District,8,223,210,13,0
2022-07-14,Can Tho City,Ninh Kieu District,9,238,222,16,0
2022-07-14,Can Tho City,Ninh Kieu District,10,469,446,23,0
2022-07-14,Can Tho City,Ninh Kieu District,11,702,654,48,3
2022-07-14,Can Tho City,Ninh Kieu District,12,597,580,17,0
2022-07-14,Can Tho City,Ninh Kieu District,13,469,451,18,0
2022-07-14,Can Tho City,Ninh Kieu District,14,408,394,14,0
2022-07-14,Can Tho City,Ninh Kieu District,15,379,363,16,0
2022-07-14,Can Tho City,Ninh Kieu District,16,380,367,13,0
2022-07-14,Can Tho City,Ninh Kieu District,17,450,433,17,0
2022-07-14,Can Tho City,Ninh Kieu District,18,484,463,21,0
2022-07-14,Can Tho City,Ninh Kieu District,19,464,447,17,0
2022-07-14,Can Tho City,Ninh Kieu District,20,358,330,28,0
2022-07-14,Can Tho City,Ninh Kieu District,21,209,187,22,0
2022-07-14,Can Tho City,Ninh Kieu District,22,42,36,6,0
2022-07-14,Can Tho City,Ninh Kieu District,23,10,7,3,0
2022-07-14,Can Tho City,O Mon District,8,1,0,1,1
2022-07-14,Can Tho City,O Mon District,12,1,0,1,1
2022-07-14,Dong Nai,Bien Hoa City,0,10,4,6,3
2022-07-14,Dong Nai,Bien Hoa City,1,8,3,5,3
2022-07-14,Dong Nai,Bien Hoa City,2,4,1,3,2
2022-07-14,Dong Nai,Bien Hoa City,3,3,0,3,1
2022-07-14,Dong Nai,Bien Hoa City,5,4,2,2,1
2022-07-14,Dong Nai,Bien Hoa City,6,42,30,12,5
2022-07-14,Dong Nai,Bien Hoa City,7,171,153,18,7
2022-07-14,Dong Nai,Bien Hoa City,8,298,268,30,1
2022-07-14,Dong Nai,Bien Hoa City,9,435,395,40,4
2022-07-14,Dong Nai,Bien Hoa City,10,741,675,66,14
2022-07-14,Dong Nai,Bien Hoa City,11,1146,1059,87,12
2022-07-14,Dong Nai,Bien Hoa City,12,901,841,60,14
2022-07-14,Dong Nai,Bien Hoa City,13,803,756,47,8
2022-07-14,Dong Nai,Bien Hoa City,14,711,659,52,5
2022-07-14,Dong Nai,Bien Hoa City,15,516,481,35,9
2022-07-14,Dong Nai,Bien Hoa City,16,507,469,38,4
2022-07-14,Dong Nai,Bien Hoa City,17,626,587,39,5
2022-07-14,Dong Nai,Bien Hoa City,18,623,585,38,4
2022-07-14,Dong Nai,Bien Hoa City,19,621,573,48,5
2022-07-14,Dong Nai,Bien Hoa City,20,516,447,69,15
2022-07-14,Dong Nai,Bien Hoa City,21,243,190,53,7
2022-07-14,Dong Nai,Bien Hoa City,22,60,35,25,10
2022-07-14,Dong Nai,Bien Hoa City,23,26,12,14,11
2022-07-14,Dong Nai,Long Khanh,17,2,0,2,1
2022-07-14,Dong Nai,Long Thanh,11,1,0,1,0
2022-07-14,Dong Nai,Long Thanh,12,1,0,1,0
2022-07-14,Dong Nai,Long Thanh,13,5,0,5,5
2022-07-14,Dong Nai,Long Thanh,14,5,0,5,5
2022-07-14,Dong Nai,Long Thanh,15,1,0,1,1
2022-07-14,Dong Nai,Long Thanh,17,2,0,2,2
2022-07-14,Dong Nai,Long Thanh,19,4,0,4,4
2022-07-14,Dong Nai,Long Thanh,20,1,0,1,1
2022-07-14,Dong Nai,Nhon trach,9,1,0,1,1
2022-07-14,Dong Nai,Nhon trach,10,2,0,2,2
2022-07-14,Dong Nai,Nhon trach,11,1,0,1,1
2022-07-14,Dong Nai,Trang Bom,10,1,0,1,1
2022-07-14,Dong Nai,Trang Bom,11,3,1,2,2
2022-07-14,Dong Nai,Trang Bom,12,1,1,0,0
2022-07-14,Dong Nai,Trang Bom,13,1,0,1,1
2022-07-14,Dong Nai,Trang Bom,15,2,0,2,2
2022-07-14,Dong Nai,Trang Bom,16,2,0,2,2
2022-07-14,Dong Nai,Trang Bom,18,2,0,2,2
2022-07-14,Dong Nai,Trang Bom,19,5,0,5,4
2022-07-14,Dong Nai,Trang Bom,20,1,0,1,1
2022-07-14,Dong Nai,Vinh Cuu,11,1,1,0,0
2022-07-14,Dong Nai,Vinh Cuu,12,1,1,0,0
2022-07-14,Dong Nai,Vinh Cuu,13,1,1,0,0
2022-07-14,Hai Phong City,An Duong,7,2,0,2,2
2022-07-14,Hai Phong City,An Duong,8,4,2,2,2
2022-07-14,Hai Phong City,An Duong,9,4,1,3,3
2022-07-14,Hai Phong City,An Duong,10,6,2,4,4
2022-07-14,Hai Phong City,An Duong,11,9,2,7,6
2022-07-14,Hai Phong City,An Duong,12,8,4,4,4
2022-07-14,Hai Phong City,An Duong,13,7,5,2,2
2022-07-14,Hai Phong City,An Duong,14,9,4,5,4
2022-07-14,Hai Phong City,An Duong,15,8,3,5,5
2022-07-14,Hai Phong City,An Duong,16,2,0,2,1
2022-07-14,Hai Phong City,An Duong,17,2,2,0,0
2022-07-14,Hai Phong City,An Duong,18,5,3,2,2
2022-07-14,Hai Phong City,An Duong,19,3,2,1,1
2022-07-14,Hai Phong City,An Duong,20,4,2,2,2
2022-07-14,Hai Phong City,Duong Kinh District,14,1,0,1,1
2022-07-14,Hai Phong City,Duong Kinh District,22,1,0,1,1
2022-07-14,Hai Phong City,Hai An District,0,1,0,1,1
2022-07-14,Hai Phong City,Hai An District,3,1,0,1,1
2022-07-14,Hai Phong City,Hai An District,6,1,0,1,1
2022-07-14,Hai Phong City,Hai An District,7,4,4,0,0
2022-07-14,Hai Phong City,Hai An District,8,10,6,4,1
2022-07-14,Hai Phong City,Hai An District,9,18,12,6,0
2022-07-14,Hai Phong City,Hai An District,10,29,23,6,2
2022-07-14,Hai Phong City,Hai An District,11,79,62,17,10
2022-07-14,Hai Phong City,Hai An District,12,35,28,7,0
2022-07-14,Hai Phong City,Hai An District,13,17,13,4,1
2022-07-14,Hai Phong City,Hai An District,14,15,12,3,0
2022-07-14,Hai Phong City,Hai An District,15,22,20,2,0
2022-07-14,Hai Phong City,Hai An District,16,15,13,2,0
2022-07-14,Hai Phong City,Hai An District,17,13,12,1,1
2022-07-14,Hai Phong City,Hai An District,18,26,23,3,0
2022-07-14,Hai Phong City,Hai An District,19,21,16,5,2
2022-07-14,Hai Phong City,Hai An District,20,13,10,3,2
2022-07-14,Hai Phong City,Hai An District,21,10,9,1,1
2022-07-14,Hai Phong City,Hai An District,22,6,2,4,2
2022-07-14,Hai Phong City,Hai An District,23,1,0,1,1
2022-07-14,Hai Phong City,Hong Bang District,3,1,0,1,1
2022-07-14,Hai Phong City,Hong Bang District,6,1,0,1,1
2022-07-14,Hai Phong City,Hong Bang District,7,13,7,6,4
2022-07-14,Hai Phong City,Hong Bang District,8,30,28,2,0
2022-07-14,Hai Phong City,Hong Bang District,9,33,29,4,0
2022-07-14,Hai Phong City,Hong Bang District,10,64,52,12,4
2022-07-14,Hai Phong City,Hong Bang District,11,104,72,32,19
2022-07-14,Hai Phong City,Hong Bang District,12,75,64,11,8
2022-07-14,Hai Phong City,Hong Bang District,13,60,48,12,4
2022-07-14,Hai Phong City,Hong Bang District,14,44,40,4,0
2022-07-14,Hai Phong City,Hong Bang District,15,46,36,10,6
2022-07-14,Hai Phong City,Hong Bang District,16,25,22,3,0
2022-07-14,Hai Phong City,Hong Bang District,17,49,43,6,0
2022-07-14,Hai Phong City,Hong Bang District,18,38,36,2,0
2022-07-14,Hai Phong City,Hong Bang District,19,49,42,7,1
2022-07-14,Hai Phong City,Hong Bang District,20,42,37,5,1
2022-07-14,Hai Phong City,Hong Bang District,21,23,18,5,3
2022-07-14,Hai Phong City,Hong Bang District,22,6,3,3,2
2022-07-14,Hai Phong City,Hong Bang District,23,2,1,1,1
2022-07-14,Hai Phong City,Kien An District,2,2,0,2,1
2022-07-14,Hai Phong City,Kien An District,6,3,0,3,2
2022-07-14,Hai Phong City,Kien An District,7,4,2,2,2
2022-07-14,Hai Phong City,Kien An District,8,4,2,2,0
2022-07-14,Hai Phong City,Kien An District,9,1,0,1,0
2022-07-14,Hai Phong City,Kien An District,10,13,8,5,3
2022-07-14,Hai Phong City,Kien An District,11,12,9,3,2
2022-07-14,Hai Phong City,Kien An District,12,10,7,3,3
2022-07-14,Hai Phong City,Kien An District,13,4,3,1,1
2022-07-14,Hai Phong City,Kien An District,14,16,9,7,5
2022-07-14,Hai Phong City,Kien An District,15,11,8,3,2
2022-07-14,Hai Phong City,Kien An District,16,6,4,2,2
2022-07-14,Hai Phong City,Kien An District,17,3,2,1,0
2022-07-14,Hai Phong City,Kien An District,18,5,4,1,1
2022-07-14,Hai Phong City,Kien An District,19,10,4,6,5
2022-07-14,Hai Phong City,Kien An District,20,13,0,13,11
2022-07-14,Hai Phong City,Kien An District,21,13,2,11,7
2022-07-14,Hai Phong City,Le Chan District,0,2,0,2,1
2022-07-14,Hai Phong City,Le Chan District,1,2,0,2,2
2022-07-14,Hai Phong City,Le Chan District,2,2,2,0,0
2022-07-14,Hai Phong City,Le Chan District,5,1,1,0,0
2022-07-14,Hai Phong City,Le Chan District,6,1,1,0,0
2022-07-14,Hai Phong City,Le Chan District,7,33,28,5,2
2022-07-14,Hai Phong City,Le Chan District,8,75,60,15,0
2022-07-14,Hai Phong City,Le Chan District,9,83,76,7,0
2022-07-14,Hai Phong City,Le Chan District,10,228,191,37,11
2022-07-14,Hai Phong City,Le Chan District,11,375,282,93,47
2022-07-14,Hai Phong City,Le Chan District,12,240,210,30,9
2022-07-14,Hai Phong City,Le Chan District,13,154,127,27,6
2022-07-14,Hai Phong City,Le Chan District,14,176,155,21,3
2022-07-14,Hai Phong City,Le Chan District,15,172,148,24,9
2022-07-14,Hai Phong City,Le Chan District,16,146,134,12,1
2022-07-14,Hai Phong City,Le Chan District,17,175,153,22,3
2022-07-14,Hai Phong City,Le Chan District,18,219,189,30,6
2022-07-14,Hai Phong City,Le Chan District,19,208,187,21,0
2022-07-14,Hai Phong City,Le Chan District,20,133,117,16,5
2022-07-14,Hai Phong City,Le Chan District,21,69,51,18,10
2022-07-14,Hai Phong City,Le Chan District,22,20,9,11,2
2022-07-14,Hai Phong City,Le Chan District,23,7,0,7,5
2022-07-14,Hai Phong City,Ngo Quyen District,0,1,0,1,1
2022-07-14,Hai Phong City,Ngo Quyen District,1,1,1,0,0
2022-07-14,Hai Phong City,Ngo Quyen District,3,1,1,0,0
2022-07-14,Hai Phong City,Ngo Quyen District,6,4,2,2,1
2022-07-14,Hai Phong City,Ngo Quyen District,7,33,21,12,7
2022-07-14,Hai Phong City,Ngo Quyen District,8,92,79,13,5
2022-07-14,Hai Phong City,Ngo Quyen District,9,96,89,7,0
2022-07-14,Hai Phong City,Ngo Quyen District,10,160,140,20,5
2022-07-14,Hai Phong City,Ngo Quyen District,11,233,189,44,26
2022-07-14,Hai Phong City,Ngo Quyen District,12,198,176,22,5
2022-07-14,Hai Phong City,Ngo Quyen District,13,125,113,12,2
2022-07-14,Hai Phong City,Ngo Quyen District,14,134,119,15,2
2022-07-14,Hai Phong City,Ngo Quyen District,15,175,146,29,5
2022-07-14,Hai Phong City,Ngo Quyen District,16,138,119,19,1
2022-07-14,Hai Phong City,Ngo Quyen District,17,124,115,9,1
2022-07-14,Hai Phong City,Ngo Quyen District,18,183,158,25,3
2022-07-14,Hai Phong City,Ngo Quyen District,19,178,158,20,2
2022-07-14,Hai Phong City,Ngo Quyen District,20,94,88,6,0
2022-07-14,Hai Phong City,Ngo Quyen District,21,81,61,20,7
2022-07-14,Hai Phong City,Ngo Quyen District,22,23,13,10,6
2022-07-14,Hai Phong City,Ngo Quyen District,23,6,2,4,4
2022-07-14,Hai Phong City,Thuy Nguyen,9,1,0,1,1
2022-07-14,Hai Phong City,Thuy Nguyen,10,1,0,1,1
2022-07-14,Hai Phong City,Thuy Nguyen,13,1,0,1,0
2022-07-14,Hai Phong City,Thuy Nguyen,14,1,0,1,1
2022-07-14,Hai Phong City,Thuy Nguyen,16,3,0,3,1
2022-07-14,Hai Phong City,Thuy Nguyen,17,2,0,2,2
2022-07-14,Hai Phong City,Thuy Nguyen,19,2,0,2,2
2022-07-14,Hai Phong City,Thuy Nguyen,20,1,0,1,1
2022-07-14,Hue City,Hue City,0,5,3,2,1
2022-07-14,Hue City,Hue City,1,4,3,1,0
2022-07-14,Hue City,Hue City,2,2,1,1,1
2022-07-14,Hue City,Hue City,3,1,0,1,0
2022-07-14,Hue City,Hue City,5,5,3,2,0
2022-07-14,Hue City,Hue City,6,77,68,9,4
2022-07-14,Hue City,Hue City,7,208,191,17,2
2022-07-14,Hue City,Hue City,8,316,291,25,3
2022-07-14,Hue City,Hue City,9,312,284,28,0
2022-07-14,Hue City,Hue City,10,433,398,35,0
2022-07-14,Hue City,Hue City,11,915,831,84,4
2022-07-14,Hue City,Hue City,12,644,608,36,1
2022-07-14,Hue City,Hue City,13,366,337,29,0
2022-07-14,Hue City,Hue City,14,376,348,28,2
2022-07-14,Hue City,Hue City,15,391,337,54,1
2022-07-14,Hue City,Hue City,16,332,312,20,1
2022-07-14,Hue City,Hue City,17,433,407,26,0
2022-07-14,Hue City,Hue City,18,527,492,35,0
2022-07-14,Hue City,Hue City,19,602,560,42,4
2022-07-14,Hue City,Hue City,20,562,480,82,17
2022-07-14,Hue City,Hue City,21,308,258,50,10
2022-07-14,Hue City,Hue City,22,54,35,19,1
2022-07-14,Hue City,Hue City,23,20,15,5,2
2022-07-14,Hue City,Huong Thuy,6,1,1,0,0
2022-07-14,Hue City,Huong Thuy,8,1,1,0,0
2022-07-14,Hue City,Huong Thuy,9,3,3,0,0
2022-07-14,Hue City,Huong Thuy,11,1,0,1,1
2022-07-14,Hue City,Huong Thuy,12,4,3,1,0
2022-07-14,Hue City,Huong Thuy,15,1,1,0,0
2022-07-14,Hue City,Huong Thuy,16,1,1,0,0
2022-07-14,Hue City,Huong Thuy,17,4,3,1,0
2022-07-14,Hue City,Huong Thuy,18,5,3,2,0
2022-07-14,Hue City,Huong Thuy,19,2,2,0,0
2022-07-14,Hue City,Huong Tra,11,1,1,0,0
2022-07-14,Hue City,Huong Tra,17,2,2,0,0
2022-07-14,Hue City,Phu Vang,8,3,2,1,0
2022-07-14,Hue City,Phu Vang,9,1,1,0,0
2022-07-14,Hue City,Phu Vang,11,4,4,0,0
2022-07-14,Hue City,Phu Vang,12,4,1,3,1
2022-07-14,Hue City,Phu Vang,13,6,4,2,2
2022-07-14,Hue City,Phu Vang,14,3,1,2,1
2022-07-14,Hue City,Phu Vang,15,3,0,3,2
2022-07-14,Hue City,Phu Vang,16,2,2,0,0
2022-07-14,Hue City,Phu Vang,17,4,3,1,1
2022-07-14,Hue City,Phu Vang,19,1,0,1,0
2022-07-14,Hue City,Phu Vang,21,2,0,2,1
2022-07-14,Hue City,Phu Vang,22,1,0,1,0
2022-07-14,Khanh Hoa,Dien Khanh,9,2,0,2,1
2022-07-14,Khanh Hoa,Nha Trang City,0,6,1,5,2
2022-07-14,Khanh Hoa,Nha Trang City,1,1,0,1,1
2022-07-14,Khanh Hoa,Nha Trang City,2,2,1,1,1
2022-07-14,Khanh Hoa,Nha Trang City,5,5,3,2,0
2022-07-14,Khanh Hoa,Nha Trang City,6,41,29,12,7
2022-07-14,Khanh Hoa,Nha Trang City,7,115,102,13,4
2022-07-14,Khanh Hoa,Nha Trang City,8,195,177,18,1
2022-07-14,Khanh Hoa,Nha Trang City,9,181,163,18,2
2022-07-14,Khanh Hoa,Nha Trang City,10,210,190,20,3
2022-07-14,Khanh Hoa,Nha Trang City,11,452,398,54,6
2022-07-14,Khanh Hoa,Nha Trang City,12,319,287,32,3
2022-07-14,Khanh Hoa,Nha Trang City,13,252,233,19,0
2022-07-14,Khanh Hoa,Nha Trang City,14,255,241,14,0
2022-07-14,Khanh Hoa,Nha Trang City,15,221,197,24,6
2022-07-14,Khanh Hoa,Nha Trang City,16,224,178,46,25
2022-07-14,Khanh Hoa,Nha Trang City,17,308,254,54,29
2022-07-14,Khanh Hoa,Nha Trang City,18,400,315,85,44
2022-07-14,Khanh Hoa,Nha Trang City,19,286,237,49,15
2022-07-14,Khanh Hoa,Nha Trang City,20,221,191,30,6
2022-07-14,Khanh Hoa,Nha Trang City,21,102,74,28,8
2022-07-14,Khanh Hoa,Nha Trang City,22,18,10,8,1
2022-07-14,Khanh Hoa,Nha Trang City,23,24,5,19,14
2022-07-14,Lam Dong,Da Lat City,0,8,1,7,5
2022-07-14,Lam Dong,Da Lat City,1,5,0,5,4
2022-07-14,Lam Dong,Da Lat City,2,1,0,1,1
2022-07-14,Lam Dong,Da Lat City,3,2,0,2,2
2022-07-14,Lam Dong,Da Lat City,6,8,3,5,5
2022-07-14,Lam Dong,Da Lat City,7,48,38,10,8
2022-07-14,Lam Dong,Da Lat City,8,85,72,13,5
2022-07-14,Lam Dong,Da Lat City,9,98,85,13,6
2022-07-14,Lam Dong,Da Lat City,10,101,86,15,5
2022-07-14,Lam Dong,Da Lat City,11,135,105,30,17
2022-07-14,Lam Dong,Da Lat City,12,152,119,33,24
2022-07-14,Lam Dong,Da Lat City,13,116,90,26,16
2022-07-14,Lam Dong,Da Lat City,14,101,84,17,7
2022-07-14,Lam Dong,Da Lat City,15,106,82,24,11
2022-07-14,Lam Dong,Da Lat City,16,117,95,22,13
2022-07-14,Lam Dong,Da Lat City,17,135,98,37,28
2022-07-14,Lam Dong,Da Lat City,18,153,89,64,46
2022-07-14,Lam Dong,Da Lat City,19,135,88,47,35
2022-07-14,Lam Dong,Da Lat City,20,126,63,63,51
2022-07-14,Lam Dong,Da Lat City,21,88,33,55,40
2022-07-14,Lam Dong,Da Lat City,22,39,26,13,5
2022-07-14,Lam Dong,Da Lat City,23,24,13,11,7
2022-07-14,Nghe An,Vinh City,0,3,0,3,3
2022-07-14,Nghe An,Vinh City,1,2,0,2,2
2022-07-14,Nghe An,Vinh City,3,2,1,1,1
2022-07-14,Nghe An,Vinh City,5,2,0,2,1
2022-07-14,Nghe An,Vinh City,6,23,2,21,20
2022-07-14,Nghe An,Vinh City,7,190,60,130,107
2022-07-14,Nghe An,Vinh City,8,196,154,42,19
2022-07-14,Nghe An,Vinh City,9,116,98,18,4
2022-07-14,Nghe An,Vinh City,10,182,166,16,8
2022-07-14,Nghe An,Vinh City,11,315,258,57,17
2022-07-14,Nghe An,Vinh City,12,240,220,20,4
2022-07-14,Nghe An,Vinh City,13,143,117,26,9
2022-07-14,Nghe An,Vinh City,14,195,134,61,34
2022-07-14,Nghe An,Vinh City,15,199,160,39,12
2022-07-14,Nghe An,Vinh City,16,129,107,22,8
2022-07-14,Nghe An,Vinh City,17,137,118,19,4
2022-07-14,Nghe An,Vinh City,18,196,149,47,24
2022-07-14,Nghe An,Vinh City,19,234,138,96,60
2022-07-14,Nghe An,Vinh City,20,149,100,49,28
2022-07-14,Nghe An,Vinh City,21,74,50,24,9
2022-07-14,Nghe An,Vinh City,22,25,19,6,2
2022-07-14,Nghe An,Vinh City,23,10,7,3,1
2022-07-14,Quang Nam,Dien Ban,13,1,0,1,1
2022-07-14,Quang Nam,Hoi An City,5,1,0,1,1
2022-07-14,Quang Nam,Hoi An City,6,7,1,6,6
2022-07-14,Quang Nam,Hoi An City,7,11,6,5,3
2022-07-14,Quang Nam,Hoi An City,8,18,15,3,1
2022-07-14,Quang Nam,Hoi An City,9,31,24,7,2
2022-07-14,Quang Nam,Hoi An City,10,33,22,11,2
2022-07-14,Quang Nam,Hoi An City,11,52,39,13,4
2022-07-14,Quang Nam,Hoi An City,12,56,36,20,13
2022-07-14,Quang Nam,Hoi An City,13,47,32,15,10
2022-07-14,Quang Nam,Hoi An City,14,44,33,11,7
2022-07-14,Quang Nam,Hoi An City,15,48,37,11,6
2022-07-14,Quang Nam,Hoi An City,16,38,32,6,0
2022-07-14,Quang Nam,Hoi An City,17,38,30,8,3
2022-07-14,Quang Nam,Hoi An City,18,42,33,9,3
2022-07-14,Quang Nam,Hoi An City,19,42,36,6,0
2022-07-14,Quang Nam,Hoi An City,20,48,30,18,9
2022-07-14,Quang Nam,Hoi An City,21,29,14,15,9
2022-07-14,Quang Nam,Hoi An City,22,12,5,7,3
2022-07-14,Quang Nam,Hoi An City,23,7,0,7,5
2022-07-14,Quang Ninh,Cam Pha City,8,2,0,2,1
2022-07-14,Quang Ninh,Cam Pha City,9,1,0,1,1
2022-07-14,Quang Ninh,Cam Pha City,11,3,0,3,3
2022-07-14,Quang Ninh,Cam Pha City,12,1,0,1,1
2022-07-14,Quang Ninh,Cam Pha City,13,1,0,1,1
2022-07-14,Quang Ninh,Cam Pha City,14,3,0,3,2
2022-07-14,Quang Ninh,Cam Pha City,15,2,0,2,1
2022-07-14,Quang Ninh,Cam Pha City,19,1,0,1,1
2022-07-14,Quang Ninh,Cam Pha City,20,2,0,2,2
2022-07-14,Quang Ninh,Ha Long City,0,6,0,6,5
2022-07-14,Quang Ninh,Ha Long City,6,7,1,6,5
2022-07-14,Quang Ninh,Ha Long City,7,22,16,6,5
2022-07-14,Quang Ninh,Ha Long City,8,57,46,11,3
2022-07-14,Quang Ninh,Ha Long City,9,57,39,18,6
2022-07-14,Quang Ninh,Ha Long City,10,96,76,20,3
2022-07-14,Quang Ninh,Ha Long City,11,143,108,35,12
2022-07-14,Quang Ninh,Ha Long City,12,97,80,17,2
2022-07-14,Quang Ninh,Ha Long City,13,82,65,17,4
2022-07-14,Quang Ninh,Ha Long City,14,69,58,11,2
2022-07-14,Quang Ninh,Ha Long City,15,65,55,10,3
2022-07-14,Quang Ninh,Ha Long City,16,40,33,7,3
2022-07-14,Quang Ninh,Ha Long City,17,66,57,9,1
2022-07-14,Quang Ninh,Ha Long City,18,75,60,15,3
2022-07-14,Quang Ninh,Ha Long City,19,64,51,13,1
2022-07-14,Quang Ninh,Ha Long City,20,59,35,24,13
2022-07-14,Quang Ninh,Ha Long City,21,46,20,26,17
2022-07-14,Quang Ninh,Ha Long City,22,8,6,2,0
2022-07-14,Quang Ninh,Ha Long City,23,7,3,4,1
2022-07-14,Thai Nguyen,Dong Hy,7,1,0,1,1
2022-07-14,Thai Nguyen,Dong Hy,9,1,1,0,0
2022-07-14,Thai Nguyen,Dong Hy,11,1,1,0,0
2022-07-14,Thai Nguyen,Dong Hy,13,1,0,1,1
2022-07-14,Thai Nguyen,Dong Hy,18,1,1,0,0
2022-07-14,Thai Nguyen,Dong Hy,20,1,1,0,0
2022-07-14,Thai Nguyen,Thai Nguyen City,0,3,1,2,1
2022-07-14,Thai Nguyen,Thai Nguyen City,1,2,0,2,1
2022-07-14,Thai Nguyen,Thai Nguyen City,2,1,0,1,0
2022-07-14,Thai Nguyen,Thai Nguyen City,3,2,0,2,0
2022-07-14,Thai Nguyen,Thai Nguyen City,4,3,2,1,0
2022-07-14,Thai Nguyen,Thai Nguyen City,5,1,0,1,1
2022-07-14,Thai Nguyen,Thai Nguyen City,6,14,9,5,1
2022-07-14,Thai Nguyen,Thai Nguyen City,7,91,83,8,0
2022-07-14,Thai Nguyen,Thai Nguyen City,8,152,145,7,0
2022-07-14,Thai Nguyen,Thai Nguyen City,9,140,128,12,1
2022-07-14,Thai Nguyen,Thai Nguyen City,10,205,185,20,1
2022-07-14,Thai Nguyen,Thai Nguyen City,11,415,378,37,4
2022-07-14,Thai Nguyen,Thai Nguyen City,12,248,234,14,0
2022-07-14,Thai Nguyen,Thai Nguyen City,13,192,175,17,1
2022-07-14,Thai Nguyen,Thai Nguyen City,14,187,171,16,2
2022-07-14,Thai Nguyen,Thai Nguyen City,15,165,147,18,3
2022-07-14,Thai Nguyen,Thai Nguyen City,16,132,118,14,1
2022-07-14,Thai Nguyen,Thai Nguyen City,17,149,145,4,0
2022-07-14,Thai Nguyen,Thai Nguyen City,18,195,182,13,0
2022-07-14,Thai Nguyen,Thai Nguyen City,19,231,197,34,4
2022-07-14,Thai Nguyen,Thai Nguyen City,20,182,166,16,2
2022-07-14,Thai Nguyen,Thai Nguyen City,21,101,81,20,0
2022-07-14,Thai Nguyen,Thai Nguyen City,22,21,15,6,2
2022-07-14,Thai Nguyen,Thai Nguyen City,23,6,3,3,0
2022-07-14,Vung Tau,Ba Ria City,7,1,1,0,0
2022-07-14,Vung Tau,Ba Ria City,8,3,1,2,2
2022-07-14,Vung Tau,Ba Ria City,9,5,2,3,3
2022-07-14,Vung Tau,Ba Ria City,10,4,3,1,0
2022-07-14,Vung Tau,Ba Ria City,11,6,5,1,1
2022-07-14,Vung Tau,Ba Ria City,12,4,3,1,1
2022-07-14,Vung Tau,Ba Ria City,13,3,1,2,1
2022-07-14,Vung Tau,Ba Ria City,14,4,3,1,0
2022-07-14,Vung Tau,Ba Ria City,15,3,0,3,3
2022-07-14,Vung Tau,Ba Ria City,16,6,3,3,3
2022-07-14,Vung Tau,Ba Ria City,17,7,4,3,1
2022-07-14,Vung Tau,Ba Ria City,18,2,1,1,1
2022-07-14,Vung Tau,Ba Ria City,19,8,0,8,8
2022-07-14,Vung Tau,Ba Ria City,20,3,0,3,2
2022-07-14,Vung Tau,Ba Ria City,21,3,0,3,3
2022-07-14,Vung Tau,Vung Tau City,0,4,1,3,2
2022-07-14,Vung Tau,Vung Tau City,1,2,0,2,1
2022-07-14,Vung Tau,Vung Tau City,3,3,1,2,0
2022-07-14,Vung Tau,Vung Tau City,5,3,2,1,0
2022-07-14,Vung Tau,Vung Tau City,6,20,16,4,4
2022-07-14,Vung Tau,Vung Tau City,7,129,113,16,3
2022-07-14,Vung Tau,Vung Tau City,8,197,181,16,2
2022-07-14,Vung Tau,Vung Tau City,9,204,190,14,1
2022-07-14,Vung Tau,Vung Tau City,10,202,184,18,1
2022-07-14,Vung Tau,Vung Tau City,11,348,310,38,11
2022-07-14,Vung Tau,Vung Tau City,12,281,257,24,0
2022-07-14,Vung Tau,Vung Tau City,13,239,224,15,7
2022-07-14,Vung Tau,Vung Tau City,14,211,199,12,1
2022-07-14,Vung Tau,Vung Tau City,15,218,199,19,4
2022-07-14,Vung Tau,Vung Tau City,16,194,180,14,2
2022-07-14,Vung Tau,Vung Tau City,17,261,249,12,0
2022-07-14,Vung Tau,Vung Tau City,18,349,308,41,6
2022-07-14,Vung Tau,Vung Tau City,19,292,260,32,4
2022-07-14,Vung Tau,Vung Tau City,20,182,168,14,0
2022-07-14,Vung Tau,Vung Tau City,21,95,86,9,3
2022-07-14,Vung Tau,Vung Tau City,22,42,32,10,5
2022-07-14,Vung Tau,Vung Tau City,23,10,4,6,5
2022-07-15,Bac Ninh,Bác Ninh City,0,6,3,3,2
2022-07-15,Bac Ninh,Bác Ninh City,1,5,3,2,2
2022-07-15,Bac Ninh,Bác Ninh City,2,2,1,1,1
2022-07-15,Bac Ninh,Bác Ninh City,3,2,0,2,0
2022-07-15,Bac Ninh,Bác Ninh City,4,4,0,4,2
2022-07-15,Bac Ninh,Bác Ninh City,5,1,0,1,0
2022-07-15,Bac Ninh,Bác Ninh City,6,21,10,11,8
2022-07-15,Bac Ninh,Bác Ninh City,7,103,51,52,38
2022-07-15,Bac Ninh,Bác Ninh City,8,163,112,51,35
2022-07-15,Bac Ninh,Bác Ninh City,9,141,100,41,25
2022-07-15,Bac Ninh,Bác Ninh City,10,151,140,11,1
2022-07-15,Bac Ninh,Bác Ninh City,11,342,308,34,11
2022-07-15,Bac Ninh,Bác Ninh City,12,247,234,13,1
2022-07-15,Bac Ninh,Bác Ninh City,13,159,146,13,1
2022-07-15,Bac Ninh,Bác Ninh City,14,184,158,26,3
2022-07-15,Bac Ninh,Bác Ninh City,15,178,160,18,3
2022-07-15,Bac Ninh,Bác Ninh City,16,163,141,22,2
2022-07-15,Bac Ninh,Bác Ninh City,17,134,124,10,1
2022-07-15,Bac Ninh,Bác Ninh City,18,199,184,15,2
2022-07-15,Bac Ninh,Bác Ninh City,19,192,168,24,3
2022-07-15,Bac Ninh,Bác Ninh City,20,176,157,19,5
2022-07-15,Bac Ninh,Bác Ninh City,21,82,70,12,0
2022-07-15,Bac Ninh,Bác Ninh City,22,18,13,5,0
2022-07-15,Bac Ninh,Bác Ninh City,23,10,9,1,0
2022-07-15,Bac Ninh,Que Vo,8,1,0,1,1
2022-07-15,Bac Ninh,Que Vo,9,2,0,2,2
2022-07-15,Bac Ninh,Que Vo,12,1,0,1,1
2022-07-15,Bac Ninh,Que Vo,13,1,0,1,1
2022-07-15,Bac Ninh,Que Vo,14,1,0,1,1
2022-07-15,Bac Ninh,Que Vo,15,1,1,0,0
2022-07-15,Bac Ninh,Que Vo,20,1,0,1,1
2022-07-15,Bac Ninh,Tien Du,3,1,0,1,0
2022-07-15,Bac Ninh,Tien Du,9,2,0,2,2
2022-07-15,Bac Ninh,Tien Du,12,2,0,2,1
2022-07-15,Bac Ninh,Tien Du,15,1,0,1,1
2022-07-15,Bac Ninh,Tien Du,20,2,0,2,1
2022-07-15,Bac Ninh,Tu Son,11,1,0,1,1
2022-07-15,Bac Ninh,Tu Son,12,1,0,1,1
2022-07-15,Bac Ninh,Tu Son,14,2,0,2,2
2022-07-15,Bac Ninh,Tu Son,15,1,0,1,1
2022-07-15,Bac Ninh,Tu Son,17,2,0,2,1
2022-07-15,Bac Ninh,Tu Son,18,3,0,3,2
2022-07-15,Bac Ninh,Tu Son,19,2,0,2,2
2022-07-15,Bac Ninh,Tu Son,20,1,0,1,1
2022-07-15,Binh Duong,Ben Cat,9,1,0,1,1
2022-07-15,Binh Duong,Ben Cat,10,1,0,1,0
2022-07-15,Binh Duong,Ben Cat,11,1,0,1,1
2022-07-15,Binh Duong,Ben Cat,12,3,0,3,3
2022-07-15,Binh Duong,Ben Cat,14,1,0,1,1
2022-07-15,Binh Duong,Ben Cat,17,1,0,1,1
2022-07-15,Binh Duong,Ben Cat,18,2,0,2,2
2022-07-15,Binh Duong,Ben Cat,21,1,0,1,1
2022-07-15,Binh Duong,Di An,2,1,0,1,1
2022-07-15,Binh Duong,Di An,5,1,1,0,0
2022-07-15,Binh Duong,Di An,7,5,1,4,4
2022-07-15,Binh Duong,Di An,8,17,10,7,2
2022-07-15,Binh Duong,Di An,9,28,13,15,8
2022-07-15,Binh Duong,Di An,10,57,37,20,13
2022-07-15,Binh Duong,Di An,11,41,30,11,6
2022-07-15,Binh Duong,Di An,12,30,26,4,2
2022-07-15,Binh Duong,Di An,13,47,42,5,3
2022-07-15,Binh Duong,Di An,14,55,39,16,7
2022-07-15,Binh Duong,Di An,15,37,26,11,2
2022-07-15,Binh Duong,Di An,16,41,32,9,5
2022-07-15,Binh Duong,Di An,17,28,23,5,1
2022-07-15,Binh Duong,Di An,18,23,20,3,0
2022-07-15,Binh Duong,Di An,19,43,35,8,4
2022-07-15,Binh Duong,Di An,20,31,20,11,8
2022-07-15,Binh Duong,Di An,21,12,3,9,5
2022-07-15,Binh Duong,Di An,22,3,2,1,1
2022-07-15,Binh Duong,Di An,23,3,2,1,0
2022-07-15,Binh Duong,Tan Uyen,9,1,1,0,0
2022-07-15,Binh Duong,Tan Uyen,10,3,1,2,1
2022-07-15,Binh Duong,Tan Uyen,11,3,3,0,0
2022-07-15,Binh Duong,Tan Uyen,12,7,2,5,4
2022-07-15,Binh Duong,Tan Uyen,13,6,3,3,2
2022-07-15,Binh Duong,Tan Uyen,14,5,2,3,3
2022-07-15,Binh Duong,Tan Uyen,15,2,2,0,0
2022-07-15,Binh Duong,Tan Uyen,16,2,1,1,0
2022-07-15,Binh Duong,Tan Uyen,17,1,1,0,0
2022-07-15,Binh Duong,Tan Uyen,18,1,0,1,1
2022-07-15,Binh Duong,Tan Uyen,19,2,1,1,0
2022-07-15,Binh Duong,Tan Uyen,20,6,2,4,4
2022-07-15,Binh Duong,Thu Dau Mot Town,0,7,3,4,1
2022-07-15,Binh Duong,Thu Dau Mot Town,1,9,0,9,2
2022-07-15,Binh Duong,Thu Dau Mot Town,4,1,0,1,0
2022-07-15,Binh Duong,Thu Dau Mot Town,5,3,1,2,1
2022-07-15,Binh Duong,Thu Dau Mot Town,6,35,32,3,2
2022-07-15,Binh Duong,Thu Dau Mot Town,7,111,106,5,1
2022-07-15,Binh Duong,Thu Dau Mot Town,8,242,223,19,3
2022-07-15,Binh Duong,Thu Dau Mot Town,9,244,227,17,3
2022-07-15,Binh Duong,Thu Dau Mot Town,10,416,389,27,9
2022-07-15,Binh Duong,Thu Dau Mot Town,11,704,651,53,10
2022-07-15,Binh Duong,Thu Dau Mot Town,12,495,456,39,8
2022-07-15,Binh Duong,Thu Dau Mot Town,13,458,434,24,6
2022-07-15,Binh Duong,Thu Dau Mot Town,14,427,393,34,5
2022-07-15,Binh Duong,Thu Dau Mot Town,15,313,275,38,5
2022-07-15,Binh Duong,Thu Dau Mot Town,16,300,263,37,17
2022-07-15,Binh Duong,Thu Dau Mot Town,17,384,358,26,4
2022-07-15,Binh Duong,Thu Dau Mot Town,18,391,364,27,4
2022-07-15,Binh Duong,Thu Dau Mot Town,19,366,335,31,5
2022-07-15,Binh Duong,Thu Dau Mot Town,20,297,268,29,9
2022-07-15,Binh Duong,Thu Dau Mot Town,21,122,100,22,2
2022-07-15,Binh Duong,Thu Dau Mot Town,22,29,19,10,2
2022-07-15,Binh Duong,Thu Dau Mot Town,23,19,10,9,3
2022-07-15,Binh Duong,Thuan An,1,1,0,1,0
2022-07-15,Binh Duong,Thuan An,2,3,0,3,1
2022-07-15,Binh Duong,Thuan An,5,1,0,1,0
2022-07-15,Binh Duong,Thuan An,7,14,9,5,4
2022-07-15,Binh Duong,Thuan An,8,23,15,8,1
2022-07-15,Binh Duong,Thuan An,9,44,40,4,2
2022-07-15,Binh Duong,Thuan An,10,81,68,13,1
2022-07-15,Binh Duong,Thuan An,11,91,80,11,4
2022-07-15,Binh Duong,Thuan An,12,110,88,22,13
2022-07-15,Binh Duong,Thuan An,13,104,72,32,21
2022-07-15,Binh Duong,Thuan An,14,71,51,20,12
2022-07-15,Binh Duong,Thuan An,15,60,45,15,6
2022-07-15,Binh Duong,Thuan An,16,47,36,11,7
2022-07-15,Binh Duong,Thuan An,17,55,43,12,4
2022-07-15,Binh Duong,Thuan An,18,45,38,7,0
2022-07-15,Binh Duong,Thuan An,19,54,47,7,2
2022-07-15,Binh Duong,Thuan An,20,42,27,15,6
2022-07-15,Binh Duong,Thuan An,21,22,12,10,8
2022-07-15,Binh Duong,Thuan An,22,10,1,9,5
2022-07-15,Binh Duong,Thuan An,23,2,0,2,1
2022-07-15,Can Tho City,Binh Thuy District,4,1,0,1,0
2022-07-15,Can Tho City,Binh Thuy District,6,2,1,1,0
2022-07-15,Can Tho City,Binh Thuy District,7,3,2,1,0
2022-07-15,Can Tho City,Binh Thuy District,8,7,7,0,0
2022-07-15,Can Tho City,Binh Thuy District,9,8,7,1,0
2022-07-15,Can Tho City,Binh Thuy District,10,9,8,1,0
2022-07-15,Can Tho City,Binh Thuy District,11,20,16,4,1
2022-07-15,Can Tho City,Binh Thuy District,12,12,12,0,0
2022-07-15,Can Tho City,Binh Thuy District,13,15,13,2,0
2022-07-15,Can Tho City,Binh Thuy District,14,15,11,4,2
2022-07-15,Can Tho City,Binh Thuy District,15,14,14,0,0
2022-07-15,Can Tho City,Binh Thuy District,16,15,13,2,1
2022-07-15,Can Tho City,Binh Thuy District,17,12,12,0,0
2022-07-15,Can Tho City,Binh Thuy District,18,12,11,1,0
2022-07-15,Can Tho City,Binh Thuy District,19,13,12,1,0
2022-07-15,Can Tho City,Binh Thuy District,20,17,15,2,0
2022-07-15,Can Tho City,Cai Rang District,7,5,4,1,1
2022-07-15,Can Tho City,Cai Rang District,8,6,5,1,1
2022-07-15,Can Tho City,Cai Rang District,9,5,2,3,2
2022-07-15,Can Tho City,Cai Rang District,10,5,5,0,0
2022-07-15,Can Tho City,Cai Rang District,11,19,18,1,0
2022-07-15,Can Tho City,Cai Rang District,12,10,10,0,0
2022-07-15,Can Tho City,Cai Rang District,13,5,5,0,0
2022-07-15,Can Tho City,Cai Rang District,14,15,14,1,0
2022-07-15,Can Tho City,Cai Rang District,15,15,13,2,1
2022-07-15,Can Tho City,Cai Rang District,16,9,6,3,2
2022-07-15,Can Tho City,Cai Rang District,17,10,7,3,1
2022-07-15,Can Tho City,Cai Rang District,18,8,6,2,0
2022-07-15,Can Tho City,Cai Rang District,19,12,11,1,0
2022-07-15,Can Tho City,Cai Rang District,20,9,9,0,0
2022-07-15,Can Tho City,Cai Rang District,21,5,5,0,0
2022-07-15,Can Tho City,Ninh Kieu District,0,7,6,1,1
2022-07-15,Can Tho City,Ninh Kieu District,1,7,3,4,1
2022-07-15,Can Tho City,Ninh Kieu District,2,1,0,1,1
2022-07-15,Can Tho City,Ninh Kieu District,3,2,0,2,2
2022-07-15,Can Tho City,Ninh Kieu District,4,1,0,1,1
2022-07-15,Can Tho City,Ninh Kieu District,5,2,2,0,0
2022-07-15,Can Tho City,Ninh Kieu District,6,40,40,0,0
2022-07-15,Can Tho City,Ninh Kieu District,7,129,119,10,1
2022-07-15,Can Tho City,Ninh Kieu District,8,218,207,11,0
2022-07-15,Can Tho City,Ninh Kieu District,9,304,293,11,0
2022-07-15,Can Tho City,Ninh Kieu District,10,480,462,18,1
2022-07-15,Can Tho City,Ninh Kieu District,11,787,744,43,4
2022-07-15,Can Tho City,Ninh Kieu District,12,607,581,26,0
2022-07-15,Can Tho City,Ninh Kieu District,13,552,527,25,0
2022-07-15,Can Tho City,Ninh Kieu District,14,451,427,24,0
2022-07-15,Can Tho City,Ninh Kieu District,15,362,345,17,0
2022-07-15,Can Tho City,Ninh Kieu District,16,380,368,12,0
2022-07-15,Can Tho City,Ninh Kieu District,17,456,445,11,0
2022-07-15,Can Tho City,Ninh Kieu District,18,486,457,29,0
2022-07-15,Can Tho City,Ninh Kieu District,19,437,421,16,0
2022-07-15,Can Tho City,Ninh Kieu District,20,345,318,27,0
2022-07-15,Can Tho City,Ninh Kieu District,21,228,209,19,0
2022-07-15,Can Tho City,Ninh Kieu District,22,45,39,6,0
2022-07-15,Can Tho City,Ninh Kieu District,23,23,14,9,4
2022-07-15,Can Tho City,Phong Dien,15,1,0,1,1
2022-07-15,Can Tho City,Thoi Lai,19,1,0,1,1
2022-07-15,Dong Nai,Bien Hoa City,0,21,7,14,9
2022-07-15,Dong Nai,Bien Hoa City,1,4,1,3,2
2022-07-15,Dong Nai,Bien Hoa City,2,1,1,0,0
2022-07-15,Dong Nai,Bien Hoa City,3,1,1,0,0
2022-07-15,Dong Nai,Bien Hoa City,5,6,2,4,3
2022-07-15,Dong Nai,Bien Hoa City,6,49,40,9,7
2022-07-15,Dong Nai,Bien Hoa City,7,173,156,17,5
2022-07-15,Dong Nai,Bien Hoa City,8,282,258,24,4
2022-07-15,Dong Nai,Bien Hoa City,9,435,408,27,5
2022-07-15,Dong Nai,Bien Hoa City,10,740,690,50,10
2022-07-15,Dong Nai,Bien Hoa City,11,1151,1056,95,13
2022-07-15,Dong Nai,Bien Hoa City,12,930,855,75,7
2022-07-15,Dong Nai,Bien Hoa City,13,885,821,64,6
2022-07-15,Dong Nai,Bien Hoa City,14,696,633,63,5
2022-07-15,Dong Nai,Bien Hoa City,15,545,510,35,5
2022-07-15,Dong Nai,Bien Hoa City,16,562,518,44,7
2022-07-15,Dong Nai,Bien Hoa City,17,663,612,51,7
2022-07-15,Dong Nai,Bien Hoa City,18,676,627,49,8
2022-07-15,Dong Nai,Bien Hoa City,19,713,655,58,14
2022-07-15,Dong Nai,Bien Hoa City,20,540,479,61,22
2022-07-15,Dong Nai,Bien Hoa City,21,259,211,48,12
2022-07-15,Dong Nai,Bien Hoa City,22,64,41,23,7
2022-07-15,Dong Nai,Bien Hoa City,23,28,14,14,7
2022-07-15,Dong Nai,Long Khanh,9,1,0,1,1
2022-07-15,Dong Nai,Long Khanh,10,2,0,2,2
2022-07-15,Dong Nai,Long Khanh,13,1,0,1,1
2022-07-15,Dong Nai,Long Khanh,18,1,0,1,1
2022-07-15,Dong Nai,Long Thanh,8,2,0,2,2
2022-07-15,Dong Nai,Long Thanh,10,1,0,1,1
2022-07-15,Dong Nai,Long Thanh,11,5,0,5,5
2022-07-15,Dong Nai,Long Thanh,12,2,0,2,1
2022-07-15,Dong Nai,Long Thanh,14,1,0,1,1
2022-07-15,Dong Nai,Long Thanh,18,3,0,3,1
2022-07-15,Dong Nai,Long Thanh,19,3,0,3,3
2022-07-15,Dong Nai,Long Thanh,21,1,0,1,1
2022-07-15,Dong Nai,Nhon trach,12,1,0,1,1
2022-07-15,Dong Nai,Nhon trach,17,1,0,1,1
2022-07-15,Dong Nai,Nhon trach,19,1,0,1,1
2022-07-15,Dong Nai,Nhon trach,20,1,0,1,1
2022-07-15,Dong Nai,Trang Bom,9,2,0,2,1
2022-07-15,Dong Nai,Trang Bom,10,1,0,1,1
2022-07-15,Dong Nai,Trang Bom,11,1,1,0,0
2022-07-15,Dong Nai,Trang Bom,13,1,0,1,0
2022-07-15,Dong Nai,Trang Bom,14,1,0,1,1
2022-07-15,Dong Nai,Trang Bom,18,1,0,1,1
2022-07-15,Dong Nai,Vinh Cuu,19,1,0,1,1
2022-07-15,Hai Phong City,An Duong,9,2,2,0,0
2022-07-15,Hai Phong City,An Duong,10,7,3,4,2
2022-07-15,Hai Phong City,An Duong,11,11,6,5,4
2022-07-15,Hai Phong City,An Duong,12,3,1,2,2
2022-07-15,Hai Phong City,An Duong,13,2,1,1,1
2022-07-15,Hai Phong City,An Duong,14,1,1,0,0
2022-07-15,Hai Phong City,An Duong,15,5,2,3,2
2022-07-15,Hai Phong City,An Duong,16,2,1,1,1
2022-07-15,Hai Phong City,An Duong,17,2,1,1,0
2022-07-15,Hai Phong City,An Duong,19,4,2,2,1
2022-07-15,Hai Phong City,An Duong,20,3,2,1,0
2022-07-15,Hai Phong City,An Duong,21,4,1,3,3
2022-07-15,Hai Phong City,Duong Kinh District,17,1,0,1,1
2022-07-15,Hai Phong City,Hai An District,0,1,0,1,1
2022-07-15,Hai Phong City,Hai An District,2,3,0,3,1
2022-07-15,Hai Phong City,Hai An District,6,2,1,1,1
2022-07-15,Hai Phong City,Hai An District,7,13,8,5,1
2022-07-15,Hai Phong City,Hai An District,8,17,13,4,2
2022-07-15,Hai Phong City,Hai An District,9,24,20,4,0
2022-07-15,Hai Phong City,Hai An District,10,33,27,6,1
2022-07-15,Hai Phong City,Hai An District,11,63,48,15,7
2022-07-15,Hai Phong City,Hai An District,12,21,20,1,0
2022-07-15,Hai Phong City,Hai An District,13,20,15,5,1
2022-07-15,Hai Phong City,Hai An District,14,9,7,2,1
2022-07-15,Hai Phong City,Hai An District,15,24,17,7,3
2022-07-15,Hai Phong City,Hai An District,16,21,18,3,1
2022-07-15,Hai Phong City,Hai An District,17,13,12,1,0
2022-07-15,Hai Phong City,Hai An District,18,10,10,0,0
2022-07-15,Hai Phong City,Hai An District,19,26,16,10,7
2022-07-15,Hai Phong City,Hai An District,20,14,13,1,1
2022-07-15,Hai Phong City,Hai An District,21,20,13,7,1
2022-07-15,Hai Phong City,Hai An District,22,2,1,1,1
2022-07-15,Hai Phong City,Hai An District,23,1,0,1,0
2022-07-15,Hai Phong City,Hong Bang District,0,1,0,1,1
2022-07-15,Hai Phong City,Hong Bang District,6,5,1,4,4
2022-07-15,Hai Phong City,Hong Bang District,7,19,13,6,3
2022-07-15,Hai Phong City,Hong Bang District,8,38,34,4,2
2022-07-15,Hai Phong City,Hong Bang District,9,28,23,5,0
2022-07-15,Hai Phong City,Hong Bang District,10,81,73,8,1
2022-07-15,Hai Phong City,Hong Bang District,11,121,102,19,8
2022-07-15,Hai Phong City,Hong Bang District,12,80,73,7,2
2022-07-15,Hai Phong City,Hong Bang District,13,56,51,5,2
2022-07-15,Hai Phong City,Hong Bang District,14,51,42,9,1
2022-07-15,Hai Phong City,Hong Bang District,15,50,46,4,1
2022-07-15,Hai Phong City,Hong Bang District,16,49,44,5,0
2022-07-15,Hai Phong City,Hong Bang District,17,56,49,7,2
2022-07-15,Hai Phong City,Hong Bang District,18,51,41,10,3
2022-07-15,Hai Phong City,Hong Bang District,19,58,46,12,6
2022-07-15,Hai Phong City,Hong Bang District,20,45,36,9,3
2022-07-15,Hai Phong City,Hong Bang District,21,27,21,6,3
2022-07-15,Hai Phong City,Hong Bang District,22,8,6,2,1
2022-07-15,Hai Phong City,Kien An District,0,2,0,2,1
2022-07-15,Hai Phong City,Kien An District,1,1,0,1,0
2022-07-15,Hai Phong City,Kien An District,3,1,0,1,1
2022-07-15,Hai Phong City,Kien An District,7,2,0,2,2
2022-07-15,Hai Phong City,Kien An District,8,2,0,2,2
2022-07-15,Hai Phong City,Kien An District,9,4,4,0,0
2022-07-15,Hai Phong City,Kien An District,10,4,4,0,0
2022-07-15,Hai Phong City,Kien An District,11,13,12,1,1
2022-07-15,Hai Phong City,Kien An District,12,16,11,5,2
2022-07-15,Hai Phong City,Kien An District,13,7,7,0,0
2022-07-15,Hai Phong City,Kien An District,14,13,10,3,1
2022-07-15,Hai Phong City,Kien An District,15,6,2,4,1
2022-07-15,Hai Phong City,Kien An District,16,12,5,7,5
2022-07-15,Hai Phong City,Kien An District,17,13,9,4,2
2022-07-15,Hai Phong City,Kien An District,18,4,4,0,0
2022-07-15,Hai Phong City,Kien An District,19,12,7,5,2
2022-07-15,Hai Phong City,Kien An District,20,7,2,5,4
2022-07-15,Hai Phong City,Kien An District,21,4,0,4,4
2022-07-15,Hai Phong City,Kien An District,23,2,0,2,1
2022-07-15,Hai Phong City,Le Chan District,2,1,0,1,1
2022-07-15,Hai Phong City,Le Chan District,6,12,7,5,4
2022-07-15,Hai Phong City,Le Chan District,7,39,32,7,5
2022-07-15,Hai Phong City,Le Chan District,8,88,69,19,2
2022-07-15,Hai Phong City,Le Chan District,9,115,97,18,3
2022-07-15,Hai Phong City,Le Chan District,10,210,178,32,2
2022-07-15,Hai Phong City,Le Chan District,11,396,347,49,15
2022-07-15,Hai Phong City,Le Chan District,12,247,218,29,6
2022-07-15,Hai Phong City,Le Chan District,13,157,129,28,3
2022-07-15,Hai Phong City,Le Chan District,14,187,163,24,10
2022-07-15,Hai Phong City,Le Chan District,15,180,154,26,8
2022-07-15,Hai Phong City,Le Chan District,16,159,142,17,2
2022-07-15,Hai Phong City,Le Chan District,17,193,168,25,1
2022-07-15,Hai Phong City,Le Chan District,18,224,207,17,3
2022-07-15,Hai Phong City,Le Chan District,19,206,165,41,16
2022-07-15,Hai Phong City,Le Chan District,20,177,143,34,16
2022-07-15,Hai Phong City,Le Chan District,21,78,58,20,6
2022-07-15,Hai Phong City,Le Chan District,22,10,6,4,1
2022-07-15,Hai Phong City,Le Chan District,23,7,3,4,0
2022-07-15,Hai Phong City,Ngo Quyen District,0,1,1,0,0
2022-07-15,Hai Phong City,Ngo Quyen District,2,1,1,0,0
2022-07-15,Hai Phong City,Ngo Quyen District,5,1,0,1,1
2022-07-15,Hai Phong City,Ngo Quyen District,6,2,0,2,1
2022-07-15,Hai Phong City,Ngo Quyen District,7,27,19,8,3
2022-07-15,Hai Phong City,Ngo Quyen District,8,88,75,13,2
2022-07-15,Hai Phong City,Ngo Quyen District,9,83,73,10,0
2022-07-15,Hai Phong City,Ngo Quyen District,10,150,134,16,1
2022-07-15,Hai Phong City,Ngo Quyen District,11,288,253,35,9
2022-07-15,Hai Phong City,Ngo Quyen District,12,167,148,19,2
2022-07-15,Hai Phong City,Ngo Quyen District,13,157,141,16,4
2022-07-15,Hai Phong City,Ngo Quyen District,14,174,160,14,4
2022-07-15,Hai Phong City,Ngo Quyen District,15,162,142,20,6
2022-07-15,Hai Phong City,Ngo Quyen District,16,163,148,15,1
2022-07-15,Hai Phong City,Ngo Quyen District,17,111,102,9,0
2022-07-15,Hai Phong City,Ngo Quyen District,18,165,148,17,1
2022-07-15,Hai Phong City,Ngo Quyen District,19,144,134,10,4
2022-07-15,Hai Phong City,Ngo Quyen District,20,139,116,23,3
2022-07-15,Hai Phong City,Ngo Quyen District,21,83,61,22,5
2022-07-15,Hai Phong City,Ngo Quyen District,22,10,6,4,2
2022-07-15,Hai Phong City,Ngo Quyen District,23,7,3,4,1
2022-07-15,Hai Phong City,Thuy Nguyen,9,2,0,2,1
2022-07-15,Hai Phong City,Thuy Nguyen,10,1,0,1,0
2022-07-15,Hai Phong City,Thuy Nguyen,11,1,0,1,1
2022-07-15,Hai Phong City,Thuy Nguyen,12,1,0,1,1
2022-07-15,Hai Phong City,Thuy Nguyen,13,3,0,3,3
2022-07-15,Hai Phong City,Thuy Nguyen,14,2,0,2,2
2022-07-15,Hai Phong City,Thuy Nguyen,15,1,0,1,1
2022-07-15,Hai Phong City,Thuy Nguyen,16,1,1,0,0
2022-07-15,Hai Phong City,Thuy Nguyen,19,1,0,1,1
2022-07-15,Hai Phong City,Thuy Nguyen,20,1,0,1,1
2022-07-15,Hue City,Hue City,0,12,11,1,1
2022-07-15,Hue City,Hue City,1,12,2,10,10
2022-07-15,Hue City,Hue City,3,2,0,2,1
2022-07-15,Hue City,Hue City,4,1,0,1,0
2022-07-15,Hue City,Hue City,5,2,1,1,1
2022-07-15,Hue City,Hue City,6,84,74,10,4
2022-07-15,Hue City,Hue City,7,196,184,12,1
2022-07-15,Hue City,Hue City,8,343,321,22,1
2022-07-15,Hue City,Hue City,9,290,252,38,1
2022-07-15,Hue City,Hue City,10,471,436,35,4
2022-07-15,Hue City,Hue City,11,907,833,74,5
2022-07-15,Hue City,Hue City,12,625,584,41,0
2022-07-15,Hue City,Hue City,13,464,434,30,1
2022-07-15,Hue City,Hue City,14,500,457,43,2
2022-07-15,Hue City,Hue City,15,434,391,43,1
2022-07-15,Hue City,Hue City,16,410,374,36,2
2022-07-15,Hue City,Hue City,17,465,433,32,2
2022-07-15,Hue City,Hue City,18,625,578,47,1
2022-07-15,Hue City,Hue City,19,578,522,56,4
2022-07-15,Hue City,Hue City,20,468,419,49,5
2022-07-15,Hue City,Hue City,21,261,225,36,7
2022-07-15,Hue City,Hue City,22,51,37,14,1
2022-07-15,Hue City,Hue City,23,26,16,10,1
2022-07-15,Hue City,Huong Thuy,7,1,1,0,0
2022-07-15,Hue City,Huong Thuy,8,5,3,2,1
2022-07-15,Hue City,Huong Thuy,11,2,2,0,0
2022-07-15,Hue City,Huong Thuy,12,1,1,0,0
2022-07-15,Hue City,Huong Thuy,13,2,0,2,1
2022-07-15,Hue City,Huong Thuy,14,1,0,1,0
2022-07-15,Hue City,Huong Thuy,15,4,3,1,1
2022-07-15,Hue City,Huong Thuy,19,1,1,0,0
2022-07-15,Hue City,Huong Thuy,20,1,1,0,0
2022-07-15,Hue City,Huong Thuy,21,1,1,0,0
2022-07-15,Hue City,Huong Tra,11,1,1,0,0
2022-07-15,Hue City,Huong Tra,14,2,1,1,0
2022-07-15,Hue City,Huong Tra,17,1,1,0,0
2022-07-15,Hue City,Huong Tra,23,1,0,1,1
2022-07-15,Hue City,Phu Vang,6,1,0,1,1
2022-07-15,Hue City,Phu Vang,7,5,2,3,3
2022-07-15,Hue City,Phu Vang,8,3,1,2,2
2022-07-15,Hue City,Phu Vang,9,2,2,0,0
2022-07-15,Hue City,Phu Vang,11,2,1,1,1
2022-07-15,Hue City,Phu Vang,12,4,3,1,0
2022-07-15,Hue City,Phu Vang,13,2,2,0,0
2022-07-15,Hue City,Phu Vang,14,3,1,2,2
2022-07-15,Hue City,Phu Vang,15,2,1,1,1
2022-07-15,Hue City,Phu Vang,16,1,1,0,0
2022-07-15,Hue City,Phu Vang,17,2,2,0,0
2022-07-15,Hue City,Phu Vang,18,2,1,1,1
2022-07-15,Hue City,Phu Vang,19,2,2,0,0
2022-07-15,Hue City,Phu Vang,20,3,1,2,1
2022-07-15,Khanh Hoa,Cam Ranh City,9,1,0,1,1
2022-07-15,Khanh Hoa,Dien Khanh,9,1,0,1,1
2022-07-15,Khanh Hoa,Nha Trang City,0,11,4,7,5
2022-07-15,Khanh Hoa,Nha Trang City,1,2,0,2,1
2022-07-15,Khanh Hoa,Nha Trang City,2,4,0,4,3
2022-07-15,Khanh Hoa,Nha Trang City,3,1,0,1,1
2022-07-15,Khanh Hoa,Nha Trang City,5,6,5,1,1
2022-07-15,Khanh Hoa,Nha Trang City,6,39,35,4,1
2022-07-15,Khanh Hoa,Nha Trang City,7,139,123,16,3
2022-07-15,Khanh Hoa,Nha Trang City,8,194,184,10,1
2022-07-15,Khanh Hoa,Nha Trang City,9,202,194,8,2
2022-07-15,Khanh Hoa,Nha Trang City,10,248,230,18,3
2022-07-15,Khanh Hoa,Nha Trang City,11,409,382,27,3
2022-07-15,Khanh Hoa,Nha Trang City,12,317,292,25,1
2022-07-15,Khanh Hoa,Nha Trang City,13,316,299,17,5
2022-07-15,Khanh Hoa,Nha Trang City,14,265,246,19,0
2022-07-15,Khanh Hoa,Nha Trang City,15,257,230,27,1
2022-07-15,Khanh Hoa,Nha Trang City,16,226,199,27,16
2022-07-15,Khanh Hoa,Nha Trang City,17,235,213,22,1
2022-07-15,Khanh Hoa,Nha Trang City,18,295,272,23,0
2022-07-15,Khanh Hoa,Nha Trang City,19,304,260,44,1
2022-07-15,Khanh Hoa,Nha Trang City,20,212,191,21,1
2022-07-15,Khanh Hoa,Nha Trang City,21,151,119,32,9
2022-07-15,Khanh Hoa,Nha Trang City,22,43,26,17,2
2022-07-15,Khanh Hoa,Nha Trang City,23,21,12,9,6
2022-07-15,Lam Dong,Da Lat City,1,3,0,3,3
2022-07-15,Lam Dong,Da Lat City,2,6,0,6,5
2022-07-15,Lam Dong,Da Lat City,5,7,0,7,7
2022-07-15,Lam Dong,Da Lat City,6,24,5,19,19
2022-07-15,Lam Dong,Da Lat City,7,70,36,34,28
2022-07-15,Lam Dong,Da Lat City,8,95,71,24,16
2022-07-15,Lam Dong,Da Lat City,9,109,85,24,10
2022-07-15,Lam Dong,Da Lat City,10,99,80,19,4
2022-07-15,Lam Dong,Da Lat City,11,169,138,31,15
2022-07-15,Lam Dong,Da Lat City,12,205,140,65,34
2022-07-15,Lam Dong,Da Lat City,13,163,119,44,32
2022-07-15,Lam Dong,Da Lat City,14,147,101,46,25
2022-07-15,Lam Dong,Da Lat City,15,125,92,33,18
2022-07-15,Lam Dong,Da Lat City,16,124,89,35,24
2022-07-15,Lam Dong,Da Lat City,17,135,85,50,36
2022-07-15,Lam Dong,Da Lat City,18,163,104,59,38
2022-07-15,Lam Dong,Da Lat City,19,171,97,74,46
2022-07-15,Lam Dong,Da Lat City,20,171,83,88,63
2022-07-15,Lam Dong,Da Lat City,21,112,63,49,37
2022-07-15,Lam Dong,Da Lat City,22,42,27,15,6
2022-07-15,Lam Dong,Da Lat City,23,24,14,10,3
2022-07-15,Nghe An,Vinh City,0,3,1,2,1
2022-07-15,Nghe An,Vinh City,1,2,0,2,2
2022-07-15,Nghe An,Vinh City,2,5,1,4,2
2022-07-15,Nghe An,Vinh City,5,2,0,2,2
2022-07-15,Nghe An,Vinh City,6,23,9,14,13
2022-07-15,Nghe An,Vinh City,7,134,111,23,11
2022-07-15,Nghe An,Vinh City,8,177,160,17,2
2022-07-15,Nghe An,Vinh City,9,127,111,16,4
2022-07-15,Nghe An,Vinh City,10,244,197,47,24
2022-07-15,Nghe An,Vinh City,11,341,285,56,29
2022-07-15,Nghe An,Vinh City,12,202,174,28,15
2022-07-15,Nghe An,Vinh City,13,148,123,25,6
2022-07-15,Nghe An,Vinh City,14,173,144,29,3
2022-07-15,Nghe An,Vinh City,15,160,140,20,8
2022-07-15,Nghe An,Vinh City,16,145,124,21,5
2022-07-15,Nghe An,Vinh City,17,167,127,40,14
2022-07-15,Nghe An,Vinh City,18,196,128,68,43
2022-07-15,Nghe An,Vinh City,19,188,125,63,37
2022-07-15,Nghe An,Vinh City,20,158,105,53,30
2022-07-15,Nghe An,Vinh City,21,99,60,39,26
2022-07-15,Nghe An,Vinh City,22,36,24,12,3
2022-07-15,Nghe An,Vinh City,23,16,6,10,2
2022-07-15,Quang Nam,Hoi An City,6,5,0,5,5
2022-07-15,Quang Nam,Hoi An City,7,13,5,8,7
2022-07-15,Quang Nam,Hoi An City,8,25,19,6,6
2022-07-15,Quang Nam,Hoi An City,9,23,18,5,1
2022-07-15,Quang Nam,Hoi An City,10,27,20,7,3
2022-07-15,Quang Nam,Hoi An City,11,43,32,11,1
2022-07-15,Quang Nam,Hoi An City,12,56,45,11,4
2022-07-15,Quang Nam,Hoi An City,13,39,35,4,1
2022-07-15,Quang Nam,Hoi An City,14,57,45,12,7
2022-07-15,Quang Nam,Hoi An City,15,52,42,10,1
2022-07-15,Quang Nam,Hoi An City,16,32,28,4,0
2022-07-15,Quang Nam,Hoi An City,17,46,37,9,4
2022-07-15,Quang Nam,Hoi An City,18,54,44,10,4
2022-07-15,Quang Nam,Hoi An City,19,47,35,12,8
2022-07-15,Quang Nam,Hoi An City,20,61,32,29,28
2022-07-15,Quang Nam,Hoi An City,21,38,21,17,13
2022-07-15,Quang Nam,Hoi An City,22,10,4,6,4
2022-07-15,Quang Nam,Hoi An City,23,5,0,5,5
2022-07-15,Quang Ninh,Cam Pha City,9,1,0,1,0
2022-07-15,Quang Ninh,Cam Pha City,10,4,0,4,4
2022-07-15,Quang Ninh,Cam Pha City,12,1,0,1,1
2022-07-15,Quang Ninh,Cam Pha City,13,1,0,1,1
2022-07-15,Quang Ninh,Cam Pha City,14,2,0,2,1
2022-07-15,Quang Ninh,Cam Pha City,16,2,0,2,1
2022-07-15,Quang Ninh,Cam Pha City,18,2,0,2,2
2022-07-15,Quang Ninh,Cam Pha City,19,1,0,1,1
2022-07-15,Quang Ninh,Cam Pha City,20,1,0,1,1
2022-07-15,Quang Ninh,Ha Long City,6,5,1,4,4
2022-07-15,Quang Ninh,Ha Long City,7,20,17,3,2
2022-07-15,Quang Ninh,Ha Long City,8,57,39,18,9
2022-07-15,Quang Ninh,Ha Long City,9,50,36,14,4
2022-07-15,Quang Ninh,Ha Long City,10,71,52,19,9
2022-07-15,Quang Ninh,Ha Long City,11,149,104,45,20
2022-07-15,Quang Ninh,Ha Long City,12,110,73,37,24
2022-07-15,Quang Ninh,Ha Long City,13,90,56,34,16
2022-07-15,Quang Ninh,Ha Long City,14,76,43,33,16
2022-07-15,Quang Ninh,Ha Long City,15,87,55,32,10
2022-07-15,Quang Ninh,Ha Long City,16,70,51,19,3
2022-07-15,Quang Ninh,Ha Long City,17,77,51,26,10
2022-07-15,Quang Ninh,Ha Long City,18,97,69,28,11
2022-07-15,Quang Ninh,Ha Long City,19,98,62,36,20
2022-07-15,Quang Ninh,Ha Long City,20,77,43,34,13
2022-07-15,Quang Ninh,Ha Long City,21,31,17,14,5
2022-07-15,Quang Ninh,Ha Long City,22,29,14,15,11
2022-07-15,Quang Ninh,Ha Long City,23,5,1,4,2
2022-07-15,Quang Ninh,Uong Bi City,12,1,0,1,1
2022-07-15,Quang Ninh,Uong Bi City,14,2,0,2,2
2022-07-15,Thai Nguyen,Dong Hy,11,1,1,0,0
2022-07-15,Thai Nguyen,Dong Hy,17,1,0,1,0
2022-07-15,Thai Nguyen,Dong Hy,18,2,2,0,0
2022-07-15,Thai Nguyen,Dong Hy,19,2,1,1,1
2022-07-15,Thai Nguyen,Dong Hy,20,1,0,1,1
2022-07-15,Thai Nguyen,Pho Yen,11,1,0,1,1
2022-07-15,Thai Nguyen,Thai Nguyen City,0,2,2,0,0
2022-07-15,Thai Nguyen,Thai Nguyen City,1,2,0,2,1
2022-07-15,Thai Nguyen,Thai Nguyen City,2,1,0,1,1
2022-07-15,Thai Nguyen,Thai Nguyen City,6,19,8,11,11
2022-07-15,Thai Nguyen,Thai Nguyen City,7,109,85,24,4
2022-07-15,Thai Nguyen,Thai Nguyen City,8,159,147,12,0
2022-07-15,Thai Nguyen,Thai Nguyen City,9,140,127,13,1
2022-07-15,Thai Nguyen,Thai Nguyen City,10,181,163,18,3
2022-07-15,Thai Nguyen,Thai Nguyen City,11,383,356,27,1
2022-07-15,Thai Nguyen,Thai Nguyen City,12,247,230,17,1
2022-07-15,Thai Nguyen,Thai Nguyen City,13,161,151,10,0
2022-07-15,Thai Nguyen,Thai Nguyen City,14,184,170,14,1
2022-07-15,Thai Nguyen,Thai Nguyen City,15,158,150,8,0
2022-07-15,Thai Nguyen,Thai Nguyen City,16,129,110,19,1
2022-07-15,Thai Nguyen,Thai Nguyen City,17,143,133,10,2
2022-07-15,Thai Nguyen,Thai Nguyen City,18,200,181,19,5
2022-07-15,Thai Nguyen,Thai Nguyen City,19,235,209,26,1
2022-07-15,Thai Nguyen,Thai Nguyen City,20,183,157,26,0
2022-07-15,Thai Nguyen,Thai Nguyen City,21,125,111,14,0
2022-07-15,Thai Nguyen,Thai Nguyen City,22,26,18,8,0
2022-07-15,Thai Nguyen,Thai Nguyen City,23,13,9,4,2
2022-07-15,Vung Tau,Ba Ria City,6,1,0,1,1
2022-07-15,Vung Tau,Ba Ria City,7,1,1,0,0
2022-07-15,Vung Tau,Ba Ria City,8,7,4,3,2
2022-07-15,Vung Tau,Ba Ria City,9,17,10,7,4
2022-07-15,Vung Tau,Ba Ria City,10,5,4,1,0
2022-07-15,Vung Tau,Ba Ria City,11,3,2,1,0
2022-07-15,Vung Tau,Ba Ria City,12,4,3,1,1
2022-07-15,Vung Tau,Ba Ria City,13,4,4,0,0
2022-07-15,Vung Tau,Ba Ria City,14,4,1,3,2
2022-07-15,Vung Tau,Ba Ria City,15,4,2,2,1
2022-07-15,Vung Tau,Ba Ria City,16,4,3,1,0
2022-07-15,Vung Tau,Ba Ria City,17,5,2,3,2
2022-07-15,Vung Tau,Ba Ria City,18,11,5,6,3
2022-07-15,Vung Tau,Ba Ria City,20,2,0,2,2
2022-07-15,Vung Tau,Ba Ria City,21,1,0,1,1
2022-07-15,Vung Tau,Ba Ria City,22,2,0,2,2
2022-07-15,Vung Tau,Chau Duc,12,1,0,1,1
2022-07-15,Vung Tau,Chau Duc,17,1,0,1,1
2022-07-15,Vung Tau,Chau Duc,20,2,0,2,2
2022-07-15,Vung Tau,Vung Tau City,0,3,2,1,0
2022-07-15,Vung Tau,Vung Tau City,3,2,0,2,2
2022-07-15,Vung Tau,Vung Tau City,4,1,1,0,0
2022-07-15,Vung Tau,Vung Tau City,5,1,1,0,0
2022-07-15,Vung Tau,Vung Tau City,6,33,27,6,2
2022-07-15,Vung Tau,Vung Tau City,7,116,107,9,7
2022-07-15,Vung Tau,Vung Tau City,8,182,165,17,2
2022-07-15,Vung Tau,Vung Tau City,9,196,182,14,0
2022-07-15,Vung Tau,Vung Tau City,10,252,234,18,1
2022-07-15,Vung Tau,Vung Tau City,11,414,381,33,4
2022-07-15,Vung Tau,Vung Tau City,12,333,311,22,2
2022-07-15,Vung Tau,Vung Tau City,13,259,241,18,0
2022-07-15,Vung Tau,Vung Tau City,14,270,252,18,6
2022-07-15,Vung Tau,Vung Tau City,15,232,210,22,2
2022-07-15,Vung Tau,Vung Tau City,16,195,185,10,2
2022-07-15,Vung Tau,Vung Tau City,17,278,261,17,2
2022-07-15,Vung Tau,Vung Tau City,18,287,270,17,2
2022-07-15,Vung Tau,Vung Tau City,19,256,228,28,4
2022-07-15,Vung Tau,Vung Tau City,20,177,153,24,1
2022-07-15,Vung Tau,Vung Tau City,21,104,84,20,7
2022-07-15,Vung Tau,Vung Tau City,22,31,25,6,2
2022-07-15,Vung Tau,Vung Tau City,23,17,15,2,0
2022-07-16,Bac Ninh,Bác Ninh City,0,4,2,2,0
2022-07-16,Bac Ninh,Bác Ninh City,1,2,1,1,0
2022-07-16,Bac Ninh,Bác Ninh City,2,3,0,3,3
2022-07-16,Bac Ninh,Bác Ninh City,3,2,2,0,0
2022-07-16,Bac Ninh,Bác Ninh City,6,13,9,4,3
2022-07-16,Bac Ninh,Bác Ninh City,7,65,57,8,2
2022-07-16,Bac Ninh,Bác Ninh City,8,134,115,19,3
2022-07-16,Bac Ninh,Bác Ninh City,9,127,118,9,1
2022-07-16,Bac Ninh,Bác Ninh City,10,210,193,17,1
2022-07-16,Bac Ninh,Bác Ninh City,11,372,331,41,1
2022-07-16,Bac Ninh,Bác Ninh City,12,250,238,12,1
2022-07-16,Bac Ninh,Bác Ninh City,13,191,176,15,1
2022-07-16,Bac Ninh,Bác Ninh City,14,178,161,17,1
2022-07-16,Bac Ninh,Bác Ninh City,15,164,152,12,0
2022-07-16,Bac Ninh,Bác Ninh City,16,134,127,7,0
2022-07-16,Bac Ninh,Bác Ninh City,17,151,141,10,0
2022-07-16,Bac Ninh,Bác Ninh City,18,193,168,25,4
2022-07-16,Bac Ninh,Bác Ninh City,19,194,166,28,5
2022-07-16,Bac Ninh,Bác Ninh City,20,167,150,17,4
2022-07-16,Bac Ninh,Bác Ninh City,21,115,95,20,3
2022-07-16,Bac Ninh,Bác Ninh City,22,30,18,12,3
2022-07-16,Bac Ninh,Bác Ninh City,23,12,9,3,1
2022-07-16,Bac Ninh,Que Vo,7,1,0,1,1
2022-07-16,Bac Ninh,Que Vo,8,4,0,4,2
2022-07-16,Bac Ninh,Que Vo,11,3,2,1,1
2022-07-16,Bac Ninh,Que Vo,14,1,1,0,0
2022-07-16,Bac Ninh,Que Vo,15,1,1,0,0
2022-07-16,Bac Ninh,Que Vo,18,1,0,1,1
2022-07-16,Bac Ninh,Que Vo,20,1,0,1,1
2022-07-16,Bac Ninh,Tien Du,7,1,0,1,0
2022-07-16,Bac Ninh,Tien Du,11,4,0,4,4
2022-07-16,Bac Ninh,Tien Du,12,3,0,3,2
2022-07-16,Bac Ninh,Tien Du,13,1,0,1,1
2022-07-16,Bac Ninh,Tien Du,14,1,0,1,1
2022-07-16,Bac Ninh,Tien Du,15,1,0,1,1
2022-07-16,Bac Ninh,Tien Du,16,1,0,1,1
2022-07-16,Bac Ninh,Tien Du,18,4,0,4,3
2022-07-16,Bac Ninh,Tien Du,19,4,0,4,3
2022-07-16,Bac Ninh,Tien Du,21,1,0,1,1
2022-07-16,Bac Ninh,Tu Son,14,2,0,2,2
2022-07-16,Bac Ninh,Tu Son,15,2,0,2,2
2022-07-16,Bac Ninh,Tu Son,16,1,0,1,1
2022-07-16,Bac Ninh,Tu Son,18,1,0,1,1
2022-07-16,Bac Ninh,Tu Son,20,1,0,1,1
2022-07-16,Binh Duong,Ben Cat,7,2,0,2,1
2022-07-16,Binh Duong,Ben Cat,11,1,0,1,1
2022-07-16,Binh Duong,Ben Cat,12,1,0,1,1
2022-07-16,Binh Duong,Ben Cat,13,2,0,2,2
2022-07-16,Binh Duong,Ben Cat,14,3,1,2,1
2022-07-16,Binh Duong,Ben Cat,15,2,0,2,2
2022-07-16,Binh Duong,Ben Cat,16,2,0,2,2
2022-07-16,Binh Duong,Ben Cat,19,1,0,1,1
2022-07-16,Binh Duong,Di An,0,3,0,3,3
2022-07-16,Binh Duong,Di An,2,2,0,2,0
2022-07-16,Binh Duong,Di An,5,1,0,1,1
2022-07-16,Binh Duong,Di An,6,1,0,1,1
2022-07-16,Binh Duong,Di An,7,4,0,4,4
2022-07-16,Binh Duong,Di An,8,17,12,5,4
2022-07-16,Binh Duong,Di An,9,22,17,5,2
2022-07-16,Binh Duong,Di An,10,33,30,3,2
2022-07-16,Binh Duong,Di An,11,37,30,7,1
2022-07-16,Binh Duong,Di An,12,47,34,13,6
2022-07-16,Binh Duong,Di An,13,34,27,7,4
2022-07-16,Binh Duong,Di An,14,39,30,9,7
2022-07-16,Binh Duong,Di An,15,23,20,3,1
2022-07-16,Binh Duong,Di An,16,25,15,10,6
2022-07-16,Binh Duong,Di An,17,42,34,8,3
2022-07-16,Binh Duong,Di An,18,32,26,6,0
2022-07-16,Binh Duong,Di An,19,39,32,7,6
2022-07-16,Binh Duong,Di An,20,29,23,6,0
2022-07-16,Binh Duong,Di An,21,11,9,2,1
2022-07-16,Binh Duong,Di An,22,8,3,5,4
2022-07-16,Binh Duong,Di An,23,2,1,1,1
2022-07-16,Binh Duong,Phu Giao,13,1,0,1,1
2022-07-16,Binh Duong,Tan Uyen,9,1,0,1,1
2022-07-16,Binh Duong,Tan Uyen,11,1,1,0,0
2022-07-16,Binh Duong,Tan Uyen,12,3,2,1,1
2022-07-16,Binh Duong,Tan Uyen,14,3,2,1,1
2022-07-16,Binh Duong,Tan Uyen,15,2,0,2,2
2022-07-16,Binh Duong,Tan Uyen,16,1,1,0,0
2022-07-16,Binh Duong,Tan Uyen,17,3,3,0,0
2022-07-16,Binh Duong,Tan Uyen,18,3,2,1,1
2022-07-16,Binh Duong,Tan Uyen,19,5,2,3,2
2022-07-16,Binh Duong,Tan Uyen,20,5,2,3,2
2022-07-16,Binh Duong,Tan Uyen,21,2,0,2,2
2022-07-16,Binh Duong,Tan Uyen,22,1,0,1,0
2022-07-16,Binh Duong,Thu Dau Mot Town,0,2,0,2,0
2022-07-16,Binh Duong,Thu Dau Mot Town,1,4,0,4,4
2022-07-16,Binh Duong,Thu Dau Mot Town,2,5,1,4,2
2022-07-16,Binh Duong,Thu Dau Mot Town,4,5,2,3,0
2022-07-16,Binh Duong,Thu Dau Mot Town,6,52,44,8,1
2022-07-16,Binh Duong,Thu Dau Mot Town,7,138,124,14,2
2022-07-16,Binh Duong,Thu Dau Mot Town,8,252,241,11,2
2022-07-16,Binh Duong,Thu Dau Mot Town,9,292,273,19,2
2022-07-16,Binh Duong,Thu Dau Mot Town,10,449,423,26,3
2022-07-16,Binh Duong,Thu Dau Mot Town,11,601,557,44,7
2022-07-16,Binh Duong,Thu Dau Mot Town,12,577,525,52,14
2022-07-16,Binh Duong,Thu Dau Mot Town,13,520,481,39,10
2022-07-16,Binh Duong,Thu Dau Mot Town,14,407,377,30,10
2022-07-16,Binh Duong,Thu Dau Mot Town,15,375,350,25,7
2022-07-16,Binh Duong,Thu Dau Mot Town,16,343,311,32,9
2022-07-16,Binh Duong,Thu Dau Mot Town,17,354,327,27,4
2022-07-16,Binh Duong,Thu Dau Mot Town,18,415,377,38,6
2022-07-16,Binh Duong,Thu Dau Mot Town,19,487,420,67,25
2022-07-16,Binh Duong,Thu Dau Mot Town,20,325,286,39,6
2022-07-16,Binh Duong,Thu Dau Mot Town,21,134,109,25,9
2022-07-16,Binh Duong,Thu Dau Mot Town,22,30,18,12,3
2022-07-16,Binh Duong,Thu Dau Mot Town,23,7,6,1,0
2022-07-16,Binh Duong,Thuan An,0,1,0,1,1
2022-07-16,Binh Duong,Thuan An,1,2,0,2,2
2022-07-16,Binh Duong,Thuan An,3,2,0,2,2
2022-07-16,Binh Duong,Thuan An,4,1,0,1,1
2022-07-16,Binh Duong,Thuan An,7,6,5,1,1
2022-07-16,Binh Duong,Thuan An,8,27,25,2,1
2022-07-16,Binh Duong,Thuan An,9,56,45,11,5
2022-07-16,Binh Duong,Thuan An,10,97,79,18,4
2022-07-16,Binh Duong,Thuan An,11,96,84,12,3
2022-07-16,Binh Duong,Thuan An,12,83,74,9,2
2022-07-16,Binh Duong,Thuan An,13,84,73,11,5
2022-07-16,Binh Duong,Thuan An,14,60,54,6,3
2022-07-16,Binh Duong,Thuan An,15,43,38,5,1
2022-07-16,Binh Duong,Thuan An,16,39,31,8,4
2022-07-16,Binh Duong,Thuan An,17,56,46,10,1
2022-07-16,Binh Duong,Thuan An,18,51,34,17,8
2022-07-16,Binh Duong,Thuan An,19,96,54,42,33
2022-07-16,Binh Duong,Thuan An,20,64,43,21,7
2022-07-16,Binh Duong,Thuan An,21,30,22,8,4
2022-07-16,Binh Duong,Thuan An,22,7,2,5,3
2022-07-16,Binh Duong,Thuan An,23,2,0,2,2
2022-07-16,Can Tho City,Binh Thuy District,7,2,2,0,0
2022-07-16,Can Tho City,Binh Thuy District,8,3,2,1,0
2022-07-16,Can Tho City,Binh Thuy District,9,7,4,3,1
2022-07-16,Can Tho City,Binh Thuy District,10,19,18,1,0
2022-07-16,Can Tho City,Binh Thuy District,11,16,12,4,1
2022-07-16,Can Tho City,Binh Thuy District,12,11,8,3,2
2022-07-16,Can Tho City,Binh Thuy District,13,9,7,2,2
2022-07-16,Can Tho City,Binh Thuy District,14,13,12,1,0
2022-07-16,Can Tho City,Binh Thuy District,15,12,9,3,0
2022-07-16,Can Tho City,Binh Thuy District,16,14,12,2,0
2022-07-16,Can Tho City,Binh Thuy District,17,10,10,0,0
2022-07-16,Can Tho City,Binh Thuy District,18,12,12,0,0
2022-07-16,Can Tho City,Binh Thuy District,19,13,11,2,2
2022-07-16,Can Tho City,Binh Thuy District,20,13,11,2,0
2022-07-16,Can Tho City,Binh Thuy District,21,7,5,2,0
2022-07-16,Can Tho City,Cai Rang District,6,2,2,0,0
2022-07-16,Can Tho City,Cai Rang District,7,1,1,0,0
2022-07-16,Can Tho City,Cai Rang District,8,3,3,0,0
2022-07-16,Can Tho City,Cai Rang District,9,9,9,0,0
2022-07-16,Can Tho City,Cai Rang District,10,10,9,1,0
2022-07-16,Can Tho City,Cai Rang District,11,15,13,2,0
2022-07-16,Can Tho City,Cai Rang District,12,13,12,1,0
2022-07-16,Can Tho City,Cai Rang District,13,9,6,3,2
2022-07-16,Can Tho City,Cai Rang District,14,8,8,0,0
2022-07-16,Can Tho City,Cai Rang District,15,8,7,1,1
2022-07-16,Can Tho City,Cai Rang District,16,23,22,1,0
2022-07-16,Can Tho City,Cai Rang District,17,12,9,3,1
2022-07-16,Can Tho City,Cai Rang District,18,17,13,4,0
2022-07-16,Can Tho City,Cai Rang District,19,8,8,0,0
2022-07-16,Can Tho City,Cai Rang District,20,8,7,1,0
2022-07-16,Can Tho City,Cai Rang District,21,7,6,1,0
2022-07-16,Can Tho City,Cai Rang District,22,1,1,0,0
2022-07-16,Can Tho City,Ninh Kieu District,0,8,7,1,0
2022-07-16,Can Tho City,Ninh Kieu District,1,5,3,2,2
2022-07-16,Can Tho City,Ninh Kieu District,3,2,1,1,1
2022-07-16,Can Tho City,Ninh Kieu District,5,5,4,1,1
2022-07-16,Can Tho City,Ninh Kieu District,6,31,28,3,0
2022-07-16,Can Tho City,Ninh Kieu District,7,125,121,4,1
2022-07-16,Can Tho City,Ninh Kieu District,8,247,234,13,0
2022-07-16,Can Tho City,Ninh Kieu District,9,279,256,23,0
2022-07-16,Can Tho City,Ninh Kieu District,10,502,481,21,0
2022-07-16,Can Tho City,Ninh Kieu District,11,695,656,39,1
2022-07-16,Can Tho City,Ninh Kieu District,12,600,561,39,0
2022-07-16,Can Tho City,Ninh Kieu District,13,528,502,26,0
2022-07-16,Can Tho City,Ninh Kieu District,14,413,389,24,0
2022-07-16,Can Tho City,Ninh Kieu District,15,360,344,16,0
2022-07-16,Can Tho City,Ninh Kieu District,16,378,364,14,0
2022-07-16,Can Tho City,Ninh Kieu District,17,494,463,31,0
2022-07-16,Can Tho City,Ninh Kieu District,18,541,519,22,0
2022-07-16,Can Tho City,Ninh Kieu District,19,483,456,27,0
2022-07-16,Can Tho City,Ninh Kieu District,20,377,345,32,0
2022-07-16,Can Tho City,Ninh Kieu District,21,244,222,22,1
2022-07-16,Can Tho City,Ninh Kieu District,22,49,39,10,0
2022-07-16,Can Tho City,Ninh Kieu District,23,14,8,6,1
2022-07-16,Dong Nai,Bien Hoa City,0,7,1,6,2
2022-07-16,Dong Nai,Bien Hoa City,1,2,1,1,1
2022-07-16,Dong Nai,Bien Hoa City,2,1,0,1,0
2022-07-16,Dong Nai,Bien Hoa City,3,1,0,1,0
2022-07-16,Dong Nai,Bien Hoa City,5,8,2,6,4
2022-07-16,Dong Nai,Bien Hoa City,6,42,30,12,4
2022-07-16,Dong Nai,Bien Hoa City,7,202,174,28,9
2022-07-16,Dong Nai,Bien Hoa City,8,357,321,36,3
2022-07-16,Dong Nai,Bien Hoa City,9,473,430,43,6
2022-07-16,Dong Nai,Bien Hoa City,10,813,744,69,10
2022-07-16,Dong Nai,Bien Hoa City,11,1084,1000,84,19
2022-07-16,Dong Nai,Bien Hoa City,12,1004,941,63,10
2022-07-16,Dong Nai,Bien Hoa City,13,811,760,51,3
2022-07-16,Dong Nai,Bien Hoa City,14,635,587,48,6
2022-07-16,Dong Nai,Bien Hoa City,15,479,412,67,26
2022-07-16,Dong Nai,Bien Hoa City,16,611,546,65,15
2022-07-16,Dong Nai,Bien Hoa City,17,689,630,59,15
2022-07-16,Dong Nai,Bien Hoa City,18,780,721,59,16
2022-07-16,Dong Nai,Bien Hoa City,19,954,744,210,126
2022-07-16,Dong Nai,Bien Hoa City,20,796,556,240,132
2022-07-16,Dong Nai,Bien Hoa City,21,294,217,77,36
2022-07-16,Dong Nai,Bien Hoa City,22,62,41,21,9
2022-07-16,Dong Nai,Bien Hoa City,23,19,8,11,6
2022-07-16,Dong Nai,Long Khanh,11,2,0,2,2
2022-07-16,Dong Nai,Long Khanh,20,1,0,1,1
2022-07-16,Dong Nai,Long Thanh,9,1,0,1,1
2022-07-16,Dong Nai,Long Thanh,11,4,1,3,3
2022-07-16,Dong Nai,Long Thanh,12,2,0,2,2
2022-07-16,Dong Nai,Long Thanh,13,3,0,3,2
2022-07-16,Dong Nai,Long Thanh,14,2,0,2,2
2022-07-16,Dong Nai,Long Thanh,16,1,0,1,1
2022-07-16,Dong Nai,Long Thanh,17,2,0,2,1
2022-07-16,Dong Nai,Long Thanh,18,1,0,1,1
2022-07-16,Dong Nai,Long Thanh,20,1,0,1,1
2022-07-16,Dong Nai,Nhon trach,9,1,0,1,1
2022-07-16,Dong Nai,Nhon trach,10,1,0,1,1
2022-07-16,Dong Nai,Nhon trach,11,1,0,1,1
2022-07-16,Dong Nai,Nhon trach,13,1,0,1,1
2022-07-16,Dong Nai,Nhon trach,15,1,0,1,1
2022-07-16,Dong Nai,Trang Bom,11,1,0,1,1
2022-07-16,Dong Nai,Trang Bom,12,3,0,3,2
2022-07-16,Dong Nai,Trang Bom,13,1,0,1,1
2022-07-16,Dong Nai,Vinh Cuu,18,1,0,1,0
2022-07-16,Hai Phong City,An Duong,7,3,1,2,1
2022-07-16,Hai Phong City,An Duong,8,3,2,1,0
2022-07-16,Hai Phong City,An Duong,9,2,1,1,1
2022-07-16,Hai Phong City,An Duong,10,7,4,3,1
2022-07-16,Hai Phong City,An Duong,11,8,4,4,4
2022-07-16,Hai Phong City,An Duong,12,3,1,2,1
2022-07-16,Hai Phong City,An Duong,13,5,3,2,2
2022-07-16,Hai Phong City,An Duong,14,2,0,2,1
2022-07-16,Hai Phong City,An Duong,16,3,3,0,0
2022-07-16,Hai Phong City,An Duong,17,6,2,4,3
2022-07-16,Hai Phong City,An Duong,18,1,0,1,1
2022-07-16,Hai Phong City,An Duong,19,1,1,0,0
2022-07-16,Hai Phong City,An Duong,20,3,1,2,0
2022-07-16,Hai Phong City,An Duong,21,1,0,1,0
2022-07-16,Hai Phong City,An Duong,22,2,0,2,0
2022-07-16,Hai Phong City,Do Son District,12,1,0,1,0
2022-07-16,Hai Phong City,Duong Kinh District,9,1,0,1,1
2022-07-16,Hai Phong City,Duong Kinh District,14,1,0,1,1
2022-07-16,Hai Phong City,Hai An District,0,1,0,1,0
2022-07-16,Hai Phong City,Hai An District,6,1,1,0,0
2022-07-16,Hai Phong City,Hai An District,7,13,9,4,2
2022-07-16,Hai Phong City,Hai An District,8,15,14,1,0
2022-07-16,Hai Phong City,Hai An District,9,15,12,3,0
2022-07-16,Hai Phong City,Hai An District,10,29,26,3,0
2022-07-16,Hai Phong City,Hai An District,11,37,33,4,2
2022-07-16,Hai Phong City,Hai An District,12,33,32,1,0
2022-07-16,Hai Phong City,Hai An District,13,26,19,7,2
2022-07-16,Hai Phong City,Hai An District,14,28,18,10,2
2022-07-16,Hai Phong City,Hai An District,15,26,19,7,4
2022-07-16,Hai Phong City,Hai An District,16,23,20,3,2
2022-07-16,Hai Phong City,Hai An District,17,20,18,2,0
2022-07-16,Hai Phong City,Hai An District,18,22,20,2,0
2022-07-16,Hai Phong City,Hai An District,19,29,26,3,1
2022-07-16,Hai Phong City,Hai An District,20,14,11,3,0
2022-07-16,Hai Phong City,Hai An District,21,17,9,8,5
2022-07-16,Hai Phong City,Hai An District,22,13,11,2,1
2022-07-16,Hai Phong City,Hong Bang District,0,2,1,1,0
2022-07-16,Hai Phong City,Hong Bang District,6,2,1,1,0
2022-07-16,Hai Phong City,Hong Bang District,7,13,10,3,1
2022-07-16,Hai Phong City,Hong Bang District,8,40,35,5,3
2022-07-16,Hai Phong City,Hong Bang District,9,45,41,4,0
2022-07-16,Hai Phong City,Hong Bang District,10,78,69,9,2
2022-07-16,Hai Phong City,Hong Bang District,11,121,105,16,6
2022-07-16,Hai Phong City,Hong Bang District,12,103,88,15,4
2022-07-16,Hai Phong City,Hong Bang District,13,57,52,5,1
2022-07-16,Hai Phong City,Hong Bang District,14,35,28,7,4
2022-07-16,Hai Phong City,Hong Bang District,15,51,41,10,7
2022-07-16,Hai Phong City,Hong Bang District,16,52,47,5,0
2022-07-16,Hai Phong City,Hong Bang District,17,52,49,3,1
2022-07-16,Hai Phong City,Hong Bang District,18,81,69,12,6
2022-07-16,Hai Phong City,Hong Bang District,19,81,72,9,2
2022-07-16,Hai Phong City,Hong Bang District,20,45,40,5,1
2022-07-16,Hai Phong City,Hong Bang District,21,15,13,2,0
2022-07-16,Hai Phong City,Hong Bang District,22,3,1,2,0
2022-07-16,Hai Phong City,Hong Bang District,23,1,0,1,0
2022-07-16,Hai Phong City,Kien An District,2,1,0,1,1
2022-07-16,Hai Phong City,Kien An District,3,1,0,1,1
2022-07-16,Hai Phong City,Kien An District,8,5,2,3,2
2022-07-16,Hai Phong City,Kien An District,9,8,4,4,4
2022-07-16,Hai Phong City,Kien An District,10,7,6,1,1
2022-07-16,Hai Phong City,Kien An District,11,16,14,2,1
2022-07-16,Hai Phong City,Kien An District,12,18,10,8,6
2022-07-16,Hai Phong City,Kien An District,13,13,7,6,2
2022-07-16,Hai Phong City,Kien An District,14,8,3,5,1
2022-07-16,Hai Phong City,Kien An District,15,15,12,3,1
2022-07-16,Hai Phong City,Kien An District,16,5,3,2,2
2022-07-16,Hai Phong City,Kien An District,17,9,7,2,1
2022-07-16,Hai Phong City,Kien An District,18,8,6,2,2
2022-07-16,Hai Phong City,Kien An District,19,11,6,5,4
2022-07-16,Hai Phong City,Kien An District,20,8,4,4,4
2022-07-16,Hai Phong City,Kien An District,21,5,1,4,4
2022-07-16,Hai Phong City,Le Chan District,0,1,1,0,0
2022-07-16,Hai Phong City,Le Chan District,1,1,0,1,1
2022-07-16,Hai Phong City,Le Chan District,2,2,0,2,0
2022-07-16,Hai Phong City,Le Chan District,6,10,4,6,4
2022-07-16,Hai Phong City,Le Chan District,7,41,32,9,1
2022-07-16,Hai Phong City,Le Chan District,8,86,69,17,1
2022-07-16,Hai Phong City,Le Chan District,9,122,104,18,0
2022-07-16,Hai Phong City,Le Chan District,10,222,195,27,2
2022-07-16,Hai Phong City,Le Chan District,11,387,346,41,11
2022-07-16,Hai Phong City,Le Chan District,12,303,275,28,3
2022-07-16,Hai Phong City,Le Chan District,13,166,148,18,1
2022-07-16,Hai Phong City,Le Chan District,14,174,149,25,5
2022-07-16,Hai Phong City,Le Chan District,15,196,169,27,6
2022-07-16,Hai Phong City,Le Chan District,16,198,173,25,8
2022-07-16,Hai Phong City,Le Chan District,17,172,153,19,2
2022-07-16,Hai Phong City,Le Chan District,18,240,199,41,16
2022-07-16,Hai Phong City,Le Chan District,19,209,176,33,13
2022-07-16,Hai Phong City,Le Chan District,20,158,134,24,8
2022-07-16,Hai Phong City,Le Chan District,21,93,73,20,7
2022-07-16,Hai Phong City,Le Chan District,22,19,7,12,3
2022-07-16,Hai Phong City,Le Chan District,23,12,3,9,5
2022-07-16,Hai Phong City,Ngo Quyen District,0,4,2,2,0
2022-07-16,Hai Phong City,Ngo Quyen District,5,1,0,1,1
2022-07-16,Hai Phong City,Ngo Quyen District,6,6,2,4,3
2022-07-16,Hai Phong City,Ngo Quyen District,7,22,17,5,3
2022-07-16,Hai Phong City,Ngo Quyen District,8,79,72,7,1
2022-07-16,Hai Phong City,Ngo Quyen District,9,92,82,10,2
2022-07-16,Hai Phong City,Ngo Quyen District,10,168,149,19,5
2022-07-16,Hai Phong City,Ngo Quyen District,11,274,245,29,9
2022-07-16,Hai Phong City,Ngo Quyen District,12,217,189,28,6
2022-07-16,Hai Phong City,Ngo Quyen District,13,153,131,22,4
2022-07-16,Hai Phong City,Ngo Quyen District,14,148,131,17,2
2022-07-16,Hai Phong City,Ngo Quyen District,15,152,141,11,2
2022-07-16,Hai Phong City,Ngo Quyen District,16,134,118,16,7
2022-07-16,Hai Phong City,Ngo Quyen District,17,132,116,16,3
2022-07-16,Hai Phong City,Ngo Quyen District,18,184,161,23,4
2022-07-16,Hai Phong City,Ngo Quyen District,19,169,134,35,12
2022-07-16,Hai Phong City,Ngo Quyen District,20,119,95,24,8
2022-07-16,Hai Phong City,Ngo Quyen District,21,80,69,11,3
2022-07-16,Hai Phong City,Ngo Quyen District,22,11,9,2,0
2022-07-16,Hai Phong City,Ngo Quyen District,23,7,4,3,1
2022-07-16,Hai Phong City,Thuy Nguyen,10,1,1,0,0
2022-07-16,Hai Phong City,Thuy Nguyen,11,3,1,2,2
2022-07-16,Hai Phong City,Thuy Nguyen,15,1,0,1,1
2022-07-16,Hai Phong City,Thuy Nguyen,17,1,0,1,0
2022-07-16,Hai Phong City,Thuy Nguyen,18,2,0,2,2
2022-07-16,Hai Phong City,Thuy Nguyen,19,1,0,1,1
2022-07-16,Hai Phong City,Thuy Nguyen,21,1,0,1,0
2022-07-16,Hue City,Hue City,0,11,4,7,3
2022-07-16,Hue City,Hue City,1,2,2,0,0
2022-07-16,Hue City,Hue City,2,1,1,0,0
2022-07-16,Hue City,Hue City,3,2,0,2,2
2022-07-16,Hue City,Hue City,5,2,2,0,0
2022-07-16,Hue City,Hue City,6,71,65,6,2
2022-07-16,Hue City,Hue City,7,213,190,23,2
2022-07-16,Hue City,Hue City,8,352,312,40,2
2022-07-16,Hue City,Hue City,9,293,268,25,0
2022-07-16,Hue City,Hue City,10,483,447,36,0
2022-07-16,Hue City,Hue City,11,882,805,77,5
2022-07-16,Hue City,Hue City,12,687,629,58,0
2022-07-16,Hue City,Hue City,13,460,424,36,2
2022-07-16,Hue City,Hue City,14,432,398,34,1
2022-07-16,Hue City,Hue City,15,455,409,46,1
2022-07-16,Hue City,Hue City,16,421,396,25,0
2022-07-16,Hue City,Hue City,17,515,470,45,5
2022-07-16,Hue City,Hue City,18,588,534,54,6
2022-07-16,Hue City,Hue City,19,629,554,75,7
2022-07-16,Hue City,Hue City,20,466,404,62,9
2022-07-16,Hue City,Hue City,21,296,250,46,7
2022-07-16,Hue City,Hue City,22,68,46,22,2
2022-07-16,Hue City,Hue City,23,24,14,10,4
2022-07-16,Hue City,Huong Thuy,6,1,1,0,0
2022-07-16,Hue City,Huong Thuy,9,1,1,0,0
2022-07-16,Hue City,Huong Thuy,10,2,1,1,1
2022-07-16,Hue City,Huong Thuy,11,2,1,1,0
2022-07-16,Hue City,Huong Thuy,12,2,2,0,0
2022-07-16,Hue City,Huong Thuy,15,6,4,2,1
2022-07-16,Hue City,Huong Thuy,16,2,2,0,0
2022-07-16,Hue City,Huong Thuy,19,5,0,5,2
2022-07-16,Hue City,Huong Thuy,20,2,1,1,1
2022-07-16,Hue City,Huong Thuy,21,1,0,1,0
2022-07-16,Hue City,Huong Thuy,22,2,1,1,0
2022-07-16,Hue City,Huong Tra,15,1,0,1,0
2022-07-16,Hue City,Huong Tra,19,2,2,0,0
2022-07-16,Hue City,Phu Vang,5,1,1,0,0
2022-07-16,Hue City,Phu Vang,6,1,1,0,0
2022-07-16,Hue City,Phu Vang,8,1,1,0,0
2022-07-16,Hue City,Phu Vang,9,1,1,0,0
2022-07-16,Hue City,Phu Vang,10,3,3,0,0
2022-07-16,Hue City,Phu Vang,11,4,2,2,1
2022-07-16,Hue City,Phu Vang,12,2,2,0,0
2022-07-16,Hue City,Phu Vang,13,1,1,0,0
2022-07-16,Hue City,Phu Vang,15,4,2,2,0
2022-07-16,Hue City,Phu Vang,17,1,1,0,0
2022-07-16,Hue City,Phu Vang,18,1,1,0,0
2022-07-16,Hue City,Phu Vang,19,2,2,0,0
2022-07-16,Hue City,Phu Vang,20,2,0,2,0
2022-07-16,Hue City,Phu Vang,21,1,0,1,1
2022-07-16,Khanh Hoa,Cam Ranh City,19,1,0,1,0
2022-07-16,Khanh Hoa,Dien Khanh,14,2,0,2,1
2022-07-16,Khanh Hoa,Dien Khanh,15,1,0,1,1
2022-07-16,Khanh Hoa,Nha Trang City,0,2,1,1,0
2022-07-16,Khanh Hoa,Nha Trang City,1,6,3,3,1
2022-07-16,Khanh Hoa,Nha Trang City,2,5,1,4,2
2022-07-16,Khanh Hoa,Nha Trang City,3,1,0,1,1
2022-07-16,Khanh Hoa,Nha Trang City,4,1,1,0,0
2022-07-16,Khanh Hoa,Nha Trang City,5,4,4,0,0
2022-07-16,Khanh Hoa,Nha Trang City,6,45,39,6,4
2022-07-16,Khanh Hoa,Nha Trang City,7,124,115,9,0
2022-07-16,Khanh Hoa,Nha Trang City,8,216,191,25,2
2022-07-16,Khanh Hoa,Nha Trang City,9,225,209,16,0
2022-07-16,Khanh Hoa,Nha Trang City,10,245,223,22,0
2022-07-16,Khanh Hoa,Nha Trang City,11,372,344,28,1
2022-07-16,Khanh Hoa,Nha Trang City,12,346,320,26,0
2022-07-16,Khanh Hoa,Nha Trang City,13,358,313,45,16
2022-07-16,Khanh Hoa,Nha Trang City,14,232,217,15,1
2022-07-16,Khanh Hoa,Nha Trang City,15,189,173,16,1
2022-07-16,Khanh Hoa,Nha Trang City,16,274,242,32,4
2022-07-16,Khanh Hoa,Nha Trang City,17,286,255,31,1
2022-07-16,Khanh Hoa,Nha Trang City,18,363,241,122,84
2022-07-16,Khanh Hoa,Nha Trang City,19,550,237,313,259
2022-07-16,Khanh Hoa,Nha Trang City,20,310,226,84,52
2022-07-16,Khanh Hoa,Nha Trang City,21,159,113,46,22
2022-07-16,Khanh Hoa,Nha Trang City,22,45,27,18,2
2022-07-16,Khanh Hoa,Nha Trang City,23,32,15,17,9
2022-07-16,Lam Dong,Da Lat City,0,5,1,4,3
2022-07-16,Lam Dong,Da Lat City,1,3,0,3,3
2022-07-16,Lam Dong,Da Lat City,2,7,0,7,4
2022-07-16,Lam Dong,Da Lat City,3,1,0,1,1
2022-07-16,Lam Dong,Da Lat City,4,1,0,1,1
2022-07-16,Lam Dong,Da Lat City,5,1,0,1,1
2022-07-16,Lam Dong,Da Lat City,6,44,5,39,36
2022-07-16,Lam Dong,Da Lat City,7,77,42,35,24
2022-07-16,Lam Dong,Da Lat City,8,103,78,25,11
2022-07-16,Lam Dong,Da Lat City,9,114,78,36,28
2022-07-16,Lam Dong,Da Lat City,10,127,88,39,20
2022-07-16,Lam Dong,Da Lat City,11,159,120,39,22
2022-07-16,Lam Dong,Da Lat City,12,228,160,68,49
2022-07-16,Lam Dong,Da Lat City,13,200,122,78,55
2022-07-16,Lam Dong,Da Lat City,14,169,108,61,39
2022-07-16,Lam Dong,Da Lat City,15,122,84,38,29
2022-07-16,Lam Dong,Da Lat City,16,132,92,40,25
2022-07-16,Lam Dong,Da Lat City,17,190,114,76,57
2022-07-16,Lam Dong,Da Lat City,18,204,135,69,46
2022-07-16,Lam Dong,Da Lat City,19,188,117,71,52
2022-07-16,Lam Dong,Da Lat City,20,160,95,65,50
2022-07-16,Lam Dong,Da Lat City,21,125,59,66,47
2022-07-16,Lam Dong,Da Lat City,22,41,28,13,5
2022-07-16,Lam Dong,Da Lat City,23,21,13,8,6
2022-07-16,Nghe An,Hung Nguyen,17,1,0,1,1
2022-07-16,Nghe An,Vinh City,0,1,1,0,0
2022-07-16,Nghe An,Vinh City,2,2,0,2,2
2022-07-16,Nghe An,Vinh City,5,5,1,4,4
2022-07-16,Nghe An,Vinh City,6,15,5,10,8
2022-07-16,Nghe An,Vinh City,7,124,99,25,12
2022-07-16,Nghe An,Vinh City,8,208,172,36,11
2022-07-16,Nghe An,Vinh City,9,149,132,17,3
2022-07-16,Nghe An,Vinh City,10,227,175,52,33
2022-07-16,Nghe An,Vinh City,11,442,341,101,58
2022-07-16,Nghe An,Vinh City,12,273,228,45,16
2022-07-16,Nghe An,Vinh City,13,118,100,18,6
2022-07-16,Nghe An,Vinh City,14,205,136,69,46
2022-07-16,Nghe An,Vinh City,15,222,161,61,31
2022-07-16,Nghe An,Vinh City,16,206,145,61,38
2022-07-16,Nghe An,Vinh City,17,192,130,62,33
2022-07-16,Nghe An,Vinh City,18,172,137,35,13
2022-07-16,Nghe An,Vinh City,19,212,155,57,34
2022-07-16,Nghe An,Vinh City,20,148,109,39,24
2022-07-16,Nghe An,Vinh City,21,104,63,41,30
2022-07-16,Nghe An,Vinh City,22,28,15,13,2
2022-07-16,Nghe An,Vinh City,23,11,5,6,0
2022-07-16,Quang Nam,Dien Ban,12,2,0,2,2
2022-07-16,Quang Nam,Hoi An City,6,4,2,2,2
2022-07-16,Quang Nam,Hoi An City,7,24,11,13,10
2022-07-16,Quang Nam,Hoi An City,8,28,22,6,2
2022-07-16,Quang Nam,Hoi An City,9,34,26,8,4
2022-07-16,Quang Nam,Hoi An City,10,41,32,9,1
2022-07-16,Quang Nam,Hoi An City,11,70,52,18,5
2022-07-16,Quang Nam,Hoi An City,12,66,45,21,11
2022-07-16,Quang Nam,Hoi An City,13,59,41,18,12
2022-07-16,Quang Nam,Hoi An City,14,63,40,23,11
2022-07-16,Quang Nam,Hoi An City,15,57,45,12,6
2022-07-16,Quang Nam,Hoi An City,16,52,44,8,1
2022-07-16,Quang Nam,Hoi An City,17,52,43,9,4
2022-07-16,Quang Nam,Hoi An City,18,51,31,20,13
2022-07-16,Quang Nam,Hoi An City,19,66,42,24,18
2022-07-16,Quang Nam,Hoi An City,20,61,38,23,13
2022-07-16,Quang Nam,Hoi An City,21,59,24,35,23
2022-07-16,Quang Nam,Hoi An City,22,19,3,16,10
2022-07-16,Quang Nam,Hoi An City,23,1,0,1,1
2022-07-16,Quang Nam,Tam Ky City,19,1,0,1,1
2022-07-16,Quang Ninh,Cam Pha City,13,2,0,2,2
2022-07-16,Quang Ninh,Cam Pha City,14,4,0,4,4
2022-07-16,Quang Ninh,Cam Pha City,15,1,0,1,1
2022-07-16,Quang Ninh,Cam Pha City,16,2,0,2,2
2022-07-16,Quang Ninh,Cam Pha City,18,1,0,1,1
2022-07-16,Quang Ninh,Cam Pha City,20,2,0,2,2
2022-07-16,Quang Ninh,Cam Pha City,21,1,0,1,1
2022-07-16,Quang Ninh,Ha Long City,0,5,0,5,1
2022-07-16,Quang Ninh,Ha Long City,6,6,2,4,3
2022-07-16,Quang Ninh,Ha Long City,7,24,10,14,7
2022-07-16,Quang Ninh,Ha Long City,8,55,30,25,18
2022-07-16,Quang Ninh,Ha Long City,9,54,26,28,20
2022-07-16,Quang Ninh,Ha Long City,10,122,91,31,10
2022-07-16,Quang Ninh,Ha Long City,11,162,126,36,23
2022-07-16,Quang Ninh,Ha Long City,12,121,79,42,19
2022-07-16,Quang Ninh,Ha Long City,13,98,59,39,22
2022-07-16,Quang Ninh,Ha Long City,14,97,63,34,21
2022-07-16,Quang Ninh,Ha Long City,15,97,61,36,17
2022-07-16,Quang Ninh,Ha Long City,16,93,63,30,20
2022-07-16,Quang Ninh,Ha Long City,17,87,56,31,21
2022-07-16,Quang Ninh,Ha Long City,18,82,58,24,8
2022-07-16,Quang Ninh,Ha Long City,19,90,47,43,23
2022-07-16,Quang Ninh,Ha Long City,20,80,53,27,15
2022-07-16,Quang Ninh,Ha Long City,21,67,25,42,27
2022-07-16,Quang Ninh,Ha Long City,22,35,17,18,13
2022-07-16,Quang Ninh,Ha Long City,23,10,3,7,5
2022-07-16,Thai Nguyen,Dong Hy,9,1,0,1,0
2022-07-16,Thai Nguyen,Dong Hy,10,1,0,1,1
2022-07-16,Thai Nguyen,Dong Hy,11,1,0,1,0
2022-07-16,Thai Nguyen,Dong Hy,21,2,0,2,2
2022-07-16,Thai Nguyen,Dong Hy,23,1,0,1,1
2022-07-16,Thai Nguyen,Thai Nguyen City,0,2,2,0,0
2022-07-16,Thai Nguyen,Thai Nguyen City,1,10,2,8,6
2022-07-16,Thai Nguyen,Thai Nguyen City,2,4,1,3,2
2022-07-16,Thai Nguyen,Thai Nguyen City,5,2,0,2,2
2022-07-16,Thai Nguyen,Thai Nguyen City,6,15,12,3,1
2022-07-16,Thai Nguyen,Thai Nguyen City,7,67,60,7,2
2022-07-16,Thai Nguyen,Thai Nguyen City,8,151,137,14,2
2022-07-16,Thai Nguyen,Thai Nguyen City,9,130,120,10,0
2022-07-16,Thai Nguyen,Thai Nguyen City,10,240,215,25,1
2022-07-16,Thai Nguyen,Thai Nguyen City,11,404,380,24,1
2022-07-16,Thai Nguyen,Thai Nguyen City,12,270,249,21,3
2022-07-16,Thai Nguyen,Thai Nguyen City,13,173,158,15,0
2022-07-16,Thai Nguyen,Thai Nguyen City,14,190,176,14,2
2022-07-16,Thai Nguyen,Thai Nguyen City,15,174,155,19,0
2022-07-16,Thai Nguyen,Thai Nguyen City,16,148,131,17,0
2022-07-16,Thai Nguyen,Thai Nguyen City,17,139,125,14,2
2022-07-16,Thai Nguyen,Thai Nguyen City,18,241,221,20,4
2022-07-16,Thai Nguyen,Thai Nguyen City,19,271,239,32,1
2022-07-16,Thai Nguyen,Thai Nguyen City,20,219,198,21,2
2022-07-16,Thai Nguyen,Thai Nguyen City,21,126,107,19,2
2022-07-16,Thai Nguyen,Thai Nguyen City,22,31,23,8,2
2022-07-16,Thai Nguyen,Thai Nguyen City,23,9,6,3,0
2022-07-16,Vung Tau,Ba Ria City,7,2,0,2,1
2022-07-16,Vung Tau,Ba Ria City,8,5,3,2,0
2022-07-16,Vung Tau,Ba Ria City,9,8,4,4,2
2022-07-16,Vung Tau,Ba Ria City,10,9,4,5,3
2022-07-16,Vung Tau,Ba Ria City,11,10,5,5,5
2022-07-16,Vung Tau,Ba Ria City,12,8,5,3,3
2022-07-16,Vung Tau,Ba Ria City,13,4,4,0,0
2022-07-16,Vung Tau,Ba Ria City,14,10,4,6,3
2022-07-16,Vung Tau,Ba Ria City,15,7,2,5,3
2022-07-16,Vung Tau,Ba Ria City,16,4,3,1,0
2022-07-16,Vung Tau,Ba Ria City,17,6,4,2,2
2022-07-16,Vung Tau,Ba Ria City,18,4,3,1,0
2022-07-16,Vung Tau,Ba Ria City,19,3,2,1,1
2022-07-16,Vung Tau,Ba Ria City,20,1,0,1,1
2022-07-16,Vung Tau,Ba Ria City,22,1,0,1,1
2022-07-16,Vung Tau,Chau Duc,13,1,0,1,1
2022-07-16,Vung Tau,Chau Duc,14,2,0,2,2
2022-07-16,Vung Tau,Chau Duc,19,2,0,2,2
2022-07-16,Vung Tau,Long Son,10,1,1,0,0
2022-07-16,Vung Tau,Long Son,12,2,2,0,0
2022-07-16,Vung Tau,Long Son,13,1,1,0,0
2022-07-16,Vung Tau,Long Son,17,1,0,1,0
2022-07-16,Vung Tau,Long Son,18,1,1,0,0
2022-07-16,Vung Tau,Vung Tau City,0,8,4,4,0
2022-07-16,Vung Tau,Vung Tau City,1,5,1,4,2
2022-07-16,Vung Tau,Vung Tau City,2,1,0,1,1
2022-07-16,Vung Tau,Vung Tau City,4,2,1,1,1
2022-07-16,Vung Tau,Vung Tau City,5,3,2,1,0
2022-07-16,Vung Tau,Vung Tau City,6,48,39,9,1
2022-07-16,Vung Tau,Vung Tau City,7,119,109,10,0
2022-07-16,Vung Tau,Vung Tau City,8,200,184,16,3
2022-07-16,Vung Tau,Vung Tau City,9,228,214,14,1
2022-07-16,Vung Tau,Vung Tau City,10,274,258,16,0
2022-07-16,Vung Tau,Vung Tau City,11,420,390,30,8
2022-07-16,Vung Tau,Vung Tau City,12,359,339,20,0
2022-07-16,Vung Tau,Vung Tau City,13,254,235,19,1
2022-07-16,Vung Tau,Vung Tau City,14,301,262,39,10
2022-07-16,Vung Tau,Vung Tau City,15,246,229,17,4
2022-07-16,Vung Tau,Vung Tau City,16,311,255,56,29
2022-07-16,Vung Tau,Vung Tau City,17,340,302,38,9
2022-07-16,Vung Tau,Vung Tau City,18,345,311,34,6
2022-07-16,Vung Tau,Vung Tau City,19,281,251,30,4
2022-07-16,Vung Tau,Vung Tau City,20,234,200,34,1
2022-07-16,Vung Tau,Vung Tau City,21,141,115,26,7
2022-07-16,Vung Tau,Vung Tau City,22,40,28,12,4
2022-07-16,Vung Tau,Vung Tau City,23,20,14,6,4
2022-07-17,Bac Ninh,Bác Ninh City,0,8,7,1,0
2022-07-17,Bac Ninh,Bác Ninh City,1,4,3,1,1
2022-07-17,Bac Ninh,Bác Ninh City,2,1,0,1,1
2022-07-17,Bac Ninh,Bác Ninh City,5,3,1,2,2
2022-07-17,Bac Ninh,Bác Ninh City,6,27,14,13,12
2022-07-17,Bac Ninh,Bác Ninh City,7,46,43,3,0
2022-07-17,Bac Ninh,Bác Ninh City,8,103,98,5,0
2022-07-17,Bac Ninh,Bác Ninh City,9,129,116,13,1
2022-07-17,Bac Ninh,Bác Ninh City,10,218,201,17,3
2022-07-17,Bac Ninh,Bác Ninh City,11,358,297,61,32
2022-07-17,Bac Ninh,Bác Ninh City,12,288,246,42,15
2022-07-17,Bac Ninh,Bác Ninh City,13,179,162,17,2
2022-07-17,Bac Ninh,Bác Ninh City,14,152,138,14,3
2022-07-17,Bac Ninh,Bác Ninh City,15,145,129,16,0
2022-07-17,Bac Ninh,Bác Ninh City,16,160,144,16,2
2022-07-17,Bac Ninh,Bác Ninh City,17,149,133,16,2
2022-07-17,Bac Ninh,Bác Ninh City,18,197,173,24,4
2022-07-17,Bac Ninh,Bác Ninh City,19,196,171,25,6
2022-07-17,Bac Ninh,Bác Ninh City,20,195,150,45,21
2022-07-17,Bac Ninh,Bác Ninh City,21,97,74,23,3
2022-07-17,Bac Ninh,Bác Ninh City,22,28,19,9,1
2022-07-17,Bac Ninh,Bác Ninh City,23,14,11,3,1
2022-07-17,Bac Ninh,Que Vo,7,1,0,1,0
2022-07-17,Bac Ninh,Que Vo,8,4,0,4,3
2022-07-17,Bac Ninh,Que Vo,10,1,0,1,1
2022-07-17,Bac Ninh,Que Vo,12,1,1,0,0
2022-07-17,Bac Ninh,Que Vo,14,1,0,1,1
2022-07-17,Bac Ninh,Que Vo,15,2,1,1,0
2022-07-17,Bac Ninh,Que Vo,16,2,0,2,2
2022-07-17,Bac Ninh,Tien Du,8,1,0,1,1
2022-07-17,Bac Ninh,Tien Du,9,1,0,1,1
2022-07-17,Bac Ninh,Tien Du,10,3,0,3,3
2022-07-17,Bac Ninh,Tien Du,11,2,0,2,2
2022-07-17,Bac Ninh,Tien Du,13,1,0,1,0
2022-07-17,Bac Ninh,Tien Du,15,1,0,1,1
2022-07-17,Bac Ninh,Tien Du,16,3,0,3,3
2022-07-17,Bac Ninh,Tien Du,19,1,1,0,0
2022-07-17,Bac Ninh,Tien Du,21,3,0,3,3
2022-07-17,Bac Ninh,Tu Son,12,1,0,1,0
2022-07-17,Bac Ninh,Tu Son,13,1,0,1,1
2022-07-17,Bac Ninh,Tu Son,14,1,0,1,1
2022-07-17,Bac Ninh,Tu Son,15,4,0,4,4
2022-07-17,Bac Ninh,Tu Son,18,1,0,1,1
2022-07-17,Bac Ninh,Tu Son,19,3,0,3,2
2022-07-17,Bac Ninh,Tu Son,20,1,0,1,1
2022-07-17,Bac Ninh,Tu Son,21,1,0,1,1
2022-07-17,Binh Duong,Ben Cat,9,5,0,5,4
2022-07-17,Binh Duong,Ben Cat,11,1,0,1,1
2022-07-17,Binh Duong,Ben Cat,12,6,0,6,6
2022-07-17,Binh Duong,Ben Cat,13,3,0,3,3
2022-07-17,Binh Duong,Ben Cat,14,4,0,4,4
2022-07-17,Binh Duong,Ben Cat,17,1,0,1,0
2022-07-17,Binh Duong,Ben Cat,19,1,0,1,1
2022-07-17,Binh Duong,Ben Cat,20,2,0,2,2
2022-07-17,Binh Duong,Di An,0,3,0,3,2
2022-07-17,Binh Duong,Di An,5,1,0,1,1
2022-07-17,Binh Duong,Di An,6,1,0,1,1
2022-07-17,Binh Duong,Di An,7,5,2,3,1
2022-07-17,Binh Duong,Di An,8,16,7,9,8
2022-07-17,Binh Duong,Di An,9,36,17,19,15
2022-07-17,Binh Duong,Di An,10,58,41,17,9
2022-07-17,Binh Duong,Di An,11,64,45,19,15
2022-07-17,Binh Duong,Di An,12,50,40,10,4
2022-07-17,Binh Duong,Di An,13,54,46,8,3
2022-07-17,Binh Duong,Di An,14,38,29,9,5
2022-07-17,Binh Duong,Di An,15,36,25,11,4
2022-07-17,Binh Duong,Di An,16,15,8,7,3
2022-07-17,Binh Duong,Di An,17,46,33,13,11
2022-07-17,Binh Duong,Di An,18,55,39,16,10
2022-07-17,Binh Duong,Di An,19,55,36,19,7
2022-07-17,Binh Duong,Di An,20,26,18,8,4
2022-07-17,Binh Duong,Di An,21,7,3,4,1
2022-07-17,Binh Duong,Di An,22,6,0,6,6
2022-07-17,Binh Duong,Di An,23,4,0,4,4
2022-07-17,Binh Duong,Tan Uyen,9,3,1,2,2
2022-07-17,Binh Duong,Tan Uyen,10,7,2,5,4
2022-07-17,Binh Duong,Tan Uyen,11,2,1,1,1
2022-07-17,Binh Duong,Tan Uyen,12,2,2,0,0
2022-07-17,Binh Duong,Tan Uyen,13,5,2,3,2
2022-07-17,Binh Duong,Tan Uyen,14,4,2,2,2
2022-07-17,Binh Duong,Tan Uyen,15,2,2,0,0
2022-07-17,Binh Duong,Tan Uyen,16,5,1,4,4
2022-07-17,Binh Duong,Tan Uyen,17,4,2,2,1
2022-07-17,Binh Duong,Tan Uyen,18,2,1,1,1
2022-07-17,Binh Duong,Tan Uyen,19,7,2,5,3
2022-07-17,Binh Duong,Tan Uyen,20,1,0,1,0
2022-07-17,Binh Duong,Thu Dau Mot Town,0,7,4,3,2
2022-07-17,Binh Duong,Thu Dau Mot Town,1,1,1,0,0
2022-07-17,Binh Duong,Thu Dau Mot Town,2,4,0,4,4
2022-07-17,Binh Duong,Thu Dau Mot Town,4,1,0,1,1
2022-07-17,Binh Duong,Thu Dau Mot Town,5,4,1,3,2
2022-07-17,Binh Duong,Thu Dau Mot Town,6,38,30,8,4
2022-07-17,Binh Duong,Thu Dau Mot Town,7,132,117,15,1
2022-07-17,Binh Duong,Thu Dau Mot Town,8,241,218,23,1
2022-07-17,Binh Duong,Thu Dau Mot Town,9,336,309,27,3
2022-07-17,Binh Duong,Thu Dau Mot Town,10,461,422,39,5
2022-07-17,Binh Duong,Thu Dau Mot Town,11,630,581,49,10
2022-07-17,Binh Duong,Thu Dau Mot Town,12,534,493,41,6
2022-07-17,Binh Duong,Thu Dau Mot Town,13,417,392,25,4
2022-07-17,Binh Duong,Thu Dau Mot Town,14,388,349,39,10
2022-07-17,Binh Duong,Thu Dau Mot Town,15,354,328,26,11
2022-07-17,Binh Duong,Thu Dau Mot Town,16,283,268,15,4
2022-07-17,Binh Duong,Thu Dau Mot Town,17,447,405,42,10
2022-07-17,Binh Duong,Thu Dau Mot Town,18,487,443,44,6
2022-07-17,Binh Duong,Thu Dau Mot Town,19,351,318,33,5
2022-07-17,Binh Duong,Thu Dau Mot Town,20,285,253,32,8
2022-07-17,Binh Duong,Thu Dau Mot Town,21,133,112,21,5
2022-07-17,Binh Duong,Thu Dau Mot Town,22,23,17,6,1
2022-07-17,Binh Duong,Thu Dau Mot Town,23,8,7,1,1
2022-07-17,Binh Duong,Thuan An,0,2,0,2,1
2022-07-17,Binh Duong,Thuan An,1,2,0,2,2
2022-07-17,Binh Duong,Thuan An,7,10,7,3,2
2022-07-17,Binh Duong,Thuan An,8,23,13,10,7
2022-07-17,Binh Duong,Thuan An,9,49,38,11,5
2022-07-17,Binh Duong,Thuan An,10,64,57,7,3
2022-07-17,Binh Duong,Thuan An,11,99,80,19,5
2022-07-17,Binh Duong,Thuan An,12,77,65,12,3
2022-07-17,Binh Duong,Thuan An,13,63,51,12,6
2022-07-17,Binh Duong,Thuan An,14,50,43,7,3
2022-07-17,Binh Duong,Thuan An,15,45,34,11,9
2022-07-17,Binh Duong,Thuan An,16,72,41,31,24
2022-07-17,Binh Duong,Thuan An,17,47,29,18,12
2022-07-17,Binh Duong,Thuan An,18,61,53,8,3
2022-07-17,Binh Duong,Thuan An,19,54,42,12,7
2022-07-17,Binh Duong,Thuan An,20,47,38,9,4
2022-07-17,Binh Duong,Thuan An,21,25,15,10,3
2022-07-17,Binh Duong,Thuan An,22,6,3,3,1
2022-07-17,Binh Duong,Thuan An,23,4,0,4,2
2022-07-17,Can Tho City,Binh Thuy District,6,1,1,0,0
2022-07-17,Can Tho City,Binh Thuy District,7,1,1,0,0
2022-07-17,Can Tho City,Binh Thuy District,8,7,6,1,0
2022-07-17,Can Tho City,Binh Thuy District,9,8,8,0,0
2022-07-17,Can Tho City,Binh Thuy District,10,14,13,1,0
2022-07-17,Can Tho City,Binh Thuy District,11,18,13,5,2
2022-07-17,Can Tho City,Binh Thuy District,12,23,21,2,1
2022-07-17,Can Tho City,Binh Thuy District,13,11,10,1,1
2022-07-17,Can Tho City,Binh Thuy District,14,11,7,4,4
2022-07-17,Can Tho City,Binh Thuy District,15,8,7,1,0
2022-07-17,Can Tho City,Binh Thuy District,16,10,9,1,0
2022-07-17,Can Tho City,Binh Thuy District,17,17,16,1,0
2022-07-17,Can Tho City,Binh Thuy District,18,17,15,2,0
2022-07-17,Can Tho City,Binh Thuy District,19,16,15,1,0
2022-07-17,Can Tho City,Binh Thuy District,20,4,4,0,0
2022-07-17,Can Tho City,Binh Thuy District,21,5,4,1,0
2022-07-17,Can Tho City,Cai Rang District,7,4,2,2,2
2022-07-17,Can Tho City,Cai Rang District,8,9,6,3,0
2022-07-17,Can Tho City,Cai Rang District,9,8,7,1,0
2022-07-17,Can Tho City,Cai Rang District,10,10,9,1,0
2022-07-17,Can Tho City,Cai Rang District,11,11,11,0,0
2022-07-17,Can Tho City,Cai Rang District,12,22,17,5,1
2022-07-17,Can Tho City,Cai Rang District,13,14,12,2,0
2022-07-17,Can Tho City,Cai Rang District,14,5,4,1,0
2022-07-17,Can Tho City,Cai Rang District,15,12,11,1,0
2022-07-17,Can Tho City,Cai Rang District,16,11,11,0,0
2022-07-17,Can Tho City,Cai Rang District,17,21,18,3,1
2022-07-17,Can Tho City,Cai Rang District,18,12,11,1,0
2022-07-17,Can Tho City,Cai Rang District,19,9,9,0,0
2022-07-17,Can Tho City,Cai Rang District,20,16,12,4,0
2022-07-17,Can Tho City,Cai Rang District,21,3,1,2,1
2022-07-17,Can Tho City,Cai Rang District,22,1,1,0,0
2022-07-17,Can Tho City,Ninh Kieu District,0,7,6,1,1
2022-07-17,Can Tho City,Ninh Kieu District,1,6,5,1,1
2022-07-17,Can Tho City,Ninh Kieu District,2,4,2,2,1
2022-07-17,Can Tho City,Ninh Kieu District,3,2,1,1,1
2022-07-17,Can Tho City,Ninh Kieu District,4,2,0,2,2
2022-07-17,Can Tho City,Ninh Kieu District,5,4,3,1,1
2022-07-17,Can Tho City,Ninh Kieu District,6,47,40,7,0
2022-07-17,Can Tho City,Ninh Kieu District,7,146,135,11,0
2022-07-17,Can Tho City,Ninh Kieu District,8,222,208,14,0
2022-07-17,Can Tho City,Ninh Kieu District,9,326,318,8,0
2022-07-17,Can Tho City,Ninh Kieu District,10,502,474,28,0
2022-07-17,Can Tho City,Ninh Kieu District,11,684,650,34,5
2022-07-17,Can Tho City,Ninh Kieu District,12,663,638,25,0
2022-07-17,Can Tho City,Ninh Kieu District,13,387,369,18,0
2022-07-17,Can Tho City,Ninh Kieu District,14,361,342,19,0
2022-07-17,Can Tho City,Ninh Kieu District,15,370,349,21,1
2022-07-17,Can Tho City,Ninh Kieu District,16,404,376,28,0
2022-07-17,Can Tho City,Ninh Kieu District,17,557,531,26,0
2022-07-17,Can Tho City,Ninh Kieu District,18,576,547,29,0
2022-07-17,Can Tho City,Ninh Kieu District,19,510,482,28,0
2022-07-17,Can Tho City,Ninh Kieu District,20,396,381,15,1
2022-07-17,Can Tho City,Ninh Kieu District,21,197,179,18,0
2022-07-17,Can Tho City,Ninh Kieu District,22,44,37,7,0
2022-07-17,Can Tho City,Ninh Kieu District,23,14,10,4,2
2022-07-17,Dong Nai,Bien Hoa City,0,14,5,9,2
2022-07-17,Dong Nai,Bien Hoa City,1,7,3,4,3
2022-07-17,Dong Nai,Bien Hoa City,2,5,1,4,3
2022-07-17,Dong Nai,Bien Hoa City,4,1,1,0,0
2022-07-17,Dong Nai,Bien Hoa City,5,5,3,2,2
2022-07-17,Dong Nai,Bien Hoa City,6,63,43,20,8
2022-07-17,Dong Nai,Bien Hoa City,7,204,166,38,18
2022-07-17,Dong Nai,Bien Hoa City,8,353,304,49,7
2022-07-17,Dong Nai,Bien Hoa City,9,486,435,51,9
2022-07-17,Dong Nai,Bien Hoa City,10,860,776,84,17
2022-07-17,Dong Nai,Bien Hoa City,11,1103,998,105,20
2022-07-17,Dong Nai,Bien Hoa City,12,1022,934,88,13
2022-07-17,Dong Nai,Bien Hoa City,13,841,776,65,12
2022-07-17,Dong Nai,Bien Hoa City,14,663,616,47,4
2022-07-17,Dong Nai,Bien Hoa City,15,612,561,51,8
2022-07-17,Dong Nai,Bien Hoa City,16,561,472,89,43
2022-07-17,Dong Nai,Bien Hoa City,17,780,605,175,96
2022-07-17,Dong Nai,Bien Hoa City,18,845,718,127,48
2022-07-17,Dong Nai,Bien Hoa City,19,751,670,81,14
2022-07-17,Dong Nai,Bien Hoa City,20,603,515,88,20
2022-07-17,Dong Nai,Bien Hoa City,21,235,202,33,5
2022-07-17,Dong Nai,Bien Hoa City,22,53,29,24,10
2022-07-17,Dong Nai,Bien Hoa City,23,27,10,17,7
2022-07-17,Dong Nai,Long Khanh,14,2,0,2,1
2022-07-17,Dong Nai,Long Khanh,17,2,0,2,2
2022-07-17,Dong Nai,Long Khanh,20,1,0,1,0
2022-07-17,Dong Nai,Long Khanh,21,1,0,1,0
2022-07-17,Dong Nai,Long Thanh,8,1,0,1,1
2022-07-17,Dong Nai,Long Thanh,11,4,0,4,3
2022-07-17,Dong Nai,Long Thanh,12,1,0,1,1
2022-07-17,Dong Nai,Long Thanh,13,1,0,1,1
2022-07-17,Dong Nai,Long Thanh,17,1,0,1,1
2022-07-17,Dong Nai,Nhon trach,12,1,0,1,1
2022-07-17,Dong Nai,Nhon trach,13,2,0,2,2
2022-07-17,Dong Nai,Nhon trach,17,3,0,3,2
2022-07-17,Dong Nai,Nhon trach,20,1,0,1,1
2022-07-17,Dong Nai,Trang Bom,9,1,0,1,1
2022-07-17,Dong Nai,Trang Bom,14,2,0,2,2
2022-07-17,Dong Nai,Trang Bom,15,2,0,2,2
2022-07-17,Dong Nai,Trang Bom,19,1,1,0,0
2022-07-17,Dong Nai,Vinh Cuu,14,1,0,1,1
2022-07-17,Dong Nai,Vinh Cuu,17,1,0,1,0
2022-07-17,Hai Phong City,An Duong,7,1,0,1,1
2022-07-17,Hai Phong City,An Duong,8,2,0,2,2
2022-07-17,Hai Phong City,An Duong,9,4,0,4,2
2022-07-17,Hai Phong City,An Duong,10,5,3,2,2
2022-07-17,Hai Phong City,An Duong,11,12,7,5,3
2022-07-17,Hai Phong City,An Duong,12,7,3,4,2
2022-07-17,Hai Phong City,An Duong,13,8,1,7,6
2022-07-17,Hai Phong City,An Duong,14,7,4,3,3
2022-07-17,Hai Phong City,An Duong,15,5,2,3,1
2022-07-17,Hai Phong City,An Duong,16,5,4,1,1
2022-07-17,Hai Phong City,An Duong,17,2,1,1,1
2022-07-17,Hai Phong City,An Duong,18,5,1,4,2
2022-07-17,Hai Phong City,An Duong,19,2,0,2,1
2022-07-17,Hai Phong City,An Duong,20,1,0,1,0
2022-07-17,Hai Phong City,An Duong,21,5,3,2,2
2022-07-17,Hai Phong City,Hai An District,7,3,1,2,0
2022-07-17,Hai Phong City,Hai An District,8,11,8,3,0
2022-07-17,Hai Phong City,Hai An District,9,6,4,2,0
2022-07-17,Hai Phong City,Hai An District,10,28,25,3,0
2022-07-17,Hai Phong City,Hai An District,11,54,46,8,4
2022-07-17,Hai Phong City,Hai An District,12,28,27,1,0
2022-07-17,Hai Phong City,Hai An District,13,25,15,10,3
2022-07-17,Hai Phong City,Hai An District,14,30,18,12,5
2022-07-17,Hai Phong City,Hai An District,15,33,19,14,6
2022-07-17,Hai Phong City,Hai An District,16,12,7,5,2
2022-07-17,Hai Phong City,Hai An District,17,15,12,3,2
2022-07-17,Hai Phong City,Hai An District,18,24,21,3,0
2022-07-17,Hai Phong City,Hai An District,19,33,22,11,4
2022-07-17,Hai Phong City,Hai An District,20,13,11,2,1
2022-07-17,Hai Phong City,Hai An District,21,13,9,4,2
2022-07-17,Hai Phong City,Hai An District,22,4,2,2,1
2022-07-17,Hai Phong City,Hai An District,23,1,0,1,0
2022-07-17,Hai Phong City,Hong Bang District,3,1,0,1,0
2022-07-17,Hai Phong City,Hong Bang District,6,2,1,1,1
2022-07-17,Hai Phong City,Hong Bang District,7,25,16,9,7
2022-07-17,Hai Phong City,Hong Bang District,8,33,28,5,2
2022-07-17,Hai Phong City,Hong Bang District,9,46,37,9,0
2022-07-17,Hai Phong City,Hong Bang District,10,109,88,21,9
2022-07-17,Hai Phong City,Hong Bang District,11,125,104,21,13
2022-07-17,Hai Phong City,Hong Bang District,12,99,83,16,8
2022-07-17,Hai Phong City,Hong Bang District,13,34,31,3,1
2022-07-17,Hai Phong City,Hong Bang District,14,37,33,4,3
2022-07-17,Hai Phong City,Hong Bang District,15,35,29,6,2
2022-07-17,Hai Phong City,Hong Bang District,16,43,33,10,8
2022-07-17,Hai Phong City,Hong Bang District,17,62,49,13,6
2022-07-17,Hai Phong City,Hong Bang District,18,51,43,8,6
2022-07-17,Hai Phong City,Hong Bang District,19,74,59,15,5
2022-07-17,Hai Phong City,Hong Bang District,20,37,27,10,5
2022-07-17,Hai Phong City,Hong Bang District,21,29,24,5,1
2022-07-17,Hai Phong City,Hong Bang District,22,8,7,1,0
2022-07-17,Hai Phong City,Hong Bang District,23,1,0,1,1
2022-07-17,Hai Phong City,Kien An District,0,1,0,1,1
2022-07-17,Hai Phong City,Kien An District,1,1,0,1,1
2022-07-17,Hai Phong City,Kien An District,2,4,0,4,2
2022-07-17,Hai Phong City,Kien An District,6,1,0,1,1
2022-07-17,Hai Phong City,Kien An District,7,6,2,4,4
2022-07-17,Hai Phong City,Kien An District,8,5,2,3,2
2022-07-17,Hai Phong City,Kien An District,9,13,8,5,3
2022-07-17,Hai Phong City,Kien An District,10,10,7,3,2
2022-07-17,Hai Phong City,Kien An District,11,31,18,13,4
2022-07-17,Hai Phong City,Kien An District,12,24,15,9,7
2022-07-17,Hai Phong City,Kien An District,13,10,8,2,1
2022-07-17,Hai Phong City,Kien An District,14,12,3,9,7
2022-07-17,Hai Phong City,Kien An District,15,9,8,1,1
2022-07-17,Hai Phong City,Kien An District,16,11,8,3,2
2022-07-17,Hai Phong City,Kien An District,17,7,5,2,2
2022-07-17,Hai Phong City,Kien An District,18,13,13,0,0
2022-07-17,Hai Phong City,Kien An District,19,15,5,10,9
2022-07-17,Hai Phong City,Kien An District,20,9,8,1,1
2022-07-17,Hai Phong City,Kien An District,21,2,2,0,0
2022-07-17,Hai Phong City,Le Chan District,0,4,1,3,2
2022-07-17,Hai Phong City,Le Chan District,1,2,0,2,1
2022-07-17,Hai Phong City,Le Chan District,2,2,0,2,2
2022-07-17,Hai Phong City,Le Chan District,3,2,0,2,1
2022-07-17,Hai Phong City,Le Chan District,5,1,1,0,0
2022-07-17,Hai Phong City,Le Chan District,6,5,3,2,2
2022-07-17,Hai Phong City,Le Chan District,7,49,36,13,8
2022-07-17,Hai Phong City,Le Chan District,8,97,82,15,2
2022-07-17,Hai Phong City,Le Chan District,9,117,104,13,0
2022-07-17,Hai Phong City,Le Chan District,10,280,233,47,17
2022-07-17,Hai Phong City,Le Chan District,11,395,301,94,54
2022-07-17,Hai Phong City,Le Chan District,12,294,252,42,11
2022-07-17,Hai Phong City,Le Chan District,13,183,149,34,5
2022-07-17,Hai Phong City,Le Chan District,14,167,147,20,5
2022-07-17,Hai Phong City,Le Chan District,15,217,179,38,15
2022-07-17,Hai Phong City,Le Chan District,16,207,176,31,12
2022-07-17,Hai Phong City,Le Chan District,17,229,171,58,31
2022-07-17,Hai Phong City,Le Chan District,18,287,228,59,23
2022-07-17,Hai Phong City,Le Chan District,19,262,196,66,37
2022-07-17,Hai Phong City,Le Chan District,20,167,129,38,14
2022-07-17,Hai Phong City,Le Chan District,21,82,61,21,8
2022-07-17,Hai Phong City,Le Chan District,22,20,14,6,1
2022-07-17,Hai Phong City,Le Chan District,23,11,1,10,7
2022-07-17,Hai Phong City,Ngo Quyen District,0,3,1,2,1
2022-07-17,Hai Phong City,Ngo Quyen District,1,2,1,1,0
2022-07-17,Hai Phong City,Ngo Quyen District,5,2,0,2,2
2022-07-17,Hai Phong City,Ngo Quyen District,6,3,2,1,1
2022-07-17,Hai Phong City,Ngo Quyen District,7,23,19,4,2
2022-07-17,Hai Phong City,Ngo Quyen District,8,67,53,14,2
2022-07-17,Hai Phong City,Ngo Quyen District,9,91,81,10,1
2022-07-17,Hai Phong City,Ngo Quyen District,10,183,158,25,8
2022-07-17,Hai Phong City,Ngo Quyen District,11,310,251,59,26
2022-07-17,Hai Phong City,Ngo Quyen District,12,220,194,26,13
2022-07-17,Hai Phong City,Ngo Quyen District,13,115,97,18,2
2022-07-17,Hai Phong City,Ngo Quyen District,14,147,119,28,11
2022-07-17,Hai Phong City,Ngo Quyen District,15,141,117,24,9
2022-07-17,Hai Phong City,Ngo Quyen District,16,161,132,29,11
2022-07-17,Hai Phong City,Ngo Quyen District,17,175,141,34,12
2022-07-17,Hai Phong City,Ngo Quyen District,18,209,167,42,14
2022-07-17,Hai Phong City,Ngo Quyen District,19,173,129,44,22
2022-07-17,Hai Phong City,Ngo Quyen District,20,120,98,22,4
2022-07-17,Hai Phong City,Ngo Quyen District,21,60,50,10,3
2022-07-17,Hai Phong City,Ngo Quyen District,22,10,8,2,0
2022-07-17,Hai Phong City,Ngo Quyen District,23,6,5,1,0
2022-07-17,Hai Phong City,Thuy Nguyen,7,1,0,1,1
2022-07-17,Hai Phong City,Thuy Nguyen,10,5,0,5,5
2022-07-17,Hai Phong City,Thuy Nguyen,11,2,0,2,2
2022-07-17,Hai Phong City,Thuy Nguyen,14,1,0,1,1
2022-07-17,Hai Phong City,Thuy Nguyen,16,2,0,2,2
2022-07-17,Hai Phong City,Thuy Nguyen,17,1,0,1,1
2022-07-17,Hai Phong City,Thuy Nguyen,18,1,0,1,1
2022-07-17,Hai Phong City,Thuy Nguyen,19,2,0,2,2
2022-07-17,Hai Phong City,Thuy Nguyen,20,1,0,1,1
2022-07-17,Hue City,Hue City,0,11,5,6,2
2022-07-17,Hue City,Hue City,1,5,1,4,3
2022-07-17,Hue City,Hue City,2,4,0,4,3
2022-07-17,Hue City,Hue City,3,2,2,0,0
2022-07-17,Hue City,Hue City,5,6,2,4,2
2022-07-17,Hue City,Hue City,6,68,65,3,3
2022-07-17,Hue City,Hue City,7,220,201,19,2
2022-07-17,Hue City,Hue City,8,365,325,40,2
2022-07-17,Hue City,Hue City,9,363,314,49,2
2022-07-17,Hue City,Hue City,10,514,473,41,2
2022-07-17,Hue City,Hue City,11,983,910,73,15
2022-07-17,Hue City,Hue City,12,718,635,83,10
2022-07-17,Hue City,Hue City,13,416,384,32,2
2022-07-17,Hue City,Hue City,14,391,354,37,4
2022-07-17,Hue City,Hue City,15,418,379,39,1
2022-07-17,Hue City,Hue City,16,486,449,37,11
2022-07-17,Hue City,Hue City,17,525,472,53,2
2022-07-17,Hue City,Hue City,18,528,465,63,5
2022-07-17,Hue City,Hue City,19,641,555,86,23
2022-07-17,Hue City,Hue City,20,440,373,67,6
2022-07-17,Hue City,Hue City,21,227,188,39,4
2022-07-17,Hue City,Hue City,22,47,33,14,3
2022-07-17,Hue City,Hue City,23,18,11,7,0
2022-07-17,Hue City,Huong Thuy,6,4,1,3,2
2022-07-17,Hue City,Huong Thuy,7,1,1,0,0
2022-07-17,Hue City,Huong Thuy,8,2,2,0,0
2022-07-17,Hue City,Huong Thuy,9,2,1,1,1
2022-07-17,Hue City,Huong Thuy,10,2,1,1,0
2022-07-17,Hue City,Huong Thuy,11,1,1,0,0
2022-07-17,Hue City,Huong Thuy,12,1,1,0,0
2022-07-17,Hue City,Huong Thuy,17,1,1,0,0
2022-07-17,Hue City,Huong Thuy,19,1,1,0,0
2022-07-17,Hue City,Huong Thuy,21,1,1,0,0
2022-07-17,Hue City,Huong Tra,11,1,1,0,0
2022-07-17,Hue City,Huong Tra,12,1,0,1,0
2022-07-17,Hue City,Huong Tra,13,1,1,0,0
2022-07-17,Hue City,Huong Tra,19,1,0,1,1
2022-07-17,Hue City,Phong Dien,20,1,1,0,0
2022-07-17,Hue City,Phu Vang,6,3,1,2,1
2022-07-17,Hue City,Phu Vang,7,4,3,1,0
2022-07-17,Hue City,Phu Vang,8,3,3,0,0
2022-07-17,Hue City,Phu Vang,10,2,2,0,0
2022-07-17,Hue City,Phu Vang,11,3,2,1,1
2022-07-17,Hue City,Phu Vang,13,2,2,0,0
2022-07-17,Hue City,Phu Vang,14,4,3,1,1
2022-07-17,Hue City,Phu Vang,15,5,5,0,0
2022-07-17,Hue City,Phu Vang,16,4,3,1,0
2022-07-17,Hue City,Phu Vang,18,1,1,0,0
2022-07-17,Hue City,Phu Vang,19,4,3,1,1
2022-07-17,Hue City,Phu Vang,20,1,1,0,0
2022-07-17,Hue City,Phu Vang,21,1,1,0,0
2022-07-17,Khanh Hoa,Dien Khanh,12,2,0,2,2
2022-07-17,Khanh Hoa,Dien Khanh,14,1,0,1,1
2022-07-17,Khanh Hoa,Dien Khanh,16,1,0,1,1
2022-07-17,Khanh Hoa,Dien Khanh,18,1,0,1,1
2022-07-17,Khanh Hoa,Dien Khanh,21,1,0,1,0
2022-07-17,Khanh Hoa,Nha Trang City,0,2,0,2,2
2022-07-17,Khanh Hoa,Nha Trang City,1,7,0,7,7
2022-07-17,Khanh Hoa,Nha Trang City,2,1,0,1,0
2022-07-17,Khanh Hoa,Nha Trang City,3,2,0,2,2
2022-07-17,Khanh Hoa,Nha Trang City,6,39,31,8,0
2022-07-17,Khanh Hoa,Nha Trang City,7,136,114,22,11
2022-07-17,Khanh Hoa,Nha Trang City,8,200,185,15,1
2022-07-17,Khanh Hoa,Nha Trang City,9,210,190,20,3
2022-07-17,Khanh Hoa,Nha Trang City,10,259,235,24,2
2022-07-17,Khanh Hoa,Nha Trang City,11,410,383,27,10
2022-07-17,Khanh Hoa,Nha Trang City,12,329,298,31,5
2022-07-17,Khanh Hoa,Nha Trang City,13,246,223,23,2
2022-07-17,Khanh Hoa,Nha Trang City,14,245,223,22,3
2022-07-17,Khanh Hoa,Nha Trang City,15,211,197,14,0
2022-07-17,Khanh Hoa,Nha Trang City,16,297,235,62,35
2022-07-17,Khanh Hoa,Nha Trang City,17,348,290,58,28
2022-07-17,Khanh Hoa,Nha Trang City,18,365,296,69,36
2022-07-17,Khanh Hoa,Nha Trang City,19,304,263,41,6
2022-07-17,Khanh Hoa,Nha Trang City,20,204,179,25,2
2022-07-17,Khanh Hoa,Nha Trang City,21,121,86,35,19
2022-07-17,Khanh Hoa,Nha Trang City,22,33,19,14,9
2022-07-17,Khanh Hoa,Nha Trang City,23,28,7,21,15
2022-07-17,Lam Dong,Da Lat City,0,4,3,1,1
2022-07-17,Lam Dong,Da Lat City,1,8,0,8,8
2022-07-17,Lam Dong,Da Lat City,2,9,0,9,8
2022-07-17,Lam Dong,Da Lat City,5,2,0,2,2
2022-07-17,Lam Dong,Da Lat City,6,48,4,44,37
2022-07-17,Lam Dong,Da Lat City,7,76,36,40,34
2022-07-17,Lam Dong,Da Lat City,8,116,63,53,44
2022-07-17,Lam Dong,Da Lat City,9,83,62,21,11
2022-07-17,Lam Dong,Da Lat City,10,131,94,37,23
2022-07-17,Lam Dong,Da Lat City,11,209,141,68,36
2022-07-17,Lam Dong,Da Lat City,12,207,122,85,69
2022-07-17,Lam Dong,Da Lat City,13,136,93,43,30
2022-07-17,Lam Dong,Da Lat City,14,167,106,61,48
2022-07-17,Lam Dong,Da Lat City,15,140,89,51,35
2022-07-17,Lam Dong,Da Lat City,16,147,100,47,32
2022-07-17,Lam Dong,Da Lat City,17,147,90,57,37
2022-07-17,Lam Dong,Da Lat City,18,262,120,142,116
2022-07-17,Lam Dong,Da Lat City,19,300,116,184,139
2022-07-17,Lam Dong,Da Lat City,20,170,88,82,56
2022-07-17,Lam Dong,Da Lat City,21,77,55,22,10
2022-07-17,Lam Dong,Da Lat City,22,35,23,12,4
2022-07-17,Lam Dong,Da Lat City,23,15,2,13,9
2022-07-17,Nghe An,Vinh City,0,2,2,0,0
2022-07-17,Nghe An,Vinh City,1,1,0,1,1
2022-07-17,Nghe An,Vinh City,2,2,0,2,2
2022-07-17,Nghe An,Vinh City,5,2,1,1,1
2022-07-17,Nghe An,Vinh City,6,19,7,12,12
2022-07-17,Nghe An,Vinh City,7,118,95,23,14
2022-07-17,Nghe An,Vinh City,8,137,114,23,6
2022-07-17,Nghe An,Vinh City,9,168,132,36,3
2022-07-17,Nghe An,Vinh City,10,249,193,56,32
2022-07-17,Nghe An,Vinh City,11,349,294,55,23
2022-07-17,Nghe An,Vinh City,12,243,210,33,9
2022-07-17,Nghe An,Vinh City,13,129,108,21,4
2022-07-17,Nghe An,Vinh City,14,150,130,20,9
2022-07-17,Nghe An,Vinh City,15,191,142,49,30
2022-07-17,Nghe An,Vinh City,16,172,121,51,35
2022-07-17,Nghe An,Vinh City,17,177,130,47,18
2022-07-17,Nghe An,Vinh City,18,194,139,55,37
2022-07-17,Nghe An,Vinh City,19,245,154,91,56
2022-07-17,Nghe An,Vinh City,20,174,106,68,38
2022-07-17,Nghe An,Vinh City,21,138,60,78,40
2022-07-17,Nghe An,Vinh City,22,28,16,12,5
2022-07-17,Nghe An,Vinh City,23,9,1,8,3
2022-07-17,Quang Nam,Hoi An City,0,1,1,0,0
2022-07-17,Quang Nam,Hoi An City,5,1,0,1,1
2022-07-17,Quang Nam,Hoi An City,6,16,1,15,12
2022-07-17,Quang Nam,Hoi An City,7,39,10,29,27
2022-07-17,Quang Nam,Hoi An City,8,56,26,30,19
2022-07-17,Quang Nam,Hoi An City,9,62,39,23,10
2022-07-17,Quang Nam,Hoi An City,10,44,36,8,2
2022-07-17,Quang Nam,Hoi An City,11,96,53,43,30
2022-07-17,Quang Nam,Hoi An City,12,98,51,47,32
2022-07-17,Quang Nam,Hoi An City,13,43,36,7,4
2022-07-17,Quang Nam,Hoi An City,14,53,33,20,14
2022-07-17,Quang Nam,Hoi An City,15,67,45,22,11
2022-07-17,Quang Nam,Hoi An City,16,57,41,16,2
2022-07-17,Quang Nam,Hoi An City,17,39,33,6,0
2022-07-17,Quang Nam,Hoi An City,18,54,36,18,9
2022-07-17,Quang Nam,Hoi An City,19,110,38,72,61
2022-07-17,Quang Nam,Hoi An City,20,95,32,63,54
2022-07-17,Quang Nam,Hoi An City,21,43,18,25,16
2022-07-17,Quang Nam,Hoi An City,22,12,3,9,7
2022-07-17,Quang Ninh,Cam Pha City,9,1,0,1,1
2022-07-17,Quang Ninh,Cam Pha City,11,1,0,1,1
2022-07-17,Quang Ninh,Cam Pha City,12,1,0,1,1
2022-07-17,Quang Ninh,Cam Pha City,19,1,0,1,1
2022-07-17,Quang Ninh,Cam Pha City,20,1,0,1,1
2022-07-17,Quang Ninh,Cam Pha City,21,1,0,1,1
2022-07-17,Quang Ninh,Ha Long City,0,1,0,1,1
2022-07-17,Quang Ninh,Ha Long City,1,1,0,1,1
2022-07-17,Quang Ninh,Ha Long City,6,5,1,4,3
2022-07-17,Quang Ninh,Ha Long City,7,24,10,14,11
2022-07-17,Quang Ninh,Ha Long City,8,47,26,21,17
2022-07-17,Quang Ninh,Ha Long City,9,84,47,37,23
2022-07-17,Quang Ninh,Ha Long City,10,126,71,55,37
2022-07-17,Quang Ninh,Ha Long City,11,163,111,52,33
2022-07-17,Quang Ninh,Ha Long City,12,130,99,31,13
2022-07-17,Quang Ninh,Ha Long City,13,66,41,25,13
2022-07-17,Quang Ninh,Ha Long City,14,70,47,23,3
2022-07-17,Quang Ninh,Ha Long City,15,70,51,19,2
2022-07-17,Quang Ninh,Ha Long City,16,67,50,17,7
2022-07-17,Quang Ninh,Ha Long City,17,63,48,15,4
2022-07-17,Quang Ninh,Ha Long City,18,82,62,20,9
2022-07-17,Quang Ninh,Ha Long City,19,89,51,38,17
2022-07-17,Quang Ninh,Ha Long City,20,70,40,30,13
2022-07-17,Quang Ninh,Ha Long City,21,35,21,14,5
2022-07-17,Quang Ninh,Ha Long City,22,11,7,4,0
2022-07-17,Quang Ninh,Ha Long City,23,4,0,4,2
2022-07-17,Quang Ninh,Uong Bi City,12,1,0,1,1
2022-07-17,Quang Ninh,Uong Bi City,19,1,0,1,1
2022-07-17,Thai Nguyen,Dong Hy,8,2,1,1,0
2022-07-17,Thai Nguyen,Dong Hy,11,2,1,1,0
2022-07-17,Thai Nguyen,Dong Hy,16,2,0,2,2
2022-07-17,Thai Nguyen,Pho Yen,13,1,0,1,1
2022-07-17,Thai Nguyen,Thai Nguyen City,0,6,1,5,2
2022-07-17,Thai Nguyen,Thai Nguyen City,1,3,0,3,3
2022-07-17,Thai Nguyen,Thai Nguyen City,2,3,0,3,3
2022-07-17,Thai Nguyen,Thai Nguyen City,6,14,10,4,1
2022-07-17,Thai Nguyen,Thai Nguyen City,7,92,85,7,1
2022-07-17,Thai Nguyen,Thai Nguyen City,8,160,142,18,2
2022-07-17,Thai Nguyen,Thai Nguyen City,9,170,152,18,2
2022-07-17,Thai Nguyen,Thai Nguyen City,10,227,209,18,0
2022-07-17,Thai Nguyen,Thai Nguyen City,11,428,375,53,13
2022-07-17,Thai Nguyen,Thai Nguyen City,12,322,293,29,9
2022-07-17,Thai Nguyen,Thai Nguyen City,13,186,172,14,3
2022-07-17,Thai Nguyen,Thai Nguyen City,14,188,161,27,1
2022-07-17,Thai Nguyen,Thai Nguyen City,15,169,161,8,0
2022-07-17,Thai Nguyen,Thai Nguyen City,16,140,119,21,3
2022-07-17,Thai Nguyen,Thai Nguyen City,17,137,126,11,2
2022-07-17,Thai Nguyen,Thai Nguyen City,18,208,192,16,1
2022-07-17,Thai Nguyen,Thai Nguyen City,19,286,248,38,16
2022-07-17,Thai Nguyen,Thai Nguyen City,20,222,198,24,3
2022-07-17,Thai Nguyen,Thai Nguyen City,21,153,115,38,5
2022-07-17,Thai Nguyen,Thai Nguyen City,22,27,19,8,0
2022-07-17,Thai Nguyen,Thai Nguyen City,23,14,8,6,2
2022-07-17,Vung Tau,Ba Ria City,7,2,0,2,2
2022-07-17,Vung Tau,Ba Ria City,8,3,0,3,0
2022-07-17,Vung Tau,Ba Ria City,9,6,6,0,0
2022-07-17,Vung Tau,Ba Ria City,10,18,11,7,2
2022-07-17,Vung Tau,Ba Ria City,11,13,10,3,0
2022-07-17,Vung Tau,Ba Ria City,12,9,4,5,2
2022-07-17,Vung Tau,Ba Ria City,13,8,4,4,3
2022-07-17,Vung Tau,Ba Ria City,14,4,2,2,2
2022-07-17,Vung Tau,Ba Ria City,15,7,7,0,0
2022-07-17,Vung Tau,Ba Ria City,16,7,4,3,2
2022-07-17,Vung Tau,Ba Ria City,17,9,6,3,2
2022-07-17,Vung Tau,Ba Ria City,18,2,1,1,0
2022-07-17,Vung Tau,Ba Ria City,19,13,2,11,10
2022-07-17,Vung Tau,Ba Ria City,20,9,0,9,6
2022-07-17,Vung Tau,Ba Ria City,21,4,0,4,4
2022-07-17,Vung Tau,Long Son,13,1,1,0,0
2022-07-17,Vung Tau,Long Son,17,2,1,1,0
2022-07-17,Vung Tau,Vung Tau City,0,15,10,5,2
2022-07-17,Vung Tau,Vung Tau City,1,8,4,4,3
2022-07-17,Vung Tau,Vung Tau City,4,1,1,0,0
2022-07-17,Vung Tau,Vung Tau City,5,6,1,5,4
2022-07-17,Vung Tau,Vung Tau City,6,62,40,22,13
2022-07-17,Vung Tau,Vung Tau City,7,146,121,25,13
2022-07-17,Vung Tau,Vung Tau City,8,225,201,24,9
2022-07-17,Vung Tau,Vung Tau City,9,247,216,31,6
2022-07-17,Vung Tau,Vung Tau City,10,294,274,20,1
2022-07-17,Vung Tau,Vung Tau City,11,464,430,34,4
2022-07-17,Vung Tau,Vung Tau City,12,419,380,39,6
2022-07-17,Vung Tau,Vung Tau City,13,275,250,25,1
2022-07-17,Vung Tau,Vung Tau City,14,258,232,26,5
2022-07-17,Vung Tau,Vung Tau City,15,262,236,26,3
2022-07-17,Vung Tau,Vung Tau City,16,231,214,17,2
2022-07-17,Vung Tau,Vung Tau City,17,349,319,30,11
2022-07-17,Vung Tau,Vung Tau City,18,328,287,41,9
2022-07-17,Vung Tau,Vung Tau City,19,283,256,27,4
2022-07-17,Vung Tau,Vung Tau City,20,207,175,32,11
2022-07-17,Vung Tau,Vung Tau City,21,125,96,29,4
2022-07-17,Vung Tau,Vung Tau City,22,19,12,7,0
2022-07-17,Vung Tau,Vung Tau City,23,18,14,4,3
2022-07-18,Bac Ninh,Bác Ninh City,0,4,4,0,0
2022-07-18,Bac Ninh,Bác Ninh City,1,1,1,0,0
2022-07-18,Bac Ninh,Bác Ninh City,3,1,1,0,0
2022-07-18,Bac Ninh,Bác Ninh City,5,1,0,1,0
2022-07-18,Bac Ninh,Bác Ninh City,6,17,11,6,3
2022-07-18,Bac Ninh,Bác Ninh City,7,70,66,4,0
2022-07-18,Bac Ninh,Bác Ninh City,8,123,115,8,0
2022-07-18,Bac Ninh,Bác Ninh City,9,136,126,10,2
2022-07-18,Bac Ninh,Bác Ninh City,10,183,166,17,1
2022-07-18,Bac Ninh,Bác Ninh City,11,374,338,36,8
2022-07-18,Bac Ninh,Bác Ninh City,12,265,243,22,0
2022-07-18,Bac Ninh,Bác Ninh City,13,171,158,13,1
2022-07-18,Bac Ninh,Bác Ninh City,14,155,144,11,0
2022-07-18,Bac Ninh,Bác Ninh City,15,143,125,18,3
2022-07-18,Bac Ninh,Bác Ninh City,16,104,91,13,2
2022-07-18,Bac Ninh,Bác Ninh City,17,107,96,11,0
2022-07-18,Bac Ninh,Bác Ninh City,18,150,134,16,2
2022-07-18,Bac Ninh,Bác Ninh City,19,210,193,17,5
2022-07-18,Bac Ninh,Bác Ninh City,20,146,133,13,5
2022-07-18,Bac Ninh,Bác Ninh City,21,106,90,16,2
2022-07-18,Bac Ninh,Bác Ninh City,22,17,11,6,0
2022-07-18,Bac Ninh,Bác Ninh City,23,11,7,4,1
2022-07-18,Bac Ninh,Que Vo,8,4,1,3,3
2022-07-18,Bac Ninh,Que Vo,9,1,0,1,1
2022-07-18,Bac Ninh,Que Vo,10,3,1,2,2
2022-07-18,Bac Ninh,Que Vo,11,1,0,1,1
2022-07-18,Bac Ninh,Que Vo,14,1,1,0,0
2022-07-18,Bac Ninh,Que Vo,16,1,1,0,0
2022-07-18,Bac Ninh,Que Vo,21,1,0,1,1
2022-07-18,Bac Ninh,Tien Du,9,4,0,4,1
2022-07-18,Bac Ninh,Tien Du,10,2,0,2,2
2022-07-18,Bac Ninh,Tien Du,11,2,0,2,2
2022-07-18,Bac Ninh,Tien Du,12,3,0,3,3
2022-07-18,Bac Ninh,Tien Du,14,4,0,4,3
2022-07-18,Bac Ninh,Tien Du,17,3,0,3,3
2022-07-18,Bac Ninh,Tien Du,20,1,1,0,0
2022-07-18,Bac Ninh,Tien Du,21,2,0,2,2
2022-07-18,Bac Ninh,Tu Son,10,2,0,2,2
2022-07-18,Bac Ninh,Tu Son,11,2,0,2,2
2022-07-18,Bac Ninh,Tu Son,12,6,0,6,5
2022-07-18,Bac Ninh,Tu Son,13,3,0,3,3
2022-07-18,Bac Ninh,Tu Son,14,3,0,3,3
2022-07-18,Bac Ninh,Tu Son,15,3,0,3,2
2022-07-18,Bac Ninh,Tu Son,16,1,0,1,1
2022-07-18,Binh Duong,Ben Cat,7,3,0,3,0
2022-07-18,Binh Duong,Ben Cat,8,1,0,1,1
2022-07-18,Binh Duong,Ben Cat,9,1,0,1,1
2022-07-18,Binh Duong,Ben Cat,10,1,0,1,1
2022-07-18,Binh Duong,Ben Cat,11,1,0,1,1
2022-07-18,Binh Duong,Ben Cat,12,2,0,2,2
2022-07-18,Binh Duong,Ben Cat,13,3,0,3,3
2022-07-18,Binh Duong,Ben Cat,14,2,0,2,2
2022-07-18,Binh Duong,Ben Cat,15,3,0,3,3
2022-07-18,Binh Duong,Ben Cat,16,1,0,1,1
2022-07-18,Binh Duong,Ben Cat,20,3,0,3,3
2022-07-18,Binh Duong,Ben Cat,21,1,0,1,1
2022-07-18,Binh Duong,Ben Cat,23,1,0,1,0
2022-07-18,Binh Duong,Di An,0,1,0,1,1
2022-07-18,Binh Duong,Di An,7,13,3,10,9
2022-07-18,Binh Duong,Di An,8,20,12,8,8
2022-07-18,Binh Duong,Di An,9,20,13,7,6
2022-07-18,Binh Duong,Di An,10,42,32,10,9
2022-07-18,Binh Duong,Di An,11,39,35,4,1
2022-07-18,Binh Duong,Di An,12,30,25,5,2
2022-07-18,Binh Duong,Di An,13,50,36,14,10
2022-07-18,Binh Duong,Di An,14,38,29,9,6
2022-07-18,Binh Duong,Di An,15,34,28,6,2
2022-07-18,Binh Duong,Di An,16,34,28,6,5
2022-07-18,Binh Duong,Di An,17,35,31,4,3
2022-07-18,Binh Duong,Di An,18,35,28,7,2
2022-07-18,Binh Duong,Di An,19,32,15,17,11
2022-07-18,Binh Duong,Di An,20,33,9,24,19
2022-07-18,Binh Duong,Di An,21,10,5,5,2
2022-07-18,Binh Duong,Di An,22,4,1,3,0
2022-07-18,Binh Duong,Di An,23,3,0,3,3
2022-07-18,Binh Duong,Tan Uyen,7,1,0,1,1
2022-07-18,Binh Duong,Tan Uyen,9,1,1,0,0
2022-07-18,Binh Duong,Tan Uyen,11,5,1,4,4
2022-07-18,Binh Duong,Tan Uyen,12,2,1,1,1
2022-07-18,Binh Duong,Tan Uyen,13,2,2,0,0
2022-07-18,Binh Duong,Tan Uyen,14,1,1,0,0
2022-07-18,Binh Duong,Tan Uyen,15,1,1,0,0
2022-07-18,Binh Duong,Tan Uyen,16,1,1,0,0
2022-07-18,Binh Duong,Tan Uyen,17,2,1,1,0
2022-07-18,Binh Duong,Tan Uyen,19,4,2,2,1
2022-07-18,Binh Duong,Tan Uyen,20,2,2,0,0
2022-07-18,Binh Duong,Tan Uyen,21,2,0,2,2
2022-07-18,Binh Duong,Tan Uyen,22,1,0,1,0
2022-07-18,Binh Duong,Thu Dau Mot Town,0,7,4,3,3
2022-07-18,Binh Duong,Thu Dau Mot Town,1,2,0,2,2
2022-07-18,Binh Duong,Thu Dau Mot Town,2,5,1,4,3
2022-07-18,Binh Duong,Thu Dau Mot Town,5,4,1,3,3
2022-07-18,Binh Duong,Thu Dau Mot Town,6,41,33,8,3
2022-07-18,Binh Duong,Thu Dau Mot Town,7,127,119,8,0
2022-07-18,Binh Duong,Thu Dau Mot Town,8,231,213,18,3
2022-07-18,Binh Duong,Thu Dau Mot Town,9,280,253,27,6
2022-07-18,Binh Duong,Thu Dau Mot Town,10,423,393,30,6
2022-07-18,Binh Duong,Thu Dau Mot Town,11,702,645,57,10
2022-07-18,Binh Duong,Thu Dau Mot Town,12,515,481,34,9
2022-07-18,Binh Duong,Thu Dau Mot Town,13,453,421,32,2
2022-07-18,Binh Duong,Thu Dau Mot Town,14,396,374,22,5
2022-07-18,Binh Duong,Thu Dau Mot Town,15,305,283,22,2
2022-07-18,Binh Duong,Thu Dau Mot Town,16,308,286,22,4
2022-07-18,Binh Duong,Thu Dau Mot Town,17,368,347,21,4
2022-07-18,Binh Duong,Thu Dau Mot Town,18,371,339,32,3
2022-07-18,Binh Duong,Thu Dau Mot Town,19,356,307,49,15
2022-07-18,Binh Duong,Thu Dau Mot Town,20,280,252,28,5
2022-07-18,Binh Duong,Thu Dau Mot Town,21,122,111,11,1
2022-07-18,Binh Duong,Thu Dau Mot Town,22,27,24,3,0
2022-07-18,Binh Duong,Thu Dau Mot Town,23,6,5,1,0
2022-07-18,Binh Duong,Thuan An,0,2,0,2,2
2022-07-18,Binh Duong,Thuan An,6,3,1,2,2
2022-07-18,Binh Duong,Thuan An,7,12,5,7,7
2022-07-18,Binh Duong,Thuan An,8,38,22,16,6
2022-07-18,Binh Duong,Thuan An,9,54,36,18,11
2022-07-18,Binh Duong,Thuan An,10,82,63,19,9
2022-07-18,Binh Duong,Thuan An,11,112,89,23,6
2022-07-18,Binh Duong,Thuan An,12,97,81,16,6
2022-07-18,Binh Duong,Thuan An,13,83,67,16,9
2022-07-18,Binh Duong,Thuan An,14,73,57,16,10
2022-07-18,Binh Duong,Thuan An,15,39,34,5,0
2022-07-18,Binh Duong,Thuan An,16,45,36,9,2
2022-07-18,Binh Duong,Thuan An,17,40,35,5,2
2022-07-18,Binh Duong,Thuan An,18,46,45,1,1
2022-07-18,Binh Duong,Thuan An,19,36,23,13,9
2022-07-18,Binh Duong,Thuan An,20,39,24,15,9
2022-07-18,Binh Duong,Thuan An,21,27,17,10,6
2022-07-18,Binh Duong,Thuan An,22,5,2,3,2
2022-07-18,Binh Duong,Thuan An,23,1,0,1,1
2022-07-18,Can Tho City,Binh Thuy District,6,3,1,2,1
2022-07-18,Can Tho City,Binh Thuy District,7,3,3,0,0
2022-07-18,Can Tho City,Binh Thuy District,8,4,3,1,0
2022-07-18,Can Tho City,Binh Thuy District,9,8,7,1,0
2022-07-18,Can Tho City,Binh Thuy District,10,7,5,2,1
2022-07-18,Can Tho City,Binh Thuy District,11,13,12,1,0
2022-07-18,Can Tho City,Binh Thuy District,12,13,13,0,0
2022-07-18,Can Tho City,Binh Thuy District,13,15,13,2,0
2022-07-18,Can Tho City,Binh Thuy District,14,21,17,4,0
2022-07-18,Can Tho City,Binh Thuy District,15,20,13,7,3
2022-07-18,Can Tho City,Binh Thuy District,16,12,12,0,0
2022-07-18,Can Tho City,Binh Thuy District,17,13,12,1,0
2022-07-18,Can Tho City,Binh Thuy District,18,13,12,1,0
2022-07-18,Can Tho City,Binh Thuy District,19,20,16,4,3
2022-07-18,Can Tho City,Binh Thuy District,20,8,6,2,0
2022-07-18,Can Tho City,Binh Thuy District,21,6,4,2,1
2022-07-18,Can Tho City,Cai Rang District,6,3,1,2,0
2022-07-18,Can Tho City,Cai Rang District,7,4,2,2,2
2022-07-18,Can Tho City,Cai Rang District,8,8,7,1,0
2022-07-18,Can Tho City,Cai Rang District,9,7,6,1,1
2022-07-18,Can Tho City,Cai Rang District,10,12,12,0,0
2022-07-18,Can Tho City,Cai Rang District,11,11,11,0,0
2022-07-18,Can Tho City,Cai Rang District,12,14,12,2,2
2022-07-18,Can Tho City,Cai Rang District,13,8,7,1,1
2022-07-18,Can Tho City,Cai Rang District,14,7,4,3,1
2022-07-18,Can Tho City,Cai Rang District,15,4,4,0,0
2022-07-18,Can Tho City,Cai Rang District,16,4,4,0,0
2022-07-18,Can Tho City,Cai Rang District,17,13,13,0,0
2022-07-18,Can Tho City,Cai Rang District,18,8,8,0,0
2022-07-18,Can Tho City,Cai Rang District,19,9,8,1,0
2022-07-18,Can Tho City,Cai Rang District,20,6,6,0,0
2022-07-18,Can Tho City,Cai Rang District,21,4,3,1,0
2022-07-18,Can Tho City,Ninh Kieu District,0,5,3,2,1
2022-07-18,Can Tho City,Ninh Kieu District,1,10,2,8,4
2022-07-18,Can Tho City,Ninh Kieu District,2,3,1,2,1
2022-07-18,Can Tho City,Ninh Kieu District,3,2,2,0,0
2022-07-18,Can Tho City,Ninh Kieu District,4,4,0,4,3
2022-07-18,Can Tho City,Ninh Kieu District,5,5,3,2,2
2022-07-18,Can Tho City,Ninh Kieu District,6,63,40,23,8
2022-07-18,Can Tho City,Ninh Kieu District,7,116,111,5,0
2022-07-18,Can Tho City,Ninh Kieu District,8,217,209,8,0
2022-07-18,Can Tho City,Ninh Kieu District,9,267,247,20,0
2022-07-18,Can Tho City,Ninh Kieu District,10,446,425,21,0
2022-07-18,Can Tho City,Ninh Kieu District,11,820,773,47,6
2022-07-18,Can Tho City,Ninh Kieu District,12,611,586,25,0
2022-07-18,Can Tho City,Ninh Kieu District,13,479,456,23,1
2022-07-18,Can Tho City,Ninh Kieu District,14,463,448,15,0
2022-07-18,Can Tho City,Ninh Kieu District,15,349,330,19,0
2022-07-18,Can Tho City,Ninh Kieu District,16,316,307,9,0
2022-07-18,Can Tho City,Ninh Kieu District,17,430,408,22,0
2022-07-18,Can Tho City,Ninh Kieu District,18,491,460,31,0
2022-07-18,Can Tho City,Ninh Kieu District,19,448,424,24,0
2022-07-18,Can Tho City,Ninh Kieu District,20,343,324,19,0
2022-07-18,Can Tho City,Ninh Kieu District,21,237,219,18,2
2022-07-18,Can Tho City,Ninh Kieu District,22,46,37,9,0
2022-07-18,Can Tho City,Ninh Kieu District,23,22,14,8,3
2022-07-18,Can Tho City,O Mon District,11,1,0,1,0
2022-07-18,Dong Nai,Bien Hoa City,0,8,5,3,2
2022-07-18,Dong Nai,Bien Hoa City,1,4,0,4,4
2022-07-18,Dong Nai,Bien Hoa City,2,2,0,2,2
2022-07-18,Dong Nai,Bien Hoa City,4,1,0,1,1
2022-07-18,Dong Nai,Bien Hoa City,5,6,3,3,1
2022-07-18,Dong Nai,Bien Hoa City,6,50,35,15,11
2022-07-18,Dong Nai,Bien Hoa City,7,144,128,16,4
2022-07-18,Dong Nai,Bien Hoa City,8,311,285,26,5
2022-07-18,Dong Nai,Bien Hoa City,9,423,388,35,2
2022-07-18,Dong Nai,Bien Hoa City,10,738,685,53,8
2022-07-18,Dong Nai,Bien Hoa City,11,1212,1108,104,12
2022-07-18,Dong Nai,Bien Hoa City,12,941,875,66,10
2022-07-18,Dong Nai,Bien Hoa City,13,878,828,50,6
2022-07-18,Dong Nai,Bien Hoa City,14,742,679,63,11
2022-07-18,Dong Nai,Bien Hoa City,15,495,468,27,2
2022-07-18,Dong Nai,Bien Hoa City,16,487,448,39,4
2022-07-18,Dong Nai,Bien Hoa City,17,608,559,49,7
2022-07-18,Dong Nai,Bien Hoa City,18,691,650,41,4
2022-07-18,Dong Nai,Bien Hoa City,19,683,622,61,16
2022-07-18,Dong Nai,Bien Hoa City,20,509,425,84,24
2022-07-18,Dong Nai,Bien Hoa City,21,233,179,54,20
2022-07-18,Dong Nai,Bien Hoa City,22,51,29,22,5
2022-07-18,Dong Nai,Bien Hoa City,23,20,5,15,7
2022-07-18,Dong Nai,Long Khanh,10,1,0,1,1
2022-07-18,Dong Nai,Long Khanh,13,1,0,1,0
2022-07-18,Dong Nai,Long Khanh,15,2,0,2,2
2022-07-18,Dong Nai,Long Khanh,18,1,0,1,1
2022-07-18,Dong Nai,Long Khanh,19,1,0,1,1
2022-07-18,Dong Nai,Long Thanh,7,1,0,1,1
2022-07-18,Dong Nai,Long Thanh,8,1,0,1,1
2022-07-18,Dong Nai,Long Thanh,9,2,0,2,2
2022-07-18,Dong Nai,Long Thanh,10,3,0,3,3
2022-07-18,Dong Nai,Long Thanh,11,2,0,2,1
2022-07-18,Dong Nai,Long Thanh,12,1,0,1,1
2022-07-18,Dong Nai,Long Thanh,16,1,0,1,1
2022-07-18,Dong Nai,Long Thanh,17,1,0,1,1
2022-07-18,Dong Nai,Long Thanh,18,1,0,1,1
2022-07-18,Hai Phong City,An Duong,1,1,1,0,0
2022-07-18,Hai Phong City,An Duong,7,2,1,1,1
2022-07-18,Hai Phong City,An Duong,8,1,1,0,0
2022-07-18,Hai Phong City,An Duong,9,11,5,6,2
2022-07-18,Hai Phong City,An Duong,10,8,5,3,2
2022-07-18,Hai Phong City,An Duong,11,8,4,4,2
2022-07-18,Hai Phong City,An Duong,13,3,1,2,1
2022-07-18,Hai Phong City,An Duong,14,3,1,2,1
2022-07-18,Hai Phong City,An Duong,15,3,2,1,1
2022-07-18,Hai Phong City,An Duong,16,1,0,1,1
2022-07-18,Hai Phong City,An Duong,17,5,4,1,1
2022-07-18,Hai Phong City,An Duong,18,4,2,2,1
2022-07-18,Hai Phong City,An Duong,19,7,3,4,3
2022-07-18,Hai Phong City,An Duong,20,2,0,2,2
2022-07-18,Hai Phong City,An Duong,21,1,1,0,0
2022-07-18,Hai Phong City,Duong Kinh District,16,1,0,1,0
2022-07-18,Hai Phong City,Duong Kinh District,17,1,0,1,1
2022-07-18,Hai Phong City,Hai An District,6,2,0,2,2
2022-07-18,Hai Phong City,Hai An District,7,9,7,2,1
2022-07-18,Hai Phong City,Hai An District,8,13,13,0,0
2022-07-18,Hai Phong City,Hai An District,9,22,21,1,0
2022-07-18,Hai Phong City,Hai An District,10,19,19,0,0
2022-07-18,Hai Phong City,Hai An District,11,47,37,10,7
2022-07-18,Hai Phong City,Hai An District,12,33,29,4,0
2022-07-18,Hai Phong City,Hai An District,13,19,17,2,1
2022-07-18,Hai Phong City,Hai An District,14,21,17,4,1
2022-07-18,Hai Phong City,Hai An District,15,24,21,3,0
2022-07-18,Hai Phong City,Hai An District,16,21,16,5,0
2022-07-18,Hai Phong City,Hai An District,17,16,15,1,1
2022-07-18,Hai Phong City,Hai An District,18,23,17,6,2
2022-07-18,Hai Phong City,Hai An District,19,21,13,8,3
2022-07-18,Hai Phong City,Hai An District,20,26,15,11,5
2022-07-18,Hai Phong City,Hai An District,21,8,5,3,2
2022-07-18,Hai Phong City,Hai An District,22,3,0,3,0
2022-07-18,Hai Phong City,Hong Bang District,0,1,1,0,0
2022-07-18,Hai Phong City,Hong Bang District,1,2,0,2,1
2022-07-18,Hai Phong City,Hong Bang District,6,1,1,0,0
2022-07-18,Hai Phong City,Hong Bang District,7,25,19,6,6
2022-07-18,Hai Phong City,Hong Bang District,8,38,37,1,1
2022-07-18,Hai Phong City,Hong Bang District,9,41,39,2,0
2022-07-18,Hai Phong City,Hong Bang District,10,77,63,14,6
2022-07-18,Hai Phong City,Hong Bang District,11,117,88,29,17
2022-07-18,Hai Phong City,Hong Bang District,12,93,76,17,5
2022-07-18,Hai Phong City,Hong Bang District,13,54,43,11,5
2022-07-18,Hai Phong City,Hong Bang District,14,51,41,10,5
2022-07-18,Hai Phong City,Hong Bang District,15,44,33,11,4
2022-07-18,Hai Phong City,Hong Bang District,16,31,28,3,0
2022-07-18,Hai Phong City,Hong Bang District,17,41,36,5,1
2022-07-18,Hai Phong City,Hong Bang District,18,54,51,3,1
2022-07-18,Hai Phong City,Hong Bang District,19,41,36,5,0
2022-07-18,Hai Phong City,Hong Bang District,20,49,38,11,4
2022-07-18,Hai Phong City,Hong Bang District,21,23,13,10,4
2022-07-18,Hai Phong City,Hong Bang District,22,2,2,0,0
2022-07-18,Hai Phong City,Kien An District,7,2,1,1,1
2022-07-18,Hai Phong City,Kien An District,8,3,2,1,1
2022-07-18,Hai Phong City,Kien An District,9,11,8,3,2
2022-07-18,Hai Phong City,Kien An District,10,3,3,0,0
2022-07-18,Hai Phong City,Kien An District,11,15,14,1,0
2022-07-18,Hai Phong City,Kien An District,12,7,6,1,1
2022-07-18,Hai Phong City,Kien An District,13,9,7,2,2
2022-07-18,Hai Phong City,Kien An District,14,8,6,2,0
2022-07-18,Hai Phong City,Kien An District,15,15,11,4,1
2022-07-18,Hai Phong City,Kien An District,16,7,4,3,1
2022-07-18,Hai Phong City,Kien An District,17,5,4,1,0
2022-07-18,Hai Phong City,Kien An District,18,8,8,0,0
2022-07-18,Hai Phong City,Kien An District,19,13,9,4,3
2022-07-18,Hai Phong City,Kien An District,20,16,4,12,10
2022-07-18,Hai Phong City,Kien An District,21,3,1,2,1
2022-07-18,Hai Phong City,Kien An District,22,2,0,2,1
2022-07-18,Hai Phong City,Le Chan District,0,1,0,1,1
2022-07-18,Hai Phong City,Le Chan District,1,1,1,0,0
2022-07-18,Hai Phong City,Le Chan District,4,1,1,0,0
2022-07-18,Hai Phong City,Le Chan District,5,1,0,1,0
2022-07-18,Hai Phong City,Le Chan District,6,11,6,5,5
2022-07-18,Hai Phong City,Le Chan District,7,31,24,7,3
2022-07-18,Hai Phong City,Le Chan District,8,71,58,13,4
2022-07-18,Hai Phong City,Le Chan District,9,98,87,11,2
2022-07-18,Hai Phong City,Le Chan District,10,224,193,31,7
2022-07-18,Hai Phong City,Le Chan District,11,353,294,59,25
2022-07-18,Hai Phong City,Le Chan District,12,246,220,26,5
2022-07-18,Hai Phong City,Le Chan District,13,157,136,21,6
2022-07-18,Hai Phong City,Le Chan District,14,187,156,31,8
2022-07-18,Hai Phong City,Le Chan District,15,187,159,28,11
2022-07-18,Hai Phong City,Le Chan District,16,181,158,23,4
2022-07-18,Hai Phong City,Le Chan District,17,202,177,25,5
2022-07-18,Hai Phong City,Le Chan District,18,215,188,27,5
2022-07-18,Hai Phong City,Le Chan District,19,220,179,41,12
2022-07-18,Hai Phong City,Le Chan District,20,162,133,29,5
2022-07-18,Hai Phong City,Le Chan District,21,104,71,33,11
2022-07-18,Hai Phong City,Le Chan District,22,16,14,2,0
2022-07-18,Hai Phong City,Le Chan District,23,6,2,4,2
2022-07-18,Hai Phong City,Ngo Quyen District,0,1,0,1,1
2022-07-18,Hai Phong City,Ngo Quyen District,1,3,0,3,0
2022-07-18,Hai Phong City,Ngo Quyen District,2,2,2,0,0
2022-07-18,Hai Phong City,Ngo Quyen District,6,3,1,2,2
2022-07-18,Hai Phong City,Ngo Quyen District,7,28,20,8,4
2022-07-18,Hai Phong City,Ngo Quyen District,8,100,89,11,0
2022-07-18,Hai Phong City,Ngo Quyen District,9,93,75,18,1
2022-07-18,Hai Phong City,Ngo Quyen District,10,172,148,24,6
2022-07-18,Hai Phong City,Ngo Quyen District,11,278,239,39,20
2022-07-18,Hai Phong City,Ngo Quyen District,12,182,157,25,5
2022-07-18,Hai Phong City,Ngo Quyen District,13,136,117,19,3
2022-07-18,Hai Phong City,Ngo Quyen District,14,145,120,25,12
2022-07-18,Hai Phong City,Ngo Quyen District,15,137,120,17,4
2022-07-18,Hai Phong City,Ngo Quyen District,16,141,126,15,2
2022-07-18,Hai Phong City,Ngo Quyen District,17,156,131,25,4
2022-07-18,Hai Phong City,Ngo Quyen District,18,161,142,19,3
2022-07-18,Hai Phong City,Ngo Quyen District,19,181,152,29,9
2022-07-18,Hai Phong City,Ngo Quyen District,20,127,101,26,4
2022-07-18,Hai Phong City,Ngo Quyen District,21,89,65,24,11
2022-07-18,Hai Phong City,Ngo Quyen District,22,17,10,7,1
2022-07-18,Hai Phong City,Ngo Quyen District,23,6,5,1,1
2022-07-18,Hai Phong City,Thuy Nguyen,8,1,0,1,1
2022-07-18,Hai Phong City,Thuy Nguyen,9,2,0,2,2
2022-07-18,Hai Phong City,Thuy Nguyen,10,6,0,6,6
2022-07-18,Hai Phong City,Thuy Nguyen,11,1,0,1,1
2022-07-18,Hai Phong City,Thuy Nguyen,12,3,0,3,3
2022-07-18,Hai Phong City,Thuy Nguyen,13,2,0,2,2
2022-07-18,Hai Phong City,Thuy Nguyen,14,2,0,2,2
2022-07-18,Hue City,Hue City,0,5,3,2,0
2022-07-18,Hue City,Hue City,1,2,2,0,0
2022-07-18,Hue City,Hue City,2,2,0,2,1
2022-07-18,Hue City,Hue City,3,1,0,1,1
2022-07-18,Hue City,Hue City,4,1,1,0,0
2022-07-18,Hue City,Hue City,5,7,4,3,1
2022-07-18,Hue City,Hue City,6,78,63,15,3
2022-07-18,Hue City,Hue City,7,205,185,20,1
2022-07-18,Hue City,Hue City,8,353,327,26,2
2022-07-18,Hue City,Hue City,9,297,274,23,0
2022-07-18,Hue City,Hue City,10,453,422,31,0
2022-07-18,Hue City,Hue City,11,1008,927,81,9
2022-07-18,Hue City,Hue City,12,695,647,48,2
2022-07-18,Hue City,Hue City,13,381,350,31,2
2022-07-18,Hue City,Hue City,14,469,433,36,1
2022-07-18,Hue City,Hue City,15,448,414,34,2
2022-07-18,Hue City,Hue City,16,416,377,39,2
2022-07-18,Hue City,Hue City,17,470,439,31,4
2022-07-18,Hue City,Hue City,18,541,500,41,5
2022-07-18,Hue City,Hue City,19,648,588,60,1
2022-07-18,Hue City,Hue City,20,483,430,53,8
2022-07-18,Hue City,Hue City,21,268,223,45,6
2022-07-18,Hue City,Hue City,22,45,32,13,1
2022-07-18,Hue City,Hue City,23,17,15,2,1
2022-07-18,Hue City,Huong Thuy,8,1,1,0,0
2022-07-18,Hue City,Huong Thuy,9,2,1,1,0
2022-07-18,Hue City,Huong Thuy,11,4,3,1,0
2022-07-18,Hue City,Huong Thuy,12,4,3,1,1
2022-07-18,Hue City,Huong Thuy,13,1,0,1,1
2022-07-18,Hue City,Huong Thuy,15,1,0,1,1
2022-07-18,Hue City,Huong Thuy,16,1,0,1,0
2022-07-18,Hue City,Huong Thuy,17,1,1,0,0
2022-07-18,Hue City,Huong Thuy,18,3,2,1,1
2022-07-18,Hue City,Huong Thuy,19,1,0,1,1
2022-07-18,Hue City,Huong Thuy,21,1,1,0,0
2022-07-18,Hue City,Huong Tra,12,1,1,0,0
2022-07-18,Hue City,Huong Tra,13,1,1,0,0
2022-07-18,Hue City,Huong Tra,16,1,1,0,0
2022-07-18,Hue City,Huong Tra,18,2,2,0,0
2022-07-18,Hue City,Huong Tra,19,1,1,0,0
2022-07-18,Hue City,Phu Vang,6,1,1,0,0
2022-07-18,Hue City,Phu Vang,7,1,0,1,0
2022-07-18,Hue City,Phu Vang,8,2,2,0,0
2022-07-18,Hue City,Phu Vang,9,4,1,3,0
2022-07-18,Hue City,Phu Vang,10,1,1,0,0
2022-07-18,Hue City,Phu Vang,11,1,1,0,0
2022-07-18,Hue City,Phu Vang,12,2,2,0,0
2022-07-18,Hue City,Phu Vang,13,1,1,0,0
2022-07-18,Hue City,Phu Vang,14,3,1,2,1
2022-07-18,Hue City,Phu Vang,15,1,0,1,0
2022-07-18,Hue City,Phu Vang,16,5,5,0,0
2022-07-18,Hue City,Phu Vang,17,2,2,0,0
2022-07-18,Hue City,Phu Vang,18,5,3,2,1
2022-07-18,Hue City,Phu Vang,19,4,3,1,0
2022-07-18,Hue City,Phu Vang,21,1,0,1,0
2022-07-18,Khanh Hoa,Cam Ranh City,11,1,0,1,1
2022-07-18,Khanh Hoa,Cam Ranh City,13,1,0,1,1
2022-07-18,Khanh Hoa,Dien Khanh,10,2,0,2,2
2022-07-18,Khanh Hoa,Dien Khanh,17,1,0,1,1
2022-07-18,Khanh Hoa,Dien Khanh,19,1,0,1,1
2022-07-18,Khanh Hoa,Nha Trang City,0,11,3,8,7
2022-07-18,Khanh Hoa,Nha Trang City,1,9,1,8,6
2022-07-18,Khanh Hoa,Nha Trang City,2,1,0,1,1
2022-07-18,Khanh Hoa,Nha Trang City,4,1,0,1,1
2022-07-18,Khanh Hoa,Nha Trang City,5,1,1,0,0
2022-07-18,Khanh Hoa,Nha Trang City,6,59,52,7,2
2022-07-18,Khanh Hoa,Nha Trang City,7,133,121,12,2
2022-07-18,Khanh Hoa,Nha Trang City,8,200,184,16,2
2022-07-18,Khanh Hoa,Nha Trang City,9,187,161,26,4
2022-07-18,Khanh Hoa,Nha Trang City,10,219,205,14,1
2022-07-18,Khanh Hoa,Nha Trang City,11,407,379,28,1
2022-07-18,Khanh Hoa,Nha Trang City,12,306,291,15,0
2022-07-18,Khanh Hoa,Nha Trang City,13,263,250,13,0
2022-07-18,Khanh Hoa,Nha Trang City,14,252,236,16,2
2022-07-18,Khanh Hoa,Nha Trang City,15,210,203,7,0
2022-07-18,Khanh Hoa,Nha Trang City,16,206,178,28,2
2022-07-18,Khanh Hoa,Nha Trang City,17,254,232,22,1
2022-07-18,Khanh Hoa,Nha Trang City,18,293,271,22,1
2022-07-18,Khanh Hoa,Nha Trang City,19,293,265,28,1
2022-07-18,Khanh Hoa,Nha Trang City,20,228,202,26,1
2022-07-18,Khanh Hoa,Nha Trang City,21,136,110,26,7
2022-07-18,Khanh Hoa,Nha Trang City,22,42,22,20,1
2022-07-18,Khanh Hoa,Nha Trang City,23,19,7,12,5
2022-07-18,Lam Dong,Da Lat City,0,6,1,5,3
2022-07-18,Lam Dong,Da Lat City,1,3,1,2,1
2022-07-18,Lam Dong,Da Lat City,2,3,0,3,3
2022-07-18,Lam Dong,Da Lat City,3,3,0,3,3
2022-07-18,Lam Dong,Da Lat City,4,2,0,2,2
2022-07-18,Lam Dong,Da Lat City,5,1,0,1,1
2022-07-18,Lam Dong,Da Lat City,6,32,5,27,26
2022-07-18,Lam Dong,Da Lat City,7,78,44,34,31
2022-07-18,Lam Dong,Da Lat City,8,90,61,29,16
2022-07-18,Lam Dong,Da Lat City,9,94,71,23,14
2022-07-18,Lam Dong,Da Lat City,10,123,96,27,13
2022-07-18,Lam Dong,Da Lat City,11,159,119,40,23
2022-07-18,Lam Dong,Da Lat City,12,156,113,43,29
2022-07-18,Lam Dong,Da Lat City,13,108,83,25,14
2022-07-18,Lam Dong,Da Lat City,14,128,108,20,10
2022-07-18,Lam Dong,Da Lat City,15,121,99,22,6
2022-07-18,Lam Dong,Da Lat City,16,94,75,19,5
2022-07-18,Lam Dong,Da Lat City,17,124,94,30,11
2022-07-18,Lam Dong,Da Lat City,18,141,116,25,14
2022-07-18,Lam Dong,Da Lat City,19,140,109,31,14
2022-07-18,Lam Dong,Da Lat City,20,95,72,23,13
2022-07-18,Lam Dong,Da Lat City,21,63,32,31,15
2022-07-18,Lam Dong,Da Lat City,22,19,13,6,3
2022-07-18,Lam Dong,Da Lat City,23,19,13,6,5
2022-07-18,Nghe An,Vinh City,0,6,2,4,4
2022-07-18,Nghe An,Vinh City,1,2,0,2,1
2022-07-18,Nghe An,Vinh City,5,2,0,2,1
2022-07-18,Nghe An,Vinh City,6,24,6,18,14
2022-07-18,Nghe An,Vinh City,7,175,111,64,46
2022-07-18,Nghe An,Vinh City,8,219,177,42,25
2022-07-18,Nghe An,Vinh City,9,178,154,24,2
2022-07-18,Nghe An,Vinh City,10,277,223,54,12
2022-07-18,Nghe An,Vinh City,11,366,323,43,13
2022-07-18,Nghe An,Vinh City,12,235,208,27,6
2022-07-18,Nghe An,Vinh City,13,153,128,25,6
2022-07-18,Nghe An,Vinh City,14,191,153,38,15
2022-07-18,Nghe An,Vinh City,15,205,172,33,9
2022-07-18,Nghe An,Vinh City,16,123,104,19,0
2022-07-18,Nghe An,Vinh City,17,153,129,24,15
2022-07-18,Nghe An,Vinh City,18,183,149,34,13
2022-07-18,Nghe An,Vinh City,19,198,149,49,18
2022-07-18,Nghe An,Vinh City,20,147,114,33,13
2022-07-18,Nghe An,Vinh City,21,89,61,28,10
2022-07-18,Nghe An,Vinh City,22,28,13,15,3
2022-07-18,Nghe An,Vinh City,23,13,9,4,0
2022-07-18,Quang Nam,Hoi An City,6,2,0,2,2
2022-07-18,Quang Nam,Hoi An City,7,16,9,7,4
2022-07-18,Quang Nam,Hoi An City,8,30,22,8,6
2022-07-18,Quang Nam,Hoi An City,9,39,27,12,8
2022-07-18,Quang Nam,Hoi An City,10,28,18,10,3
2022-07-18,Quang Nam,Hoi An City,11,50,38,12,4
2022-07-18,Quang Nam,Hoi An City,12,40,35,5,2
2022-07-18,Quang Nam,Hoi An City,13,28,25,3,1
2022-07-18,Quang Nam,Hoi An City,14,55,39,16,8
2022-07-18,Quang Nam,Hoi An City,15,25,20,5,1
2022-07-18,Quang Nam,Hoi An City,16,53,43,10,4
2022-07-18,Quang Nam,Hoi An City,17,38,32,6,1
2022-07-18,Quang Nam,Hoi An City,18,38,32,6,0
2022-07-18,Quang Nam,Hoi An City,19,53,34,19,12
2022-07-18,Quang Nam,Hoi An City,20,45,22,23,17
2022-07-18,Quang Nam,Hoi An City,21,41,11,30,13
2022-07-18,Quang Nam,Hoi An City,22,7,5,2,1
2022-07-18,Quang Nam,Hoi An City,23,3,3,0,0
2022-07-18,Quang Ninh,Cam Pha City,10,1,0,1,1
2022-07-18,Quang Ninh,Cam Pha City,11,3,0,3,3
2022-07-18,Quang Ninh,Cam Pha City,12,5,0,5,4
2022-07-18,Quang Ninh,Cam Pha City,13,3,0,3,3
2022-07-18,Quang Ninh,Ha Long City,0,1,0,1,1
2022-07-18,Quang Ninh,Ha Long City,6,9,2,7,3
2022-07-18,Quang Ninh,Ha Long City,7,25,14,11,8
2022-07-18,Quang Ninh,Ha Long City,8,50,40,10,3
2022-07-18,Quang Ninh,Ha Long City,9,50,35,15,10
2022-07-18,Quang Ninh,Ha Long City,10,95,73,22,11
2022-07-18,Quang Ninh,Ha Long City,11,148,108,40,14
2022-07-18,Quang Ninh,Ha Long City,12,105,73,32,9
2022-07-18,Quang Ninh,Ha Long City,13,93,67,26,12
2022-07-18,Quang Ninh,Ha Long City,14,71,47,24,15
2022-07-18,Quang Ninh,Ha Long City,15,78,54,24,13
2022-07-18,Quang Ninh,Ha Long City,16,54,39,15,10
2022-07-18,Quang Ninh,Ha Long City,17,58,47,11,5
2022-07-18,Quang Ninh,Ha Long City,18,63,46,17,7
2022-07-18,Quang Ninh,Ha Long City,19,77,49,28,10
2022-07-18,Quang Ninh,Ha Long City,20,69,43,26,14
2022-07-18,Quang Ninh,Ha Long City,21,41,17,24,14
2022-07-18,Quang Ninh,Ha Long City,22,26,11,15,7
2022-07-18,Quang Ninh,Ha Long City,23,6,2,4,1
2022-07-18,Quang Ninh,Uong Bi City,17,1,0,1,1
2022-07-18,Quang Ninh,Uong Bi City,18,2,0,2,2
2022-07-18,Quang Ninh,Uong Bi City,19,1,0,1,1
2022-07-18,Thai Nguyen,Dong Hy,19,2,1,1,1
2022-07-18,Thai Nguyen,Thai Nguyen City,0,3,1,2,0
2022-07-18,Thai Nguyen,Thai Nguyen City,1,3,1,2,0
2022-07-18,Thai Nguyen,Thai Nguyen City,4,2,0,2,1
2022-07-18,Thai Nguyen,Thai Nguyen City,6,12,8,4,2
2022-07-18,Thai Nguyen,Thai Nguyen City,7,89,77,12,1
2022-07-18,Thai Nguyen,Thai Nguyen City,8,181,159,22,0
2022-07-18,Thai Nguyen,Thai Nguyen City,9,136,128,8,1
2022-07-18,Thai Nguyen,Thai Nguyen City,10,195,174,21,4
2022-07-18,Thai Nguyen,Thai Nguyen City,11,391,361,30,2
2022-07-18,Thai Nguyen,Thai Nguyen City,12,226,205,21,0
2022-07-18,Thai Nguyen,Thai Nguyen City,13,168,151,17,3
2022-07-18,Thai Nguyen,Thai Nguyen City,14,167,154,13,1
2022-07-18,Thai Nguyen,Thai Nguyen City,15,195,170,25,2
2022-07-18,Thai Nguyen,Thai Nguyen City,16,141,125,16,1
2022-07-18,Thai Nguyen,Thai Nguyen City,17,155,140,15,0
2022-07-18,Thai Nguyen,Thai Nguyen City,18,192,173,19,2
2022-07-18,Thai Nguyen,Thai Nguyen City,19,220,189,31,4
2022-07-18,Thai Nguyen,Thai Nguyen City,20,209,179,30,7
2022-07-18,Thai Nguyen,Thai Nguyen City,21,136,119,17,0
2022-07-18,Thai Nguyen,Thai Nguyen City,22,31,28,3,1
2022-07-18,Thai Nguyen,Thai Nguyen City,23,9,5,4,3
2022-07-18,Vung Tau,Ba Ria City,7,1,1,0,0
2022-07-18,Vung Tau,Ba Ria City,8,2,2,0,0
2022-07-18,Vung Tau,Ba Ria City,9,3,2,1,0
2022-07-18,Vung Tau,Ba Ria City,10,5,4,1,1
2022-07-18,Vung Tau,Ba Ria City,11,3,3,0,0
2022-07-18,Vung Tau,Ba Ria City,12,3,3,0,0
2022-07-18,Vung Tau,Ba Ria City,13,6,5,1,1
2022-07-18,Vung Tau,Ba Ria City,14,13,7,6,3
2022-07-18,Vung Tau,Ba Ria City,15,9,5,4,3
2022-07-18,Vung Tau,Ba Ria City,16,7,5,2,1
2022-07-18,Vung Tau,Ba Ria City,17,4,4,0,0
2022-07-18,Vung Tau,Ba Ria City,19,2,2,0,0
2022-07-18,Vung Tau,Ba Ria City,20,6,0,6,6
2022-07-18,Vung Tau,Ba Ria City,21,1,0,1,1
2022-07-18,Vung Tau,Chau Duc,10,1,0,1,0
2022-07-18,Vung Tau,Chau Duc,12,1,0,1,1
2022-07-18,Vung Tau,Chau Duc,13,1,0,1,1
2022-07-18,Vung Tau,Chau Duc,15,1,0,1,1
2022-07-18,Vung Tau,Long Son,14,1,1,0,0
2022-07-18,Vung Tau,Vung Tau City,0,1,1,0,0
2022-07-18,Vung Tau,Vung Tau City,1,2,0,2,1
2022-07-18,Vung Tau,Vung Tau City,2,1,0,1,0
2022-07-18,Vung Tau,Vung Tau City,3,3,2,1,1
2022-07-18,Vung Tau,Vung Tau City,6,30,24,6,0
2022-07-18,Vung Tau,Vung Tau City,7,128,104,24,4
2022-07-18,Vung Tau,Vung Tau City,8,213,190,23,8
2022-07-18,Vung Tau,Vung Tau City,9,209,193,16,2
2022-07-18,Vung Tau,Vung Tau City,10,231,212,19,7
2022-07-18,Vung Tau,Vung Tau City,11,407,365,42,12
2022-07-18,Vung Tau,Vung Tau City,12,327,296,31,7
2022-07-18,Vung Tau,Vung Tau City,13,282,266,16,4
2022-07-18,Vung Tau,Vung Tau City,14,256,238,18,0
2022-07-18,Vung Tau,Vung Tau City,15,213,193,20,2
2022-07-18,Vung Tau,Vung Tau City,16,223,208,15,2
2022-07-18,Vung Tau,Vung Tau City,17,261,244,17,2
2022-07-18,Vung Tau,Vung Tau City,18,256,232,24,2
2022-07-18,Vung Tau,Vung Tau City,19,276,243,33,3
2022-07-18,Vung Tau,Vung Tau City,20,165,141,24,5
2022-07-18,Vung Tau,Vung Tau City,21,113,87,26,5
2022-07-18,Vung Tau,Vung Tau City,22,24,19,5,1
2022-07-18,Vung Tau,Vung Tau City,23,10,9,1,0
2022-07-19,Bac Ninh,Bác Ninh City,0,7,6,1,1
2022-07-19,Bac Ninh,Bác Ninh City,1,2,2,0,0
2022-07-19,Bac Ninh,Bác Ninh City,2,1,0,1,1
2022-07-19,Bac Ninh,Bác Ninh City,5,2,0,2,2
2022-07-19,Bac Ninh,Bác Ninh City,6,8,7,1,1
2022-07-19,Bac Ninh,Bác Ninh City,7,45,41,4,0
2022-07-19,Bac Ninh,Bác Ninh City,8,117,106,11,0
2022-07-19,Bac Ninh,Bác Ninh City,9,121,110,11,1
2022-07-19,Bac Ninh,Bác Ninh City,10,204,185,19,1
2022-07-19,Bac Ninh,Bác Ninh City,11,348,314,34,4
2022-07-19,Bac Ninh,Bác Ninh City,12,230,202,28,4
2022-07-19,Bac Ninh,Bác Ninh City,13,200,181,19,5
2022-07-19,Bac Ninh,Bác Ninh City,14,185,170,15,5
2022-07-19,Bac Ninh,Bác Ninh City,15,133,127,6,0
2022-07-19,Bac Ninh,Bác Ninh City,16,113,105,8,2
2022-07-19,Bac Ninh,Bác Ninh City,17,128,118,10,1
2022-07-19,Bac Ninh,Bác Ninh City,18,181,168,13,1
2022-07-19,Bac Ninh,Bác Ninh City,19,188,167,21,3
2022-07-19,Bac Ninh,Bác Ninh City,20,122,110,12,1
2022-07-19,Bac Ninh,Bác Ninh City,21,77,70,7,1
2022-07-19,Bac Ninh,Bác Ninh City,22,23,19,4,1
2022-07-19,Bac Ninh,Bác Ninh City,23,14,9,5,2
2022-07-19,Bac Ninh,Que Vo,9,1,0,1,0
2022-07-19,Bac Ninh,Que Vo,11,1,0,1,1
2022-07-19,Bac Ninh,Que Vo,12,1,1,0,0
2022-07-19,Bac Ninh,Que Vo,13,1,0,1,1
2022-07-19,Bac Ninh,Que Vo,14,1,0,1,1
2022-07-19,Bac Ninh,Que Vo,15,3,0,3,2
2022-07-19,Bac Ninh,Que Vo,16,1,1,0,0
2022-07-19,Bac Ninh,Que Vo,17,1,0,1,1
2022-07-19,Bac Ninh,Que Vo,21,1,0,1,1
2022-07-19,Bac Ninh,Tien Du,10,2,0,2,2
2022-07-19,Bac Ninh,Tien Du,11,1,0,1,1
2022-07-19,Bac Ninh,Tien Du,12,1,0,1,1
2022-07-19,Bac Ninh,Tien Du,15,2,0,2,2
2022-07-19,Bac Ninh,Tien Du,16,2,0,2,1
2022-07-19,Bac Ninh,Tien Du,18,1,0,1,1
2022-07-19,Bac Ninh,Tien Du,21,1,0,1,1
2022-07-19,Bac Ninh,Tu Son,9,1,0,1,1
2022-07-19,Bac Ninh,Tu Son,11,1,0,1,1
2022-07-19,Bac Ninh,Tu Son,14,2,0,2,2
2022-07-19,Bac Ninh,Tu Son,15,2,0,2,2
2022-07-19,Bac Ninh,Tu Son,20,3,0,3,3
2022-07-19,Bac Ninh,Tu Son,21,2,0,2,2
2022-07-19,Bac Ninh,Yen Phong,17,1,0,1,1
2022-07-19,Binh Duong,Ben Cat,8,1,0,1,1
2022-07-19,Binh Duong,Ben Cat,9,3,0,3,2
2022-07-19,Binh Duong,Ben Cat,12,1,0,1,1
2022-07-19,Binh Duong,Ben Cat,13,2,0,2,2
2022-07-19,Binh Duong,Ben Cat,14,2,0,2,2
2022-07-19,Binh Duong,Ben Cat,15,1,0,1,1
2022-07-19,Binh Duong,Ben Cat,17,2,0,2,1
2022-07-19,Binh Duong,Ben Cat,18,3,0,3,2
2022-07-19,Binh Duong,Ben Cat,19,1,0,1,1
2022-07-19,Binh Duong,Ben Cat,21,1,0,1,1
2022-07-19,Binh Duong,Di An,0,4,0,4,4
2022-07-19,Binh Duong,Di An,1,2,0,2,2
2022-07-19,Binh Duong,Di An,4,1,0,1,0
2022-07-19,Binh Duong,Di An,6,1,0,1,1
2022-07-19,Binh Duong,Di An,7,12,0,12,11
2022-07-19,Binh Duong,Di An,8,26,7,19,14
2022-07-19,Binh Duong,Di An,9,32,21,11,8
2022-07-19,Binh Duong,Di An,10,42,30,12,11
2022-07-19,Binh Duong,Di An,11,34,30,4,2
2022-07-19,Binh Duong,Di An,12,44,33,11,4
2022-07-19,Binh Duong,Di An,13,36,30,6,3
2022-07-19,Binh Duong,Di An,14,32,26,6,1
2022-07-19,Binh Duong,Di An,15,32,26,6,2
2022-07-19,Binh Duong,Di An,16,29,20,9,5
2022-07-19,Binh Duong,Di An,17,35,25,10,4
2022-07-19,Binh Duong,Di An,18,31,27,4,1
2022-07-19,Binh Duong,Di An,19,34,25,9,1
2022-07-19,Binh Duong,Di An,20,29,24,5,0
2022-07-19,Binh Duong,Di An,21,6,6,0,0
2022-07-19,Binh Duong,Di An,22,3,3,0,0
2022-07-19,Binh Duong,Di An,23,4,1,3,2
2022-07-19,Binh Duong,Tan Uyen,7,3,2,1,0
2022-07-19,Binh Duong,Tan Uyen,8,1,0,1,1
2022-07-19,Binh Duong,Tan Uyen,9,1,0,1,1
2022-07-19,Binh Duong,Tan Uyen,10,1,0,1,1
2022-07-19,Binh Duong,Tan Uyen,11,1,1,0,0
2022-07-19,Binh Duong,Tan Uyen,12,3,3,0,0
2022-07-19,Binh Duong,Tan Uyen,13,6,6,0,0
2022-07-19,Binh Duong,Tan Uyen,14,3,1,2,1
2022-07-19,Binh Duong,Tan Uyen,15,2,1,1,0
2022-07-19,Binh Duong,Tan Uyen,17,2,1,1,0
2022-07-19,Binh Duong,Tan Uyen,18,2,0,2,2
2022-07-19,Binh Duong,Tan Uyen,20,2,0,2,0
2022-07-19,Binh Duong,Tan Uyen,21,3,0,3,3
2022-07-19,Binh Duong,Thu Dau Mot Town,0,2,1,1,0
2022-07-19,Binh Duong,Thu Dau Mot Town,1,4,3,1,0
2022-07-19,Binh Duong,Thu Dau Mot Town,2,1,0,1,1
2022-07-19,Binh Duong,Thu Dau Mot Town,4,1,0,1,0
2022-07-19,Binh Duong,Thu Dau Mot Town,6,40,32,8,1
2022-07-19,Binh Duong,Thu Dau Mot Town,7,120,106,14,4
2022-07-19,Binh Duong,Thu Dau Mot Town,8,248,235,13,4
2022-07-19,Binh Duong,Thu Dau Mot Town,9,273,253,20,4
2022-07-19,Binh Duong,Thu Dau Mot Town,10,438,396,42,4
2022-07-19,Binh Duong,Thu Dau Mot Town,11,726,667,59,7
2022-07-19,Binh Duong,Thu Dau Mot Town,12,500,465,35,7
2022-07-19,Binh Duong,Thu Dau Mot Town,13,441,411,30,9
2022-07-19,Binh Duong,Thu Dau Mot Town,14,426,395,31,9
2022-07-19,Binh Duong,Thu Dau Mot Town,15,272,252,20,4
2022-07-19,Binh Duong,Thu Dau Mot Town,16,240,219,21,3
2022-07-19,Binh Duong,Thu Dau Mot Town,17,361,343,18,6
2022-07-19,Binh Duong,Thu Dau Mot Town,18,427,391,36,7
2022-07-19,Binh Duong,Thu Dau Mot Town,19,379,342,37,6
2022-07-19,Binh Duong,Thu Dau Mot Town,20,271,243,28,5
2022-07-19,Binh Duong,Thu Dau Mot Town,21,122,107,15,3
2022-07-19,Binh Duong,Thu Dau Mot Town,22,22,16,6,5
2022-07-19,Binh Duong,Thu Dau Mot Town,23,13,7,6,2
2022-07-19,Binh Duong,Thuan An,0,6,0,6,5
2022-07-19,Binh Duong,Thuan An,1,1,0,1,1
2022-07-19,Binh Duong,Thuan An,2,1,0,1,0
2022-07-19,Binh Duong,Thuan An,4,1,0,1,1
2022-07-19,Binh Duong,Thuan An,7,6,1,5,3
2022-07-19,Binh Duong,Thuan An,8,31,20,11,5
2022-07-19,Binh Duong,Thuan An,9,41,30,11,5
2022-07-19,Binh Duong,Thuan An,10,58,48,10,5
2022-07-19,Binh Duong,Thuan An,11,86,76,10,7
2022-07-19,Binh Duong,Thuan An,12,84,70,14,6
2022-07-19,Binh Duong,Thuan An,13,120,71,49,36
2022-07-19,Binh Duong,Thuan An,14,60,42,18,17
2022-07-19,Binh Duong,Thuan An,15,43,37,6,3
2022-07-19,Binh Duong,Thuan An,16,40,23,17,15
2022-07-19,Binh Duong,Thuan An,17,58,47,11,6
2022-07-19,Binh Duong,Thuan An,18,56,44,12,5
2022-07-19,Binh Duong,Thuan An,19,52,37,15,5
2022-07-19,Binh Duong,Thuan An,20,46,36,10,5
2022-07-19,Binh Duong,Thuan An,21,25,20,5,4
2022-07-19,Binh Duong,Thuan An,22,7,4,3,2
2022-07-19,Binh Duong,Thuan An,23,3,0,3,1
2022-07-19,Can Tho City,Binh Thuy District,8,2,2,0,0
2022-07-19,Can Tho City,Binh Thuy District,9,8,8,0,0
2022-07-19,Can Tho City,Binh Thuy District,10,6,5,1,0
2022-07-19,Can Tho City,Binh Thuy District,11,33,28,5,0
2022-07-19,Can Tho City,Binh Thuy District,12,8,7,1,0
2022-07-19,Can Tho City,Binh Thuy District,13,11,11,0,0
2022-07-19,Can Tho City,Binh Thuy District,14,12,12,0,0
2022-07-19,Can Tho City,Binh Thuy District,15,10,9,1,0
2022-07-19,Can Tho City,Binh Thuy District,16,11,7,4,4
2022-07-19,Can Tho City,Binh Thuy District,17,15,14,1,0
2022-07-19,Can Tho City,Binh Thuy District,18,10,10,0,0
2022-07-19,Can Tho City,Binh Thuy District,19,15,15,0,0
2022-07-19,Can Tho City,Binh Thuy District,20,8,7,1,0
2022-07-19,Can Tho City,Binh Thuy District,21,12,10,2,0
2022-07-19,Can Tho City,Cai Rang District,7,2,2,0,0
2022-07-19,Can Tho City,Cai Rang District,8,5,4,1,0
2022-07-19,Can Tho City,Cai Rang District,9,7,6,1,1
2022-07-19,Can Tho City,Cai Rang District,10,9,8,1,0
2022-07-19,Can Tho City,Cai Rang District,11,17,15,2,1
2022-07-19,Can Tho City,Cai Rang District,12,16,13,3,1
2022-07-19,Can Tho City,Cai Rang District,13,17,15,2,0
2022-07-19,Can Tho City,Cai Rang District,14,8,7,1,1
2022-07-19,Can Tho City,Cai Rang District,15,7,5,2,0
2022-07-19,Can Tho City,Cai Rang District,16,8,6,2,0
2022-07-19,Can Tho City,Cai Rang District,17,10,9,1,0
2022-07-19,Can Tho City,Cai Rang District,18,19,17,2,1
2022-07-19,Can Tho City,Cai Rang District,19,15,13,2,1
2022-07-19,Can Tho City,Cai Rang District,20,10,9,1,1
2022-07-19,Can Tho City,Cai Rang District,21,7,6,1,1
2022-07-19,Can Tho City,Cai Rang District,22,1,1,0,0
2022-07-19,Can Tho City,Ninh Kieu District,0,7,5,2,0
2022-07-19,Can Tho City,Ninh Kieu District,1,4,2,2,1
2022-07-19,Can Tho City,Ninh Kieu District,2,3,2,1,1
2022-07-19,Can Tho City,Ninh Kieu District,3,2,1,1,0
2022-07-19,Can Tho City,Ninh Kieu District,4,3,1,2,1
2022-07-19,Can Tho City,Ninh Kieu District,5,7,4,3,3
2022-07-19,Can Tho City,Ninh Kieu District,6,44,42,2,0
2022-07-19,Can Tho City,Ninh Kieu District,7,134,126,8,3
2022-07-19,Can Tho City,Ninh Kieu District,8,210,198,12,0
2022-07-19,Can Tho City,Ninh Kieu District,9,270,257,13,0
2022-07-19,Can Tho City,Ninh Kieu District,10,512,488,24,0
2022-07-19,Can Tho City,Ninh Kieu District,11,829,769,60,6
2022-07-19,Can Tho City,Ninh Kieu District,12,558,535,23,0
2022-07-19,Can Tho City,Ninh Kieu District,13,524,493,31,0
2022-07-19,Can Tho City,Ninh Kieu District,14,447,418,29,0
2022-07-19,Can Tho City,Ninh Kieu District,15,371,351,20,0
2022-07-19,Can Tho City,Ninh Kieu District,16,383,358,25,0
2022-07-19,Can Tho City,Ninh Kieu District,17,524,500,24,0
2022-07-19,Can Tho City,Ninh Kieu District,18,502,477,25,0
2022-07-19,Can Tho City,Ninh Kieu District,19,435,410,25,0
2022-07-19,Can Tho City,Ninh Kieu District,20,323,297,26,0
2022-07-19,Can Tho City,Ninh Kieu District,21,191,175,16,0
2022-07-19,Can Tho City,Ninh Kieu District,22,26,21,5,0
2022-07-19,Can Tho City,Ninh Kieu District,23,12,9,3,1
2022-07-19,Can Tho City,O Mon District,11,1,0,1,1
2022-07-19,Can Tho City,Phong Dien,20,1,0,1,1
2022-07-19,Dong Nai,Bien Hoa City,0,13,6,7,4
2022-07-19,Dong Nai,Bien Hoa City,1,3,1,2,2
2022-07-19,Dong Nai,Bien Hoa City,2,2,0,2,1
2022-07-19,Dong Nai,Bien Hoa City,3,2,0,2,2
2022-07-19,Dong Nai,Bien Hoa City,4,1,0,1,1
2022-07-19,Dong Nai,Bien Hoa City,5,4,2,2,2
2022-07-19,Dong Nai,Bien Hoa City,6,52,39,13,10
2022-07-19,Dong Nai,Bien Hoa City,7,172,147,25,8
2022-07-19,Dong Nai,Bien Hoa City,8,316,271,45,5
2022-07-19,Dong Nai,Bien Hoa City,9,431,395,36,2
2022-07-19,Dong Nai,Bien Hoa City,10,817,761,56,10
2022-07-19,Dong Nai,Bien Hoa City,11,1142,1033,109,25
2022-07-19,Dong Nai,Bien Hoa City,12,899,817,82,13
2022-07-19,Dong Nai,Bien Hoa City,13,867,816,51,4
2022-07-19,Dong Nai,Bien Hoa City,14,697,644,53,9
2022-07-19,Dong Nai,Bien Hoa City,15,538,508,30,4
2022-07-19,Dong Nai,Bien Hoa City,16,410,340,70,34
2022-07-19,Dong Nai,Bien Hoa City,17,664,595,69,20
2022-07-19,Dong Nai,Bien Hoa City,18,769,704,65,7
2022-07-19,Dong Nai,Bien Hoa City,19,777,697,80,11
2022-07-19,Dong Nai,Bien Hoa City,20,509,447,62,19
2022-07-19,Dong Nai,Bien Hoa City,21,236,187,49,8
2022-07-19,Dong Nai,Bien Hoa City,22,53,31,22,7
2022-07-19,Dong Nai,Bien Hoa City,23,10,4,6,0
2022-07-19,Dong Nai,Long Khanh,9,2,0,2,2
2022-07-19,Dong Nai,Long Khanh,10,1,0,1,1
2022-07-19,Dong Nai,Long Khanh,12,2,0,2,1
2022-07-19,Dong Nai,Long Khanh,13,1,0,1,1
2022-07-19,Dong Nai,Long Khanh,15,1,0,1,1
2022-07-19,Dong Nai,Long Khanh,16,1,0,1,1
2022-07-19,Dong Nai,Long Khanh,18,1,0,1,1
2022-07-19,Dong Nai,Long Thanh,10,1,0,1,1
2022-07-19,Dong Nai,Long Thanh,11,2,0,2,2
2022-07-19,Dong Nai,Long Thanh,12,1,0,1,1
2022-07-19,Dong Nai,Long Thanh,13,1,0,1,1
2022-07-19,Dong Nai,Long Thanh,20,3,0,3,1
2022-07-19,Dong Nai,Nhon trach,11,1,0,1,1
2022-07-19,Dong Nai,Nhon trach,12,2,0,2,2
2022-07-19,Dong Nai,Nhon trach,13,2,0,2,2
2022-07-19,Dong Nai,Nhon trach,14,1,0,1,1
2022-07-19,Dong Nai,Nhon trach,20,1,0,1,1
2022-07-19,Dong Nai,Trang Bom,11,1,0,1,0
2022-07-19,Dong Nai,Trang Bom,13,1,0,1,1
2022-07-19,Dong Nai,Trang Bom,20,1,0,1,1
2022-07-19,Dong Nai,Vinh Cuu,15,1,0,1,1
2022-07-19,Hai Phong City,An Duong,0,1,0,1,0
2022-07-19,Hai Phong City,An Duong,7,1,1,0,0
2022-07-19,Hai Phong City,An Duong,8,5,2,3,2
2022-07-19,Hai Phong City,An Duong,9,4,1,3,2
2022-07-19,Hai Phong City,An Duong,10,2,1,1,0
2022-07-19,Hai Phong City,An Duong,11,5,2,3,1
2022-07-19,Hai Phong City,An Duong,12,5,1,4,2
2022-07-19,Hai Phong City,An Duong,13,2,1,1,0
2022-07-19,Hai Phong City,An Duong,14,2,1,1,1
2022-07-19,Hai Phong City,An Duong,15,1,1,0,0
2022-07-19,Hai Phong City,An Duong,16,1,0,1,0
2022-07-19,Hai Phong City,An Duong,17,2,2,0,0
2022-07-19,Hai Phong City,An Duong,18,2,2,0,0
2022-07-19,Hai Phong City,An Duong,19,3,3,0,0
2022-07-19,Hai Phong City,An Duong,20,3,0,3,3
2022-07-19,Hai Phong City,An Duong,21,1,0,1,0
2022-07-19,Hai Phong City,An Duong,22,1,0,1,1
2022-07-19,Hai Phong City,Duong Kinh District,16,2,0,2,2
2022-07-19,Hai Phong City,Hai An District,3,1,0,1,1
2022-07-19,Hai Phong City,Hai An District,6,3,2,1,1
2022-07-19,Hai Phong City,Hai An District,7,2,1,1,0
2022-07-19,Hai Phong City,Hai An District,8,16,15,1,1
2022-07-19,Hai Phong City,Hai An District,9,14,14,0,0
2022-07-19,Hai Phong City,Hai An District,10,45,36,9,5
2022-07-19,Hai Phong City,Hai An District,11,56,47,9,2
2022-07-19,Hai Phong City,Hai An District,12,25,19,6,0
2022-07-19,Hai Phong City,Hai An District,13,22,19,3,1
2022-07-19,Hai Phong City,Hai An District,14,22,15,7,1
2022-07-19,Hai Phong City,Hai An District,15,17,16,1,0
2022-07-19,Hai Phong City,Hai An District,16,16,13,3,1
2022-07-19,Hai Phong City,Hai An District,17,17,14,3,1
2022-07-19,Hai Phong City,Hai An District,18,18,15,3,3
2022-07-19,Hai Phong City,Hai An District,19,20,15,5,1
2022-07-19,Hai Phong City,Hai An District,20,14,9,5,2
2022-07-19,Hai Phong City,Hai An District,21,10,9,1,1
2022-07-19,Hai Phong City,Hai An District,22,1,1,0,0
2022-07-19,Hai Phong City,Hong Bang District,0,1,1,0,0
2022-07-19,Hai Phong City,Hong Bang District,2,1,1,0,0
2022-07-19,Hai Phong City,Hong Bang District,6,2,1,1,1
2022-07-19,Hai Phong City,Hong Bang District,7,16,10,6,2
2022-07-19,Hai Phong City,Hong Bang District,8,44,31,13,2
2022-07-19,Hai Phong City,Hong Bang District,9,30,27,3,0
2022-07-19,Hai Phong City,Hong Bang District,10,53,49,4,1
2022-07-19,Hai Phong City,Hong Bang District,11,110,96,14,5
2022-07-19,Hai Phong City,Hong Bang District,12,77,64,13,3
2022-07-19,Hai Phong City,Hong Bang District,13,51,48,3,0
2022-07-19,Hai Phong City,Hong Bang District,14,52,41,11,6
2022-07-19,Hai Phong City,Hong Bang District,15,51,45,6,1
2022-07-19,Hai Phong City,Hong Bang District,16,43,36,7,1
2022-07-19,Hai Phong City,Hong Bang District,17,45,40,5,0
2022-07-19,Hai Phong City,Hong Bang District,18,49,41,8,4
2022-07-19,Hai Phong City,Hong Bang District,19,55,40,15,6
2022-07-19,Hai Phong City,Hong Bang District,20,33,28,5,1
2022-07-19,Hai Phong City,Hong Bang District,21,15,12,3,0
2022-07-19,Hai Phong City,Hong Bang District,22,6,2,4,2
2022-07-19,Hai Phong City,Hong Bang District,23,1,0,1,0
2022-07-19,Hai Phong City,Kien An District,0,1,0,1,1
2022-07-19,Hai Phong City,Kien An District,1,1,0,1,1
2022-07-19,Hai Phong City,Kien An District,8,12,7,5,2
2022-07-19,Hai Phong City,Kien An District,9,5,5,0,0
2022-07-19,Hai Phong City,Kien An District,10,9,6,3,1
2022-07-19,Hai Phong City,Kien An District,11,19,15,4,3
2022-07-19,Hai Phong City,Kien An District,12,8,8,0,0
2022-07-19,Hai Phong City,Kien An District,13,13,9,4,2
2022-07-19,Hai Phong City,Kien An District,14,8,7,1,0
2022-07-19,Hai Phong City,Kien An District,15,7,7,0,0
2022-07-19,Hai Phong City,Kien An District,16,2,2,0,0
2022-07-19,Hai Phong City,Kien An District,17,6,4,2,1
2022-07-19,Hai Phong City,Kien An District,18,5,4,1,1
2022-07-19,Hai Phong City,Kien An District,19,7,6,1,0
2022-07-19,Hai Phong City,Kien An District,20,6,2,4,3
2022-07-19,Hai Phong City,Le Chan District,0,3,3,0,0
2022-07-19,Hai Phong City,Le Chan District,5,3,0,3,1
2022-07-19,Hai Phong City,Le Chan District,6,5,2,3,2
2022-07-19,Hai Phong City,Le Chan District,7,61,48,13,2
2022-07-19,Hai Phong City,Le Chan District,8,94,83,11,0
2022-07-19,Hai Phong City,Le Chan District,9,102,90,12,0
2022-07-19,Hai Phong City,Le Chan District,10,224,203,21,6
2022-07-19,Hai Phong City,Le Chan District,11,378,340,38,10
2022-07-19,Hai Phong City,Le Chan District,12,274,250,24,2
2022-07-19,Hai Phong City,Le Chan District,13,167,147,20,7
2022-07-19,Hai Phong City,Le Chan District,14,213,164,49,16
2022-07-19,Hai Phong City,Le Chan District,15,205,171,34,8
2022-07-19,Hai Phong City,Le Chan District,16,164,143,21,2
2022-07-19,Hai Phong City,Le Chan District,17,188,165,23,2
2022-07-19,Hai Phong City,Le Chan District,18,223,205,18,4
2022-07-19,Hai Phong City,Le Chan District,19,212,178,34,6
2022-07-19,Hai Phong City,Le Chan District,20,175,143,32,11
2022-07-19,Hai Phong City,Le Chan District,21,86,70,16,1
2022-07-19,Hai Phong City,Le Chan District,22,20,12,8,3
2022-07-19,Hai Phong City,Le Chan District,23,11,1,10,7
2022-07-19,Hai Phong City,Ngo Quyen District,0,1,0,1,1
2022-07-19,Hai Phong City,Ngo Quyen District,2,1,1,0,0
2022-07-19,Hai Phong City,Ngo Quyen District,3,1,0,1,0
2022-07-19,Hai Phong City,Ngo Quyen District,6,2,2,0,0
2022-07-19,Hai Phong City,Ngo Quyen District,7,23,20,3,1
2022-07-19,Hai Phong City,Ngo Quyen District,8,76,66,10,0
2022-07-19,Hai Phong City,Ngo Quyen District,9,108,100,8,1
2022-07-19,Hai Phong City,Ngo Quyen District,10,157,143,14,2
2022-07-19,Hai Phong City,Ngo Quyen District,11,273,249,24,3
2022-07-19,Hai Phong City,Ngo Quyen District,12,163,149,14,1
2022-07-19,Hai Phong City,Ngo Quyen District,13,135,122,13,2
2022-07-19,Hai Phong City,Ngo Quyen District,14,174,152,22,7
2022-07-19,Hai Phong City,Ngo Quyen District,15,171,148,23,6
2022-07-19,Hai Phong City,Ngo Quyen District,16,134,110,24,2
2022-07-19,Hai Phong City,Ngo Quyen District,17,160,131,29,3
2022-07-19,Hai Phong City,Ngo Quyen District,18,160,137,23,7
2022-07-19,Hai Phong City,Ngo Quyen District,19,155,125,30,5
2022-07-19,Hai Phong City,Ngo Quyen District,20,134,112,22,3
2022-07-19,Hai Phong City,Ngo Quyen District,21,61,49,12,1
2022-07-19,Hai Phong City,Ngo Quyen District,22,15,8,7,1
2022-07-19,Hai Phong City,Thuy Nguyen,10,1,0,1,1
2022-07-19,Hai Phong City,Thuy Nguyen,11,1,0,1,1
2022-07-19,Hai Phong City,Thuy Nguyen,12,2,0,2,1
2022-07-19,Hai Phong City,Thuy Nguyen,14,2,0,2,2
2022-07-19,Hai Phong City,Thuy Nguyen,15,2,0,2,2
2022-07-19,Hai Phong City,Thuy Nguyen,16,1,0,1,1
2022-07-19,Hai Phong City,Thuy Nguyen,17,3,1,2,1
2022-07-19,Hai Phong City,Thuy Nguyen,19,1,0,1,0
2022-07-19,Hai Phong City,Thuy Nguyen,22,1,0,1,1
2022-07-19,Hue City,Hue City,0,16,5,11,5
2022-07-19,Hue City,Hue City,1,6,4,2,2
2022-07-19,Hue City,Hue City,2,2,1,1,0
2022-07-19,Hue City,Hue City,3,1,0,1,0
2022-07-19,Hue City,Hue City,5,1,0,1,0
2022-07-19,Hue City,Hue City,6,84,75,9,1
2022-07-19,Hue City,Hue City,7,220,199,21,2
2022-07-19,Hue City,Hue City,8,359,334,25,0
2022-07-19,Hue City,Hue City,9,333,313,20,0
2022-07-19,Hue City,Hue City,10,458,417,41,0
2022-07-19,Hue City,Hue City,11,980,889,91,11
2022-07-19,Hue City,Hue City,12,683,643,40,1
2022-07-19,Hue City,Hue City,13,403,378,25,0
2022-07-19,Hue City,Hue City,14,438,405,33,0
2022-07-19,Hue City,Hue City,15,452,412,40,4
2022-07-19,Hue City,Hue City,16,394,346,48,1
2022-07-19,Hue City,Hue City,17,485,441,44,0
2022-07-19,Hue City,Hue City,18,525,482,43,1
2022-07-19,Hue City,Hue City,19,610,557,53,1
2022-07-19,Hue City,Hue City,20,471,418,53,4
2022-07-19,Hue City,Hue City,21,269,220,49,5
2022-07-19,Hue City,Hue City,22,50,36,14,1
2022-07-19,Hue City,Hue City,23,22,17,5,0
2022-07-19,Hue City,Huong Thuy,8,4,3,1,0
2022-07-19,Hue City,Huong Thuy,9,4,1,3,2
2022-07-19,Hue City,Huong Thuy,10,2,2,0,0
2022-07-19,Hue City,Huong Thuy,11,8,5,3,0
2022-07-19,Hue City,Huong Thuy,12,2,2,0,0
2022-07-19,Hue City,Huong Thuy,13,1,1,0,0
2022-07-19,Hue City,Huong Thuy,15,2,2,0,0
2022-07-19,Hue City,Huong Thuy,16,1,1,0,0
2022-07-19,Hue City,Huong Thuy,18,8,2,6,4
2022-07-19,Hue City,Huong Thuy,19,3,3,0,0
2022-07-19,Hue City,Huong Tra,10,1,1,0,0
2022-07-19,Hue City,Huong Tra,11,1,1,0,0
2022-07-19,Hue City,Huong Tra,19,1,0,1,1
2022-07-19,Hue City,Huong Tra,21,1,0,1,1
2022-07-19,Hue City,Phu Vang,6,3,1,2,2
2022-07-19,Hue City,Phu Vang,7,6,3,3,3
2022-07-19,Hue City,Phu Vang,8,3,2,1,0
2022-07-19,Hue City,Phu Vang,9,1,0,1,0
2022-07-19,Hue City,Phu Vang,10,1,1,0,0
2022-07-19,Hue City,Phu Vang,11,10,4,6,3
2022-07-19,Hue City,Phu Vang,12,3,3,0,0
2022-07-19,Hue City,Phu Vang,14,4,1,3,3
2022-07-19,Hue City,Phu Vang,16,2,0,2,2
2022-07-19,Hue City,Phu Vang,17,2,2,0,0
2022-07-19,Hue City,Phu Vang,18,3,2,1,0
2022-07-19,Hue City,Phu Vang,19,1,0,1,1
2022-07-19,Hue City,Phu Vang,20,2,0,2,1
2022-07-19,Hue City,Phu Vang,21,1,1,0,0
2022-07-19,Khanh Hoa,Dien Khanh,8,1,0,1,1
2022-07-19,Khanh Hoa,Nha Trang City,0,8,5,3,1
2022-07-19,Khanh Hoa,Nha Trang City,1,3,3,0,0
2022-07-19,Khanh Hoa,Nha Trang City,2,1,0,1,1
2022-07-19,Khanh Hoa,Nha Trang City,3,1,0,1,1
2022-07-19,Khanh Hoa,Nha Trang City,4,2,1,1,1
2022-07-19,Khanh Hoa,Nha Trang City,5,1,1,0,0
2022-07-19,Khanh Hoa,Nha Trang City,6,38,32,6,2
2022-07-19,Khanh Hoa,Nha Trang City,7,133,122,11,3
2022-07-19,Khanh Hoa,Nha Trang City,8,177,168,9,0
2022-07-19,Khanh Hoa,Nha Trang City,9,192,179,13,0
2022-07-19,Khanh Hoa,Nha Trang City,10,200,192,8,1
2022-07-19,Khanh Hoa,Nha Trang City,11,405,373,32,1
2022-07-19,Khanh Hoa,Nha Trang City,12,308,287,21,0
2022-07-19,Khanh Hoa,Nha Trang City,13,236,223,13,0
2022-07-19,Khanh Hoa,Nha Trang City,14,241,229,12,0
2022-07-19,Khanh Hoa,Nha Trang City,15,214,200,14,0
2022-07-19,Khanh Hoa,Nha Trang City,16,192,176,16,0
2022-07-19,Khanh Hoa,Nha Trang City,17,238,218,20,0
2022-07-19,Khanh Hoa,Nha Trang City,18,322,285,37,3
2022-07-19,Khanh Hoa,Nha Trang City,19,221,200,21,0
2022-07-19,Khanh Hoa,Nha Trang City,20,162,148,14,0
2022-07-19,Khanh Hoa,Nha Trang City,21,114,91,23,8
2022-07-19,Khanh Hoa,Nha Trang City,22,35,23,12,2
2022-07-19,Khanh Hoa,Nha Trang City,23,14,7,7,4
2022-07-19,Lam Dong,Da Lat City,0,4,3,1,1
2022-07-19,Lam Dong,Da Lat City,1,4,2,2,1
2022-07-19,Lam Dong,Da Lat City,2,2,1,1,0
2022-07-19,Lam Dong,Da Lat City,3,2,0,2,2
2022-07-19,Lam Dong,Da Lat City,4,2,0,2,2
2022-07-19,Lam Dong,Da Lat City,5,1,0,1,1
2022-07-19,Lam Dong,Da Lat City,6,11,5,6,5
2022-07-19,Lam Dong,Da Lat City,7,59,45,14,13
2022-07-19,Lam Dong,Da Lat City,8,82,66,16,10
2022-07-19,Lam Dong,Da Lat City,9,67,57,10,2
2022-07-19,Lam Dong,Da Lat City,10,92,84,8,1
2022-07-19,Lam Dong,Da Lat City,11,161,134,27,14
2022-07-19,Lam Dong,Da Lat City,12,130,104,26,5
2022-07-19,Lam Dong,Da Lat City,13,123,102,21,6
2022-07-19,Lam Dong,Da Lat City,14,130,108,22,14
2022-07-19,Lam Dong,Da Lat City,15,106,91,15,6
2022-07-19,Lam Dong,Da Lat City,16,100,84,16,5
2022-07-19,Lam Dong,Da Lat City,17,105,95,10,2
2022-07-19,Lam Dong,Da Lat City,18,141,114,27,10
2022-07-19,Lam Dong,Da Lat City,19,166,120,46,22
2022-07-19,Lam Dong,Da Lat City,20,118,68,50,36
2022-07-19,Lam Dong,Da Lat City,21,83,31,52,38
2022-07-19,Lam Dong,Da Lat City,22,45,15,30,16
2022-07-19,Lam Dong,Da Lat City,23,32,10,22,16
2022-07-19,Nghe An,Vinh City,0,1,1,0,0
2022-07-19,Nghe An,Vinh City,5,2,0,2,2
2022-07-19,Nghe An,Vinh City,6,28,13,15,10
2022-07-19,Nghe An,Vinh City,7,143,119,24,8
2022-07-19,Nghe An,Vinh City,8,187,163,24,5
2022-07-19,Nghe An,Vinh City,9,166,144,22,6
2022-07-19,Nghe An,Vinh City,10,269,219,50,19
2022-07-19,Nghe An,Vinh City,11,375,331,44,11
2022-07-19,Nghe An,Vinh City,12,241,214,27,6
2022-07-19,Nghe An,Vinh City,13,147,127,20,0
2022-07-19,Nghe An,Vinh City,14,191,168,23,5
2022-07-19,Nghe An,Vinh City,15,168,137,31,14
2022-07-19,Nghe An,Vinh City,16,137,111,26,3
2022-07-19,Nghe An,Vinh City,17,139,118,21,4
2022-07-19,Nghe An,Vinh City,18,195,149,46,15
2022-07-19,Nghe An,Vinh City,19,207,153,54,21
2022-07-19,Nghe An,Vinh City,20,142,108,34,15
2022-07-19,Nghe An,Vinh City,21,84,57,27,13
2022-07-19,Nghe An,Vinh City,22,22,18,4,0
2022-07-19,Nghe An,Vinh City,23,11,4,7,2
2022-07-19,Quang Nam,Hoi An City,6,8,0,8,4
2022-07-19,Quang Nam,Hoi An City,7,20,14,6,1
2022-07-19,Quang Nam,Hoi An City,8,29,24,5,1
2022-07-19,Quang Nam,Hoi An City,9,28,23,5,3
2022-07-19,Quang Nam,Hoi An City,10,37,34,3,0
2022-07-19,Quang Nam,Hoi An City,11,39,32,7,1
2022-07-19,Quang Nam,Hoi An City,12,47,27,20,4
2022-07-19,Quang Nam,Hoi An City,13,47,42,5,4
2022-07-19,Quang Nam,Hoi An City,14,45,31,14,2
2022-07-19,Quang Nam,Hoi An City,15,51,34,17,10
2022-07-19,Quang Nam,Hoi An City,16,38,30,8,5
2022-07-19,Quang Nam,Hoi An City,17,54,37,17,10
2022-07-19,Quang Nam,Hoi An City,18,44,34,10,4
2022-07-19,Quang Nam,Hoi An City,19,41,32,9,3
2022-07-19,Quang Nam,Hoi An City,20,49,38,11,2
2022-07-19,Quang Nam,Hoi An City,21,21,10,11,8
2022-07-19,Quang Nam,Hoi An City,22,6,1,5,3
2022-07-19,Quang Nam,Hoi An City,23,1,0,1,0
2022-07-19,Quang Nam,Tam Ky City,14,1,0,1,1
2022-07-19,Quang Nam,Tam Ky City,15,1,0,1,1
2022-07-19,Quang Ninh,Cam Pha City,9,3,0,3,3
2022-07-19,Quang Ninh,Cam Pha City,10,1,0,1,1
2022-07-19,Quang Ninh,Cam Pha City,11,1,0,1,1
2022-07-19,Quang Ninh,Cam Pha City,12,2,0,2,2
2022-07-19,Quang Ninh,Cam Pha City,13,1,0,1,1
2022-07-19,Quang Ninh,Cam Pha City,17,1,0,1,1
2022-07-19,Quang Ninh,Cam Pha City,18,1,0,1,1
2022-07-19,Quang Ninh,Cam Pha City,22,1,0,1,1
2022-07-19,Quang Ninh,Ha Long City,0,1,0,1,1
2022-07-19,Quang Ninh,Ha Long City,1,2,0,2,2
2022-07-19,Quang Ninh,Ha Long City,6,2,1,1,1
2022-07-19,Quang Ninh,Ha Long City,7,27,18,9,3
2022-07-19,Quang Ninh,Ha Long City,8,57,33,24,10
2022-07-19,Quang Ninh,Ha Long City,9,45,34,11,6
2022-07-19,Quang Ninh,Ha Long City,10,105,78,27,10
2022-07-19,Quang Ninh,Ha Long City,11,161,116,45,15
2022-07-19,Quang Ninh,Ha Long City,12,134,91,43,22
2022-07-19,Quang Ninh,Ha Long City,13,86,62,24,13
2022-07-19,Quang Ninh,Ha Long City,14,87,72,15,9
2022-07-19,Quang Ninh,Ha Long City,15,81,58,23,5
2022-07-19,Quang Ninh,Ha Long City,16,70,45,25,7
2022-07-19,Quang Ninh,Ha Long City,17,56,42,14,6
2022-07-19,Quang Ninh,Ha Long City,18,81,69,12,7
2022-07-19,Quang Ninh,Ha Long City,19,63,45,18,9
2022-07-19,Quang Ninh,Ha Long City,20,60,41,19,3
2022-07-19,Quang Ninh,Ha Long City,21,36,21,15,6
2022-07-19,Quang Ninh,Ha Long City,22,16,7,9,2
2022-07-19,Quang Ninh,Ha Long City,23,8,2,6,3
2022-07-19,Quang Ninh,Uong Bi City,10,1,0,1,1
2022-07-19,Quang Ninh,Uong Bi City,11,1,0,1,1
2022-07-19,Quang Ninh,Uong Bi City,19,2,0,2,2
2022-07-19,Quang Ninh,Uong Bi City,20,1,0,1,1
2022-07-19,Thai Nguyen,Thai Nguyen City,0,8,3,5,1
2022-07-19,Thai Nguyen,Thai Nguyen City,1,4,2,2,1
2022-07-19,Thai Nguyen,Thai Nguyen City,3,1,1,0,0
2022-07-19,Thai Nguyen,Thai Nguyen City,5,2,0,2,2
2022-07-19,Thai Nguyen,Thai Nguyen City,6,17,13,4,2
2022-07-19,Thai Nguyen,Thai Nguyen City,7,91,83,8,0
2022-07-19,Thai Nguyen,Thai Nguyen City,8,148,136,12,0
2022-07-19,Thai Nguyen,Thai Nguyen City,9,129,121,8,0
2022-07-19,Thai Nguyen,Thai Nguyen City,10,166,155,11,0
2022-07-19,Thai Nguyen,Thai Nguyen City,11,374,348,26,1
2022-07-19,Thai Nguyen,Thai Nguyen City,12,269,238,31,2
2022-07-19,Thai Nguyen,Thai Nguyen City,13,170,162,8,0
2022-07-19,Thai Nguyen,Thai Nguyen City,14,176,155,21,4
2022-07-19,Thai Nguyen,Thai Nguyen City,15,144,124,20,5
2022-07-19,Thai Nguyen,Thai Nguyen City,16,134,120,14,1
2022-07-19,Thai Nguyen,Thai Nguyen City,17,146,128,18,2
2022-07-19,Thai Nguyen,Thai Nguyen City,18,205,183,22,0
2022-07-19,Thai Nguyen,Thai Nguyen City,19,187,163,24,4
2022-07-19,Thai Nguyen,Thai Nguyen City,20,183,163,20,5
2022-07-19,Thai Nguyen,Thai Nguyen City,21,96,86,10,0
2022-07-19,Thai Nguyen,Thai Nguyen City,22,26,18,8,1
2022-07-19,Thai Nguyen,Thai Nguyen City,23,9,4,5,1
2022-07-19,Vung Tau,Ba Ria City,7,3,1,2,2
2022-07-19,Vung Tau,Ba Ria City,8,1,1,0,0
2022-07-19,Vung Tau,Ba Ria City,9,4,4,0,0
2022-07-19,Vung Tau,Ba Ria City,10,8,7,1,0
2022-07-19,Vung Tau,Ba Ria City,11,7,6,1,0
2022-07-19,Vung Tau,Ba Ria City,12,4,1,3,2
2022-07-19,Vung Tau,Ba Ria City,13,13,11,2,1
2022-07-19,Vung Tau,Ba Ria City,14,6,6,0,0
2022-07-19,Vung Tau,Ba Ria City,15,3,2,1,0
2022-07-19,Vung Tau,Ba Ria City,16,3,3,0,0
2022-07-19,Vung Tau,Ba Ria City,18,2,2,0,0
2022-07-19,Vung Tau,Ba Ria City,19,7,2,5,2
2022-07-19,Vung Tau,Ba Ria City,20,2,0,2,2
2022-07-19,Vung Tau,Ba Ria City,21,6,0,6,5
2022-07-19,Vung Tau,Long Dien,11,2,0,2,2
2022-07-19,Vung Tau,Long Dien,15,2,2,0,0
2022-07-19,Vung Tau,Long Son,11,1,0,1,0
2022-07-19,Vung Tau,Long Son,12,1,1,0,0
2022-07-19,Vung Tau,Long Son,18,2,0,2,1
2022-07-19,Vung Tau,Tan Thanh,10,1,0,1,1
2022-07-19,Vung Tau,Vung Tau City,0,7,5,2,0
2022-07-19,Vung Tau,Vung Tau City,1,2,0,2,1
2022-07-19,Vung Tau,Vung Tau City,3,1,1,0,0
2022-07-19,Vung Tau,Vung Tau City,4,1,0,1,1
2022-07-19,Vung Tau,Vung Tau City,5,2,0,2,2
2022-07-19,Vung Tau,Vung Tau City,6,39,24,15,7
2022-07-19,Vung Tau,Vung Tau City,7,124,115,9,3
2022-07-19,Vung Tau,Vung Tau City,8,183,161,22,10
2022-07-19,Vung Tau,Vung Tau City,9,177,163,14,8
2022-07-19,Vung Tau,Vung Tau City,10,269,238,31,8
2022-07-19,Vung Tau,Vung Tau City,11,357,328,29,8
2022-07-19,Vung Tau,Vung Tau City,12,305,294,11,2
2022-07-19,Vung Tau,Vung Tau City,13,246,226,20,1
2022-07-19,Vung Tau,Vung Tau City,14,247,227,20,3
2022-07-19,Vung Tau,Vung Tau City,15,233,209,24,7
2022-07-19,Vung Tau,Vung Tau City,16,205,180,25,3
2022-07-19,Vung Tau,Vung Tau City,17,297,251,46,24
2022-07-19,Vung Tau,Vung Tau City,18,458,337,121,74
2022-07-19,Vung Tau,Vung Tau City,19,412,319,93,57
2022-07-19,Vung Tau,Vung Tau City,20,242,185,57,16
2022-07-19,Vung Tau,Vung Tau City,21,110,92,18,4
2022-07-19,Vung Tau,Vung Tau City,22,31,20,11,0
2022-07-19,Vung Tau,Vung Tau City,23,5,5,0,0
2022-07-20,Bac Ninh,Bác Ninh City,0,8,6,2,0
2022-07-20,Bac Ninh,Bác Ninh City,1,4,0,4,4
2022-07-20,Bac Ninh,Bác Ninh City,2,2,1,1,1
2022-07-20,Bac Ninh,Bác Ninh City,5,2,0,2,1
2022-07-20,Bac Ninh,Bác Ninh City,6,19,14,5,3
2022-07-20,Bac Ninh,Bác Ninh City,7,69,62,7,1
2022-07-20,Bac Ninh,Bác Ninh City,8,137,124,13,1
2022-07-20,Bac Ninh,Bác Ninh City,9,121,109,12,0
2022-07-20,Bac Ninh,Bác Ninh City,10,186,167,19,1
2022-07-20,Bac Ninh,Bác Ninh City,11,374,319,55,17
2022-07-20,Bac Ninh,Bác Ninh City,12,182,170,12,3
2022-07-20,Bac Ninh,Bác Ninh City,13,134,122,12,0
2022-07-20,Bac Ninh,Bác Ninh City,14,154,135,19,3
2022-07-20,Bac Ninh,Bác Ninh City,15,142,133,9,0
2022-07-20,Bac Ninh,Bác Ninh City,16,109,95,14,0
2022-07-20,Bac Ninh,Bác Ninh City,17,112,102,10,1
2022-07-20,Bac Ninh,Bác Ninh City,18,157,148,9,0
2022-07-20,Bac Ninh,Bác Ninh City,19,176,153,23,1
2022-07-20,Bac Ninh,Bác Ninh City,20,115,101,14,0
2022-07-20,Bac Ninh,Bác Ninh City,21,92,82,10,1
2022-07-20,Bac Ninh,Bác Ninh City,22,12,7,5,0
2022-07-20,Bac Ninh,Bác Ninh City,23,10,9,1,0
2022-07-20,Bac Ninh,Que Vo,8,2,0,2,1
2022-07-20,Bac Ninh,Que Vo,11,1,1,0,0
2022-07-20,Bac Ninh,Que Vo,13,1,1,0,0
2022-07-20,Bac Ninh,Que Vo,14,2,0,2,2
2022-07-20,Bac Ninh,Que Vo,16,2,1,1,1
2022-07-20,Bac Ninh,Que Vo,20,2,0,2,1
2022-07-20,Bac Ninh,Que Vo,22,1,0,1,1
2022-07-20,Bac Ninh,Tien Du,11,1,0,1,1
2022-07-20,Bac Ninh,Tien Du,13,2,0,2,1
2022-07-20,Bac Ninh,Tien Du,14,2,0,2,2
2022-07-20,Bac Ninh,Tien Du,15,4,0,4,2
2022-07-20,Bac Ninh,Tien Du,16,2,0,2,2
2022-07-20,Bac Ninh,Tien Du,20,1,0,1,1
2022-07-20,Bac Ninh,Tu Son,10,2,0,2,2
2022-07-20,Bac Ninh,Tu Son,12,1,0,1,1
2022-07-20,Bac Ninh,Tu Son,13,2,0,2,2
2022-07-20,Bac Ninh,Tu Son,14,3,0,3,3
2022-07-20,Bac Ninh,Tu Son,15,2,0,2,2
2022-07-20,Bac Ninh,Tu Son,16,1,0,1,1
2022-07-20,Bac Ninh,Tu Son,17,2,0,2,1
2022-07-20,Binh Duong,Ben Cat,11,3,0,3,3
2022-07-20,Binh Duong,Ben Cat,12,6,0,6,6
2022-07-20,Binh Duong,Ben Cat,13,3,0,3,1
2022-07-20,Binh Duong,Ben Cat,14,7,0,7,7
2022-07-20,Binh Duong,Ben Cat,17,1,0,1,1
2022-07-20,Binh Duong,Ben Cat,18,2,0,2,2
2022-07-20,Binh Duong,Ben Cat,23,1,0,1,1
2022-07-20,Binh Duong,Di An,0,1,0,1,1
2022-07-20,Binh Duong,Di An,7,15,2,13,8
2022-07-20,Binh Duong,Di An,8,20,7,13,12
2022-07-20,Binh Duong,Di An,9,23,11,12,5
2022-07-20,Binh Duong,Di An,10,56,29,27,19
2022-07-20,Binh Duong,Di An,11,39,28,11,6
2022-07-20,Binh Duong,Di An,12,33,20,13,8
2022-07-20,Binh Duong,Di An,13,24,15,9,4
2022-07-20,Binh Duong,Di An,14,39,25,14,9
2022-07-20,Binh Duong,Di An,15,33,15,18,17
2022-07-20,Binh Duong,Di An,16,42,24,18,16
2022-07-20,Binh Duong,Di An,17,46,25,21,11
2022-07-20,Binh Duong,Di An,18,49,30,19,11
2022-07-20,Binh Duong,Di An,19,39,32,7,4
2022-07-20,Binh Duong,Di An,20,13,8,5,4
2022-07-20,Binh Duong,Di An,21,12,4,8,4
2022-07-20,Binh Duong,Di An,22,1,1,0,0
2022-07-20,Binh Duong,Di An,23,4,0,4,1
2022-07-20,Binh Duong,Tan Uyen,6,1,0,1,1
2022-07-20,Binh Duong,Tan Uyen,8,2,1,1,1
2022-07-20,Binh Duong,Tan Uyen,9,2,0,2,2
2022-07-20,Binh Duong,Tan Uyen,10,2,0,2,1
2022-07-20,Binh Duong,Tan Uyen,11,3,0,3,1
2022-07-20,Binh Duong,Tan Uyen,12,5,1,4,2
2022-07-20,Binh Duong,Tan Uyen,13,8,2,6,5
2022-07-20,Binh Duong,Tan Uyen,14,2,2,0,0
2022-07-20,Binh Duong,Tan Uyen,15,4,2,2,2
2022-07-20,Binh Duong,Tan Uyen,16,2,1,1,0
2022-07-20,Binh Duong,Tan Uyen,17,1,1,0,0
2022-07-20,Binh Duong,Tan Uyen,18,3,1,2,1
2022-07-20,Binh Duong,Tan Uyen,19,2,0,2,2
2022-07-20,Binh Duong,Tan Uyen,20,2,1,1,1
2022-07-20,Binh Duong,Tan Uyen,21,1,0,1,1
2022-07-20,Binh Duong,Tan Uyen,22,1,0,1,1
2022-07-20,Binh Duong,Thu Dau Mot Town,0,3,2,1,0
2022-07-20,Binh Duong,Thu Dau Mot Town,1,3,2,1,0
2022-07-20,Binh Duong,Thu Dau Mot Town,2,4,0,4,4
2022-07-20,Binh Duong,Thu Dau Mot Town,6,32,32,0,0
2022-07-20,Binh Duong,Thu Dau Mot Town,7,127,114,13,0
2022-07-20,Binh Duong,Thu Dau Mot Town,8,209,201,8,1
2022-07-20,Binh Duong,Thu Dau Mot Town,9,289,267,22,2
2022-07-20,Binh Duong,Thu Dau Mot Town,10,407,374,33,11
2022-07-20,Binh Duong,Thu Dau Mot Town,11,609,545,64,13
2022-07-20,Binh Duong,Thu Dau Mot Town,12,462,428,34,11
2022-07-20,Binh Duong,Thu Dau Mot Town,13,395,367,28,7
2022-07-20,Binh Duong,Thu Dau Mot Town,14,380,344,36,6
2022-07-20,Binh Duong,Thu Dau Mot Town,15,306,274,32,13
2022-07-20,Binh Duong,Thu Dau Mot Town,16,342,309,33,8
2022-07-20,Binh Duong,Thu Dau Mot Town,17,424,391,33,5
2022-07-20,Binh Duong,Thu Dau Mot Town,18,417,379,38,9
2022-07-20,Binh Duong,Thu Dau Mot Town,19,390,361,29,9
2022-07-20,Binh Duong,Thu Dau Mot Town,20,294,274,20,3
2022-07-20,Binh Duong,Thu Dau Mot Town,21,142,119,23,4
2022-07-20,Binh Duong,Thu Dau Mot Town,22,31,25,6,1
2022-07-20,Binh Duong,Thu Dau Mot Town,23,9,6,3,0
2022-07-20,Binh Duong,Thuan An,3,1,0,1,1
2022-07-20,Binh Duong,Thuan An,6,2,2,0,0
2022-07-20,Binh Duong,Thuan An,7,11,7,4,3
2022-07-20,Binh Duong,Thuan An,8,25,17,8,5
2022-07-20,Binh Duong,Thuan An,9,53,40,13,7
2022-07-20,Binh Duong,Thuan An,10,70,53,17,4
2022-07-20,Binh Duong,Thuan An,11,84,67,17,9
2022-07-20,Binh Duong,Thuan An,12,62,46,16,7
2022-07-20,Binh Duong,Thuan An,13,94,54,40,29
2022-07-20,Binh Duong,Thuan An,14,68,37,31,22
2022-07-20,Binh Duong,Thuan An,15,57,24,33,27
2022-07-20,Binh Duong,Thuan An,16,48,28,20,16
2022-07-20,Binh Duong,Thuan An,17,56,40,16,12
2022-07-20,Binh Duong,Thuan An,18,60,42,18,8
2022-07-20,Binh Duong,Thuan An,19,64,49,15,8
2022-07-20,Binh Duong,Thuan An,20,53,41,12,4
2022-07-20,Binh Duong,Thuan An,21,30,17,13,4
2022-07-20,Binh Duong,Thuan An,22,5,1,4,1
2022-07-20,Binh Duong,Thuan An,23,2,1,1,0
2022-07-20,Can Tho City,Binh Thuy District,8,8,5,3,3
2022-07-20,Can Tho City,Binh Thuy District,9,8,7,1,0
2022-07-20,Can Tho City,Binh Thuy District,10,2,2,0,0
2022-07-20,Can Tho City,Binh Thuy District,11,20,16,4,1
2022-07-20,Can Tho City,Binh Thuy District,12,12,9,3,0
2022-07-20,Can Tho City,Binh Thuy District,13,13,13,0,0
2022-07-20,Can Tho City,Binh Thuy District,14,19,19,0,0
2022-07-20,Can Tho City,Binh Thuy District,15,7,7,0,0
2022-07-20,Can Tho City,Binh Thuy District,16,7,7,0,0
2022-07-20,Can Tho City,Binh Thuy District,17,7,6,1,0
2022-07-20,Can Tho City,Binh Thuy District,18,14,14,0,0
2022-07-20,Can Tho City,Binh Thuy District,19,12,12,0,0
2022-07-20,Can Tho City,Binh Thuy District,20,11,10,1,0
2022-07-20,Can Tho City,Binh Thuy District,21,5,4,1,0
2022-07-20,Can Tho City,Binh Thuy District,22,2,1,1,0
2022-07-20,Can Tho City,Binh Thuy District,23,2,1,1,1
2022-07-20,Can Tho City,Cai Rang District,6,2,1,1,1
2022-07-20,Can Tho City,Cai Rang District,7,3,3,0,0
2022-07-20,Can Tho City,Cai Rang District,8,10,7,3,0
2022-07-20,Can Tho City,Cai Rang District,9,14,10,4,2
2022-07-20,Can Tho City,Cai Rang District,10,11,10,1,1
2022-07-20,Can Tho City,Cai Rang District,11,19,15,4,1
2022-07-20,Can Tho City,Cai Rang District,12,16,15,1,0
2022-07-20,Can Tho City,Cai Rang District,13,15,14,1,0
2022-07-20,Can Tho City,Cai Rang District,14,12,12,0,0
2022-07-20,Can Tho City,Cai Rang District,15,9,9,0,0
2022-07-20,Can Tho City,Cai Rang District,16,15,15,0,0
2022-07-20,Can Tho City,Cai Rang District,17,3,3,0,0
2022-07-20,Can Tho City,Cai Rang District,18,11,9,2,0
2022-07-20,Can Tho City,Cai Rang District,19,13,11,2,1
2022-07-20,Can Tho City,Cai Rang District,20,2,1,1,0
2022-07-20,Can Tho City,Cai Rang District,21,5,3,2,0
2022-07-20,Can Tho City,Cai Rang District,22,1,1,0,0
2022-07-20,Can Tho City,Ninh Kieu District,0,7,2,5,3
2022-07-20,Can Tho City,Ninh Kieu District,1,1,1,0,0
2022-07-20,Can Tho City,Ninh Kieu District,2,3,0,3,3
2022-07-20,Can Tho City,Ninh Kieu District,3,1,0,1,0
2022-07-20,Can Tho City,Ninh Kieu District,5,2,2,0,0
2022-07-20,Can Tho City,Ninh Kieu District,6,31,29,2,0
2022-07-20,Can Tho City,Ninh Kieu District,7,123,112,11,0
2022-07-20,Can Tho City,Ninh Kieu District,8,217,210,7,0
2022-07-20,Can Tho City,Ninh Kieu District,9,229,222,7,0
2022-07-20,Can Tho City,Ninh Kieu District,10,522,495,27,0
2022-07-20,Can Tho City,Ninh Kieu District,11,882,823,59,7
2022-07-20,Can Tho City,Ninh Kieu District,12,676,648,28,2
2022-07-20,Can Tho City,Ninh Kieu District,13,513,497,16,0
2022-07-20,Can Tho City,Ninh Kieu District,14,408,388,20,0
2022-07-20,Can Tho City,Ninh Kieu District,15,332,322,10,0
2022-07-20,Can Tho City,Ninh Kieu District,16,401,376,25,0
2022-07-20,Can Tho City,Ninh Kieu District,17,507,479,28,0
2022-07-20,Can Tho City,Ninh Kieu District,18,524,498,26,0
2022-07-20,Can Tho City,Ninh Kieu District,19,499,471,28,1
2022-07-20,Can Tho City,Ninh Kieu District,20,351,332,19,0
2022-07-20,Can Tho City,Ninh Kieu District,21,217,190,27,1
2022-07-20,Can Tho City,Ninh Kieu District,22,39,26,13,2
2022-07-20,Can Tho City,Ninh Kieu District,23,12,8,4,0
2022-07-20,Dong Nai,Bien Hoa City,0,10,3,7,5
2022-07-20,Dong Nai,Bien Hoa City,1,9,2,7,4
2022-07-20,Dong Nai,Bien Hoa City,5,6,1,5,2
2022-07-20,Dong Nai,Bien Hoa City,6,29,26,3,1
2022-07-20,Dong Nai,Bien Hoa City,7,172,154,18,8
2022-07-20,Dong Nai,Bien Hoa City,8,270,256,14,2
2022-07-20,Dong Nai,Bien Hoa City,9,398,371,27,1
2022-07-20,Dong Nai,Bien Hoa City,10,732,673,59,9
2022-07-20,Dong Nai,Bien Hoa City,11,1073,967,106,19
2022-07-20,Dong Nai,Bien Hoa City,12,750,674,76,28
2022-07-20,Dong Nai,Bien Hoa City,13,817,744,73,19
2022-07-20,Dong Nai,Bien Hoa City,14,684,636,48,11
2022-07-20,Dong Nai,Bien Hoa City,15,562,483,79,23
2022-07-20,Dong Nai,Bien Hoa City,16,573,510,63,20
2022-07-20,Dong Nai,Bien Hoa City,17,660,593,67,21
2022-07-20,Dong Nai,Bien Hoa City,18,804,736,68,13
2022-07-20,Dong Nai,Bien Hoa City,19,724,636,88,22
2022-07-20,Dong Nai,Bien Hoa City,20,552,478,74,15
2022-07-20,Dong Nai,Bien Hoa City,21,210,179,31,6
2022-07-20,Dong Nai,Bien Hoa City,22,40,24,16,5
2022-07-20,Dong Nai,Bien Hoa City,23,26,7,19,14
2022-07-20,Dong Nai,Cam My,16,1,0,1,1
2022-07-20,Dong Nai,Long Khanh,12,1,0,1,1
2022-07-20,Dong Nai,Long Khanh,18,1,0,1,1
2022-07-20,Dong Nai,Long Khanh,19,1,0,1,1
2022-07-20,Dong Nai,Long Khanh,21,1,0,1,1
2022-07-20,Dong Nai,Long Thanh,8,1,0,1,1
2022-07-20,Dong Nai,Long Thanh,9,2,0,2,2
2022-07-20,Dong Nai,Long Thanh,13,1,0,1,1
2022-07-20,Dong Nai,Long Thanh,14,2,0,2,2
2022-07-20,Dong Nai,Long Thanh,15,1,0,1,1
2022-07-20,Dong Nai,Long Thanh,17,1,0,1,1
2022-07-20,Dong Nai,Long Thanh,18,1,0,1,1
2022-07-20,Dong Nai,Nhon trach,9,1,0,1,1
2022-07-20,Dong Nai,Nhon trach,15,1,0,1,1
2022-07-20,Dong Nai,Nhon trach,16,2,0,2,2
2022-07-20,Dong Nai,Nhon trach,18,1,0,1,1
2022-07-20,Dong Nai,Trang Bom,8,2,0,2,2
2022-07-20,Dong Nai,Trang Bom,14,1,1,0,0
2022-07-20,Dong Nai,Trang Bom,15,1,0,1,1
2022-07-20,Dong Nai,Trang Bom,19,1,0,1,1
2022-07-20,Dong Nai,Trang Bom,20,1,0,1,1
2022-07-20,Dong Nai,Vinh Cuu,13,2,0,2,2
2022-07-20,Hai Phong City,An Duong,8,3,1,2,2
2022-07-20,Hai Phong City,An Duong,9,1,1,0,0
2022-07-20,Hai Phong City,An Duong,10,12,4,8,3
2022-07-20,Hai Phong City,An Duong,11,12,6,6,3
2022-07-20,Hai Phong City,An Duong,12,5,1,4,2
2022-07-20,Hai Phong City,An Duong,13,4,2,2,1
2022-07-20,Hai Phong City,An Duong,14,4,2,2,2
2022-07-20,Hai Phong City,An Duong,15,8,3,5,4
2022-07-20,Hai Phong City,An Duong,16,5,2,3,2
2022-07-20,Hai Phong City,An Duong,17,4,1,3,2
2022-07-20,Hai Phong City,An Duong,18,4,3,1,0
2022-07-20,Hai Phong City,An Duong,19,2,0,2,1
2022-07-20,Hai Phong City,An Duong,20,1,0,1,1
2022-07-20,Hai Phong City,An Duong,21,4,1,3,3
2022-07-20,Hai Phong City,Duong Kinh District,16,1,0,1,1
2022-07-20,Hai Phong City,Hai An District,0,1,0,1,1
2022-07-20,Hai Phong City,Hai An District,1,2,1,1,0
2022-07-20,Hai Phong City,Hai An District,7,5,3,2,1
2022-07-20,Hai Phong City,Hai An District,8,16,13,3,0
2022-07-20,Hai Phong City,Hai An District,9,11,11,0,0
2022-07-20,Hai Phong City,Hai An District,10,22,21,1,0
2022-07-20,Hai Phong City,Hai An District,11,36,33,3,0
2022-07-20,Hai Phong City,Hai An District,12,28,26,2,0
2022-07-20,Hai Phong City,Hai An District,13,21,15,6,3
2022-07-20,Hai Phong City,Hai An District,14,13,11,2,0
2022-07-20,Hai Phong City,Hai An District,15,13,10,3,2
2022-07-20,Hai Phong City,Hai An District,16,16,13,3,0
2022-07-20,Hai Phong City,Hai An District,17,16,15,1,0
2022-07-20,Hai Phong City,Hai An District,18,32,19,13,0
2022-07-20,Hai Phong City,Hai An District,19,21,18,3,0
2022-07-20,Hai Phong City,Hai An District,20,9,9,0,0
2022-07-20,Hai Phong City,Hai An District,21,9,4,5,1
2022-07-20,Hai Phong City,Hai An District,22,1,0,1,1
2022-07-20,Hai Phong City,Hai An District,23,1,0,1,0
2022-07-20,Hai Phong City,Hong Bang District,6,1,1,0,0
2022-07-20,Hai Phong City,Hong Bang District,7,22,20,2,1
2022-07-20,Hai Phong City,Hong Bang District,8,29,26,3,1
2022-07-20,Hai Phong City,Hong Bang District,9,33,29,4,0
2022-07-20,Hai Phong City,Hong Bang District,10,57,50,7,0
2022-07-20,Hai Phong City,Hong Bang District,11,118,101,17,5
2022-07-20,Hai Phong City,Hong Bang District,12,65,60,5,0
2022-07-20,Hai Phong City,Hong Bang District,13,45,42,3,0
2022-07-20,Hai Phong City,Hong Bang District,14,63,50,13,4
2022-07-20,Hai Phong City,Hong Bang District,15,61,56,5,2
2022-07-20,Hai Phong City,Hong Bang District,16,53,45,8,2
2022-07-20,Hai Phong City,Hong Bang District,17,48,45,3,1
2022-07-20,Hai Phong City,Hong Bang District,18,61,54,7,2
2022-07-20,Hai Phong City,Hong Bang District,19,62,50,12,5
2022-07-20,Hai Phong City,Hong Bang District,20,31,27,4,1
2022-07-20,Hai Phong City,Hong Bang District,21,15,10,5,1
2022-07-20,Hai Phong City,Hong Bang District,22,2,1,1,0
2022-07-20,Hai Phong City,Kien An District,8,3,2,1,0
2022-07-20,Hai Phong City,Kien An District,9,10,7,3,2
2022-07-20,Hai Phong City,Kien An District,10,13,12,1,0
2022-07-20,Hai Phong City,Kien An District,11,18,12,6,6
2022-07-20,Hai Phong City,Kien An District,12,17,13,4,1
2022-07-20,Hai Phong City,Kien An District,13,9,5,4,1
2022-07-20,Hai Phong City,Kien An District,14,9,8,1,0
2022-07-20,Hai Phong City,Kien An District,15,3,1,2,1
2022-07-20,Hai Phong City,Kien An District,16,10,9,1,1
2022-07-20,Hai Phong City,Kien An District,17,4,3,1,0
2022-07-20,Hai Phong City,Kien An District,18,5,4,1,1
2022-07-20,Hai Phong City,Kien An District,19,10,9,1,1
2022-07-20,Hai Phong City,Kien An District,20,6,2,4,4
2022-07-20,Hai Phong City,Kien An District,21,8,0,8,8
2022-07-20,Hai Phong City,Le Chan District,0,4,2,2,1
2022-07-20,Hai Phong City,Le Chan District,1,2,1,1,1
2022-07-20,Hai Phong City,Le Chan District,2,1,1,0,0
2022-07-20,Hai Phong City,Le Chan District,3,1,0,1,0
2022-07-20,Hai Phong City,Le Chan District,6,7,3,4,3
2022-07-20,Hai Phong City,Le Chan District,7,44,42,2,0
2022-07-20,Hai Phong City,Le Chan District,8,80,73,7,0
2022-07-20,Hai Phong City,Le Chan District,9,96,83,13,4
2022-07-20,Hai Phong City,Le Chan District,10,178,162,16,0
2022-07-20,Hai Phong City,Le Chan District,11,370,332,38,6
2022-07-20,Hai Phong City,Le Chan District,12,256,227,29,3
2022-07-20,Hai Phong City,Le Chan District,13,161,140,21,2
2022-07-20,Hai Phong City,Le Chan District,14,161,139,22,11
2022-07-20,Hai Phong City,Le Chan District,15,209,178,31,4
2022-07-20,Hai Phong City,Le Chan District,16,166,145,21,4
2022-07-20,Hai Phong City,Le Chan District,17,190,163,27,5
2022-07-20,Hai Phong City,Le Chan District,18,255,223,32,7
2022-07-20,Hai Phong City,Le Chan District,19,216,180,36,9
2022-07-20,Hai Phong City,Le Chan District,20,155,133,22,3
2022-07-20,Hai Phong City,Le Chan District,21,77,68,9,5
2022-07-20,Hai Phong City,Le Chan District,22,12,8,4,1
2022-07-20,Hai Phong City,Le Chan District,23,2,0,2,2
2022-07-20,Hai Phong City,Ngo Quyen District,0,1,0,1,0
2022-07-20,Hai Phong City,Ngo Quyen District,3,1,1,0,0
2022-07-20,Hai Phong City,Ngo Quyen District,5,1,1,0,0
2022-07-20,Hai Phong City,Ngo Quyen District,6,2,0,2,1
2022-07-20,Hai Phong City,Ngo Quyen District,7,17,15,2,0
2022-07-20,Hai Phong City,Ngo Quyen District,8,89,80,9,1
2022-07-20,Hai Phong City,Ngo Quyen District,9,79,69,10,1
2022-07-20,Hai Phong City,Ngo Quyen District,10,138,119,19,0
2022-07-20,Hai Phong City,Ngo Quyen District,11,282,256,26,4
2022-07-20,Hai Phong City,Ngo Quyen District,12,159,138,21,3
2022-07-20,Hai Phong City,Ngo Quyen District,13,118,108,10,3
2022-07-20,Hai Phong City,Ngo Quyen District,14,159,135,24,8
2022-07-20,Hai Phong City,Ngo Quyen District,15,151,131,20,1
2022-07-20,Hai Phong City,Ngo Quyen District,16,128,112,16,4
2022-07-20,Hai Phong City,Ngo Quyen District,17,141,124,17,2
2022-07-20,Hai Phong City,Ngo Quyen District,18,163,139,24,3
2022-07-20,Hai Phong City,Ngo Quyen District,19,169,140,29,1
2022-07-20,Hai Phong City,Ngo Quyen District,20,128,104,24,3
2022-07-20,Hai Phong City,Ngo Quyen District,21,66,45,21,5
2022-07-20,Hai Phong City,Ngo Quyen District,22,7,2,5,3
2022-07-20,Hai Phong City,Ngo Quyen District,23,5,3,2,0
2022-07-20,Hai Phong City,Thuy Nguyen,10,1,0,1,1
2022-07-20,Hai Phong City,Thuy Nguyen,14,1,0,1,1
2022-07-20,Hai Phong City,Thuy Nguyen,15,2,0,2,1
2022-07-20,Hai Phong City,Thuy Nguyen,16,1,0,1,0
2022-07-20,Hai Phong City,Thuy Nguyen,17,1,1,0,0
2022-07-20,Hai Phong City,Thuy Nguyen,19,1,0,1,1
2022-07-20,Hue City,Hue City,0,7,3,4,3
2022-07-20,Hue City,Hue City,1,4,2,2,0
2022-07-20,Hue City,Hue City,2,3,1,2,2
2022-07-20,Hue City,Hue City,5,4,2,2,0
2022-07-20,Hue City,Hue City,6,62,56,6,6
2022-07-20,Hue City,Hue City,7,201,190,11,2
2022-07-20,Hue City,Hue City,8,337,304,33,0
2022-07-20,Hue City,Hue City,9,290,265,25,0
2022-07-20,Hue City,Hue City,10,455,410,45,0
2022-07-20,Hue City,Hue City,11,982,894,88,13
2022-07-20,Hue City,Hue City,12,635,581,54,3
2022-07-20,Hue City,Hue City,13,416,392,24,1
2022-07-20,Hue City,Hue City,14,444,401,43,0
2022-07-20,Hue City,Hue City,15,448,415,33,0
2022-07-20,Hue City,Hue City,16,408,386,22,0
2022-07-20,Hue City,Hue City,17,481,441,40,0
2022-07-20,Hue City,Hue City,18,562,516,46,2
2022-07-20,Hue City,Hue City,19,620,565,55,2
2022-07-20,Hue City,Hue City,20,480,409,71,11
2022-07-20,Hue City,Hue City,21,254,221,33,5
2022-07-20,Hue City,Hue City,22,46,36,10,0
2022-07-20,Hue City,Hue City,23,23,19,4,1
2022-07-20,Hue City,Huong Thuy,7,2,0,2,1
2022-07-20,Hue City,Huong Thuy,8,2,2,0,0
2022-07-20,Hue City,Huong Thuy,9,2,2,0,0
2022-07-20,Hue City,Huong Thuy,10,1,0,1,0
2022-07-20,Hue City,Huong Thuy,11,2,2,0,0
2022-07-20,Hue City,Huong Thuy,12,1,1,0,0
2022-07-20,Hue City,Huong Thuy,15,2,1,1,0
2022-07-20,Hue City,Huong Thuy,16,1,1,0,0
2022-07-20,Hue City,Huong Thuy,17,2,2,0,0
2022-07-20,Hue City,Huong Thuy,18,1,1,0,0
2022-07-20,Hue City,Huong Thuy,19,6,4,2,0
2022-07-20,Hue City,Huong Thuy,20,1,0,1,0
2022-07-20,Hue City,Huong Thuy,21,1,0,1,0
2022-07-20,Hue City,Huong Tra,9,1,1,0,0
2022-07-20,Hue City,Huong Tra,10,1,1,0,0
2022-07-20,Hue City,Huong Tra,11,1,1,0,0
2022-07-20,Hue City,Huong Tra,13,1,0,1,0
2022-07-20,Hue City,Huong Tra,18,1,0,1,0
2022-07-20,Hue City,Huong Tra,19,2,0,2,0
2022-07-20,Hue City,Phu Vang,6,1,0,1,1
2022-07-20,Hue City,Phu Vang,7,1,1,0,0
2022-07-20,Hue City,Phu Vang,8,4,4,0,0
2022-07-20,Hue City,Phu Vang,9,4,3,1,1
2022-07-20,Hue City,Phu Vang,10,2,1,1,0
2022-07-20,Hue City,Phu Vang,11,1,1,0,0
2022-07-20,Hue City,Phu Vang,12,1,1,0,0
2022-07-20,Hue City,Phu Vang,13,2,1,1,0
2022-07-20,Hue City,Phu Vang,14,3,2,1,1
2022-07-20,Hue City,Phu Vang,15,1,1,0,0
2022-07-20,Hue City,Phu Vang,16,1,1,0,0
2022-07-20,Hue City,Phu Vang,17,3,2,1,0
2022-07-20,Hue City,Phu Vang,18,2,2,0,0
2022-07-20,Hue City,Phu Vang,19,2,0,2,2
2022-07-20,Hue City,Phu Vang,20,1,1,0,0
2022-07-20,Hue City,Phu Vang,21,2,1,1,1
2022-07-20,Khanh Hoa,Dien Khanh,8,1,0,1,1
2022-07-20,Khanh Hoa,Dien Khanh,18,1,0,1,1
2022-07-20,Khanh Hoa,Dien Khanh,19,8,0,8,7
2022-07-20,Khanh Hoa,Nha Trang City,0,7,1,6,4
2022-07-20,Khanh Hoa,Nha Trang City,1,7,2,5,4
2022-07-20,Khanh Hoa,Nha Trang City,2,5,0,5,5
2022-07-20,Khanh Hoa,Nha Trang City,5,1,0,1,1
2022-07-20,Khanh Hoa,Nha Trang City,6,33,29,4,3
2022-07-20,Khanh Hoa,Nha Trang City,7,146,127,19,3
2022-07-20,Khanh Hoa,Nha Trang City,8,192,178,14,1
2022-07-20,Khanh Hoa,Nha Trang City,9,181,175,6,0
2022-07-20,Khanh Hoa,Nha Trang City,10,225,194,31,1
2022-07-20,Khanh Hoa,Nha Trang City,11,319,304,15,2
2022-07-20,Khanh Hoa,Nha Trang City,12,264,247,17,1
2022-07-20,Khanh Hoa,Nha Trang City,13,242,228,14,2
2022-07-20,Khanh Hoa,Nha Trang City,14,276,264,12,1
2022-07-20,Khanh Hoa,Nha Trang City,15,225,202,23,0
2022-07-20,Khanh Hoa,Nha Trang City,16,201,183,18,1
2022-07-20,Khanh Hoa,Nha Trang City,17,304,277,27,2
2022-07-20,Khanh Hoa,Nha Trang City,18,340,301,39,16
2022-07-20,Khanh Hoa,Nha Trang City,19,286,251,35,7
2022-07-20,Khanh Hoa,Nha Trang City,20,232,209,23,3
2022-07-20,Khanh Hoa,Nha Trang City,21,91,75,16,4
2022-07-20,Khanh Hoa,Nha Trang City,22,41,28,13,4
2022-07-20,Khanh Hoa,Nha Trang City,23,11,7,4,2
2022-07-20,Lam Dong,Da Lat City,0,10,2,8,6
2022-07-20,Lam Dong,Da Lat City,1,5,1,4,2
2022-07-20,Lam Dong,Da Lat City,2,2,0,2,2
2022-07-20,Lam Dong,Da Lat City,3,1,0,1,0
2022-07-20,Lam Dong,Da Lat City,6,16,5,11,9
2022-07-20,Lam Dong,Da Lat City,7,59,39,20,13
2022-07-20,Lam Dong,Da Lat City,8,87,76,11,7
2022-07-20,Lam Dong,Da Lat City,9,108,82,26,5
2022-07-20,Lam Dong,Da Lat City,10,97,82,15,5
2022-07-20,Lam Dong,Da Lat City,11,137,115,22,10
2022-07-20,Lam Dong,Da Lat City,12,158,130,28,10
2022-07-20,Lam Dong,Da Lat City,13,163,112,51,36
2022-07-20,Lam Dong,Da Lat City,14,127,104,23,14
2022-07-20,Lam Dong,Da Lat City,15,97,79,18,5
2022-07-20,Lam Dong,Da Lat City,16,137,94,43,22
2022-07-20,Lam Dong,Da Lat City,17,236,133,103,64
2022-07-20,Lam Dong,Da Lat City,18,298,138,160,119
2022-07-20,Lam Dong,Da Lat City,19,286,146,140,106
2022-07-20,Lam Dong,Da Lat City,20,213,110,103,70
2022-07-20,Lam Dong,Da Lat City,21,128,68,60,39
2022-07-20,Lam Dong,Da Lat City,22,36,21,15,4
2022-07-20,Lam Dong,Da Lat City,23,15,11,4,3
2022-07-20,Nghe An,Vinh City,0,4,3,1,0
2022-07-20,Nghe An,Vinh City,1,3,0,3,2
2022-07-20,Nghe An,Vinh City,3,1,0,1,0
2022-07-20,Nghe An,Vinh City,4,1,0,1,1
2022-07-20,Nghe An,Vinh City,5,1,0,1,1
2022-07-20,Nghe An,Vinh City,6,18,9,9,5
2022-07-20,Nghe An,Vinh City,7,158,135,23,2
2022-07-20,Nghe An,Vinh City,8,188,161,27,0
2022-07-20,Nghe An,Vinh City,9,163,140,23,2
2022-07-20,Nghe An,Vinh City,10,235,209,26,7
2022-07-20,Nghe An,Vinh City,11,423,370,53,8
2022-07-20,Nghe An,Vinh City,12,205,182,23,7
2022-07-20,Nghe An,Vinh City,13,144,124,20,3
2022-07-20,Nghe An,Vinh City,14,163,136,27,6
2022-07-20,Nghe An,Vinh City,15,163,135,28,6
2022-07-20,Nghe An,Vinh City,16,148,121,27,10
2022-07-20,Nghe An,Vinh City,17,216,147,69,34
2022-07-20,Nghe An,Vinh City,18,215,170,45,16
2022-07-20,Nghe An,Vinh City,19,157,127,30,6
2022-07-20,Nghe An,Vinh City,20,110,93,17,2
2022-07-20,Nghe An,Vinh City,21,77,51,26,11
2022-07-20,Nghe An,Vinh City,22,14,8,6,1
2022-07-20,Nghe An,Vinh City,23,9,4,5,2
2022-07-20,Quang Nam,Hoi An City,6,3,2,1,1
2022-07-20,Quang Nam,Hoi An City,7,12,9,3,2
2022-07-20,Quang Nam,Hoi An City,8,20,17,3,2
2022-07-20,Quang Nam,Hoi An City,9,16,12,4,1
2022-07-20,Quang Nam,Hoi An City,10,33,20,13,7
2022-07-20,Quang Nam,Hoi An City,11,55,35,20,9
2022-07-20,Quang Nam,Hoi An City,12,34,26,8,2
2022-07-20,Quang Nam,Hoi An City,13,35,30,5,2
2022-07-20,Quang Nam,Hoi An City,14,45,30,15,2
2022-07-20,Quang Nam,Hoi An City,15,53,42,11,3
2022-07-20,Quang Nam,Hoi An City,16,30,23,7,2
2022-07-20,Quang Nam,Hoi An City,17,42,37,5,1
2022-07-20,Quang Nam,Hoi An City,18,60,48,12,7
2022-07-20,Quang Nam,Hoi An City,19,42,27,15,7
2022-07-20,Quang Nam,Hoi An City,20,30,24,6,4
2022-07-20,Quang Nam,Hoi An City,21,17,5,12,6
2022-07-20,Quang Nam,Hoi An City,22,5,3,2,0
2022-07-20,Quang Ninh,Cam Pha City,8,2,0,2,2
2022-07-20,Quang Ninh,Cam Pha City,9,1,0,1,1
2022-07-20,Quang Ninh,Cam Pha City,10,2,0,2,2
2022-07-20,Quang Ninh,Cam Pha City,11,1,0,1,1
2022-07-20,Quang Ninh,Cam Pha City,12,1,0,1,1
2022-07-20,Quang Ninh,Cam Pha City,13,4,0,4,4
2022-07-20,Quang Ninh,Cam Pha City,14,1,0,1,1
2022-07-20,Quang Ninh,Ha Long City,0,2,0,2,2
2022-07-20,Quang Ninh,Ha Long City,1,4,0,4,4
2022-07-20,Quang Ninh,Ha Long City,6,3,0,3,1
2022-07-20,Quang Ninh,Ha Long City,7,34,19,15,7
2022-07-20,Quang Ninh,Ha Long City,8,63,39,24,11
2022-07-20,Quang Ninh,Ha Long City,9,48,34,14,3
2022-07-20,Quang Ninh,Ha Long City,10,69,54,15,5
2022-07-20,Quang Ninh,Ha Long City,11,131,97,34,11
2022-07-20,Quang Ninh,Ha Long City,12,96,65,31,12
2022-07-20,Quang Ninh,Ha Long City,13,94,58,36,19
2022-07-20,Quang Ninh,Ha Long City,14,111,61,50,29
2022-07-20,Quang Ninh,Ha Long City,15,73,53,20,9
2022-07-20,Quang Ninh,Ha Long City,16,58,48,10,3
2022-07-20,Quang Ninh,Ha Long City,17,46,34,12,4
2022-07-20,Quang Ninh,Ha Long City,18,72,53,19,5
2022-07-20,Quang Ninh,Ha Long City,19,82,60,22,8
2022-07-20,Quang Ninh,Ha Long City,20,54,39,15,9
2022-07-20,Quang Ninh,Ha Long City,21,45,17,28,16
2022-07-20,Quang Ninh,Ha Long City,22,15,9,6,1
2022-07-20,Quang Ninh,Ha Long City,23,2,0,2,2
2022-07-20,Thai Nguyen,Dong Hy,20,3,1,2,1
2022-07-20,Thai Nguyen,Thai Nguyen City,0,2,1,1,0
2022-07-20,Thai Nguyen,Thai Nguyen City,4,1,0,1,1
2022-07-20,Thai Nguyen,Thai Nguyen City,6,17,8,9,7
2022-07-20,Thai Nguyen,Thai Nguyen City,7,113,105,8,0
2022-07-20,Thai Nguyen,Thai Nguyen City,8,140,128,12,0
2022-07-20,Thai Nguyen,Thai Nguyen City,9,130,119,11,0
2022-07-20,Thai Nguyen,Thai Nguyen City,10,176,160,16,3
2022-07-20,Thai Nguyen,Thai Nguyen City,11,387,356,31,0
2022-07-20,Thai Nguyen,Thai Nguyen City,12,246,223,23,2
2022-07-20,Thai Nguyen,Thai Nguyen City,13,167,144,23,2
2022-07-20,Thai Nguyen,Thai Nguyen City,14,155,138,17,1
2022-07-20,Thai Nguyen,Thai Nguyen City,15,155,144,11,2
2022-07-20,Thai Nguyen,Thai Nguyen City,16,151,139,12,2
2022-07-20,Thai Nguyen,Thai Nguyen City,17,154,142,12,2
2022-07-20,Thai Nguyen,Thai Nguyen City,18,242,183,59,38
2022-07-20,Thai Nguyen,Thai Nguyen City,19,323,274,49,21
2022-07-20,Thai Nguyen,Thai Nguyen City,20,193,168,25,2
2022-07-20,Thai Nguyen,Thai Nguyen City,21,116,98,18,0
2022-07-20,Thai Nguyen,Thai Nguyen City,22,19,13,6,0
2022-07-20,Thai Nguyen,Thai Nguyen City,23,7,5,2,1
2022-07-20,Vung Tau,Ba Ria City,7,4,0,4,4
2022-07-20,Vung Tau,Ba Ria City,8,6,4,2,2
2022-07-20,Vung Tau,Ba Ria City,9,4,4,0,0
2022-07-20,Vung Tau,Ba Ria City,10,4,4,0,0
2022-07-20,Vung Tau,Ba Ria City,11,5,4,1,0
2022-07-20,Vung Tau,Ba Ria City,12,6,5,1,1
2022-07-20,Vung Tau,Ba Ria City,13,8,8,0,0
2022-07-20,Vung Tau,Ba Ria City,14,2,2,0,0
2022-07-20,Vung Tau,Ba Ria City,15,5,2,3,3
2022-07-20,Vung Tau,Ba Ria City,16,3,2,1,1
2022-07-20,Vung Tau,Ba Ria City,17,10,4,6,6
2022-07-20,Vung Tau,Ba Ria City,18,5,3,2,1
2022-07-20,Vung Tau,Ba Ria City,19,9,3,6,4
2022-07-20,Vung Tau,Ba Ria City,20,5,0,5,5
2022-07-20,Vung Tau,Ba Ria City,21,1,0,1,1
2022-07-20,Vung Tau,Ba Ria City,22,3,0,3,1
2022-07-20,Vung Tau,Chau Duc,12,1,0,1,1
2022-07-20,Vung Tau,Long Son,11,2,2,0,0
2022-07-20,Vung Tau,Long Son,16,1,0,1,1
2022-07-20,Vung Tau,Long Son,18,2,1,1,1
2022-07-20,Vung Tau,Tan Thanh,11,1,0,1,1
2022-07-20,Vung Tau,Vung Tau City,0,3,2,1,1
2022-07-20,Vung Tau,Vung Tau City,1,2,0,2,1
2022-07-20,Vung Tau,Vung Tau City,3,1,1,0,0
2022-07-20,Vung Tau,Vung Tau City,4,1,0,1,1
2022-07-20,Vung Tau,Vung Tau City,5,4,2,2,1
2022-07-20,Vung Tau,Vung Tau City,6,34,28,6,3
2022-07-20,Vung Tau,Vung Tau City,7,125,112,13,8
2022-07-20,Vung Tau,Vung Tau City,8,164,156,8,3
2022-07-20,Vung Tau,Vung Tau City,9,166,140,26,12
2022-07-20,Vung Tau,Vung Tau City,10,203,185,18,6
2022-07-20,Vung Tau,Vung Tau City,11,463,326,137,96
2022-07-20,Vung Tau,Vung Tau City,12,414,295,119,85
2022-07-20,Vung Tau,Vung Tau City,13,301,254,47,29
2022-07-20,Vung Tau,Vung Tau City,14,259,222,37,18
2022-07-20,Vung Tau,Vung Tau City,15,269,212,57,36
2022-07-20,Vung Tau,Vung Tau City,16,242,209,33,11
2022-07-20,Vung Tau,Vung Tau City,17,302,251,51,16
2022-07-20,Vung Tau,Vung Tau City,18,330,279,51,19
2022-07-20,Vung Tau,Vung Tau City,19,279,243,36,9
2022-07-20,Vung Tau,Vung Tau City,20,182,157,25,3
2022-07-20,Vung Tau,Vung Tau City,21,92,71,21,7
2022-07-20,Vung Tau,Vung Tau City,22,31,25,6,3
2022-07-20,Vung Tau,Vung Tau City,23,18,10,8,2
2022-07-21,Bac Ninh,Bác Ninh City,0,8,6,2,1
2022-07-21,Bac Ninh,Bác Ninh City,1,2,2,0,0
2022-07-21,Bac Ninh,Bác Ninh City,2,3,1,2,2
2022-07-21,Bac Ninh,Bác Ninh City,5,4,0,4,3
2022-07-21,Bac Ninh,Bác Ninh City,6,35,17,18,13
2022-07-21,Bac Ninh,Bác Ninh City,7,71,65,6,0
2022-07-21,Bac Ninh,Bác Ninh City,8,151,138,13,0
2022-07-21,Bac Ninh,Bác Ninh City,9,116,106,10,0
2022-07-21,Bac Ninh,Bác Ninh City,10,174,145,29,11
2022-07-21,Bac Ninh,Bác Ninh City,11,335,311,24,3
2022-07-21,Bac Ninh,Bác Ninh City,12,196,182,14,0
2022-07-21,Bac Ninh,Bác Ninh City,13,143,129,14,0
2022-07-21,Bac Ninh,Bác Ninh City,14,152,133,19,0
2022-07-21,Bac Ninh,Bác Ninh City,15,147,124,23,0
2022-07-21,Bac Ninh,Bác Ninh City,16,109,101,8,0
2022-07-21,Bac Ninh,Bác Ninh City,17,149,128,21,1
2022-07-21,Bac Ninh,Bác Ninh City,18,165,154,11,0
2022-07-21,Bac Ninh,Bác Ninh City,19,184,166,18,0
2022-07-21,Bac Ninh,Bác Ninh City,20,167,147,20,1
2022-07-21,Bac Ninh,Bác Ninh City,21,78,66,12,1
2022-07-21,Bac Ninh,Bác Ninh City,22,20,16,4,0
2022-07-21,Bac Ninh,Bác Ninh City,23,5,5,0,0
2022-07-21,Bac Ninh,Que Vo,8,1,0,1,1
2022-07-21,Bac Ninh,Que Vo,9,2,0,2,2
2022-07-21,Bac Ninh,Que Vo,10,1,1,0,0
2022-07-21,Bac Ninh,Que Vo,13,1,0,1,1
2022-07-21,Bac Ninh,Que Vo,16,1,0,1,1
2022-07-21,Bac Ninh,Tien Du,10,1,0,1,1
2022-07-21,Bac Ninh,Tien Du,11,1,0,1,1
2022-07-21,Bac Ninh,Tien Du,15,4,0,4,2
2022-07-21,Bac Ninh,Tien Du,16,4,0,4,4
2022-07-21,Bac Ninh,Tien Du,17,2,0,2,2
2022-07-21,Bac Ninh,Tien Du,20,1,0,1,0
2022-07-21,Bac Ninh,Tu Son,9,1,0,1,1
2022-07-21,Bac Ninh,Tu Son,10,4,1,3,3
2022-07-21,Bac Ninh,Tu Son,11,1,0,1,1
2022-07-21,Bac Ninh,Tu Son,12,4,0,4,4
2022-07-21,Bac Ninh,Tu Son,13,1,0,1,1
2022-07-21,Bac Ninh,Tu Son,14,5,0,5,3
2022-07-21,Bac Ninh,Tu Son,15,3,0,3,2
2022-07-21,Bac Ninh,Tu Son,17,4,0,4,2
2022-07-21,Bac Ninh,Tu Son,18,1,0,1,1
2022-07-21,Bac Ninh,Tu Son,21,1,0,1,1
2022-07-21,Bac Ninh,Yen Phong,15,1,0,1,1
2022-07-21,Bac Ninh,Yen Phong,18,3,0,3,3
2022-07-21,Bac Ninh,Yen Phong,19,1,0,1,1
2022-07-21,Binh Duong,Ben Cat,9,1,0,1,0
2022-07-21,Binh Duong,Ben Cat,12,2,0,2,2
2022-07-21,Binh Duong,Ben Cat,13,3,0,3,3
2022-07-21,Binh Duong,Ben Cat,16,1,0,1,1
2022-07-21,Binh Duong,Ben Cat,17,1,0,1,1
2022-07-21,Binh Duong,Ben Cat,18,2,0,2,2
2022-07-21,Binh Duong,Ben Cat,20,3,0,3,3
2022-07-21,Binh Duong,Di An,0,1,0,1,1
2022-07-21,Binh Duong,Di An,1,1,0,1,1
2022-07-21,Binh Duong,Di An,7,11,1,10,10
2022-07-21,Binh Duong,Di An,8,26,9,17,14
2022-07-21,Binh Duong,Di An,9,25,20,5,2
2022-07-21,Binh Duong,Di An,10,29,23,6,4
2022-07-21,Binh Duong,Di An,11,36,29,7,3
2022-07-21,Binh Duong,Di An,12,37,25,12,9
2022-07-21,Binh Duong,Di An,13,39,29,10,7
2022-07-21,Binh Duong,Di An,14,22,17,5,2
2022-07-21,Binh Duong,Di An,15,32,28,4,1
2022-07-21,Binh Duong,Di An,16,19,17,2,1
2022-07-21,Binh Duong,Di An,17,26,23,3,1
2022-07-21,Binh Duong,Di An,18,23,21,2,0
2022-07-21,Binh Duong,Di An,19,32,25,7,3
2022-07-21,Binh Duong,Di An,20,24,15,9,5
2022-07-21,Binh Duong,Di An,21,18,9,9,5
2022-07-21,Binh Duong,Di An,22,6,1,5,4
2022-07-21,Binh Duong,Di An,23,2,0,2,2
2022-07-21,Binh Duong,Tan Uyen,8,2,0,2,2
2022-07-21,Binh Duong,Tan Uyen,9,1,0,1,1
2022-07-21,Binh Duong,Tan Uyen,10,4,3,1,0
2022-07-21,Binh Duong,Tan Uyen,11,6,3,3,3
2022-07-21,Binh Duong,Tan Uyen,12,2,2,0,0
2022-07-21,Binh Duong,Tan Uyen,13,5,4,1,1
2022-07-21,Binh Duong,Tan Uyen,14,1,1,0,0
2022-07-21,Binh Duong,Tan Uyen,15,4,1,3,3
2022-07-21,Binh Duong,Tan Uyen,16,2,1,1,1
2022-07-21,Binh Duong,Tan Uyen,17,2,0,2,2
2022-07-21,Binh Duong,Tan Uyen,18,1,1,0,0
2022-07-21,Binh Duong,Tan Uyen,20,1,0,1,0
2022-07-21,Binh Duong,Thu Dau Mot Town,0,2,2,0,0
2022-07-21,Binh Duong,Thu Dau Mot Town,1,2,1,1,0
2022-07-21,Binh Duong,Thu Dau Mot Town,2,2,1,1,1
2022-07-21,Binh Duong,Thu Dau Mot Town,5,6,4,2,1
2022-07-21,Binh Duong,Thu Dau Mot Town,6,38,30,8,4
2022-07-21,Binh Duong,Thu Dau Mot Town,7,114,108,6,1
2022-07-21,Binh Duong,Thu Dau Mot Town,8,210,200,10,0
2022-07-21,Binh Duong,Thu Dau Mot Town,9,251,234,17,1
2022-07-21,Binh Duong,Thu Dau Mot Town,10,401,372,29,2
2022-07-21,Binh Duong,Thu Dau Mot Town,11,602,549,53,13
2022-07-21,Binh Duong,Thu Dau Mot Town,12,435,402,33,8
2022-07-21,Binh Duong,Thu Dau Mot Town,13,422,394,28,6
2022-07-21,Binh Duong,Thu Dau Mot Town,14,338,313,25,3
2022-07-21,Binh Duong,Thu Dau Mot Town,15,297,278,19,2
2022-07-21,Binh Duong,Thu Dau Mot Town,16,310,282,28,8
2022-07-21,Binh Duong,Thu Dau Mot Town,17,362,327,35,9
2022-07-21,Binh Duong,Thu Dau Mot Town,18,387,358,29,8
2022-07-21,Binh Duong,Thu Dau Mot Town,19,405,374,31,6
2022-07-21,Binh Duong,Thu Dau Mot Town,20,279,257,22,3
2022-07-21,Binh Duong,Thu Dau Mot Town,21,110,94,16,4
2022-07-21,Binh Duong,Thu Dau Mot Town,22,30,22,8,1
2022-07-21,Binh Duong,Thu Dau Mot Town,23,9,7,2,1
2022-07-21,Binh Duong,Thuan An,0,1,0,1,0
2022-07-21,Binh Duong,Thuan An,4,1,0,1,1
2022-07-21,Binh Duong,Thuan An,5,1,0,1,0
2022-07-21,Binh Duong,Thuan An,6,1,1,0,0
2022-07-21,Binh Duong,Thuan An,7,12,6,6,4
2022-07-21,Binh Duong,Thuan An,8,18,11,7,4
2022-07-21,Binh Duong,Thuan An,9,57,40,17,12
2022-07-21,Binh Duong,Thuan An,10,86,66,20,12
2022-07-21,Binh Duong,Thuan An,11,94,73,21,10
2022-07-21,Binh Duong,Thuan An,12,69,50,19,12
2022-07-21,Binh Duong,Thuan An,13,74,50,24,15
2022-07-21,Binh Duong,Thuan An,14,70,53,17,4
2022-07-21,Binh Duong,Thuan An,15,65,49,16,11
2022-07-21,Binh Duong,Thuan An,16,42,33,9,7
2022-07-21,Binh Duong,Thuan An,17,49,37,12,7
2022-07-21,Binh Duong,Thuan An,18,50,43,7,4
2022-07-21,Binh Duong,Thuan An,19,51,47,4,2
2022-07-21,Binh Duong,Thuan An,20,46,29,17,10
2022-07-21,Binh Duong,Thuan An,21,24,13,11,7
2022-07-21,Binh Duong,Thuan An,22,4,0,4,3
2022-07-21,Binh Duong,Thuan An,23,3,0,3,1
2022-07-21,Can Tho City,Binh Thuy District,6,1,0,1,0
2022-07-21,Can Tho City,Binh Thuy District,7,4,4,0,0
2022-07-21,Can Tho City,Binh Thuy District,8,3,2,1,0
2022-07-21,Can Tho City,Binh Thuy District,9,8,6,2,0
2022-07-21,Can Tho City,Binh Thuy District,10,14,13,1,1
2022-07-21,Can Tho City,Binh Thuy District,11,17,14,3,1
2022-07-21,Can Tho City,Binh Thuy District,12,11,10,1,0
2022-07-21,Can Tho City,Binh Thuy District,13,14,14,0,0
2022-07-21,Can Tho City,Binh Thuy District,14,9,9,0,0
2022-07-21,Can Tho City,Binh Thuy District,15,20,18,2,0
2022-07-21,Can Tho City,Binh Thuy District,16,11,10,1,1
2022-07-21,Can Tho City,Binh Thuy District,17,11,10,1,0
2022-07-21,Can Tho City,Binh Thuy District,18,16,14,2,0
2022-07-21,Can Tho City,Binh Thuy District,19,10,10,0,0
2022-07-21,Can Tho City,Binh Thuy District,20,11,8,3,0
2022-07-21,Can Tho City,Binh Thuy District,21,7,5,2,1
2022-07-21,Can Tho City,Binh Thuy District,22,1,0,1,1
2022-07-21,Can Tho City,Cai Rang District,6,2,1,1,0
2022-07-21,Can Tho City,Cai Rang District,7,3,2,1,1
2022-07-21,Can Tho City,Cai Rang District,8,3,2,1,1
2022-07-21,Can Tho City,Cai Rang District,9,6,6,0,0
2022-07-21,Can Tho City,Cai Rang District,10,12,11,1,0
2022-07-21,Can Tho City,Cai Rang District,11,16,15,1,0
2022-07-21,Can Tho City,Cai Rang District,12,13,13,0,0
2022-07-21,Can Tho City,Cai Rang District,13,14,14,0,0
2022-07-21,Can Tho City,Cai Rang District,14,6,6,0,0
2022-07-21,Can Tho City,Cai Rang District,15,9,7,2,0
2022-07-21,Can Tho City,Cai Rang District,16,6,6,0,0
2022-07-21,Can Tho City,Cai Rang District,17,11,10,1,0
2022-07-21,Can Tho City,Cai Rang District,18,11,10,1,0
2022-07-21,Can Tho City,Cai Rang District,19,13,11,2,0
2022-07-21,Can Tho City,Cai Rang District,20,13,11,2,1
2022-07-21,Can Tho City,Cai Rang District,21,3,2,1,1
2022-07-21,Can Tho City,Ninh Kieu District,0,7,4,3,1
2022-07-21,Can Tho City,Ninh Kieu District,1,9,2,7,7
2022-07-21,Can Tho City,Ninh Kieu District,2,4,0,4,3
2022-07-21,Can Tho City,Ninh Kieu District,3,1,0,1,1
2022-07-21,Can Tho City,Ninh Kieu District,5,7,6,1,1
2022-07-21,Can Tho City,Ninh Kieu District,6,43,36,7,5
2022-07-21,Can Tho City,Ninh Kieu District,7,120,106,14,2
2022-07-21,Can Tho City,Ninh Kieu District,8,251,237,14,0
2022-07-21,Can Tho City,Ninh Kieu District,9,253,242,11,0
2022-07-21,Can Tho City,Ninh Kieu District,10,429,411,18,0
2022-07-21,Can Tho City,Ninh Kieu District,11,760,711,49,5
2022-07-21,Can Tho City,Ninh Kieu District,12,519,494,25,0
2022-07-21,Can Tho City,Ninh Kieu District,13,455,429,26,0
2022-07-21,Can Tho City,Ninh Kieu District,14,367,350,17,0
2022-07-21,Can Tho City,Ninh Kieu District,15,310,295,15,0
2022-07-21,Can Tho City,Ninh Kieu District,16,355,334,21,0
2022-07-21,Can Tho City,Ninh Kieu District,17,474,442,32,0
2022-07-21,Can Tho City,Ninh Kieu District,18,467,439,28,0
2022-07-21,Can Tho City,Ninh Kieu District,19,412,375,37,0
2022-07-21,Can Tho City,Ninh Kieu District,20,354,338,16,0
2022-07-21,Can Tho City,Ninh Kieu District,21,194,168,26,0
2022-07-21,Can Tho City,Ninh Kieu District,22,37,36,1,0
2022-07-21,Can Tho City,Ninh Kieu District,23,13,12,1,0
2022-07-21,Dong Nai,Bien Hoa City,0,11,2,9,7
2022-07-21,Dong Nai,Bien Hoa City,1,12,2,10,8
2022-07-21,Dong Nai,Bien Hoa City,2,4,1,3,3
2022-07-21,Dong Nai,Bien Hoa City,5,3,2,1,1
2022-07-21,Dong Nai,Bien Hoa City,6,42,29,13,7
2022-07-21,Dong Nai,Bien Hoa City,7,174,158,16,5
2022-07-21,Dong Nai,Bien Hoa City,8,327,290,37,2
2022-07-21,Dong Nai,Bien Hoa City,9,405,369,36,3
2022-07-21,Dong Nai,Bien Hoa City,10,735,676,59,9
2022-07-21,Dong Nai,Bien Hoa City,11,1093,1017,76,13
2022-07-21,Dong Nai,Bien Hoa City,12,798,752,46,5
2022-07-21,Dong Nai,Bien Hoa City,13,767,720,47,0
2022-07-21,Dong Nai,Bien Hoa City,14,646,601,45,4
2022-07-21,Dong Nai,Bien Hoa City,15,433,415,18,1
2022-07-21,Dong Nai,Bien Hoa City,16,494,439,55,3
2022-07-21,Dong Nai,Bien Hoa City,17,605,561,44,4
2022-07-21,Dong Nai,Bien Hoa City,18,651,610,41,2
2022-07-21,Dong Nai,Bien Hoa City,19,662,592,70,21
2022-07-21,Dong Nai,Bien Hoa City,20,557,463,94,27
2022-07-21,Dong Nai,Bien Hoa City,21,220,174,46,19
2022-07-21,Dong Nai,Bien Hoa City,22,46,30,16,5
2022-07-21,Dong Nai,Bien Hoa City,23,20,8,12,8
2022-07-21,Dong Nai,Dinh Quan,14,1,0,1,1
2022-07-21,Dong Nai,Long Khanh,12,1,0,1,0
2022-07-21,Dong Nai,Long Khanh,13,2,0,2,1
2022-07-21,Dong Nai,Long Khanh,15,1,0,1,1
2022-07-21,Dong Nai,Long Thanh,10,2,0,2,2
2022-07-21,Dong Nai,Long Thanh,11,2,0,2,2
2022-07-21,Dong Nai,Long Thanh,13,2,0,2,2
2022-07-21,Dong Nai,Long Thanh,14,2,0,2,2
2022-07-21,Dong Nai,Long Thanh,15,5,0,5,3
2022-07-21,Dong Nai,Nhon trach,9,1,0,1,1
2022-07-21,Dong Nai,Nhon trach,12,1,0,1,0
2022-07-21,Dong Nai,Nhon trach,17,1,0,1,1
2022-07-21,Dong Nai,Nhon trach,20,2,0,2,2
2022-07-21,Dong Nai,Nhon trach,21,2,0,2,2
2022-07-21,Dong Nai,Trang Bom,10,1,0,1,1
2022-07-21,Dong Nai,Trang Bom,12,1,1,0,0
2022-07-21,Dong Nai,Trang Bom,13,1,0,1,1
2022-07-21,Dong Nai,Trang Bom,15,4,1,3,0
2022-07-21,Dong Nai,Trang Bom,16,1,0,1,0
2022-07-21,Dong Nai,Trang Bom,21,1,0,1,1
2022-07-21,Dong Nai,Vinh Cuu,11,1,0,1,1
2022-07-21,Dong Nai,Vinh Cuu,19,1,0,1,1
2022-07-21,Hai Phong City,An Duong,8,2,1,1,1
2022-07-21,Hai Phong City,An Duong,10,8,5,3,2
2022-07-21,Hai Phong City,An Duong,11,5,4,1,0
2022-07-21,Hai Phong City,An Duong,12,1,0,1,1
2022-07-21,Hai Phong City,An Duong,13,7,3,4,2
2022-07-21,Hai Phong City,An Duong,14,5,1,4,3
2022-07-21,Hai Phong City,An Duong,15,6,4,2,1
2022-07-21,Hai Phong City,An Duong,16,5,4,1,1
2022-07-21,Hai Phong City,An Duong,17,2,0,2,2
2022-07-21,Hai Phong City,An Duong,18,2,1,1,0
2022-07-21,Hai Phong City,An Duong,19,2,2,0,0
2022-07-21,Hai Phong City,An Duong,20,2,1,1,0
2022-07-21,Hai Phong City,An Duong,22,1,0,1,1
2022-07-21,Hai Phong City,Duong Kinh District,17,1,0,1,1
2022-07-21,Hai Phong City,Hai An District,6,4,3,1,0
2022-07-21,Hai Phong City,Hai An District,7,6,5,1,0
2022-07-21,Hai Phong City,Hai An District,8,19,17,2,0
2022-07-21,Hai Phong City,Hai An District,9,16,12,4,2
2022-07-21,Hai Phong City,Hai An District,10,37,34,3,2
2022-07-21,Hai Phong City,Hai An District,11,56,52,4,2
2022-07-21,Hai Phong City,Hai An District,12,28,22,6,1
2022-07-21,Hai Phong City,Hai An District,13,20,13,7,4
2022-07-21,Hai Phong City,Hai An District,14,21,14,7,3
2022-07-21,Hai Phong City,Hai An District,15,22,17,5,1
2022-07-21,Hai Phong City,Hai An District,16,21,18,3,0
2022-07-21,Hai Phong City,Hai An District,17,23,18,5,0
2022-07-21,Hai Phong City,Hai An District,18,25,21,4,0
2022-07-21,Hai Phong City,Hai An District,19,18,17,1,1
2022-07-21,Hai Phong City,Hai An District,20,21,16,5,0
2022-07-21,Hai Phong City,Hai An District,21,5,3,2,0
2022-07-21,Hai Phong City,Hai An District,22,8,5,3,1
2022-07-21,Hai Phong City,Hong Bang District,2,2,0,2,0
2022-07-21,Hai Phong City,Hong Bang District,3,1,1,0,0
2022-07-21,Hai Phong City,Hong Bang District,6,2,2,0,0
2022-07-21,Hai Phong City,Hong Bang District,7,23,21,2,0
2022-07-21,Hai Phong City,Hong Bang District,8,39,34,5,0
2022-07-21,Hai Phong City,Hong Bang District,9,33,31,2,0
2022-07-21,Hai Phong City,Hong Bang District,10,71,64,7,1
2022-07-21,Hai Phong City,Hong Bang District,11,113,93,20,3
2022-07-21,Hai Phong City,Hong Bang District,12,56,50,6,0
2022-07-21,Hai Phong City,Hong Bang District,13,43,41,2,1
2022-07-21,Hai Phong City,Hong Bang District,14,44,38,6,0
2022-07-21,Hai Phong City,Hong Bang District,15,67,55,12,4
2022-07-21,Hai Phong City,Hong Bang District,16,33,31,2,0
2022-07-21,Hai Phong City,Hong Bang District,17,46,43,3,1
2022-07-21,Hai Phong City,Hong Bang District,18,49,43,6,0
2022-07-21,Hai Phong City,Hong Bang District,19,46,44,2,0
2022-07-21,Hai Phong City,Hong Bang District,20,27,25,2,0
2022-07-21,Hai Phong City,Hong Bang District,21,18,15,3,0
2022-07-21,Hai Phong City,Hong Bang District,22,5,2,3,0
2022-07-21,Hai Phong City,Kien An District,6,3,0,3,2
2022-07-21,Hai Phong City,Kien An District,7,2,1,1,1
2022-07-21,Hai Phong City,Kien An District,8,3,2,1,0
2022-07-21,Hai Phong City,Kien An District,9,8,6,2,1
2022-07-21,Hai Phong City,Kien An District,10,12,8,4,4
2022-07-21,Hai Phong City,Kien An District,11,14,13,1,1
2022-07-21,Hai Phong City,Kien An District,12,8,7,1,0
2022-07-21,Hai Phong City,Kien An District,13,7,5,2,0
2022-07-21,Hai Phong City,Kien An District,14,5,4,1,0
2022-07-21,Hai Phong City,Kien An District,15,8,8,0,0
2022-07-21,Hai Phong City,Kien An District,16,8,4,4,3
2022-07-21,Hai Phong City,Kien An District,17,2,0,2,0
2022-07-21,Hai Phong City,Kien An District,18,9,6,3,0
2022-07-21,Hai Phong City,Kien An District,19,9,7,2,2
2022-07-21,Hai Phong City,Kien An District,20,1,1,0,0
2022-07-21,Hai Phong City,Kien An District,21,4,1,3,1
2022-07-21,Hai Phong City,Le Chan District,0,1,0,1,1
2022-07-21,Hai Phong City,Le Chan District,2,1,1,0,0
2022-07-21,Hai Phong City,Le Chan District,5,1,1,0,0
2022-07-21,Hai Phong City,Le Chan District,6,17,7,10,7
2022-07-21,Hai Phong City,Le Chan District,7,55,43,12,3
2022-07-21,Hai Phong City,Le Chan District,8,86,76,10,2
2022-07-21,Hai Phong City,Le Chan District,9,91,69,22,2
2022-07-21,Hai Phong City,Le Chan District,10,211,186,25,6
2022-07-21,Hai Phong City,Le Chan District,11,347,308,39,10
2022-07-21,Hai Phong City,Le Chan District,12,225,212,13,2
2022-07-21,Hai Phong City,Le Chan District,13,157,141,16,0
2022-07-21,Hai Phong City,Le Chan District,14,150,133,17,6
2022-07-21,Hai Phong City,Le Chan District,15,174,150,24,4
2022-07-21,Hai Phong City,Le Chan District,16,176,157,19,3
2022-07-21,Hai Phong City,Le Chan District,17,171,150,21,4
2022-07-21,Hai Phong City,Le Chan District,18,220,191,29,4
2022-07-21,Hai Phong City,Le Chan District,19,203,172,31,8
2022-07-21,Hai Phong City,Le Chan District,20,141,119,22,4
2022-07-21,Hai Phong City,Le Chan District,21,98,76,22,6
2022-07-21,Hai Phong City,Le Chan District,22,13,7,6,0
2022-07-21,Hai Phong City,Le Chan District,23,12,1,11,5
2022-07-21,Hai Phong City,Ngo Quyen District,0,1,1,0,0
2022-07-21,Hai Phong City,Ngo Quyen District,6,4,1,3,0
2022-07-21,Hai Phong City,Ngo Quyen District,7,21,18,3,0
2022-07-21,Hai Phong City,Ngo Quyen District,8,92,83,9,1
2022-07-21,Hai Phong City,Ngo Quyen District,9,85,72,13,1
2022-07-21,Hai Phong City,Ngo Quyen District,10,140,126,14,3
2022-07-21,Hai Phong City,Ngo Quyen District,11,239,219,20,6
2022-07-21,Hai Phong City,Ngo Quyen District,12,176,162,14,6
2022-07-21,Hai Phong City,Ngo Quyen District,13,112,99,13,3
2022-07-21,Hai Phong City,Ngo Quyen District,14,126,117,9,3
2022-07-21,Hai Phong City,Ngo Quyen District,15,158,137,21,0
2022-07-21,Hai Phong City,Ngo Quyen District,16,130,115,15,3
2022-07-21,Hai Phong City,Ngo Quyen District,17,129,107,22,3
2022-07-21,Hai Phong City,Ngo Quyen District,18,174,160,14,3
2022-07-21,Hai Phong City,Ngo Quyen District,19,151,138,13,1
2022-07-21,Hai Phong City,Ngo Quyen District,20,121,105,16,4
2022-07-21,Hai Phong City,Ngo Quyen District,21,62,48,14,1
2022-07-21,Hai Phong City,Ngo Quyen District,22,9,6,3,0
2022-07-21,Hai Phong City,Ngo Quyen District,23,2,1,1,1
2022-07-21,Hai Phong City,Thuy Nguyen,10,1,0,1,0
2022-07-21,Hai Phong City,Thuy Nguyen,13,2,0,2,2
2022-07-21,Hai Phong City,Thuy Nguyen,14,1,0,1,0
2022-07-21,Hai Phong City,Thuy Nguyen,16,2,0,2,2
2022-07-21,Hai Phong City,Thuy Nguyen,17,1,0,1,1
2022-07-21,Hue City,Hue City,0,11,9,2,1
2022-07-21,Hue City,Hue City,1,6,1,5,3
2022-07-21,Hue City,Hue City,2,4,0,4,4
2022-07-21,Hue City,Hue City,3,1,1,0,0
2022-07-21,Hue City,Hue City,5,2,2,0,0
2022-07-21,Hue City,Hue City,6,59,53,6,1
2022-07-21,Hue City,Hue City,7,195,172,23,3
2022-07-21,Hue City,Hue City,8,356,320,36,0
2022-07-21,Hue City,Hue City,9,311,278,33,1
2022-07-21,Hue City,Hue City,10,451,405,46,0
2022-07-21,Hue City,Hue City,11,937,863,74,8
2022-07-21,Hue City,Hue City,12,625,570,55,1
2022-07-21,Hue City,Hue City,13,356,328,28,1
2022-07-21,Hue City,Hue City,14,443,394,49,1
2022-07-21,Hue City,Hue City,15,496,447,49,13
2022-07-21,Hue City,Hue City,16,426,392,34,2
2022-07-21,Hue City,Hue City,17,521,472,49,4
2022-07-21,Hue City,Hue City,18,520,468,52,6
2022-07-21,Hue City,Hue City,19,589,532,57,4
2022-07-21,Hue City,Hue City,20,556,473,83,20
2022-07-21,Hue City,Hue City,21,308,248,60,10
2022-07-21,Hue City,Hue City,22,59,44,15,0
2022-07-21,Hue City,Hue City,23,26,22,4,0
2022-07-21,Hue City,Huong Thuy,8,1,1,0,0
2022-07-21,Hue City,Huong Thuy,10,3,3,0,0
2022-07-21,Hue City,Huong Thuy,12,3,3,0,0
2022-07-21,Hue City,Huong Thuy,13,2,0,2,2
2022-07-21,Hue City,Huong Thuy,14,2,2,0,0
2022-07-21,Hue City,Huong Thuy,15,2,2,0,0
2022-07-21,Hue City,Huong Thuy,16,2,2,0,0
2022-07-21,Hue City,Huong Thuy,17,1,1,0,0
2022-07-21,Hue City,Huong Thuy,18,1,1,0,0
2022-07-21,Hue City,Huong Thuy,19,1,1,0,0
2022-07-21,Hue City,Huong Thuy,20,1,0,1,0
2022-07-21,Hue City,Huong Thuy,21,1,0,1,1
2022-07-21,Hue City,Huong Tra,9,1,1,0,0
2022-07-21,Hue City,Huong Tra,11,1,1,0,0
2022-07-21,Hue City,Huong Tra,20,1,0,1,0
2022-07-21,Hue City,Huong Tra,21,1,0,1,1
2022-07-21,Hue City,Phu Vang,7,1,1,0,0
2022-07-21,Hue City,Phu Vang,8,3,2,1,1
2022-07-21,Hue City,Phu Vang,9,1,1,0,0
2022-07-21,Hue City,Phu Vang,10,2,1,1,0
2022-07-21,Hue City,Phu Vang,11,1,1,0,0
2022-07-21,Hue City,Phu Vang,12,3,3,0,0
2022-07-21,Hue City,Phu Vang,13,4,4,0,0
2022-07-21,Hue City,Phu Vang,14,6,6,0,0
2022-07-21,Hue City,Phu Vang,15,1,1,0,0
2022-07-21,Hue City,Phu Vang,16,2,2,0,0
2022-07-21,Hue City,Phu Vang,17,2,2,0,0
2022-07-21,Hue City,Phu Vang,18,1,1,0,0
2022-07-21,Hue City,Phu Vang,19,2,1,1,0
2022-07-21,Hue City,Phu Vang,20,2,2,0,0
2022-07-21,Hue City,Phu Vang,21,1,0,1,0
2022-07-21,Khanh Hoa,Cam Ranh City,9,1,0,1,1
2022-07-21,Khanh Hoa,Dien Khanh,11,1,0,1,1
2022-07-21,Khanh Hoa,Nha Trang City,0,5,0,5,5
2022-07-21,Khanh Hoa,Nha Trang City,1,4,0,4,3
2022-07-21,Khanh Hoa,Nha Trang City,2,8,0,8,8
2022-07-21,Khanh Hoa,Nha Trang City,3,1,0,1,1
2022-07-21,Khanh Hoa,Nha Trang City,6,31,29,2,1
2022-07-21,Khanh Hoa,Nha Trang City,7,138,131,7,1
2022-07-21,Khanh Hoa,Nha Trang City,8,226,207,19,0
2022-07-21,Khanh Hoa,Nha Trang City,9,173,158,15,0
2022-07-21,Khanh Hoa,Nha Trang City,10,220,203,17,1
2022-07-21,Khanh Hoa,Nha Trang City,11,335,305,30,1
2022-07-21,Khanh Hoa,Nha Trang City,12,319,293,26,1
2022-07-21,Khanh Hoa,Nha Trang City,13,217,202,15,0
2022-07-21,Khanh Hoa,Nha Trang City,14,255,236,19,3
2022-07-21,Khanh Hoa,Nha Trang City,15,200,190,10,0
2022-07-21,Khanh Hoa,Nha Trang City,16,170,162,8,0
2022-07-21,Khanh Hoa,Nha Trang City,17,224,206,18,0
2022-07-21,Khanh Hoa,Nha Trang City,18,227,211,16,0
2022-07-21,Khanh Hoa,Nha Trang City,19,220,197,23,2
2022-07-21,Khanh Hoa,Nha Trang City,20,181,153,28,1
2022-07-21,Khanh Hoa,Nha Trang City,21,106,94,12,2
2022-07-21,Khanh Hoa,Nha Trang City,22,25,21,4,0
2022-07-21,Khanh Hoa,Nha Trang City,23,12,8,4,3
2022-07-21,Lam Dong,Da Lat City,0,6,0,6,6
2022-07-21,Lam Dong,Da Lat City,1,10,0,10,9
2022-07-21,Lam Dong,Da Lat City,2,1,0,1,1
2022-07-21,Lam Dong,Da Lat City,3,1,0,1,1
2022-07-21,Lam Dong,Da Lat City,5,1,0,1,0
2022-07-21,Lam Dong,Da Lat City,6,15,4,11,8
2022-07-21,Lam Dong,Da Lat City,7,47,28,19,14
2022-07-21,Lam Dong,Da Lat City,8,97,68,29,16
2022-07-21,Lam Dong,Da Lat City,9,94,83,11,2
2022-07-21,Lam Dong,Da Lat City,10,101,89,12,2
2022-07-21,Lam Dong,Da Lat City,11,132,109,23,6
2022-07-21,Lam Dong,Da Lat City,12,147,125,22,6
2022-07-21,Lam Dong,Da Lat City,13,111,96,15,9
2022-07-21,Lam Dong,Da Lat City,14,123,111,12,4
2022-07-21,Lam Dong,Da Lat City,15,96,80,16,5
2022-07-21,Lam Dong,Da Lat City,16,95,75,20,6
2022-07-21,Lam Dong,Da Lat City,17,142,103,39,15
2022-07-21,Lam Dong,Da Lat City,18,143,120,23,7
2022-07-21,Lam Dong,Da Lat City,19,104,91,13,6
2022-07-21,Lam Dong,Da Lat City,20,104,82,22,9
2022-07-21,Lam Dong,Da Lat City,21,68,45,23,18
2022-07-21,Lam Dong,Da Lat City,22,36,24,12,4
2022-07-21,Lam Dong,Da Lat City,23,14,11,3,2
2022-07-21,Nghe An,Vinh City,0,2,0,2,2
2022-07-21,Nghe An,Vinh City,2,3,0,3,3
2022-07-21,Nghe An,Vinh City,3,3,0,3,2
2022-07-21,Nghe An,Vinh City,4,2,1,1,1
2022-07-21,Nghe An,Vinh City,6,19,4,15,11
2022-07-21,Nghe An,Vinh City,7,115,92,23,6
2022-07-21,Nghe An,Vinh City,8,179,149,30,0
2022-07-21,Nghe An,Vinh City,9,148,118,30,0
2022-07-21,Nghe An,Vinh City,10,200,171,29,6
2022-07-21,Nghe An,Vinh City,11,328,289,39,6
2022-07-21,Nghe An,Vinh City,12,218,195,23,2
2022-07-21,Nghe An,Vinh City,13,153,131,22,6
2022-07-21,Nghe An,Vinh City,14,132,111,21,2
2022-07-21,Nghe An,Vinh City,15,197,166,31,4
2022-07-21,Nghe An,Vinh City,16,124,108,16,5
2022-07-21,Nghe An,Vinh City,17,135,115,20,3
2022-07-21,Nghe An,Vinh City,18,202,166,36,10
2022-07-21,Nghe An,Vinh City,19,157,128,29,15
2022-07-21,Nghe An,Vinh City,20,128,96,32,6
2022-07-21,Nghe An,Vinh City,21,78,58,20,5
2022-07-21,Nghe An,Vinh City,22,24,16,8,3
2022-07-21,Nghe An,Vinh City,23,10,9,1,0
2022-07-21,Quang Nam,Hoi An City,7,12,10,2,1
2022-07-21,Quang Nam,Hoi An City,8,22,16,6,1
2022-07-21,Quang Nam,Hoi An City,9,25,22,3,0
2022-07-21,Quang Nam,Hoi An City,10,26,22,4,0
2022-07-21,Quang Nam,Hoi An City,11,38,34,4,0
2022-07-21,Quang Nam,Hoi An City,12,43,36,7,2
2022-07-21,Quang Nam,Hoi An City,13,36,26,10,4
2022-07-21,Quang Nam,Hoi An City,14,48,38,10,7
2022-07-21,Quang Nam,Hoi An City,15,38,35,3,1
2022-07-21,Quang Nam,Hoi An City,16,44,31,13,6
2022-07-21,Quang Nam,Hoi An City,17,46,33,13,10
2022-07-21,Quang Nam,Hoi An City,18,67,30,37,25
2022-07-21,Quang Nam,Hoi An City,19,151,34,117,97
2022-07-21,Quang Nam,Hoi An City,20,114,31,83,74
2022-07-21,Quang Nam,Hoi An City,21,49,10,39,35
2022-07-21,Quang Nam,Hoi An City,22,13,3,10,6
2022-07-21,Quang Nam,Tam Ky City,14,2,0,2,1
2022-07-21,Quang Ninh,Cam Pha City,9,2,0,2,2
2022-07-21,Quang Ninh,Cam Pha City,10,4,0,4,3
2022-07-21,Quang Ninh,Cam Pha City,11,3,0,3,2
2022-07-21,Quang Ninh,Ha Long City,0,2,1,1,1
2022-07-21,Quang Ninh,Ha Long City,2,1,1,0,0
2022-07-21,Quang Ninh,Ha Long City,6,1,0,1,1
2022-07-21,Quang Ninh,Ha Long City,7,20,15,5,0
2022-07-21,Quang Ninh,Ha Long City,8,56,42,14,6
2022-07-21,Quang Ninh,Ha Long City,9,67,53,14,3
2022-07-21,Quang Ninh,Ha Long City,10,79,72,7,2
2022-07-21,Quang Ninh,Ha Long City,11,149,117,32,16
2022-07-21,Quang Ninh,Ha Long City,12,106,86,20,9
2022-07-21,Quang Ninh,Ha Long City,13,60,43,17,7
2022-07-21,Quang Ninh,Ha Long City,14,77,64,13,2
2022-07-21,Quang Ninh,Ha Long City,15,83,59,24,12
2022-07-21,Quang Ninh,Ha Long City,16,54,40,14,5
2022-07-21,Quang Ninh,Ha Long City,17,68,55,13,5
2022-07-21,Quang Ninh,Ha Long City,18,57,39,18,4
2022-07-21,Quang Ninh,Ha Long City,19,85,62,23,9
2022-07-21,Quang Ninh,Ha Long City,20,69,49,20,11
2022-07-21,Quang Ninh,Ha Long City,21,42,24,18,7
2022-07-21,Quang Ninh,Ha Long City,22,18,8,10,7
2022-07-21,Quang Ninh,Ha Long City,23,6,1,5,3
2022-07-21,Quang Ninh,Uong Bi City,13,1,0,1,0
2022-07-21,Thai Nguyen,Dong Hy,7,1,0,1,1
2022-07-21,Thai Nguyen,Dong Hy,9,1,1,0,0
2022-07-21,Thai Nguyen,Dong Hy,11,3,2,1,0
2022-07-21,Thai Nguyen,Dong Hy,14,1,1,0,0
2022-07-21,Thai Nguyen,Dong Hy,18,1,1,0,0
2022-07-21,Thai Nguyen,Thai Nguyen City,0,7,3,4,1
2022-07-21,Thai Nguyen,Thai Nguyen City,1,2,2,0,0
2022-07-21,Thai Nguyen,Thai Nguyen City,2,1,1,0,0
2022-07-21,Thai Nguyen,Thai Nguyen City,6,16,12,4,3
2022-07-21,Thai Nguyen,Thai Nguyen City,7,94,90,4,0
2022-07-21,Thai Nguyen,Thai Nguyen City,8,142,134,8,0
2022-07-21,Thai Nguyen,Thai Nguyen City,9,141,128,13,0
2022-07-21,Thai Nguyen,Thai Nguyen City,10,182,162,20,0
2022-07-21,Thai Nguyen,Thai Nguyen City,11,397,340,57,25
2022-07-21,Thai Nguyen,Thai Nguyen City,12,234,209,25,2
2022-07-21,Thai Nguyen,Thai Nguyen City,13,129,119,10,3
2022-07-21,Thai Nguyen,Thai Nguyen City,14,158,139,19,3
2022-07-21,Thai Nguyen,Thai Nguyen City,15,134,119,15,1
2022-07-21,Thai Nguyen,Thai Nguyen City,16,118,95,23,1
2022-07-21,Thai Nguyen,Thai Nguyen City,17,139,124,15,0
2022-07-21,Thai Nguyen,Thai Nguyen City,18,204,185,19,1
2022-07-21,Thai Nguyen,Thai Nguyen City,19,171,153,18,1
2022-07-21,Thai Nguyen,Thai Nguyen City,20,144,130,14,2
2022-07-21,Thai Nguyen,Thai Nguyen City,21,109,97,12,2
2022-07-21,Thai Nguyen,Thai Nguyen City,22,33,26,7,1
2022-07-21,Thai Nguyen,Thai Nguyen City,23,4,1,3,0
2022-07-21,Vung Tau,Ba Ria City,7,2,1,1,0
2022-07-21,Vung Tau,Ba Ria City,8,1,1,0,0
2022-07-21,Vung Tau,Ba Ria City,9,3,2,1,1
2022-07-21,Vung Tau,Ba Ria City,10,4,3,1,1
2022-07-21,Vung Tau,Ba Ria City,11,6,2,4,0
2022-07-21,Vung Tau,Ba Ria City,12,3,3,0,0
2022-07-21,Vung Tau,Ba Ria City,13,6,5,1,1
2022-07-21,Vung Tau,Ba Ria City,14,2,2,0,0
2022-07-21,Vung Tau,Ba Ria City,15,2,2,0,0
2022-07-21,Vung Tau,Ba Ria City,16,1,1,0,0
2022-07-21,Vung Tau,Ba Ria City,17,1,1,0,0
2022-07-21,Vung Tau,Ba Ria City,18,4,2,2,2
2022-07-21,Vung Tau,Ba Ria City,19,1,0,1,1
2022-07-21,Vung Tau,Ba Ria City,20,1,0,1,1
2022-07-21,Vung Tau,Long Dien,11,1,1,0,0
2022-07-21,Vung Tau,Long Son,18,1,1,0,0
2022-07-21,Vung Tau,Vung Tau City,0,2,1,1,1
2022-07-21,Vung Tau,Vung Tau City,1,2,2,0,0
2022-07-21,Vung Tau,Vung Tau City,4,1,1,0,0
2022-07-21,Vung Tau,Vung Tau City,5,2,2,0,0
2022-07-21,Vung Tau,Vung Tau City,6,30,22,8,6
2022-07-21,Vung Tau,Vung Tau City,7,116,101,15,6
2022-07-21,Vung Tau,Vung Tau City,8,167,144,23,6
2022-07-21,Vung Tau,Vung Tau City,9,183,168,15,4
2022-07-21,Vung Tau,Vung Tau City,10,214,192,22,5
2022-07-21,Vung Tau,Vung Tau City,11,346,306,40,13
2022-07-21,Vung Tau,Vung Tau City,12,276,254,22,4
2022-07-21,Vung Tau,Vung Tau City,13,220,200,20,6
2022-07-21,Vung Tau,Vung Tau City,14,253,241,12,2
2022-07-21,Vung Tau,Vung Tau City,15,203,187,16,4
2022-07-21,Vung Tau,Vung Tau City,16,223,201,22,0
2022-07-21,Vung Tau,Vung Tau City,17,243,222,21,3
2022-07-21,Vung Tau,Vung Tau City,18,262,237,25,3
2022-07-21,Vung Tau,Vung Tau City,19,281,233,48,11
2022-07-21,Vung Tau,Vung Tau City,20,181,151,30,5
2022-07-21,Vung Tau,Vung Tau City,21,86,72,14,1
2022-07-21,Vung Tau,Vung Tau City,22,35,21,14,6
2022-07-21,Vung Tau,Vung Tau City,23,13,11,2,0
2022-07-22,Bac Ninh,Bác Ninh City,0,1,1,0,0
2022-07-22,Bac Ninh,Bác Ninh City,1,1,0,1,1
2022-07-22,Bac Ninh,Bác Ninh City,5,2,0,2,1
2022-07-22,Bac Ninh,Bác Ninh City,6,15,10,5,1
2022-07-22,Bac Ninh,Bác Ninh City,7,64,59,5,0
2022-07-22,Bac Ninh,Bác Ninh City,8,102,90,12,0
2022-07-22,Bac Ninh,Bác Ninh City,9,89,82,7,0
2022-07-22,Bac Ninh,Bác Ninh City,10,161,147,14,1
2022-07-22,Bac Ninh,Bác Ninh City,11,329,297,32,3
2022-07-22,Bac Ninh,Bác Ninh City,12,199,181,18,0
2022-07-22,Bac Ninh,Bác Ninh City,13,150,137,13,0
2022-07-22,Bac Ninh,Bác Ninh City,14,157,130,27,5
2022-07-22,Bac Ninh,Bác Ninh City,15,100,88,12,1
2022-07-22,Bac Ninh,Bác Ninh City,16,133,118,15,1
2022-07-22,Bac Ninh,Bác Ninh City,17,146,132,14,0
2022-07-22,Bac Ninh,Bác Ninh City,18,155,142,13,1
2022-07-22,Bac Ninh,Bác Ninh City,19,197,180,17,1
2022-07-22,Bac Ninh,Bác Ninh City,20,152,137,15,0
2022-07-22,Bac Ninh,Bác Ninh City,21,83,70,13,1
2022-07-22,Bac Ninh,Bác Ninh City,22,22,19,3,0
2022-07-22,Bac Ninh,Bác Ninh City,23,6,5,1,0
2022-07-22,Bac Ninh,Que Vo,9,1,1,0,0
2022-07-22,Bac Ninh,Que Vo,10,1,1,0,0
2022-07-22,Bac Ninh,Que Vo,11,2,0,2,2
2022-07-22,Bac Ninh,Que Vo,12,3,0,3,3
2022-07-22,Bac Ninh,Que Vo,13,1,1,0,0
2022-07-22,Bac Ninh,Que Vo,14,1,0,1,1
2022-07-22,Bac Ninh,Que Vo,15,1,0,1,1
2022-07-22,Bac Ninh,Que Vo,16,1,0,1,1
2022-07-22,Bac Ninh,Que Vo,21,1,1,0,0
2022-07-22,Bac Ninh,Tien Du,9,2,0,2,2
2022-07-22,Bac Ninh,Tien Du,13,1,0,1,1
2022-07-22,Bac Ninh,Tien Du,14,2,0,2,1
2022-07-22,Bac Ninh,Tien Du,15,5,0,5,3
2022-07-22,Bac Ninh,Tien Du,16,1,0,1,1
2022-07-22,Bac Ninh,Tien Du,19,1,0,1,1
2022-07-22,Bac Ninh,Tien Du,20,1,0,1,1
2022-07-22,Bac Ninh,Tu Son,9,1,0,1,1
2022-07-22,Bac Ninh,Tu Son,10,2,0,2,2
2022-07-22,Bac Ninh,Tu Son,11,1,0,1,0
2022-07-22,Bac Ninh,Tu Son,12,1,0,1,1
2022-07-22,Bac Ninh,Tu Son,13,1,0,1,1
2022-07-22,Bac Ninh,Tu Son,14,3,0,3,3
2022-07-22,Bac Ninh,Tu Son,15,1,0,1,1
2022-07-22,Bac Ninh,Tu Son,16,1,1,0,0
2022-07-22,Bac Ninh,Tu Son,17,2,0,2,1
2022-07-22,Bac Ninh,Tu Son,20,2,0,2,2
2022-07-22,Bac Ninh,Tu Son,21,3,0,3,3
2022-07-22,Bac Ninh,Yen Phong,20,1,0,1,1
2022-07-22,Binh Duong,Ben Cat,7,1,0,1,1
2022-07-22,Binh Duong,Ben Cat,8,2,0,2,2
2022-07-22,Binh Duong,Ben Cat,10,3,0,3,3
2022-07-22,Binh Duong,Ben Cat,12,2,0,2,0
2022-07-22,Binh Duong,Ben Cat,14,1,0,1,1
2022-07-22,Binh Duong,Ben Cat,18,1,1,0,0
2022-07-22,Binh Duong,Ben Cat,19,1,1,0,0
2022-07-22,Binh Duong,Ben Cat,20,1,1,0,0
2022-07-22,Binh Duong,Di An,0,3,0,3,2
2022-07-22,Binh Duong,Di An,7,3,2,1,1
2022-07-22,Binh Duong,Di An,8,19,10,9,9
2022-07-22,Binh Duong,Di An,9,23,18,5,3
2022-07-22,Binh Duong,Di An,10,42,34,8,3
2022-07-22,Binh Duong,Di An,11,45,37,8,3
2022-07-22,Binh Duong,Di An,12,44,35,9,1
2022-07-22,Binh Duong,Di An,13,53,34,19,10
2022-07-22,Binh Duong,Di An,14,33,21,12,6
2022-07-22,Binh Duong,Di An,15,39,28,11,10
2022-07-22,Binh Duong,Di An,16,40,28,12,7
2022-07-22,Binh Duong,Di An,17,38,33,5,1
2022-07-22,Binh Duong,Di An,18,42,34,8,2
2022-07-22,Binh Duong,Di An,19,27,25,2,0
2022-07-22,Binh Duong,Di An,20,28,18,10,7
2022-07-22,Binh Duong,Di An,21,17,10,7,6
2022-07-22,Binh Duong,Di An,22,1,0,1,1
2022-07-22,Binh Duong,Di An,23,3,0,3,2
2022-07-22,Binh Duong,Tan Uyen,9,2,2,0,0
2022-07-22,Binh Duong,Tan Uyen,11,1,1,0,0
2022-07-22,Binh Duong,Tan Uyen,13,7,3,4,4
2022-07-22,Binh Duong,Tan Uyen,14,3,1,2,2
2022-07-22,Binh Duong,Tan Uyen,15,1,1,0,0
2022-07-22,Binh Duong,Tan Uyen,16,1,1,0,0
2022-07-22,Binh Duong,Tan Uyen,17,3,2,1,1
2022-07-22,Binh Duong,Tan Uyen,18,1,1,0,0
2022-07-22,Binh Duong,Tan Uyen,19,1,0,1,1
2022-07-22,Binh Duong,Tan Uyen,20,4,2,2,1
2022-07-22,Binh Duong,Tan Uyen,21,2,1,1,1
2022-07-22,Binh Duong,Thu Dau Mot Town,0,7,5,2,1
2022-07-22,Binh Duong,Thu Dau Mot Town,1,2,1,1,1
2022-07-22,Binh Duong,Thu Dau Mot Town,2,4,2,2,1
2022-07-22,Binh Duong,Thu Dau Mot Town,3,3,2,1,0
2022-07-22,Binh Duong,Thu Dau Mot Town,4,3,1,2,2
2022-07-22,Binh Duong,Thu Dau Mot Town,5,3,2,1,1
2022-07-22,Binh Duong,Thu Dau Mot Town,6,41,36,5,2
2022-07-22,Binh Duong,Thu Dau Mot Town,7,100,96,4,2
2022-07-22,Binh Duong,Thu Dau Mot Town,8,234,214,20,4
2022-07-22,Binh Duong,Thu Dau Mot Town,9,291,267,24,1
2022-07-22,Binh Duong,Thu Dau Mot Town,10,435,383,52,10
2022-07-22,Binh Duong,Thu Dau Mot Town,11,676,615,61,20
2022-07-22,Binh Duong,Thu Dau Mot Town,12,527,487,40,12
2022-07-22,Binh Duong,Thu Dau Mot Town,13,467,411,56,27
2022-07-22,Binh Duong,Thu Dau Mot Town,14,416,374,42,19
2022-07-22,Binh Duong,Thu Dau Mot Town,15,298,275,23,5
2022-07-22,Binh Duong,Thu Dau Mot Town,16,277,250,27,8
2022-07-22,Binh Duong,Thu Dau Mot Town,17,447,420,27,10
2022-07-22,Binh Duong,Thu Dau Mot Town,18,395,364,31,4
2022-07-22,Binh Duong,Thu Dau Mot Town,19,358,317,41,12
2022-07-22,Binh Duong,Thu Dau Mot Town,20,241,225,16,3
2022-07-22,Binh Duong,Thu Dau Mot Town,21,136,117,19,4
2022-07-22,Binh Duong,Thu Dau Mot Town,22,17,16,1,0
2022-07-22,Binh Duong,Thu Dau Mot Town,23,20,14,6,1
2022-07-22,Binh Duong,Thuan An,0,2,0,2,2
2022-07-22,Binh Duong,Thuan An,1,1,0,1,1
2022-07-22,Binh Duong,Thuan An,6,3,0,3,3
2022-07-22,Binh Duong,Thuan An,7,10,4,6,5
2022-07-22,Binh Duong,Thuan An,8,22,11,11,7
2022-07-22,Binh Duong,Thuan An,9,41,34,7,2
2022-07-22,Binh Duong,Thuan An,10,78,66,12,6
2022-07-22,Binh Duong,Thuan An,11,90,81,9,2
2022-07-22,Binh Duong,Thuan An,12,85,71,14,5
2022-07-22,Binh Duong,Thuan An,13,107,77,30,16
2022-07-22,Binh Duong,Thuan An,14,72,55,17,14
2022-07-22,Binh Duong,Thuan An,15,47,41,6,3
2022-07-22,Binh Duong,Thuan An,16,37,31,6,3
2022-07-22,Binh Duong,Thuan An,17,50,45,5,0
2022-07-22,Binh Duong,Thuan An,18,45,35,10,2
2022-07-22,Binh Duong,Thuan An,19,37,29,8,2
2022-07-22,Binh Duong,Thuan An,20,36,28,8,5
2022-07-22,Binh Duong,Thuan An,21,18,12,6,3
2022-07-22,Binh Duong,Thuan An,22,3,0,3,2
2022-07-22,Binh Duong,Thuan An,23,4,0,4,2
2022-07-22,Can Tho City,Binh Thuy District,6,1,1,0,0
2022-07-22,Can Tho City,Binh Thuy District,7,4,4,0,0
2022-07-22,Can Tho City,Binh Thuy District,8,5,5,0,0
2022-07-22,Can Tho City,Binh Thuy District,9,8,7,1,0
2022-07-22,Can Tho City,Binh Thuy District,10,6,6,0,0
2022-07-22,Can Tho City,Binh Thuy District,11,11,10,1,0
2022-07-22,Can Tho City,Binh Thuy District,12,11,9,2,1
2022-07-22,Can Tho City,Binh Thuy District,13,11,10,1,0
2022-07-22,Can Tho City,Binh Thuy District,14,12,11,1,0
2022-07-22,Can Tho City,Binh Thuy District,15,10,10,0,0
2022-07-22,Can Tho City,Binh Thuy District,16,10,7,3,0
2022-07-22,Can Tho City,Binh Thuy District,17,11,11,0,0
2022-07-22,Can Tho City,Binh Thuy District,18,9,9,0,0
2022-07-22,Can Tho City,Binh Thuy District,19,19,19,0,0
2022-07-22,Can Tho City,Binh Thuy District,20,13,13,0,0
2022-07-22,Can Tho City,Binh Thuy District,21,4,4,0,0
2022-07-22,Can Tho City,Binh Thuy District,22,2,1,1,0
2022-07-22,Can Tho City,Cai Rang District,6,7,2,5,5
2022-07-22,Can Tho City,Cai Rang District,7,6,3,3,0
2022-07-22,Can Tho City,Cai Rang District,8,10,7,3,2
2022-07-22,Can Tho City,Cai Rang District,9,5,5,0,0
2022-07-22,Can Tho City,Cai Rang District,10,11,9,2,0
2022-07-22,Can Tho City,Cai Rang District,11,21,20,1,1
2022-07-22,Can Tho City,Cai Rang District,12,12,12,0,0
2022-07-22,Can Tho City,Cai Rang District,13,11,11,0,0
2022-07-22,Can Tho City,Cai Rang District,14,17,16,1,0
2022-07-22,Can Tho City,Cai Rang District,15,13,13,0,0
2022-07-22,Can Tho City,Cai Rang District,16,6,6,0,0
2022-07-22,Can Tho City,Cai Rang District,17,3,3,0,0
2022-07-22,Can Tho City,Cai Rang District,18,13,12,1,0
2022-07-22,Can Tho City,Cai Rang District,19,8,8,0,0
2022-07-22,Can Tho City,Cai Rang District,20,11,10,1,0
2022-07-22,Can Tho City,Cai Rang District,21,5,4,1,1
2022-07-22,Can Tho City,Cai Rang District,22,3,1,2,2
2022-07-22,Can Tho City,Ninh Kieu District,0,11,5,6,4
2022-07-22,Can Tho City,Ninh Kieu District,1,3,3,0,0
2022-07-22,Can Tho City,Ninh Kieu District,2,2,1,1,1
2022-07-22,Can Tho City,Ninh Kieu District,3,1,1,0,0
2022-07-22,Can Tho City,Ninh Kieu District,4,3,1,2,2
2022-07-22,Can Tho City,Ninh Kieu District,5,4,1,3,1
2022-07-22,Can Tho City,Ninh Kieu District,6,43,38,5,1
2022-07-22,Can Tho City,Ninh Kieu District,7,114,108,6,1
2022-07-22,Can Tho City,Ninh Kieu District,8,207,198,9,0
2022-07-22,Can Tho City,Ninh Kieu District,9,270,259,11,0
2022-07-22,Can Tho City,Ninh Kieu District,10,468,446,22,1
2022-07-22,Can Tho City,Ninh Kieu District,11,808,756,52,7
2022-07-22,Can Tho City,Ninh Kieu District,12,596,570,26,0
2022-07-22,Can Tho City,Ninh Kieu District,13,480,454,26,0
2022-07-22,Can Tho City,Ninh Kieu District,14,428,399,29,0
2022-07-22,Can Tho City,Ninh Kieu District,15,372,340,32,0
2022-07-22,Can Tho City,Ninh Kieu District,16,345,331,14,0
2022-07-22,Can Tho City,Ninh Kieu District,17,422,397,25,0
2022-07-22,Can Tho City,Ninh Kieu District,18,456,436,20,0
2022-07-22,Can Tho City,Ninh Kieu District,19,469,449,20,0
2022-07-22,Can Tho City,Ninh Kieu District,20,376,350,26,2
2022-07-22,Can Tho City,Ninh Kieu District,21,226,204,22,0
2022-07-22,Can Tho City,Ninh Kieu District,22,45,40,5,0
2022-07-22,Can Tho City,Ninh Kieu District,23,13,9,4,2
2022-07-22,Dong Nai,Bien Hoa City,0,10,4,6,5
2022-07-22,Dong Nai,Bien Hoa City,1,3,1,2,2
2022-07-22,Dong Nai,Bien Hoa City,2,3,0,3,1
2022-07-22,Dong Nai,Bien Hoa City,4,2,0,2,2
2022-07-22,Dong Nai,Bien Hoa City,5,9,4,5,3
2022-07-22,Dong Nai,Bien Hoa City,6,46,31,15,7
2022-07-22,Dong Nai,Bien Hoa City,7,172,160,12,3
2022-07-22,Dong Nai,Bien Hoa City,8,261,233,28,3
2022-07-22,Dong Nai,Bien Hoa City,9,406,379,27,2
2022-07-22,Dong Nai,Bien Hoa City,10,808,747,61,7
2022-07-22,Dong Nai,Bien Hoa City,11,1180,1082,98,11
2022-07-22,Dong Nai,Bien Hoa City,12,910,847,63,6
2022-07-22,Dong Nai,Bien Hoa City,13,906,855,51,4
2022-07-22,Dong Nai,Bien Hoa City,14,791,735,56,12
2022-07-22,Dong Nai,Bien Hoa City,15,571,530,41,4
2022-07-22,Dong Nai,Bien Hoa City,16,530,498,32,3
2022-07-22,Dong Nai,Bien Hoa City,17,676,618,58,14
2022-07-22,Dong Nai,Bien Hoa City,18,687,637,50,11
2022-07-22,Dong Nai,Bien Hoa City,19,778,712,66,21
2022-07-22,Dong Nai,Bien Hoa City,20,551,484,67,15
2022-07-22,Dong Nai,Bien Hoa City,21,253,196,57,12
2022-07-22,Dong Nai,Bien Hoa City,22,50,34,16,5
2022-07-22,Dong Nai,Bien Hoa City,23,27,10,17,8
2022-07-22,Dong Nai,Cam My,16,1,0,1,1
2022-07-22,Dong Nai,Long Khanh,11,3,0,3,3
2022-07-22,Dong Nai,Long Khanh,15,1,0,1,1
2022-07-22,Dong Nai,Long Khanh,16,1,0,1,1
2022-07-22,Dong Nai,Long Thanh,8,1,0,1,1
2022-07-22,Dong Nai,Long Thanh,10,1,0,1,1
2022-07-22,Dong Nai,Long Thanh,11,2,0,2,2
2022-07-22,Dong Nai,Long Thanh,12,2,0,2,2
2022-07-22,Dong Nai,Long Thanh,13,2,0,2,1
2022-07-22,Dong Nai,Long Thanh,15,3,0,3,2
2022-07-22,Dong Nai,Nhon trach,12,1,0,1,1
2022-07-22,Dong Nai,Nhon trach,19,1,0,1,1
2022-07-22,Dong Nai,Trang Bom,10,4,0,4,3
2022-07-22,Dong Nai,Trang Bom,13,4,1,3,2
2022-07-22,Dong Nai,Trang Bom,14,2,0,2,2
2022-07-22,Dong Nai,Trang Bom,18,1,0,1,1
2022-07-22,Dong Nai,Trang Bom,21,1,0,1,1
2022-07-22,Dong Nai,Vinh Cuu,10,2,0,2,1
2022-07-22,Dong Nai,Vinh Cuu,14,1,0,1,0
2022-07-22,Dong Nai,Vinh Cuu,21,2,0,2,1
2022-07-22,Hai Phong City,An Duong,7,2,2,0,0
2022-07-22,Hai Phong City,An Duong,8,1,1,0,0
2022-07-22,Hai Phong City,An Duong,9,4,2,2,0
2022-07-22,Hai Phong City,An Duong,10,7,1,6,5
2022-07-22,Hai Phong City,An Duong,11,5,3,2,2
2022-07-22,Hai Phong City,An Duong,12,5,2,3,2
2022-07-22,Hai Phong City,An Duong,13,2,1,1,1
2022-07-22,Hai Phong City,An Duong,14,2,2,0,0
2022-07-22,Hai Phong City,An Duong,15,2,1,1,1
2022-07-22,Hai Phong City,An Duong,16,4,3,1,1
2022-07-22,Hai Phong City,An Duong,17,2,2,0,0
2022-07-22,Hai Phong City,An Duong,18,5,2,3,1
2022-07-22,Hai Phong City,An Duong,19,3,0,3,2
2022-07-22,Hai Phong City,An Duong,20,7,3,4,2
2022-07-22,Hai Phong City,An Duong,21,4,1,3,3
2022-07-22,Hai Phong City,An Duong,22,1,0,1,0
2022-07-22,Hai Phong City,Hai An District,0,2,0,2,1
2022-07-22,Hai Phong City,Hai An District,3,1,0,1,1
2022-07-22,Hai Phong City,Hai An District,4,1,0,1,1
2022-07-22,Hai Phong City,Hai An District,6,3,2,1,1
2022-07-22,Hai Phong City,Hai An District,7,7,2,5,1
2022-07-22,Hai Phong City,Hai An District,8,16,12,4,1
2022-07-22,Hai Phong City,Hai An District,9,15,11,4,2
2022-07-22,Hai Phong City,Hai An District,10,28,25,3,0
2022-07-22,Hai Phong City,Hai An District,11,55,48,7,1
2022-07-22,Hai Phong City,Hai An District,12,26,21,5,1
2022-07-22,Hai Phong City,Hai An District,13,20,15,5,4
2022-07-22,Hai Phong City,Hai An District,14,18,16,2,2
2022-07-22,Hai Phong City,Hai An District,15,11,10,1,0
2022-07-22,Hai Phong City,Hai An District,16,19,16,3,1
2022-07-22,Hai Phong City,Hai An District,17,19,17,2,2
2022-07-22,Hai Phong City,Hai An District,18,25,22,3,0
2022-07-22,Hai Phong City,Hai An District,19,37,29,8,0
2022-07-22,Hai Phong City,Hai An District,20,20,18,2,0
2022-07-22,Hai Phong City,Hai An District,21,18,14,4,2
2022-07-22,Hai Phong City,Hai An District,22,4,1,3,1
2022-07-22,Hai Phong City,Hai An District,23,2,1,1,1
2022-07-22,Hai Phong City,Hong Bang District,7,22,18,4,1
2022-07-22,Hai Phong City,Hong Bang District,8,34,32,2,0
2022-07-22,Hai Phong City,Hong Bang District,9,35,29,6,0
2022-07-22,Hai Phong City,Hong Bang District,10,80,74,6,1
2022-07-22,Hai Phong City,Hong Bang District,11,113,104,9,0
2022-07-22,Hai Phong City,Hong Bang District,12,65,58,7,0
2022-07-22,Hai Phong City,Hong Bang District,13,37,32,5,2
2022-07-22,Hai Phong City,Hong Bang District,14,38,31,7,1
2022-07-22,Hai Phong City,Hong Bang District,15,51,36,15,11
2022-07-22,Hai Phong City,Hong Bang District,16,50,44,6,2
2022-07-22,Hai Phong City,Hong Bang District,17,45,38,7,1
2022-07-22,Hai Phong City,Hong Bang District,18,62,57,5,0
2022-07-22,Hai Phong City,Hong Bang District,19,48,42,6,1
2022-07-22,Hai Phong City,Hong Bang District,20,32,28,4,3
2022-07-22,Hai Phong City,Hong Bang District,21,18,13,5,2
2022-07-22,Hai Phong City,Hong Bang District,22,1,1,0,0
2022-07-22,Hai Phong City,Hong Bang District,23,1,1,0,0
2022-07-22,Hai Phong City,Kien An District,6,2,0,2,1
2022-07-22,Hai Phong City,Kien An District,7,4,2,2,2
2022-07-22,Hai Phong City,Kien An District,8,4,3,1,0
2022-07-22,Hai Phong City,Kien An District,9,7,3,4,3
2022-07-22,Hai Phong City,Kien An District,10,12,12,0,0
2022-07-22,Hai Phong City,Kien An District,11,13,13,0,0
2022-07-22,Hai Phong City,Kien An District,12,10,8,2,0
2022-07-22,Hai Phong City,Kien An District,13,3,2,1,1
2022-07-22,Hai Phong City,Kien An District,14,4,3,1,1
2022-07-22,Hai Phong City,Kien An District,15,4,4,0,0
2022-07-22,Hai Phong City,Kien An District,16,7,7,0,0
2022-07-22,Hai Phong City,Kien An District,17,7,6,1,0
2022-07-22,Hai Phong City,Kien An District,18,9,7,2,0
2022-07-22,Hai Phong City,Kien An District,19,15,10,5,2
2022-07-22,Hai Phong City,Kien An District,20,6,1,5,3
2022-07-22,Hai Phong City,Kien An District,21,1,0,1,1
2022-07-22,Hai Phong City,Kien An District,23,1,0,1,0
2022-07-22,Hai Phong City,Le Chan District,1,1,0,1,1
2022-07-22,Hai Phong City,Le Chan District,3,2,2,0,0
2022-07-22,Hai Phong City,Le Chan District,6,3,2,1,1
2022-07-22,Hai Phong City,Le Chan District,7,45,33,12,4
2022-07-22,Hai Phong City,Le Chan District,8,60,54,6,0
2022-07-22,Hai Phong City,Le Chan District,9,112,96,16,1
2022-07-22,Hai Phong City,Le Chan District,10,229,198,31,2
2022-07-22,Hai Phong City,Le Chan District,11,354,329,25,6
2022-07-22,Hai Phong City,Le Chan District,12,245,207,38,8
2022-07-22,Hai Phong City,Le Chan District,13,150,115,35,4
2022-07-22,Hai Phong City,Le Chan District,14,150,131,19,6
2022-07-22,Hai Phong City,Le Chan District,15,156,126,30,15
2022-07-22,Hai Phong City,Le Chan District,16,169,139,30,6
2022-07-22,Hai Phong City,Le Chan District,17,187,160,27,10
2022-07-22,Hai Phong City,Le Chan District,18,226,195,31,9
2022-07-22,Hai Phong City,Le Chan District,19,235,206,29,7
2022-07-22,Hai Phong City,Le Chan District,20,173,143,30,11
2022-07-22,Hai Phong City,Le Chan District,21,113,83,30,9
2022-07-22,Hai Phong City,Le Chan District,22,14,11,3,2
2022-07-22,Hai Phong City,Le Chan District,23,8,5,3,0
2022-07-22,Hai Phong City,Ngo Quyen District,0,1,1,0,0
2022-07-22,Hai Phong City,Ngo Quyen District,1,1,1,0,0
2022-07-22,Hai Phong City,Ngo Quyen District,6,2,2,0,0
2022-07-22,Hai Phong City,Ngo Quyen District,7,25,21,4,1
2022-07-22,Hai Phong City,Ngo Quyen District,8,90,83,7,0
2022-07-22,Hai Phong City,Ngo Quyen District,9,72,67,5,0
2022-07-22,Hai Phong City,Ngo Quyen District,10,180,162,18,5
2022-07-22,Hai Phong City,Ngo Quyen District,11,285,258,27,10
2022-07-22,Hai Phong City,Ngo Quyen District,12,182,165,17,2
2022-07-22,Hai Phong City,Ngo Quyen District,13,122,109,13,6
2022-07-22,Hai Phong City,Ngo Quyen District,14,143,115,28,7
2022-07-22,Hai Phong City,Ngo Quyen District,15,146,109,37,19
2022-07-22,Hai Phong City,Ngo Quyen District,16,135,117,18,5
2022-07-22,Hai Phong City,Ngo Quyen District,17,160,138,22,2
2022-07-22,Hai Phong City,Ngo Quyen District,18,212,190,22,4
2022-07-22,Hai Phong City,Ngo Quyen District,19,162,144,18,5
2022-07-22,Hai Phong City,Ngo Quyen District,20,133,108,25,7
2022-07-22,Hai Phong City,Ngo Quyen District,21,82,56,26,15
2022-07-22,Hai Phong City,Ngo Quyen District,22,9,7,2,0
2022-07-22,Hai Phong City,Ngo Quyen District,23,2,1,1,1
2022-07-22,Hai Phong City,Thuy Nguyen,8,1,0,1,1
2022-07-22,Hai Phong City,Thuy Nguyen,9,2,0,2,2
2022-07-22,Hai Phong City,Thuy Nguyen,10,2,1,1,1
2022-07-22,Hai Phong City,Thuy Nguyen,11,1,0,1,1
2022-07-22,Hai Phong City,Thuy Nguyen,13,1,0,1,1
2022-07-22,Hai Phong City,Thuy Nguyen,16,1,0,1,1
2022-07-22,Hai Phong City,Thuy Nguyen,19,1,0,1,1
2022-07-22,Hue City,Hue City,0,9,8,1,0
2022-07-22,Hue City,Hue City,1,3,1,2,2
2022-07-22,Hue City,Hue City,2,2,0,2,2
2022-07-22,Hue City,Hue City,3,2,0,2,2
2022-07-22,Hue City,Hue City,4,1,1,0,0
2022-07-22,Hue City,Hue City,5,3,1,2,0
2022-07-22,Hue City,Hue City,6,81,63,18,2
2022-07-22,Hue City,Hue City,7,222,201,21,2
2022-07-22,Hue City,Hue City,8,353,316,37,0
2022-07-22,Hue City,Hue City,9,274,253,21,0
2022-07-22,Hue City,Hue City,10,439,403,36,3
2022-07-22,Hue City,Hue City,11,983,902,81,9
2022-07-22,Hue City,Hue City,12,653,615,38,1
2022-07-22,Hue City,Hue City,13,385,356,29,4
2022-07-22,Hue City,Hue City,14,441,407,34,2
2022-07-22,Hue City,Hue City,15,425,388,37,1
2022-07-22,Hue City,Hue City,16,414,378,36,2
2022-07-22,Hue City,Hue City,17,469,424,45,3
2022-07-22,Hue City,Hue City,18,540,497,43,0
2022-07-22,Hue City,Hue City,19,568,518,50,0
2022-07-22,Hue City,Hue City,20,477,417,60,9
2022-07-22,Hue City,Hue City,21,296,247,49,7
2022-07-22,Hue City,Hue City,22,62,45,17,3
2022-07-22,Hue City,Hue City,23,19,12,7,1
2022-07-22,Hue City,Huong Thuy,7,2,2,0,0
2022-07-22,Hue City,Huong Thuy,11,2,1,1,0
2022-07-22,Hue City,Huong Thuy,12,3,0,3,0
2022-07-22,Hue City,Huong Thuy,13,1,1,0,0
2022-07-22,Hue City,Huong Thuy,14,2,1,1,1
2022-07-22,Hue City,Huong Thuy,18,3,2,1,0
2022-07-22,Hue City,Huong Thuy,19,3,2,1,0
2022-07-22,Hue City,Huong Thuy,20,1,0,1,0
2022-07-22,Hue City,Huong Thuy,22,1,0,1,0
2022-07-22,Hue City,Huong Tra,11,1,0,1,1
2022-07-22,Hue City,Huong Tra,12,2,0,2,2
2022-07-22,Hue City,Huong Tra,13,1,1,0,0
2022-07-22,Hue City,Huong Tra,16,1,1,0,0
2022-07-22,Hue City,Huong Tra,20,1,1,0,0
2022-07-22,Hue City,Phu Vang,6,1,0,1,1
2022-07-22,Hue City,Phu Vang,7,2,1,1,0
2022-07-22,Hue City,Phu Vang,8,3,3,0,0
2022-07-22,Hue City,Phu Vang,9,3,2,1,0
2022-07-22,Hue City,Phu Vang,11,10,6,4,2
2022-07-22,Hue City,Phu Vang,12,3,3,0,0
2022-07-22,Hue City,Phu Vang,13,3,3,0,0
2022-07-22,Hue City,Phu Vang,14,3,0,3,3
2022-07-22,Hue City,Phu Vang,15,4,1,3,3
2022-07-22,Hue City,Phu Vang,16,2,2,0,0
2022-07-22,Hue City,Phu Vang,18,3,2,1,1
2022-07-22,Hue City,Phu Vang,19,2,1,1,0
2022-07-22,Hue City,Phu Vang,20,2,2,0,0
2022-07-22,Hue City,Phu Vang,21,1,0,1,0
2022-07-22,Khanh Hoa,Dien Khanh,16,1,0,1,1
2022-07-22,Khanh Hoa,Dien Khanh,21,1,0,1,1
2022-07-22,Khanh Hoa,Nha Trang City,0,2,1,1,1
2022-07-22,Khanh Hoa,Nha Trang City,1,7,1,6,6
2022-07-22,Khanh Hoa,Nha Trang City,2,3,1,2,1
2022-07-22,Khanh Hoa,Nha Trang City,5,8,6,2,0
2022-07-22,Khanh Hoa,Nha Trang City,6,41,35,6,0
2022-07-22,Khanh Hoa,Nha Trang City,7,146,140,6,1
2022-07-22,Khanh Hoa,Nha Trang City,8,234,216,18,1
2022-07-22,Khanh Hoa,Nha Trang City,9,225,205,20,1
2022-07-22,Khanh Hoa,Nha Trang City,10,219,200,19,0
2022-07-22,Khanh Hoa,Nha Trang City,11,364,335,29,4
2022-07-22,Khanh Hoa,Nha Trang City,12,299,274,25,0
2022-07-22,Khanh Hoa,Nha Trang City,13,281,259,22,3
2022-07-22,Khanh Hoa,Nha Trang City,14,256,239,17,2
2022-07-22,Khanh Hoa,Nha Trang City,15,208,198,10,0
2022-07-22,Khanh Hoa,Nha Trang City,16,208,190,18,1
2022-07-22,Khanh Hoa,Nha Trang City,17,267,240,27,3
2022-07-22,Khanh Hoa,Nha Trang City,18,293,274,19,1
2022-07-22,Khanh Hoa,Nha Trang City,19,242,221,21,0
2022-07-22,Khanh Hoa,Nha Trang City,20,206,185,21,1
2022-07-22,Khanh Hoa,Nha Trang City,21,123,103,20,1
2022-07-22,Khanh Hoa,Nha Trang City,22,41,29,12,1
2022-07-22,Khanh Hoa,Nha Trang City,23,14,12,2,0
2022-07-22,Lam Dong,Da Lat City,1,4,0,4,3
2022-07-22,Lam Dong,Da Lat City,2,2,0,2,0
2022-07-22,Lam Dong,Da Lat City,5,1,1,0,0
2022-07-22,Lam Dong,Da Lat City,6,14,5,9,6
2022-07-22,Lam Dong,Da Lat City,7,57,40,17,11
2022-07-22,Lam Dong,Da Lat City,8,97,72,25,13
2022-07-22,Lam Dong,Da Lat City,9,102,77,25,8
2022-07-22,Lam Dong,Da Lat City,10,98,87,11,3
2022-07-22,Lam Dong,Da Lat City,11,124,96,28,14
2022-07-22,Lam Dong,Da Lat City,12,171,128,43,23
2022-07-22,Lam Dong,Da Lat City,13,143,90,53,27
2022-07-22,Lam Dong,Da Lat City,14,145,104,41,22
2022-07-22,Lam Dong,Da Lat City,15,158,97,61,36
2022-07-22,Lam Dong,Da Lat City,16,139,101,38,21
2022-07-22,Lam Dong,Da Lat City,17,175,122,53,31
2022-07-22,Lam Dong,Da Lat City,18,173,127,46,29
2022-07-22,Lam Dong,Da Lat City,19,171,127,44,30
2022-07-22,Lam Dong,Da Lat City,20,162,101,61,46
2022-07-22,Lam Dong,Da Lat City,21,88,46,42,21
2022-07-22,Lam Dong,Da Lat City,22,40,30,10,3
2022-07-22,Lam Dong,Da Lat City,23,21,10,11,5
2022-07-22,Nghe An,Vinh City,0,1,0,1,1
2022-07-22,Nghe An,Vinh City,1,4,0,4,4
2022-07-22,Nghe An,Vinh City,6,17,10,7,4
2022-07-22,Nghe An,Vinh City,7,137,122,15,2
2022-07-22,Nghe An,Vinh City,8,191,173,18,2
2022-07-22,Nghe An,Vinh City,9,136,119,17,0
2022-07-22,Nghe An,Vinh City,10,202,173,29,4
2022-07-22,Nghe An,Vinh City,11,337,299,38,14
2022-07-22,Nghe An,Vinh City,12,226,193,33,4
2022-07-22,Nghe An,Vinh City,13,144,127,17,3
2022-07-22,Nghe An,Vinh City,14,141,121,20,2
2022-07-22,Nghe An,Vinh City,15,169,137,32,2
2022-07-22,Nghe An,Vinh City,16,126,106,20,3
2022-07-22,Nghe An,Vinh City,17,121,105,16,4
2022-07-22,Nghe An,Vinh City,18,148,122,26,4
2022-07-22,Nghe An,Vinh City,19,168,131,37,7
2022-07-22,Nghe An,Vinh City,20,138,103,35,15
2022-07-22,Nghe An,Vinh City,21,77,61,16,6
2022-07-22,Nghe An,Vinh City,22,26,12,14,1
2022-07-22,Nghe An,Vinh City,23,15,5,10,2
2022-07-22,Quang Nam,Dien Ban,10,1,0,1,1
2022-07-22,Quang Nam,Dien Ban,12,1,0,1,1
2022-07-22,Quang Nam,Hoi An City,6,4,0,4,2
2022-07-22,Quang Nam,Hoi An City,7,14,11,3,1
2022-07-22,Quang Nam,Hoi An City,8,23,18,5,2
2022-07-22,Quang Nam,Hoi An City,9,37,26,11,4
2022-07-22,Quang Nam,Hoi An City,10,23,18,5,0
2022-07-22,Quang Nam,Hoi An City,11,50,41,9,3
2022-07-22,Quang Nam,Hoi An City,12,36,30,6,2
2022-07-22,Quang Nam,Hoi An City,13,31,27,4,2
2022-07-22,Quang Nam,Hoi An City,14,34,28,6,3
2022-07-22,Quang Nam,Hoi An City,15,35,31,4,0
2022-07-22,Quang Nam,Hoi An City,16,31,26,5,0
2022-07-22,Quang Nam,Hoi An City,17,41,28,13,7
2022-07-22,Quang Nam,Hoi An City,18,46,39,7,4
2022-07-22,Quang Nam,Hoi An City,19,47,37,10,6
2022-07-22,Quang Nam,Hoi An City,20,34,26,8,2
2022-07-22,Quang Nam,Hoi An City,21,29,18,11,5
2022-07-22,Quang Nam,Hoi An City,22,10,1,9,3
2022-07-22,Quang Nam,Hoi An City,23,6,2,4,2
2022-07-22,Quang Nam,Tam Ky City,17,2,0,2,1
2022-07-22,Quang Ninh,Cam Pha City,9,1,0,1,1
2022-07-22,Quang Ninh,Cam Pha City,10,2,0,2,2
2022-07-22,Quang Ninh,Cam Pha City,12,3,0,3,2
2022-07-22,Quang Ninh,Cam Pha City,14,1,0,1,1
2022-07-22,Quang Ninh,Cam Pha City,15,1,0,1,1
2022-07-22,Quang Ninh,Ha Long City,1,1,0,1,1
2022-07-22,Quang Ninh,Ha Long City,5,1,1,0,0
2022-07-22,Quang Ninh,Ha Long City,6,3,0,3,2
2022-07-22,Quang Ninh,Ha Long City,7,24,22,2,1
2022-07-22,Quang Ninh,Ha Long City,8,41,35,6,1
2022-07-22,Quang Ninh,Ha Long City,9,41,30,11,3
2022-07-22,Quang Ninh,Ha Long City,10,109,79,30,7
2022-07-22,Quang Ninh,Ha Long City,11,165,127,38,17
2022-07-22,Quang Ninh,Ha Long City,12,116,93,23,7
2022-07-22,Quang Ninh,Ha Long City,13,74,50,24,8
2022-07-22,Quang Ninh,Ha Long City,14,68,55,13,7
2022-07-22,Quang Ninh,Ha Long City,15,74,51,23,8
2022-07-22,Quang Ninh,Ha Long City,16,75,51,24,7
2022-07-22,Quang Ninh,Ha Long City,17,64,48,16,7
2022-07-22,Quang Ninh,Ha Long City,18,76,53,23,11
2022-07-22,Quang Ninh,Ha Long City,19,73,63,10,6
2022-07-22,Quang Ninh,Ha Long City,20,63,39,24,12
2022-07-22,Quang Ninh,Ha Long City,21,37,24,13,5
2022-07-22,Quang Ninh,Ha Long City,22,33,18,15,12
2022-07-22,Quang Ninh,Ha Long City,23,3,1,2,1
2022-07-22,Quang Ninh,Uong Bi City,18,1,0,1,1
2022-07-22,Thai Nguyen,Dong Hy,7,2,1,1,1
2022-07-22,Thai Nguyen,Dong Hy,11,2,1,1,0
2022-07-22,Thai Nguyen,Dong Hy,12,2,1,1,1
2022-07-22,Thai Nguyen,Dong Hy,13,1,1,0,0
2022-07-22,Thai Nguyen,Pho Yen,13,1,0,1,1
2022-07-22,Thai Nguyen,Thai Nguyen City,0,5,2,3,3
2022-07-22,Thai Nguyen,Thai Nguyen City,2,2,0,2,2
2022-07-22,Thai Nguyen,Thai Nguyen City,3,2,0,2,2
2022-07-22,Thai Nguyen,Thai Nguyen City,5,2,0,2,2
2022-07-22,Thai Nguyen,Thai Nguyen City,6,17,16,1,1
2022-07-22,Thai Nguyen,Thai Nguyen City,7,87,82,5,0
2022-07-22,Thai Nguyen,Thai Nguyen City,8,143,134,9,0
2022-07-22,Thai Nguyen,Thai Nguyen City,9,107,96,11,0
2022-07-22,Thai Nguyen,Thai Nguyen City,10,188,170,18,0
2022-07-22,Thai Nguyen,Thai Nguyen City,11,393,363,30,4
2022-07-22,Thai Nguyen,Thai Nguyen City,12,256,228,28,3
2022-07-22,Thai Nguyen,Thai Nguyen City,13,140,131,9,0
2022-07-22,Thai Nguyen,Thai Nguyen City,14,175,153,22,2
2022-07-22,Thai Nguyen,Thai Nguyen City,15,151,137,14,2
2022-07-22,Thai Nguyen,Thai Nguyen City,16,97,75,22,7
2022-07-22,Thai Nguyen,Thai Nguyen City,17,172,154,18,3
2022-07-22,Thai Nguyen,Thai Nguyen City,18,210,196,14,0
2022-07-22,Thai Nguyen,Thai Nguyen City,19,210,188,22,6
2022-07-22,Thai Nguyen,Thai Nguyen City,20,177,161,16,2
2022-07-22,Thai Nguyen,Thai Nguyen City,21,115,109,6,1
2022-07-22,Thai Nguyen,Thai Nguyen City,22,31,21,10,1
2022-07-22,Thai Nguyen,Thai Nguyen City,23,4,2,2,0
2022-07-22,Vung Tau,Ba Ria City,8,4,1,3,2
2022-07-22,Vung Tau,Ba Ria City,9,9,6,3,3
2022-07-22,Vung Tau,Ba Ria City,10,3,3,0,0
2022-07-22,Vung Tau,Ba Ria City,11,8,5,3,2
2022-07-22,Vung Tau,Ba Ria City,12,6,3,3,1
2022-07-22,Vung Tau,Ba Ria City,13,4,4,0,0
2022-07-22,Vung Tau,Ba Ria City,14,7,4,3,2
2022-07-22,Vung Tau,Ba Ria City,15,1,0,1,1
2022-07-22,Vung Tau,Ba Ria City,16,3,1,2,2
2022-07-22,Vung Tau,Ba Ria City,17,6,1,5,3
2022-07-22,Vung Tau,Ba Ria City,18,6,3,3,3
2022-07-22,Vung Tau,Ba Ria City,19,5,0,5,4
2022-07-22,Vung Tau,Ba Ria City,20,1,0,1,1
2022-07-22,Vung Tau,Ba Ria City,21,3,0,3,2
2022-07-22,Vung Tau,Ba Ria City,22,6,0,6,6
2022-07-22,Vung Tau,Chau Duc,9,1,0,1,0
2022-07-22,Vung Tau,Chau Duc,11,1,0,1,1
2022-07-22,Vung Tau,Chau Duc,18,1,0,1,0
2022-07-22,Vung Tau,Long Son,11,1,1,0,0
2022-07-22,Vung Tau,Long Son,18,1,1,0,0
2022-07-22,Vung Tau,Long Son,19,1,1,0,0
2022-07-22,Vung Tau,Tan Thanh,17,1,0,1,1
2022-07-22,Vung Tau,Vung Tau City,0,5,4,1,0
2022-07-22,Vung Tau,Vung Tau City,1,2,0,2,2
2022-07-22,Vung Tau,Vung Tau City,2,1,0,1,1
2022-07-22,Vung Tau,Vung Tau City,3,2,2,0,0
2022-07-22,Vung Tau,Vung Tau City,5,3,2,1,0
2022-07-22,Vung Tau,Vung Tau City,6,31,28,3,0
2022-07-22,Vung Tau,Vung Tau City,7,95,81,14,4
2022-07-22,Vung Tau,Vung Tau City,8,192,177,15,4
2022-07-22,Vung Tau,Vung Tau City,9,205,186,19,1
2022-07-22,Vung Tau,Vung Tau City,10,239,210,29,7
2022-07-22,Vung Tau,Vung Tau City,11,365,325,40,5
2022-07-22,Vung Tau,Vung Tau City,12,341,317,24,1
2022-07-22,Vung Tau,Vung Tau City,13,274,225,49,6
2022-07-22,Vung Tau,Vung Tau City,14,289,253,36,6
2022-07-22,Vung Tau,Vung Tau City,15,239,219,20,3
2022-07-22,Vung Tau,Vung Tau City,16,172,163,9,1
2022-07-22,Vung Tau,Vung Tau City,17,245,224,21,2
2022-07-22,Vung Tau,Vung Tau City,18,314,287,27,4
2022-07-22,Vung Tau,Vung Tau City,19,254,220,34,4
2022-07-22,Vung Tau,Vung Tau City,20,202,180,22,1
2022-07-22,Vung Tau,Vung Tau City,21,105,91,14,0
2022-07-22,Vung Tau,Vung Tau City,22,46,30,16,1
2022-07-22,Vung Tau,Vung Tau City,23,12,11,1,0
2022-07-23,Bac Ninh,Bác Ninh City,0,1,1,0,0
2022-07-23,Bac Ninh,Bác Ninh City,1,9,3,6,4
2022-07-23,Bac Ninh,Bác Ninh City,2,5,1,4,4
2022-07-23,Bac Ninh,Bác Ninh City,5,1,0,1,1
2022-07-23,Bac Ninh,Bác Ninh City,6,14,11,3,2
2022-07-23,Bac Ninh,Bác Ninh City,7,68,63,5,0
2022-07-23,Bac Ninh,Bác Ninh City,8,124,111,13,0
2022-07-23,Bac Ninh,Bác Ninh City,9,110,104,6,0
2022-07-23,Bac Ninh,Bác Ninh City,10,167,151,16,2
2022-07-23,Bac Ninh,Bác Ninh City,11,338,306,32,4
2022-07-23,Bac Ninh,Bác Ninh City,12,256,229,27,2
2022-07-23,Bac Ninh,Bác Ninh City,13,168,157,11,1
2022-07-23,Bac Ninh,Bác Ninh City,14,133,123,10,0
2022-07-23,Bac Ninh,Bác Ninh City,15,173,148,25,2
2022-07-23,Bac Ninh,Bác Ninh City,16,118,105,13,0
2022-07-23,Bac Ninh,Bác Ninh City,17,125,119,6,0
2022-07-23,Bac Ninh,Bác Ninh City,18,170,159,11,1
2022-07-23,Bac Ninh,Bác Ninh City,19,196,181,15,2
2022-07-23,Bac Ninh,Bác Ninh City,20,154,135,19,3
2022-07-23,Bac Ninh,Bác Ninh City,21,82,71,11,1
2022-07-23,Bac Ninh,Bác Ninh City,22,17,15,2,0
2022-07-23,Bac Ninh,Bác Ninh City,23,14,11,3,1
2022-07-23,Bac Ninh,Que Vo,9,2,1,1,1
2022-07-23,Bac Ninh,Que Vo,10,4,2,2,2
2022-07-23,Bac Ninh,Que Vo,11,3,1,2,2
2022-07-23,Bac Ninh,Que Vo,12,1,0,1,1
2022-07-23,Bac Ninh,Que Vo,13,2,0,2,2
2022-07-23,Bac Ninh,Que Vo,14,5,2,3,3
2022-07-23,Bac Ninh,Que Vo,15,4,1,3,3
2022-07-23,Bac Ninh,Que Vo,17,1,0,1,1
2022-07-23,Bac Ninh,Que Vo,18,1,0,1,1
2022-07-23,Bac Ninh,Que Vo,19,2,0,2,2
2022-07-23,Bac Ninh,Que Vo,21,2,0,2,2
2022-07-23,Bac Ninh,Tien Du,9,1,0,1,1
2022-07-23,Bac Ninh,Tien Du,10,2,0,2,1
2022-07-23,Bac Ninh,Tien Du,11,1,0,1,0
2022-07-23,Bac Ninh,Tien Du,12,7,0,7,7
2022-07-23,Bac Ninh,Tien Du,14,1,0,1,0
2022-07-23,Bac Ninh,Tien Du,16,1,0,1,1
2022-07-23,Bac Ninh,Tien Du,18,2,0,2,2
2022-07-23,Bac Ninh,Tien Du,20,1,0,1,1
2022-07-23,Bac Ninh,Tien Du,21,1,0,1,0
2022-07-23,Bac Ninh,Tu Son,9,1,0,1,1
2022-07-23,Bac Ninh,Tu Son,10,3,0,3,3
2022-07-23,Bac Ninh,Tu Son,12,9,0,9,7
2022-07-23,Bac Ninh,Tu Son,13,2,0,2,2
2022-07-23,Bac Ninh,Tu Son,15,1,0,1,1
2022-07-23,Bac Ninh,Tu Son,18,1,0,1,1
2022-07-23,Bac Ninh,Tu Son,19,1,0,1,1
2022-07-23,Bac Ninh,Tu Son,21,2,0,2,1
2022-07-23,Binh Duong,Ben Cat,9,1,0,1,1
2022-07-23,Binh Duong,Ben Cat,10,4,0,4,3
2022-07-23,Binh Duong,Ben Cat,11,1,0,1,1
2022-07-23,Binh Duong,Ben Cat,13,1,0,1,0
2022-07-23,Binh Duong,Ben Cat,14,2,0,2,1
2022-07-23,Binh Duong,Ben Cat,15,2,0,2,2
2022-07-23,Binh Duong,Ben Cat,19,3,0,3,3
2022-07-23,Binh Duong,Ben Cat,20,3,0,3,3
2022-07-23,Binh Duong,Ben Cat,21,3,0,3,2
2022-07-23,Binh Duong,Di An,0,1,0,1,1
2022-07-23,Binh Duong,Di An,1,4,0,4,4
2022-07-23,Binh Duong,Di An,2,4,1,3,3
2022-07-23,Binh Duong,Di An,6,1,0,1,1
2022-07-23,Binh Duong,Di An,7,3,1,2,2
2022-07-23,Binh Duong,Di An,8,19,7,12,7
2022-07-23,Binh Duong,Di An,9,24,18,6,5
2022-07-23,Binh Duong,Di An,10,53,34,19,12
2022-07-23,Binh Duong,Di An,11,64,39,25,18
2022-07-23,Binh Duong,Di An,12,51,35,16,10
2022-07-23,Binh Duong,Di An,13,46,34,12,9
2022-07-23,Binh Duong,Di An,14,29,22,7,3
2022-07-23,Binh Duong,Di An,15,35,26,9,4
2022-07-23,Binh Duong,Di An,16,29,23,6,2
2022-07-23,Binh Duong,Di An,17,41,30,11,8
2022-07-23,Binh Duong,Di An,18,29,23,6,5
2022-07-23,Binh Duong,Di An,19,29,24,5,4
2022-07-23,Binh Duong,Di An,20,24,19,5,1
2022-07-23,Binh Duong,Di An,21,12,10,2,1
2022-07-23,Binh Duong,Di An,22,8,2,6,4
2022-07-23,Binh Duong,Di An,23,4,0,4,4
2022-07-23,Binh Duong,Tan Uyen,8,1,0,1,0
2022-07-23,Binh Duong,Tan Uyen,9,5,1,4,3
2022-07-23,Binh Duong,Tan Uyen,10,4,2,2,2
2022-07-23,Binh Duong,Tan Uyen,11,13,7,6,3
2022-07-23,Binh Duong,Tan Uyen,12,4,2,2,2
2022-07-23,Binh Duong,Tan Uyen,13,1,0,1,1
2022-07-23,Binh Duong,Tan Uyen,14,3,1,2,2
2022-07-23,Binh Duong,Tan Uyen,15,5,0,5,4
2022-07-23,Binh Duong,Tan Uyen,16,1,0,1,0
2022-07-23,Binh Duong,Tan Uyen,17,1,1,0,0
2022-07-23,Binh Duong,Tan Uyen,19,2,1,1,0
2022-07-23,Binh Duong,Tan Uyen,21,5,0,5,3
2022-07-23,Binh Duong,Thu Dau Mot Town,0,5,2,3,1
2022-07-23,Binh Duong,Thu Dau Mot Town,1,6,2,4,2
2022-07-23,Binh Duong,Thu Dau Mot Town,2,2,0,2,2
2022-07-23,Binh Duong,Thu Dau Mot Town,4,1,0,1,1
2022-07-23,Binh Duong,Thu Dau Mot Town,5,4,1,3,3
2022-07-23,Binh Duong,Thu Dau Mot Town,6,42,31,11,6
2022-07-23,Binh Duong,Thu Dau Mot Town,7,142,138,4,1
2022-07-23,Binh Duong,Thu Dau Mot Town,8,227,210,17,2
2022-07-23,Binh Duong,Thu Dau Mot Town,9,295,279,16,4
2022-07-23,Binh Duong,Thu Dau Mot Town,10,400,373,27,6
2022-07-23,Binh Duong,Thu Dau Mot Town,11,607,559,48,4
2022-07-23,Binh Duong,Thu Dau Mot Town,12,550,513,37,6
2022-07-23,Binh Duong,Thu Dau Mot Town,13,398,359,39,10
2022-07-23,Binh Duong,Thu Dau Mot Town,14,366,338,28,9
2022-07-23,Binh Duong,Thu Dau Mot Town,15,333,304,29,7
2022-07-23,Binh Duong,Thu Dau Mot Town,16,343,305,38,14
2022-07-23,Binh Duong,Thu Dau Mot Town,17,426,373,53,13
2022-07-23,Binh Duong,Thu Dau Mot Town,18,497,389,108,74
2022-07-23,Binh Duong,Thu Dau Mot Town,19,516,401,115,64
2022-07-23,Binh Duong,Thu Dau Mot Town,20,422,332,90,50
2022-07-23,Binh Duong,Thu Dau Mot Town,21,182,139,43,15
2022-07-23,Binh Duong,Thu Dau Mot Town,22,36,25,11,4
2022-07-23,Binh Duong,Thu Dau Mot Town,23,20,11,9,4
2022-07-23,Binh Duong,Thuan An,4,1,0,1,1
2022-07-23,Binh Duong,Thuan An,5,2,0,2,2
2022-07-23,Binh Duong,Thuan An,6,1,1,0,0
2022-07-23,Binh Duong,Thuan An,7,7,3,4,2
2022-07-23,Binh Duong,Thuan An,8,21,15,6,2
2022-07-23,Binh Duong,Thuan An,9,51,36,15,11
2022-07-23,Binh Duong,Thuan An,10,89,71,18,13
2022-07-23,Binh Duong,Thuan An,11,70,62,8,0
2022-07-23,Binh Duong,Thuan An,12,79,70,9,5
2022-07-23,Binh Duong,Thuan An,13,66,54,12,4
2022-07-23,Binh Duong,Thuan An,14,54,42,12,8
2022-07-23,Binh Duong,Thuan An,15,58,44,14,9
2022-07-23,Binh Duong,Thuan An,16,39,28,11,8
2022-07-23,Binh Duong,Thuan An,17,54,48,6,0
2022-07-23,Binh Duong,Thuan An,18,48,44,4,2
2022-07-23,Binh Duong,Thuan An,19,63,43,20,8
2022-07-23,Binh Duong,Thuan An,20,55,40,15,10
2022-07-23,Binh Duong,Thuan An,21,28,16,12,7
2022-07-23,Binh Duong,Thuan An,22,5,1,4,3
2022-07-23,Binh Duong,Thuan An,23,7,1,6,5
2022-07-23,Can Tho City,Binh Thuy District,7,1,0,1,0
2022-07-23,Can Tho City,Binh Thuy District,8,6,6,0,0
2022-07-23,Can Tho City,Binh Thuy District,9,12,11,1,0
2022-07-23,Can Tho City,Binh Thuy District,10,11,8,3,0
2022-07-23,Can Tho City,Binh Thuy District,11,16,14,2,0
2022-07-23,Can Tho City,Binh Thuy District,12,15,10,5,2
2022-07-23,Can Tho City,Binh Thuy District,13,10,9,1,0
2022-07-23,Can Tho City,Binh Thuy District,14,13,11,2,0
2022-07-23,Can Tho City,Binh Thuy District,15,8,8,0,0
2022-07-23,Can Tho City,Binh Thuy District,16,14,14,0,0
2022-07-23,Can Tho City,Binh Thuy District,17,14,11,3,1
2022-07-23,Can Tho City,Binh Thuy District,18,17,13,4,1
2022-07-23,Can Tho City,Binh Thuy District,19,13,12,1,1
2022-07-23,Can Tho City,Binh Thuy District,20,5,5,0,0
2022-07-23,Can Tho City,Binh Thuy District,21,8,4,4,0
2022-07-23,Can Tho City,Cai Rang District,6,2,1,1,1
2022-07-23,Can Tho City,Cai Rang District,7,5,2,3,2
2022-07-23,Can Tho City,Cai Rang District,8,9,7,2,0
2022-07-23,Can Tho City,Cai Rang District,9,5,5,0,0
2022-07-23,Can Tho City,Cai Rang District,10,11,11,0,0
2022-07-23,Can Tho City,Cai Rang District,11,17,17,0,0
2022-07-23,Can Tho City,Cai Rang District,12,9,9,0,0
2022-07-23,Can Tho City,Cai Rang District,13,8,8,0,0
2022-07-23,Can Tho City,Cai Rang District,14,7,7,0,0
2022-07-23,Can Tho City,Cai Rang District,15,15,8,7,1
2022-07-23,Can Tho City,Cai Rang District,16,10,9,1,0
2022-07-23,Can Tho City,Cai Rang District,17,11,11,0,0
2022-07-23,Can Tho City,Cai Rang District,18,15,12,3,0
2022-07-23,Can Tho City,Cai Rang District,19,11,7,4,0
2022-07-23,Can Tho City,Cai Rang District,20,9,6,3,0
2022-07-23,Can Tho City,Cai Rang District,21,7,4,3,1
2022-07-23,Can Tho City,Ninh Kieu District,0,9,7,2,0
2022-07-23,Can Tho City,Ninh Kieu District,1,1,1,0,0
2022-07-23,Can Tho City,Ninh Kieu District,2,2,1,1,0
2022-07-23,Can Tho City,Ninh Kieu District,3,2,1,1,1
2022-07-23,Can Tho City,Ninh Kieu District,4,3,0,3,3
2022-07-23,Can Tho City,Ninh Kieu District,5,2,1,1,1
2022-07-23,Can Tho City,Ninh Kieu District,6,37,35,2,0
2022-07-23,Can Tho City,Ninh Kieu District,7,128,114,14,1
2022-07-23,Can Tho City,Ninh Kieu District,8,210,194,16,0
2022-07-23,Can Tho City,Ninh Kieu District,9,300,282,18,0
2022-07-23,Can Tho City,Ninh Kieu District,10,462,440,22,0
2022-07-23,Can Tho City,Ninh Kieu District,11,729,680,49,3
2022-07-23,Can Tho City,Ninh Kieu District,12,626,599,27,1
2022-07-23,Can Tho City,Ninh Kieu District,13,491,471,20,1
2022-07-23,Can Tho City,Ninh Kieu District,14,427,413,14,0
2022-07-23,Can Tho City,Ninh Kieu District,15,371,357,14,0
2022-07-23,Can Tho City,Ninh Kieu District,16,442,422,20,0
2022-07-23,Can Tho City,Ninh Kieu District,17,483,466,17,0
2022-07-23,Can Tho City,Ninh Kieu District,18,475,455,20,0
2022-07-23,Can Tho City,Ninh Kieu District,19,428,411,17,0
2022-07-23,Can Tho City,Ninh Kieu District,20,345,323,22,0
2022-07-23,Can Tho City,Ninh Kieu District,21,204,189,15,0
2022-07-23,Can Tho City,Ninh Kieu District,22,47,38,9,1
2022-07-23,Can Tho City,Ninh Kieu District,23,13,12,1,0
2022-07-23,Can Tho City,Thoi Lai,13,1,0,1,1
2022-07-23,Can Tho City,Thoi Lai,14,1,0,1,1
2022-07-23,Dong Nai,Bien Hoa City,0,6,5,1,0
2022-07-23,Dong Nai,Bien Hoa City,1,5,1,4,2
2022-07-23,Dong Nai,Bien Hoa City,2,6,1,5,4
2022-07-23,Dong Nai,Bien Hoa City,3,1,1,0,0
2022-07-23,Dong Nai,Bien Hoa City,4,1,0,1,1
2022-07-23,Dong Nai,Bien Hoa City,5,6,2,4,4
2022-07-23,Dong Nai,Bien Hoa City,6,41,30,11,6
2022-07-23,Dong Nai,Bien Hoa City,7,189,166,23,4
2022-07-23,Dong Nai,Bien Hoa City,8,310,285,25,4
2022-07-23,Dong Nai,Bien Hoa City,9,504,460,44,6
2022-07-23,Dong Nai,Bien Hoa City,10,825,762,63,6
2022-07-23,Dong Nai,Bien Hoa City,11,1100,1030,70,10
2022-07-23,Dong Nai,Bien Hoa City,12,968,907,61,7
2022-07-23,Dong Nai,Bien Hoa City,13,817,767,50,5
2022-07-23,Dong Nai,Bien Hoa City,14,699,656,43,2
2022-07-23,Dong Nai,Bien Hoa City,15,588,545,43,2
2022-07-23,Dong Nai,Bien Hoa City,16,534,497,37,4
2022-07-23,Dong Nai,Bien Hoa City,17,676,621,55,9
2022-07-23,Dong Nai,Bien Hoa City,18,936,831,105,27
2022-07-23,Dong Nai,Bien Hoa City,19,925,795,130,37
2022-07-23,Dong Nai,Bien Hoa City,20,663,578,85,18
2022-07-23,Dong Nai,Bien Hoa City,21,286,225,61,11
2022-07-23,Dong Nai,Bien Hoa City,22,62,47,15,2
2022-07-23,Dong Nai,Bien Hoa City,23,24,14,10,6
2022-07-23,Dong Nai,Long Khanh,13,3,0,3,2
2022-07-23,Dong Nai,Long Khanh,19,1,0,1,1
2022-07-23,Dong Nai,Long Thanh,10,1,0,1,1
2022-07-23,Dong Nai,Long Thanh,14,3,0,3,3
2022-07-23,Dong Nai,Long Thanh,17,1,0,1,1
2022-07-23,Dong Nai,Long Thanh,18,3,0,3,2
2022-07-23,Dong Nai,Long Thanh,19,1,0,1,1
2022-07-23,Dong Nai,Nhon trach,12,1,0,1,0
2022-07-23,Dong Nai,Nhon trach,13,1,0,1,0
2022-07-23,Dong Nai,Nhon trach,14,1,0,1,1
2022-07-23,Dong Nai,Nhon trach,19,2,0,2,1
2022-07-23,Dong Nai,Trang Bom,12,2,0,2,1
2022-07-23,Dong Nai,Trang Bom,13,1,0,1,1
2022-07-23,Dong Nai,Trang Bom,14,1,1,0,0
2022-07-23,Dong Nai,Vinh Cuu,8,1,0,1,0
2022-07-23,Hai Phong City,An Duong,5,1,1,0,0
2022-07-23,Hai Phong City,An Duong,8,2,2,0,0
2022-07-23,Hai Phong City,An Duong,9,1,1,0,0
2022-07-23,Hai Phong City,An Duong,10,9,7,2,1
2022-07-23,Hai Phong City,An Duong,11,2,2,0,0
2022-07-23,Hai Phong City,An Duong,12,5,3,2,2
2022-07-23,Hai Phong City,An Duong,13,4,2,2,0
2022-07-23,Hai Phong City,An Duong,14,2,2,0,0
2022-07-23,Hai Phong City,An Duong,15,4,2,2,1
2022-07-23,Hai Phong City,An Duong,16,1,1,0,0
2022-07-23,Hai Phong City,An Duong,17,1,1,0,0
2022-07-23,Hai Phong City,An Duong,18,5,4,1,0
2022-07-23,Hai Phong City,An Duong,19,6,3,3,2
2022-07-23,Hai Phong City,An Duong,20,1,0,1,1
2022-07-23,Hai Phong City,An Duong,21,2,0,2,2
2022-07-23,Hai Phong City,Hai An District,0,1,0,1,1
2022-07-23,Hai Phong City,Hai An District,6,3,1,2,2
2022-07-23,Hai Phong City,Hai An District,7,7,3,4,3
2022-07-23,Hai Phong City,Hai An District,8,21,17,4,2
2022-07-23,Hai Phong City,Hai An District,9,19,14,5,0
2022-07-23,Hai Phong City,Hai An District,10,30,26,4,1
2022-07-23,Hai Phong City,Hai An District,11,48,45,3,2
2022-07-23,Hai Phong City,Hai An District,12,34,31,3,1
2022-07-23,Hai Phong City,Hai An District,13,17,14,3,0
2022-07-23,Hai Phong City,Hai An District,14,17,16,1,0
2022-07-23,Hai Phong City,Hai An District,15,15,13,2,1
2022-07-23,Hai Phong City,Hai An District,16,22,18,4,3
2022-07-23,Hai Phong City,Hai An District,17,20,17,3,0
2022-07-23,Hai Phong City,Hai An District,18,27,21,6,0
2022-07-23,Hai Phong City,Hai An District,19,20,18,2,0
2022-07-23,Hai Phong City,Hai An District,20,13,11,2,0
2022-07-23,Hai Phong City,Hai An District,21,10,7,3,1
2022-07-23,Hai Phong City,Hai An District,22,5,2,3,2
2022-07-23,Hai Phong City,Hai An District,23,2,1,1,1
2022-07-23,Hai Phong City,Hong Bang District,1,1,1,0,0
2022-07-23,Hai Phong City,Hong Bang District,5,1,0,1,0
2022-07-23,Hai Phong City,Hong Bang District,6,5,3,2,1
2022-07-23,Hai Phong City,Hong Bang District,7,16,13,3,1
2022-07-23,Hai Phong City,Hong Bang District,8,30,24,6,2
2022-07-23,Hai Phong City,Hong Bang District,9,44,38,6,0
2022-07-23,Hai Phong City,Hong Bang District,10,73,62,11,2
2022-07-23,Hai Phong City,Hong Bang District,11,130,111,19,8
2022-07-23,Hai Phong City,Hong Bang District,12,111,97,14,4
2022-07-23,Hai Phong City,Hong Bang District,13,46,41,5,4
2022-07-23,Hai Phong City,Hong Bang District,14,54,51,3,0
2022-07-23,Hai Phong City,Hong Bang District,15,56,44,12,0
2022-07-23,Hai Phong City,Hong Bang District,16,39,34,5,2
2022-07-23,Hai Phong City,Hong Bang District,17,59,49,10,2
2022-07-23,Hai Phong City,Hong Bang District,18,68,54,14,11
2022-07-23,Hai Phong City,Hong Bang District,19,60,47,13,6
2022-07-23,Hai Phong City,Hong Bang District,20,44,35,9,3
2022-07-23,Hai Phong City,Hong Bang District,21,19,14,5,1
2022-07-23,Hai Phong City,Hong Bang District,22,2,0,2,1
2022-07-23,Hai Phong City,Hong Bang District,23,2,0,2,1
2022-07-23,Hai Phong City,Kien An District,0,2,0,2,2
2022-07-23,Hai Phong City,Kien An District,7,1,1,0,0
2022-07-23,Hai Phong City,Kien An District,8,3,2,1,0
2022-07-23,Hai Phong City,Kien An District,9,12,9,3,0
2022-07-23,Hai Phong City,Kien An District,10,11,9,2,0
2022-07-23,Hai Phong City,Kien An District,11,15,15,0,0
2022-07-23,Hai Phong City,Kien An District,12,11,9,2,2
2022-07-23,Hai Phong City,Kien An District,13,13,10,3,3
2022-07-23,Hai Phong City,Kien An District,14,19,12,7,5
2022-07-23,Hai Phong City,Kien An District,15,6,5,1,0
2022-07-23,Hai Phong City,Kien An District,16,11,10,1,0
2022-07-23,Hai Phong City,Kien An District,17,10,9,1,0
2022-07-23,Hai Phong City,Kien An District,18,11,9,2,0
2022-07-23,Hai Phong City,Kien An District,19,14,7,7,3
2022-07-23,Hai Phong City,Kien An District,20,16,7,9,9
2022-07-23,Hai Phong City,Kien An District,21,6,2,4,3
2022-07-23,Hai Phong City,Le Chan District,0,1,0,1,0
2022-07-23,Hai Phong City,Le Chan District,1,2,0,2,1
2022-07-23,Hai Phong City,Le Chan District,2,2,0,2,1
2022-07-23,Hai Phong City,Le Chan District,3,1,0,1,1
2022-07-23,Hai Phong City,Le Chan District,4,1,0,1,1
2022-07-23,Hai Phong City,Le Chan District,6,6,4,2,2
2022-07-23,Hai Phong City,Le Chan District,7,46,39,7,4
2022-07-23,Hai Phong City,Le Chan District,8,94,84,10,1
2022-07-23,Hai Phong City,Le Chan District,9,116,98,18,1
2022-07-23,Hai Phong City,Le Chan District,10,215,194,21,2
2022-07-23,Hai Phong City,Le Chan District,11,386,348,38,14
2022-07-23,Hai Phong City,Le Chan District,12,288,259,29,2
2022-07-23,Hai Phong City,Le Chan District,13,177,161,16,1
2022-07-23,Hai Phong City,Le Chan District,14,175,148,27,5
2022-07-23,Hai Phong City,Le Chan District,15,191,170,21,7
2022-07-23,Hai Phong City,Le Chan District,16,187,167,20,5
2022-07-23,Hai Phong City,Le Chan District,17,224,192,32,9
2022-07-23,Hai Phong City,Le Chan District,18,284,241,43,13
2022-07-23,Hai Phong City,Le Chan District,19,265,225,40,11
2022-07-23,Hai Phong City,Le Chan District,20,150,133,17,5
2022-07-23,Hai Phong City,Le Chan District,21,71,55,16,5
2022-07-23,Hai Phong City,Le Chan District,22,19,13,6,0
2022-07-23,Hai Phong City,Le Chan District,23,11,7,4,3
2022-07-23,Hai Phong City,Ngo Quyen District,0,2,1,1,0
2022-07-23,Hai Phong City,Ngo Quyen District,5,1,1,0,0
2022-07-23,Hai Phong City,Ngo Quyen District,6,2,1,1,0
2022-07-23,Hai Phong City,Ngo Quyen District,7,22,18,4,0
2022-07-23,Hai Phong City,Ngo Quyen District,8,80,66,14,3
2022-07-23,Hai Phong City,Ngo Quyen District,9,96,88,8,0
2022-07-23,Hai Phong City,Ngo Quyen District,10,161,143,18,5
2022-07-23,Hai Phong City,Ngo Quyen District,11,272,246,26,8
2022-07-23,Hai Phong City,Ngo Quyen District,12,232,207,25,4
2022-07-23,Hai Phong City,Ngo Quyen District,13,148,136,12,5
2022-07-23,Hai Phong City,Ngo Quyen District,14,153,133,20,4
2022-07-23,Hai Phong City,Ngo Quyen District,15,152,141,11,4
2022-07-23,Hai Phong City,Ngo Quyen District,16,142,123,19,2
2022-07-23,Hai Phong City,Ngo Quyen District,17,146,127,19,3
2022-07-23,Hai Phong City,Ngo Quyen District,18,180,157,23,6
2022-07-23,Hai Phong City,Ngo Quyen District,19,173,149,24,7
2022-07-23,Hai Phong City,Ngo Quyen District,20,127,109,18,4
2022-07-23,Hai Phong City,Ngo Quyen District,21,98,80,18,6
2022-07-23,Hai Phong City,Ngo Quyen District,22,12,9,3,1
2022-07-23,Hai Phong City,Ngo Quyen District,23,8,5,3,3
2022-07-23,Hai Phong City,Thuy Nguyen,9,1,0,1,1
2022-07-23,Hai Phong City,Thuy Nguyen,15,1,0,1,1
2022-07-23,Hai Phong City,Thuy Nguyen,17,1,0,1,1
2022-07-23,Hai Phong City,Thuy Nguyen,18,2,0,2,2
2022-07-23,Hai Phong City,Thuy Nguyen,19,1,0,1,1
2022-07-23,Hue City,Hue City,0,8,4,4,4
2022-07-23,Hue City,Hue City,1,5,2,3,3
2022-07-23,Hue City,Hue City,2,7,2,5,2
2022-07-23,Hue City,Hue City,3,1,1,0,0
2022-07-23,Hue City,Hue City,4,1,0,1,1
2022-07-23,Hue City,Hue City,5,6,3,3,2
2022-07-23,Hue City,Hue City,6,68,61,7,1
2022-07-23,Hue City,Hue City,7,218,197,21,1
2022-07-23,Hue City,Hue City,8,343,319,24,0
2022-07-23,Hue City,Hue City,9,345,317,28,2
2022-07-23,Hue City,Hue City,10,449,421,28,1
2022-07-23,Hue City,Hue City,11,948,878,70,9
2022-07-23,Hue City,Hue City,12,657,606,51,1
2022-07-23,Hue City,Hue City,13,468,432,36,1
2022-07-23,Hue City,Hue City,14,373,342,31,0
2022-07-23,Hue City,Hue City,15,422,387,35,5
2022-07-23,Hue City,Hue City,16,488,447,41,2
2022-07-23,Hue City,Hue City,17,527,462,65,4
2022-07-23,Hue City,Hue City,18,584,516,68,8
2022-07-23,Hue City,Hue City,19,650,567,83,11
2022-07-23,Hue City,Hue City,20,443,387,56,10
2022-07-23,Hue City,Hue City,21,306,256,50,4
2022-07-23,Hue City,Hue City,22,70,49,21,4
2022-07-23,Hue City,Hue City,23,41,23,18,3
2022-07-23,Hue City,Huong Thuy,7,4,2,2,2
2022-07-23,Hue City,Huong Thuy,8,2,2,0,0
2022-07-23,Hue City,Huong Thuy,10,1,1,0,0
2022-07-23,Hue City,Huong Thuy,11,4,4,0,0
2022-07-23,Hue City,Huong Thuy,12,1,1,0,0
2022-07-23,Hue City,Huong Thuy,13,1,0,1,1
2022-07-23,Hue City,Huong Thuy,14,1,0,1,1
2022-07-23,Hue City,Huong Thuy,15,1,1,0,0
2022-07-23,Hue City,Huong Thuy,16,1,0,1,0
2022-07-23,Hue City,Huong Thuy,17,1,0,1,0
2022-07-23,Hue City,Huong Thuy,18,2,1,1,0
2022-07-23,Hue City,Huong Thuy,19,1,1,0,0
2022-07-23,Hue City,Huong Thuy,20,1,1,0,0
2022-07-23,Hue City,Huong Thuy,22,1,0,1,0
2022-07-23,Hue City,Huong Tra,19,1,0,1,1
2022-07-23,Hue City,Phu Vang,10,1,1,0,0
2022-07-23,Hue City,Phu Vang,11,1,1,0,0
2022-07-23,Hue City,Phu Vang,15,3,0,3,0
2022-07-23,Hue City,Phu Vang,16,1,1,0,0
2022-07-23,Hue City,Phu Vang,17,1,1,0,0
2022-07-23,Hue City,Phu Vang,18,2,2,0,0
2022-07-23,Hue City,Phu Vang,19,1,1,0,0
2022-07-23,Hue City,Phu Vang,20,3,1,2,2
2022-07-23,Khanh Hoa,Cam Ranh City,11,2,0,2,2
2022-07-23,Khanh Hoa,Cam Ranh City,21,2,0,2,1
2022-07-23,Khanh Hoa,Nha Trang City,0,12,6,6,4
2022-07-23,Khanh Hoa,Nha Trang City,1,1,0,1,0
2022-07-23,Khanh Hoa,Nha Trang City,2,1,0,1,1
2022-07-23,Khanh Hoa,Nha Trang City,3,1,0,1,1
2022-07-23,Khanh Hoa,Nha Trang City,5,1,1,0,0
2022-07-23,Khanh Hoa,Nha Trang City,6,35,33,2,0
2022-07-23,Khanh Hoa,Nha Trang City,7,148,126,22,1
2022-07-23,Khanh Hoa,Nha Trang City,8,204,186,18,2
2022-07-23,Khanh Hoa,Nha Trang City,9,219,198,21,2
2022-07-23,Khanh Hoa,Nha Trang City,10,234,223,11,2
2022-07-23,Khanh Hoa,Nha Trang City,11,390,352,38,2
2022-07-23,Khanh Hoa,Nha Trang City,12,388,353,35,3
2022-07-23,Khanh Hoa,Nha Trang City,13,251,233,18,0
2022-07-23,Khanh Hoa,Nha Trang City,14,246,230,16,1
2022-07-23,Khanh Hoa,Nha Trang City,15,229,209,20,1
2022-07-23,Khanh Hoa,Nha Trang City,16,238,208,30,3
2022-07-23,Khanh Hoa,Nha Trang City,17,279,250,29,4
2022-07-23,Khanh Hoa,Nha Trang City,18,292,272,20,0
2022-07-23,Khanh Hoa,Nha Trang City,19,321,294,27,4
2022-07-23,Khanh Hoa,Nha Trang City,20,204,188,16,0
2022-07-23,Khanh Hoa,Nha Trang City,21,136,111,25,4
2022-07-23,Khanh Hoa,Nha Trang City,22,52,33,19,3
2022-07-23,Khanh Hoa,Nha Trang City,23,19,12,7,2
2022-07-23,Lam Dong,Da Lat City,0,10,7,3,1
2022-07-23,Lam Dong,Da Lat City,1,3,0,3,2
2022-07-23,Lam Dong,Da Lat City,2,3,0,3,3
2022-07-23,Lam Dong,Da Lat City,3,1,0,1,1
2022-07-23,Lam Dong,Da Lat City,4,1,0,1,0
2022-07-23,Lam Dong,Da Lat City,5,5,2,3,3
2022-07-23,Lam Dong,Da Lat City,6,16,6,10,9
2022-07-23,Lam Dong,Da Lat City,7,47,35,12,7
2022-07-23,Lam Dong,Da Lat City,8,95,75,20,12
2022-07-23,Lam Dong,Da Lat City,9,91,68,23,9
2022-07-23,Lam Dong,Da Lat City,10,113,92,21,12
2022-07-23,Lam Dong,Da Lat City,11,139,117,22,14
2022-07-23,Lam Dong,Da Lat City,12,182,135,47,32
2022-07-23,Lam Dong,Da Lat City,13,154,96,58,34
2022-07-23,Lam Dong,Da Lat City,14,148,114,34,21
2022-07-23,Lam Dong,Da Lat City,15,146,92,54,32
2022-07-23,Lam Dong,Da Lat City,16,128,90,38,25
2022-07-23,Lam Dong,Da Lat City,17,158,111,47,26
2022-07-23,Lam Dong,Da Lat City,18,152,108,44,25
2022-07-23,Lam Dong,Da Lat City,19,178,123,55,33
2022-07-23,Lam Dong,Da Lat City,20,152,87,65,44
2022-07-23,Lam Dong,Da Lat City,21,101,48,53,39
2022-07-23,Lam Dong,Da Lat City,22,53,36,17,10
2022-07-23,Lam Dong,Da Lat City,23,17,11,6,0
2022-07-23,Nghe An,Vinh City,0,3,0,3,2
2022-07-23,Nghe An,Vinh City,1,1,0,1,0
2022-07-23,Nghe An,Vinh City,4,1,1,0,0
2022-07-23,Nghe An,Vinh City,6,17,9,8,7
2022-07-23,Nghe An,Vinh City,7,132,113,19,4
2022-07-23,Nghe An,Vinh City,8,164,138,26,1
2022-07-23,Nghe An,Vinh City,9,144,122,22,0
2022-07-23,Nghe An,Vinh City,10,195,173,22,3
2022-07-23,Nghe An,Vinh City,11,345,295,50,8
2022-07-23,Nghe An,Vinh City,12,259,228,31,5
2022-07-23,Nghe An,Vinh City,13,179,156,23,3
2022-07-23,Nghe An,Vinh City,14,176,149,27,6
2022-07-23,Nghe An,Vinh City,15,179,154,25,4
2022-07-23,Nghe An,Vinh City,16,168,145,23,7
2022-07-23,Nghe An,Vinh City,17,165,135,30,15
2022-07-23,Nghe An,Vinh City,18,194,160,34,10
2022-07-23,Nghe An,Vinh City,19,189,144,45,4
2022-07-23,Nghe An,Vinh City,20,127,97,30,8
2022-07-23,Nghe An,Vinh City,21,84,65,19,6
2022-07-23,Nghe An,Vinh City,22,21,13,8,2
2022-07-23,Nghe An,Vinh City,23,9,3,6,4
2022-07-23,Quang Nam,Dien Ban,17,1,0,1,1
2022-07-23,Quang Nam,Hoi An City,5,1,0,1,0
2022-07-23,Quang Nam,Hoi An City,6,4,0,4,1
2022-07-23,Quang Nam,Hoi An City,7,20,13,7,4
2022-07-23,Quang Nam,Hoi An City,8,22,16,6,5
2022-07-23,Quang Nam,Hoi An City,9,27,18,9,2
2022-07-23,Quang Nam,Hoi An City,10,40,30,10,0
2022-07-23,Quang Nam,Hoi An City,11,52,44,8,0
2022-07-23,Quang Nam,Hoi An City,12,42,30,12,3
2022-07-23,Quang Nam,Hoi An City,13,32,28,4,2
2022-07-23,Quang Nam,Hoi An City,14,41,32,9,1
2022-07-23,Quang Nam,Hoi An City,15,57,49,8,4
2022-07-23,Quang Nam,Hoi An City,16,62,47,15,6
2022-07-23,Quang Nam,Hoi An City,17,68,47,21,9
2022-07-23,Quang Nam,Hoi An City,18,56,47,9,3
2022-07-23,Quang Nam,Hoi An City,19,54,45,9,1
2022-07-23,Quang Nam,Hoi An City,20,60,41,19,6
2022-07-23,Quang Nam,Hoi An City,21,42,20,22,16
2022-07-23,Quang Nam,Hoi An City,22,10,6,4,0
2022-07-23,Quang Nam,Hoi An City,23,4,3,1,0
2022-07-23,Quang Ninh,Cam Pha City,11,3,0,3,3
2022-07-23,Quang Ninh,Cam Pha City,12,1,0,1,1
2022-07-23,Quang Ninh,Cam Pha City,16,1,0,1,1
2022-07-23,Quang Ninh,Cam Pha City,20,1,0,1,1
2022-07-23,Quang Ninh,Cam Pha City,21,2,0,2,2
2022-07-23,Quang Ninh,Ha Long City,0,3,1,2,1
2022-07-23,Quang Ninh,Ha Long City,1,1,0,1,1
2022-07-23,Quang Ninh,Ha Long City,6,8,1,7,6
2022-07-23,Quang Ninh,Ha Long City,7,21,5,16,11
2022-07-23,Quang Ninh,Ha Long City,8,46,31,15,8
2022-07-23,Quang Ninh,Ha Long City,9,80,52,28,13
2022-07-23,Quang Ninh,Ha Long City,10,124,82,42,21
2022-07-23,Quang Ninh,Ha Long City,11,167,121,46,27
2022-07-23,Quang Ninh,Ha Long City,12,154,109,45,26
2022-07-23,Quang Ninh,Ha Long City,13,118,71,47,27
2022-07-23,Quang Ninh,Ha Long City,14,84,50,34,18
2022-07-23,Quang Ninh,Ha Long City,15,97,71,26,14
2022-07-23,Quang Ninh,Ha Long City,16,72,44,28,8
2022-07-23,Quang Ninh,Ha Long City,17,69,54,15,5
2022-07-23,Quang Ninh,Ha Long City,18,68,51,17,5
2022-07-23,Quang Ninh,Ha Long City,19,95,59,36,17
2022-07-23,Quang Ninh,Ha Long City,20,80,34,46,29
2022-07-23,Quang Ninh,Ha Long City,21,63,26,37,28
2022-07-23,Quang Ninh,Ha Long City,22,34,14,20,15
2022-07-23,Quang Ninh,Ha Long City,23,27,10,17,7
2022-07-23,Quang Ninh,Hoanh Bo,7,1,1,0,0
2022-07-23,Thai Nguyen,Thai Nguyen City,0,3,2,1,1
2022-07-23,Thai Nguyen,Thai Nguyen City,1,1,1,0,0
2022-07-23,Thai Nguyen,Thai Nguyen City,2,1,0,1,0
2022-07-23,Thai Nguyen,Thai Nguyen City,6,13,8,5,2
2022-07-23,Thai Nguyen,Thai Nguyen City,7,82,76,6,0
2022-07-23,Thai Nguyen,Thai Nguyen City,8,146,131,15,1
2022-07-23,Thai Nguyen,Thai Nguyen City,9,134,119,15,1
2022-07-23,Thai Nguyen,Thai Nguyen City,10,173,161,12,3
2022-07-23,Thai Nguyen,Thai Nguyen City,11,367,328,39,2
2022-07-23,Thai Nguyen,Thai Nguyen City,12,315,285,30,0
2022-07-23,Thai Nguyen,Thai Nguyen City,13,180,166,14,2
2022-07-23,Thai Nguyen,Thai Nguyen City,14,165,146,19,1
2022-07-23,Thai Nguyen,Thai Nguyen City,15,149,142,7,0
2022-07-23,Thai Nguyen,Thai Nguyen City,16,136,127,9,2
2022-07-23,Thai Nguyen,Thai Nguyen City,17,148,134,14,3
2022-07-23,Thai Nguyen,Thai Nguyen City,18,192,175,17,2
2022-07-23,Thai Nguyen,Thai Nguyen City,19,259,230,29,6
2022-07-23,Thai Nguyen,Thai Nguyen City,20,174,155,19,0
2022-07-23,Thai Nguyen,Thai Nguyen City,21,117,108,9,1
2022-07-23,Thai Nguyen,Thai Nguyen City,22,28,23,5,1
2022-07-23,Thai Nguyen,Thai Nguyen City,23,16,10,6,2
2022-07-23,Vung Tau,Ba Ria City,7,3,0,3,0
2022-07-23,Vung Tau,Ba Ria City,8,4,3,1,1
2022-07-23,Vung Tau,Ba Ria City,9,5,4,1,1
2022-07-23,Vung Tau,Ba Ria City,10,3,3,0,0
2022-07-23,Vung Tau,Ba Ria City,11,4,2,2,1
2022-07-23,Vung Tau,Ba Ria City,12,10,8,2,1
2022-07-23,Vung Tau,Ba Ria City,13,6,4,2,1
2022-07-23,Vung Tau,Ba Ria City,14,10,5,5,0
2022-07-23,Vung Tau,Ba Ria City,15,4,4,0,0
2022-07-23,Vung Tau,Ba Ria City,16,9,3,6,4
2022-07-23,Vung Tau,Ba Ria City,17,2,2,0,0
2022-07-23,Vung Tau,Ba Ria City,18,4,2,2,1
2022-07-23,Vung Tau,Ba Ria City,19,4,2,2,1
2022-07-23,Vung Tau,Ba Ria City,20,2,0,2,2
2022-07-23,Vung Tau,Ba Ria City,21,2,0,2,2
2022-07-23,Vung Tau,Ba Ria City,22,2,0,2,1
2022-07-23,Vung Tau,Long Son,12,1,1,0,0
2022-07-23,Vung Tau,Long Son,18,1,0,1,0
2022-07-23,Vung Tau,Vung Tau City,0,12,4,8,5
2022-07-23,Vung Tau,Vung Tau City,1,4,0,4,4
2022-07-23,Vung Tau,Vung Tau City,3,1,0,1,0
2022-07-23,Vung Tau,Vung Tau City,5,2,1,1,0
2022-07-23,Vung Tau,Vung Tau City,6,45,31,14,10
2022-07-23,Vung Tau,Vung Tau City,7,116,106,10,2
2022-07-23,Vung Tau,Vung Tau City,8,185,174,11,1
2022-07-23,Vung Tau,Vung Tau City,9,229,201,28,1
2022-07-23,Vung Tau,Vung Tau City,10,294,266,28,4
2022-07-23,Vung Tau,Vung Tau City,11,419,383,36,7
2022-07-23,Vung Tau,Vung Tau City,12,399,364,35,4
2022-07-23,Vung Tau,Vung Tau City,13,312,282,30,4
2022-07-23,Vung Tau,Vung Tau City,14,315,292,23,2
2022-07-23,Vung Tau,Vung Tau City,15,257,233,24,0
2022-07-23,Vung Tau,Vung Tau City,16,256,240,16,2
2022-07-23,Vung Tau,Vung Tau City,17,316,284,32,5
2022-07-23,Vung Tau,Vung Tau City,18,366,322,44,8
2022-07-23,Vung Tau,Vung Tau City,19,321,282,39,10
2022-07-23,Vung Tau,Vung Tau City,20,226,189,37,8
2022-07-23,Vung Tau,Vung Tau City,21,144,126,18,1
2022-07-23,Vung Tau,Vung Tau City,22,49,34,15,3
2022-07-23,Vung Tau,Vung Tau City,23,23,14,9,3
2022-07-24,Bac Ninh,Bác Ninh City,0,10,7,3,1
2022-07-24,Bac Ninh,Bác Ninh City,1,6,5,1,0
2022-07-24,Bac Ninh,Bác Ninh City,2,1,0,1,1
2022-07-24,Bac Ninh,Bác Ninh City,5,2,0,2,1
2022-07-24,Bac Ninh,Bác Ninh City,6,14,9,5,1
2022-07-24,Bac Ninh,Bác Ninh City,7,49,45,4,1
2022-07-24,Bac Ninh,Bác Ninh City,8,110,100,10,0
2022-07-24,Bac Ninh,Bác Ninh City,9,148,136,12,1
2022-07-24,Bac Ninh,Bác Ninh City,10,214,193,21,4
2022-07-24,Bac Ninh,Bác Ninh City,11,361,330,31,3
2022-07-24,Bac Ninh,Bác Ninh City,12,258,238,20,3
2022-07-24,Bac Ninh,Bác Ninh City,13,162,153,9,1
2022-07-24,Bac Ninh,Bác Ninh City,14,108,102,6,1
2022-07-24,Bac Ninh,Bác Ninh City,15,138,124,14,0
2022-07-24,Bac Ninh,Bác Ninh City,16,143,137,6,0
2022-07-24,Bac Ninh,Bác Ninh City,17,148,131,17,0
2022-07-24,Bac Ninh,Bác Ninh City,18,186,174,12,1
2022-07-24,Bac Ninh,Bác Ninh City,19,234,210,24,4
2022-07-24,Bac Ninh,Bác Ninh City,20,158,141,17,4
2022-07-24,Bac Ninh,Bác Ninh City,21,93,82,11,2
2022-07-24,Bac Ninh,Bác Ninh City,22,22,20,2,0
2022-07-24,Bac Ninh,Bác Ninh City,23,18,14,4,1
2022-07-24,Bac Ninh,Que Vo,10,2,2,0,0
2022-07-24,Bac Ninh,Que Vo,12,3,1,2,2
2022-07-24,Bac Ninh,Que Vo,15,2,0,2,1
2022-07-24,Bac Ninh,Que Vo,17,1,0,1,0
2022-07-24,Bac Ninh,Que Vo,18,1,1,0,0
2022-07-24,Bac Ninh,Que Vo,20,1,0,1,1
2022-07-24,Bac Ninh,Que Vo,21,1,0,1,1
2022-07-24,Bac Ninh,Tien Du,0,1,0,1,0
2022-07-24,Bac Ninh,Tien Du,9,1,0,1,1
2022-07-24,Bac Ninh,Tien Du,10,1,0,1,1
2022-07-24,Bac Ninh,Tien Du,11,2,0,2,2
2022-07-24,Bac Ninh,Tien Du,12,3,0,3,2
2022-07-24,Bac Ninh,Tien Du,13,3,0,3,2
2022-07-24,Bac Ninh,Tien Du,14,1,0,1,0
2022-07-24,Bac Ninh,Tien Du,15,1,0,1,1
2022-07-24,Bac Ninh,Tien Du,20,3,0,3,1
2022-07-24,Bac Ninh,Tien Du,21,1,0,1,1
2022-07-24,Bac Ninh,Tien Du,22,1,0,1,1
2022-07-24,Bac Ninh,Tu Son,9,1,0,1,1
2022-07-24,Bac Ninh,Tu Son,10,1,0,1,1
2022-07-24,Bac Ninh,Tu Son,14,1,0,1,1
2022-07-24,Bac Ninh,Tu Son,15,6,0,6,6
2022-07-24,Bac Ninh,Tu Son,16,3,0,3,2
2022-07-24,Bac Ninh,Tu Son,17,1,0,1,1
2022-07-24,Bac Ninh,Tu Son,18,1,0,1,1
2022-07-24,Bac Ninh,Tu Son,20,1,0,1,1
2022-07-24,Bac Ninh,Tu Son,21,1,0,1,1
2022-07-24,Bac Ninh,Yen Phong,13,1,0,1,1
2022-07-24,Binh Duong,Ben Cat,8,1,0,1,1
2022-07-24,Binh Duong,Ben Cat,9,1,0,1,1
2022-07-24,Binh Duong,Ben Cat,11,2,0,2,2
2022-07-24,Binh Duong,Ben Cat,12,4,1,3,3
2022-07-24,Binh Duong,Ben Cat,13,2,0,2,2
2022-07-24,Binh Duong,Ben Cat,14,2,0,2,1
2022-07-24,Binh Duong,Ben Cat,15,1,0,1,1
2022-07-24,Binh Duong,Ben Cat,16,1,0,1,0
2022-07-24,Binh Duong,Ben Cat,20,1,0,1,1
2022-07-24,Binh Duong,Di An,0,5,0,5,2
2022-07-24,Binh Duong,Di An,1,1,0,1,1
2022-07-24,Binh Duong,Di An,3,1,0,1,1
2022-07-24,Binh Duong,Di An,6,2,0,2,2
2022-07-24,Binh Duong,Di An,7,8,3,5,5
2022-07-24,Binh Duong,Di An,8,16,5,11,9
2022-07-24,Binh Duong,Di An,9,23,15,8,6
2022-07-24,Binh Duong,Di An,10,32,24,8,5
2022-07-24,Binh Duong,Di An,11,68,46,22,6
2022-07-24,Binh Duong,Di An,12,58,46,12,5
2022-07-24,Binh Duong,Di An,13,38,29,9,6
2022-07-24,Binh Duong,Di An,14,38,28,10,4
2022-07-24,Binh Duong,Di An,15,40,26,14,12
2022-07-24,Binh Duong,Di An,16,31,25,6,5
2022-07-24,Binh Duong,Di An,17,46,31,15,9
2022-07-24,Binh Duong,Di An,18,36,30,6,1
2022-07-24,Binh Duong,Di An,19,31,22,9,5
2022-07-24,Binh Duong,Di An,20,33,23,10,7
2022-07-24,Binh Duong,Di An,21,11,6,5,4
2022-07-24,Binh Duong,Di An,22,1,1,0,0
2022-07-24,Binh Duong,Di An,23,3,0,3,2
2022-07-24,Binh Duong,Phu Giao,20,2,0,2,1
2022-07-24,Binh Duong,Tan Uyen,10,4,2,2,1
2022-07-24,Binh Duong,Tan Uyen,11,5,5,0,0
2022-07-24,Binh Duong,Tan Uyen,12,14,5,9,6
2022-07-24,Binh Duong,Tan Uyen,13,3,2,1,1
2022-07-24,Binh Duong,Tan Uyen,14,3,1,2,2
2022-07-24,Binh Duong,Tan Uyen,15,3,2,1,1
2022-07-24,Binh Duong,Tan Uyen,16,2,0,2,1
2022-07-24,Binh Duong,Tan Uyen,17,3,1,2,2
2022-07-24,Binh Duong,Tan Uyen,18,4,2,2,1
2022-07-24,Binh Duong,Tan Uyen,19,2,1,1,1
2022-07-24,Binh Duong,Tan Uyen,20,2,0,2,1
2022-07-24,Binh Duong,Tan Uyen,21,2,0,2,2
2022-07-24,Binh Duong,Thu Dau Mot Town,0,5,5,0,0
2022-07-24,Binh Duong,Thu Dau Mot Town,1,4,3,1,1
2022-07-24,Binh Duong,Thu Dau Mot Town,2,2,2,0,0
2022-07-24,Binh Duong,Thu Dau Mot Town,3,1,1,0,0
2022-07-24,Binh Duong,Thu Dau Mot Town,4,2,0,2,1
2022-07-24,Binh Duong,Thu Dau Mot Town,5,4,2,2,2
2022-07-24,Binh Duong,Thu Dau Mot Town,6,43,36,7,4
2022-07-24,Binh Duong,Thu Dau Mot Town,7,126,117,9,2
2022-07-24,Binh Duong,Thu Dau Mot Town,8,262,245,17,4
2022-07-24,Binh Duong,Thu Dau Mot Town,9,331,302,29,4
2022-07-24,Binh Duong,Thu Dau Mot Town,10,500,453,47,11
2022-07-24,Binh Duong,Thu Dau Mot Town,11,636,588,48,13
2022-07-24,Binh Duong,Thu Dau Mot Town,12,595,551,44,10
2022-07-24,Binh Duong,Thu Dau Mot Town,13,466,415,51,8
2022-07-24,Binh Duong,Thu Dau Mot Town,14,355,330,25,9
2022-07-24,Binh Duong,Thu Dau Mot Town,15,326,295,31,10
2022-07-24,Binh Duong,Thu Dau Mot Town,16,347,322,25,8
2022-07-24,Binh Duong,Thu Dau Mot Town,17,396,332,64,33
2022-07-24,Binh Duong,Thu Dau Mot Town,18,465,430,35,12
2022-07-24,Binh Duong,Thu Dau Mot Town,19,394,365,29,3
2022-07-24,Binh Duong,Thu Dau Mot Town,20,284,255,29,7
2022-07-24,Binh Duong,Thu Dau Mot Town,21,145,118,27,8
2022-07-24,Binh Duong,Thu Dau Mot Town,22,29,22,7,2
2022-07-24,Binh Duong,Thu Dau Mot Town,23,7,4,3,1
2022-07-24,Binh Duong,Thuan An,0,3,1,2,2
2022-07-24,Binh Duong,Thuan An,1,1,1,0,0
2022-07-24,Binh Duong,Thuan An,2,2,0,2,2
2022-07-24,Binh Duong,Thuan An,3,4,1,3,1
2022-07-24,Binh Duong,Thuan An,6,3,1,2,1
2022-07-24,Binh Duong,Thuan An,7,7,5,2,0
2022-07-24,Binh Duong,Thuan An,8,34,14,20,12
2022-07-24,Binh Duong,Thuan An,9,62,29,33,25
2022-07-24,Binh Duong,Thuan An,10,78,56,22,11
2022-07-24,Binh Duong,Thuan An,11,88,72,16,6
2022-07-24,Binh Duong,Thuan An,12,88,73,15,5
2022-07-24,Binh Duong,Thuan An,13,61,42,19,10
2022-07-24,Binh Duong,Thuan An,14,55,40,15,8
2022-07-24,Binh Duong,Thuan An,15,62,54,8,1
2022-07-24,Binh Duong,Thuan An,16,45,39,6,5
2022-07-24,Binh Duong,Thuan An,17,56,42,14,7
2022-07-24,Binh Duong,Thuan An,18,61,51,10,3
2022-07-24,Binh Duong,Thuan An,19,59,43,16,10
2022-07-24,Binh Duong,Thuan An,20,42,33,9,3
2022-07-24,Binh Duong,Thuan An,21,27,14,13,10
2022-07-24,Binh Duong,Thuan An,22,5,1,4,4
2022-07-24,Binh Duong,Thuan An,23,7,1,6,4
2022-07-24,Can Tho City,Binh Thuy District,7,2,1,1,0
2022-07-24,Can Tho City,Binh Thuy District,8,6,5,1,1
2022-07-24,Can Tho City,Binh Thuy District,9,7,6,1,1
2022-07-24,Can Tho City,Binh Thuy District,10,16,15,1,1
2022-07-24,Can Tho City,Binh Thuy District,11,18,17,1,0
2022-07-24,Can Tho City,Binh Thuy District,12,18,16,2,0
2022-07-24,Can Tho City,Binh Thuy District,13,17,16,1,0
2022-07-24,Can Tho City,Binh Thuy District,14,17,17,0,0
2022-07-24,Can Tho City,Binh Thuy District,15,11,8,3,2
2022-07-24,Can Tho City,Binh Thuy District,16,15,13,2,2
2022-07-24,Can Tho City,Binh Thuy District,17,18,15,3,0
2022-07-24,Can Tho City,Binh Thuy District,18,13,11,2,0
2022-07-24,Can Tho City,Binh Thuy District,19,14,13,1,0
2022-07-24,Can Tho City,Binh Thuy District,20,16,15,1,0
2022-07-24,Can Tho City,Binh Thuy District,21,1,0,1,0
2022-07-24,Can Tho City,Cai Rang District,6,1,1,0,0
2022-07-24,Can Tho City,Cai Rang District,7,3,2,1,1
2022-07-24,Can Tho City,Cai Rang District,8,9,5,4,0
2022-07-24,Can Tho City,Cai Rang District,9,19,17,2,1
2022-07-24,Can Tho City,Cai Rang District,10,13,12,1,1
2022-07-24,Can Tho City,Cai Rang District,11,22,19,3,0
2022-07-24,Can Tho City,Cai Rang District,12,16,16,0,0
2022-07-24,Can Tho City,Cai Rang District,13,9,7,2,0
2022-07-24,Can Tho City,Cai Rang District,14,21,16,5,3
2022-07-24,Can Tho City,Cai Rang District,15,7,6,1,0
2022-07-24,Can Tho City,Cai Rang District,16,8,7,1,0
2022-07-24,Can Tho City,Cai Rang District,17,14,13,1,1
2022-07-24,Can Tho City,Cai Rang District,18,15,13,2,1
2022-07-24,Can Tho City,Cai Rang District,19,11,10,1,0
2022-07-24,Can Tho City,Cai Rang District,20,13,13,0,0
2022-07-24,Can Tho City,Cai Rang District,21,3,1,2,0
2022-07-24,Can Tho City,Cai Rang District,22,4,1,3,0
2022-07-24,Can Tho City,Ninh Kieu District,0,6,4,2,0
2022-07-24,Can Tho City,Ninh Kieu District,1,3,1,2,2
2022-07-24,Can Tho City,Ninh Kieu District,5,3,1,2,2
2022-07-24,Can Tho City,Ninh Kieu District,6,48,40,8,0
2022-07-24,Can Tho City,Ninh Kieu District,7,117,106,11,1
2022-07-24,Can Tho City,Ninh Kieu District,8,216,201,15,0
2022-07-24,Can Tho City,Ninh Kieu District,9,319,292,27,0
2022-07-24,Can Tho City,Ninh Kieu District,10,446,421,25,0
2022-07-24,Can Tho City,Ninh Kieu District,11,673,618,55,7
2022-07-24,Can Tho City,Ninh Kieu District,12,620,596,24,1
2022-07-24,Can Tho City,Ninh Kieu District,13,431,408,23,0
2022-07-24,Can Tho City,Ninh Kieu District,14,375,360,15,0
2022-07-24,Can Tho City,Ninh Kieu District,15,339,320,19,0
2022-07-24,Can Tho City,Ninh Kieu District,16,393,372,21,0
2022-07-24,Can Tho City,Ninh Kieu District,17,444,426,18,0
2022-07-24,Can Tho City,Ninh Kieu District,18,428,404,24,0
2022-07-24,Can Tho City,Ninh Kieu District,19,482,448,34,1
2022-07-24,Can Tho City,Ninh Kieu District,20,385,363,22,1
2022-07-24,Can Tho City,Ninh Kieu District,21,195,180,15,0
2022-07-24,Can Tho City,Ninh Kieu District,22,40,30,10,1
2022-07-24,Can Tho City,Ninh Kieu District,23,13,8,5,2
2022-07-24,Can Tho City,O Mon District,11,2,0,2,1
2022-07-24,Can Tho City,O Mon District,12,2,0,2,2
2022-07-24,Can Tho City,Thoi Lai,11,1,0,1,1
2022-07-24,Dong Nai,Bien Hoa City,0,10,5,5,5
2022-07-24,Dong Nai,Bien Hoa City,1,12,1,11,8
2022-07-24,Dong Nai,Bien Hoa City,2,9,0,9,7
2022-07-24,Dong Nai,Bien Hoa City,3,3,1,2,2
2022-07-24,Dong Nai,Bien Hoa City,4,3,2,1,1
2022-07-24,Dong Nai,Bien Hoa City,5,2,1,1,0
2022-07-24,Dong Nai,Bien Hoa City,6,50,39,11,5
2022-07-24,Dong Nai,Bien Hoa City,7,189,154,35,12
2022-07-24,Dong Nai,Bien Hoa City,8,335,300,35,1
2022-07-24,Dong Nai,Bien Hoa City,9,488,446,42,5
2022-07-24,Dong Nai,Bien Hoa City,10,854,793,61,7
2022-07-24,Dong Nai,Bien Hoa City,11,1271,1156,115,26
2022-07-24,Dong Nai,Bien Hoa City,12,1079,981,98,28
2022-07-24,Dong Nai,Bien Hoa City,13,866,807,59,8
2022-07-24,Dong Nai,Bien Hoa City,14,609,562,47,8
2022-07-24,Dong Nai,Bien Hoa City,15,663,598,65,19
2022-07-24,Dong Nai,Bien Hoa City,16,607,536,71,22
2022-07-24,Dong Nai,Bien Hoa City,17,655,592,63,10
2022-07-24,Dong Nai,Bien Hoa City,18,812,722,90,26
2022-07-24,Dong Nai,Bien Hoa City,19,848,749,99,23
2022-07-24,Dong Nai,Bien Hoa City,20,590,490,100,27
2022-07-24,Dong Nai,Bien Hoa City,21,219,164,55,15
2022-07-24,Dong Nai,Bien Hoa City,22,71,32,39,7
2022-07-24,Dong Nai,Bien Hoa City,23,15,6,9,7
2022-07-24,Dong Nai,Long Khanh,10,1,0,1,1
2022-07-24,Dong Nai,Long Khanh,11,1,0,1,1
2022-07-24,Dong Nai,Long Khanh,12,1,0,1,1
2022-07-24,Dong Nai,Long Khanh,14,1,0,1,1
2022-07-24,Dong Nai,Long Thanh,11,2,0,2,1
2022-07-24,Dong Nai,Long Thanh,12,5,0,5,5
2022-07-24,Dong Nai,Long Thanh,13,2,0,2,2
2022-07-24,Dong Nai,Long Thanh,14,2,0,2,2
2022-07-24,Dong Nai,Long Thanh,15,1,0,1,1
2022-07-24,Dong Nai,Long Thanh,16,1,0,1,1
2022-07-24,Dong Nai,Nhon trach,9,1,0,1,1
2022-07-24,Dong Nai,Nhon trach,11,1,0,1,1
2022-07-24,Dong Nai,Nhon trach,13,1,0,1,1
2022-07-24,Dong Nai,Nhon trach,14,2,0,2,1
2022-07-24,Dong Nai,Nhon trach,15,1,0,1,1
2022-07-24,Dong Nai,Trang Bom,7,1,0,1,1
2022-07-24,Dong Nai,Trang Bom,13,3,1,2,2
2022-07-24,Dong Nai,Trang Bom,14,1,0,1,0
2022-07-24,Dong Nai,Trang Bom,15,2,0,2,2
2022-07-24,Dong Nai,Trang Bom,17,1,0,1,1
2022-07-24,Dong Nai,Trang Bom,18,1,1,0,0
2022-07-24,Hai Phong City,An Duong,8,3,2,1,1
2022-07-24,Hai Phong City,An Duong,9,4,2,2,1
2022-07-24,Hai Phong City,An Duong,10,10,3,7,6
2022-07-24,Hai Phong City,An Duong,11,7,5,2,1
2022-07-24,Hai Phong City,An Duong,12,9,7,2,0
2022-07-24,Hai Phong City,An Duong,13,2,2,0,0
2022-07-24,Hai Phong City,An Duong,14,1,0,1,1
2022-07-24,Hai Phong City,An Duong,15,1,0,1,1
2022-07-24,Hai Phong City,An Duong,16,5,0,5,3
2022-07-24,Hai Phong City,An Duong,17,12,3,9,6
2022-07-24,Hai Phong City,An Duong,18,7,2,5,3
2022-07-24,Hai Phong City,An Duong,19,6,0,6,4
2022-07-24,Hai Phong City,An Duong,20,3,3,0,0
2022-07-24,Hai Phong City,An Lao,12,1,0,1,1
2022-07-24,Hai Phong City,Duong Kinh District,19,1,0,1,1
2022-07-24,Hai Phong City,Hai An District,1,1,0,1,0
2022-07-24,Hai Phong City,Hai An District,6,1,0,1,1
2022-07-24,Hai Phong City,Hai An District,7,7,1,6,4
2022-07-24,Hai Phong City,Hai An District,8,8,7,1,0
2022-07-24,Hai Phong City,Hai An District,9,15,13,2,0
2022-07-24,Hai Phong City,Hai An District,10,30,25,5,3
2022-07-24,Hai Phong City,Hai An District,11,49,39,10,1
2022-07-24,Hai Phong City,Hai An District,12,45,39,6,2
2022-07-24,Hai Phong City,Hai An District,13,15,12,3,0
2022-07-24,Hai Phong City,Hai An District,14,17,12,5,1
2022-07-24,Hai Phong City,Hai An District,15,31,23,8,0
2022-07-24,Hai Phong City,Hai An District,16,21,18,3,1
2022-07-24,Hai Phong City,Hai An District,17,24,18,6,3
2022-07-24,Hai Phong City,Hai An District,18,24,15,9,4
2022-07-24,Hai Phong City,Hai An District,19,23,22,1,1
2022-07-24,Hai Phong City,Hai An District,20,17,14,3,1
2022-07-24,Hai Phong City,Hai An District,21,8,5,3,2
2022-07-24,Hai Phong City,Hai An District,22,3,0,3,1
2022-07-24,Hai Phong City,Hai An District,23,1,0,1,0
2022-07-24,Hai Phong City,Hong Bang District,0,2,2,0,0
2022-07-24,Hai Phong City,Hong Bang District,6,2,2,0,0
2022-07-24,Hai Phong City,Hong Bang District,7,12,8,4,1
2022-07-24,Hai Phong City,Hong Bang District,8,28,26,2,1
2022-07-24,Hai Phong City,Hong Bang District,9,42,36,6,4
2022-07-24,Hai Phong City,Hong Bang District,10,82,64,18,8
2022-07-24,Hai Phong City,Hong Bang District,11,131,93,38,23
2022-07-24,Hai Phong City,Hong Bang District,12,92,77,15,3
2022-07-24,Hai Phong City,Hong Bang District,13,54,50,4,0
2022-07-24,Hai Phong City,Hong Bang District,14,44,36,8,2
2022-07-24,Hai Phong City,Hong Bang District,15,53,43,10,6
2022-07-24,Hai Phong City,Hong Bang District,16,58,48,10,2
2022-07-24,Hai Phong City,Hong Bang District,17,60,42,18,10
2022-07-24,Hai Phong City,Hong Bang District,18,67,53,14,10
2022-07-24,Hai Phong City,Hong Bang District,19,70,39,31,27
2022-07-24,Hai Phong City,Hong Bang District,20,40,28,12,8
2022-07-24,Hai Phong City,Hong Bang District,21,33,26,7,5
2022-07-24,Hai Phong City,Hong Bang District,22,5,0,5,2
2022-07-24,Hai Phong City,Kien An District,0,1,0,1,1
2022-07-24,Hai Phong City,Kien An District,1,2,0,2,2
2022-07-24,Hai Phong City,Kien An District,6,2,0,2,1
2022-07-24,Hai Phong City,Kien An District,7,6,0,6,4
2022-07-24,Hai Phong City,Kien An District,8,2,1,1,1
2022-07-24,Hai Phong City,Kien An District,9,9,1,8,6
2022-07-24,Hai Phong City,Kien An District,10,21,12,9,9
2022-07-24,Hai Phong City,Kien An District,11,23,10,13,12
2022-07-24,Hai Phong City,Kien An District,12,13,8,5,5
2022-07-24,Hai Phong City,Kien An District,13,6,4,2,2
2022-07-24,Hai Phong City,Kien An District,14,13,8,5,4
2022-07-24,Hai Phong City,Kien An District,15,10,10,0,0
2022-07-24,Hai Phong City,Kien An District,16,10,6,4,2
2022-07-24,Hai Phong City,Kien An District,17,11,9,2,2
2022-07-24,Hai Phong City,Kien An District,18,8,6,2,2
2022-07-24,Hai Phong City,Kien An District,19,22,11,11,4
2022-07-24,Hai Phong City,Kien An District,20,13,6,7,3
2022-07-24,Hai Phong City,Kien An District,21,4,2,2,1
2022-07-24,Hai Phong City,Le Chan District,0,2,0,2,1
2022-07-24,Hai Phong City,Le Chan District,3,1,0,1,0
2022-07-24,Hai Phong City,Le Chan District,4,1,1,0,0
2022-07-24,Hai Phong City,Le Chan District,5,1,0,1,1
2022-07-24,Hai Phong City,Le Chan District,6,7,3,4,2
2022-07-24,Hai Phong City,Le Chan District,7,54,40,14,9
2022-07-24,Hai Phong City,Le Chan District,8,94,77,17,7
2022-07-24,Hai Phong City,Le Chan District,9,134,105,29,6
2022-07-24,Hai Phong City,Le Chan District,10,251,210,41,16
2022-07-24,Hai Phong City,Le Chan District,11,411,326,85,49
2022-07-24,Hai Phong City,Le Chan District,12,284,241,43,13
2022-07-24,Hai Phong City,Le Chan District,13,166,148,18,4
2022-07-24,Hai Phong City,Le Chan District,14,159,139,20,4
2022-07-24,Hai Phong City,Le Chan District,15,202,160,42,19
2022-07-24,Hai Phong City,Le Chan District,16,232,189,43,19
2022-07-24,Hai Phong City,Le Chan District,17,233,184,49,28
2022-07-24,Hai Phong City,Le Chan District,18,270,205,65,42
2022-07-24,Hai Phong City,Le Chan District,19,255,187,68,38
2022-07-24,Hai Phong City,Le Chan District,20,169,126,43,23
2022-07-24,Hai Phong City,Le Chan District,21,90,61,29,16
2022-07-24,Hai Phong City,Le Chan District,22,17,8,9,4
2022-07-24,Hai Phong City,Le Chan District,23,12,2,10,5
2022-07-24,Hai Phong City,Ngo Quyen District,0,4,1,3,1
2022-07-24,Hai Phong City,Ngo Quyen District,1,1,1,0,0
2022-07-24,Hai Phong City,Ngo Quyen District,3,2,1,1,0
2022-07-24,Hai Phong City,Ngo Quyen District,5,2,0,2,2
2022-07-24,Hai Phong City,Ngo Quyen District,6,1,0,1,1
2022-07-24,Hai Phong City,Ngo Quyen District,7,31,25,6,3
2022-07-24,Hai Phong City,Ngo Quyen District,8,70,52,18,7
2022-07-24,Hai Phong City,Ngo Quyen District,9,121,105,16,3
2022-07-24,Hai Phong City,Ngo Quyen District,10,206,173,33,6
2022-07-24,Hai Phong City,Ngo Quyen District,11,278,223,55,33
2022-07-24,Hai Phong City,Ngo Quyen District,12,223,192,31,9
2022-07-24,Hai Phong City,Ngo Quyen District,13,152,136,16,5
2022-07-24,Hai Phong City,Ngo Quyen District,14,128,108,20,5
2022-07-24,Hai Phong City,Ngo Quyen District,15,164,143,21,6
2022-07-24,Hai Phong City,Ngo Quyen District,16,164,144,20,3
2022-07-24,Hai Phong City,Ngo Quyen District,17,152,133,19,8
2022-07-24,Hai Phong City,Ngo Quyen District,18,205,168,37,24
2022-07-24,Hai Phong City,Ngo Quyen District,19,212,166,46,22
2022-07-24,Hai Phong City,Ngo Quyen District,20,161,119,42,19
2022-07-24,Hai Phong City,Ngo Quyen District,21,57,48,9,5
2022-07-24,Hai Phong City,Ngo Quyen District,22,16,13,3,1
2022-07-24,Hai Phong City,Ngo Quyen District,23,2,0,2,2
2022-07-24,Hai Phong City,Thuy Nguyen,8,2,0,2,2
2022-07-24,Hai Phong City,Thuy Nguyen,9,1,0,1,1
2022-07-24,Hai Phong City,Thuy Nguyen,11,1,0,1,1
2022-07-24,Hai Phong City,Thuy Nguyen,12,3,1,2,1
2022-07-24,Hai Phong City,Thuy Nguyen,13,1,0,1,1
2022-07-24,Hai Phong City,Thuy Nguyen,14,2,0,2,2
2022-07-24,Hai Phong City,Thuy Nguyen,15,4,0,4,3
2022-07-24,Hai Phong City,Thuy Nguyen,16,1,0,1,0
2022-07-24,Hai Phong City,Thuy Nguyen,17,3,0,3,3
2022-07-24,Hai Phong City,Thuy Nguyen,19,1,0,1,1
2022-07-24,Hue City,Hue City,0,12,7,5,5
2022-07-24,Hue City,Hue City,1,4,3,1,0
2022-07-24,Hue City,Hue City,2,2,2,0,0
2022-07-24,Hue City,Hue City,3,1,0,1,1
2022-07-24,Hue City,Hue City,5,2,1,1,1
2022-07-24,Hue City,Hue City,6,73,58,15,5
2022-07-24,Hue City,Hue City,7,219,206,13,0
2022-07-24,Hue City,Hue City,8,354,333,21,0
2022-07-24,Hue City,Hue City,9,337,307,30,0
2022-07-24,Hue City,Hue City,10,532,483,49,1
2022-07-24,Hue City,Hue City,11,993,894,99,11
2022-07-24,Hue City,Hue City,12,702,658,44,0
2022-07-24,Hue City,Hue City,13,423,393,30,1
2022-07-24,Hue City,Hue City,14,447,395,52,1
2022-07-24,Hue City,Hue City,15,476,429,47,5
2022-07-24,Hue City,Hue City,16,493,459,34,2
2022-07-24,Hue City,Hue City,17,555,502,53,7
2022-07-24,Hue City,Hue City,18,646,567,79,14
2022-07-24,Hue City,Hue City,19,636,543,93,10
2022-07-24,Hue City,Hue City,20,504,430,74,11
2022-07-24,Hue City,Hue City,21,270,235,35,7
2022-07-24,Hue City,Hue City,22,50,35,15,1
2022-07-24,Hue City,Hue City,23,23,19,4,0
2022-07-24,Hue City,Huong Thuy,7,1,0,1,1
2022-07-24,Hue City,Huong Thuy,10,2,1,1,0
2022-07-24,Hue City,Huong Thuy,11,1,1,0,0
2022-07-24,Hue City,Huong Thuy,12,2,0,2,1
2022-07-24,Hue City,Huong Thuy,13,5,3,2,1
2022-07-24,Hue City,Huong Thuy,16,1,0,1,0
2022-07-24,Hue City,Huong Thuy,17,1,0,1,0
2022-07-24,Hue City,Huong Thuy,18,3,3,0,0
2022-07-24,Hue City,Huong Thuy,19,2,1,1,1
2022-07-24,Hue City,Huong Thuy,21,2,0,2,1
2022-07-24,Hue City,Huong Tra,16,2,1,1,1
2022-07-24,Hue City,Huong Tra,21,1,1,0,0
2022-07-24,Hue City,Phu Vang,6,1,0,1,1
2022-07-24,Hue City,Phu Vang,7,2,2,0,0
2022-07-24,Hue City,Phu Vang,8,2,2,0,0
2022-07-24,Hue City,Phu Vang,9,1,0,1,0
2022-07-24,Hue City,Phu Vang,10,2,2,0,0
2022-07-24,Hue City,Phu Vang,11,4,4,0,0
2022-07-24,Hue City,Phu Vang,13,1,0,1,1
2022-07-24,Hue City,Phu Vang,14,7,6,1,1
2022-07-24,Hue City,Phu Vang,16,3,2,1,0
2022-07-24,Hue City,Phu Vang,17,3,3,0,0
2022-07-24,Hue City,Phu Vang,18,4,2,2,2
2022-07-24,Hue City,Phu Vang,19,3,2,1,0
2022-07-24,Hue City,Phu Vang,20,1,1,0,0
2022-07-24,Khanh Hoa,Dien Khanh,7,1,0,1,1
2022-07-24,Khanh Hoa,Dien Khanh,8,2,0,2,2
2022-07-24,Khanh Hoa,Dien Khanh,16,1,0,1,1
2022-07-24,Khanh Hoa,Nha Trang City,0,5,4,1,1
2022-07-24,Khanh Hoa,Nha Trang City,1,7,4,3,2
2022-07-24,Khanh Hoa,Nha Trang City,2,1,0,1,1
2022-07-24,Khanh Hoa,Nha Trang City,3,1,0,1,1
2022-07-24,Khanh Hoa,Nha Trang City,5,6,2,4,2
2022-07-24,Khanh Hoa,Nha Trang City,6,42,34,8,7
2022-07-24,Khanh Hoa,Nha Trang City,7,127,110,17,4
2022-07-24,Khanh Hoa,Nha Trang City,8,204,180,24,3
2022-07-24,Khanh Hoa,Nha Trang City,9,213,201,12,1
2022-07-24,Khanh Hoa,Nha Trang City,10,264,241,23,3
2022-07-24,Khanh Hoa,Nha Trang City,11,398,365,33,1
2022-07-24,Khanh Hoa,Nha Trang City,12,319,293,26,2
2022-07-24,Khanh Hoa,Nha Trang City,13,280,261,19,4
2022-07-24,Khanh Hoa,Nha Trang City,14,298,268,30,2
2022-07-24,Khanh Hoa,Nha Trang City,15,232,207,25,2
2022-07-24,Khanh Hoa,Nha Trang City,16,280,261,19,1
2022-07-24,Khanh Hoa,Nha Trang City,17,257,245,12,0
2022-07-24,Khanh Hoa,Nha Trang City,18,372,328,44,20
2022-07-24,Khanh Hoa,Nha Trang City,19,364,297,67,34
2022-07-24,Khanh Hoa,Nha Trang City,20,261,219,42,13
2022-07-24,Khanh Hoa,Nha Trang City,21,147,120,27,2
2022-07-24,Khanh Hoa,Nha Trang City,22,51,33,18,6
2022-07-24,Khanh Hoa,Nha Trang City,23,6,5,1,0
2022-07-24,Lam Dong,Da Lat City,0,6,1,5,1
2022-07-24,Lam Dong,Da Lat City,1,7,0,7,4
2022-07-24,Lam Dong,Da Lat City,2,2,0,2,2
2022-07-24,Lam Dong,Da Lat City,5,4,0,4,3
2022-07-24,Lam Dong,Da Lat City,6,10,4,6,6
2022-07-24,Lam Dong,Da Lat City,7,46,33,13,7
2022-07-24,Lam Dong,Da Lat City,8,106,79,27,18
2022-07-24,Lam Dong,Da Lat City,9,83,63,20,9
2022-07-24,Lam Dong,Da Lat City,10,160,125,35,17
2022-07-24,Lam Dong,Da Lat City,11,185,139,46,31
2022-07-24,Lam Dong,Da Lat City,12,219,161,58,35
2022-07-24,Lam Dong,Da Lat City,13,132,110,22,11
2022-07-24,Lam Dong,Da Lat City,14,111,89,22,8
2022-07-24,Lam Dong,Da Lat City,15,115,90,25,16
2022-07-24,Lam Dong,Da Lat City,16,123,100,23,14
2022-07-24,Lam Dong,Da Lat City,17,144,104,40,19
2022-07-24,Lam Dong,Da Lat City,18,127,106,21,7
2022-07-24,Lam Dong,Da Lat City,19,172,121,51,33
2022-07-24,Lam Dong,Da Lat City,20,108,74,34,23
2022-07-24,Lam Dong,Da Lat City,21,61,35,26,15
2022-07-24,Lam Dong,Da Lat City,22,27,21,6,3
2022-07-24,Lam Dong,Da Lat City,23,12,10,2,0
2022-07-24,Nghe An,Vinh City,0,2,0,2,1
2022-07-24,Nghe An,Vinh City,1,2,0,2,2
2022-07-24,Nghe An,Vinh City,2,1,0,1,1
2022-07-24,Nghe An,Vinh City,5,1,0,1,0
2022-07-24,Nghe An,Vinh City,6,24,13,11,8
2022-07-24,Nghe An,Vinh City,7,88,73,15,8
2022-07-24,Nghe An,Vinh City,8,172,153,19,1
2022-07-24,Nghe An,Vinh City,9,156,136,20,2
2022-07-24,Nghe An,Vinh City,10,234,203,31,5
2022-07-24,Nghe An,Vinh City,11,369,316,53,17
2022-07-24,Nghe An,Vinh City,12,299,240,59,18
2022-07-24,Nghe An,Vinh City,13,114,98,16,3
2022-07-24,Nghe An,Vinh City,14,177,141,36,9
2022-07-24,Nghe An,Vinh City,15,233,191,42,11
2022-07-24,Nghe An,Vinh City,16,172,136,36,7
2022-07-24,Nghe An,Vinh City,17,172,146,26,8
2022-07-24,Nghe An,Vinh City,18,215,165,50,17
2022-07-24,Nghe An,Vinh City,19,177,142,35,2
2022-07-24,Nghe An,Vinh City,20,134,108,26,7
2022-07-24,Nghe An,Vinh City,21,109,79,30,8
2022-07-24,Nghe An,Vinh City,22,19,11,8,1
2022-07-24,Nghe An,Vinh City,23,13,5,8,4
2022-07-24,Quang Nam,Dien Ban,17,1,0,1,1
2022-07-24,Quang Nam,Hoi An City,5,2,0,2,2
2022-07-24,Quang Nam,Hoi An City,6,7,0,7,6
2022-07-24,Quang Nam,Hoi An City,7,16,9,7,6
2022-07-24,Quang Nam,Hoi An City,8,30,25,5,3
2022-07-24,Quang Nam,Hoi An City,9,42,31,11,6
2022-07-24,Quang Nam,Hoi An City,10,61,35,26,14
2022-07-24,Quang Nam,Hoi An City,11,83,41,42,33
2022-07-24,Quang Nam,Hoi An City,12,48,36,12,8
2022-07-24,Quang Nam,Hoi An City,13,37,30,7,4
2022-07-24,Quang Nam,Hoi An City,14,44,35,9,3
2022-07-24,Quang Nam,Hoi An City,15,58,38,20,12
2022-07-24,Quang Nam,Hoi An City,16,44,35,9,5
2022-07-24,Quang Nam,Hoi An City,17,60,47,13,10
2022-07-24,Quang Nam,Hoi An City,18,58,42,16,7
2022-07-24,Quang Nam,Hoi An City,19,54,38,16,6
2022-07-24,Quang Nam,Hoi An City,20,59,25,34,22
2022-07-24,Quang Nam,Hoi An City,21,29,9,20,8
2022-07-24,Quang Nam,Hoi An City,22,8,3,5,2
2022-07-24,Quang Nam,Hoi An City,23,1,1,0,0
2022-07-24,Quang Nam,Tam Ky City,10,1,0,1,1
2022-07-24,Quang Ninh,Cam Pha City,7,1,0,1,1
2022-07-24,Quang Ninh,Cam Pha City,8,2,0,2,1
2022-07-24,Quang Ninh,Cam Pha City,9,2,0,2,2
2022-07-24,Quang Ninh,Cam Pha City,10,1,0,1,1
2022-07-24,Quang Ninh,Cam Pha City,11,2,0,2,1
2022-07-24,Quang Ninh,Cam Pha City,13,2,0,2,2
2022-07-24,Quang Ninh,Cam Pha City,17,1,0,1,0
2022-07-24,Quang Ninh,Cam Pha City,19,2,0,2,1
2022-07-24,Quang Ninh,Cam Pha City,20,2,0,2,2
2022-07-24,Quang Ninh,Cam Pha City,21,1,0,1,1
2022-07-24,Quang Ninh,Ha Long City,0,1,0,1,1
2022-07-24,Quang Ninh,Ha Long City,1,1,1,0,0
2022-07-24,Quang Ninh,Ha Long City,2,1,0,1,1
2022-07-24,Quang Ninh,Ha Long City,6,4,1,3,3
2022-07-24,Quang Ninh,Ha Long City,7,25,13,12,6
2022-07-24,Quang Ninh,Ha Long City,8,43,28,15,11
2022-07-24,Quang Ninh,Ha Long City,9,87,54,33,13
2022-07-24,Quang Ninh,Ha Long City,10,112,84,28,16
2022-07-24,Quang Ninh,Ha Long City,11,157,116,41,24
2022-07-24,Quang Ninh,Ha Long City,12,152,96,56,38
2022-07-24,Quang Ninh,Ha Long City,13,87,62,25,16
2022-07-24,Quang Ninh,Ha Long City,14,92,58,34,17
2022-07-24,Quang Ninh,Ha Long City,15,71,53,18,13
2022-07-24,Quang Ninh,Ha Long City,16,71,54,17,11
2022-07-24,Quang Ninh,Ha Long City,17,63,41,22,13
2022-07-24,Quang Ninh,Ha Long City,18,64,52,12,4
2022-07-24,Quang Ninh,Ha Long City,19,88,58,30,13
2022-07-24,Quang Ninh,Ha Long City,20,62,40,22,15
2022-07-24,Quang Ninh,Ha Long City,21,26,15,11,7
2022-07-24,Quang Ninh,Ha Long City,22,18,8,10,8
2022-07-24,Quang Ninh,Ha Long City,23,2,0,2,2
2022-07-24,Thai Nguyen,Dong Hy,7,3,1,2,1
2022-07-24,Thai Nguyen,Dong Hy,9,1,0,1,1
2022-07-24,Thai Nguyen,Dong Hy,10,1,1,0,0
2022-07-24,Thai Nguyen,Dong Hy,11,3,3,0,0
2022-07-24,Thai Nguyen,Dong Hy,13,1,1,0,0
2022-07-24,Thai Nguyen,Dong Hy,14,2,0,2,1
2022-07-24,Thai Nguyen,Dong Hy,15,1,0,1,0
2022-07-24,Thai Nguyen,Dong Hy,18,1,1,0,0
2022-07-24,Thai Nguyen,Thai Nguyen City,0,5,0,5,4
2022-07-24,Thai Nguyen,Thai Nguyen City,2,2,0,2,1
2022-07-24,Thai Nguyen,Thai Nguyen City,5,2,0,2,2
2022-07-24,Thai Nguyen,Thai Nguyen City,6,21,11,10,8
2022-07-24,Thai Nguyen,Thai Nguyen City,7,78,71,7,1
2022-07-24,Thai Nguyen,Thai Nguyen City,8,158,143,15,1
2022-07-24,Thai Nguyen,Thai Nguyen City,9,145,123,22,2
2022-07-24,Thai Nguyen,Thai Nguyen City,10,247,219,28,1
2022-07-24,Thai Nguyen,Thai Nguyen City,11,385,348,37,4
2022-07-24,Thai Nguyen,Thai Nguyen City,12,296,268,28,3
2022-07-24,Thai Nguyen,Thai Nguyen City,13,170,150,20,1
2022-07-24,Thai Nguyen,Thai Nguyen City,14,160,144,16,2
2022-07-24,Thai Nguyen,Thai Nguyen City,15,174,154,20,3
2022-07-24,Thai Nguyen,Thai Nguyen City,16,158,143,15,3
2022-07-24,Thai Nguyen,Thai Nguyen City,17,144,132,12,2
2022-07-24,Thai Nguyen,Thai Nguyen City,18,191,175,16,0
2022-07-24,Thai Nguyen,Thai Nguyen City,19,241,228,13,0
2022-07-24,Thai Nguyen,Thai Nguyen City,20,211,175,36,7
2022-07-24,Thai Nguyen,Thai Nguyen City,21,114,99,15,1
2022-07-24,Thai Nguyen,Thai Nguyen City,22,21,16,5,0
2022-07-24,Thai Nguyen,Thai Nguyen City,23,14,5,9,3
2022-07-24,Vung Tau,Ba Ria City,7,1,1,0,0
2022-07-24,Vung Tau,Ba Ria City,8,8,2,6,4
2022-07-24,Vung Tau,Ba Ria City,9,7,3,4,3
2022-07-24,Vung Tau,Ba Ria City,10,6,6,0,0
2022-07-24,Vung Tau,Ba Ria City,11,10,9,1,1
2022-07-24,Vung Tau,Ba Ria City,12,4,4,0,0
2022-07-24,Vung Tau,Ba Ria City,13,6,6,0,0
2022-07-24,Vung Tau,Ba Ria City,14,6,4,2,2
2022-07-24,Vung Tau,Ba Ria City,15,10,6,4,2
2022-07-24,Vung Tau,Ba Ria City,16,8,3,5,3
2022-07-24,Vung Tau,Ba Ria City,17,4,3,1,1
2022-07-24,Vung Tau,Ba Ria City,18,7,4,3,3
2022-07-24,Vung Tau,Ba Ria City,19,3,1,2,1
2022-07-24,Vung Tau,Ba Ria City,20,5,2,3,2
2022-07-24,Vung Tau,Long Dien,8,1,0,1,1
2022-07-24,Vung Tau,Long Son,19,1,1,0,0
2022-07-24,Vung Tau,Vung Tau City,0,12,10,2,1
2022-07-24,Vung Tau,Vung Tau City,1,6,2,4,1
2022-07-24,Vung Tau,Vung Tau City,2,5,0,5,2
2022-07-24,Vung Tau,Vung Tau City,3,1,0,1,1
2022-07-24,Vung Tau,Vung Tau City,4,2,1,1,1
2022-07-24,Vung Tau,Vung Tau City,5,9,4,5,5
2022-07-24,Vung Tau,Vung Tau City,6,37,32,5,2
2022-07-24,Vung Tau,Vung Tau City,7,136,111,25,9
2022-07-24,Vung Tau,Vung Tau City,8,226,191,35,16
2022-07-24,Vung Tau,Vung Tau City,9,258,234,24,5
2022-07-24,Vung Tau,Vung Tau City,10,359,323,36,14
2022-07-24,Vung Tau,Vung Tau City,11,471,406,65,29
2022-07-24,Vung Tau,Vung Tau City,12,413,356,57,18
2022-07-24,Vung Tau,Vung Tau City,13,340,304,36,9
2022-07-24,Vung Tau,Vung Tau City,14,266,246,20,1
2022-07-24,Vung Tau,Vung Tau City,15,278,255,23,2
2022-07-24,Vung Tau,Vung Tau City,16,281,257,24,2
2022-07-24,Vung Tau,Vung Tau City,17,314,292,22,7
2022-07-24,Vung Tau,Vung Tau City,18,319,278,41,9
2022-07-24,Vung Tau,Vung Tau City,19,313,256,57,14
2022-07-24,Vung Tau,Vung Tau City,20,239,192,47,11
2022-07-24,Vung Tau,Vung Tau City,21,112,84,28,5
2022-07-24,Vung Tau,Vung Tau City,22,21,17,4,1
2022-07-24,Vung Tau,Vung Tau City,23,12,10,2,1
2022-07-25,Bac Ninh,Bác Ninh City,0,7,6,1,0
2022-07-25,Bac Ninh,Bác Ninh City,1,5,3,2,2
2022-07-25,Bac Ninh,Bác Ninh City,2,1,1,0,0
2022-07-25,Bac Ninh,Bác Ninh City,5,3,2,1,0
2022-07-25,Bac Ninh,Bác Ninh City,6,19,14,5,2
2022-07-25,Bac Ninh,Bác Ninh City,7,64,58,6,0
2022-07-25,Bac Ninh,Bác Ninh City,8,106,101,5,0
2022-07-25,Bac Ninh,Bác Ninh City,9,119,100,19,0
2022-07-25,Bac Ninh,Bác Ninh City,10,209,192,17,1
2022-07-25,Bac Ninh,Bác Ninh City,11,343,323,20,2
2022-07-25,Bac Ninh,Bác Ninh City,12,232,215,17,0
2022-07-25,Bac Ninh,Bác Ninh City,13,165,137,28,4
2022-07-25,Bac Ninh,Bác Ninh City,14,157,145,12,0
2022-07-25,Bac Ninh,Bác Ninh City,15,167,150,17,1
2022-07-25,Bac Ninh,Bác Ninh City,16,137,114,23,1
2022-07-25,Bac Ninh,Bác Ninh City,17,128,113,15,2
2022-07-25,Bac Ninh,Bác Ninh City,18,170,157,13,1
2022-07-25,Bac Ninh,Bác Ninh City,19,190,173,17,0
2022-07-25,Bac Ninh,Bác Ninh City,20,168,149,19,3
2022-07-25,Bac Ninh,Bác Ninh City,21,94,71,23,1
2022-07-25,Bac Ninh,Bác Ninh City,22,11,9,2,0
2022-07-25,Bac Ninh,Bác Ninh City,23,6,6,0,0
2022-07-25,Bac Ninh,Que Vo,9,4,1,3,2
2022-07-25,Bac Ninh,Que Vo,13,1,0,1,1
2022-07-25,Bac Ninh,Que Vo,14,5,3,2,1
2022-07-25,Bac Ninh,Que Vo,15,1,0,1,1
2022-07-25,Bac Ninh,Que Vo,18,1,0,1,1
2022-07-25,Bac Ninh,Que Vo,21,2,0,2,2
2022-07-25,Bac Ninh,Tien Du,0,1,0,1,1
2022-07-25,Bac Ninh,Tien Du,9,3,0,3,3
2022-07-25,Bac Ninh,Tien Du,10,3,0,3,3
2022-07-25,Bac Ninh,Tien Du,11,1,0,1,1
2022-07-25,Bac Ninh,Tien Du,12,3,0,3,3
2022-07-25,Bac Ninh,Tien Du,13,2,0,2,2
2022-07-25,Bac Ninh,Tien Du,14,1,0,1,0
2022-07-25,Bac Ninh,Tien Du,21,1,0,1,1
2022-07-25,Bac Ninh,Tien Du,22,3,0,3,3
2022-07-25,Bac Ninh,Tu Son,10,1,0,1,1
2022-07-25,Bac Ninh,Tu Son,11,3,0,3,3
2022-07-25,Bac Ninh,Tu Son,12,1,0,1,1
2022-07-25,Bac Ninh,Tu Son,13,4,0,4,4
2022-07-25,Bac Ninh,Tu Son,15,1,0,1,1
2022-07-25,Bac Ninh,Tu Son,16,1,0,1,0
2022-07-25,Bac Ninh,Tu Son,20,2,0,2,2
2022-07-25,Binh Duong,Ben Cat,9,1,0,1,1
2022-07-25,Binh Duong,Ben Cat,10,3,0,3,2
2022-07-25,Binh Duong,Ben Cat,11,1,0,1,1
2022-07-25,Binh Duong,Ben Cat,12,7,0,7,7
2022-07-25,Binh Duong,Ben Cat,13,4,0,4,3
2022-07-25,Binh Duong,Ben Cat,14,3,0,3,3
2022-07-25,Binh Duong,Ben Cat,18,1,0,1,1
2022-07-25,Binh Duong,Ben Cat,19,1,0,1,0
2022-07-25,Binh Duong,Ben Cat,20,3,1,2,1
2022-07-25,Binh Duong,Ben Cat,21,2,0,2,2
2022-07-25,Binh Duong,Di An,6,1,0,1,1
2022-07-25,Binh Duong,Di An,7,12,2,10,9
2022-07-25,Binh Duong,Di An,8,22,11,11,9
2022-07-25,Binh Duong,Di An,9,20,18,2,2
2022-07-25,Binh Duong,Di An,10,43,18,25,19
2022-07-25,Binh Duong,Di An,11,54,39,15,12
2022-07-25,Binh Duong,Di An,12,51,32,19,12
2022-07-25,Binh Duong,Di An,13,35,25,10,9
2022-07-25,Binh Duong,Di An,14,36,24,12,5
2022-07-25,Binh Duong,Di An,15,31,26,5,4
2022-07-25,Binh Duong,Di An,16,25,18,7,4
2022-07-25,Binh Duong,Di An,17,37,28,9,7
2022-07-25,Binh Duong,Di An,18,32,29,3,1
2022-07-25,Binh Duong,Di An,19,23,19,4,2
2022-07-25,Binh Duong,Di An,20,21,16,5,4
2022-07-25,Binh Duong,Di An,21,18,13,5,2
2022-07-25,Binh Duong,Di An,22,3,2,1,1
2022-07-25,Binh Duong,Di An,23,3,0,3,1
2022-07-25,Binh Duong,Phu Giao,17,1,0,1,1
2022-07-25,Binh Duong,Phu Giao,18,1,0,1,1
2022-07-25,Binh Duong,Phu Giao,19,1,0,1,1
2022-07-25,Binh Duong,Tan Uyen,7,1,0,1,1
2022-07-25,Binh Duong,Tan Uyen,9,1,1,0,0
2022-07-25,Binh Duong,Tan Uyen,10,2,0,2,1
2022-07-25,Binh Duong,Tan Uyen,11,7,4,3,2
2022-07-25,Binh Duong,Tan Uyen,12,3,1,2,2
2022-07-25,Binh Duong,Tan Uyen,13,8,4,4,4
2022-07-25,Binh Duong,Tan Uyen,14,4,1,3,3
2022-07-25,Binh Duong,Tan Uyen,15,4,2,2,2
2022-07-25,Binh Duong,Tan Uyen,16,3,2,1,1
2022-07-25,Binh Duong,Tan Uyen,17,2,1,1,1
2022-07-25,Binh Duong,Tan Uyen,18,1,1,0,0
2022-07-25,Binh Duong,Tan Uyen,19,4,3,1,1
2022-07-25,Binh Duong,Tan Uyen,21,4,0,4,3
2022-07-25,Binh Duong,Thu Dau Mot Town,0,11,7,4,1
2022-07-25,Binh Duong,Thu Dau Mot Town,1,3,2,1,1
2022-07-25,Binh Duong,Thu Dau Mot Town,2,2,1,1,1
2022-07-25,Binh Duong,Thu Dau Mot Town,3,4,1,3,2
2022-07-25,Binh Duong,Thu Dau Mot Town,5,1,1,0,0
2022-07-25,Binh Duong,Thu Dau Mot Town,6,38,26,12,6
2022-07-25,Binh Duong,Thu Dau Mot Town,7,104,99,5,0
2022-07-25,Binh Duong,Thu Dau Mot Town,8,220,204,16,3
2022-07-25,Binh Duong,Thu Dau Mot Town,9,249,235,14,2
2022-07-25,Binh Duong,Thu Dau Mot Town,10,439,398,41,5
2022-07-25,Binh Duong,Thu Dau Mot Town,11,623,566,57,20
2022-07-25,Binh Duong,Thu Dau Mot Town,12,524,484,40,11
2022-07-25,Binh Duong,Thu Dau Mot Town,13,534,494,40,12
2022-07-25,Binh Duong,Thu Dau Mot Town,14,403,361,42,12
2022-07-25,Binh Duong,Thu Dau Mot Town,15,324,292,32,9
2022-07-25,Binh Duong,Thu Dau Mot Town,16,272,245,27,4
2022-07-25,Binh Duong,Thu Dau Mot Town,17,345,320,25,3
2022-07-25,Binh Duong,Thu Dau Mot Town,18,364,328,36,10
2022-07-25,Binh Duong,Thu Dau Mot Town,19,388,357,31,6
2022-07-25,Binh Duong,Thu Dau Mot Town,20,282,250,32,4
2022-07-25,Binh Duong,Thu Dau Mot Town,21,124,89,35,5
2022-07-25,Binh Duong,Thu Dau Mot Town,22,37,26,11,2
2022-07-25,Binh Duong,Thu Dau Mot Town,23,18,11,7,2
2022-07-25,Binh Duong,Thuan An,0,1,0,1,1
2022-07-25,Binh Duong,Thuan An,1,3,0,3,3
2022-07-25,Binh Duong,Thuan An,2,5,0,5,5
2022-07-25,Binh Duong,Thuan An,5,1,0,1,0
2022-07-25,Binh Duong,Thuan An,6,1,0,1,0
2022-07-25,Binh Duong,Thuan An,7,2,2,0,0
2022-07-25,Binh Duong,Thuan An,8,27,18,9,6
2022-07-25,Binh Duong,Thuan An,9,43,32,11,7
2022-07-25,Binh Duong,Thuan An,10,64,47,17,10
2022-07-25,Binh Duong,Thuan An,11,103,86,17,3
2022-07-25,Binh Duong,Thuan An,12,96,82,14,5
2022-07-25,Binh Duong,Thuan An,13,96,65,31,22
2022-07-25,Binh Duong,Thuan An,14,75,56,19,10
2022-07-25,Binh Duong,Thuan An,15,66,49,17,12
2022-07-25,Binh Duong,Thuan An,16,40,33,7,2
2022-07-25,Binh Duong,Thuan An,17,39,32,7,3
2022-07-25,Binh Duong,Thuan An,18,51,46,5,1
2022-07-25,Binh Duong,Thuan An,19,33,28,5,1
2022-07-25,Binh Duong,Thuan An,20,34,24,10,8
2022-07-25,Binh Duong,Thuan An,21,28,12,16,12
2022-07-25,Binh Duong,Thuan An,22,6,2,4,2
2022-07-25,Can Tho City,Binh Thuy District,7,2,1,1,0
2022-07-25,Can Tho City,Binh Thuy District,8,1,1,0,0
2022-07-25,Can Tho City,Binh Thuy District,9,10,7,3,1
2022-07-25,Can Tho City,Binh Thuy District,10,14,12,2,0
2022-07-25,Can Tho City,Binh Thuy District,11,16,15,1,0
2022-07-25,Can Tho City,Binh Thuy District,12,11,11,0,0
2022-07-25,Can Tho City,Binh Thuy District,13,8,8,0,0
2022-07-25,Can Tho City,Binh Thuy District,14,12,10,2,1
2022-07-25,Can Tho City,Binh Thuy District,15,7,7,0,0
2022-07-25,Can Tho City,Binh Thuy District,16,15,14,1,1
2022-07-25,Can Tho City,Binh Thuy District,17,14,10,4,3
2022-07-25,Can Tho City,Binh Thuy District,18,19,16,3,1
2022-07-25,Can Tho City,Binh Thuy District,19,7,7,0,0
2022-07-25,Can Tho City,Binh Thuy District,20,14,9,5,0
2022-07-25,Can Tho City,Binh Thuy District,21,8,6,2,1
2022-07-25,Can Tho City,Binh Thuy District,22,1,1,0,0
2022-07-25,Can Tho City,Cai Rang District,6,3,2,1,1
2022-07-25,Can Tho City,Cai Rang District,7,5,5,0,0
2022-07-25,Can Tho City,Cai Rang District,8,7,6,1,0
2022-07-25,Can Tho City,Cai Rang District,9,5,5,0,0
2022-07-25,Can Tho City,Cai Rang District,10,12,12,0,0
2022-07-25,Can Tho City,Cai Rang District,11,17,15,2,2
2022-07-25,Can Tho City,Cai Rang District,12,16,13,3,0
2022-07-25,Can Tho City,Cai Rang District,13,11,10,1,0
2022-07-25,Can Tho City,Cai Rang District,14,11,9,2,1
2022-07-25,Can Tho City,Cai Rang District,15,14,13,1,0
2022-07-25,Can Tho City,Cai Rang District,16,11,11,0,0
2022-07-25,Can Tho City,Cai Rang District,17,9,8,1,1
2022-07-25,Can Tho City,Cai Rang District,18,7,7,0,0
2022-07-25,Can Tho City,Cai Rang District,19,13,11,2,0
2022-07-25,Can Tho City,Cai Rang District,20,8,7,1,0
2022-07-25,Can Tho City,Cai Rang District,21,7,3,4,2
2022-07-25,Can Tho City,Cai Rang District,22,3,2,1,0
2022-07-25,Can Tho City,Ninh Kieu District,0,9,3,6,4
2022-07-25,Can Tho City,Ninh Kieu District,1,1,0,1,1
2022-07-25,Can Tho City,Ninh Kieu District,2,1,1,0,0
2022-07-25,Can Tho City,Ninh Kieu District,3,3,2,1,1
2022-07-25,Can Tho City,Ninh Kieu District,5,1,1,0,0
2022-07-25,Can Tho City,Ninh Kieu District,6,49,37,12,7
2022-07-25,Can Tho City,Ninh Kieu District,7,108,98,10,0
2022-07-25,Can Tho City,Ninh Kieu District,8,210,195,15,0
2022-07-25,Can Tho City,Ninh Kieu District,9,294,272,22,0
2022-07-25,Can Tho City,Ninh Kieu District,10,463,443,20,0
2022-07-25,Can Tho City,Ninh Kieu District,11,780,740,40,2
2022-07-25,Can Tho City,Ninh Kieu District,12,563,547,16,0
2022-07-25,Can Tho City,Ninh Kieu District,13,486,471,15,0
2022-07-25,Can Tho City,Ninh Kieu District,14,417,399,18,0
2022-07-25,Can Tho City,Ninh Kieu District,15,352,334,18,0
2022-07-25,Can Tho City,Ninh Kieu District,16,345,329,16,0
2022-07-25,Can Tho City,Ninh Kieu District,17,443,422,21,1
2022-07-25,Can Tho City,Ninh Kieu District,18,483,453,30,0
2022-07-25,Can Tho City,Ninh Kieu District,19,438,417,21,1
2022-07-25,Can Tho City,Ninh Kieu District,20,334,297,37,0
2022-07-25,Can Tho City,Ninh Kieu District,21,209,191,18,1
2022-07-25,Can Tho City,Ninh Kieu District,22,37,31,6,0
2022-07-25,Can Tho City,Ninh Kieu District,23,19,14,5,1
2022-07-25,Dong Nai,Bien Hoa City,0,14,5,9,5
2022-07-25,Dong Nai,Bien Hoa City,1,11,1,10,5
2022-07-25,Dong Nai,Bien Hoa City,2,3,0,3,3
2022-07-25,Dong Nai,Bien Hoa City,3,3,0,3,3
2022-07-25,Dong Nai,Bien Hoa City,4,3,1,2,2
2022-07-25,Dong Nai,Bien Hoa City,5,7,2,5,5
2022-07-25,Dong Nai,Bien Hoa City,6,57,37,20,14
2022-07-25,Dong Nai,Bien Hoa City,7,182,165,17,2
2022-07-25,Dong Nai,Bien Hoa City,8,297,269,28,5
2022-07-25,Dong Nai,Bien Hoa City,9,425,392,33,1
2022-07-25,Dong Nai,Bien Hoa City,10,741,682,59,11
2022-07-25,Dong Nai,Bien Hoa City,11,1161,1066,95,17
2022-07-25,Dong Nai,Bien Hoa City,12,917,845,72,7
2022-07-25,Dong Nai,Bien Hoa City,13,922,864,58,7
2022-07-25,Dong Nai,Bien Hoa City,14,722,663,59,9
2022-07-25,Dong Nai,Bien Hoa City,15,497,457,40,7
2022-07-25,Dong Nai,Bien Hoa City,16,504,473,31,3
2022-07-25,Dong Nai,Bien Hoa City,17,584,548,36,7
2022-07-25,Dong Nai,Bien Hoa City,18,665,623,42,4
2022-07-25,Dong Nai,Bien Hoa City,19,730,658,72,13
2022-07-25,Dong Nai,Bien Hoa City,20,495,415,80,10
2022-07-25,Dong Nai,Bien Hoa City,21,256,183,73,10
2022-07-25,Dong Nai,Bien Hoa City,22,61,36,25,13
2022-07-25,Dong Nai,Bien Hoa City,23,20,11,9,8
2022-07-25,Dong Nai,Long Khanh,8,1,0,1,1
2022-07-25,Dong Nai,Long Khanh,15,1,0,1,0
2022-07-25,Dong Nai,Long Khanh,18,1,0,1,1
2022-07-25,Dong Nai,Long Thanh,2,1,0,1,0
2022-07-25,Dong Nai,Long Thanh,7,1,0,1,1
2022-07-25,Dong Nai,Long Thanh,10,1,0,1,1
2022-07-25,Dong Nai,Long Thanh,11,2,0,2,2
2022-07-25,Dong Nai,Long Thanh,12,6,0,6,6
2022-07-25,Dong Nai,Long Thanh,13,1,0,1,1
2022-07-25,Dong Nai,Long Thanh,15,3,0,3,3
2022-07-25,Dong Nai,Long Thanh,17,1,0,1,1
2022-07-25,Dong Nai,Long Thanh,18,2,0,2,2
2022-07-25,Dong Nai,Long Thanh,20,1,0,1,1
2022-07-25,Dong Nai,Nhon trach,11,1,0,1,1
2022-07-25,Dong Nai,Nhon trach,16,1,0,1,1
2022-07-25,Dong Nai,Nhon trach,20,2,0,2,1
2022-07-25,Dong Nai,Trang Bom,11,2,1,1,1
2022-07-25,Dong Nai,Trang Bom,12,3,0,3,3
2022-07-25,Dong Nai,Trang Bom,20,1,0,1,1
2022-07-25,Dong Nai,Vinh Cuu,16,1,1,0,0
2022-07-25,Hai Phong City,An Duong,8,2,2,0,0
2022-07-25,Hai Phong City,An Duong,9,7,3,4,3
2022-07-25,Hai Phong City,An Duong,10,5,4,1,1
2022-07-25,Hai Phong City,An Duong,11,3,2,1,1
2022-07-25,Hai Phong City,An Duong,12,3,3,0,0
2022-07-25,Hai Phong City,An Duong,13,6,3,3,3
2022-07-25,Hai Phong City,An Duong,14,10,4,6,5
2022-07-25,Hai Phong City,An Duong,15,7,5,2,2
2022-07-25,Hai Phong City,An Duong,16,1,1,0,0
2022-07-25,Hai Phong City,An Duong,17,4,1,3,2
2022-07-25,Hai Phong City,An Duong,18,3,2,1,0
2022-07-25,Hai Phong City,An Duong,19,4,1,3,2
2022-07-25,Hai Phong City,An Duong,20,6,2,4,4
2022-07-25,Hai Phong City,An Duong,21,2,1,1,1
2022-07-25,Hai Phong City,An Duong,22,3,0,3,2
2022-07-25,Hai Phong City,Duong Kinh District,11,1,0,1,0
2022-07-25,Hai Phong City,Duong Kinh District,19,1,0,1,1
2022-07-25,Hai Phong City,Hai An District,5,1,0,1,1
2022-07-25,Hai Phong City,Hai An District,6,4,2,2,2
2022-07-25,Hai Phong City,Hai An District,7,5,4,1,0
2022-07-25,Hai Phong City,Hai An District,8,12,8,4,1
2022-07-25,Hai Phong City,Hai An District,9,11,11,0,0
2022-07-25,Hai Phong City,Hai An District,10,22,16,6,2
2022-07-25,Hai Phong City,Hai An District,11,54,45,9,4
2022-07-25,Hai Phong City,Hai An District,12,33,28,5,2
2022-07-25,Hai Phong City,Hai An District,13,21,21,0,0
2022-07-25,Hai Phong City,Hai An District,14,21,19,2,1
2022-07-25,Hai Phong City,Hai An District,15,22,15,7,5
2022-07-25,Hai Phong City,Hai An District,16,12,9,3,0
2022-07-25,Hai Phong City,Hai An District,17,18,15,3,1
2022-07-25,Hai Phong City,Hai An District,18,25,23,2,1
2022-07-25,Hai Phong City,Hai An District,19,14,12,2,2
2022-07-25,Hai Phong City,Hai An District,20,13,11,2,1
2022-07-25,Hai Phong City,Hai An District,21,9,7,2,0
2022-07-25,Hai Phong City,Hai An District,22,1,0,1,1
2022-07-25,Hai Phong City,Hai An District,23,3,1,2,2
2022-07-25,Hai Phong City,Hong Bang District,2,1,1,0,0
2022-07-25,Hai Phong City,Hong Bang District,6,2,1,1,1
2022-07-25,Hai Phong City,Hong Bang District,7,16,15,1,0
2022-07-25,Hai Phong City,Hong Bang District,8,39,34,5,3
2022-07-25,Hai Phong City,Hong Bang District,9,35,32,3,0
2022-07-25,Hai Phong City,Hong Bang District,10,70,62,8,2
2022-07-25,Hai Phong City,Hong Bang District,11,142,114,28,13
2022-07-25,Hai Phong City,Hong Bang District,12,67,60,7,1
2022-07-25,Hai Phong City,Hong Bang District,13,44,41,3,1
2022-07-25,Hai Phong City,Hong Bang District,14,62,49,13,7
2022-07-25,Hai Phong City,Hong Bang District,15,58,49,9,4
2022-07-25,Hai Phong City,Hong Bang District,16,30,27,3,2
2022-07-25,Hai Phong City,Hong Bang District,17,52,47,5,2
2022-07-25,Hai Phong City,Hong Bang District,18,52,45,7,1
2022-07-25,Hai Phong City,Hong Bang District,19,52,43,9,1
2022-07-25,Hai Phong City,Hong Bang District,20,42,38,4,2
2022-07-25,Hai Phong City,Hong Bang District,21,35,21,14,2
2022-07-25,Hai Phong City,Hong Bang District,22,1,1,0,0
2022-07-25,Hai Phong City,Kien An District,1,1,0,1,1
2022-07-25,Hai Phong City,Kien An District,7,1,0,1,1
2022-07-25,Hai Phong City,Kien An District,8,3,0,3,3
2022-07-25,Hai Phong City,Kien An District,9,10,5,5,3
2022-07-25,Hai Phong City,Kien An District,10,6,4,2,2
2022-07-25,Hai Phong City,Kien An District,11,22,16,6,5
2022-07-25,Hai Phong City,Kien An District,12,15,12,3,1
2022-07-25,Hai Phong City,Kien An District,13,11,8,3,1
2022-07-25,Hai Phong City,Kien An District,14,15,9,6,4
2022-07-25,Hai Phong City,Kien An District,15,11,8,3,3
2022-07-25,Hai Phong City,Kien An District,16,11,7,4,1
2022-07-25,Hai Phong City,Kien An District,17,10,9,1,0
2022-07-25,Hai Phong City,Kien An District,18,5,5,0,0
2022-07-25,Hai Phong City,Kien An District,19,11,3,8,6
2022-07-25,Hai Phong City,Kien An District,20,10,6,4,4
2022-07-25,Hai Phong City,Kien An District,21,2,1,1,1
2022-07-25,Hai Phong City,Le Chan District,1,1,0,1,0
2022-07-25,Hai Phong City,Le Chan District,2,1,0,1,0
2022-07-25,Hai Phong City,Le Chan District,6,11,8,3,1
2022-07-25,Hai Phong City,Le Chan District,7,42,34,8,3
2022-07-25,Hai Phong City,Le Chan District,8,65,56,9,1
2022-07-25,Hai Phong City,Le Chan District,9,111,100,11,0
2022-07-25,Hai Phong City,Le Chan District,10,235,204,31,5
2022-07-25,Hai Phong City,Le Chan District,11,366,326,40,11
2022-07-25,Hai Phong City,Le Chan District,12,279,257,22,3
2022-07-25,Hai Phong City,Le Chan District,13,130,110,20,1
2022-07-25,Hai Phong City,Le Chan District,14,194,161,33,21
2022-07-25,Hai Phong City,Le Chan District,15,187,155,32,16
2022-07-25,Hai Phong City,Le Chan District,16,176,155,21,8
2022-07-25,Hai Phong City,Le Chan District,17,180,162,18,5
2022-07-25,Hai Phong City,Le Chan District,18,214,187,27,6
2022-07-25,Hai Phong City,Le Chan District,19,207,181,26,4
2022-07-25,Hai Phong City,Le Chan District,20,122,102,20,3
2022-07-25,Hai Phong City,Le Chan District,21,82,61,21,2
2022-07-25,Hai Phong City,Le Chan District,22,14,11,3,0
2022-07-25,Hai Phong City,Ngo Quyen District,3,2,2,0,0
2022-07-25,Hai Phong City,Ngo Quyen District,6,6,5,1,1
2022-07-25,Hai Phong City,Ngo Quyen District,7,30,15,15,7
2022-07-25,Hai Phong City,Ngo Quyen District,8,95,83,12,1
2022-07-25,Hai Phong City,Ngo Quyen District,9,81,73,8,3
2022-07-25,Hai Phong City,Ngo Quyen District,10,174,144,30,9
2022-07-25,Hai Phong City,Ngo Quyen District,11,267,235,32,9
2022-07-25,Hai Phong City,Ngo Quyen District,12,183,173,10,1
2022-07-25,Hai Phong City,Ngo Quyen District,13,137,125,12,1
2022-07-25,Hai Phong City,Ngo Quyen District,14,172,154,18,7
2022-07-25,Hai Phong City,Ngo Quyen District,15,174,138,36,10
2022-07-25,Hai Phong City,Ngo Quyen District,16,121,107,14,3
2022-07-25,Hai Phong City,Ngo Quyen District,17,107,90,17,4
2022-07-25,Hai Phong City,Ngo Quyen District,18,131,116,15,3
2022-07-25,Hai Phong City,Ngo Quyen District,19,150,129,21,3
2022-07-25,Hai Phong City,Ngo Quyen District,20,133,105,28,4
2022-07-25,Hai Phong City,Ngo Quyen District,21,57,41,16,6
2022-07-25,Hai Phong City,Ngo Quyen District,22,6,3,3,0
2022-07-25,Hai Phong City,Ngo Quyen District,23,2,1,1,0
2022-07-25,Hai Phong City,Thuy Nguyen,10,2,0,2,2
2022-07-25,Hai Phong City,Thuy Nguyen,11,1,0,1,1
2022-07-25,Hai Phong City,Thuy Nguyen,12,1,0,1,1
2022-07-25,Hai Phong City,Thuy Nguyen,13,1,0,1,1
2022-07-25,Hai Phong City,Thuy Nguyen,14,1,0,1,1
2022-07-25,Hai Phong City,Thuy Nguyen,19,1,0,1,1
2022-07-25,Hue City,Hue City,0,16,8,8,7
2022-07-25,Hue City,Hue City,1,10,3,7,5
2022-07-25,Hue City,Hue City,2,3,1,2,1
2022-07-25,Hue City,Hue City,3,1,0,1,1
2022-07-25,Hue City,Hue City,4,1,0,1,0
2022-07-25,Hue City,Hue City,5,7,5,2,2
2022-07-25,Hue City,Hue City,6,62,54,8,2
2022-07-25,Hue City,Hue City,7,230,205,25,2
2022-07-25,Hue City,Hue City,8,337,313,24,3
2022-07-25,Hue City,Hue City,9,263,249,14,1
2022-07-25,Hue City,Hue City,10,442,418,24,0
2022-07-25,Hue City,Hue City,11,984,911,73,4
2022-07-25,Hue City,Hue City,12,671,622,49,2
2022-07-25,Hue City,Hue City,13,435,404,31,1
2022-07-25,Hue City,Hue City,14,425,383,42,1
2022-07-25,Hue City,Hue City,15,439,400,39,1
2022-07-25,Hue City,Hue City,16,379,361,18,2
2022-07-25,Hue City,Hue City,17,450,418,32,3
2022-07-25,Hue City,Hue City,18,547,521,26,0
2022-07-25,Hue City,Hue City,19,610,565,45,1
2022-07-25,Hue City,Hue City,20,500,414,86,9
2022-07-25,Hue City,Hue City,21,245,186,59,7
2022-07-25,Hue City,Hue City,22,56,39,17,3
2022-07-25,Hue City,Hue City,23,28,18,10,6
2022-07-25,Hue City,Huong Thuy,6,2,1,1,1
2022-07-25,Hue City,Huong Thuy,7,1,1,0,0
2022-07-25,Hue City,Huong Thuy,9,1,1,0,0
2022-07-25,Hue City,Huong Thuy,10,1,1,0,0
2022-07-25,Hue City,Huong Thuy,11,4,3,1,0
2022-07-25,Hue City,Huong Thuy,12,1,0,1,1
2022-07-25,Hue City,Huong Thuy,14,1,0,1,0
2022-07-25,Hue City,Huong Thuy,15,2,2,0,0
2022-07-25,Hue City,Huong Thuy,16,1,1,0,0
2022-07-25,Hue City,Huong Thuy,17,3,0,3,3
2022-07-25,Hue City,Huong Thuy,18,1,1,0,0
2022-07-25,Hue City,Huong Thuy,19,4,3,1,0
2022-07-25,Hue City,Huong Thuy,20,2,2,0,0
2022-07-25,Hue City,Huong Thuy,21,2,2,0,0
2022-07-25,Hue City,Huong Tra,13,1,1,0,0
2022-07-25,Hue City,Phu Vang,6,1,1,0,0
2022-07-25,Hue City,Phu Vang,7,2,1,1,1
2022-07-25,Hue City,Phu Vang,8,1,1,0,0
2022-07-25,Hue City,Phu Vang,9,4,3,1,0
2022-07-25,Hue City,Phu Vang,10,1,0,1,0
2022-07-25,Hue City,Phu Vang,11,7,7,0,0
2022-07-25,Hue City,Phu Vang,12,4,3,1,0
2022-07-25,Hue City,Phu Vang,13,2,0,2,1
2022-07-25,Hue City,Phu Vang,14,1,1,0,0
2022-07-25,Hue City,Phu Vang,15,1,0,1,1
2022-07-25,Hue City,Phu Vang,16,1,1,0,0
2022-07-25,Hue City,Phu Vang,17,4,4,0,0
2022-07-25,Hue City,Phu Vang,18,3,1,2,0
2022-07-25,Hue City,Phu Vang,19,2,2,0,0
2022-07-25,Hue City,Phu Vang,20,1,1,0,0
2022-07-25,Khanh Hoa,Cam Ranh City,15,1,0,1,1
2022-07-25,Khanh Hoa,Dien Khanh,16,1,0,1,1
2022-07-25,Khanh Hoa,Dien Khanh,20,1,0,1,1
2022-07-25,Khanh Hoa,Nha Trang City,0,4,3,1,1
2022-07-25,Khanh Hoa,Nha Trang City,1,2,0,2,2
2022-07-25,Khanh Hoa,Nha Trang City,2,6,0,6,5
2022-07-25,Khanh Hoa,Nha Trang City,4,1,1,0,0
2022-07-25,Khanh Hoa,Nha Trang City,5,3,1,2,2
2022-07-25,Khanh Hoa,Nha Trang City,6,47,36,11,5
2022-07-25,Khanh Hoa,Nha Trang City,7,169,158,11,2
2022-07-25,Khanh Hoa,Nha Trang City,8,202,191,11,1
2022-07-25,Khanh Hoa,Nha Trang City,9,193,174,19,1
2022-07-25,Khanh Hoa,Nha Trang City,10,211,202,9,0
2022-07-25,Khanh Hoa,Nha Trang City,11,380,358,22,2
2022-07-25,Khanh Hoa,Nha Trang City,12,317,291,26,2
2022-07-25,Khanh Hoa,Nha Trang City,13,344,322,22,0
2022-07-25,Khanh Hoa,Nha Trang City,14,288,273,15,1
2022-07-25,Khanh Hoa,Nha Trang City,15,256,232,24,2
2022-07-25,Khanh Hoa,Nha Trang City,16,243,231,12,0
2022-07-25,Khanh Hoa,Nha Trang City,17,213,189,24,1
2022-07-25,Khanh Hoa,Nha Trang City,18,264,243,21,1
2022-07-25,Khanh Hoa,Nha Trang City,19,259,238,21,3
2022-07-25,Khanh Hoa,Nha Trang City,20,210,182,28,3
2022-07-25,Khanh Hoa,Nha Trang City,21,127,94,33,3
2022-07-25,Khanh Hoa,Nha Trang City,22,34,21,13,2
2022-07-25,Khanh Hoa,Nha Trang City,23,18,14,4,1
2022-07-25,Lam Dong,Da Lat City,0,5,2,3,1
2022-07-25,Lam Dong,Da Lat City,1,1,0,1,1
2022-07-25,Lam Dong,Da Lat City,2,2,0,2,2
2022-07-25,Lam Dong,Da Lat City,3,1,0,1,1
2022-07-25,Lam Dong,Da Lat City,4,1,0,1,0
2022-07-25,Lam Dong,Da Lat City,5,1,0,1,1
2022-07-25,Lam Dong,Da Lat City,6,13,7,6,6
2022-07-25,Lam Dong,Da Lat City,7,57,47,10,3
2022-07-25,Lam Dong,Da Lat City,8,106,88,18,10
2022-07-25,Lam Dong,Da Lat City,9,83,69,14,6
2022-07-25,Lam Dong,Da Lat City,10,110,83,27,11
2022-07-25,Lam Dong,Da Lat City,11,140,123,17,8
2022-07-25,Lam Dong,Da Lat City,12,149,114,35,18
2022-07-25,Lam Dong,Da Lat City,13,149,98,51,39
2022-07-25,Lam Dong,Da Lat City,14,141,104,37,29
2022-07-25,Lam Dong,Da Lat City,15,116,82,34,21
2022-07-25,Lam Dong,Da Lat City,16,99,83,16,8
2022-07-25,Lam Dong,Da Lat City,17,92,81,11,1
2022-07-25,Lam Dong,Da Lat City,18,126,100,26,5
2022-07-25,Lam Dong,Da Lat City,19,120,100,20,10
2022-07-25,Lam Dong,Da Lat City,20,118,80,38,17
2022-07-25,Lam Dong,Da Lat City,21,69,45,24,13
2022-07-25,Lam Dong,Da Lat City,22,29,20,9,5
2022-07-25,Lam Dong,Da Lat City,23,13,8,5,4
2022-07-25,Nghe An,Vinh City,1,1,0,1,1
2022-07-25,Nghe An,Vinh City,2,2,0,2,1
2022-07-25,Nghe An,Vinh City,4,1,0,1,1
2022-07-25,Nghe An,Vinh City,6,18,9,9,4
2022-07-25,Nghe An,Vinh City,7,120,105,15,1
2022-07-25,Nghe An,Vinh City,8,192,173,19,0
2022-07-25,Nghe An,Vinh City,9,156,126,30,1
2022-07-25,Nghe An,Vinh City,10,222,183,39,8
2022-07-25,Nghe An,Vinh City,11,359,321,38,8
2022-07-25,Nghe An,Vinh City,12,238,209,29,4
2022-07-25,Nghe An,Vinh City,13,150,129,21,1
2022-07-25,Nghe An,Vinh City,14,203,169,34,0
2022-07-25,Nghe An,Vinh City,15,190,164,26,1
2022-07-25,Nghe An,Vinh City,16,143,129,14,2
2022-07-25,Nghe An,Vinh City,17,126,104,22,1
2022-07-25,Nghe An,Vinh City,18,173,156,17,1
2022-07-25,Nghe An,Vinh City,19,171,136,35,4
2022-07-25,Nghe An,Vinh City,20,136,112,24,3
2022-07-25,Nghe An,Vinh City,21,83,51,32,7
2022-07-25,Nghe An,Vinh City,22,18,14,4,0
2022-07-25,Nghe An,Vinh City,23,19,9,10,8
2022-07-25,Quang Nam,Dien Ban,17,1,0,1,1
2022-07-25,Quang Nam,Hoi An City,0,2,0,2,2
2022-07-25,Quang Nam,Hoi An City,6,3,0,3,3
2022-07-25,Quang Nam,Hoi An City,7,14,9,5,2
2022-07-25,Quang Nam,Hoi An City,8,17,12,5,1
2022-07-25,Quang Nam,Hoi An City,9,30,22,8,1
2022-07-25,Quang Nam,Hoi An City,10,38,30,8,3
2022-07-25,Quang Nam,Hoi An City,11,37,33,4,1
2022-07-25,Quang Nam,Hoi An City,12,49,35,14,6
2022-07-25,Quang Nam,Hoi An City,13,36,29,7,1
2022-07-25,Quang Nam,Hoi An City,14,34,30,4,1
2022-07-25,Quang Nam,Hoi An City,15,45,36,9,0
2022-07-25,Quang Nam,Hoi An City,16,35,28,7,0
2022-07-25,Quang Nam,Hoi An City,17,41,30,11,5
2022-07-25,Quang Nam,Hoi An City,18,47,37,10,1
2022-07-25,Quang Nam,Hoi An City,19,55,42,13,4
2022-07-25,Quang Nam,Hoi An City,20,33,22,11,5
2022-07-25,Quang Nam,Hoi An City,21,20,17,3,2
2022-07-25,Quang Nam,Hoi An City,22,14,6,8,4
2022-07-25,Quang Nam,Hoi An City,23,5,1,4,1
2022-07-25,Quang Nam,Tam Ky City,18,1,0,1,1
2022-07-25,Quang Ninh,Cam Pha City,12,1,0,1,1
2022-07-25,Quang Ninh,Cam Pha City,13,1,0,1,1
2022-07-25,Quang Ninh,Ha Long City,0,2,0,2,2
2022-07-25,Quang Ninh,Ha Long City,4,1,0,1,1
2022-07-25,Quang Ninh,Ha Long City,6,11,4,7,6
2022-07-25,Quang Ninh,Ha Long City,7,31,19,12,9
2022-07-25,Quang Ninh,Ha Long City,8,55,40,15,1
2022-07-25,Quang Ninh,Ha Long City,9,64,46,18,9
2022-07-25,Quang Ninh,Ha Long City,10,109,80,29,14
2022-07-25,Quang Ninh,Ha Long City,11,166,116,50,22
2022-07-25,Quang Ninh,Ha Long City,12,128,87,41,19
2022-07-25,Quang Ninh,Ha Long City,13,76,53,23,11
2022-07-25,Quang Ninh,Ha Long City,14,77,54,23,13
2022-07-25,Quang Ninh,Ha Long City,15,84,48,36,22
2022-07-25,Quang Ninh,Ha Long City,16,65,46,19,12
2022-07-25,Quang Ninh,Ha Long City,17,56,45,11,5
2022-07-25,Quang Ninh,Ha Long City,18,60,48,12,4
2022-07-25,Quang Ninh,Ha Long City,19,91,50,41,29
2022-07-25,Quang Ninh,Ha Long City,20,51,32,19,10
2022-07-25,Quang Ninh,Ha Long City,21,16,10,6,2
2022-07-25,Quang Ninh,Ha Long City,22,17,11,6,3
2022-07-25,Quang Ninh,Ha Long City,23,5,1,4,4
2022-07-25,Quang Ninh,Hoanh Bo,6,1,0,1,0
2022-07-25,Thai Nguyen,Dong Hy,19,1,1,0,0
2022-07-25,Thai Nguyen,Thai Nguyen City,0,6,5,1,0
2022-07-25,Thai Nguyen,Thai Nguyen City,1,7,2,5,3
2022-07-25,Thai Nguyen,Thai Nguyen City,2,4,1,3,2
2022-07-25,Thai Nguyen,Thai Nguyen City,5,1,0,1,1
2022-07-25,Thai Nguyen,Thai Nguyen City,6,19,13,6,4
2022-07-25,Thai Nguyen,Thai Nguyen City,7,106,91,15,2
2022-07-25,Thai Nguyen,Thai Nguyen City,8,153,139,14,0
2022-07-25,Thai Nguyen,Thai Nguyen City,9,168,155,13,0
2022-07-25,Thai Nguyen,Thai Nguyen City,10,171,159,12,2
2022-07-25,Thai Nguyen,Thai Nguyen City,11,383,355,28,8
2022-07-25,Thai Nguyen,Thai Nguyen City,12,260,229,31,1
2022-07-25,Thai Nguyen,Thai Nguyen City,13,183,170,13,2
2022-07-25,Thai Nguyen,Thai Nguyen City,14,176,161,15,2
2022-07-25,Thai Nguyen,Thai Nguyen City,15,164,144,20,2
2022-07-25,Thai Nguyen,Thai Nguyen City,16,140,114,26,2
2022-07-25,Thai Nguyen,Thai Nguyen City,17,146,124,22,0
2022-07-25,Thai Nguyen,Thai Nguyen City,18,190,175,15,1
2022-07-25,Thai Nguyen,Thai Nguyen City,19,240,212,28,6
2022-07-25,Thai Nguyen,Thai Nguyen City,20,187,161,26,2
2022-07-25,Thai Nguyen,Thai Nguyen City,21,135,99,36,2
2022-07-25,Thai Nguyen,Thai Nguyen City,22,24,15,9,2
2022-07-25,Thai Nguyen,Thai Nguyen City,23,16,5,11,5
2022-07-25,Vung Tau,Ba Ria City,9,6,2,4,4
2022-07-25,Vung Tau,Ba Ria City,10,13,6,7,6
2022-07-25,Vung Tau,Ba Ria City,11,10,3,7,6
2022-07-25,Vung Tau,Ba Ria City,12,16,10,6,3
2022-07-25,Vung Tau,Ba Ria City,13,6,4,2,1
2022-07-25,Vung Tau,Ba Ria City,14,7,6,1,1
2022-07-25,Vung Tau,Ba Ria City,15,9,7,2,2
2022-07-25,Vung Tau,Ba Ria City,16,2,1,1,0
2022-07-25,Vung Tau,Ba Ria City,17,4,4,0,0
2022-07-25,Vung Tau,Ba Ria City,18,3,3,0,0
2022-07-25,Vung Tau,Ba Ria City,19,4,0,4,3
2022-07-25,Vung Tau,Ba Ria City,20,4,0,4,3
2022-07-25,Vung Tau,Ba Ria City,21,2,0,2,2
2022-07-25,Vung Tau,Vung Tau City,0,11,9,2,1
2022-07-25,Vung Tau,Vung Tau City,1,3,0,3,0
2022-07-25,Vung Tau,Vung Tau City,2,1,0,1,1
2022-07-25,Vung Tau,Vung Tau City,5,2,0,2,0
2022-07-25,Vung Tau,Vung Tau City,6,47,32,15,10
2022-07-25,Vung Tau,Vung Tau City,7,134,113,21,8
2022-07-25,Vung Tau,Vung Tau City,8,172,158,14,1
2022-07-25,Vung Tau,Vung Tau City,9,197,179,18,4
2022-07-25,Vung Tau,Vung Tau City,10,256,238,18,1
2022-07-25,Vung Tau,Vung Tau City,11,420,369,51,13
2022-07-25,Vung Tau,Vung Tau City,12,359,333,26,2
2022-07-25,Vung Tau,Vung Tau City,13,293,270,23,2
2022-07-25,Vung Tau,Vung Tau City,14,283,262,21,2
2022-07-25,Vung Tau,Vung Tau City,15,285,248,37,2
2022-07-25,Vung Tau,Vung Tau City,16,209,191,18,4
2022-07-25,Vung Tau,Vung Tau City,17,268,243,25,2
2022-07-25,Vung Tau,Vung Tau City,18,281,254,27,8
2022-07-25,Vung Tau,Vung Tau City,19,285,242,43,6
2022-07-25,Vung Tau,Vung Tau City,20,195,160,35,12
2022-07-25,Vung Tau,Vung Tau City,21,141,98,43,3
2022-07-25,Vung Tau,Vung Tau City,22,40,30,10,0
2022-07-25,Vung Tau,Vung Tau City,23,13,8,5,2
